10000,cāgacetanā,cagacetana,9,9,0,0,10
10001,deyyadhammo,deyyadhammo,133,130,3,0,11
10002,hiriyaṃ,hiriyam,12,11,1,0,7
10003,kusalañca,kusalanca,196,192,4,0,9
10004,viratī,virati,23,21,2,0,6
10005,deti,deti,3117,3053,64,0,4
10006,annaṃ,annam,204,184,20,0,5
10007,pānanti,pananti,5,5,0,0,7
10008,deyyadhammaṃ,deyyadhammam,168,163,5,0,12
10009,denti,denti,943,932,11,0,5
10010,deyyadhammanti,deyyadhammanti,5,5,0,0,14
10011,avakhaṇḍanaṭṭhena,avakhandanatthena,2,2,0,0,17
10012,lavanaṭṭhena,lavanatthena,2,2,0,0,12
10013,bhayabheravasaṅkhātaṃ,bhayabheravasankhatam,1,1,0,0,21
10014,dussilyaṃ,dussilyam,12,12,0,0,9
10015,cetanaṃ,cetanam,75,71,4,0,7
10016,dāti,dati,9,9,0,0,4
10017,diyyatīti,diyyatiti,13,12,1,0,9
10018,itīti,ititi,255,21,234,0,5
10019,dānameva,danameva,39,38,1,0,8
10020,dānapāramī,danaparami,42,38,4,0,10
10021,tatoti,tatoti,465,45,420,0,6
10022,dānapāramito,danaparamito,3,3,0,0,12
10023,sīlapāramādikampīti,silaparamadikampiti,1,0,1,0,19
10024,samādahati,samadahati,35,35,0,0,10
10025,samādhapetīti,samadhapetiti,1,1,0,0,13
10026,susilyavasena,susilyavasena,2,2,0,0,13
10027,sīlayati,silayati,4,4,0,0,8
10028,upadhāretīti,upadharetiti,11,9,2,0,12
10029,patiṭṭhānabhāvena,patitthanabhavena,9,9,0,0,17
10030,sīliyati,siliyati,1,1,0,0,8
10031,upadhāriyati,upadhariyati,1,1,0,0,12
10032,hadayamaṃsantaraṃ,hadayamamsantaram,2,2,0,0,17
10033,upanetvāti,upanetvati,7,4,3,0,10
10034,sīleti,sileti,13,8,5,0,6
10035,upadhāreti,upadhareti,30,29,1,0,10
10036,samaṅgī,samangi,23,21,2,0,7
10037,puggalaṃ,puggalam,1019,972,47,0,8
10038,uppattinīvāraṇavasena,uppattinivaranavasena,1,1,0,0,21
10039,suggati,suggati,4,4,0,0,7
10040,sīlapāramī,silaparami,26,22,4,0,10
10041,yāsanteti,yasanteti,1,1,0,0,9
10042,sīlapāramādikā,silaparamadika,1,1,0,0,14
10043,nekkhammapaññā,nekkhammapanna,1,1,0,0,14
10044,vīriyakhantisaccaadhiṭṭhānamettāupekkhāpāramiṃ,viriyakhantisaccaadhitthanamettaupekkhaparamim,1,1,0,0,46
10045,buddhavaṃsapāḷiyaṃ,buddhavamsapaliyam,2,0,2,0,18
10046,mettupekkhā,mettupekkha,5,5,0,0,11
10047,M0.0159,M0.0159,71,71,0,0,7
10048,apūrīti,apuriti,1,0,1,0,7
10049,sammāsambodhatthāya,sammasambodhatthaya,2,2,0,0,19
10050,pūraṇaṃ,puranam,47,44,3,0,7
10051,samodhānetvā,samodhanetva,194,183,11,0,12
10052,buddhatthāya,buddhatthaya,6,6,0,0,12
10053,anekajātīsu,anekajatisu,2,2,0,0,11
10054,paṭivijjhituṃ,pativijjhitum,143,130,13,0,13
10055,vāyamanto,vayamanto,91,91,0,0,9
10056,adinnadānaṃ,adinnadanam,4,4,0,0,11
10057,arakkhitasīlaṃ,arakkhitasilam,2,2,0,0,14
10058,apūritā,apurita,2,2,0,0,7
10059,atibahumpi,atibahumpi,1,1,0,0,10
10060,akāsiyeva,akasiyeva,3,3,0,0,9
10061,bodhisatta,bodhisatta,4,4,0,0,10
10062,mahāsamuddesu,mahasamuddesu,24,24,0,0,13
10063,parājetvā,parajetva,13,13,0,0,9
10064,lohitadānamakāsi,lohitadanamakasi,1,1,0,0,16
10065,sakalapathaviyā,sakalapathaviya,2,2,0,0,15
10066,paṃsuṃ,pamsum,122,116,6,0,6
10067,maṃsamadāsi,mamsamadasi,1,1,0,0,11
10068,sinerupabbatarājaṃ,sinerupabbatarajam,6,6,0,0,18
10069,sīsadānamadāsi,sisadanamadasi,1,1,0,0,14
10070,tārakasamūhaṃ,tarakasamuham,1,1,0,0,13
10071,nayanamadāsi,nayanamadasi,1,1,0,0,12
10072,jinālaṅkāre,jinalankare,1,0,1,0,11
10073,sāgare,sagare,28,28,0,0,6
10074,jaladhikaṃ,jaladhikam,2,2,0,0,10
10075,rudhiraṃ,rudhiram,27,25,2,0,8
10076,bhūmiṃ,bhumim,339,314,25,0,6
10077,parājiya,parajiya,1,1,0,0,8
10078,samaṃsamadāsi,samamsamadasi,2,2,0,0,13
10079,meruppamāṇamadhikañca,meruppamanamadhikanca,2,2,0,0,21
10080,samoḷisīsaṃ,samolisisam,2,2,0,0,11
10081,khe,khe,29,23,6,0,3
10082,tārakādhikataraṃ,tarakadhikataram,2,2,0,0,16
10083,adāsī,adasi,59,54,5,0,5
10084,vasantatilakagāthā,vasantatilakagatha,2,2,0,0,18
10085,evaṃvidho,evamvidho,34,34,0,0,9
10086,sāgareti,sagareti,2,2,0,0,8
10087,jaladhikanti,jaladhikanti,1,1,0,0,12
10088,udakato,udakato,95,95,0,0,7
10089,adāsīti,adasiti,65,48,17,0,7
10090,lohitadānamadāsi,lohitadanamadasi,1,1,0,0,16
10091,parājiyāti,parajiyati,1,1,0,0,10
10092,paṃsupathaviyā,pamsupathaviya,1,1,0,0,14
10093,sarīramaṃsaṃ,sariramamsam,7,7,0,0,12
10094,meruppamāṇamadhikanti,meruppamanamadhikanti,1,1,0,0,21
10095,yojana,yojana,8,8,0,0,6
10096,aṭṭhasaṭṭhisatasahassubbedhassa,atthasatthisatasahassubbedhassa,1,1,0,0,31
10097,girirājassa,girirajassa,1,1,0,0,11
10098,pamāṇatopi,pamanatopi,1,1,0,0,10
10099,samoḷisīsanti,samolisisanti,1,1,0,0,13
10100,moḷiyā,moliya,7,7,0,0,6
10101,abhisittasīsaṃ,abhisittasisam,1,1,0,0,14
10102,kheti,kheti,1,1,0,0,5
10103,cakkavāḷapabbatapariyante,cakkavalapabbatapariyante,1,1,0,0,25
10104,tārakādhikataranti,tarakadhikataranti,1,1,0,0,18
10105,nakkhattāditārakarūpatopi,nakkhattaditarakarupatopi,1,1,0,0,25
10106,M0.0160,M0.0160,72,72,0,0,7
10107,nettadānaṃ,nettadanam,1,1,0,0,10
10108,evamettha,evamettha,922,915,7,0,9
10109,upayātaṃ,upayatam,2,2,0,0,8
10110,tāsanti,tasanti,1,1,0,0,7
10111,iddhiyāti,iddhiyati,28,2,26,0,9
10112,samiddhiyā,samiddhiya,6,6,0,0,10
10113,cetaṃ,cetam,1237,1178,59,0,5
10114,upayātanti,upayatanti,1,1,0,0,10
10115,upagataṃ,upagatam,115,110,5,0,8
10116,seṭṭhabhūtaṃ,setthabhutam,3,3,0,0,12
10117,buddhattanti,buddhattanti,1,1,0,0,12
10118,upayātantipade,upayatantipade,1,1,0,0,14
10119,aggati,aggati,3,3,0,0,6
10120,aggadhātu,aggadhatu,1,1,0,0,9
10121,uttamataro,uttamataro,5,5,0,0,10
10122,seṭṭhataroti,setthataroti,2,2,0,0,12
10123,dasanipāta,dasanipata,1,1,0,0,10
10124,rūpino,rupino,91,76,15,0,6
10125,arūpino,arupino,397,379,18,0,7
10126,saññino,sannino,96,89,7,0,7
10127,asaññino,asannino,37,32,5,0,8
10128,nevasaññīnāsaññino,nevasanninasannino,13,12,1,0,18
10129,ekadīpakanti,ekadipakanti,4,4,0,0,12
10130,ekapaṭisaraṇabhūtaṃ,ekapatisaranabhutam,3,3,0,0,19
10131,patiṭṭhabhūtaṃ,patitthabhutam,1,1,0,0,14
10132,dīpakasaddo,dipakasaddo,1,1,0,0,11
10133,paṭisaraṇapatiṭṭhavācako,patisaranapatitthavacako,1,1,0,0,24
10134,patiṭṭhāpanaṭṭhena,patitthapanatthena,3,3,0,0,18
10135,dīpanti,dipanti,6,6,0,0,7
10136,paṭisaraṇabhāvena,patisaranabhavena,1,1,0,0,17
10137,dīpako,dipako,43,41,2,0,6
10138,dīpadhātu,dipadhatu,3,3,0,0,9
10139,ako,ako,8,8,0,0,3
10140,saṅkhyāvācako,sankhyavacako,2,2,0,0,13
10141,dīpakoti,dipakoti,5,5,0,0,8
10142,ekadīpako,ekadipako,2,2,0,0,9
10143,samuddadīpakamiva,samuddadipakamiva,1,1,0,0,17
10144,ekabuddhabhūtaṃ,ekabuddhabhutam,1,1,0,0,15
10145,jalamajjhe,jalamajjhe,13,13,0,0,10
10146,dippatīti,dippatiti,31,20,11,0,9
10147,dīpo,dipo,115,98,17,0,4
10148,dvidhā,dvidha,775,709,66,0,6
10149,āposandati,aposandati,1,1,0,0,10
10150,soviya,soviya,1,1,0,0,6
10151,M0.0161,M0.0161,72,72,0,0,7
10152,bhinnanāvānaṃ,bhinnanavanam,6,6,0,0,13
10153,samuddadīpo,samuddadipo,2,2,0,0,11
10154,saṃsārasāgare,samsarasagare,9,9,0,0,13
10155,alabbhaneyyapatiṭṭhe,alabbhaneyyapatitthe,2,2,0,0,20
10156,osīdantānaṃ,osidantanam,4,3,1,0,11
10157,jātiyaṃ,jatiyam,70,64,6,0,7
10158,aṅgajīvitampi,angajivitampi,1,1,0,0,13
10159,aṅgapaccaṅgajīvitindriyampi,angapaccangajivitindriyampi,1,1,0,0,27
10160,sabbaññutañāṇasaṅkhātāya,sabbannutananasankhataya,1,1,0,0,24
10161,alagga,alagga,1,1,0,0,6
10162,mānasoti,manasoti,5,3,2,0,8
10163,anallīyanacitto,analliyanacitto,1,1,0,0,15
10164,puttadārādiṃ,puttadaradim,1,1,0,0,12
10165,pariccāgacetanāya,pariccagacetanaya,5,5,0,0,17
10166,adāsieva,adasieva,1,1,0,0,8
10167,dānapāramimpi,danaparamimpi,1,1,0,0,13
10168,sīlapāramīādikampi,silaparamiadikampi,1,1,0,0,18
10169,seṭṭhabuddhattaṃ,setthabuddhattam,1,1,0,0,16
10170,ekadīpakaṃ,ekadipakam,1,1,0,0,10
10171,ekapatiṭṭhānabhūtaṃ,ekapatitthanabhutam,1,1,0,0,19
10172,dīpakamiva,dipakamiva,1,1,0,0,10
10173,ekavīsatimavandanagāthāvaṇṇanā,ekavisatimavandanagathavannana,1,1,0,0,30
10174,M0.0162,M0.0162,71,71,0,0,7
10175,ekavīsatimāya,ekavisatimaya,1,1,0,0,13
10176,devādevātidevantyādīhi,devadevatidevantyadihi,1,1,0,0,22
10177,itiādimāha,itiadimaha,3234,3230,4,0,10
10178,timuniyatīhi,timuniyatihi,1,1,0,0,12
10179,ekavīsatakkharehi,ekavisatakkharehi,1,1,0,0,17
10180,ādyantayamakā,adyantayamaka,1,1,0,0,13
10181,saddharā,saddhara,2,2,0,0,8
10182,mrā,mra,4,4,0,0,3
10183,bhnā,bhna,3,3,0,0,4
10184,yotra,yotra,1,1,0,0,5
10185,timuniyatiyutā,timuniyatiyuta,2,2,0,0,14
10186,kittitāyaṃ,kittitayam,1,1,0,0,10
10187,maragaṇā,maragana,1,1,0,0,8
10188,bhanagaṇā,bhanagana,1,1,0,0,9
10189,yagaṇena,yaganena,1,1,0,0,8
10190,sattamakkharantetīhi,sattamakkharantetihi,1,1,0,0,20
10191,atra,atra,153,139,14,0,4
10192,pakati,pakati,234,208,26,0,6
10193,chande,chande,32,32,0,0,6
10194,saddharāgāthāti,saddharagathati,4,4,0,0,15
10195,kittitāti,kittitati,8,4,4,0,9
10196,munisaddo,munisaddo,3,3,0,0,9
10197,ekasmiṃ,ekasmim,2298,2204,94,0,7
10198,sattamakkharante,sattamakkharante,2,2,0,0,16
10199,tiparivattattā,tiparivattatta,1,1,0,0,14
10200,timuniyatiyutāti,timuniyatiyutati,1,1,0,0,16
10201,ekavīsatakkharavantoti,ekavisatakkharavantoti,1,1,0,0,22
10202,rājasaṅkhātasammutideva,rajasankhatasammutideva,1,1,0,0,23
10203,catumahārājādikaupapattidevānaṃ,catumaharajadikaupapattidevanam,1,1,0,0,31
10204,atiuttamaṃ,atiuttamam,3,3,0,0,10
10205,atiseṭṭhaṃ,atisettham,6,5,1,0,10
10206,visuddhidevabhūtaṃ,visuddhidevabhutam,2,2,0,0,18
10207,mānussaissariyasampattīhi,manussaissariyasampattihi,1,1,0,0,25
10208,manussarājadevī,manussarajadevi,1,1,0,0,15
10209,kumārā,kumara,153,152,1,0,6
10210,dibbaissariyasampattīhi,dibbaissariyasampattihi,1,1,0,0,23
10211,catumahārājikā,catumaharajika,2,2,0,0,14
10212,kāmaguṇādīhi,kamagunadihi,5,5,0,0,12
10213,kīḷanti,kilanti,263,261,2,0,7
10214,laḷanti,lalanti,18,14,4,0,7
10215,viharanti,viharanti,816,805,11,0,9
10216,vijayasamatthatāyogena,vijayasamatthatayogena,6,6,0,0,22
10217,paccatthike,paccatthike,32,29,3,0,11
10218,vijetuṃ,vijetum,27,26,1,0,7
10219,issariyadhanādisakkāradānaggahaṇaṃ,issariyadhanadisakkaradanaggahanam,3,3,0,0,34
10220,atthānusāsanañca,atthanusasananca,1,1,0,0,16
10221,karontā,karonta,514,511,3,0,7
10222,voharanti,voharanti,139,139,0,0,9
10223,puññātisayayogānubhāvappattāya,punnatisayayoganubhavappattaya,2,2,0,0,30
10224,jotanti,jotanti,45,45,0,0,7
10225,yathādhippetañca,yathadhippetanca,3,3,0,0,16
10226,visayaṃ,visayam,221,210,11,0,7
10227,appaṭighātena,appatighatena,6,6,0,0,13
10228,yathicchitanipphādane,yathicchitanipphadane,7,7,0,0,21
10229,sakkontīti,sakkontiti,77,65,12,0,10
10230,āgatanayenapi,agatanayenapi,2,2,0,0,13
10231,atidevanti,atidevanti,1,1,0,0,10
10232,M0.0163,M0.0163,70,70,0,0,7
10233,visuddhi,visuddhi,795,788,7,0,8
10234,devabhūtaṃ,devabhutam,1,1,0,0,10
10235,bhagavantanti,bhagavantanti,9,9,0,0,13
10236,sammuti,sammuti,198,169,29,0,7
10237,atirekattā,atirekatta,2,2,0,0,10
10238,atireko,atireko,38,37,1,0,7
10239,devoti,devoti,77,44,33,0,6
10240,atidevoti,atidevoti,2,2,0,0,9
10241,atiuttamo,atiuttamo,2,2,0,0,9
10242,atiseṭṭho,atisettho,2,2,0,0,9
10243,ativisiṭṭho,ativisittho,1,1,0,0,11
10244,devādevātidevo,devadevatidevo,1,1,0,0,14
10245,visuddhidevabhūto,visuddhidevabhuto,3,3,0,0,17
10246,dhammahadayavibhaṅge,dhammahadayavibhange,21,8,13,0,20
10247,catumahārājike,catumaharajike,2,2,0,0,14
10248,deve,deve,574,556,18,0,4
10249,tadupari,tadupari,8,8,0,0,8
10250,vuccantī,vuccanti,68,51,17,0,8
10251,nirātisayāya,niratisayaya,1,1,0,0,12
10252,abhiññākīḷāya,abhinnakilaya,5,4,1,0,13
10253,uttamehi,uttamehi,13,12,1,0,8
10254,dibbabrahmaariyavihārehi,dibbabrahmaariyaviharehi,8,8,0,0,24
10255,saparasantānagatapañcavidhamāravija,saparasantanagatapancavidhamaravija,1,1,0,0,35
10256,yicchānipphattiyācittissariya,yicchanipphattiyacittissariya,1,1,0,0,29
10257,sattadhanādi,sattadhanadi,1,1,0,0,12
10258,sammāpaṭipatti,sammapatipatti,41,39,2,0,14
10259,aveccappasādasakkāradānaggahaṇasaṅkhātena,aveccappasadasakkaradanaggahanasankhatena,1,1,0,0,41
10260,dhammasabhāvapuggalajjhāsayānurūpānusāsanīsaṅkhātena,dhammasabhavapuggalajjhasayanurupanusasanisankhatena,3,3,0,0,52
10261,vohārātisayena,voharatisayena,4,4,0,0,14
10262,paramāya,paramaya,128,117,11,0,8
10263,paññāsarīrappabhāsaṅkhātāya,pannasarirappabhasankhataya,3,3,0,0,27
10264,anaññasādhāraṇāya,anannasadharanaya,8,8,0,0,17
10265,ñāṇasarīragatiyā,nanasariragatiya,4,4,0,0,16
10266,māravijaya,maravijaya,1,1,0,0,10
10267,sabbaññuguṇaparahita,sabbannugunaparahita,1,1,0,0,20
10268,nipphādanesu,nipphadanesu,1,1,0,0,12
10269,appaṭihatāya,appatihataya,4,4,0,0,12
10270,sattiyā,sattiya,120,112,8,0,7
10271,sadevakena,sadevakena,47,44,3,0,10
10272,gamanīyato,gamaniyato,7,6,1,0,10
10273,abhitthavanīyato,abhitthavaniyato,4,4,0,0,16
10274,bhattivasena,bhattivasena,11,11,0,0,12
10275,kamanīyato,kamaniyato,6,6,0,0,10
10276,abhibhuyya,abhibhuyya,419,398,21,0,10
10277,ṭhitattā,thitatta,352,338,14,0,8
10278,devādevātidevoti,devadevatidevoti,1,1,0,0,16
10279,antimakāyadhāraṇaṃ,antimakayadharanam,2,2,0,0,18
10280,nidhanasaddo,nidhanasaddo,1,1,0,0,12
10281,pariyosānavācako,pariyosanavacako,1,1,0,0,16
10282,nidheti,nidheti,24,21,3,0,7
10283,nidhanaṃ,nidhanam,14,13,1,0,8
10284,vināseti,vinaseti,140,137,3,0,8
10285,antimakāyo,antimakayo,1,1,0,0,10
10286,M0.0164,M0.0164,72,72,0,0,7
10287,nāse,nase,24,20,4,0,4
10288,vapati,vapati,13,13,0,0,6
10289,kusalākusalabījametthāti,kusalakusalabijametthati,2,2,0,0,24
10290,vapu,vapu,9,7,2,0,4
10291,vapadhātu,vapadhatu,1,1,0,0,9
10292,bījasantāne,bijasantane,6,6,0,0,11
10293,nidhanañca,nidhananca,1,1,0,0,10
10294,nidhanavapu,nidhanavapu,1,1,0,0,11
10295,nidhanavapudharo,nidhanavapudharo,1,1,0,0,16
10296,anamataggasaṃsārabhavesu,anamataggasamsarabhavesu,1,1,0,0,24
10297,nibbattentānaṃ,nibbattentanam,5,5,0,0,14
10298,aggamaggañāṇasatthena,aggamaggananasatthena,1,1,0,0,21
10299,samucchindi,samucchindi,10,10,0,0,11
10300,tattā,tatta,10,10,0,0,5
10301,buddhabhāvajāti,buddhabhavajati,1,1,0,0,15
10302,antima,antima,16,16,0,0,6
10303,munindameva,munindameva,1,1,0,0,11
10304,nidhanavapudharanti,nidhanavapudharanti,1,1,0,0,19
10305,dharo,dharo,8,6,2,0,5
10306,devaputtādipañcamāre,devaputtadipancamare,2,2,0,0,20
10307,viddhaṃsanaṃ,viddhamsanam,17,15,2,0,12
10308,mārasaddattho,marasaddattho,1,1,0,0,13
10309,bhañjati,bhanjati,89,87,2,0,8
10310,abhañji,abhanji,9,8,1,0,7
10311,bhañjissatīti,bhanjissatiti,1,1,0,0,13
10312,mārabhaṅgo,marabhango,2,2,0,0,10
10313,avamaddane,avamaddane,5,5,0,0,10
10314,goādeso,goadeso,1,1,0,0,7
10315,nakārassa,nakarassa,20,20,0,0,9
10316,niggahitādeso,niggahitadeso,3,3,0,0,13
10317,kavaggantādeso,kavaggantadeso,1,1,0,0,14
10318,mārasenāya,marasenaya,9,9,0,0,10
10319,bhañjiyate,bhanjiyate,1,1,0,0,10
10320,nabhaṅgo,nabhango,1,1,0,0,8
10321,bhañjiyatīti,bhanjiyatiti,1,1,0,0,12
10322,samatthoti,samatthoti,58,51,7,0,10
10323,dīpaṃdīpaṃ,dipamdipam,1,0,1,0,10
10324,pajānanti,pajananti,225,223,2,0,9
10325,pajāyanti,pajayanti,14,14,0,0,9
10326,nibbattiyanti,nibbattiyanti,1,1,0,0,13
10327,paṭisandhicutivasenāti,patisandhicutivasenati,1,1,0,0,22
10328,paññāpadīpaṃ,pannapadipam,2,2,0,0,12
10329,kusalākusale,kusalakusale,94,91,3,0,12
10330,dippati,dippati,59,59,0,0,7
10331,pakāsetīti,pakasetiti,106,92,14,0,10
10332,dīpamivāti,dipamivati,1,1,0,0,10
10333,dīpā,dipa,81,73,8,0,4
10334,vidhamitvā,vidhamitva,103,101,2,0,10
10335,hantvā,hantva,169,163,6,0,6
10336,dhammālokaṃ,dhammalokam,5,5,0,0,11
10337,M0.0165,M0.0165,73,73,0,0,7
10338,dīpakaṃ,dipakam,59,52,7,0,7
10339,pakāsentanti,pakasentanti,1,1,0,0,12
10340,dīpoti,dipoti,9,7,2,0,6
10341,payirupāsanavasena,payirupasanavasena,7,7,0,0,18
10342,gatāgatānaṃ,gatagatanam,1,1,0,0,11
10343,vineyyasattānaṃ,vineyyasattanam,1,1,0,0,15
10344,catumaggañāṇādipaññāpadīpaṃ,catumaggananadipannapadipam,1,1,0,0,27
10345,jayavarasayaneti,jayavarasayaneti,1,0,1,0,16
10346,pañcamāravijayantaṭṭhānabhūte,pancamaravijayantatthanabhute,2,2,0,0,29
10347,bodhipallaṅkāsane,bodhipallankasane,1,1,0,0,17
10348,bodhirukkhapallaṅko,bodhirukkhapallanko,2,2,0,0,19
10349,jidhātu,jidhatu,1,1,0,0,7
10350,jaye,jaye,40,38,2,0,4
10351,patthi,patthi,4,4,0,0,6
10352,tabboti,tabboti,2,2,0,0,7
10353,bhajiyati,bhajiyati,1,1,0,0,9
10354,sayano,sayano,2,2,0,0,6
10355,sevāyaṃyu,sevayamyu,1,1,0,0,9
10356,varasayano,varasayano,2,2,0,0,10
10357,jayoeva,jayoeva,1,1,0,0,7
10358,jayavarasayano,jayavarasayano,1,1,0,0,14
10359,bodhipattaṃ,bodhipattam,4,4,0,0,11
10360,adhipattanti,adhipattanti,3,3,0,0,12
10361,bodhipattanti,bodhipattanti,1,1,0,0,13
10362,arahattamaggasabbaññutañāṇaṃ,arahattamaggasabbannutananam,3,3,0,0,28
10363,bodhisaddo,bodhisaddo,8,8,0,0,10
10364,rukkhamaggañāṇasabbaññutañāṇanibbānesupi,rukkhamaggananasabbannutanananibbanesupi,1,1,0,0,40
10365,paṭhamābhisambuddhotiādīsu,pathamabhisambuddhotiadisu,1,1,0,0,26
10366,rukkhe,rukkhe,365,355,10,0,6
10367,ñāṇantiādīsu,nanantiadisu,1,1,0,0,12
10368,varabhūrī,varabhuri,1,1,0,0,9
10369,medhasotiādīsu,medhasotiadisu,1,1,0,0,14
10370,asaṅkhatantiādīsu,asankhatantiadisu,1,1,0,0,17
10371,sarūpekasesavasena,sarupekasesavasena,4,4,0,0,18
10372,apajjiṃ,apajjim,1,1,0,0,7
10373,vuḍḍhatarabhāvaṃ,vuddhatarabhavam,4,4,0,0,16
10374,adhipatto,adhipatto,1,1,0,0,9
10375,adhipattaṃ,adhipattam,2,2,0,0,10
10376,kukkuṭapotakānaṃ,kukkutapotakanam,17,17,0,0,16
10377,M0.0166,M0.0166,73,73,0,0,7
10378,kukkuṭapotako,kukkutapotako,8,8,0,0,13
10379,aṇḍakosaṃ,andakosam,56,53,3,0,9
10380,abhinibbhido,abhinibbhido,2,2,0,0,12
10381,avijjā,avijja,1355,1227,128,0,6
10382,gatāya,gataya,41,40,1,0,6
10383,sabbaguṇehi,sabbagunehi,16,16,0,0,11
10384,adhikattā,adhikatta,11,11,0,0,9
10385,appaṭisamattā,appatisamatta,3,3,0,0,13
10386,appaṭisamabhāvañca,appatisamabhavanca,1,1,0,0,18
10387,brahma,brahma,53,32,21,0,6
10388,abrahma,abrahma,1,1,0,0,7
10389,āgatānanti,agatananti,2,2,0,0,10
10390,āgatānaṃ,agatanam,211,205,6,0,8
10391,devamanussaparisānanti,devamanussaparisananti,2,2,0,0,22
10392,brahmāti,brahmati,67,49,18,0,8
10393,brahmapārisajjādi,brahmaparisajjadi,3,3,0,0,17
10394,jhānādiguṇehi,jhanadigunehi,4,4,0,0,13
10395,brūhanti,bruhanti,3,3,0,0,8
10396,vaḍḍhantīti,vaddhantiti,23,17,6,0,11
10397,abrahmāti,abrahmati,2,2,0,0,9
10398,āgacchanti,agacchanti,586,575,11,0,10
10399,payirupāsanavasenāti,payirupasanavasenati,1,1,0,0,20
10400,āpubbagamudhātu,apubbagamudhatu,1,1,0,0,15
10401,abrahmā,abrahma,1,1,0,0,7
10402,brahmābrahmāgatā,brahmabrahmagata,1,1,0,0,16
10403,visesana,visesana,30,30,0,0,8
10404,paranipātapadametaṃ,paranipatapadametam,1,1,0,0,19
10405,agyāhitotiādīsu,agyahitotiadisu,2,2,0,0,15
10406,varagirakathikantipade,varagirakathikantipade,1,1,0,0,22
10407,sampadānaṃ,sampadanam,56,50,6,0,10
10408,payirupāsanānaṃ,payirupasananam,1,1,0,0,15
10409,dhammavācaṃ,dhammavacam,1,1,0,0,11
10410,desentaṃ,desentam,69,67,2,0,8
10411,seṭṭhavācāya,setthavacaya,2,2,0,0,12
10412,desamānaṃ,desamanam,2,2,0,0,9
10413,gāyati,gayati,26,26,0,0,6
10414,girā,gira,30,25,5,0,4
10415,gādhātu,gadhatu,1,1,0,0,7
10416,īro,iro,16,16,0,0,3
10417,varā,vara,30,29,1,0,4
10418,seṭṭhā,settha,142,132,10,0,6
10419,varagirā,varagira,1,1,0,0,8
10420,kathetīti,kathetiti,74,51,23,0,9
10421,varagirakathiko,varagirakathiko,1,1,0,0,15
10422,manāpabhūtavācāya,manapabhutavacaya,1,1,0,0,17
10423,desetīti,desetiti,122,103,19,0,8
10424,lāmakaakusalakilesaṃ,lamakaakusalakilesam,2,2,0,0,20
10425,apāyādi,apayadi,1,1,0,0,7
10426,pāpetīti,papetiti,52,46,6,0,8
10427,pāpoti,papoti,13,7,6,0,6
10428,akusalakileso,akusalakileso,1,1,0,0,13
10429,papubbaapadhātu,papubbaapadhatu,1,1,0,0,15
10430,pāpuṇane,papunane,32,31,1,0,8
10431,kusaladhammena,kusaladhammena,3,3,0,0,14
10432,caji,caji,9,9,0,0,4
10433,lāmakadhammo,lamakadhammo,13,11,2,0,12
10434,tassino,tassino,1,1,0,0,7
10435,pāpoeva,papoeva,1,1,0,0,7
10436,hīnaṃ,hinam,494,431,63,0,5
10437,M0.0167,M0.0167,70,70,0,0,7
10438,susamucchinnaṃ,susamucchinnam,2,2,0,0,14
10439,pajahatīti,pajahatiti,307,273,34,0,10
10440,pahīno,pahino,943,929,14,0,6
10441,papubbahādhātu,papubbahadhatu,1,1,0,0,14
10442,ino,ino,37,37,0,0,3
10443,akusaladhamme,akusaladhamme,19,19,0,0,13
10444,aggamaggañāṇena,aggamaggananena,9,9,0,0,15
10445,samucchindatīti,samucchindatiti,14,13,1,0,15
10446,lokaalokaabhirāmanti,lokaalokaabhiramanti,1,1,0,0,20
10447,manussalokadevabrahmalokānaṃ,manussalokadevabrahmalokanam,1,1,0,0,28
10448,abhirāmaṭṭhānabhūtanti,abhiramatthanabhutanti,1,1,0,0,22
10449,manussa,manussa,25,25,0,0,7
10450,puññāpuññaṃ,punnapunnam,6,6,0,0,11
10451,aloko,aloko,2,2,0,0,5
10452,devabrahmaloko,devabrahmaloko,1,1,0,0,14
10453,lokālokā,lokaloka,2,2,0,0,8
10454,sattalokānaṃ,sattalokanam,3,3,0,0,12
10455,abhiadhikaṃ,abhiadhikam,1,1,0,0,11
10456,ramanti,ramanti,78,75,3,0,7
10457,lokālokābhirāmo,lokalokabhiramo,1,1,0,0,15
10458,pūjānuggahādikaraṇavasena,pujanuggahadikaranavasena,1,1,0,0,25
10459,abhirāmaṭṭhānaṃ,abhiramatthanam,1,1,0,0,15
10460,lokālokābhirāmanti,lokalokabhiramanti,1,1,0,0,18
10461,abhiṇhanti,abhinhanti,2,2,0,0,10
10462,pañcamunissaraṃ,pancamunissaram,2,2,0,0,15
10463,abhinameti,abhinameti,1,0,1,0,10
10464,abhisakkaccaṃ,abhisakkaccam,2,2,0,0,13
10465,sammutidevaupapattidevānaṃ,sammutidevaupapattidevanam,1,1,0,0,26
10466,bhañjanārahaṃ,bhanjanaraham,1,1,0,0,13
10467,kammabhūtaṃ,kammabhutam,13,13,0,0,11
10468,pakāsentaṃ,pakasentam,14,14,0,0,10
10469,uttamabodhipallaṅkāsane,uttamabodhipallankasane,1,1,0,0,23
10470,ādhārabhūte,adharabhute,5,5,0,0,11
10471,brahmāgatānaṃ,brahmagatanam,1,1,0,0,13
10472,brahmadeva,brahmadeva,1,1,0,0,10
10473,manussaparisānaṃ,manussaparisanam,1,1,0,0,16
10474,M0.0168,M0.0168,71,71,0,0,7
10475,lokadevabrahmalokānaṃ,lokadevabrahmalokanam,1,1,0,0,21
10476,abhirāmabhūtaṃ,abhiramabhutam,1,1,0,0,14
10477,abhiname,abhiname,1,1,0,0,8
10478,dvāvīsatimavandanagāthāvaṇṇanā,dvavisatimavandanagathavannana,1,1,0,0,30
10479,M0.0169,M0.0169,68,68,0,0,7
10480,dvāvīsatimāya,dvavisatimaya,1,1,0,0,13
10481,paṇāmaṃ,panamam,41,41,0,0,7
10482,nigrodhabimbotyādīhi,nigrodhabimbotyadihi,1,1,0,0,20
10483,dvattiṃsamahāpurisalakkhaṇasampannehi,dvattimsamahapurisalakkhanasampannehi,1,1,0,0,37
10484,tyādigāthāttayamāha,tyadigathattayamaha,1,1,0,0,19
10485,gāthāttayaṃ,gathattayam,9,9,0,0,11
10486,paṭhamagāthāyaṃ,pathamagathayam,18,18,0,0,15
10487,paṭividdhaniravasesasabbadhammo,patividdhaniravasesasabbadhammo,1,1,0,0,31
10488,tyādīsu,tyadisu,103,102,1,0,7
10489,padesu,padesu,226,225,1,0,6
10490,tulyaliṅgattabhāvena,tulyalingattabhavena,6,6,0,0,20
10491,niravasesasabbadhamme,niravasesasabbadhamme,1,1,0,0,21
10492,vikappesu,vikappesu,46,45,1,0,9
10493,budhadhātussa,budhadhatussa,4,4,0,0,13
10494,catusaccadhammapaṭivijjhanaṃ,catusaccadhammapativijjhanam,1,1,0,0,28
10495,maggaphalañāṇañca,maggaphalanananca,1,1,0,0,17
10496,arahattaphalañāṇañca,arahattaphalanananca,2,2,0,0,20
10497,sabbaññutañāṇādipacchimapacchimañāṇāni,sabbannutananadipacchimapacchimananani,1,1,0,0,38
10498,tapaccayassa,tapaccayassa,19,19,0,0,12
10499,mukhyopacārena,mukhyopacarena,2,2,0,0,14
10500,aparimitaguṇagaṇālaṅkāraṃ,aparimitagunaganalankaram,1,1,0,0,25
10501,khandhapañcakaṃ,khandhapancakam,166,162,4,0,15
10502,buddhobuddhoti,buddhobuddhoti,4,4,0,0,14
10503,paññatto,pannatto,306,298,8,0,8
10504,sattaviseso,sattaviseso,9,9,0,0,11
10505,vikappe,vikappe,42,40,2,0,7
10506,sabbañeyyadhammapaṭivijjhanasamatthaṃ,sabbaneyyadhammapativijjhanasamattham,1,1,0,0,37
10507,catumaggaphalañāṇañca,catumaggaphalanananca,1,1,0,0,21
10508,vipassanā,vipassana,916,823,93,0,9
10509,āsayānusayañāṇādipacchima,asayanusayananadipacchima,1,1,0,0,25
10510,pacchimañāṇāni,pacchimananani,1,1,0,0,14
10511,aparimāṇaguṇoghālaṅkataṃ,aparimanagunoghalankatam,1,1,0,0,24
10512,kiṃpanettha,kimpanettha,2,2,0,0,11
10513,vāccabhūtaṃ,vaccabhutam,1,1,0,0,11
10514,ñāṇameva,nanameva,36,33,3,0,8
10515,udāhu,udahu,1126,1091,35,0,5
10516,malakara,malakara,1,1,0,0,8
10517,savāsanānaṃ,savasananam,25,22,3,0,11
10518,citta,citta,282,223,59,0,5
10519,nissayabhūto,nissayabhuto,7,7,0,0,12
10520,M0.0170,M0.0170,69,69,0,0,7
10521,rūpakāyopi,rupakayopi,19,16,3,0,10
10522,arahattamaggañāṇādīnaṃ,arahattamaggananadinam,1,1,0,0,22
10523,ādhārabhūto,adharabhuto,12,10,2,0,11
10524,nāmapaññattivohārena,namapannattivoharena,1,1,0,0,20
10525,paṭisambhidāmaggaṭṭhakathāyaṃ,patisambhidamaggatthakathayam,6,4,2,0,29
10526,sabbesu,sabbesu,709,660,49,0,7
10527,appaṭihatañāṇa,appatihatanana,1,1,0,0,14
10528,nimittānuttaravimokkhādhigamaparibhāvitaṃ,nimittanuttaravimokkhadhigamaparibhavitam,1,1,0,0,41
10529,paṇṇattiko,pannattiko,6,6,0,0,10
10530,sabbaññutapadaṭṭhānaṃ,sabbannutapadatthanam,3,3,0,0,21
10531,saccābhisambodhimupādāya,saccabhisambodhimupadaya,4,4,0,0,24
10532,paramatthabhūte,paramatthabhute,1,1,0,0,15
10533,khandhasantāne,khandhasantane,12,12,0,0,14
10534,vohārasukhatthaṃ,voharasukhattham,7,7,0,0,16
10535,puggalādivohāro,puggaladivoharo,1,1,0,0,15
10536,āropito,aropito,83,74,9,0,7
10537,vohārappatto,voharappatto,1,1,0,0,12
10538,bodhiñāṇatthāya,bodhinanatthaya,3,3,0,0,15
10539,paṇidhānaṃ,panidhanam,64,64,0,0,10
10540,sattotveva,sattotveva,1,1,0,0,10
10541,saṅkhaṃ,sankham,665,626,39,0,7
10542,yato,yato,2953,2765,188,0,4
10543,vohāro,voharo,279,259,20,0,6
10544,bodhiñāṇaṃ,bodhinanam,7,7,0,0,10
10545,labhati,labhati,2373,2298,75,0,7
10546,paññattisaṅkhāto,pannattisankhato,2,2,0,0,16
10547,pitarā,pitara,269,263,6,0,6
10548,bhātarā,bhatara,79,79,0,0,7
10549,bhaginiyā,bhaginiya,103,102,1,0,9
10550,mittāmaccehi,mittamaccehi,27,27,0,0,12
10551,ñātisā,natisa,1,1,0,0,6
10552,lohitehi,lohitehi,2,2,0,0,8
10553,samaṇabrāhmaṇehi,samanabrahmanehi,40,40,0,0,16
10554,vimokkhantikametaṃ,vimokkhantikametam,27,27,0,0,18
10555,bhagavantānaṃ,bhagavantanam,135,132,3,0,13
10556,mūle,mule,383,362,21,0,4
10557,paṭilābhā,patilabha,40,38,2,0,9
10558,sacchikā,sacchika,81,74,7,0,8
10559,paṭṭhānanayena,patthananayena,9,9,0,0,14
10560,nānantarikanayena,nanantarikanayena,1,1,0,0,17
10561,ñāṇappadhāno,nanappadhano,2,2,0,0,12
10562,suvisuddhakhandhasantāno,suvisuddhakhandhasantano,1,1,0,0,24
10563,atthopi,atthopi,75,70,5,0,7
10564,yujjatevāti,yujjatevati,6,6,0,0,11
10565,nigrodhabimboti,nigrodhabimboti,1,0,1,0,15
10566,nigrodharukkhassa,nigrodharukkhassa,10,10,0,0,17
10567,parimaṇḍalasarīro,parimandalasariro,2,2,0,0,17
10568,adhobhāgaṃ,adhobhagam,14,13,1,0,10
10569,nigrodho,nigrodho,97,85,12,0,8
10570,vaṭarukkho,vatarukkho,10,9,1,0,10
10571,nipubbarudhadhātu,nipubbarudhadhatu,1,1,0,0,17
10572,usso,usso,7,7,0,0,4
10573,gāgamo,gagamo,1,1,0,0,6
10574,M0.0171,M0.0171,71,71,0,0,7
10575,bimbo,bimbo,4,4,0,0,5
10576,sarīro,sariro,10,10,0,0,6
10577,vamudhātu,vamudhatu,1,1,0,0,9
10578,nigrodhassa,nigrodhassa,27,27,0,0,11
10579,nigrodhaparimaṇḍalabimboti,nigrodhaparimandalabimboti,1,1,0,0,26
10580,parimaṇḍalasaddalope,parimandalasaddalope,1,1,0,0,20
10581,nevaṃ,nevam,16,15,1,0,5
10582,paṇṇāsahatthatāya,pannasahatthataya,2,2,0,0,17
10583,satahatthatāya,satahatthataya,3,3,0,0,14
10584,samakkhandhasākho,samakkhandhasakho,5,3,2,0,17
10585,dīghatopi,dighatopi,4,4,0,0,9
10586,vitthāratopi,vittharatopi,24,21,3,0,12
10587,ekappamāṇova,ekappamanova,5,5,0,0,12
10588,kāyatopi,kayatopi,6,6,0,0,8
10589,byāmatopi,byamatopi,3,3,0,0,9
10590,ekappamāṇo,ekappamano,3,3,0,0,10
10591,visamappamāṇoti,visamappamanoti,3,3,0,0,15
10592,yāvatakvāssa,yavatakvassa,2,2,0,0,12
10593,takvāssa,takvassa,2,2,0,0,8
10594,mudukaracaraṇoti,mudukaracaranoti,1,0,1,0,16
10595,saṇhahatthapādo,sanhahatthapado,3,3,0,0,15
10596,mudusaddo,mudusaddo,1,1,0,0,9
10597,saṇhasukhumavācako,sanhasukhumavacako,3,3,0,0,18
10598,mudeti,mudeti,2,2,0,0,6
10599,modayati,modayati,3,3,0,0,8
10600,modane,modane,3,3,0,0,6
10601,hāse,hase,33,24,9,0,4
10602,caraṇo,carano,12,12,0,0,6
10603,mudukaro,mudukaro,1,1,0,0,8
10604,sappi,sappi,203,181,22,0,5
10605,maṇḍe,mande,7,6,1,0,5
10606,osāritvā,osaritva,1,1,0,0,8
10607,satavāraṃ,satavaram,11,11,0,0,9
10608,vihatakappāsapaṭalaṃ,vihatakappasapatalam,1,1,0,0,20
10609,mudujātamattakumārassa,mudujatamattakumarassa,1,1,0,0,22
10610,niccakālaṃ,niccakalam,154,148,6,0,10
10611,muduhattha,muduhattha,1,1,0,0,10
10612,pādoti,padoti,40,32,8,0,6
10613,brahmaghoseṇijaṅghoti,brahmaghosenijanghoti,1,0,1,0,21
10614,brahmaghoso,brahmaghoso,8,8,0,0,11
10615,eṇijaṅghoti,enijanghoti,4,1,3,0,11
10616,brahmaghosoti,brahmaghosoti,1,1,0,0,13
10617,aṭṭhaṅga,atthanga,1,1,0,0,8
10618,sampannasaravantoti,sampannasaravantoti,1,1,0,0,19
10619,brūhati,bruhati,6,6,0,0,7
10620,vaḍḍhatītibrahmā,vaddhatitibrahma,1,1,0,0,16
10621,brūhadhātu,bruhadhatu,2,2,0,0,10
10622,ghusiyati,ghusiyati,3,3,0,0,9
10623,saddiyati,saddiyati,2,2,0,0,9
10624,ghusadhātu,ghusadhatu,2,2,0,0,10
10625,M0.0172,M0.0172,68,68,0,0,7
10626,mahābrahmuno,mahabrahmuno,60,56,4,0,12
10627,tathāgatenapi,tathagatenapi,1,1,0,0,13
10628,aṭṭhaṅgasamannāgatasaravantoti,atthangasamannagatasaravantoti,1,1,0,0,30
10629,eṇimigassa,enimigassa,8,7,1,0,10
10630,jaṅghā,jangha,46,45,1,0,6
10631,suvaṭṭajāṇuko,suvattajanuko,2,2,0,0,13
10632,eṇi,eni,1,1,0,0,3
10633,migo,migo,227,215,12,0,4
10634,kamanametāyāti,kamanametayati,1,1,0,0,14
10635,jaṅgho,jangho,7,6,1,0,6
10636,suvaṭṭo,suvatto,1,1,0,0,7
10637,maṃsussadena,mamsussadena,3,3,0,0,12
10638,paripuṇṇajaṅgho,paripunnajangho,5,5,0,0,15
10639,ekato,ekato,2154,2034,120,0,5
10640,bandhapiṇḍikamaṃso,bandhapindikamamso,1,1,0,0,18
10641,samasaṇṭhitena,samasanthitena,3,3,0,0,14
10642,maṃsena,mamsena,85,84,1,0,7
10643,parikkhittāhi,parikkhittahi,3,3,0,0,13
10644,suvaṭṭitāhi,suvattitahi,3,3,0,0,11
10645,sāli,sali,48,44,4,0,4
10646,gabbhayavagabbhasadisāhi,gabbhayavagabbhasadisahi,1,1,0,0,24
10647,jaṅghāhi,janghahi,10,10,0,0,8
10648,eṇimigajaṅghasadiso,enimigajanghasadiso,1,1,0,0,19
10649,suvaṭṭajāṇukoti,suvattajanukoti,1,1,0,0,15
10650,kosacchādaṅgajātoti,kosacchadangajatoti,1,0,1,0,19
10651,kosacchādaaṅgajātoti,kosacchadaangajatoti,1,1,0,0,20
10652,usabhavāraṇādīnaṃ,usabhavaranadinam,4,4,0,0,17
10653,aṅgajāto,angajato,3,3,0,0,8
10654,suvaṇṇapaduma,suvannapaduma,1,1,0,0,13
10655,kaṇṇikasadisena,kannikasadisena,1,1,0,0,15
10656,vatthakosena,vatthakosena,2,2,0,0,12
10657,paṭicchannena,paticchannena,15,14,1,0,13
10658,guyhaṅgajātena,guyhangajatena,2,2,0,0,14
10659,kusati,kusati,6,6,0,0,6
10660,koso,koso,77,67,10,0,4
10661,kusadhātu,kusadhatu,2,2,0,0,9
10662,chādiyatīti,chadiyatiti,2,2,0,0,11
10663,chādo,chado,3,3,0,0,5
10664,chadadhātu,chadadhatu,2,2,0,0,10
10665,paṭicchanne,paticchanne,122,113,9,0,11
10666,kosena,kosena,6,6,0,0,6
10667,kosacchādo,kosacchado,1,1,0,0,10
10668,aṅge,ange,61,55,6,0,4
10669,sarīrāvayave,sariravayave,11,11,0,0,12
10670,aṅgajātaṃ,angajatam,280,259,21,0,9
10671,kosacchādaṃ,kosacchadam,1,1,0,0,11
10672,byañjanaṃ,byanjanam,347,281,66,0,9
10673,suvaṇṇapadumakaṇṇi,suvannapadumakanni,1,1,0,0,18
10674,kasadisena,kasadisena,1,1,0,0,10
10675,kosohitavatthaguyhena,kosohitavatthaguyhena,1,1,0,0,21
10676,byañjanena,byanjanena,58,51,7,0,10
10677,kosacchādaṅgajātasampannoti,kosacchadangajatasampannoti,1,1,0,0,27
10678,punarapīti,punarapiti,1,0,1,0,10
10679,apīti,apiti,20,5,15,0,5
10680,rakārā,rakara,3,3,0,0,6
10681,M0.0173,M0.0173,70,70,0,0,7
10682,eso,eso,1788,1695,93,0,3
10683,atthantaratthe,atthantaratthe,2,2,0,0,14
10684,apisaddo,apisaddo,21,21,0,0,8
10685,suppatiṭṭhitapādoti,suppatitthitapadoti,5,1,4,0,19
10686,suvaṇṇapādukatalamiva,suvannapadukatalamiva,3,2,1,0,21
10687,patiṭṭhitapādo,patitthitapado,7,7,0,0,14
10688,patiṭṭhatīti,patitthatiti,2,2,0,0,12
10689,suppatiṭṭhito,suppatitthito,49,48,1,0,13
10690,su,su,1388,1252,136,0,2
10691,pati,pati,772,724,48,0,4
10692,pubbo,pubbo,339,324,15,0,5
10693,ṭhā,tha,60,17,43,0,3
10694,gatinivattiyaṃ,gatinivattiyam,17,14,3,0,14
10695,ṭhapentānaṃ,thapentanam,3,3,0,0,11
10696,aggatalaṃ,aggatalam,4,2,2,0,9
10697,paṇhiṃ,panhim,6,6,0,0,6
10698,phusati,phusati,306,293,13,0,7
10699,vemajjhaṃ,vemajjham,45,35,10,0,9
10700,ukkhipantānampi,ukkhipantanampi,2,2,0,0,15
10701,aggatalādīsu,aggataladisu,3,3,0,0,12
10702,ekakoṭṭhāsova,ekakotthasova,3,3,0,0,13
10703,uṭṭhahati,utthahati,137,136,1,0,9
10704,suvaṇṇapādukatalaṃ,suvannapadukatalam,3,2,1,0,18
10705,ekappahāreneva,ekappahareneva,176,171,5,0,14
10706,sakalapādatalaṃ,sakalapadatalam,2,2,0,0,15
10707,bhūmito,bhumito,166,151,15,0,7
10708,sacepi,sacepi,734,711,23,0,6
10709,anekasataporisaṃ,anekasataporisam,3,3,0,0,16
10710,narakaṃ,narakam,29,26,3,0,7
10711,akkamissāmīti,akkamissamiti,6,6,0,0,13
10712,nīharati,niharati,106,103,3,0,8
10713,ninnaṭṭhānaṃ,ninnatthanam,30,25,5,0,12
10714,vātapūritaṃ,vatapuritam,3,3,0,0,11
10715,kammārabhastaṃ,kammarabhastam,2,2,0,0,14
10716,unnamitvā,unnamitva,3,3,0,0,9
10717,pathavīsamaṃ,pathavisamam,5,4,1,0,12
10718,unnataṭṭhānampi,unnatatthanampi,3,3,0,0,15
10719,pavisati,pavisati,482,476,6,0,8
10720,dūre,dure,874,836,38,0,4
10721,abhinīharantassa,abhiniharantassa,3,3,0,0,16
10722,sineruppamāṇopi,sineruppamanopi,5,5,0,0,15
10723,seditavetthaṅkuro,seditavetthankuro,1,1,0,0,17
10724,namitvā,namitva,26,26,0,0,7
10725,pādasamīpaṃ,padasamipam,8,8,0,0,11
10726,āgacchati,agacchati,830,817,13,0,9
10727,yugandharapabbataṃ,yugandharapabbatam,7,5,2,0,18
10728,abhinīharato,abhiniharato,2,2,0,0,12
10729,akkamitvā,akkamitva,114,111,3,0,9
10730,dutiyapādena,dutiyapadena,7,7,0,0,12
10731,tāvatiṃsabhavanaṃ,tavatimsabhavanam,81,79,2,0,17
10732,akkami,akkami,41,41,0,0,6
10733,cakkalakkhaṇena,cakkalakkhanena,4,3,1,0,15
10734,patiṭṭhātabbaṭṭhānaṃ,patitthatabbatthanam,8,7,1,0,20
10735,visamaṃ,visamam,259,230,29,0,7
10736,bhavituṃ,bhavitum,465,437,28,0,8
10737,khāṇu,khanu,42,40,2,0,5
10738,kaṇḍako,kandako,35,32,3,0,7
10739,sakkharakathalā,sakkharakathala,2,2,0,0,15
10740,uccārapassāvo,uccarapassavo,18,17,1,0,13
10741,kheḷasiṅghaṇikādīni,khelasinghanikadini,1,1,0,0,19
10742,purimatarāva,purimatarava,2,2,0,0,12
10743,apagacchanti,apagacchanti,26,25,1,0,12
10744,tattheva,tattheva,2523,2430,93,0,8
10745,sīlatejena,silatejena,35,34,1,0,10
10746,paññātejena,pannatejena,4,4,0,0,11
10747,dhammatejena,dhammatejena,26,26,0,0,12
10748,ānubhāvena,anubhavena,340,340,0,0,10
10749,mahāpathavī,mahapathavi,248,245,3,0,11
10750,pupphākiṇṇā,pupphakinna,2,2,0,0,11
10751,nikkhipati,nikkhipati,115,115,0,0,10
10752,uddharati,uddharati,108,106,2,0,9
10753,sabbāvantehi,sabbavantehi,6,4,2,0,12
10754,pādatalehi,padatalehi,15,15,0,0,10
10755,M0.0174,M0.0174,69,69,0,0,7
10756,mūdo,mudo,2,1,1,0,4
10757,dātuṇṇalomoti,datunnalomoti,1,0,1,0,13
10758,muda,muda,17,5,12,0,4
10759,odāta,odata,1,1,0,0,5
10760,uṇṇalomoti,unnalomoti,1,1,0,0,10
10761,saṇhasukhumo,sanhasukhumo,5,5,0,0,12
10762,seto,seto,67,62,5,0,4
10763,uṇṇalomavantoti,unnalomavantoti,1,1,0,0,15
10764,mudasaddo,mudasaddo,1,1,0,0,9
10765,mudayati,mudayati,1,1,0,0,8
10766,mudo,mudo,7,7,0,0,4
10767,sukhumo,sukhumo,163,147,16,0,7
10768,avadāyati,avadayati,4,4,0,0,9
10769,khaṇḍiyatīti,khandiyatiti,1,1,0,0,12
10770,odāto,odato,61,58,3,0,5
10771,avakhaṇḍane,avakhandane,15,13,2,0,11
10772,mudodāto,mudodato,1,1,0,0,8
10773,lomo,lomo,12,12,0,0,4
10774,uṇṇasaddo,unnasaddo,1,1,0,0,9
10775,lomasaddapariyāyoti,lomasaddapariyayoti,1,1,0,0,19
10776,maṃsassa,mamsassa,25,25,0,0,8
10777,uṇadhātu,unadhatu,1,1,0,0,8
10778,maṃsacammāni,mamsacammani,4,4,0,0,12
10779,ludhātu,ludhatu,1,1,0,0,7
10780,chindane,chindane,4,4,0,0,8
10781,lunitabboti,lunitabboti,2,2,0,0,11
10782,uṇṇalomo,unnalomo,2,2,0,0,8
10783,lomaviseso,lomaviseso,1,1,0,0,10
10784,dāto,dato,6,6,0,0,4
10785,mudodātuṇṇa,mudodatunna,1,1,0,0,11
10786,uṇṇālomaṃ,unnalomam,3,3,0,0,9
10787,dvinnaṃ,dvinnam,2937,2775,162,0,7
10788,bhamukānaṃ,bhamukanam,3,3,0,0,10
10789,vemajjhe,vemajjhe,134,128,6,0,8
10790,nāsimatthakeyeva,nasimatthakeyeva,1,1,0,0,16
10791,nalāṭamajjhe,nalatamajjhe,1,1,0,0,12
10792,sappimaṇḍe,sappimande,12,11,1,0,10
10793,osāretvā,osaretva,38,34,4,0,8
10794,ṭhapitasata,thapitasata,1,1,0,0,11
10795,vitatakappāsapaṭalaṃ,vitatakappasapatalam,1,1,0,0,20
10796,mudaṃ,mudam,6,6,0,0,5
10797,parisuddhaosadhitārakavaṇṇaṃ,parisuddhaosadhitarakavannam,1,1,0,0,28
10798,sippalitūlalatātūlaṃ,sippalitulalatatulam,1,1,0,0,20
10799,vigatamalena,vigatamalena,1,1,0,0,12
10800,odātaṃ,odatam,133,125,8,0,6
10801,aññesanti,annesanti,24,24,0,0,9
10802,bhoto,bhoto,494,476,18,0,5
10803,tūlasannibhā,tulasannibha,2,2,0,0,12
10804,ākaḍḍhiyamānaṃ,akaddhiyamanam,4,4,0,0,14
10805,upaḍḍha,upaddha,1,1,0,0,7
10806,bāhuppamāṇaṃ,bahuppamanam,1,1,0,0,12
10807,dakkhiṇāvaṭṭavasena,dakkhinavattavasena,3,3,0,0,19
10808,āvaṭṭitvā,avattitva,4,4,0,0,9
10809,uddhaggā,uddhagga,10,10,0,0,8
10810,santiṭṭhati,santitthati,296,293,3,0,11
10811,suvaṇṇaphalakamajjhe,suvannaphalakamajjhe,3,3,0,0,20
10812,ṭhapitarajata,thapitarajata,1,1,0,0,13
10813,pupphuḷakaṃ,pupphulakam,2,2,0,0,11
10814,M0.0175,M0.0175,67,67,0,0,7
10815,suvaṇṇaghaṭato,suvannaghatato,9,9,0,0,14
10816,nikkhammamānaṃ,nikkhammamanam,1,1,0,0,14
10817,khīradhāraṃ,khiradharam,5,5,0,0,11
10818,aruṇappabhārañjite,arunappabharanjite,3,3,0,0,18
10819,osadhitārakaṃ,osadhitarakam,1,1,0,0,13
10820,atimanoharāya,atimanoharaya,3,3,0,0,13
10821,siriyā,siriya,131,121,10,0,6
10822,mūdodātuṇṇalomoti,mudodatunnalomoti,1,1,0,0,17
10823,athamapīti,athamapiti,1,0,1,0,10
10824,tadaññaṃ,tadannam,76,69,7,0,8
10825,sundaravācaṃ,sundaravacam,1,1,0,0,12
10826,brahmujuggattabhāvoti,brahmujuggattabhavoti,3,2,1,0,21
10827,brahmaujuuggataattabhāvoti,brahmaujuuggataattabhavoti,1,1,0,0,26
10828,uju,uju,88,78,10,0,3
10829,uggataattabhāvo,uggataattabhavo,2,2,0,0,15
10830,ujumeva,ujumeva,15,15,0,0,7
10831,dīghasarīroti,dighasariroti,1,1,0,0,13
10832,tipāṭho,tipatho,2,2,0,0,7
10833,brahmujugattoti,brahmujugattoti,6,1,5,0,15
10834,ujugatto,ujugatto,7,5,2,0,8
10835,uggatadīghasarīroti,uggatadighasariroti,1,1,0,0,19
10836,vivarati,vivarati,197,193,4,0,8
10837,uparūparibrūhati,uparuparibruhati,1,1,0,0,16
10838,avaṅkabhāvena,avankabhavena,1,1,0,0,13
10839,avaṅko,avanko,10,10,0,0,6
10840,jupaccayo,jupaccayo,2,2,0,0,9
10841,arissa,arissa,5,5,0,0,6
10842,uādeso,uadeso,3,3,0,0,6
10843,upubba,upubba,3,3,0,0,6
10844,āhito,ahito,50,47,3,0,5
10845,māno,mano,834,773,61,0,4
10846,ropane,ropane,12,12,0,0,6
10847,tupaccayo,tupaccayo,1,1,0,0,9
10848,sukhadukkhaṃ,sukhadukkham,317,302,15,0,12
10849,anubhavatīti,anubhavatiti,24,22,2,0,12
10850,anubhavane,anubhavane,7,7,0,0,10
10851,kaccāyanasaddasatthe,kaccayanasaddasatthe,1,0,1,0,20
10852,bhakkhatīti,bhakkhatiti,11,11,0,0,11
10853,adiyate,adiyate,2,2,0,0,7
10854,bhakkhiyateti,bhakkhiyateti,1,1,0,0,13
10855,ātumā,atuma,19,15,4,0,5
10856,khyādīhi,khyadihi,4,2,2,0,8
10857,manimaca,manimaca,1,1,0,0,8
10858,tovāti,tovati,1,1,0,0,6
10859,attāti,attati,376,290,86,0,6
10860,abhidhānaṃ,abhidhanam,42,42,0,0,10
10861,buddhi,buddhi,137,127,10,0,6
10862,anuṭīkāyaṃ,anutikayam,4,2,2,0,10
10863,soeva,soeva,13,13,0,0,5
10864,paraparikappito,paraparikappito,3,3,0,0,15
10865,niccoti,niccoti,16,9,7,0,7
10866,diṭṭhigatikehi,ditthigatikehi,24,24,0,0,14
10867,gahetabbākārena,gahetabbakarena,3,3,0,0,15
10868,M0.0176,M0.0176,68,68,0,0,7
10869,yebhuyyena,yebhuyyena,987,955,32,0,10
10870,kaṭiyaṃ,katiyam,42,42,0,0,7
10871,jāṇusūti,janusuti,1,1,0,0,8
10872,ṭhānesu,thanesu,1333,1303,30,0,7
10873,namanti,namanti,65,58,7,0,7
10874,thokaṃ,thokam,797,778,19,0,6
10875,namantā,namanta,12,12,0,0,7
10876,itaresu,itaresu,181,177,4,0,7
10877,dīghasarīrā,dighasarira,5,5,0,0,11
10878,paneke,paneke,108,104,4,0,6
10879,passā,passa,36,25,11,0,5
10880,vaṅkā,vanka,16,16,0,0,5
10881,eke,eke,929,877,52,0,3
10882,unnametvā,unnametva,2,2,0,0,9
10883,gaṇayantā,ganayanta,5,5,0,0,9
10884,caranti,caranti,597,563,34,0,7
10885,appamaṃsalohitā,appamamsalohita,10,10,0,0,15
10886,sūlasadisā,sulasadisa,5,5,0,0,10
10887,pavedhamānā,pavedhamana,16,16,0,0,11
10888,dīghappamāṇo,dighappamano,3,3,0,0,12
10889,devanagare,devanagare,19,18,1,0,10
10890,ussitasuvaṇṇa,ussitasuvanna,1,1,0,0,13
10891,nīlakkhīti,nilakkhiti,2,1,1,0,10
10892,nīlaakkhīti,nilaakkhiti,1,1,0,0,11
10893,atinīlanettena,atinilanettena,2,2,0,0,14
10894,ikkhati,ikkhati,20,20,0,0,7
10895,rūpārammaṇaṃ,ruparammanam,272,258,14,0,12
10896,akkhi,akkhi,56,53,3,0,5
10897,nettaṃ,nettam,37,32,5,0,6
10898,ikkhadhātu,ikkhadhatu,3,3,0,0,10
10899,dassane,dassane,142,130,12,0,7
10900,nīlā,nila,57,51,6,0,4
10901,atinīlā,atinila,1,1,0,0,7
10902,nettā,netta,34,30,4,0,5
10903,nīlakkhi,nilakkhi,2,2,0,0,8
10904,sakalanīlakkhiva,sakalanilakkhiva,1,1,0,0,16
10905,nīlayuttaṭṭhāne,nilayuttatthane,3,3,0,0,15
10906,ummārapupphasadisena,ummarapupphasadisena,1,1,0,0,20
10907,ativisuddhena,ativisuddhena,9,8,1,0,13
10908,nīlavaṇṇena,nilavannena,6,6,0,0,11
10909,samannāgatāni,samannagatani,6,6,0,0,13
10910,pītayuttaṭṭhāne,pitayuttatthane,3,3,0,0,15
10911,kaṇikārapupphasadisena,kanikarapupphasadisena,3,3,0,0,22
10912,lohitavaṇṇena,lohitavannena,5,5,0,0,13
10913,lohitayuttaṭṭhāne,lohitayuttatthane,3,3,0,0,17
10914,bandhujīvakapupphasadisena,bandhujivakapupphasadisena,3,3,0,0,26
10915,seta,seta,11,9,2,0,4
10916,osadhitārakasadisena,osadhitarakasadisena,3,3,0,0,20
10917,setavaṇṇena,setavannena,4,4,0,0,11
10918,kāḷa,kala,20,18,2,0,4
10919,addāriṭṭhakasadisena,addaritthakasadisena,3,3,0,0,20
10920,kāḷavaṇṇena,kalavannena,7,7,0,0,11
10921,suvaṇṇavimāne,suvannavimane,8,8,0,0,13
10922,ugghāṭitamaṇisīhapañjarasadisāni,ugghatitamanisihapanjarasadisani,3,3,0,0,32
10923,khāyanti,khayanti,43,43,0,0,8
10924,maṃsacakkhumhi,mamsacakkhumhi,4,3,1,0,14
10925,pañcavaṇṇā,pancavanna,33,28,5,0,10
10926,saṃvijjanti,samvijjanti,181,176,5,0,11
10927,nīlo,nilo,44,41,3,0,4
10928,pītako,pitako,6,5,1,0,6
10929,lohitako,lohitako,29,27,2,0,8
10930,kaṇho,kanho,140,120,20,0,5
10931,akkhilomāni,akkhilomani,8,7,1,0,11
10932,patiṭṭhitāni,patitthitani,26,26,0,0,12
10933,nīlaṃ,nilam,217,194,23,0,5
10934,sunīlaṃ,sunilam,12,10,2,0,7
10935,pāsādikaṃ,pasadikam,139,123,16,0,9
10936,dassaneyyaṃ,dassaneyyam,47,42,5,0,11
10937,ummārapupphasamānaṃ,ummarapupphasamanam,3,3,0,0,19
10938,parato,parato,1164,1102,62,0,6
10939,pītakaṃ,pitakam,83,76,7,0,7
10940,M0.0177,M0.0177,66,66,0,0,7
10941,supītakaṃ,supitakam,7,6,1,0,9
10942,kaṇikārapupphasamānaṃ,kanikarapupphasamanam,5,5,0,0,21
10943,ubhato,ubhato,395,369,26,0,6
10944,akkhikuṭāni,akkhikutani,1,1,0,0,11
10945,lohitakāni,lohitakani,34,33,1,0,10
10946,sulohikāni,sulohikani,1,1,0,0,10
10947,pāsādikāni,pasadikani,9,8,1,0,10
10948,dassaneyyāni,dassaneyyani,5,5,0,0,12
10949,indagopakasamānāni,indagopakasamanani,4,4,0,0,18
10950,kaṇhaṃ,kanham,153,121,32,0,6
10951,sukaṇhaṃ,sukanham,5,4,1,0,8
10952,alūkhaṃ,alukham,5,4,1,0,7
10953,addāriṭṭhaka,addaritthaka,1,1,0,0,12
10954,samānaṃ,samanam,447,435,12,0,7
10955,suodātaṃ,suodatam,7,6,1,0,8
10956,setaṃ,setam,98,90,8,0,5
10957,osadhitārakasamānaṃ,osadhitarakasamanam,5,5,0,0,19
10958,maṃsacakkhunā,mamsacakkhuna,58,54,4,0,13
10959,caturaṅgasamannāgate,caturangasamannagate,16,16,0,0,20
10960,andhakārepi,andhakarepi,3,3,0,0,11
10961,yojanaṃ,yojanam,304,292,12,0,7
10962,rattiñca,rattinca,57,55,2,0,8
10963,pākatikena,pakatikena,13,12,1,0,10
10964,attabhāva,attabhava,3,3,0,0,9
10965,pariyāpannena,pariyapannena,2,2,0,0,13
10966,purimasucaritakammābhinibbattena,purimasucaritakammabhinibbattena,4,4,0,0,32
10967,yadāpi,yadapi,13,12,1,0,6
10968,caturaṅgasamannāgato,caturangasamannagato,12,12,0,0,20
10969,atthaṅgamito,atthangamito,4,4,0,0,12
10970,kāḷapakkho,kalapakkho,11,10,1,0,10
10971,uposatho,uposatho,505,453,52,0,8
10972,tibbo,tibbo,61,58,3,0,5
10973,vanasaṇḍo,vanasando,53,49,4,0,9
10974,kāḷamegho,kalamegho,6,5,1,0,9
10975,abbhuṭṭhito,abbhutthito,5,5,0,0,11
10976,evarūpepi,evarupepi,23,23,0,0,9
10977,andhakāre,andhakare,224,218,6,0,9
10978,kuṭṭo,kutto,15,12,3,0,5
10979,kavāṭaṃ,kavatam,99,95,4,0,7
10980,pākāro,pakaro,40,30,10,0,6
10981,gaccho,gaccho,21,20,1,0,6
10982,latā,lata,158,147,11,0,4
10983,āvaraṇaṃ,avaranam,183,156,27,0,8
10984,rūpānaṃ,rupanam,1900,1872,28,0,7
10985,dassanāyā,dassanaya,38,37,1,0,9
10986,upalakkhaṇanayena,upalakkhananayena,3,3,0,0,17
10987,dīghapaṇhīti,dighapanhiti,2,1,1,0,12
10988,paripuṇṇapaṇhīti,paripunnapanhiti,3,3,0,0,16
10989,pasati,pasati,9,9,0,0,6
10990,bādhati,badhati,93,91,2,0,7
10991,paresanti,paresanti,6,5,1,0,9
10992,paṇhi,panhi,16,16,0,0,5
10993,pādassa,padassa,73,70,3,0,7
10994,pacchābhāgo,pacchabhago,8,8,0,0,11
10995,pasadhātu,pasadhatu,1,1,0,0,9
10996,bādhane,badhane,2,1,1,0,7
10997,sassa,sassa,184,170,14,0,5
10998,paṇa,pana,13,2,11,0,4
10999,byavahārathutīsu,byavaharathutisu,4,4,0,0,16
11000,paṇiyati,paniyati,1,1,0,0,8
11001,vohāriyatīti,vohariyatiti,1,1,0,0,12
11002,dīghā,digha,151,137,14,0,5
11003,dīghapaṇhi,dighapanhi,4,4,0,0,10
11004,paṇhimatthake,panhimatthake,3,3,0,0,13
11005,M0.0178,M0.0178,70,70,0,0,7
11006,tacchetvā,tacchetva,67,65,2,0,9
11007,ṭhapitā,thapita,392,384,8,0,7
11008,koṭṭhāsesu,kotthasesu,103,101,2,0,10
11009,aggapādā,aggapada,3,3,0,0,8
11010,tatiye,tatiye,774,753,21,0,6
11011,catutthe,catutthe,678,650,28,0,8
11012,āraggena,araggena,18,17,1,0,8
11013,vaṭṭetvā,vattetva,100,98,2,0,8
11014,rattakambale,rattakambale,8,8,0,0,12
11015,geṇḍukasadisā,gendukasadisa,2,2,0,0,13
11016,sukhumamalachavīti,sukhumamalachaviti,1,0,1,0,18
11017,sukhuma,sukhuma,8,7,1,0,7
11018,amala,amala,1,1,0,0,5
11019,chavīti,chaviti,4,4,0,0,7
11020,saṇhamalavisuddhataco,sanhamalavisuddhataco,2,2,0,0,21
11021,saṇhamalavirahitataco,sanhamalavirahitataco,1,1,0,0,21
11022,sukhumasaddo,sukhumasaddo,1,1,0,0,12
11023,saṇhavācako,sanhavacako,1,1,0,0,11
11024,sukhayati,sukhayati,10,8,2,0,9
11025,saṇhabhāvenāti,sanhabhavenati,1,1,0,0,14
11026,sukhumaṃ,sukhumam,318,289,29,0,8
11027,saṇhaṃ,sanham,85,77,8,0,6
11028,sukhadhātu,sukhadhatu,12,10,2,0,10
11029,takkariyaṃ,takkariyam,1,1,0,0,10
11030,umapaccayo,umapaccayo,1,1,0,0,10
11031,kiliṭṭhaṃ,kilittham,63,54,9,0,9
11032,rajādimalaṃ,rajadimalam,1,1,0,0,11
11033,malametissāti,malametissati,1,1,0,0,13
11034,amalā,amala,3,3,0,0,5
11035,chavī,chavi,3,3,0,0,5
11036,maṃsaṃ,mamsam,739,702,37,0,6
11037,chādetīti,chadetiti,23,22,1,0,9
11038,chada,chada,16,3,13,0,5
11039,saṃvaraṇe,samvarane,77,66,11,0,9
11040,ravapaccayo,ravapaccayo,1,1,0,0,11
11041,sukhumā,sukhuma,303,290,13,0,7
11042,saṇhā,sanha,24,21,3,0,5
11043,malavirahitā,malavirahita,1,1,0,0,12
11044,suvaṇṇasiniddhasaṇhasarīrattā,suvannasiniddhasanhasariratta,1,1,0,0,29
11045,kañcanasannibha,kancanasannibha,1,1,0,0,15
11046,tacattā,tacatta,1,1,0,0,7
11047,rūpakāye,rupakaye,61,55,6,0,8
11048,padumapalāse,padumapalase,11,11,0,0,12
11049,udakabindhu,udakabindhu,2,2,0,0,11
11050,limpati,limpati,122,114,8,0,7
11051,majjhimapaṇṇāse,majjhimapannase,1,1,0,0,15
11052,upalimpatī,upalimpati,1,1,0,0,10
11053,malachavīti,malachaviti,1,1,0,0,11
11054,thomyarasaggasaggīti,thomyarasaggasaggiti,2,1,1,0,20
11055,thomyarasa,thomyarasa,1,1,0,0,10
11056,gasa,gasa,7,2,5,0,4
11057,aggīti,aggiti,11,4,7,0,6
11058,thomitabba,thomitabba,1,1,0,0,10
11059,rasaharaṇasattasahassanhārū,rasaharanasattasahassanharu,1,1,0,0,27
11060,uddhaggikāti,uddhaggikati,1,1,0,0,12
11061,thomiyatīti,thomiyatiti,1,1,0,0,11
11062,thomyo,thomyo,2,2,0,0,6
11063,thomadhātu,thomadhatu,1,1,0,0,10
11064,sīlāghāyaṃ,silaghayam,1,1,0,0,10
11065,madhurādibhedaṃ,madhuradibhedam,4,4,0,0,15
11066,rasaṃ,rasam,404,372,32,0,5
11067,gasenti,gasenti,1,1,0,0,7
11068,pavesentīti,pavesentiti,2,2,0,0,11
11069,rasaggasā,rasaggasa,11,9,2,0,9
11070,rasasaddūpapadagasadhātu,rasasaddupapadagasadhatu,1,1,0,0,24
11071,adane,adane,48,42,6,0,5
11072,gasati,gasati,3,3,0,0,6
11073,M0.0179,M0.0179,69,69,0,0,7
11074,gasadhātu,gasadhatu,1,1,0,0,9
11075,dhātusaddo,dhatusaddo,20,19,1,0,10
11076,rasaggasānaṃ,rasaggasanam,4,4,0,0,12
11077,aggāti,aggati,33,28,5,0,6
11078,rasaggasaggā,rasaggasagga,4,3,1,0,12
11079,rasaggasaggī,rasaggasaggi,14,12,2,0,12
11080,sattarasaharaṇisahassāni,sattarasaharanisahassani,4,4,0,0,24
11081,gīvāyameva,givayameva,7,7,0,0,10
11082,paṭimukkāni,patimukkani,8,8,0,0,11
11083,tilaphalamattopi,tilaphalamattopi,4,4,0,0,16
11084,āhāro,aharo,914,822,92,0,5
11085,jivhagge,jivhagge,30,30,0,0,8
11086,ṭhapito,thapito,330,322,8,0,7
11087,anupharati,anupharati,3,3,0,0,10
11088,mahāpadhānaṃ,mahapadhanam,46,43,3,0,12
11089,padahantassa,padahantassa,17,17,0,0,12
11090,ekataṇḍulādīhipi,ekatanduladihipi,3,3,0,0,16
11091,kaḷāyayūsapasatenapi,kalayayusapasatenapi,1,1,0,0,20
11092,yāpanaṃ,yapanam,38,36,2,0,7
11093,sakalakāyaṃ,sakalakayam,5,5,0,0,11
11094,ojā,oja,103,96,7,0,3
11095,bahvābādhā,bahvabadha,17,14,3,0,10
11096,appābādhatāsaṅkhātassa,appabadhatasankhatassa,2,2,0,0,22
11097,nissandaphalassavasena,nissandaphalassavasena,1,1,0,0,22
11098,tevīsatimavandanagāthāvaṇṇanā,tevisatimavandanagathavannana,1,1,0,0,29
11099,pañcamārajitavā,pancamarajitava,4,4,0,0,15
11100,samacattālīsaggadantotyādīhi,samacattalisaggadantotyadihi,1,1,0,0,28
11101,padehi,padehi,668,654,14,0,6
11102,cattālīsaggadantoti,cattalisaggadantoti,2,1,1,0,19
11103,cattālīsaaggadantoti,cattalisaaggadantoti,1,1,0,0,20
11104,samacattālīsa,samacattalisa,8,7,1,0,13
11105,uttamadantoti,uttamadantoti,1,1,0,0,13
11106,danto,danto,207,190,17,0,5
11107,daṃsati,damsati,8,8,0,0,7
11108,vidaṃsati,vidamsati,4,4,0,0,9
11109,bhojjamanenāti,bhojjamanenati,2,2,0,0,14
11110,daṃsadhātu,damsadhatu,3,3,0,0,10
11111,daṃsane,damsane,10,7,3,0,7
11112,nto,nto,69,56,13,0,3
11113,samacattālīsaṃ,samacattalisam,1,1,0,0,14
11114,uparimahanuke,uparimahanuke,2,2,0,0,13
11115,patiṭṭhitā,patitthita,348,337,11,0,10
11116,dantā,danta,221,213,8,0,5
11117,vīsati,visati,600,573,27,0,6
11118,heṭṭhime,hetthime,15,15,0,0,8
11119,vīsatīti,visatiti,16,15,1,0,8
11120,samacattālīsadantā,samacattalisadanta,1,1,0,0,18
11121,aññesañhi,annesanhi,28,28,0,0,9
11122,paripuṇṇadantānampi,paripunnadantanampi,4,4,0,0,19
11123,dvattiṃsadantā,dvattimsadanta,3,3,0,0,14
11124,cattālīsaṃ,cattalisam,67,63,4,0,10
11125,samakalapanajoti,samakalapanajoti,2,1,1,0,16
11126,M0.0180,M0.0180,69,69,0,0,7
11127,kakacena,kakacena,29,29,0,0,8
11128,samadantoti,samadantoti,1,1,0,0,11
11129,lapati,lapati,35,33,2,0,6
11130,vadati,vadati,3419,3328,91,0,6
11131,lapanaṃ,lapanam,33,30,3,0,7
11132,lapadhātu,lapadhatu,1,1,0,0,9
11133,vadane,vadane,6,5,1,0,6
11134,lapane,lapane,7,7,0,0,6
11135,mukhe,mukhe,446,428,18,0,5
11136,lapanajo,lapanajo,4,3,1,0,8
11137,samako,samako,36,32,4,0,6
11138,ayamevattho,ayamevattho,117,107,10,0,11
11139,uccā,ucca,73,67,6,0,4
11140,nīcāti,nicati,4,3,1,0,6
11141,visamā,visama,45,39,6,0,6
11142,ayapaṭṭachinnasaṅkhapaṭalaṃ,ayapattachinnasankhapatalam,3,2,1,0,27
11143,antaraṃsappapīnoti,antaramsappapinoti,2,1,1,0,18
11144,antaraaṃsapīnoti,antaraamsapinoti,1,1,0,0,16
11145,gāthābandhavasena,gathabandhavasena,94,93,1,0,17
11146,pakārāgamaṃ,pakaragamam,1,1,0,0,11
11147,aṃsānaṃ,amsanam,4,4,0,0,7
11148,antaraṃ,antaram,281,255,26,0,7
11149,paripuṇṇapiṭṭhitaloti,paripunnapitthitaloti,1,1,0,0,21
11150,aṃsasaddo,amsasaddo,2,2,0,0,9
11151,khandhatthe,khandhatthe,2,2,0,0,11
11152,aṃso,amso,21,19,2,0,4
11153,nitthi,nitthi,5,5,0,0,6
11154,bhujasiro,bhujasiro,4,3,1,0,9
11155,khandho,khandho,991,968,23,0,7
11156,tassandhi,tassandhi,3,2,1,0,9
11157,jattu,jattu,6,4,2,0,5
11158,anati,anati,9,9,0,0,5
11159,sopaccayo,sopaccayo,6,6,0,0,9
11160,avayavabhāvena,avayavabhavena,10,10,0,0,14
11161,vemajjhanti,vemajjhanti,1,1,0,0,11
11162,antaraṃso,antaramso,2,2,0,0,9
11163,piṇati,pinati,1,1,0,0,6
11164,pūratīti,puratiti,10,5,5,0,8
11165,pīno,pino,12,12,0,0,4
11166,piṭṭhitalaṃ,pitthitalam,2,2,0,0,11
11167,piṇadhātu,pinadhatu,1,1,0,0,9
11168,pinane,pinane,1,1,0,0,6
11169,ṇassa,nassa,7,7,0,0,5
11170,pīnaṃ,pinam,3,3,0,0,5
11171,uttarapadalopabahubbīhisamāsoyaṃ,uttarapadalopabahubbihisamasoyam,1,1,0,0,32
11172,ninnaṃ,ninnam,79,74,5,0,6
11173,piṭṭhikoṭṭā,pitthikotta,3,3,0,0,11
11174,pāṭiekkaṃ,patiekkam,9,9,0,0,9
11175,paññāyanti,pannayanti,212,209,3,0,10
11176,kaṭito,katito,30,29,1,0,6
11177,maṃsapaṭalaṃ,mamsapatalam,6,6,0,0,12
11178,uggamma,uggamma,9,9,0,0,7
11179,samussitasuvaṇṇaphalakaṃ,samussitasuvannaphalakam,3,3,0,0,24
11180,piṭṭhiṃ,pitthim,167,163,4,0,7
11181,chādetvā,chadetva,115,115,0,0,8
11182,patiṭṭhitaṃ,patitthitam,321,294,27,0,11
11183,citantaraṃ,citantaram,1,1,0,0,10
11184,M0.0181,M0.0181,69,69,0,0,7
11185,antaraṃsaṃ,antaramsam,4,4,0,0,10
11186,koṭṭānamantaraṃ,kottanamantaram,3,2,1,0,15
11187,paripuṇṇa,paripunna,13,13,0,0,9
11188,massāti,massati,9,8,1,0,7
11189,cakkenaṅkitapādoti,cakkenankitapadoti,2,1,1,0,18
11190,cakkena,cakkena,38,37,1,0,7
11191,aṅkitapādoti,ankitapadoti,1,1,0,0,12
11192,aṭṭhasatapādacakkalakkhaṇena,atthasatapadacakkalakkhanena,2,2,0,0,28
11193,lakkhitapādataloti,lakkhitapadataloti,1,1,0,0,18
11194,aṭṭhasatapādacakkena,atthasatapadacakkena,1,1,0,0,20
11195,aṅkito,ankito,1,1,0,0,6
11196,aṭṭhasatapādacakka,atthasatapadacakka,1,1,0,0,18
11197,pādataleeva,padataleeva,1,1,0,0,11
11198,sabbākāraparipūrānī,sabbakaraparipurani,2,2,0,0,19
11199,aṭṭhasatapādacakkalakkhaṇasarūpaṃ,atthasatapadacakkalakkhanasarupam,1,1,0,0,33
11200,pādapaṅkajamuduttalarā,padapankajamuduttalara,1,1,0,0,22
11201,jikehīti,jikehiti,1,1,0,0,8
11202,gāthāvaṇṇanāyaṃ,gathavannanayam,9,9,0,0,15
11203,vuttamevāti,vuttamevati,75,60,15,0,11
11204,aviraḷadasanoti,aviraladasanoti,2,1,1,0,15
11205,avivaradanto,avivaradanto,1,1,0,0,12
11206,avivaradantena,avivaradantena,2,2,0,0,14
11207,phullatīti,phullatiti,2,2,0,0,10
11208,viraḷo,viralo,5,5,0,0,6
11209,phullaneḷo,phullanelo,1,1,0,0,10
11210,aviraḷo,aviralo,4,4,0,0,7
11211,khādanīyaṃ,khadaniyam,472,433,39,0,10
11212,bhojanīyaṃ,bhojaniyam,340,307,33,0,10
11213,dasano,dasano,4,4,0,0,6
11214,niggahitalopo,niggahitalopo,4,4,0,0,13
11215,kumbhilānaṃ,kumbhilanam,4,4,0,0,11
11216,viraḷā,virala,6,6,0,0,6
11217,macchamaṃsādīni,macchamamsadini,12,12,0,0,15
11218,khādantānaṃ,khadantanam,8,8,0,0,11
11219,dantantaraṃ,dantantaram,3,3,0,0,11
11220,pūrati,purati,127,124,3,0,6
11221,kanakalatāya,kanakalataya,2,2,0,0,12
11222,samussāpitavajira,samussapitavajira,1,1,0,0,17
11223,panti,panti,21,19,2,0,5
11224,aviraḷā,avirala,7,7,0,0,7
11225,tulikāya,tulikaya,7,6,1,0,8
11226,dassitaparicchedā,dassitapariccheda,3,3,0,0,17
11227,mārajussaṅkhapādoti,marajussankhapadoti,1,0,1,0,19
11228,māraji,maraji,11,10,1,0,6
11229,ussaṅkhapādoti,ussankhapadoti,3,3,0,0,14
11230,mārajīti,marajiti,2,2,0,0,8
11231,M0.0182,M0.0182,71,71,0,0,7
11232,jitavāti,jitavati,10,10,0,0,8
11233,ṭhitena,thitena,276,261,15,0,7
11234,saṅkhasadisattā,sankhasadisatta,2,2,0,0,15
11235,saṅkhanāmikena,sankhanamikena,2,2,0,0,14
11236,gopphakena,gopphakena,13,13,0,0,10
11237,saṃsuṭṭhuṃ,samsutthum,2,2,0,0,10
11238,saṃpubbakhanudhātu,sampubbakhanudhatu,1,1,0,0,18
11239,khādanto,khadanto,135,134,1,0,8
11240,khaṇanto,khananto,19,17,2,0,8
11241,samuddajalapariyante,samuddajalapariyante,2,2,0,0,20
11242,caramāno,caramano,384,381,3,0,8
11243,gopphako,gopphako,2,2,0,0,8
11244,saṅkhasadisaṃ,sankhasadisam,1,1,0,0,13
11245,gopphaka,gopphaka,1,1,0,0,8
11246,brahmāyusuttaṭṭhakathāyaṃ,brahmayusuttatthakathayam,4,0,4,0,25
11247,patiṭṭhitagopphakattā,patitthitagopphakatta,3,3,0,0,21
11248,ussaṅkhā,ussankha,5,3,2,0,8
11249,piṭṭhipāde,pitthipade,13,13,0,0,10
11250,gopphakā,gopphaka,21,20,1,0,8
11251,āṇibaddhā,anibaddha,3,3,0,0,9
11252,yathāsukhaṃ,yathasukham,310,291,19,0,11
11253,parivattanti,parivattanti,68,66,2,0,12
11254,gacchantānaṃ,gacchantanam,86,81,5,0,12
11255,pādatalāni,padatalani,21,20,1,0,10
11256,tenassa,tenassa,455,450,5,0,7
11257,uparimakāyo,uparimakayo,24,24,0,0,11
11258,ṭhapita,thapita,5,5,0,0,7
11259,suvaṇṇapaṭimā,suvannapatima,18,18,0,0,13
11260,niccalo,niccalo,65,63,2,0,7
11261,adhokāyova,adhokayova,6,5,1,0,10
11262,iñjati,injati,89,86,3,0,6
11263,sukhena,sukhena,625,602,23,0,7
11264,puratopi,puratopi,64,62,2,0,8
11265,ubhayapassesupi,ubhayapassesupi,5,5,0,0,15
11266,passantānaṃ,passantanam,179,175,4,0,11
11267,hatthīnaṃ,hatthinam,102,99,3,0,9
11268,pacchatoyevāti,pacchatoyevati,2,2,0,0,14
11269,jaṇṇukānāma,jannukanama,1,0,1,0,11
11270,namanto,namanto,4,4,0,0,7
11271,ubhaya,ubhaya,24,13,11,0,6
11272,karamudunā,karamuduna,1,1,0,0,10
11273,jaṇṇukāni,jannukani,21,21,0,0,9
11274,āmasantoti,amasantoti,4,2,2,0,10
11275,tiṭṭhantoti,titthantoti,2,0,2,0,11
11276,nonamantoti,nonamantoti,2,1,1,0,11
11277,anamamāno,anamamano,2,2,0,0,9
11278,karamudunāti,karamudunati,1,0,1,0,12
11279,sukhumena,sukhumena,26,26,0,0,9
11280,hatthadvayena,hatthadvayena,4,4,0,0,13
11281,jaṇṇukānīti,jannukaniti,1,0,1,0,11
11282,jaṅghāni,janghani,2,2,0,0,8
11283,gamanāgamanaṃ,gamanagamanam,28,22,6,0,13
11284,jaṇṇu,jannu,7,6,1,0,5
11285,ṇu,nu,43,26,17,0,2
11286,jaṇṇukā,jannuka,5,5,0,0,7
11287,jaṅghorūnaṃ,janghorunam,3,3,0,0,11
11288,sandhi,sandhi,154,139,15,0,6
11289,parimajjituṃ,parimajjitum,5,5,0,0,12
11290,sakkonto,sakkonto,34,33,1,0,8
11291,akhujjaavāmanabhāvo,akhujjaavamanabhavo,3,3,0,0,19
11292,dīpito,dipito,171,165,6,0,6
11293,M0.0183,M0.0183,71,71,0,0,7
11294,avasesajanā,avasesajana,4,4,0,0,11
11295,khujjā,khujja,43,40,3,0,6
11296,vāmanā,vamana,10,8,2,0,6
11297,khujjānaṃ,khujjanam,3,3,0,0,9
11298,aparipuṇṇo,aparipunno,32,30,2,0,10
11299,vāmanānaṃ,vamananam,3,3,0,0,9
11300,heṭṭhimakāyo,hetthimakayo,19,19,0,0,12
11301,aparipuṇṇakāyattā,aparipunnakayatta,3,3,0,0,17
11302,sakkonti,sakkonti,627,611,16,0,8
11303,nonamanto,nonamanto,2,2,0,0,9
11304,paripuṇṇaubhayakāyattā,paripunnaubhayakayatta,3,3,0,0,22
11305,nāmasantoti,namasantoti,1,1,0,0,11
11306,vaṭṭakkhandhoti,vattakkhandhoti,2,1,1,0,15
11307,suvaṇṇāliṅgo,suvannalingo,2,2,0,0,12
11308,samavaṭṭitagaliko,samavattitagaliko,2,2,0,0,17
11309,parimaṇḍalā,parimandala,11,10,1,0,11
11310,vaṭṭo,vatto,10,9,1,0,5
11311,vaṭṭadhātu,vattadhatu,1,1,0,0,10
11312,vaṭṭane,vattane,4,4,0,0,7
11313,bhojanaṃ,bhojanam,998,943,55,0,8
11314,khādati,khadati,311,311,0,0,7
11315,galenāti,galenati,1,1,0,0,8
11316,galo,galo,13,12,1,0,4
11317,khādadhātu,khadadhatu,1,1,0,0,10
11318,khādane,khadane,12,12,0,0,7
11319,bhakkhane,bhakkhane,18,17,1,0,9
11320,kvipaccayo,kvipaccayo,2,2,0,0,10
11321,khādāmagamānaṃ,khadamagamanam,7,5,2,0,14
11322,khandhandhagandhāti,khandhandhagandhati,1,1,0,0,19
11323,matthakaṃ,matthakam,436,417,19,0,9
11324,dadhātīti,dadhatiti,6,6,0,0,9
11325,kandho,kandho,2,2,0,0,6
11326,kakārassa,kakarassa,35,35,0,0,9
11327,khakārakaraṇavasenā,khakarakaranavasena,1,1,0,0,19
11328,samaparimaṇḍalo,samaparimandalo,1,1,0,0,15
11329,koñcā,konca,46,41,5,0,5
11330,bakā,baka,18,18,0,0,4
11331,varāhā,varaha,24,24,0,0,6
11332,dīghagalā,dighagala,5,5,0,0,9
11333,vaṅkagalā,vankagala,5,5,0,0,9
11334,puthugalā,puthugala,1,1,0,0,9
11335,kathanakāle,kathanakale,17,17,0,0,11
11336,sirājalaṃ,sirajalam,2,2,0,0,9
11337,paññāyati,pannayati,1369,1340,29,0,9
11338,mando,mando,198,171,27,0,5
11339,nikkhamati,nikkhamati,259,249,10,0,10
11340,suvaṭṭitasuvaṇṇāliṅgasadiso,suvattitasuvannalingasadiso,2,2,0,0,27
11341,meghassa,meghassa,31,30,1,0,8
11342,gajjato,gajjato,13,12,1,0,7
11343,gotaruṇapakhumakotyādīhi,gotarunapakhumakotyadihi,1,1,0,0,24
11344,gotaruṇapakhumakoti,gotarunapakhumakoti,2,1,1,0,19
11345,taṃmuhuttajātaratta,tammuhuttajataratta,1,1,0,0,19
11346,vacchassa,vacchassa,24,22,2,0,9
11347,cakkhubhaṇḍo,cakkhubhando,2,2,0,0,12
11348,vippasannacakkhubhaṇḍo,vippasannacakkhubhando,2,2,0,0,22
11349,vippasannacakkhubhaṇḍena,vippasannacakkhubhandena,2,2,0,0,24
11350,pakhumakoti,pakhumakoti,1,1,0,0,11
11351,sakalaṃ,sakalam,537,495,42,0,7
11352,cakkhubhaṇḍaṃ,cakkhubhandam,4,2,2,0,13
11353,cakkhubhaṇḍanti,cakkhubhandanti,2,2,0,0,15
11354,cakkhuparivāraṃ,cakkhuparivaram,1,1,0,0,15
11355,akkhidalanti,akkhidalanti,2,2,0,0,12
11356,akkhidalapattanti,akkhidalapattanti,2,2,0,0,17
11357,akkhidale,akkhidale,1,1,0,0,9
11358,M0.0184,M0.0184,68,68,0,0,7
11359,akkhibimbanti,akkhibimbanti,3,3,0,0,13
11360,parivāreti,parivareti,8,8,0,0,10
11361,pakhumaṃ,pakhumam,11,8,3,0,8
11362,pamhādiparivāraṃ,pamhadiparivaram,1,1,0,0,16
11363,patadhātu,patadhatu,2,2,0,0,9
11364,parivāre,parivare,174,107,67,0,8
11365,umo,umo,16,16,0,0,3
11366,takārassa,takarassa,71,71,0,0,9
11367,akkhino,akkhino,6,6,0,0,7
11368,pakkhadvaye,pakkhadvaye,4,4,0,0,11
11369,pamhaṃ,pamham,7,6,1,0,6
11370,jātataddhite,jatataddhite,1,1,0,0,12
11371,pakkhumanti,pakkhumanti,1,1,0,0,11
11372,kakāralopavasena,kakaralopavasena,1,1,0,0,16
11373,pakhumanti,pakhumanti,4,4,0,0,10
11374,pakhumaṃyeva,pakhumamyeva,1,1,0,0,12
11375,pakhumako,pakhumako,2,2,0,0,9
11376,gotaruṇassa,gotarunassa,2,2,0,0,11
11377,taṃmuhuttajātarattavacchassa,tammuhuttajatarattavacchassa,3,3,0,0,28
11378,pakhumasadisaṃ,pakhumasadisam,1,1,0,0,14
11379,vippasannacakkhubhaṇḍaṃ,vippasannacakkhubhandam,1,1,0,0,23
11380,akkhibhaṇḍo,akkhibhando,1,1,0,0,11
11381,hatthimūsikakākādīnaṃ,hatthimusikakakadinam,2,2,0,0,21
11382,akkhisadisehi,akkhisadisehi,3,3,0,0,13
11383,viniggatehi,viniggatehi,3,3,0,0,11
11384,gambhīrehipi,gambhirehipi,3,3,0,0,12
11385,akkhīhi,akkhihi,46,46,0,0,7
11386,samannāgatā,samannagata,916,905,11,0,11
11387,dhovitvā,dhovitva,498,489,9,0,8
11388,majjitvā,majjitva,20,20,0,0,8
11389,ṭhapitamaṇiguḷikā,thapitamanigulika,4,4,0,0,17
11390,mudusiniddhanīla,mudusiniddhanila,1,1,0,0,16
11391,sukhumapakhumācitāni,sukhumapakhumacitani,1,1,0,0,20
11392,sīhapubbaḍḍhakāyoti,sihapubbaddhakayoti,2,1,1,0,19
11393,sīhassa,sihassa,188,184,4,0,7
11394,pubbaḍḍhakāyo,pubbaddhakayo,2,2,0,0,13
11395,paripuṇṇakāyo,paripunnakayo,13,13,0,0,13
11396,vātātapādiparissayaṃ,vatatapadiparissayam,1,1,0,0,20
11397,sīho,siho,517,490,27,0,4
11398,khamane,khamane,4,4,0,0,7
11399,īkārāgamo,ikaragamo,6,6,0,0,9
11400,sūkaramahiṃsādayo,sukaramahimsadayo,2,2,0,0,17
11401,hanane,hanane,2,2,0,0,6
11402,hiṃsoti,himsoti,1,1,0,0,7
11403,akkharavipariyāyena,akkharavipariyayena,1,1,0,0,19
11404,sīhoti,sihoti,35,24,11,0,6
11405,sabbiriyāpathesu,sabbiriyapathesu,39,38,1,0,16
11406,daḷhavīriyattā,dalhaviriyatta,2,2,0,0,14
11407,vāyamatīti,vayamatiti,33,18,15,0,10
11408,kesarasīho,kesarasiho,28,25,3,0,10
11409,īhadhātu,ihadhatu,2,2,0,0,8
11410,sahahiṃsa,sahahimsa,1,1,0,0,9
11411,īhāvasā,ihavasa,1,1,0,0,7
11412,sīhasaddagatiṃ,sihasaddagatim,1,1,0,0,14
11413,vade,vade,129,123,6,0,4
11414,pubbaḍḍhe,pubbaddhe,2,2,0,0,9
11415,pubbaḍḍhakāyova,pubbaddhakayova,1,1,0,0,15
11416,paripuṇṇo,paripunno,186,182,4,0,9
11417,sabbaparipuṇṇoti,sabbaparipunnoti,1,1,0,0,16
11418,purimakāyova,purimakayova,1,1,0,0,12
11419,pacchima,pacchima,27,22,5,0,8
11420,M0.0185,M0.0185,70,70,0,0,7
11421,pubbaḍḍhakāyoiva,pubbaddhakayoiva,1,1,0,0,16
11422,sopi,sopi,1829,1780,49,0,4
11423,sīhasseva,sihasseva,11,11,0,0,9
11424,vinatunnatādivasena,vinatunnatadivasena,3,3,0,0,19
11425,dussaṇṭhita,dussanthita,1,1,0,0,11
11426,visaṇṭhito,visanthito,1,1,0,0,10
11427,dīghayuttaṭṭhāne,dighayuttatthane,2,2,0,0,16
11428,rassakisathūla,rassakisathula,1,1,0,0,14
11429,anuvaṭṭitayuttaṭṭhānesu,anuvattitayuttatthanesu,1,1,0,0,23
11430,tathāvidhova,tathavidhova,4,4,0,0,12
11431,manāpiye,manapiye,7,7,0,0,8
11432,kammavipāke,kammavipake,9,9,0,0,11
11433,paccupaṭṭhite,paccupatthite,42,42,0,0,13
11434,aṅgehi,angehi,606,595,11,0,6
11435,dīghehi,dighehi,8,8,0,0,7
11436,thūlāni,thulani,28,26,2,0,7
11437,saṇṭhahanti,santhahanti,28,28,0,0,11
11438,kisehi,kisehi,3,3,0,0,6
11439,kisāni,kisani,5,5,0,0,6
11440,vaṭṭehi,vattehi,7,7,0,0,7
11441,vaṭṭāni,vattani,11,9,2,0,7
11442,saṇṭhahantī,santhahanti,8,7,1,0,11
11443,nānācittena,nanacittena,4,3,1,0,11
11444,puññacittena,punnacittena,8,5,3,0,12
11445,cittito,cittito,8,7,1,0,7
11446,pāramīhi,paramihi,10,10,0,0,8
11447,sajjito,sajjito,23,19,4,0,7
11448,sabbasippino,sabbasippino,3,3,0,0,12
11449,iddhimanto,iddhimanto,68,65,3,0,10
11450,patirūpakampi,patirupakampi,2,2,0,0,13
11451,catuvīsatimavandanagāthāvaṇṇanā,catuvisatimavandanagathavannana,1,1,0,0,31
11452,sattappīnotyādīhi,sattappinotyadihi,1,1,0,0,17
11453,sattappīnoti,sattappinoti,2,1,1,0,12
11454,dvihatthapāda,dvihatthapada,1,1,0,0,13
11455,aṃsakūṭa,amsakuta,2,2,0,0,8
11456,ekagalavasena,ekagalavasena,1,1,0,0,13
11457,sattasu,sattasu,448,419,29,0,7
11458,paripuṇṇamaṃsikoti,paripunnamamsikoti,1,1,0,0,18
11459,paripuṇṇadvihatthapāda,paripunnadvihatthapada,1,1,0,0,22
11460,khandhasaṅkhātasattaṭṭhānoti,khandhasankhatasattatthanoti,1,1,0,0,28
11461,pīṇati,pinati,2,2,0,0,6
11462,paripūratīti,paripuratiti,8,7,1,0,12
11463,pīṇate,pinate,1,1,0,0,6
11464,paripūrate,paripurate,1,1,0,0,10
11465,pīṇadhātu,pinadhatu,1,1,0,0,9
11466,hatthapiṭṭhiyo,hatthapitthiyo,3,3,0,0,14
11467,pādapiṭṭhiyo,padapitthiyo,3,3,0,0,12
11468,aṃsakūṭāni,amsakutani,3,3,0,0,10
11469,ekagalo,ekagalo,1,1,0,0,7
11470,maṃso,mamso,4,4,0,0,5
11471,sattapīno,sattapino,2,2,0,0,9
11472,hatthapādapiṭṭhīsu,hatthapadapitthisu,4,4,0,0,18
11473,nhārujālā,nharujala,2,2,0,0,9
11474,aṃsakūṭagalesu,amsakutagalesu,1,1,0,0,14
11475,aṭṭhikoṭiyo,atthikotiyo,4,4,0,0,11
11476,petā,peta,137,127,10,0,4
11477,M0.0186,M0.0186,69,69,0,0,7
11478,paripuṇṇamaṃsussadattā,paripunnamamsussadatta,3,3,0,0,22
11479,niguḷanhārujālehi,nigulanharujalehi,1,1,0,0,17
11480,hatthapiṭṭhādīhi,hatthapitthadihi,3,3,0,0,16
11481,ṭhapitasuvaṇṇavaṇṇāliṅgasadisena,thapitasuvannavannalingasadisena,2,2,0,0,32
11482,galena,galena,13,12,1,0,6
11483,sīlārūpakaṃ,silarupakam,1,1,0,0,11
11484,cittakammarūpakaṃ,cittakammarupakam,3,3,0,0,17
11485,khāyati,khayati,211,207,4,0,7
11486,paripuṇṇamaṃsussadoti,paripunnamamsussadoti,1,1,0,0,21
11487,dīghaṅgulīti,dighanguliti,4,1,3,0,12
11488,dīghaaṅgulīti,dighaanguliti,1,1,0,0,13
11489,samaāyatahattha,samaayatahattha,1,1,0,0,15
11490,pādaṅgulīti,padanguliti,1,1,0,0,11
11491,aṅguli,anguli,36,30,6,0,6
11492,parāmasati,paramasati,279,271,8,0,10
11493,karasākhā,karasakha,7,6,1,0,9
11494,ulipaccayo,ulipaccayo,1,1,0,0,10
11495,aṅga,anga,28,7,21,0,4
11496,saddūpapadauladhātu,saddupapadauladhatu,1,1,0,0,19
11497,samadīghā,samadigha,2,2,0,0,9
11498,pādaṅguli,padanguli,1,1,0,0,9
11499,hatthapādaṅguli,hatthapadanguli,1,1,0,0,15
11500,kāci,kaci,632,603,29,0,4
11501,rassā,rassa,65,55,10,0,5
11502,makkaṭasseva,makkatasseva,6,6,0,0,12
11503,dīghahatthapādaṅguliyo,dighahatthapadanguliyo,2,2,0,0,22
11504,thūlā,thula,28,27,1,0,5
11505,tanukā,tanuka,27,27,0,0,6
11506,niyyāsatelena,niyyasatelena,3,3,0,0,13
11507,vaṭṭitaharitālavaṭṭasadisā,vattitaharitalavattasadisa,1,1,0,0,26
11508,mathāti,mathati,1,0,1,0,7
11509,maathāti,maathati,1,1,0,0,8
11510,makāro,makaro,74,69,5,0,6
11511,padasandhikaro,padasandhikaro,125,122,3,0,14
11512,athāti,athati,119,12,107,0,6
11513,atthantare,atthantare,5,5,0,0,10
11514,tadaññanti,tadannanti,3,3,0,0,10
11515,lomakūpekalomoti,lomakupekalomoti,2,1,1,0,16
11516,lomakūpaekalomoti,lomakupaekalomoti,1,1,0,0,17
11517,ekekalomakūpe,ekekalomakupe,2,2,0,0,13
11518,ekekajātalomoti,ekekajatalomoti,1,1,0,0,15
11519,cammamaṃsaṃ,cammamamsam,1,1,0,0,11
11520,vaḍḍhamānaṃ,vaddhamanam,22,18,4,0,11
11521,lunitabbanti,lunitabbanti,1,1,0,0,12
11522,lūdhātu,ludhatu,1,1,0,0,7
11523,chedane,chedane,96,84,12,0,7
11524,kuvuccati,kuvuccati,3,3,0,0,9
11525,kūpo,kupo,20,19,1,0,4
11526,kupubbapādhātu,kupubbapadhatu,1,1,0,0,14
11527,M0.0187,M0.0187,68,68,0,0,7
11528,lomaṃ,lomam,222,209,13,0,5
11529,kusadde,kusadde,6,6,0,0,7
11530,po,po,40,28,12,0,2
11531,dīghādi,dighadi,43,43,0,0,7
11532,kena,kena,1868,1741,127,0,4
11533,ubhatīti,ubhatiti,3,3,0,0,8
11534,bhassa,bhassa,12,7,5,0,6
11535,lomassa,lomassa,2,2,0,0,7
11536,lomakūpo,lomakupo,1,1,0,0,8
11537,ekeka,ekeka,11,10,1,0,5
11538,ekekasmimpi,ekekasmimpi,5,5,0,0,11
11539,lomakūpe,lomakupe,5,5,0,0,8
11540,anekāni,anekani,262,259,3,0,7
11541,nī,ni,770,738,32,0,2
11542,sampannodātadāṭhoti,sampannodatadathoti,2,1,1,0,19
11543,sampannoodātadāṭhoti,sampannoodatadathoti,1,1,0,0,20
11544,sampannasukkadāṭhoti,sampannasukkadathoti,1,1,0,0,20
11545,saṃpubbapadadhātu,sampubbapadadhatu,1,1,0,0,17
11546,anno,anno,2,1,1,0,4
11547,avakhaṇḍiyati,avakhandiyati,1,1,0,0,13
11548,aññavaṇṇobhāsanti,annavannobhasanti,1,1,0,0,17
11549,odanādiṃ,odanadim,4,4,0,0,8
11550,dāṭho,datho,3,3,0,0,5
11551,dantaviseso,dantaviseso,2,2,0,0,11
11552,ṭho,tho,44,38,6,0,3
11553,daṃsissa,damsissa,2,2,0,0,8
11554,dā,da,167,97,70,0,2
11555,dātadāṭho,datadatho,1,1,0,0,9
11556,pūtidantā,putidanta,3,3,0,0,9
11557,dāṭhā,datha,65,61,4,0,5
11558,kāḷāpi,kalapi,7,7,0,0,6
11559,vivaṇṇāpi,vivannapi,3,3,0,0,9
11560,sukkadāṭho,sukkadatho,7,7,0,0,10
11561,osadhitārakampi,osadhitarakampi,3,3,0,0,15
11562,atikkamma,atikkamma,414,391,23,0,9
11563,virocamānāya,virocamanaya,4,4,0,0,12
11564,pabhāya,pabhaya,73,69,4,0,7
11565,samannāgatadāṭho,samannagatadatho,3,3,0,0,16
11566,kanakasamatacoti,kanakasamatacoti,2,1,1,0,16
11567,suvaṇṇena,suvannena,51,48,3,0,9
11568,sadisacammo,sadisacammo,2,2,0,0,11
11569,kanati,kanati,9,9,0,0,6
11570,obhāsenāti,obhasenati,1,1,0,0,10
11571,kanakaṃ,kanakam,13,11,2,0,7
11572,kaniyati,kaniyati,2,2,0,0,8
11573,hīti,hiti,484,20,464,0,4
11574,suvaṇṇaṃ,suvannam,255,243,12,0,8
11575,kanadhātu,kanadhatu,1,1,0,0,9
11576,dittigatikantīsu,dittigatikantisu,4,4,0,0,16
11577,akapaccayo,akapaccayo,1,1,0,0,10
11578,saṃsadisena,samsadisena,1,1,0,0,11
11579,saṃpubbaamadhātu,sampubbaamadhatu,1,1,0,0,16
11580,tacati,tacati,4,4,0,0,6
11581,chādeti,chadeti,248,234,14,0,7
11582,saṃvarati,samvarati,19,19,0,0,9
11583,M0.0188,M0.0188,66,66,0,0,7
11584,suvaṇṇobhāsenāti,suvannobhasenati,1,1,0,0,16
11585,cammaṃ,cammam,213,195,18,0,6
11586,tacadhātu,tacadhatu,1,1,0,0,9
11587,saṃvaraṇadittīsu,samvaranadittisu,1,1,0,0,16
11588,kanakena,kanakena,1,1,0,0,8
11589,kanaka,kanaka,5,5,0,0,6
11590,samataco,samataco,2,2,0,0,8
11591,nīlataco,nilataco,1,1,0,0,8
11592,setataco,setataco,1,1,0,0,8
11593,pītataco,pitataco,1,1,0,0,8
11594,jātihiṅgulakena,jatihingulakena,21,21,0,0,15
11595,nisadāya,nisadaya,5,5,0,0,8
11596,ghaṃsitvā,ghamsitva,103,98,5,0,9
11597,gerukaparikammaṃ,gerukaparikammam,18,18,0,0,16
11598,ghanasuvaṇṇarūpakaṃ,ghanasuvannarupakam,1,1,0,0,19
11599,kañcanasadisataco,kancanasadisataco,1,1,0,0,17
11600,kañcanena,kancanena,2,2,0,0,9
11601,sannibhaṃ,sannibham,4,4,0,0,9
11602,tacamassāti,tacamassati,1,1,0,0,11
11603,kañcanasannibhattacoti,kancanasannibhattacoti,4,2,2,0,22
11604,suvaṇṇavaṇṇanti,suvannavannanti,1,1,0,0,15
11605,ghanasiniddhasaṇhasarīrataṃ,ghanasiniddhasanhasariratam,3,3,0,0,27
11606,chavivaṇṇaṃ,chavivannam,3,3,0,0,11
11607,vevacanametaṃ,vevacanametam,4,3,1,0,13
11608,nīlamuddhaggalomoti,nilamuddhaggalomoti,2,1,1,0,19
11609,aggalomoti,aggalomoti,1,1,0,0,10
11610,aggā,agga,119,115,4,0,4
11611,koṭi,koti,272,251,21,0,4
11612,mukhasobhaṃ,mukhasobham,11,8,3,0,11
11613,ullokayamāno,ullokayamano,3,3,0,0,12
11614,ṭhitalomo,thitalomo,2,2,0,0,9
11615,aggāni,aggani,16,16,0,0,6
11616,koṭīni,kotini,1,1,0,0,6
11617,ṭhitāni,thitani,139,135,4,0,7
11618,tiṭṭhanti,titthanti,837,818,19,0,9
11619,āvaṭṭapariyosāne,avattapariyosane,3,3,0,0,16
11620,ullokayamānāni,ullokayamanani,3,3,0,0,14
11621,kuṇḍalāvaṭṭāni,kundalavattani,4,4,0,0,14
11622,padakkhiṇāvaṭṭakajātānī,padakkhinavattakajatani,1,1,0,0,23
11623,anaññabuddho,anannabuddho,1,1,0,0,12
11624,sāmaṃyeva,samamyeva,37,37,0,0,9
11625,M0.0189,M0.0189,69,69,0,0,7
11626,thūlajivhotyādīhi,thulajivhotyadihi,1,1,0,0,17
11627,thūlajivhoti,thulajivhoti,1,0,1,0,12
11628,mududīghaputhula,mududighaputhula,1,1,0,0,16
11629,jivhāya,jivhaya,340,336,4,0,7
11630,mududīghasaddalopaṃ,mududighasaddalopam,1,1,0,0,19
11631,mudujivhā,mudujivha,5,5,0,0,9
11632,vaṇṇa,vanna,53,26,27,0,5
11633,sampannā,sampanna,85,82,3,0,8
11634,thūlati,thulati,1,1,0,0,7
11635,brūhatīti,bruhatiti,2,2,0,0,9
11636,jivhā,jivha,439,408,31,0,5
11637,thūladhātu,thuladhatu,1,1,0,0,10
11638,rasanā,rasana,10,7,3,0,6
11639,hapaccayo,hapaccayo,1,1,0,0,9
11640,rasenāti,rasenati,7,4,3,0,8
11641,chabbidharaso,chabbidharaso,1,1,0,0,13
11642,avhāyatīti,avhayatiti,15,14,1,0,10
11643,jivhāpasādarūpaṃ,jivhapasadarupam,1,1,0,0,16
11644,sambhārajivhā,sambharajivha,1,1,0,0,13
11645,jīvitasaddūpapada,jivitasaddupapada,1,1,0,0,17
11646,avhadhātu,avhadhatu,1,1,0,0,9
11647,avhāyane,avhayane,2,1,1,0,8
11648,jīvitaavhāti,jivitaavhati,1,1,0,0,12
11649,vitasaddalopaṃ,vitasaddalopam,1,1,0,0,14
11650,jivhāti,jivhati,15,14,1,0,7
11651,mahantā,mahanta,229,221,8,0,7
11652,mudukā,muduka,62,56,6,0,6
11653,thūlāpi,thulapi,3,3,0,0,7
11654,kisāpi,kisapi,3,3,0,0,6
11655,rassāpi,rassapi,3,3,0,0,7
11656,thaddhāpi,thaddhapi,3,3,0,0,9
11657,visamāpi,visamapi,3,3,0,0,8
11658,puthulā,puthula,8,8,0,0,7
11659,pariyesituṃ,pariyesitum,54,53,1,0,11
11660,brahmāyubrāhmaṇādīnaṃ,brahmayubrahmanadinam,1,1,0,0,21
11661,kaṅkhāvinodanatthaṃ,kankhavinodanattham,6,6,0,0,19
11662,mudukattā,mudukatta,4,4,0,0,9
11663,jivhaṃ,jivham,180,175,5,0,6
11664,kathinasūci,kathinasuci,2,1,1,0,11
11665,ubhopi,ubhopi,721,700,21,0,6
11666,nāsikāsotāni,nasikasotani,2,2,0,0,12
11667,dīghattā,dighatta,9,8,1,0,8
11668,kaṇṇasotāni,kannasotani,11,11,0,0,11
11669,puthulattā,puthulatta,3,3,0,0,10
11670,kesantapariyosānaṃ,kesantapariyosanam,3,3,0,0,18
11671,kevalampi,kevalampi,55,52,3,0,9
11672,nalāṭaṃ,nalatam,37,36,1,0,7
11673,paṭicchādeti,paticchadeti,131,129,2,0,12
11674,mududīghaputhulabhāvaṃ,mududighaputhulabhavam,3,3,0,0,22
11675,pakāsento,pakasento,762,759,3,0,9
11676,kaṅkhāvinodeti,kankhavinodeti,1,1,0,0,14
11677,tilakkhaṇasampannaṃ,tilakkhanasampannam,6,6,0,0,19
11678,thūla,thula,4,2,2,0,5
11679,jivhoti,jivhoti,1,1,0,0,7
11680,sīhahanukoti,sihahanukoti,2,1,1,0,12
11681,hanu,hanu,28,24,4,0,4
11682,hanuko,hanuko,1,1,0,0,6
11683,sīhasaddattho,sihasaddattho,1,1,0,0,13
11684,odanādīnaṃ,odanadinam,11,10,1,0,10
11685,vaṇṇavisesaṃ,vannavisesam,8,8,0,0,12
11686,nāsetīti,nasetiti,14,13,1,0,8
11687,M0.0190,M0.0190,62,62,0,0,7
11688,samāsante,samasante,20,18,2,0,9
11689,heṭṭhimahanumeva,hetthimahanumeva,4,4,0,0,16
11690,uparimaṃ,uparimam,95,81,14,0,8
11691,heṭṭhimaṃ,hetthimam,96,90,6,0,9
11692,paripuṇṇāni,paripunnani,98,96,2,0,11
11693,dvādasiyaṃ,dvadasiyam,9,8,1,0,10
11694,pakkhassa,pakkhassa,149,144,5,0,9
11695,candasadisāni,candasadisani,5,4,1,0,13
11696,jālikappādahatthoti,jalikappadahatthoti,2,1,1,0,19
11697,kusalena,kusalena,240,226,14,0,8
11698,vaḍḍhakinā,vaddhakina,12,12,0,0,10
11699,vātapāne,vatapane,33,31,2,0,8
11700,sammāyojitajālaṃ,sammayojitajalam,1,1,0,0,16
11701,cammena,cammena,51,51,0,0,7
11702,appaṭibaddhahatthapādaṅgulantaro,appatibaddhahatthapadangulantaro,2,2,0,0,32
11703,jālikaṃ,jalikam,6,6,0,0,7
11704,vātapānaṃ,vatapanam,56,53,3,0,9
11705,haradhātu,haradhatu,2,2,0,0,9
11706,tho,tho,76,60,16,0,3
11707,hatthapādaṅgulantaraṃ,hatthapadangulantaram,1,1,0,0,21
11708,sammāyojitāni,sammayojitani,1,1,0,0,13
11709,jālasadisāni,jalasadisani,1,1,0,0,12
11710,hatthapādaṅgulantarāni,hatthapadangulantarani,1,1,0,0,22
11711,paṭibaddhaaṅgulantarānīti,patibaddhaangulantaraniti,1,1,0,0,25
11712,jālikappādahatthaṅgulantaranti,jalikappadahatthangulantaranti,1,1,0,0,30
11713,paṭibaddhahatthapādaṅgulantaro,patibaddhahatthapadangulantaro,1,1,0,0,30
11714,phaṇahatthako,phanahatthako,11,10,1,0,13
11715,purisadosena,purisadosena,3,3,0,0,12
11716,upahato,upahato,34,29,5,0,7
11717,pabbajjampi,pabbajjampi,18,15,3,0,11
11718,catasso,catasso,2019,1917,102,0,7
11719,hatthaṅguliyo,hatthanguliyo,4,4,0,0,13
11720,pañcapi,pancapi,283,268,15,0,7
11721,pādaṅguliyo,padanguliyo,4,4,0,0,11
11722,ekappamāṇā,ekappamana,3,3,0,0,10
11723,ekappamāṇa,ekappamana,1,1,0,0,10
11724,yavalakkhaṇaṃ,yavalakkhanam,7,5,2,0,13
11725,paṭivijjhitvā,pativijjhitva,157,153,4,0,13
11726,hatthapādā,hatthapada,82,81,1,0,10
11727,sammāyojitajālavāta,sammayojitajalavata,1,1,0,0,19
11728,pānasadisā,panasadisa,1,1,0,0,10
11729,kattuvasena,kattuvasena,14,14,0,0,11
11730,yācati,yacati,532,528,4,0,6
11731,parasantānagataṃ,parasantanagatam,5,5,0,0,16
11732,kilesabyasaṃ,kilesabyasam,1,1,0,0,12
11733,upatāpeti,upatapeti,15,15,0,0,9
11734,M0.0191,M0.0191,67,67,0,0,7
11735,īsati,isati,15,15,0,0,5
11736,āsisane,asisane,1,1,0,0,7
11737,uṇhīsasīsotipadena,unhisasisotipadena,1,1,0,0,18
11738,uṇhīsasīsoti,unhisasisoti,8,5,3,0,12
11739,baddhauṇhīsa,baddhaunhisa,1,1,0,0,12
11740,paṭṭo,patto,6,4,2,0,5
11741,pakatimaṃsapiṇḍasaṅkhāto,pakatimamsapindasankhato,2,2,0,0,24
11742,uṇhīsapaṭṭasīso,unhisapattasiso,2,2,0,0,15
11743,nalāṭe,nalate,57,56,1,0,6
11744,nahiyati,nahiyati,2,2,0,0,8
11745,uṇhīso,unhiso,2,1,1,0,6
11746,upubbanahadhātu,upubbanahadhatu,1,1,0,0,15
11747,īso,iso,26,24,2,0,3
11748,vaṇṇavikāro,vannavikaro,29,27,2,0,11
11749,jāliniyaṃ,jaliniyam,1,0,1,0,9
11750,vaṇṇāgamo,vannagamo,15,13,2,0,9
11751,vaṇṇavipariyāyo,vannavipariyayo,11,9,2,0,15
11752,cāpare,capare,11,11,0,0,6
11753,vaṇṇavikāranāsā,vannavikaranasa,6,6,0,0,15
11754,dhātūnamatthātisayena,dhatunamatthatisayena,5,4,1,0,21
11755,yogo,yogo,344,326,18,0,4
11756,taduccate,taduccate,6,6,0,0,9
11757,niruttiṃ,niruttim,24,23,1,0,8
11758,avijjamānassa,avijjamanassa,32,30,2,0,13
11759,āgamā,agama,65,57,8,0,5
11760,vijjamānaakkharānaṃ,vijjamanaakkharanam,1,1,0,0,19
11761,heṭṭhupariyāyavasena,hetthupariyayavasena,3,2,1,0,20
11762,aññakkharassa,annakkharassa,3,3,0,0,13
11763,aññakkharāpajjanatā,annakkharapajjanata,2,2,0,0,19
11764,vijjamānakkharavināso,vijjamanakkharavinaso,2,2,0,0,21
11765,vaṇṇavināso,vannavinaso,3,1,2,0,11
11766,yathāyogaṃ,yathayogam,201,182,19,0,10
11767,visesatthayogo,visesatthayogo,2,2,0,0,14
11768,atthātisaya,atthatisaya,1,1,0,0,11
11769,ṇakāraṃ,nakaram,6,6,0,0,7
11770,katattā,katatta,641,634,7,0,7
11771,vaṇṇavikāroti,vannavikaroti,2,2,0,0,13
11772,mālādiṃ,maladim,5,3,2,0,7
11773,sīso,siso,6,6,0,0,4
11774,uttamaṅgo,uttamango,2,2,0,0,9
11775,rājūnaṃ,rajunam,302,296,6,0,7
11776,uṇhīsapaṭṭena,unhisapattena,6,6,0,0,13
11777,veṭhitasīso,vethitasiso,3,2,1,0,11
11778,parimaṇḍalasīso,parimandalasiso,1,1,0,0,15
11779,paripuṇṇanalāṭañceva,paripunnanalatanceva,1,1,0,0,20
11780,paripuṇṇasīsañcāti,paripunnasisancati,1,1,0,0,18
11781,atthavase,atthavase,144,135,9,0,9
11782,dakkhiṇakaṇṇacūḷikato,dakkhinakannaculikato,5,5,0,0,21
11783,maṃsapaṭaṃ,mamsapatam,1,1,0,0,10
11784,M0.0192,M0.0192,65,65,0,0,7
11785,chādayamānaṃ,chadayamanam,7,6,1,0,12
11786,pūrayamānaṃ,purayamanam,12,12,0,0,11
11787,vāmakaṇṇacūḷikāya,vamakannaculikaya,3,3,0,0,17
11788,baddhauṇhīsapaṭṭo,baddhaunhisapatto,4,3,1,0,17
11789,pacchimabhavikabodhisattānaṃ,pacchimabhavikabodhisattanam,3,3,0,0,28
11790,viditvā,viditva,966,933,33,0,7
11791,uṇhīsapaṭṭaṃ,unhisapattam,8,8,0,0,12
11792,akaṃsu,akamsu,836,832,4,0,6
11793,aparipuṇṇasīsā,aparipunnasisa,4,4,0,0,14
11794,kapisīsā,kapisisa,4,4,0,0,8
11795,phalasīsā,phalasisa,4,4,0,0,9
11796,aṭṭhisīsā,atthisisa,4,4,0,0,9
11797,tumba,tumba,3,1,2,0,5
11798,sīsā,sisa,7,7,0,0,4
11799,pabbhārasīsā,pabbharasisa,4,4,0,0,12
11800,suparipuṇṇaṃ,suparipunnam,7,7,0,0,12
11801,udakapupphulasadisaṃ,udakapupphulasadisam,1,1,0,0,20
11802,purimanayena,purimanayena,54,50,4,0,12
11803,uṇhīsaveṭhitasīso,unhisavethitasiso,5,3,2,0,17
11804,dutiyanayena,dutiyanayena,6,6,0,0,12
11805,parimaṇḍala,parimandala,2,2,0,0,11
11806,sīsoti,sisoti,1,1,0,0,6
11807,vase,vase,423,403,20,0,4
11808,cakkavattino,cakkavattino,135,132,3,0,12
11809,nalāṭatāya,nalatataya,1,1,0,0,10
11810,paripuṇṇasīsabimbatāya,paripunnasisabimbataya,3,3,0,0,22
11811,uṇhīsasīsāti,unhisasisati,1,1,0,0,12
11812,vaṇṇeti,vanneti,95,90,5,0,7
11813,vuttappakārena,vuttappakarena,216,215,1,0,14
11814,nigrodhabimbotyādinā,nigrodhabimbotyadina,2,2,0,0,20
11815,dvattiṃsamahāpurisalakkhaṇaguṇena,dvattimsamahapurisalakkhanagunena,2,2,0,0,33
11816,itievaṃ,itievam,3,3,0,0,7
11817,vuttappakāraṃ,vuttappakaram,228,215,13,0,13
11818,itiguṇaṃ,itigunam,1,1,0,0,8
11819,itiguṇasahito,itigunasahito,1,1,0,0,13
11820,cakkavattirājāno,cakkavattirajano,19,18,1,0,16
11821,sampannāpi,sampannapi,1,1,0,0,10
11822,kosohitavattha,kosohitavattha,1,1,0,0,14
11823,guyhalakkhaṇaṃ,guyhalakkhanam,1,1,0,0,14
11824,avasesehi,avasesehi,43,41,2,0,9
11825,tathāgatoyeva,tathagatoyeva,4,4,0,0,13
11826,sabbamahāpurisalakkhaṇehi,sabbamahapurisalakkhanehi,1,1,0,0,25
11827,itiguṇasahitanti,itigunasahitanti,1,1,0,0,16
11828,pañcavīsatimavandanagāthāvaṇṇanā,pancavisatimavandanagathavannana,1,1,0,0,32
11829,M0.0193,M0.0193,67,67,0,0,7
11830,aṭṭhaṅgasampannasaravanto,atthangasampannasaravanto,1,1,0,0,25
11831,eṇijaṅghā,enijangha,1,1,0,0,9
11832,usabhavāraṇā,usabhavarana,1,1,0,0,12
11833,dīnaṃ,dinam,87,86,1,0,5
11834,suvaṇṇapadumakaṇṇikasadisena,suvannapadumakannikasadisena,1,1,0,0,28
11835,punaapi,punaapi,1,1,0,0,7
11836,pādukatalamiva,padukatalamiva,1,1,0,0,14
11837,dātuṇṇalomo,datunnalomo,1,1,0,0,11
11838,uṇṇalomavanto,unnalomavanto,1,1,0,0,13
11839,tadaññaṃapi,tadannamapi,1,1,0,0,11
11840,ujuuggata,ujuuggata,1,1,0,0,9
11841,paripuṇṇapaṇhi,paripunnapanhi,1,1,0,0,14
11842,saṇhamala,sanhamala,1,1,0,0,9
11843,virahitataco,virahitataco,1,1,0,0,12
11844,thomitabbasattara,thomitabbasattara,1,1,0,0,17
11845,saharaṇasahassanhāruuddhaggikā,saharanasahassanharuuddhaggika,1,1,0,0,30
11846,samacattālīsauttamadanto,samacattalisauttamadanto,1,1,0,0,24
11847,paripuṇṇapiṭṭhitalo,paripunnapitthitalo,1,1,0,0,19
11848,lakkhita,lakkhita,1,1,0,0,8
11849,pādatalo,padatalo,1,1,0,0,8
11850,ubhayakaramudunā,ubhayakaramuduna,1,1,0,0,16
11851,āmasanto,amasanto,7,7,0,0,8
11852,M0.0194,M0.0194,64,64,0,0,7
11853,gotaruṇa,gotaruna,1,1,0,0,8
11854,dvihatthapādaaṃsakūṭaekagalavasena,dvihatthapadaamsakutaekagalavasena,1,1,0,0,34
11855,paripuṇṇamaṃsiko,paripunnamamsiko,1,1,0,0,16
11856,samaāyatahatthapādaṅguli,samaayatahatthapadanguli,1,1,0,0,24
11857,loma,loma,5,5,0,0,4
11858,kūpekalomo,kupekalomo,1,1,0,0,10
11859,ekekajātalomo,ekekajatalomo,1,1,0,0,13
11860,sampannasukkadāṭho,sampannasukkadatho,1,1,0,0,18
11861,mududīghaputhulajivhāya,mududighaputhulajivhaya,1,1,0,0,23
11862,heṭṭhāhanu,hetthahanu,1,1,0,0,10
11863,paripuṇṇahanuko,paripunnahanuko,1,1,0,0,15
11864,jālikappāda,jalikappada,1,1,0,0,11
11865,sammāyojita,sammayojita,1,1,0,0,11
11866,uṇhīsapaṭṭo,unhisapatto,2,2,0,0,11
11867,guṇasahitaṃ,gunasahitam,2,2,0,0,11
11868,namakkārapāḷiyaṃ,namakkarapaliyam,1,1,0,0,16
11869,buddhavacanapāḷiyaṃ,buddhavacanapaliyam,1,1,0,0,19
11870,āgatanayānukkamena,agatanayanukkamena,1,1,0,0,18
11871,chandānurakkhaṇatthameva,chandanurakkhanatthameva,1,1,0,0,24
11872,akkamena,akkamena,1,1,0,0,8
11873,dvattiṃsamahāpurisalakkhaṇakkamaṃ,dvattimsamahapurisalakkhanakkamam,1,1,0,0,33
11874,M0.0195,M0.0195,66,66,0,0,7
11875,bahussutapaññāvaḍḍhanatthaṃ,bahussutapannavaddhanattham,1,1,0,0,27
11876,cakkajāto,cakkajato,1,1,0,0,9
11877,mudutaluna,mudutaluna,1,1,0,0,10
11878,kosohita,kosohita,1,1,0,0,8
11879,vatthaguyho,vatthaguyho,1,1,0,0,11
11880,ekekalomakūpesu,ekekalomakupesu,1,1,0,0,15
11881,pahuta,pahuta,1,1,0,0,6
11882,jivho,jivho,1,1,0,0,5
11883,brahmasaro,brahmasaro,1,1,0,0,10
11884,abhinīlanetto,abhinilanetto,6,6,0,0,13
11885,gopa,gopa,3,2,1,0,4
11886,khumo,khumo,1,1,0,0,5
11887,dvattiṃsamahāpurisalakkhaṇassa,dvattimsamahapurisalakkhanassa,1,1,0,0,30
11888,dvattiṃsamahāpurisalakkhaṇāni,dvattimsamahapurisalakkhanani,30,30,0,0,29
11889,pāramīpuññakammena,paramipunnakammena,1,1,0,0,18
11890,kammasarikkhakaṃ,kammasarikkhakam,36,12,24,0,16
11891,labbhantīti,labbhantiti,146,124,22,0,11
11892,kammāni,kammani,688,643,45,0,7
11893,gahetabbānīti,gahetabbaniti,16,14,2,0,13
11894,vandanagāthāvaṇṇanā,vandanagathavannana,1,1,0,0,19
11895,M0.0196,M0.0196,67,67,0,0,7
11896,sugatantiādīhi,sugatantiadihi,1,1,0,0,14
11897,pañcavīsativandanagāthāhi,pancavisativandanagathahi,1,1,0,0,25
11898,vandane,vandane,5,4,1,0,7
11899,uyyojanaṃ,uyyojanam,11,11,0,0,9
11900,buddhotighoso,buddhotighoso,1,0,1,0,13
11901,tyādigāthaṃ,tyadigatham,1,1,0,0,11
11902,kathāti,kathati,97,65,32,0,7
11903,buddhotighosoti,buddhotighosoti,1,0,1,0,15
11904,thutisaddo,thutisaddo,4,4,0,0,10
11905,ghusanaṃ,ghusanam,4,4,0,0,8
11906,thaviyatīti,thaviyatiti,1,1,0,0,11
11907,kittisaddoti,kittisaddoti,18,2,16,0,12
11908,kittieva,kittieva,1,1,0,0,8
11909,thutighosoti,thutighosoti,2,1,1,0,12
11910,atidulabhataroti,atidulabhataroti,2,1,1,0,16
11911,dullabhatamo,dullabhatamo,2,2,0,0,12
11912,dullabhataroti,dullabhataroti,1,1,0,0,14
11913,lakāralopena,lakaralopena,1,1,0,0,12
11914,dulabhataroti,dulabhataroti,1,1,0,0,13
11915,labhiyatīti,labhiyatiti,1,1,0,0,11
11916,dullabho,dullabho,205,197,8,0,8
11917,dupubbalabhadhātu,dupubbalabhadhatu,1,1,0,0,17
11918,labhane,labhane,1,1,0,0,7
11919,labhassa,labhassa,1,1,0,0,8
11920,asamiddhanti,asamiddhanti,1,1,0,0,12
11921,dubbhijāneyya,dubbhijaneyya,1,1,0,0,13
11922,abyayībhāvasamāsoyaṃ,abyayibhavasamasoyam,2,2,0,0,20
11923,dusaddo,dusaddo,4,4,0,0,7
11924,asamiddhattho,asamiddhattho,1,1,0,0,13
11925,dubbhikkhoti,dubbhikkhoti,3,2,1,0,12
11926,dullabhoti,dullabhoti,9,7,2,0,10
11927,atidulabho,atidulabho,1,1,0,0,10
11928,atidullabhoti,atidullabhoti,1,1,0,0,13
11929,kadāci,kadaci,1333,1297,36,0,6
11930,karahaci,karahaci,97,94,3,0,8
11931,cūḷavaggakhandhake,culavaggakhandhake,1,0,1,0,18
11932,ghosopi,ghosopi,16,15,1,0,7
11933,gahapati,gahapati,1836,1792,44,0,8
11934,udumbarikapupphaṃ,udumbarikapuppham,1,1,0,0,17
11935,dullabhaṃ,dullabham,142,137,5,0,9
11936,candamhi,candamhi,11,10,1,0,8
11937,sasakaṃ,sasakam,20,18,2,0,7
11938,gaṇhituṃ,ganhitum,309,300,9,0,8
11939,vāyasānaṃ,vayasanam,6,5,1,0,9
11940,khīraṃ,khiram,396,369,27,0,6
11941,atidullabhataroti,atidullabhataroti,3,3,0,0,17
11942,udumbarikapupphaṃva,udumbarikapupphamva,1,1,0,0,19
11943,M0.0197,M0.0197,66,66,0,0,7
11944,lokanāyakaṃ,lokanayakam,240,235,5,0,11
11945,buddhuppādo,buddhuppado,51,49,2,0,11
11946,cakkavattirājūnaṃ,cakkavattirajunam,2,2,0,0,17
11947,ekasmimpi,ekasmimpi,94,88,6,0,9
11948,kappe,kappe,1391,1375,16,0,5
11949,tathāgatā,tathagata,264,258,6,0,9
11950,uppajjamānāpi,uppajjamanapi,17,16,1,0,13
11951,dviti,dviti,11,3,8,0,5
11952,buddhāyeva,buddhayeva,11,10,1,0,10
11953,taduttari,taduttari,72,68,4,0,9
11954,asaṅkhyeyyepi,asankhyeyyepi,9,9,0,0,13
11955,tathāgatasuñño,tathagatasunno,3,3,0,0,14
11956,tathāgatasseva,tathagatasseva,44,42,2,0,14
11957,uppajjanato,uppajjanato,234,225,9,0,11
11958,buddhabhāvoti,buddhabhavoti,7,6,1,0,13
11959,mahāparinibbānasamaye,mahaparinibbanasamaye,1,1,0,0,21
11960,ujjhāyanti,ujjhayanti,626,626,0,0,10
11961,durāvatamhā,duravatamha,1,1,0,0,11
11962,dassanāya,dassanaya,637,624,13,0,9
11963,ajja,ajja,2108,2042,66,0,4
11964,paccūsasamaye,paccusasamaye,159,159,0,0,13
11965,parinibbānaṃ,parinibbanam,128,124,4,0,12
11966,bhavissati,bhavissati,3932,3868,64,0,10
11967,mahesakkho,mahesakkho,81,79,2,0,10
11968,ovārento,ovarento,4,4,0,0,8
11969,otarento,otarento,1,1,0,0,8
11970,labhāma,labhama,55,55,0,0,7
11971,pacchime,pacchime,351,330,21,0,8
11972,vattabboevāti,vattabboevati,1,1,0,0,13
11973,saccametaṃ,saccametam,187,184,3,0,10
11974,anekāsaṅkhyeyyavārena,anekasankhyeyyavarena,1,1,0,0,21
11975,anekāsaṅkhyeyyadivasamāsasaṃvaccharaṃ,anekasankhyeyyadivasamasasamvaccharam,1,1,0,0,37
11976,anekāsaṅkhyeyyakappaṃ,anekasankhyeyyakappam,1,1,0,0,21
11977,pūretvāva,puretvava,8,8,0,0,9
11978,ekekavārādinā,ekekavaradina,1,1,0,0,13
11979,M0.0198,M0.0198,66,66,0,0,7
11980,atidullabhatarattā,atidullabhataratta,2,2,0,0,18
11981,uppannattā,uppannatta,188,183,5,0,10
11982,caeva,caeva,1,1,0,0,5
11983,kittayantassa,kittayantassa,20,20,0,0,13
11984,mahapphalaṃ,mahapphalam,424,401,23,0,11
11985,apadāne,apadane,292,26,266,0,7
11986,varameva,varameva,14,14,0,0,8
11987,kasiṇenapi,kasinenapi,10,10,0,0,10
11988,jambudīpassā,jambudipassa,5,5,0,0,12
11989,tasmāti,tasmati,626,76,550,0,7
11990,atidullabhataro,atidullabhataro,1,1,0,0,15
11991,vibhāvīti,vibhaviti,5,1,4,0,9
11992,medhāvī,medhavi,396,378,18,0,7
11993,vibhāvā,vibhava,8,8,0,0,7
11994,nānappakāraṃ,nanappakaram,141,139,2,0,12
11995,patthayantātipade,patthayantatipade,1,1,0,0,17
11996,saparahitaṃ,saparahitam,4,4,0,0,11
11997,sādhadhātu,sadhadhatu,1,1,0,0,10
11998,saṃsiddhiyaṃ,samsiddhiyam,9,7,2,0,12
11999,namassantūti,namassantuti,2,1,1,0,12
12000,patthayantāti,patthayantati,2,0,2,0,13
12001,yācantā,yacanta,11,11,0,0,7
12002,patthayanti,patthayanti,21,21,0,0,11
12003,yācantīti,yacantiti,11,5,6,0,9
12004,patthadhātu,patthadhatu,1,1,0,0,11
12005,yakārāgamo,yakaragamo,6,5,1,0,10
12006,sādhavotipade,sadhavotipade,1,1,0,0,13
12007,kāmayamānaṃ,kamayamanam,6,4,2,0,11
12008,icchitabbaṃ,icchitabbam,126,124,2,0,11
12009,kamitabbanti,kamitabbanti,1,1,0,0,12
12010,icchā,iccha,328,302,26,0,5
12011,kantīsu,kantisu,7,7,0,0,7
12012,diṭṭhadhammikasamparāyikādiatthaṃ,ditthadhammikasamparayikadiattham,2,2,0,0,33
12013,atthiyati,atthiyati,1,1,0,0,9
12014,patthiyatīti,patthiyatiti,2,2,0,0,12
12015,vipākānisaṃsaphalaṃ,vipakanisamsaphalam,1,1,0,0,19
12016,atthadhātu,atthadhatu,1,1,0,0,10
12017,yācanāyaṃ,yacanayam,9,7,2,0,9
12018,M0.0199,M0.0199,66,66,0,0,7
12019,phalabhāvenāti,phalabhavenati,3,2,1,0,14
12020,vahantantipade,vahantantipade,1,1,0,0,14
12021,vahati,vahati,182,176,6,0,6
12022,vahanto,vahanto,33,31,2,0,7
12023,vahane,vahane,5,5,0,0,6
12024,devehi,devehi,179,176,3,0,6
12025,catupaccayādīhi,catupaccayadihi,1,1,0,0,15
12026,issariyakīḷādīhi,issariyakiladihi,2,2,0,0,16
12027,īsanti,isanti,2,2,0,0,6
12028,virocanti,virocanti,68,68,0,0,9
12029,rā,ra,66,41,25,0,2
12030,mahitabbā,mahitabba,1,1,0,0,9
12031,pūjitabbāti,pujitabbati,3,3,0,0,11
12032,suranaramahito,suranaramahito,1,1,0,0,14
12033,mahadhātu,mahadhatu,1,1,0,0,9
12034,pūjāyaṃ,pujayam,70,57,13,0,7
12035,bhiyate,bhiyate,1,1,0,0,7
12036,nibbhayo,nibbhayo,47,47,0,0,8
12037,hadayacalanaṃ,hadayacalanam,2,2,0,0,13
12038,kampanaṃ,kampanam,35,30,5,0,8
12039,saddahitvā,saddahitva,142,138,4,0,10
12040,dātabbauttamadānārahaṃ,databbauttamadanaraham,2,2,0,0,22
12041,dātabbāti,databbati,36,28,8,0,9
12042,dakkhiṇā,dakkhina,326,304,22,0,8
12043,deyyadhammavatthu,deyyadhammavatthu,1,1,0,0,17
12044,dānekkhiṇapaccayo,danekkhinapaccayo,1,1,0,0,17
12045,dakkhanti,dakkhanti,62,60,2,0,9
12046,vaḍḍhanti,vaddhanti,219,217,2,0,9
12047,yathādhippetāhi,yathadhippetahi,6,6,0,0,15
12048,sampattīhīti,sampattihiti,1,1,0,0,12
12049,dātabbadānaṃ,databbadanam,8,8,0,0,12
12050,vaḍḍhaneyu,vaddhaneyu,1,1,0,0,10
12051,dakkhiṇeyyo,dakkhineyyo,119,106,13,0,11
12052,dakkhiṇāya,dakkhinaya,170,168,2,0,10
12053,anurūpaṃ,anurupam,241,227,14,0,8
12054,mahapphalakaraṇatāya,mahapphalakaranataya,4,3,1,0,20
12055,visodhetitaddhitāyaṃ,visodhetitaddhitayam,1,1,0,0,20
12056,mahapphalakaraṇavasena,mahapphalakaranavasena,1,1,0,0,22
12057,visodhanavasena,visodhanavasena,3,3,0,0,15
12058,devasakkabrahmehi,devasakkabrahmehi,1,1,0,0,17
12059,kosalarājādīhi,kosalarajadihi,1,1,0,0,14
12060,anāthapiṇḍikaseṭṭhādīhi,anathapindikasetthadihi,1,1,0,0,23
12061,dātabbaṃ,databbam,1224,1151,73,0,8
12062,uttamadānaṃ,uttamadanam,7,7,0,0,11
12063,arahati,arahati,379,371,8,0,7
12064,dakkhiṇeyyanti,dakkhineyyanti,1,1,0,0,14
12065,M0.0200,M0.0200,68,68,0,0,7
12066,pītiyā,pitiya,552,528,24,0,6
12067,vaḍḍhāpentaṃ,vaddhapentam,1,1,0,0,12
12068,nandiyate,nandiyate,1,1,0,0,9
12069,nandi,nandi,34,31,3,0,5
12070,nandadhātu,nandadhatu,1,1,0,0,10
12071,samiddhiyaṃ,samiddhiyam,13,9,4,0,11
12072,nandane,nandane,77,73,4,0,7
12073,adhivacanametaṃ,adhivacanametam,1,1,0,0,15
12074,nandivaḍḍho,nandivaddho,2,2,0,0,11
12075,nandisaddūpapadavaḍḍhadhātu,nandisaddupapadavaddhadhatu,1,1,0,0,27
12076,dvattiṃsamahāpurisalakkhaṇāsītānubyañjanalakkhaṇasampannena,dvattimsamahapurisalakkhanasitanubyanjanalakkhanasampannena,1,1,0,0,59
12077,sabbaññutañāṇādiguṇasampannena,sabbannutananadigunasampannena,1,1,0,0,30
12078,sabbasattānañhi,sabbasattananhi,4,4,0,0,15
12079,buddhadassane,buddhadassane,7,7,0,0,13
12080,dhammasavane,dhammasavane,6,6,0,0,12
12081,nandivaḍḍhanti,nandivaddhanti,1,1,0,0,14
12082,pakatiyāeva,pakatiyaeva,1,1,0,0,11
12083,puṇṇacandasamuddarājadassane,punnacandasamuddarajadassane,3,3,0,0,28
12084,atitto,atitto,69,68,1,0,6
12085,hotī,hoti,3867,3168,699,0,4
12086,bāttiṃsamahāpurisalakkhaṇādīhi,battimsamahapurisalakkhanadihi,1,1,0,0,30
12087,sīlādiasādhāraṇaguṇehi,siladiasadharanagunehi,1,1,0,0,22
12088,adhika,adhika,3,3,0,0,6
12089,ativirocamānattā,ativirocamanatta,1,1,0,0,16
12090,sambuddhaṃ,sambuddham,422,378,44,0,10
12091,atirocati,atirocati,79,75,4,0,9
12092,adhiggayha,adhiggayha,7,6,1,0,10
12093,sambuddhova,sambuddhova,4,4,0,0,11
12094,virocatī,virocati,21,20,1,0,8
12095,paccekabuddhāriyasāvakehi,paccekabuddhariyasavakehi,1,1,0,0,25
12096,dasakāyabalena,dasakayabalena,1,1,0,0,14
12097,dasañāṇabalena,dasananabalena,1,1,0,0,14
12098,kāraṇehi,karanehi,819,796,23,0,8
12099,kampentīti,kampentiti,1,1,0,0,10
12100,kappenti,kappenti,115,115,0,0,8
12101,vahituṃ,vahitum,44,44,0,0,7
12102,sakkuṇantīti,sakkunantiti,5,5,0,0,12
12103,jānanti,jananti,1197,1177,20,0,7
12104,sabbadhammanti,sabbadhammanti,1,1,0,0,14
12105,dasabalañca,dasabalanca,5,5,0,0,11
12106,dasabalāni,dasabalani,10,10,0,0,10
12107,ekasesanayena,ekasesanayena,59,59,0,0,13
12108,vuttopi,vuttopi,52,52,0,0,7
12109,visesaṭṭhāniyattā,visesatthaniyatta,1,1,0,0,17
12110,dasakāyabalāni,dasakayabalani,1,1,0,0,14
12111,dasañāṇabalāni,dasananabalani,1,1,0,0,14
12112,adhippetāni,adhippetani,50,50,0,0,11
12113,sarū,saru,1,1,0,0,4
12114,patthaṃ,pattham,10,10,0,0,7
12115,nayanasubhagakāyaṅgantyādi,nayanasubhagakayangantyadi,1,1,0,0,26
12116,M0.0201,M0.0201,66,66,0,0,7
12117,guṇasampannaṃ,gunasampannam,9,7,2,0,13
12118,abhivandantūti,abhivandantuti,2,2,0,0,14
12119,buddhoiti,buddhoiti,1,1,0,0,9
12120,kiṃvattabbo,kimvattabbo,1,1,0,0,11
12121,ghosassa,ghosassa,9,8,1,0,8
12122,asantāsaṃ,asantasam,1,1,0,0,9
12123,vaḍḍhāpanentaṃ,vaddhapanentam,1,1,0,0,14
12124,dasakāyañāṇabalena,dasakayananabalena,1,1,0,0,18
12125,nirantaraṃ,nirantaram,485,451,34,0,10
12126,chabbīsatimavandanagāthāvaṇṇanā,chabbisatimavandanagathavannana,1,1,0,0,31
12127,M0.0202,M0.0202,66,66,0,0,7
12128,saparahitadharo,saparahitadharo,1,1,0,0,15
12129,ghosotyādigāthāya,ghosotyadigathaya,1,1,0,0,17
12130,buddhavandane,buddhavandane,3,3,0,0,13
12131,paṇidhiṃ,panidhim,54,45,9,0,8
12132,ityādi,ityadi,33,33,0,0,6
12133,gāthādvayampi,gathadvayampi,1,1,0,0,13
12134,soahaṃ,soaham,1,1,0,0,6
12135,puññena,punnena,216,201,15,0,7
12136,bhaveyyanti,bhaveyyanti,41,41,0,0,11
12137,namakkāro,namakkaro,15,13,2,0,9
12138,soahanti,soahanti,1,1,0,0,8
12139,buddhavandanapuññakammena,buddhavandanapunnakammena,2,2,0,0,25
12140,buddhapaṇāmakriyābhinipphādikā,buddhapanamakriyabhinipphadika,1,1,0,0,30
12141,vandaneyyavandakānaṃ,vandaneyyavandakanam,3,3,0,0,20
12142,diṭṭhadhamma,ditthadhamma,7,7,0,0,12
12143,vedanīyabhūtā,vedaniyabhuta,1,1,0,0,13
12144,anubalappadānavasena,anubalappadanavasena,5,5,0,0,20
12145,tannidānānaṃ,tannidananam,3,3,0,0,12
12146,yathādhippetasiddhivibandhakānaṃ,yathadhippetasiddhivibandhakanam,3,3,0,0,32
12147,rogādiantarāyānamappavattiṃsādheti,rogadiantarayanamappavattimsadheti,1,1,0,0,34
12148,M0.0203,M0.0203,66,66,0,0,7
12149,aṭṭhānayogo,atthanayogo,3,3,0,0,11
12150,nipuṇamatityādīsu,nipunamatityadisu,1,1,0,0,17
12151,samparāyeti,samparayeti,2,0,2,0,11
12152,paraloke,paraloke,194,185,9,0,8
12153,samparāyitabbā,samparayitabba,2,2,0,0,14
12154,upagamitabbā,upagamitabba,1,1,0,0,12
12155,sattehīti,sattehiti,3,2,1,0,9
12156,kammakilesavasena,kammakilesavasena,12,12,0,0,17
12157,pāpuṇitabbāti,papunitabbati,2,2,0,0,13
12158,samparāyoti,samparayoti,7,2,5,0,11
12159,saṃparipubba,samparipubba,1,1,0,0,12
12160,kammavasena,kammavasena,72,68,4,0,11
12161,abhimukho,abhimukho,61,58,3,0,9
12162,sampareti,sampareti,4,4,0,0,9
12163,saṃpubbaparadhātu,sampubbaparadhatu,1,1,0,0,17
12164,kusalāni,kusalani,150,139,11,0,8
12165,sīlāni,silani,377,361,16,0,6
12166,aggāya,aggaya,9,7,2,0,6
12167,parentītiādīsu,parentitiadisu,1,1,0,0,14
12168,curādi,curadi,90,50,40,0,6
12169,parasaddaṃ,parasaddam,2,2,0,0,10
12170,gatiyamicchanti,gatiyamicchanti,2,2,0,0,15
12171,saddavidū,saddavidu,70,69,1,0,9
12172,nipuṇamatīti,nipunamatiti,1,0,1,0,12
12173,saṇhasukhumapaññavā,sanhasukhumapannava,2,2,0,0,19
12174,atthantaraṃ,atthantaram,26,21,5,0,11
12175,paṭivijjhanasamatthāya,pativijjhanasamatthaya,1,1,0,0,22
12176,nipuṇasaddo,nipunasaddo,1,1,0,0,11
12177,nipuṇā,nipuna,65,58,7,0,6
12178,meti,meti,552,228,324,0,4
12179,satoti,satoti,94,16,78,0,6
12180,satimā,satima,566,538,28,0,6
12181,cintāyanti,cintayanti,1,1,0,0,10
12182,tittoti,tittoti,6,1,5,0,7
12183,tappano,tappano,2,2,0,0,7
12184,yathāladdhavatthunā,yathaladdhavatthuna,2,2,0,0,19
12185,santuṭṭho,santuttho,316,291,25,0,9
12186,tisanaṃ,tisanam,1,1,0,0,7
12187,tappanaṃ,tappanam,16,15,1,0,8
12188,tisadhātu,tisadhatu,1,1,0,0,9
12189,tappane,tappane,8,8,0,0,7
12190,sakārassa,sakarassa,10,10,0,0,9
12191,toādeso,toadeso,7,7,0,0,7
12192,yathālābha,yathalabha,4,4,0,0,10
12193,santoso,santoso,68,62,6,0,7
12194,yathābalasantoso,yathabalasantoso,67,30,37,0,16
12195,yathāsāruppasanto,yathasaruppasanto,1,1,0,0,17
12196,tividhena,tividhena,230,224,6,0,9
12197,santosena,santosena,15,14,1,0,9
12198,santuṭṭhoti,santutthoti,28,14,14,0,11
12199,kicce,kicce,106,99,7,0,5
12200,diṭṭhujjupaññoti,ditthujjupannoti,1,0,1,0,16
12201,diṭṭhiujupaññoti,ditthiujupannoti,2,2,0,0,16
12202,diṭṭhipaññāya,ditthipannaya,1,1,0,0,13
12203,diṭṭhijju,ditthijju,1,1,0,0,9
12204,paññoti,pannoti,2,1,1,0,7
12205,soye,soye,3,3,0,0,4
12206,vattho,vattho,3,3,0,0,6
12207,M0.0204,M0.0204,65,65,0,0,7
12208,ujūti,ujuti,7,3,4,0,5
12209,akuṭilabhāvena,akutilabhavena,3,3,0,0,14
12210,ajjavo,ajjavo,15,12,3,0,6
12211,ujudhātu,ujudhatu,1,1,0,0,8
12212,ajjave,ajjave,3,2,1,0,6
12213,passane,passane,7,6,1,0,7
12214,raṭṭhādeso,ratthadeso,1,1,0,0,10
12215,ajjavā,ajjava,2,2,0,0,6
12216,diṭṭhuju,ditthuju,4,4,0,0,8
12217,visesanaparanipātavasena,visesanaparanipatavasena,4,4,0,0,24
12218,aniccādivasena,aniccadivasena,136,134,2,0,14
12219,avabujjhatīti,avabujjhatiti,5,5,0,0,13
12220,avabodhane,avabodhane,20,18,2,0,10
12221,ujudiṭṭhi,ujuditthi,4,3,1,0,9
12222,ujupaññā,ujupanna,1,1,0,0,8
12223,avikalavīriyoti,avikalaviriyoti,2,1,1,0,15
12224,anūnavīriyo,anunaviriyo,2,2,0,0,11
12225,paripuṇṇavīriyo,paripunnaviriyo,4,4,0,0,15
12226,vihīnaṃ,vihinam,7,6,1,0,7
12227,vipubbakaradhātu,vipubbakaradhatu,1,1,0,0,16
12228,rassalo,rassalo,1,1,0,0,7
12229,vīrānaṃ,viranam,20,18,2,0,7
12230,avikalaṃ,avikalam,7,7,0,0,8
12231,assameti,assameti,3,1,2,0,8
12232,kusīteneva,kusiteneva,1,1,0,0,10
12233,navalokuttaradhammā,navalokuttaradhamma,3,3,0,0,19
12234,āraddhavīriyeneva,araddhaviriyeneva,6,6,0,0,17
12235,bhogavāti,bhogavati,4,1,3,0,9
12236,bhuñjitabbasampattisukhena,bhunjitabbasampattisukhena,1,1,0,0,26
12237,bhuñjitabboti,bhunjitabboti,4,2,2,0,13
12238,bhogo,bhogo,63,54,9,0,5
12239,bhujadhātu,bhujadhatu,1,1,0,0,10
12240,pālanabyavaharaṇesu,palanabyavaharanesu,8,7,1,0,19
12241,saṃvibhāgīti,samvibhagiti,8,0,8,0,12
12242,saṃvibhajanasīlo,samvibhajanasilo,2,2,0,0,16
12243,saṃvibhajanasampanno,samvibhajanasampanno,1,1,0,0,20
12244,saṃvibhajati,samvibhajati,72,72,0,0,12
12245,saṃvibhajanasīloti,samvibhajanasiloti,1,1,0,0,18
12246,saṃvibhajituṃ,samvibhajitum,16,16,0,0,13
12247,sīlamassāti,silamassati,48,48,0,0,11
12248,saṃvibhāge,samvibhage,13,12,1,0,10
12249,tassīlattho,tassilattho,3,3,0,0,11
12250,dhammenāti,dhammenati,83,19,64,0,10
12251,saṃvibhajanadhammoti,samvibhajanadhammoti,1,1,0,0,20
12252,saṃvibhajane,samvibhajane,3,3,0,0,12
12253,taddhammattho,taddhammattho,1,1,0,0,13
12254,saṃvibhajanaṃ,samvibhajanam,7,7,0,0,13
12255,sādhukāro,sadhukaro,10,9,1,0,9
12256,sādhukārinā,sadhukarina,1,1,0,0,11
12257,saṃvibhajatīti,samvibhajatiti,2,1,1,0,14
12258,sādhukārīti,sadhukariti,10,10,0,0,11
12259,dhukārattho,dhukarattho,1,1,0,0,11
12260,saṃvipubba,samvipubba,1,1,0,0,10
12261,bhajadhātu,bhajadhatu,1,1,0,0,10
12262,vibhāge,vibhage,18,14,4,0,7
12263,saṃvibhāgo,samvibhago,10,7,3,0,10
12264,M0.0205,M0.0205,65,65,0,0,7
12265,annādidānavatthuṃ,annadidanavatthum,1,1,0,0,17
12266,pariccajanakārīti,pariccajanakariti,1,1,0,0,17
12267,tikkhoti,tikkhoti,2,1,1,0,8
12268,tikkhappaññavā,tikkhappannava,1,1,0,0,14
12269,nisānapaññavā,nisanapannava,1,1,0,0,13
12270,tijanaṃ,tijanam,1,1,0,0,7
12271,nisanaṃ,nisanam,1,1,0,0,7
12272,tikkhā,tikkha,37,36,1,0,6
12273,tijadhātu,tijadhatu,1,1,0,0,9
12274,nisāne,nisane,15,10,5,0,6
12275,tikkha,tikkha,11,10,1,0,6
12276,mūlakāraṇattā,mulakaranatta,10,10,0,0,13
12277,patthanaṃ,patthanam,391,383,8,0,9
12278,pasaṭṭhā,pasattha,11,11,0,0,8
12279,katā,kata,1272,1226,46,0,4
12280,saddhammaṭṭhitiyā,saddhammatthitiya,57,54,3,0,17
12281,vimatiṃ,vimatim,84,78,6,0,7
12282,santiṃ,santim,192,155,37,0,6
12283,paṇḍito,pandito,1507,1446,61,0,7
12284,sūroti,suroti,13,8,5,0,6
12285,vīro,viro,157,140,17,0,4
12286,sattivanto,sattivanto,5,5,0,0,10
12287,nibbhayoti,nibbhayoti,5,4,1,0,10
12288,sūrayate,surayate,1,1,0,0,8
12289,virayate,virayate,1,1,0,0,8
12290,sūradhātu,suradhatu,2,2,0,0,9
12291,vikkantiyaṃ,vikkantiyam,2,1,1,0,11
12292,vīre,vire,5,4,1,0,4
12293,abhiruachambhianutrāsabhāvena,abhiruachambhianutrasabhavena,1,1,0,0,29
12294,sūrati,surati,1,1,0,0,6
12295,parisamajjhe,parisamajjhe,98,97,1,0,12
12296,sūravīrasampanno,suravirasampanno,1,1,0,0,16
12297,sāsani,sasani,1,1,0,0,6
12298,kehi,kehi,60,58,2,0,4
12299,saddhammavidūhi,saddhammaviduhi,5,5,0,0,15
12300,sūrasaddassa,surasaddassa,1,1,0,0,12
12301,dassitaṃ,dassitam,704,669,35,0,8
12302,kevalaṃ,kevalam,2603,2480,123,0,7
12303,visiṭṭhasūroti,visitthasuroti,1,1,0,0,14
12304,atthavivaraṇamattameva,atthavivaranamattameva,2,2,0,0,22
12305,dhitattoti,dhitattoti,1,0,1,0,10
12306,dhita,dhita,1,1,0,0,5
12307,attoti,attoti,1,1,0,0,6
12308,dhitoti,dhitoti,1,1,0,0,7
12309,attanti,attanti,1,1,0,0,7
12310,ekaggacittasampanno,ekaggacittasampanno,1,1,0,0,19
12311,dhāti,dhati,47,40,7,0,5
12312,ekārammaṇehi,ekarammanehi,1,1,0,0,12
12313,saparahitacaroti,saparahitacaroti,1,0,1,0,16
12314,attahitaparahitacaro,attahitaparahitacaro,1,1,0,0,20
12315,paṭipannako,patipannako,28,25,3,0,11
12316,paṭipajjatīti,patipajjatiti,49,34,15,0,13
12317,M0.0206,M0.0206,64,64,0,0,7
12318,saparahitasaddūpapada,saparahitasaddupapada,1,1,0,0,21
12319,dīghajīvīti,dighajiviti,1,0,1,0,11
12320,dīghāyuko,dighayuko,53,52,1,0,9
12321,dīghena,dighena,110,106,4,0,7
12322,jīvitindriyena,jivitindriyena,15,13,2,0,14
12323,jīvo,jivo,136,126,10,0,4
12324,dīghajīvi,dighajivi,1,1,0,0,9
12325,āyukappampi,ayukappampi,4,4,0,0,11
12326,dīghajīvitasampanno,dighajivitasampanno,1,1,0,0,19
12327,arogoti,arogoti,14,2,12,0,7
12328,rogaviraho,rogaviraho,2,2,0,0,10
12329,ārogyaṃ,arogyam,146,137,9,0,7
12330,rujjati,rujjati,21,21,0,0,7
12331,aṅgapaccaṅgānīti,angapaccanganiti,2,2,0,0,16
12332,rogo,rogo,307,280,27,0,4
12333,byādhi,byadhi,135,124,11,0,6
12334,rujadhātu,rujadhatu,2,2,0,0,9
12335,bhaṅge,bhange,17,15,2,0,6
12336,channavutirogānaṃ,channavutiroganam,1,1,0,0,17
12337,dhaññoti,dhannoti,1,0,1,0,8
12338,sirīpuññapaññālakkhaṇasampanno,siripunnapannalakkhanasampanno,2,2,0,0,30
12339,dhaññasaddo,dhannasaddo,2,2,0,0,11
12340,sirīpuññapaññālakkhaṇavācakoti,siripunnapannalakkhanavacakoti,1,1,0,0,30
12341,dhaññaṃ,dhannam,210,187,23,0,7
12342,sammataṃ,sammatam,69,61,8,0,8
12343,temiyajātake,temiyajatake,1,0,1,0,12
12344,dhaññapuññalakkhaṇasampannaṃ,dhannapunnalakkhanasampannam,8,8,0,0,28
12345,vijāyī,vijayi,3,3,0,0,6
12346,dhananaṃ,dhananam,3,3,0,0,8
12347,sampajjanaṃ,sampajjanam,7,7,0,0,11
12348,sirīpaññāpuññalakkhaṇānaṃ,siripannapunnalakkhananam,1,1,0,0,25
12349,sampannanti,sampannanti,6,5,1,0,11
12350,dhanadhātu,dhanadhatu,1,1,0,0,10
12351,sampanne,sampanne,27,27,0,0,8
12352,anekatthattā,anekatthatta,84,83,1,0,12
12353,ṇakārānubandhe,nakaranubandhe,5,5,0,0,14
12354,lope,lope,78,72,6,0,4
12355,kate,kate,1081,1056,25,0,4
12356,yapaccayena,yapaccayena,3,3,0,0,11
12357,ñakāraṃ,nakaram,3,3,0,0,7
12358,dhaññanti,dhannanti,4,4,0,0,9
12359,sirīpaññā,siripanna,1,1,0,0,9
12360,puññalakkhaṇasampadaṃ,punnalakkhanasampadam,1,1,0,0,21
12361,vaṇṇoti,vannoti,39,11,28,0,7
12362,vaṇṇasampanno,vannasampanno,83,83,0,0,13
12363,sarīravaṇṇaguṇavaṇṇavasena,sariravannagunavannavasena,1,1,0,0,26
12364,sarīra,sarira,12,11,1,0,6
12365,pāsādikarūpasampannatā,pasadikarupasampannata,1,1,0,0,22
12366,sīlasamādhipaññādiguṇena,silasamadhipannadigunena,1,1,0,0,24
12367,dhutaṅgādipaṭipadāguṇena,dhutangadipatipadagunena,1,1,0,0,24
12368,sampannatā,sampannata,6,6,0,0,10
12369,vikāramāpannānaṃ,vikaramapannanam,1,1,0,0,16
12370,hadayaṅgatabhāvaṃ,hadayangatabhavam,29,27,2,0,17
12371,sarīrarūpaṃ,sarirarupam,3,3,0,0,11
12372,dabbaṃ,dabbam,136,125,11,0,6
12373,vaṇṇadhātu,vannadhatu,35,35,0,0,10
12374,yasassīti,yasassiti,17,2,15,0,9
12375,parivārasampanno,parivarasampanno,10,9,1,0,16
12376,kittivanto,kittivanto,1,1,0,0,10
12377,M0.0207,M0.0207,65,65,0,0,7
12378,yaso,yaso,401,371,30,0,4
12379,parivārakittiyasavasena,parivarakittiyasavasena,1,1,0,0,23
12380,yajiyati,yajiyati,3,3,0,0,8
12381,pūjiyati,pujiyati,2,2,0,0,8
12382,parivārenāti,parivarenati,4,2,2,0,12
12383,yajadhātu,yajadhatu,2,2,0,0,9
12384,sāmikassa,samikassa,226,220,6,0,9
12385,parivāranti,parivaranti,1,1,0,0,11
12386,yādhātu,yadhatu,4,4,0,0,7
12387,devapūjāsaṅgahakaraṇadānadhammesu,devapujasangahakaranadanadhammesu,2,2,0,0,33
12388,byāpananti,byapananti,2,2,0,0,10
12389,kittighoso,kittighoso,24,23,1,0,10
12390,sīpaccayo,sipaccayo,1,1,0,0,9
12391,atibalavadharoti,atibalavadharoti,1,0,1,0,16
12392,atibalavantadhārako,atibalavantadharako,2,2,0,0,19
12393,kāyabalañāṇabalavantaṃ,kayabalananabalavantam,1,1,0,0,22
12394,ajātasatturājādayo,ajatasatturajadayo,1,1,0,0,18
12395,pañcahatthi,pancahatthi,1,1,0,0,11
12396,dasahatthibalassa,dasahatthibalassa,1,1,0,0,17
12397,dhāraṇasamattho,dharanasamattho,4,4,0,0,15
12398,sāriputtattherādayo,sariputtattheradayo,6,6,0,0,19
12399,ñāṇabalassa,nanabalassa,4,4,0,0,11
12400,kittimāti,kittimati,3,0,3,0,9
12401,kittighosavanto,kittighosavanto,1,1,0,0,15
12402,kathiyate,kathiyate,2,2,0,0,9
12403,kitti,kitti,94,82,12,0,5
12404,mantupaccayo,mantupaccayo,3,3,0,0,12
12405,khantupetoti,khantupetoti,2,1,1,0,12
12406,khantiyā,khantiya,148,141,7,0,8
12407,khamudhātu,khamudhatu,1,1,0,0,10
12408,sahane,sahane,9,7,2,0,6
12409,tassanti,tassanti,4,4,0,0,8
12410,khantivādatāpaso,khantivadatapaso,1,1,0,0,16
12411,dukkarattā,dukkaratta,33,33,0,0,10
12412,padhānattā,padhanatta,47,47,0,0,10
12413,seṭṭhatapattā,setthatapatta,1,1,0,0,13
12414,khantī,khanti,65,53,12,0,6
12415,tapo,tapo,202,170,32,0,4
12416,titikkhā,titikkha,48,44,4,0,8
12417,khantyā,khantya,26,19,7,0,7
12418,bhiyyo,bhiyyo,960,885,75,0,6
12419,khantībalaṃ,khantibalam,8,7,1,0,11
12420,balānīkaṃ,balanikam,13,9,4,0,9
12421,sīlasamādhipaññānaṃ,silasamadhipannanam,7,7,0,0,19
12422,M0.0208,M0.0208,66,66,0,0,7
12423,khantippadhānakāraṇaṃ,khantippadhanakaranam,1,1,0,0,21
12424,khantyāyattāva,khantyayattava,2,2,0,0,14
12425,vaḍḍhare,vaddhare,3,3,0,0,8
12426,taṃtaṃkicce,tamtamkicce,2,2,0,0,11
12427,avīkalavīriyo,avikalaviriyo,1,1,0,0,13
12428,bhogavābhuñjitabbasampattisukhena,bhogavabhunjitabbasampattisukhena,1,1,0,0,33
12429,tikkhapaññavā,tikkhapannava,1,1,0,0,13
12430,samāhita,samahita,4,3,1,0,8
12431,ekaggacitto,ekaggacitto,54,53,1,0,11
12432,parahitapaṭipannako,parahitapatipannako,1,1,0,0,19
12433,ghosavanto,ghosavanto,2,2,0,0,10
12434,sattavīsatimagāthāvaṇṇanā,sattavisatimagathavannana,1,1,0,0,25
12435,puññenetenatyādigāthāya,punnenetenatyadigathaya,1,1,0,0,23
12436,kattukāmo,kattukamo,185,183,2,0,9
12437,saddhoti,saddhoti,53,25,28,0,8
12438,kammādi,kammadi,16,16,0,0,7
12439,saddahanalakkhaṇāya,saddahanalakkhanaya,2,2,0,0,19
12440,saddhāya,saddhaya,860,810,50,0,8
12441,saddahanaṃ,saddahanam,15,15,0,0,10
12442,saddahatīti,saddahatiti,14,10,4,0,11
12443,saddahanti,saddahanti,39,32,7,0,10
12444,saṃpubbadhādhātu,sampubbadhadhatu,1,1,0,0,16
12445,kammādīsu,kammadisu,33,31,2,0,9
12446,saddahanalakkhaṇā,saddahanalakkhana,8,6,2,0,17
12447,okappanalakkhaṇā,okappanalakkhana,13,10,3,0,16
12448,pasādarasā,pasadarasa,1,1,0,0,10
12449,udakappasādakamaṇi,udakappasadakamani,9,8,1,0,18
12450,pakkhandanarasā,pakkhandanarasa,6,6,0,0,15
12451,oghuttaraṇo,oghuttarano,4,4,0,0,11
12452,M0.0209,M0.0209,63,63,0,0,7
12453,akālussiyapaccupaṭṭhānā,akalussiyapaccupatthana,4,4,0,0,23
12454,adhimuttipaccupaṭṭhānā,adhimuttipaccupatthana,9,8,1,0,22
12455,saddheyyavatthupadaṭṭhānā,saddheyyavatthupadatthana,8,6,2,0,25
12456,sotāpattiyaṅgapadaṭṭhānā,sotapattiyangapadatthana,4,4,0,0,24
12457,hatthavittabījāni,hatthavittabijani,5,5,0,0,17
12458,saddhāhattho,saddhahattho,16,14,2,0,12
12459,mahānāgo,mahanago,44,42,2,0,8
12460,saddhīdha,saddhidha,22,18,4,0,9
12461,vittaṃ,vittam,172,144,28,0,6
12462,saddhābījaṃ,saddhabijam,6,6,0,0,11
12463,vuṭṭhī,vutthi,17,17,0,0,6
12464,tarati,tarati,107,96,11,0,6
12465,pātheyyaṃ,patheyyam,96,80,16,0,9
12466,dutiyā,dutiya,560,532,28,0,6
12467,saddhesiko,saddhesiko,4,4,0,0,10
12468,ariyasāvako,ariyasavako,1122,1111,11,0,11
12469,saddhādhanaṃ,saddhadhanam,34,31,3,0,12
12470,buddhe,buddhe,576,547,29,0,6
12471,saṅgharatane,sangharatane,4,4,0,0,12
12472,ativirocanti,ativirocanti,4,4,0,0,12
12473,āyunā,ayuna,91,88,3,0,5
12474,yasasā,yasasa,109,99,10,0,6
12475,saddhaṃ,saddham,496,438,58,0,7
12476,upanissāya,upanissaya,1075,1056,19,0,10
12477,samādiyati,samadiyati,139,139,0,0,10
12478,uposathakammaṃ,uposathakammam,489,479,10,0,14
12479,uppādeti,uppadeti,763,756,7,0,8
12480,abhiññaṃ,abhinnam,93,91,2,0,8
12481,samāpattiṃ,samapattim,496,483,13,0,10
12482,uppādetī,uppadeti,21,13,8,0,8
12483,dullabhā,dullabha,168,150,18,0,8
12484,saddhāsampattī,saddhasampatti,2,2,0,0,14
12485,catubbidhā,catubbidha,197,184,13,0,10
12486,āgamasaddhā,agamasaddha,4,3,1,0,11
12487,adhigamasaddhā,adhigamasaddha,13,7,6,0,14
12488,okappanasaddhā,okappanasaddha,22,15,7,0,14
12489,pasādasaddhā,pasadasaddha,14,6,8,0,12
12490,sabbaññubodhisattānaṃ,sabbannubodhisattanam,17,14,3,0,21
12491,āgatattā,agatatta,360,357,3,0,8
12492,ariyasāvakānaṃ,ariyasavakanam,34,33,1,0,14
12493,saccapaṭivedhena,saccapativedhena,11,11,0,0,16
12494,adhigatattā,adhigatatta,117,117,0,0,11
12495,saṅghoti,sanghoti,65,50,15,0,8
12496,acalabhāvena,acalabhavena,9,8,1,0,12
12497,okappanaṃ,okappanam,15,9,6,0,9
12498,buddhādīsu,buddhadisu,91,90,1,0,10
12499,pasāduppattimattā,pasaduppattimatta,1,1,0,0,17
12500,paṇidhānaṭṭhānattā,panidhanatthanatta,1,1,0,0,18
12501,sabbasaddhā,sabbasaddha,1,1,0,0,11
12502,dātaṅgupetoti,datangupetoti,1,0,1,0,13
12503,dātassa,datassa,4,4,0,0,7
12504,aṅgāya,angaya,2,2,0,0,6
12505,kāraṇabhūtāya,karanabhutaya,23,23,0,0,13
12506,dhanasampattiyā,dhanasampattiya,2,2,0,0,15
12507,dātabbavatthu,databbavatthu,5,5,0,0,13
12508,tappaṭiggāhakapuggalo,tappatiggahakapuggalo,2,2,0,0,21
12509,diyate,diyate,5,5,0,0,6
12510,aṅgīyati,angiyati,6,6,0,0,8
12511,M0.0210,M0.0210,66,66,0,0,7
12512,ñāyati,nayati,206,201,5,0,6
12513,dhanasampatti,dhanasampatti,2,2,0,0,13
12514,dātaṅgo,datango,2,2,0,0,7
12515,diyatīti,diyatiti,3,3,0,0,8
12516,dānavatthu,danavatthu,6,5,1,0,10
12517,tappaṭiggāhaka,tappatiggahaka,1,1,0,0,14
12518,sampajjāmīti,sampajjamiti,3,3,0,0,12
12519,itivuttaṭṭhakathāyaṃ,itivuttatthakathayam,1,0,1,0,20
12520,paṭiggāhako,patiggahako,35,35,0,0,11
12521,samukhībhūtakāleyeva,samukhibhutakaleyeva,1,1,0,0,20
12522,sambhavatī,sambhavati,31,26,5,0,10
12523,paramasiridharoti,paramasiridharoti,1,0,1,0,17
12524,uttamasirīdhārako,uttamasiridharako,2,2,0,0,17
12525,uttamasiriṃ,uttamasirim,2,2,0,0,11
12526,paññāpuññasarīrasobhaggasampattīnametaṃ,pannapunnasarirasobhaggasampattinametam,1,1,0,0,39
12527,puggale,puggale,545,528,17,0,7
12528,sevati,sevati,168,165,3,0,6
12529,paññāpuññasarīrasobhaggasampatti,pannapunnasarirasobhaggasampatti,1,1,0,0,32
12530,uttamā,uttama,69,66,3,0,6
12531,paramasirī,paramasiri,1,1,0,0,10
12532,paramasirīdharo,paramasiridharo,1,1,0,0,15
12533,paramasiriyā,paramasiriya,1,1,0,0,12
12534,dhāraṇasamatthoti,dharanasamatthoti,1,1,0,0,17
12535,diṭṭhadhammeti,ditthadhammeti,2,0,2,0,14
12536,paccakkhabhūte,paccakkhabhute,5,5,0,0,14
12537,diṭṭhadhammo,ditthadhammo,78,60,18,0,12
12538,paccakkhabhūto,paccakkhabhuto,17,17,0,0,14
12539,passitabboti,passitabboti,10,10,0,0,12
12540,diṭṭho,dittho,662,634,28,0,6
12541,passitabbo,passitabbo,20,19,1,0,10
12542,diṭṭhadhammoti,ditthadhammoti,19,3,16,0,14
12543,virattoti,virattoti,3,0,3,0,9
12544,kāmaguṇesu,kamagunesu,194,184,10,0,10
12545,vigataratto,vigataratto,2,2,0,0,11
12546,rajjanaṃ,rajjanam,9,9,0,0,8
12547,lajjīti,lajjiti,11,1,10,0,7
12548,pāpahirivanto,papahirivanto,2,2,0,0,13
12549,pāpajigucchanalakkhaṇāya,papajigucchanalakkhanaya,10,10,0,0,24
12550,lajjāya,lajjaya,56,55,1,0,7
12551,hirottappasampanno,hirottappasampanno,13,12,1,0,18
12552,lajjīsaddena,lajjisaddena,1,1,0,0,12
12553,lakkhaṇāhāranayena,lakkhanaharanayena,3,3,0,0,18
12554,ottappampi,ottappampi,16,13,3,0,10
12555,lakkhaṇasabhāvena,lakkhanasabhavena,1,1,0,0,17
12556,samānattā,samanatta,49,49,0,0,9
12557,nettipāḷiyaṃ,nettipaliyam,5,3,2,0,12
12558,vuttamhi,vuttamhi,18,16,2,0,8
12559,ekadhamme,ekadhamme,54,53,1,0,9
12560,ekalakkhaṇā,ekalakkhana,46,41,5,0,11
12561,sohāro,soharo,1,1,0,0,6
12562,lakkhaṇo,lakkhano,118,102,16,0,8
12563,nāmā,nama,1222,950,272,0,4
12564,lajjatīti,lajjatiti,11,11,0,0,9
12565,M0.0211,M0.0211,64,64,0,0,7
12566,lajjā,lajja,36,32,4,0,5
12567,hiri,hiri,29,24,5,0,4
12568,lajjadhātu,lajjadhatu,1,1,0,0,10
12569,kāyaduccaritādito,kayaduccaritadito,3,3,0,0,17
12570,hirottappasamannāgato,hirottappasamannagato,4,4,0,0,21
12571,kalyāṇamittoti,kalyanamittoti,9,2,7,0,14
12572,sundaramitta,sundaramitta,2,2,0,0,12
12573,kalyāṇasaddo,kalyanasaddo,7,7,0,0,12
12574,sundaravācako,sundaravacako,1,1,0,0,13
12575,anipphanna,anipphanna,2,2,0,0,10
12576,pāṭipadiko,patipadiko,7,7,0,0,10
12577,kalyaṃ,kalyam,9,9,0,0,6
12578,aṇayati,anayati,2,2,0,0,7
12579,pāpayatīti,papayatiti,3,3,0,0,10
12580,kalyāṇo,kalyano,161,160,1,0,7
12581,sumitto,sumitto,22,22,0,0,7
12582,kalyasaddūpapadaaṇadhātu,kalyasaddupapadaanadhatu,1,1,0,0,24
12583,mijjati,mijjati,18,18,0,0,7
12584,sinehatīti,sinehatiti,8,8,0,0,10
12585,mitto,mitto,273,255,18,0,5
12586,mijjiyati,mijjiyati,1,1,0,0,9
12587,sinehiyatīti,sinehiyatiti,1,1,0,0,12
12588,midadhātu,midadhatu,1,1,0,0,9
12589,hitadharasumittasampanno,hitadharasumittasampanno,1,1,0,0,24
12590,saddhāsīlasutacāgavīriyasati,saddhasilasutacagaviriyasati,1,1,0,0,28
12591,samādhipaññāguṇehi,samadhipannagunehi,1,1,0,0,18
12592,siṅgālasutte,singalasutte,2,1,1,0,12
12593,upakāro,upakaro,79,72,7,0,7
12594,sukhadukkhe,sukhadukkhe,37,34,3,0,11
12595,sakhā,sakha,160,146,14,0,5
12596,atthakkhāyī,atthakkhayi,14,14,0,0,11
12597,mittānukampako,mittanukampako,4,4,0,0,14
12598,etepi,etepi,84,79,5,0,5
12599,mitte,mitte,116,104,12,0,5
12600,viññāya,vinnaya,153,148,5,0,7
12601,payirupāseyya,payirupaseyya,31,31,0,0,13
12602,puttaṃva,puttamva,10,10,0,0,8
12603,orasaṃ,orasam,39,32,7,0,6
12604,bhāvanīyo,bhavaniyo,97,95,2,0,9
12605,vacanakkhamo,vacanakkhamo,50,49,1,0,12
12606,gambhīrañca,gambhiranca,30,28,2,0,11
12607,kattā,katta,546,518,28,0,5
12608,cāṭṭhāne,catthane,5,5,0,0,8
12609,niyojaye,niyojaye,8,7,1,0,8
12610,evarūpassa,evarupassa,260,256,4,0,10
12611,kalyāṇamittassa,kalyanamittassa,25,25,0,0,15
12612,dullabhattā,dullabhatta,16,16,0,0,11
12613,kalyāṇamittena,kalyanamittena,10,10,0,0,14
12614,abhiratakusaloti,abhiratakusaloti,1,0,1,0,16
12615,dānādipuññakusaladhammesu,danadipunnakusaladhammesu,2,2,0,0,25
12616,abhiramaṇo,abhiramano,2,2,0,0,10
12617,dānādipuññadhammā,danadipunnadhamma,1,1,0,0,17
12618,kupubba,kupubba,1,1,0,0,7
12619,M0.0212,M0.0212,64,64,0,0,7
12620,kitantasamāsoyaṃ,kitantasamasoyam,1,1,0,0,16
12621,kusalābhiratoti,kusalabhiratoti,1,1,0,0,15
12622,abhirato,abhirato,75,72,3,0,8
12623,kusalesu,kusalesu,646,595,51,0,8
12624,kusalapuññassa,kusalapunnassa,1,1,0,0,14
12625,abhiratacittasampanno,abhiratacittasampanno,1,1,0,0,21
12626,pañcasīlādirakkhoti,pancasiladirakkhoti,2,1,1,0,19
12627,pañcasīlādīnaṃ,pancasiladinam,1,1,0,0,14
12628,rakkhituṃ,rakkhitum,158,156,2,0,9
12629,gihīnaṃ,gihinam,306,289,17,0,7
12630,aṭṭhaṅguposathasīlaṃ,atthanguposathasilam,2,2,0,0,20
12631,sāmaṇerānaṃ,samaneranam,144,135,9,0,11
12632,dasaṅgasīlañca,dasangasilanca,2,2,0,0,14
12633,catupārisuddhisīlañca,catuparisuddhisilanca,3,3,0,0,21
12634,pañcasīlaṃ,pancasilam,40,39,1,0,10
12635,pañcasīlādi,pancasiladi,2,2,0,0,11
12636,samatthetīti,samatthetiti,12,11,1,0,12
12637,gahaṭṭhānaṃ,gahatthanam,65,62,3,0,11
12638,niccasīlavasena,niccasilavasena,8,8,0,0,15
12639,ussāhasamatthe,ussahasamatthe,1,1,0,0,14
12640,uposathaṅgavasena,uposathangavasena,4,4,0,0,17
12641,aṭṭhaṅgasīlaṃ,atthangasilam,4,4,0,0,13
12642,akhaṇḍaṃ,akhandam,51,40,11,0,8
12643,acchiddaṃ,acchiddam,9,8,1,0,9
12644,asabalaṃ,asabalam,5,4,1,0,8
12645,akammāsaṃ,akammasam,6,5,1,0,9
12646,sāmaṇerasīlavasena,samanerasilavasena,1,1,0,0,18
12647,dasasīlañca,dasasilanca,4,4,0,0,11
12648,bhikkhusīlavasena,bhikkhusilavasena,1,1,0,0,17
12649,sīlavipattihetu,silavipattihetu,4,4,0,0,15
12650,maraṇā,marana,1785,1782,3,0,6
12651,duggatiṃ,duggatim,1206,1199,7,0,8
12652,vinipātaṃ,vinipatam,388,386,2,0,9
12653,upapajjantī,upapajjanti,55,55,0,0,11
12654,sīlasampadāhetu,silasampadahetu,9,9,0,0,15
12655,sugatiṃ,sugatim,534,523,11,0,7
12656,saggaṃ,saggam,653,622,31,0,6
12657,sīlasampanno,silasampanno,228,222,6,0,12
12658,bhogakkhandhaṃ,bhogakkhandham,92,86,6,0,14
12659,adhigacchati,adhigacchati,169,160,9,0,12
12660,abbhuggacchati,abbhuggacchati,73,70,3,0,14
12661,catuparisaṃ,catuparisam,1,1,0,0,11
12662,visārado,visarado,233,224,9,0,8
12663,upasaṅkamati,upasankamati,185,185,0,0,12
12664,amaṅkubhūto,amankubhuto,21,21,0,0,11
12665,asammūḷho,asammulho,62,57,5,0,9
12666,upapajjatī,upapajjati,164,160,4,0,10
12667,aṭṭhakathāyañca,atthakathayanca,99,88,11,0,15
12668,sīlālaṅkārasadiso,silalankarasadiso,7,5,2,0,17
12669,sīlasadisaṃ,silasadisam,5,5,0,0,11
12670,pupphaṃ,puppham,492,454,38,0,7
12671,sīlagandhasadiso,silagandhasadiso,9,6,3,0,16
12672,gandho,gandho,482,440,42,0,6
12673,sampattiñhi,sampattinhi,3,3,0,0,11
12674,vijjā,vijja,924,839,85,0,5
12675,visodheyyā,visodheyya,1,1,0,0,10
12676,visujjhantī,visujjhanti,27,27,0,0,11
12677,ādī,adi,34,21,13,0,3
12678,visuddhīsu,visuddhisu,17,17,0,0,10
12679,M0.0213,M0.0213,66,66,0,0,7
12680,sīlavisuddhi,silavisuddhi,88,80,8,0,12
12681,nāmetaṃ,nametam,331,316,15,0,7
12682,avassayo,avassayo,125,121,4,0,8
12683,patiṭṭhā,patittha,345,318,27,0,8
12684,gati,gati,651,594,57,0,4
12685,appicchoti,appicchoti,17,7,10,0,10
12686,aniccho,aniccho,9,8,1,0,7
12687,rūpādikāmaguṇesu,rupadikamagunesu,2,2,0,0,16
12688,anicchantoti,anicchantoti,2,1,1,0,12
12689,abhāvatthohettha,abhavatthohettha,1,1,0,0,16
12690,appasaddo,appasaddo,50,46,4,0,9
12691,appaḍaṃsamakasavā,appadamsamakasava,1,1,0,0,17
12692,tātapātiādīsu,tatapatiadisu,1,1,0,0,13
12693,rūpādikāmaguṇaṃ,rupadikamagunam,1,1,0,0,15
12694,kāmataṇhā,kamatanha,171,152,19,0,9
12695,dhātvantassaccho,dhatvantassaccho,1,1,0,0,16
12696,kāmesu,kamesu,842,757,85,0,6
12697,anicchanto,anicchanto,70,69,1,0,10
12698,paccayaappiccho,paccayaappiccho,13,9,4,0,15
12699,pariyattiappiccho,pariyattiappiccho,17,12,5,0,17
12700,dhutaṅgaappiccho,dhutangaappiccho,9,6,3,0,16
12701,paṭivedhaappiccho,pativedhaappiccho,1,1,0,0,17
12702,paccayesu,paccayesu,285,271,14,0,9
12703,paccaye,paccaye,802,767,35,0,7
12704,dente,dente,52,51,1,0,5
12705,appaṃ,appam,450,414,36,0,5
12706,gaṇhati,ganhati,110,110,0,0,7
12707,appataraṃ,appataram,26,26,0,0,9
12708,anavasesagāhī,anavasesagahi,2,2,0,0,13
12709,tepiṭakopi,tepitakopi,3,3,0,0,10
12710,samāno,samano,1599,1579,20,0,6
12711,bahussutabhāvaṃ,bahussutabhavam,12,12,0,0,15
12712,jānāpetukāmo,janapetukamo,11,11,0,0,12
12713,dhutaṅgasamādānassa,dhutangasamadanassa,6,6,0,0,19
12714,dhutaṅgapariharaṇabhāvaṃ,dhutangapariharanabhavam,3,3,0,0,24
12715,jānituṃ,janitum,269,253,16,0,7
12716,sotāpannādīsu,sotapannadisu,11,10,1,0,13
12717,aññataro,annataro,1312,1281,31,0,8
12718,sotāpannādibhāvaṃ,sotapannadibhavam,7,7,0,0,17
12719,jānāpetuṃ,janapetum,45,43,2,0,9
12720,icchati,icchati,821,801,20,0,7
12721,adhigamaappiccho,adhigamaappiccho,6,4,2,0,16
12722,appicchaguṇehi,appicchagunehi,1,1,0,0,14
12723,appakodhoti,appakodhoti,2,1,1,0,11
12724,dussanalakkhaṇadosato,dussanalakkhanadosato,2,2,0,0,21
12725,virahito,virahito,47,47,0,0,8
12726,kujjhatīti,kujjhatiti,9,9,0,0,10
12727,kodhoti,kodhoti,18,9,9,0,7
12728,dosassetaṃ,dosassetam,6,6,0,0,10
12729,kodho,kodho,513,462,51,0,5
12730,andhatamaṃ,andhatamam,48,40,8,0,10
12731,sahate,sahate,66,62,4,0,6
12732,vuttadesanaṃ,vuttadesanam,1,1,0,0,12
12733,ativujuhadayoti,ativujuhadayoti,1,0,1,0,15
12734,M0.0214,M0.0214,66,66,0,0,7
12735,atieva,atieva,3,3,0,0,6
12736,ujucittasamannāgato,ujucittasamannagato,3,3,0,0,19
12737,akuṭilabhāvenāti,akutilabhavenati,1,1,0,0,16
12738,ajjavaṃ,ajjavam,29,20,9,0,7
12739,ju,ju,18,11,7,0,2
12740,hadayaṃ,hadayam,557,509,48,0,7
12741,aya,aya,63,34,29,0,3
12742,harantaṃ,harantam,7,6,1,0,8
12743,harasaddūpapada,harasaddupapada,1,1,0,0,15
12744,hadayañcāti,hadayancati,5,5,0,0,11
12745,ujuhadayaṃ,ujuhadayam,1,1,0,0,10
12746,gomuttavaṅko,gomuttavanko,6,6,0,0,12
12747,candalekhāvaṅko,candalekhavanko,4,4,0,0,15
12748,naṅgalakoṭi,nangalakoti,3,3,0,0,11
12749,vaṅko,vanko,25,20,5,0,5
12750,vaṅkehi,vankehi,4,4,0,0,7
12751,katvāva,katvava,73,71,2,0,7
12752,karomīti,karomiti,96,83,13,0,8
12753,paccosakkanatāya,paccosakkanataya,2,2,0,0,16
12754,karontova,karontova,35,35,0,0,9
12755,bhāyāmahaṃ,bhayamaham,2,2,0,0,10
12756,pāpassāti,papassati,5,1,4,0,9
12757,kuṭilatāya,kutilataya,6,6,0,0,10
12758,candalekhā,candalekha,16,16,0,0,10
12759,pāpassa,papassa,213,208,5,0,7
12760,bhāyeyyāti,bhayeyyati,5,5,0,0,10
12761,nātikuṭilatāya,natikutilataya,2,2,0,0,14
12762,naṅgalakoṭivaṅko,nangalakotivanko,5,5,0,0,16
12763,kammadvārāni,kammadvarani,14,13,1,0,12
12764,asuddhāni,asuddhani,3,3,0,0,9
12765,yāni,yani,1341,1264,77,0,4
12766,kānici,kanici,230,221,9,0,6
12767,yaṃkiñci,yamkinci,769,741,28,0,8
12768,iddhimāti,iddhimati,12,6,6,0,9
12769,iddhisaddassa,iddhisaddassa,3,3,0,0,13
12770,mānussikāle,manussikale,1,1,0,0,11
12771,manussiddhiyā,manussiddhiya,1,1,0,0,13
12772,devuppattikāle,devuppattikale,1,1,0,0,14
12773,deviddhiyā,deviddhiya,34,34,0,0,10
12774,samaṇuppattikāle,samanuppattikale,1,1,0,0,16
12775,samaṇiddhiyā,samaniddhiya,1,1,0,0,12
12776,sampuṇṇeyyanti,sampunneyyanti,1,1,0,0,14
12777,appameyyoti,appameyyoti,8,2,6,0,11
12778,appametabbehi,appametabbehi,1,1,0,0,13
12779,pametabboti,pametabboti,3,3,0,0,11
12780,pameyyo,pameyyo,3,3,0,0,7
12781,papubbamādhātu,papubbamadhatu,1,1,0,0,14
12782,pamāṇe,pamane,33,31,2,0,6
12783,sīlādiguṇo,siladiguno,4,4,0,0,10
12784,appameyyehi,appameyyehi,2,2,0,0,11
12785,M0.0215,M0.0215,63,63,0,0,7
12786,bhogasampattīhi,bhogasampattihi,1,1,0,0,15
12787,pāsaṃsoti,pasamsoti,7,6,1,0,9
12788,buddhādisappurisānaṃ,buddhadisappurisanam,6,6,0,0,20
12789,pasaṃsāraho,pasamsaraho,9,9,0,0,11
12790,pasaṃsiyate,pasamsiyate,1,1,0,0,11
12791,thaviyate,thaviyate,1,1,0,0,9
12792,pasaṃso,pasamso,1,1,0,0,7
12793,bhāva,bhava,58,52,6,0,5
12794,sādhanoyaṃ,sadhanoyam,1,1,0,0,10
12795,papubbasaṃsadhātu,papubbasamsadhatu,1,1,0,0,17
12796,thutiyaṃ,thutiyam,23,17,6,0,8
12797,buddhādisappurisehi,buddhadisappurisehi,4,4,0,0,19
12798,pasaṃsi,pasamsi,12,12,0,0,7
12799,tabbehi,tabbehi,1,1,0,0,7
12800,dānasīlādiguṇehi,danasiladigunehi,1,1,0,0,16
12801,pemavācoti,pemavacoti,1,0,1,0,10
12802,atthabyañjanamadhuratāya,atthabyanjanamadhurataya,8,8,0,0,24
12803,pemitabbavācāya,pemitabbavacaya,2,2,0,0,15
12804,piyateti,piyateti,1,1,0,0,8
12805,pemā,pema,14,14,0,0,4
12806,imo,imo,24,24,0,0,3
12807,vacitabbāti,vacitabbati,2,2,0,0,11
12808,vacadhātu,vacadhatu,1,1,0,0,9
12809,pema,pema,6,6,0,0,4
12810,vāco,vaco,3,2,1,0,4
12811,pemiyā,pemiya,1,1,0,0,6
12812,caturaṅgasamannāgata,caturangasamannagata,1,1,0,0,20
12813,caturaṅgasamannāgatā,caturangasamannagata,10,10,0,0,20
12814,subhāsitavācā,subhasitavaca,2,2,0,0,13
12815,dhammavācā,dhammavaca,1,1,0,0,10
12816,piyavācā,piyavaca,6,6,0,0,8
12817,saccavācāti,saccavacati,1,1,0,0,11
12818,tathāhetaṃ,tathahetam,2,2,0,0,10
12819,sagāthāvagga,sagathavagga,1,0,1,0,12
12820,saṃyutte,samyutte,10,9,1,0,8
12821,subhāsitaṃ,subhasitam,188,173,15,0,10
12822,uttamamāhu,uttamamahu,19,19,0,0,10
12823,santo,santo,1216,1110,106,0,5
12824,nādhammaṃ,nadhammam,8,8,0,0,9
12825,nāppiyaṃ,nappiyam,7,7,0,0,8
12826,nālikaṃ,nalikam,8,8,0,0,7
12827,catutthanti,catutthanti,8,8,0,0,11
12828,bhāsitaṃ,bhasitam,2096,2062,34,0,8
12829,āhu,ahu,307,283,24,0,3
12830,adhammaṃ,adhammam,225,210,15,0,8
12831,appiyaṃ,appiyam,97,81,16,0,7
12832,alikaṃ,alikam,80,75,5,0,6
12833,āhūti,ahuti,33,17,16,0,5
12834,sujanaguṇavidūti,sujanagunaviduti,1,0,1,0,16
12835,M0.0216,M0.0216,63,63,0,0,7
12836,vijānako,vijanako,2,2,0,0,8
12837,sujano,sujano,8,8,0,0,6
12838,guṇati,gunati,1,1,0,0,6
12839,sīlādiguṇasamaṅgitaṃ,siladigunasamangitam,1,1,0,0,20
12840,puggalanti,puggalanti,8,8,0,0,10
12841,sujanānaṃ,sujananam,2,2,0,0,9
12842,sujanaguṇo,sujanaguno,1,1,0,0,10
12843,vidati,vidati,25,25,0,0,6
12844,sujana,sujana,6,5,1,0,6
12845,guṇasaddūpapadavidadhātu,gunasaddupapadavidadhatu,1,1,0,0,24
12846,ū,u,110,67,43,0,1
12847,sīlasamādhipaññādiguṇaṃ,silasamadhipannadigunam,1,1,0,0,23
12848,māmakoti,mamakoti,8,0,8,0,8
12849,buddhādisajjanānaṃ,buddhadisajjananam,2,2,0,0,18
12850,mamāyatīti,mamayatiti,13,8,5,0,10
12851,mamadhātu,mamadhatu,1,1,0,0,9
12852,mānane,manane,1,1,0,0,6
12853,peme,peme,4,4,0,0,4
12854,buddhādiratanattayañca,buddhadiratanattayanca,2,2,0,0,22
12855,saddhammañca,saddhammanca,4,4,0,0,12
12856,mānanto,mananto,3,3,0,0,7
12857,bhavāmīti,bhavamiti,15,13,2,0,9
12858,dhana,dhana,48,30,18,0,5
12859,sampattiyā,sampattiya,128,126,2,0,10
12860,dātabba,databba,4,4,0,0,7
12861,vatthu,vatthu,2607,2467,140,0,6
12862,pañcasīlādīni,pancasiladini,2,2,0,0,13
12863,M0.0217,M0.0217,61,61,0,0,7
12864,aṭṭhavīsatimagāthāvaṇṇanā,atthavisatimagathavannana,1,1,0,0,25
12865,puññenetenatyādi,punnenetenatyadi,1,1,0,0,16
12866,buddhavandanassa,buddhavandanassa,1,1,0,0,16
12867,phalānisaṃsaṃ,phalanisamsam,4,4,0,0,13
12868,gāthāpañcakaṃ,gathapancakam,1,1,0,0,13
12869,mūlācariyehi,mulacariyehi,1,1,0,0,12
12870,hitakāmehi,hitakamehi,3,3,0,0,10
12871,gāthāpañcakanti,gathapancakanti,1,1,0,0,15
12872,gāthāyo,gathayo,911,909,2,0,7
12873,pathyāvattagāthāti,pathyavattagathati,1,1,0,0,18
12874,nāthaguṇe,nathagune,2,2,0,0,9
12875,sūcakāsu,sucakasu,2,2,0,0,8
12876,ekagāthampi,ekagathampi,8,8,0,0,11
12877,sarateti,sarateti,2,1,1,0,8
12878,sugatantiādinā,sugatantiadina,1,1,0,0,14
12879,asaṅkhayeti,asankhayeti,1,0,1,0,11
12880,buddhaguṇāti,buddhagunati,5,5,0,0,12
12881,asamatthe,asamatthe,4,4,0,0,9
12882,saṅkhiyate,sankhiyate,1,1,0,0,10
12883,saṅkhayā,sankhaya,7,7,0,0,8
12884,saṅkhiyati,sankhiyati,2,2,0,0,10
12885,gaṇiyatīti,ganiyatiti,2,2,0,0,10
12886,M0.0218,M0.0218,62,62,0,0,7
12887,sakhidhātu,sakhidhatu,1,1,0,0,10
12888,yapaccayo,yapaccayo,11,11,0,0,9
12889,saṅkhituṃ,sankhitum,1,1,0,0,9
12890,niravasesato,niravasesato,95,93,2,0,12
12891,ekabuddhopi,ekabuddhopi,2,2,0,0,11
12892,anekavassa,anekavassa,1,1,0,0,10
12893,satasahassakoṭiyāpi,satasahassakotiyapi,1,1,0,0,19
12894,asamatthova,asamatthova,3,3,0,0,11
12895,aññeti,anneti,40,19,21,0,6
12896,tathāgatassā,tathagatassa,38,35,3,0,12
12897,āḷhakena,alhakena,7,7,0,0,8
12898,mahāvaggasaṃyuttaṭṭhakathāyañca,mahavaggasamyuttatthakathayanca,1,0,1,0,31
12899,appamāṇā,appamana,160,148,12,0,8
12900,buddhāpi,buddhapi,38,37,1,0,8
12901,anavasesato,anavasesato,353,350,3,0,11
12902,vattuṃ,vattum,1511,1439,72,0,6
12903,asamatthā,asamattha,54,51,3,0,9
12904,pajā,paja,302,276,26,0,4
12905,lakkhaṇadīpiteti,lakkhanadipiteti,1,0,1,0,16
12906,upalakkhaṇa,upalakkhana,5,5,0,0,11
12907,pakāsitabbe,pakasitabbe,1,1,0,0,11
12908,padhānanayo,padhananayo,1,1,0,0,11
12909,nidassana,nidassana,6,6,0,0,9
12910,nāthaguṇeti,nathaguneti,1,0,1,0,11
12911,paññādiguṇe,pannadigune,1,1,0,0,11
12912,sūcakāsvekagāthampīti,sucakasvekagathampiti,1,0,1,0,21
12913,ekagāthampīti,ekagathampiti,2,1,1,0,13
12914,sūcakāsūti,sucakasuti,1,0,1,0,10
12915,pakāsakāsu,pakasakasu,1,1,0,0,10
12916,gāthāsūti,gathasuti,1,0,1,0,9
12917,sugatantyādinā,sugatantyadina,1,1,0,0,14
12918,chabbīsativandanagāthāsu,chabbisativandanagathasu,1,1,0,0,24
12919,niddhāraṇe,niddharane,184,179,5,0,10
12920,bhummavacanaṃ,bhummavacanam,179,171,8,0,13
12921,kavīhi,kavihi,39,33,6,0,6
12922,pajjaviseso,pajjaviseso,2,2,0,0,11
12923,gedhātu,gedhatu,1,1,0,0,7
12924,gedhātussa,gedhatussa,1,1,0,0,10
12925,gādeso,gadeso,1,1,0,0,6
12926,gaṃ,gam,30,30,0,0,3
12927,gaṃsaddūpapadathādhātu,gamsaddupapadathadhatu,1,1,0,0,22
12928,bandhitvā,bandhitva,1031,1009,22,0,9
12929,thiyati,thiyati,4,4,0,0,7
12930,thapiyatīti,thapiyatiti,1,1,0,0,11
12931,ekapajjampi,ekapajjampi,1,1,0,0,11
12932,garahattho,garahattho,22,22,0,0,10
12933,anekagāthāya,anekagathaya,1,1,0,0,12
12934,buddhaguṇasaraṇe,buddhagunasarane,1,1,0,0,16
12935,kathāvāti,kathavati,1,1,0,0,9
12936,budhoti,budhoti,6,2,4,0,7
12937,M0.0219,M0.0219,62,62,0,0,7
12938,atthānatthaṃ,atthanattham,51,47,4,0,12
12939,budhati,budhati,1,1,0,0,7
12940,jānātītibudhoti,janatitibudhoti,1,1,0,0,15
12941,chandānurakkhaṇatthañhi,chandanurakkhanatthanhi,1,1,0,0,23
12942,parassapadativibhattiyā,parassapadativibhattiya,1,1,0,0,23
12943,attanopadatevibhattādeso,attanopadatevibhattadeso,1,1,0,0,24
12944,caturāpāyamuttoti,caturapayamuttoti,1,0,1,0,17
12945,nirayatiracchānapetaasurakāyasaṅkhātehi,nirayatiracchanapetaasurakayasankhatehi,1,1,0,0,39
12946,vimutto,vimutto,365,349,16,0,7
12947,puññasammatā,punnasammata,17,15,2,0,12
12948,ayāyebhuyyena,ayayebhuyyena,1,1,0,0,13
12949,apagatoti,apagatoti,8,8,0,0,9
12950,apāyo,apayo,71,59,12,0,5
12951,ayato,ayato,24,24,0,0,5
12952,sukhato,sukhato,137,125,12,0,7
12953,sampattiyo,sampattiyo,141,133,8,0,10
12954,ayanti,ayanti,167,163,4,0,6
12955,puññato,punnato,25,16,9,0,7
12956,puññakārīhi,punnakarihi,1,1,0,0,11
12957,ayitabbo,ayitabbo,11,11,0,0,8
12958,pavattetabboti,pavattetabboti,8,8,0,0,14
12959,caturo,caturo,410,363,47,0,6
12960,caturāpāyo,caturapayo,1,1,0,0,10
12961,vimuttoti,vimuttoti,125,67,58,0,9
12962,sādhako,sadhako,20,18,2,0,7
12963,atthadvayassa,atthadvayassa,7,7,0,0,13
12964,atthadvayassāti,atthadvayassati,1,0,1,0,15
12965,diṭṭhadhammikasamparāyikasaṅkhātassa,ditthadhammikasamparayikasankhatassa,1,1,0,0,36
12966,sādhakoti,sadhakoti,4,2,2,0,9
12967,nipphādako,nipphadako,10,9,1,0,10
12968,nipphādetīti,nipphadetiti,21,20,1,0,12
12969,hato,hato,168,165,3,0,4
12970,upaddavasaṅkhātajālo,upaddavasankhatajalo,3,3,0,0,20
12971,hanayittha,hanayittha,1,1,0,0,10
12972,apanayitthāti,apanayitthati,1,1,0,0,13
12973,upaddavo,upaddavo,97,91,6,0,8
12974,jātibhayādi,jatibhayadi,1,1,0,0,11
12975,soḷasaupaddavo,solasaupaddavo,1,1,0,0,14
12976,upapubbadudhātu,upapubbadudhatu,1,1,0,0,15
12977,upaddavā,upaddava,43,41,2,0,8
12978,soḷasavidhā,solasavidha,30,28,2,0,11
12979,kumbhilabhayaṃ,kumbhilabhayam,3,3,0,0,14
12980,susukābhayaṃ,susukabhayam,17,12,5,0,12
12981,duggatibhayañcāti,duggatibhayancati,1,1,0,0,17
12982,macche,macche,141,136,5,0,6
12983,macchajālaṃ,macchajalam,2,2,0,0,11
12984,M0.0220,M0.0220,60,60,0,0,7
12985,jālo,jalo,7,7,0,0,4
12986,nitatthena,nitatthena,1,1,0,0,10
12987,buddhapaṇāmacetanāya,buddhapanamacetanaya,1,1,0,0,20
12988,pahito,pahito,53,51,2,0,6
12989,hitassa,hitassa,54,49,5,0,7
12990,lābho,labho,328,289,39,0,5
12991,hitañca,hitanca,19,18,1,0,7
12992,para31-32,para31-32,5,5,0,0,9
12993,kammatthe,kammatthe,65,59,6,0,9
12994,chaṭṭhīvacanaṃ,chatthivacanam,2,2,0,0,14
12995,adhipoti,adhipoti,2,1,1,0,8
12996,attādhīnaṃ,attadhinam,5,4,1,0,10
12997,adhiabhibhavitvā,adhiabhibhavitva,1,1,0,0,16
12998,adhipubbapādhātu,adhipubbapadhatu,1,1,0,0,16
12999,narānaṃ,naranam,83,76,7,0,7
13000,manussarājā,manussaraja,3,3,0,0,11
13001,sambhāvanatthe,sambhavanatthe,6,6,0,0,14
13002,ekadīpissararājabhāvo,ekadipissararajabhavo,1,1,0,0,21
13003,sissararājabhāvo,sissararajabhavo,1,1,0,0,16
13004,padapūraṇa,padapurana,1,1,0,0,10
13005,mattoyeva,mattoyeva,1,1,0,0,9
13006,catudīpissaroti,catudipissaroti,1,1,0,0,15
13007,pubbavideho,pubbavideho,9,7,2,0,11
13008,aparago,aparago,1,1,0,0,7
13009,yāno,yano,5,4,1,0,4
13010,jambudīpo,jambudipo,91,85,6,0,9
13011,uttarakuru,uttarakuru,15,14,1,0,10
13012,dīpānaṃ,dipanam,23,19,4,0,7
13013,cakkavattirājāpi,cakkavattirajapi,1,1,0,0,16
13014,pubbavidehoti,pubbavidehoti,1,1,0,0,13
13015,sineruno,sineruno,12,12,0,0,8
13016,pubbaṃ,pubbam,169,155,14,0,6
13017,vedena,vedena,25,23,2,0,6
13018,īhanti,ihanti,4,4,0,0,6
13019,vedeho,vedeho,82,81,1,0,6
13020,vidasaddūpapada,vidasaddupapada,1,1,0,0,15
13021,videho,videho,16,16,0,0,6
13022,dīpamupādāya,dipamupadaya,2,2,0,0,12
13023,pubbadisabhāgattā,pubbadisabhagatta,1,1,0,0,17
13024,pubbadīpo,pubbadipo,1,1,0,0,9
13025,aparagoyānoti,aparagoyanoti,1,1,0,0,13
13026,M0.0221,M0.0221,60,60,0,0,7
13027,gavena,gavena,17,17,0,0,6
13028,goyāno,goyano,4,3,1,0,6
13029,gosaddūpapada,gosaddupapada,2,2,0,0,13
13030,disabhāgattā,disabhagatta,1,1,0,0,12
13031,aparagoyāno,aparagoyano,3,2,1,0,11
13032,pacchimadīpo,pacchimadipo,1,1,0,0,12
13033,jambudīpoti,jambudipoti,3,3,0,0,11
13034,jāyatīti,jayatiti,155,127,28,0,8
13035,jambū,jambu,73,58,15,0,5
13036,yojanasatubbedho,yojanasatubbedho,11,11,0,0,16
13037,bakārāgamo,bakaragamo,1,1,0,0,10
13038,dippanti,dippanti,17,17,0,0,8
13039,saddhammāti,saddhammati,14,4,10,0,11
13040,dviāpoti,dviapoti,1,1,0,0,8
13041,padacchedaṃ,padacchedam,19,19,0,0,11
13042,āpo,apo,227,200,27,0,3
13043,sandati,sandati,91,88,3,0,7
13044,bahubbīhisamāsopi,bahubbihisamasopi,1,1,0,0,17
13045,jambuyā,jambuya,44,44,0,0,7
13046,paññāto,pannato,77,74,3,0,7
13047,dakkhiṇadīpo,dakkhinadipo,1,1,0,0,12
13048,uttarakurūti,uttarakuruti,1,1,0,0,12
13049,uttare,uttare,59,55,4,0,6
13050,uttarā,uttara,179,173,6,0,6
13051,dhammatāsiddhassa,dhammatasiddhassa,8,8,0,0,17
13052,pañcasīlassa,pancasilassa,7,7,0,0,12
13053,urumahantaṃ,urumahantam,1,1,0,0,11
13054,kuru,kuru,25,21,4,0,4
13055,rundhanti,rundhanti,13,12,1,0,9
13056,kupubbarudhidhātu,kupubbarudhidhatu,1,1,0,0,17
13057,uttaradisabhāgattā,uttaradisabhagatta,1,1,0,0,18
13058,uttaro,uttaro,162,152,10,0,6
13059,uttaradīpoti,uttaradipoti,1,1,0,0,12
13060,catudīpissaro,catudipissaro,2,1,1,0,13
13061,cakkavattirājā,cakkavattiraja,52,51,1,0,14
13062,lokiyahitaṃ,lokiyahitam,1,1,0,0,11
13063,lokuttarahitaṃ,lokuttarahitam,1,1,0,0,14
13064,subbatoti,subbatoti,4,0,4,0,9
13065,bhāvanāyānaṃ,bhavanayanam,4,4,0,0,12
13066,essatīti,essatiti,3,2,1,0,8
13067,antimeti,antimeti,1,0,1,0,8
13068,carime,carime,10,9,1,0,6
13069,pariyosāne,pariyosane,219,214,5,0,10
13070,pacchimasarīro,pacchimasariro,1,1,0,0,14
13071,deheti,deheti,1,0,1,0,6
13072,upaciyati,upaciyati,4,4,0,0,9
13073,deho,deho,27,25,2,0,4
13074,puññāpuññanti,punnapunnanti,1,1,0,0,13
13075,pacchimabhavabhūte,pacchimabhavabhute,1,1,0,0,18
13076,bhabbakulaputtabhūte,bhabbakulaputtabhute,1,1,0,0,20
13077,sarīreti,sarireti,12,5,7,0,8
13078,M0.0222,M0.0222,61,61,0,0,7
13079,vataṃ,vatam,220,172,48,0,5
13080,paṭipannaṃ,patipannam,47,46,1,0,10
13081,vakārassabbo,vakarassabbo,1,1,0,0,12
13082,bhāvanāyānamāruyhāti,bhavanayanamaruyhati,2,1,1,0,20
13083,vipassanābhāvanāsaṅkhātayānaṃ,vipassanabhavanasankhatayanam,1,1,0,0,29
13084,āruhitvāti,aruhitvati,2,2,0,0,10
13085,bhāvetabbā,bhavetabba,447,432,15,0,10
13086,vaḍḍhetabbāti,vaddhetabbati,1,1,0,0,13
13087,bhāvanā,bhavana,769,712,57,0,7
13088,tebhūmaka,tebhumaka,7,5,2,0,9
13089,saṅkhārārammaṇaṃ,sankhararammanam,28,28,0,0,16
13090,tadārammaṇaṃ,tadarammanam,207,200,7,0,12
13091,vipassanāpaññā,vipassanapanna,37,34,3,0,14
13092,samathavipassanā,samathavipassana,126,117,9,0,16
13093,bhāvanāvasena,bhavanavasena,70,65,5,0,13
13094,duvidhā,duvidha,378,362,16,0,7
13095,setachattakanti,setachattakanti,1,1,0,0,15
13096,saddantarasanniṭṭhānena,saddantarasannitthanena,1,1,0,0,23
13097,vipassanābhāvanā,vipassanabhavana,15,14,1,0,16
13098,yānaṃ,yanam,327,288,39,0,5
13099,aniccādivipassanāñāṇaṃ,aniccadivipassanananam,1,1,0,0,22
13100,bhāvanāsaṅkhātaṃ,bhavanasankhatam,3,3,0,0,16
13101,yānañcāti,yanancati,2,1,1,0,9
13102,pakatiyānasadisaṃ,pakatiyanasadisam,1,1,0,0,17
13103,anicca,anicca,15,10,5,0,6
13104,dukkhaanattayānaṃ,dukkhaanattayanam,1,1,0,0,17
13105,aniccādilakkhaṇena,aniccadilakkhanena,1,1,0,0,18
13106,paṭhamamaggena,pathamamaggena,63,62,1,0,14
13107,ādiṭṭhamariyādaṃ,aditthamariyadam,1,1,0,0,16
13108,aññanti,annanti,55,54,1,0,7
13109,odātātapattaṃ,odatatapattam,1,1,0,0,13
13110,dhavalaṃ,dhavalam,9,9,0,0,8
13111,kilesatapaṃ,kilesatapam,1,1,0,0,11
13112,chattaṃ,chattam,415,382,33,0,7
13113,taṃyeva,tamyeva,222,204,18,0,7
13114,chattakaṃ,chattakam,7,5,2,0,9
13115,setañca,setanca,11,11,0,0,7
13116,chattakañcāti,chattakancati,1,1,0,0,13
13117,arahattaphalaātapattaṃ,arahattaphalaatapattam,1,1,0,0,22
13118,arahattaphalasaṅkhātaṃ,arahattaphalasankhatam,8,7,1,0,22
13119,hutvāti,hutvati,305,207,98,0,7
13120,vūpasamati,vupasamati,18,18,0,0,10
13121,samanti,samanti,23,23,0,0,7
13122,pāpuṇissatīti,papunissatiti,12,12,0,0,13
13123,diṭṭhadhammikatthaṃ,ditthadhammikattham,3,3,0,0,19
13124,attabhāvepītiādimāha,attabhavepitiadimaha,1,0,1,0,20
13125,ratimano,ratimano,1,1,0,0,8
13126,M0.0223,M0.0223,59,59,0,0,7
13127,attabhāvepīti,attabhavepiti,1,0,1,0,13
13128,samparāyikatthaṃ,samparayikattham,6,6,0,0,16
13129,khandhapañcakassetamadhivacanaṃ,khandhapancakassetamadhivacanam,1,1,0,0,31
13130,sabbabyādhiviraho,sabbabyadhiviraho,1,1,0,0,17
13131,dīghajīvikoti,dighajivikoti,2,1,1,0,13
13132,jīvi,jivi,4,3,1,0,4
13133,sabbalokehīti,sabbalokehiti,1,0,1,0,13
13134,pūjitoti,pujitoti,22,8,14,0,8
13135,pūjitabbo,pujitabbo,2,2,0,0,9
13136,bhāvanābhiratimanoti,bhavanabhiratimanoti,1,0,1,0,20
13137,bhāvanāya,bhavanaya,1798,1781,17,0,9
13138,abhiramaṇacitto,abhiramanacitto,1,1,0,0,15
13139,janappiyoti,janappiyoti,1,0,1,0,11
13140,sabbajanehi,sabbajanehi,2,2,0,0,11
13141,piyāyitabbo,piyayitabbo,13,13,0,0,11
13142,manāpoti,manapoti,18,4,14,0,8
13143,cittavaḍḍhanako,cittavaddhanako,1,1,0,0,15
13144,chabbīsatiyā,chabbisatiya,15,15,0,0,12
13145,vandanagāthāsu,vandanagathasu,1,1,0,0,14
13146,ekagāthāmattampi,ekagathamattampi,3,3,0,0,16
13147,buddhaguṇānussaraṇe,buddhagunanussarane,1,1,0,0,19
13148,sabbagāthāyo,sabbagathayo,2,2,0,0,12
13149,vacasā,vacasa,186,174,12,0,6
13150,phalānisaṃsāni,phalanisamsani,2,2,0,0,14
13151,kathākhiladhāraṇeti,kathakhiladharaneti,2,0,2,0,19
13152,akhiladhāraṇeti,akhiladharaneti,1,1,0,0,15
13153,sabbabuddhavandanagāthāya,sabbabuddhavandanagathaya,1,1,0,0,25
13154,vattabbā,vattabba,1151,1124,27,0,8
13155,yevāti,yevati,132,122,10,0,6
13156,sabbavācako,sabbavacako,1,1,0,0,11
13157,khiyanaṃ,khiyanam,4,4,0,0,8
13158,khidhātu,khidhatu,1,1,0,0,8
13159,lapaccayo,lapaccayo,6,6,0,0,9
13160,khayaṃ,khayam,323,292,31,0,6
13161,appakaṃ,appakam,154,143,11,0,7
13162,khayasaddūpapadalādhātu,khayasaddupapadaladhatu,1,1,0,0,23
13163,dhāriyate,dhariyate,1,1,0,0,9
13164,akhilāya,akhilaya,1,1,0,0,8
13165,sabbāya,sabbaya,82,79,3,0,7
13166,akhiladhāraṇaṃ,akhiladharanam,1,1,0,0,14
13167,buddhavandanagāthāsu,buddhavandanagathasu,1,1,0,0,20
13168,gāthaṃ,gatham,820,807,13,0,6
13169,dhārayitvā,dharayitva,18,18,0,0,10
13170,yathāvuttaphalānisaṃsāni,yathavuttaphalanisamsani,1,1,0,0,24
13171,sabbabuddhavandanagāthāyo,sabbabuddhavandanagathayo,2,2,0,0,25
13172,buddhavandaneti,buddhavandaneti,1,1,0,0,15
13173,M0.0224,M0.0224,62,62,0,0,7
13174,gāthāpañcakena,gathapancakena,1,1,0,0,14
13175,yathāvutta,yathavutta,23,21,2,0,10
13176,saddahako,saddahako,1,1,0,0,9
13177,sammādiṭṭhiko,sammaditthiko,82,82,0,0,13
13178,kulaputto,kulaputto,434,432,2,0,9
13179,rattindivaṃ,rattindivam,183,170,13,0,11
13180,pubbaṇhakāle,pubbanhakale,6,6,0,0,12
13181,sāyanhakāle,sayanhakale,12,11,1,0,11
13182,vandeyyāti,vandeyyati,1,1,0,0,10
13183,pañcakagāthāvaṇṇanā,pancakagathavannana,1,1,0,0,19
13184,vanditassa,vanditassa,4,4,0,0,10
13185,namakkārassa,namakkarassa,2,2,0,0,12
13186,saddatthanayehi,saddatthanayehi,1,1,0,0,15
13187,chandālaṅkāranayehi,chandalankaranayehi,1,1,0,0,19
13188,saṇhasukhumasududdasa,sanhasukhumasududdasa,1,1,0,0,21
13189,gambhīrassa,gambhirassa,16,16,0,0,11
13190,duppaṭividhaguṇaparidīpakassa,duppatividhagunaparidipakassa,2,2,0,0,29
13191,cittapasannajanakassa,cittapasannajanakassa,1,1,0,0,21
13192,sāṭṭhakathe,satthakathe,65,65,0,0,11
13193,piṭakattaye,pitakattaye,52,52,0,0,11
13194,asaṃhira,asamhira,1,1,0,0,8
13195,visāradañāṇacārinā,visaradananacarina,1,1,0,0,18
13196,sāsanasodhakena,sasanasodhakena,1,1,0,0,15
13197,bhaddantareva,bhaddantareva,1,1,0,0,13
13198,tattheravarena,tattheravarena,1,1,0,0,14
13199,racitā,racita,58,58,0,0,6
13200,buddhaguṇappadīpikanāmikā,buddhagunappadipikanamika,3,3,0,0,25
13201,vaṇṇanā,vannana,135,130,5,0,7
13202,nigamana,nigamana,4,3,1,0,8
13203,puraṃ,puram,261,232,29,0,5
13204,nimmitena,nimmitena,3,3,0,0,9
13205,sirīpavaravijayānantayasapaṇḍita,siripavaravijayanantayasapandita,1,1,0,0,32
13206,tribhavanādityādhipatimahādhammarājādhirājāti,tribhavanadityadhipatimahadhammarajadhirajati,1,1,0,0,45
13207,lañchitanāmikena,lanchitanamikena,1,1,0,0,16
13208,piṭakattayapāḷiṃ,pitakattayapalim,1,1,0,0,16
13209,silārūḷhaṃ,silarulham,1,1,0,0,10
13210,kārayitvā,karayitva,28,28,0,0,9
13211,pañcama,pancama,12,11,1,0,7
13212,saṅgītikaraṇena,sangitikaranena,1,1,0,0,15
13213,timahādhammarājena,timahadhammarajena,1,1,0,0,18
13214,ratanāpuñjanti,ratanapunjanti,1,1,0,0,14
13215,sammate,sammate,11,11,0,0,7
13216,rājadhānībhūte,rajadhanibhute,1,1,0,0,14
13217,nānākulasaṃkiṇṇe,nanakulasamkinne,1,1,0,0,16
13218,puññadhaññavantānaṃ,punnadhannavantanam,1,1,0,0,19
13219,sādhūnañca,sadhunanca,2,2,0,0,10
13220,sīlasamādhipaññavantānaṃ,silasamadhipannavantanam,1,1,0,0,24
13221,bhikkhūnañca,bhikkhunanca,85,84,1,0,12
13222,nivāsabhūte,nivasabhute,5,5,0,0,11
13223,buddhadhammasaṅgharatanākare,buddhadhammasangharatanakare,1,1,0,0,28
13224,buddhasāsanujjotane,buddhasasanujjotane,1,1,0,0,19
13225,mantale,mantale,2,1,1,0,7
13226,parikittite,parikittite,1,1,0,0,11
13227,mahārāme,maharame,2,2,0,0,8
13228,vasantena,vasantena,104,102,2,0,9
13229,upāsaka,upasaka,178,177,1,0,7
13230,guṇasampannena,gunasampannena,1,1,0,0,14
13231,nāmikena,namikena,1,1,0,0,8
13232,upāsakena,upasakena,104,104,0,0,9
13233,tassupaṭṭhākāya,tassupatthakaya,1,1,0,0,15
13234,nāmikāya,namikaya,1,1,0,0,8
13235,samakusalacchandaṃ,samakusalacchandam,1,1,0,0,18
13236,sacchikaraṇatthāya,sacchikaranatthaya,8,8,0,0,18
13237,kārite,karite,175,160,15,0,6
13238,manorame,manorame,99,96,3,0,8
13239,limpitattā,limpitatta,1,1,0,0,10
13240,suvaṇṇavatī,suvannavati,1,1,0,0,11
13241,nāmike,namike,3,2,1,0,6
13242,M0.0225,M0.0225,61,61,0,0,7
13243,dvibhummike,dvibhummike,1,1,0,0,11
13244,mahiṭṭhakavihāre,mahitthakavihare,1,1,0,0,16
13245,sutesanabhikkhūnaṃ,sutesanabhikkhunam,1,1,0,0,18
13246,sāṭṭhakathaṃ,satthakatham,32,31,1,0,12
13247,piṭakattayaṃ,pitakattayam,61,60,1,0,12
13248,vācentena,vacentena,3,3,0,0,9
13249,adhivasantena,adhivasantena,2,2,0,0,13
13250,asaṃhiravisāradañāṇacārinā,asamhiravisaradananacarina,1,1,0,0,26
13251,pariyattisāsanahitadhammācariyagaṇassa,pariyattisasanahitadhammacariyaganassa,1,1,0,0,38
13252,jeṭṭhukkaṭṭhabhūtena,jetthukkatthabhutena,1,1,0,0,20
13253,revatābhipaṇḍitadhajasāsanavaṃsamahādhammarājagurūti,revatabhipanditadhajasasanavamsamahadhammarajaguruti,1,1,0,0,52
13254,mahāpaṇḍitāti,mahapanditati,1,0,1,0,13
13255,laddhalañchitena,laddhalanchitena,1,1,0,0,16
13256,mūladvādasasāsana,muladvadasasasana,1,1,0,0,17
13257,karamahāgaṇassa,karamahaganassa,1,1,0,0,15
13258,jeṭṭhamahānāyakabhūtena,jetthamahanayakabhutena,1,1,0,0,23
13259,sāsanāpruñño,sasanaprunno,1,0,1,0,12
13260,ācariyoti,acariyoti,21,9,12,0,9
13261,vissutena,vissutena,4,4,0,0,9
13262,sāsanasodhaka,sasanasodhaka,1,1,0,0,13
13263,mahānāyakattheravarena,mahanayakattheravarena,1,1,0,0,22
13264,vuttehi,vuttehi,212,205,7,0,7
13265,buddhaguṇappakāsakehi,buddhagunappakasakehi,1,1,0,0,21
13266,buddhaguṇapadehi,buddhagunapadehi,1,1,0,0,16
13267,atthabyañjanena,atthabyanjanena,3,3,0,0,15
13268,chandālaṅkāranayena,chandalankaranayena,1,1,0,0,19
13269,pathavīsandhārakassa,pathavisandharakassa,1,1,0,0,20
13270,udakakkhandhassa,udakakkhandhassa,2,2,0,0,16
13271,pabbatena,pabbatena,23,23,0,0,9
13272,paṭicchādetvā,paticchadetva,257,252,5,0,13
13273,ṭhapitassa,thapitassa,46,44,2,0,10
13274,atiduddasassa,atiduddasassa,1,1,0,0,13
13275,satadhā,satadha,33,33,0,0,7
13276,bhinnassa,bhinnassa,52,51,1,0,9
13277,vālassa,valassa,28,27,1,0,7
13278,aggakoṭiyā,aggakotiya,10,10,0,0,10
13279,atisaṇha,atisanha,1,1,0,0,8
13280,sukhumassa,sukhumassa,13,13,0,0,10
13281,puthujjanañāṇena,puthujjanananena,1,1,0,0,16
13282,līnatthappakāsanā,linatthappakasana,221,221,0,0,17
13283,saṃvaṇṇanā,samvannana,108,103,5,0,10
13284,aṭṭhakathāṭīkāsu,atthakathatikasu,13,13,0,0,16
13285,saṃvaṇṇanānayaṃ,samvannananayam,3,3,0,0,15
13286,paññāpāṭavatthāya,pannapatavatthaya,1,1,0,0,17
13287,sāsanavuddhiyā,sasanavuddhiya,1,1,0,0,14
13288,ettāvatā,ettavata,1389,1328,61,0,8
13289,sampatte,sampatte,457,454,3,0,8
13290,cakkavasse,cakkavasse,1,1,0,0,10
13291,dvisahasse,dvisahasse,5,5,0,0,10
13292,catūsate,catusate,1,1,0,0,8
13293,navādhikāsitīyā,navadhikasitiya,1,1,0,0,15
13294,sakkarāje,sakkaraje,9,9,0,0,9
13295,sattatisatasahassa,sattatisatasahassa,1,1,0,0,18
13296,vasse,vasse,241,236,5,0,5
13297,phussamāsasseva,phussamasasseva,1,1,0,0,15
13298,kālapakkhasattame,kalapakkhasattame,1,1,0,0,17
13299,suniṭṭhitā,sunitthita,4,4,0,0,10
13300,sāmañña,samanna,19,18,1,0,7
13301,saṅkharontena,sankharontena,12,12,0,0,13
13302,pasutaṃ,pasutam,78,66,12,0,7
13303,aññampi,annampi,401,383,18,0,7
13304,sambodhimuttamaṃ,sambodhimuttamam,75,71,4,0,16
13305,M0.0226,M0.0226,61,61,0,0,7
13306,tārayitvā,tarayitva,7,7,0,0,9
13307,taṇhakkhayaṃ,tanhakkhayam,37,20,17,0,12
13308,sacchikāreyyaṃ,sacchikareyyam,1,1,0,0,14
13309,maggañāṇuttarena,maggananuttarena,1,1,0,0,16
13310,rakkhantu,rakkhantu,11,11,0,0,9
13311,dhammeneva,dhammeneva,82,79,3,0,10
13312,pajaṃ,pajam,170,144,26,0,5
13313,sukhī,sukhi,303,291,12,0,5
13314,hontu,hontu,410,400,10,0,5
13315,jotentu,jotentu,4,4,0,0,7
13316,jinasāsanaṃ,jinasasanam,112,104,8,0,11
13317,mrammaraṭṭhe,mrammaratthe,2,2,0,0,12
13318,sabbadā,sabbada,461,449,12,0,7
13319,nirupaddavā,nirupaddava,12,12,0,0,11
13320,kalyāṇasaṅkappā,kalyanasankappa,7,7,0,0,15
13321,pappontu,pappontu,15,14,1,0,8
13322,mahāpaṇāmapāṭha,mahapanamapatha,1,1,0,0,15
13323,buddhavandanā,buddhavandana,2,2,0,0,13
13324,ne,ne,458,431,27,0,2
13325,nesaṃ,nesam,2191,2066,125,0,5
13326,heḷātakkāro,helatakkaro,1,1,0,0,11
13327,jantūnaṃ,jantunam,22,17,5,0,8
13328,lokandhaṃ,lokandham,1,1,0,0,9
13329,nakko,nakko,3,2,1,0,5
13330,sattambojaṃ,sattambojam,1,1,0,0,11
13331,jinasūriyo,jinasuriyo,2,2,0,0,10
13332,tibhavanabhe,tibhavanabhe,1,1,0,0,12
13333,muhatimiraṃ,muhatimiram,1,1,0,0,11
13334,abhitapaye,abhitapaye,1,1,0,0,10
13335,jeno,jeno,1,1,0,0,4
13336,jinamūle,jinamule,1,1,0,0,8
13337,janakāyaṃ,janakayam,12,11,1,0,9
13338,saṃsāranimuggaṃ,samsaranimuggam,1,1,0,0,15
13339,micchaṃ,miccham,3,3,0,0,7
13340,karupetaṃ,karupetam,1,1,0,0,9
13341,mokkhaṃ,mokkham,46,41,5,0,7
13342,vattesi,vattesi,12,12,0,0,7
13343,dayāṇā,dayana,1,1,0,0,6
13344,sutāyubhariyā,sutayubhariya,1,1,0,0,13
13345,dhanaṅgamapi,dhanangamapi,1,1,0,0,12
13346,cajjaṃ,cajjam,1,1,0,0,6
13347,cinaṃ,cinam,4,3,1,0,5
13348,budhinidāne,budhinidane,1,1,0,0,11
13349,agā,aga,96,95,1,0,3
13350,muniyaṃ,muniyam,1,1,0,0,7
13351,sasajātiya,sasajatiya,1,1,0,0,10
13352,cajjiya,cajjiya,1,1,0,0,7
13353,dānavarañca,danavaranca,1,1,0,0,11
13354,nāgusabho,nagusabho,1,1,0,0,9
13355,varasīlaṃ,varasilam,1,1,0,0,9
13356,pūrayi,purayi,5,5,0,0,6
13357,samparicāgo,samparicago,1,1,0,0,11
13358,nekkhammaggaṃ,nekkhammaggam,1,1,0,0,13
13359,senabbidvā,senabbidva,1,1,0,0,10
13360,paññāseṭṭhaṃ,pannasettham,1,1,0,0,12
13361,vedehindo,vedehindo,1,1,0,0,9
13362,vīrukkaṃsaṃ,virukkamsam,1,1,0,0,11
13363,khantīvādī,khantivadi,1,1,0,0,10
13364,khantīseṭṭhaṃ,khantisettham,1,1,0,0,13
13365,sutasomo,sutasomo,33,32,1,0,8
13366,tathagaṃ,tathagam,1,1,0,0,8
13367,temiya,temiya,4,4,0,0,6
13368,dhiṭṭhānavaraṃ,dhitthanavaram,1,1,0,0,14
13369,ekabhugo,ekabhugo,1,1,0,0,8
13370,mettavaraṃ,mettavaram,1,1,0,0,10
13371,lomahasopekkhataraṃ,lomahasopekkhataram,1,1,0,0,19
13372,tidukkarāva,tidukkarava,1,1,0,0,11
13373,pūriyāna,puriyana,1,1,0,0,8
13374,seṭṭhabodhi,setthabodhi,1,1,0,0,11
13375,pāpuṇittha,papunittha,3,3,0,0,10
13376,anantadhammasāradaṃ,anantadhammasaradam,1,1,0,0,19
13377,cakkavattikaṃ,cakkavattikam,2,2,0,0,13
13378,karopanīta,karopanita,1,1,0,0,10
13379,maddiyaṃ,maddiyam,1,1,0,0,8
13380,bhusidhare,bhusidhare,1,1,0,0,10
13381,sasenakaṃ,sasenakam,8,7,1,0,9
13382,ajeni,ajeni,1,1,0,0,5
13383,pāpimaṃ,papimam,6,6,0,0,7
13384,athuttaraṃ,athuttaram,1,1,0,0,10
13385,jayākaraṃ,jayakaram,1,1,0,0,9
13386,bahūpakārataṃ,bahupakaratam,43,36,7,0,13
13387,nimmisakkhibhi,nimmisakkhibhi,1,1,0,0,14
13388,udikkhate,udikkhate,1,1,0,0,9
13389,caṅkame,cankame,153,149,4,0,7
13390,maruvimati,maruvimati,1,1,0,0,10
13391,chindayaṃ,chindayam,1,1,0,0,9
13392,kami,kami,2,1,1,0,4
13393,rataniye,rataniye,1,1,0,0,8
13394,iddhipāṭihiraṇakaro,iddhipatihiranakaro,1,1,0,0,19
13395,cakkhumaṃ,cakkhumam,8,7,1,0,9
13396,tamabhipaṇame,tamabhipaname,1,1,0,0,13
13397,ratanaghare,ratanaghare,9,9,0,0,11
13398,chadidhiti,chadidhiti,1,1,0,0,10
13399,janayaṃ,janayam,6,5,1,0,7
13400,sīmīsā,simisa,1,1,0,0,6
13401,tamabhidhammaṃ,tamabhidhammam,1,1,0,0,14
13402,nigrodhantika,nigrodhantika,1,1,0,0,13
13403,nubbhavī,nubbhavi,1,1,0,0,8
13404,vicinaṃ,vicinam,34,26,8,0,7
13405,nadhīvaro,nadhivaro,1,1,0,0,9
13406,kicchāladdha,kicchaladdha,1,1,0,0,12
13407,manaññabodhiyaṃ,manannabodhiyam,1,1,0,0,15
13408,nigrocaraṃ,nigrocaram,1,1,0,0,10
13409,sabbhogehi,sabbhogehi,1,1,0,0,10
13410,mucalindena,mucalindena,4,4,0,0,11
13411,nāgindena,nagindena,2,2,0,0,9
13412,rahasi,rahasi,36,34,2,0,6
13413,pāvutto,pavutto,1,1,0,0,7
13414,sokhyaṃ,sokhyam,19,12,7,0,7
13415,nubhavi,nubhavi,2,2,0,0,7
13416,vimuttiṃtaṃ,vimuttimtam,1,1,0,0,11
13417,mārāji,maraji,1,1,0,0,6
13418,atulappañño,atulappanno,1,1,0,0,11
13419,rājāyatane,rajayatane,8,8,0,0,10
13420,bhoja,bhoja,1,1,0,0,5
13421,muḷāraṃ,mularam,1,1,0,0,7
13422,bhojjarasekaṃ,bhojjarasekam,1,1,0,0,13
13423,vāsa,vasa,6,3,3,0,4
13424,makā,maka,8,8,0,0,4
13425,nantagguṇadhāro,nantaggunadharo,1,1,0,0,15
13426,ekagato,ekagato,1,1,0,0,7
13427,keyyaṃ,keyyam,2,2,0,0,6
13428,abhijayaketuṃ,abhijayaketum,1,1,0,0,13
13429,jeyyaṃ,jeyyam,8,6,2,0,6
13430,varajayapānaṃ,varajayapanam,1,1,0,0,13
13431,peyyaṃ,peyyam,40,38,2,0,6
13432,suvici,suvici,1,1,0,0,6
13433,samatamupekkhiṃ,samatamupekkhim,1,1,0,0,15
13434,sattāhe,sattahe,118,108,10,0,7
13435,vijitāvī,vijitavi,90,78,12,0,8
13436,khepiya,khepiya,1,1,0,0,7
13437,nigrodhaṃ,nigrodham,34,32,2,0,9
13438,dhammasududdasyaṃ,dhammasududdasyam,1,1,0,0,17
13439,pposukka,pposukka,1,1,0,0,8
13440,vitakko,vitakko,1070,1018,52,0,7
13441,marugaṇehi,maruganehi,1,1,0,0,10
13442,brahmunā,brahmuna,251,246,5,0,8
13443,ratanadāmameruṇā,ratanadamameruna,1,1,0,0,16
13444,dadā,dada,8,6,2,0,4
13445,samabhiyācito,samabhiyacito,1,1,0,0,13
13446,paṭissavaṃ,patissavam,14,13,1,0,10
13447,desituṃ,desitum,8,8,0,0,7
13448,isippātakkānanañca,isippatakkanananca,1,1,0,0,18
13449,migaddāyaṃ,migaddayam,1,1,0,0,10
13450,desayittha,desayittha,6,6,0,0,10
13451,saccappakāraṃ,saccappakaram,1,1,0,0,13
13452,chabbīdhaṃsu,chabbidhamsu,1,1,0,0,12
13453,magadhassa,magadhassa,1,1,0,0,10
13454,katappaṭiñño,katappatinno,1,1,0,0,12
13455,gantvānatha,gantvanatha,1,1,0,0,11
13456,rājagahaṃ,rajagaham,531,489,42,0,9
13457,vineti,vineti,118,117,1,0,6
13458,malarogayute,malarogayute,1,1,0,0,12
13459,gadaggaṃ,gadaggam,1,1,0,0,8
13460,pāyetuna,payetuna,1,1,0,0,8
13461,paṇame,paname,2,2,0,0,6
13462,bhisakkaṃ,bhisakkam,19,18,1,0,9
13463,sakyādhivāse,sakyadhivase,1,1,0,0,12
13464,kapile,kapile,5,5,0,0,6
13465,saññatiṃ,sannatim,1,1,0,0,8
13466,mānaddhajaṃ,manaddhajam,11,8,3,0,11
13467,bhindiya,bhindiya,6,6,0,0,8
13468,middhivātā,middhivata,1,1,0,0,10
13469,dhammāmataṃ,dhammamatam,24,23,1,0,11
13470,pāyi,payi,2,1,1,0,4
13471,pituppabhuti,pituppabhuti,1,1,0,0,12
13472,sakyinda,sakyinda,1,1,0,0,8
13473,manomadassiṃ,manomadassim,1,1,0,0,12
13474,anāthapiṇḍoti,anathapindoti,1,1,0,0,13
13475,vhayena,vhayena,2,2,0,0,7
13476,nanta,nanta,8,7,1,0,5
13477,ddhanaṃ,ddhanam,1,1,0,0,7
13478,cajitvā,cajitva,69,66,3,0,7
13479,sukate,sukate,25,23,2,0,6
13480,vihāre,vihare,1308,1278,30,0,6
13481,vihāsi,vihasi,370,369,1,0,6
13482,janatā,janata,134,130,4,0,6
13483,hitatthaṃ,hitattham,13,13,0,0,9
13484,sudhammabheriṃ,sudhammabherim,1,1,0,0,14
13485,vadayaṃ,vadayam,1,1,0,0,7
13486,bhivande,bhivande,3,3,0,0,8
13487,upetapuññaṃ,upetapunnam,1,1,0,0,11
13488,varalakkhaṇokaṃ,varalakkhanokam,1,1,0,0,15
13489,ṇokaṃ,nokam,1,1,0,0,5
13490,jalitappadīmaṃ,jalitappadimam,1,1,0,0,14
13491,anighaṃ,anigham,5,5,0,0,7
13492,navajjaṃ,navajjam,1,1,0,0,8
13493,navajjavācaṃ,navajjavacam,1,1,0,0,12
13494,munibhānu,munibhanu,1,1,0,0,9
13495,dhammapabhāhi,dhammapabhahi,1,1,0,0,13
13496,jana,jana,51,21,30,0,4
13497,mbuja,mbuja,3,2,1,0,5
13498,muddhatandhatamo,muddhatandhatamo,1,1,0,0,16
13499,sutapo,sutapo,1,1,0,0,6
13500,karuṇāruṇo,karunaruno,3,3,0,0,10
13501,samabodhayi,samabodhayi,1,1,0,0,11
13502,bhavisītalattapano,bhavisitalattapano,1,1,0,0,18
13503,viyambaramajjhatale,viyambaramajjhatale,1,1,0,0,19
13504,tāragaṇena,taraganena,1,1,0,0,10
13505,ariyagaṇapparito,ariyaganapparito,1,1,0,0,16
13506,tibhave,tibhave,7,7,0,0,7
13507,sādara,sadara,4,2,2,0,6
13508,muggatasobha,muggatasobha,1,1,0,0,12
13509,mavandi,mavandi,3,3,0,0,7
13510,mūlāmūlā,mulamula,1,1,0,0,8
13511,tiṃsatipāramiyo,timsatiparamiyo,1,1,0,0,15
13512,sākhāsākhā,sakhasakha,1,1,0,0,10
13513,majjhimajjhānakāyā,majjhimajjhanakaya,1,1,0,0,18
13514,pattāpattā,pattapatta,1,1,0,0,10
13515,buddhacakkhuni,buddhacakkhuni,1,1,0,0,14
13516,pupphāpupphā,pupphapuppha,1,1,0,0,12
13517,kāruṇā,karuna,1,1,0,0,6
13518,maggakhandho,maggakhandho,1,1,0,0,12
13519,sārāsārā,sarasara,1,1,0,0,8
13520,pheggubhiññā,pheggubhinna,1,1,0,0,12
13521,sabbālambaṅkurakaṃ,sabbalambankurakam,1,1,0,0,18
13522,sīlavaṇṭaṃ,silavantam,1,1,0,0,10
13523,sesādhammā,sesadhamma,1,1,0,0,10
13524,madhupakkapphalāni,madhupakkapphalani,1,1,0,0,18
13525,raṃsīchallī,ramsichalli,1,1,0,0,11
13526,sutacā,sutaca,1,1,0,0,6
13527,chāyupagā,chayupaga,1,1,0,0,9
13528,suṃ,sum,60,59,1,0,3
13529,puthunaradevā,puthunaradeva,1,1,0,0,13
13530,mārajidīpaṅkara,marajidipankara,1,1,0,0,15
13531,mahijātaṃ,mahijatam,1,1,0,0,9
13532,patthatanantañca,patthatanantanca,1,1,0,0,16
13533,kusalabījaṃ,kusalabijam,8,8,0,0,11
13534,ekaruhaṃ,ekaruham,1,1,0,0,8
13535,pādapamuni,padapamuni,1,1,0,0,10
13536,māratitthiyaripuṃ,maratitthiyaripum,1,1,0,0,17
13537,tamañca,tamanca,3,3,0,0,7
13538,dhaṃsayaṃ,dhamsayam,1,1,0,0,9
13539,nagaradhamma,nagaradhamma,1,1,0,0,12
13540,māpayaṃ,mapayam,1,1,0,0,7
13541,sīlanīvaraṇa,silanivarana,1,1,0,0,12
13542,dvārakoṭṭhakaṃ,dvarakotthakam,18,16,2,0,14
13543,esikāparamasaddha,esikaparamasaddha,1,1,0,0,17
13544,muttamaṃ,muttamam,33,31,2,0,8
13545,para34,para34,486,486,0,0,6
13546,dvārapālasuyataṃ,dvarapalasuyatam,1,1,0,0,16
13547,satiṭālaṃ,satitalam,1,1,0,0,9
13548,ñāṇacaccara,nanacaccara,1,1,0,0,11
13549,sighāṭapadiddhiṃ,sighatapadiddhim,1,1,0,0,16
13550,dhammamaggakuṭisāla,dhammamaggakutisala,1,1,0,0,19
13551,sahittaṃ,sahittam,1,1,0,0,8
13552,dhammasenapatisārijabhūtaṃ,dhammasenapatisarijabhutam,1,1,0,0,26
13553,para35,para35,489,489,0,0,6
13554,dutiyasutaparohitaṃ,dutiyasutaparohitam,1,1,0,0,19
13555,dhutaguṇadharamaggha,dhutagunadharamaggha,1,1,0,0,20
13556,dassikaṃ,dassikam,1,1,0,0,8
13557,vinayacinaka,vinayacinaka,1,1,0,0,12
13558,dhammarakkhakaṃ,dhammarakkhakam,1,1,0,0,15
13559,tibhavapatika,tibhavapatika,1,1,0,0,13
13560,dhammarājiyaṃ,dhammarajiyam,1,1,0,0,13
13561,para36,para36,482,482,0,0,6
13562,sutaṃ,sutam,2434,1959,475,0,5
13563,sajjanaṃjanaṃ,sajjanamjanam,3,2,1,0,13
13564,nantaguṇālayaṃ,nantagunalayam,1,1,0,0,14
13565,layaṃ,layam,19,15,4,0,5
13566,hutaṃ,hutam,118,96,22,0,5
13567,jantunamānamaṃ,jantunamanamam,1,1,0,0,14
13568,tebhavamaṅgalaṃ,tebhavamangalam,1,1,0,0,15
13569,galaṃ,galam,3,3,0,0,5
13570,para37,para37,469,469,0,0,6
13571,lokābhirāmaṃ,lokabhiramam,1,1,0,0,12
13572,ramaṇeyyaveduraṃ,ramaneyyaveduram,1,1,0,0,16
13573,lokantaguṃ,lokantagum,1,1,0,0,10
13574,antubhayānupāgataṃ,antubhayanupagatam,1,1,0,0,18
13575,lokaddhajaṃ,lokaddhajam,1,1,0,0,11
13576,mānadhajappahārakaṃ,manadhajappaharakam,1,1,0,0,19
13577,lokaggaruṃ,lokaggarum,1,1,0,0,10
13578,aggaru,aggaru,1,1,0,0,6
13579,para38,para38,460,460,0,0,6
13580,makuṭaggaphalaṃ,makutaggaphalam,1,1,0,0,15
13581,nayanañcanikaṃ,nayanancanikam,1,1,0,0,14
13582,savanabbhusanaṃ,savanabbhusanam,1,1,0,0,15
13583,vadanabbhusanaṃ,vadanabbhusanam,1,1,0,0,15
13584,galamaṇḍanamiddhi,galamandanamiddhi,1,1,0,0,17
13585,manaññurasaṃ,manannurasam,1,1,0,0,12
13586,kiriyaññudaraṃ,kiriyannudaram,1,1,0,0,14
13587,dvikhaṇaññukaraṃ,dvikhanannukaram,1,1,0,0,16
13588,para39,para39,464,464,0,0,6
13589,kaṭivibhūsana,kativibhusana,1,1,0,0,13
13590,majjhimaññaṇakaṃ,majjhimannanakam,1,1,0,0,16
13591,dayavilepana,dayavilepana,1,1,0,0,12
13592,dhāraṇamaṇḍanaṃ,dharanamandanam,1,1,0,0,15
13593,paṭakhilaññunivattha,patakhilannunivattha,1,1,0,0,20
13594,manuttaraṃ,manuttaram,3,3,0,0,10
13595,munimaruttama,munimaruttama,1,1,0,0,13
13596,meka,meka,1,1,0,0,4
13597,mahaṃ,maham,61,58,3,0,5
13598,para40,para40,460,460,0,0,6
13599,sativara,sativara,1,1,0,0,8
13600,sucakaṃ,sucakam,1,1,0,0,7
13601,ibbhaggapaññaṃ,ibbhaggapannam,1,1,0,0,14
13602,suvīriyavasuvāhaṃ,suviriyavasuvaham,1,1,0,0,17
13603,pītiselaṃ,pitiselam,1,1,0,0,9
13604,gahapatisamathaggaṃ,gahapatisamathaggam,1,1,0,0,19
13605,thīpasaddhiṃ,thipasaddhim,1,1,0,0,12
13606,asaṇiyasunupekkhaṃ,asaniyasunupekkham,1,1,0,0,18
13607,sattabhogaṃ,sattabhogam,1,1,0,0,11
13608,para41,para41,456,456,0,0,6
13609,catudisikiddhippada,catudisikiddhippada,1,1,0,0,19
13610,masahāyaṃ,masahayam,1,1,0,0,9
13611,suparivutaṃ,suparivutam,2,2,0,0,11
13612,khattiyavirajānaṃ,khattiyavirajanam,1,1,0,0,17
13613,suciparisaṃ,suciparisam,1,1,0,0,11
13614,devanara,devanara,1,1,0,0,8
13615,manāpaṃ,manapam,359,336,23,0,7
13616,dasabalacakkādhipati,dasabalacakkadhipati,1,1,0,0,20
13617,para42,para42,447,447,0,0,6
13618,samādhibbahiddhaṃ,samadhibbahiddham,1,1,0,0,17
13619,saticchaṭṭhaselaṃ,saticchatthaselam,1,1,0,0,17
13620,virappañcamā,virappancama,1,1,0,0,12
13621,jīvamajjhaṃ,jivamajjham,1,1,0,0,11
13622,sukamma,sukamma,1,1,0,0,7
13623,ttatiyaṃ,ttatiyam,1,1,0,0,8
13624,suvācādutiyaṃ,suvacadutiyam,1,1,0,0,13
13625,bhiseṭṭhaṃ,bhisettham,1,1,0,0,10
13626,samātakkapubbañca,samatakkapubbanca,1,1,0,0,17
13627,sattappavāraṃ,sattappavaram,1,1,0,0,13
13628,para43,para43,445,445,0,0,6
13629,vividhañāṇapabhutibbasākaraṃ,vividhananapabhutibbasakaram,1,1,0,0,28
13630,bahumahiddhika,bahumahiddhika,1,1,0,0,14
13631,marūna,maruna,1,1,0,0,6
13632,māsayaṃ,masayam,1,1,0,0,7
13633,dhuṃvapabhājalitarāmaṇeyyakaṃ,dhumvapabhajalitaramaneyyakam,1,1,0,0,29
13634,sugatanerunagarāja,sugatanerunagaraja,1,1,0,0,18
13635,māname,maname,1,1,0,0,6
13636,para44,para44,445,445,0,0,6
13637,sīlajjalaṃ,silajjalam,1,1,0,0,10
13638,ratanadhamma,ratanadhamma,1,1,0,0,12
13639,mākaraṃ,makaram,1,1,0,0,7
13640,bhiññāviciṃ,bhinnavicim,1,1,0,0,11
13641,satikulaṭṭhi,satikulatthi,1,1,0,0,12
13642,gambhiraṃ,gambhiram,1,1,0,0,9
13643,vitthiṇṇañāṇa,vitthinnanana,1,1,0,0,13
13644,mariyodajāsayaṃ,mariyodajasayam,1,1,0,0,15
13645,aṭṭhambīdhacchariyakaṃ,atthambidhacchariyakam,1,1,0,0,22
13646,asandanaṃ,asandanam,1,1,0,0,9
13647,para45,para45,442,442,0,0,6
13648,bahunajjamosaraṇa,bahunajjamosarana,1,1,0,0,17
13649,mekarasaṃ,mekarasam,1,1,0,0,9
13650,durupaggamaṃ,durupaggamam,1,1,0,0,12
13651,acitasambharinaṃ,acitasambharinam,1,1,0,0,16
13652,puthupotapuññavatameva,puthupotapunnavatameva,1,1,0,0,22
13653,dvīpaduttamaṇṇava,dvipaduttamannava,1,1,0,0,17
13654,nadindavaraṃ,nadindavaram,1,1,0,0,12
13655,para46,para46,433,433,0,0,6
13656,abhiniharadhanuṃ,abhiniharadhanum,1,1,0,0,16
13657,guṇapāramiṃ,gunaparamim,3,2,1,0,11
13658,naḷamatimanabājarahammukhā,nalamatimanabajarahammukha,1,1,0,0,26
13659,dhitisamitasarena,dhitisamitasarena,1,1,0,0,17
13660,sudhārayaṃ,sudharayam,1,1,0,0,10
13661,malama,malama,1,1,0,0,6
13662,gagaṇa,gagana,2,2,0,0,6
13663,mekapavedanā,mekapavedana,1,1,0,0,12
13664,para47,para47,430,430,0,0,6
13665,pāvedhesiṃ,pavedhesim,1,1,0,0,10
13666,aggamaggañca,aggamagganca,1,1,0,0,12
13667,tūṇiṃ,tunim,1,1,0,0,5
13668,dhammālaṅkārabbamma,dhammalankarabbamma,1,1,0,0,19
13669,mekabbalaṃ,mekabbalam,1,1,0,0,10
13670,nettiṃsānantañāṇa,nettimsanantanana,1,1,0,0,17
13671,gīrellimantaṃ,girellimantam,1,1,0,0,13
13672,sabbaññussāsaṃ,sabbannussasam,1,1,0,0,14
13673,iddhidaṇḍaṃ,iddhidandam,1,1,0,0,11
13674,para48,para48,426,426,0,0,6
13675,varatapavuṭṭhi,varatapavutthi,1,1,0,0,14
13676,subījakasaddhā,subijakasaddha,1,1,0,0,14
13677,matiyuganaṅgala,matiyuganangala,1,1,0,0,15
13678,hīrutapīsā,hirutapisa,1,1,0,0,10
13679,susamatharajju,susamatharajju,1,1,0,0,14
13680,satidvijatuttaṃ,satidvijatuttam,1,1,0,0,15
13681,vīriyadurāvaha,viriyaduravaha,1,1,0,0,14
13682,saccanidānaṃ,saccanidanam,1,1,0,0,12
13683,para49,para49,432,432,0,0,6
13684,vatisaṃvaraṃ,vatisamvaram,1,1,0,0,12
13685,soratamocanañcaṃ,soratamocanancam,1,1,0,0,16
13686,nivattabbahanatthaṃ,nivattabbahanattham,1,1,0,0,19
13687,amatapphalaṃ,amatapphalam,4,4,0,0,12
13688,nekarasehupetaṃ,nekarasehupetam,1,1,0,0,15
13689,mahākassaka,mahakassaka,1,1,0,0,11
13690,mābhivande,mabhivande,1,1,0,0,10
13691,para50,para50,436,436,0,0,6
13692,devaggo,devaggo,1,1,0,0,7
13693,tidasapure,tidasapure,8,8,0,0,10
13694,varāsane,varasane,3,3,0,0,8
13695,janikapabhutinaṃ,janikapabhutinam,1,1,0,0,16
13696,bhidhammaṃ,bhidhammam,1,1,0,0,10
13697,bālakkova,balakkova,1,1,0,0,9
13698,laḷayamācale,lalayamacale,1,1,0,0,12
13699,timāsaṃ,timasam,2,2,0,0,7
13700,desesyā,desesya,1,1,0,0,7
13701,paravisayaṃ,paravisayam,15,14,1,0,11
13702,ajeyyo,ajeyyo,9,9,0,0,6
13703,para51,para51,421,421,0,0,6
13704,mahāyaso,mahayaso,176,174,2,0,8
13705,vividhasubhappakāsakaṃ,vividhasubhappakasakam,1,1,0,0,22
13706,kurūsu,kurusu,35,30,5,0,6
13707,tamonudo,tamonudo,36,29,7,0,8
13708,parappavādahari,parappavadahari,1,1,0,0,15
13709,subhānuyoginaṃ,subhanuyoginam,1,1,0,0,14
13710,kathayi,kathayi,1,1,0,0,7
13711,satippaṭhānakaṃ,satippathanakam,1,1,0,0,15
13712,para52,para52,414,414,0,0,6
13713,samathakapaliko,samathakapaliko,1,1,0,0,15
13714,sasnehasammāsati,sasnehasammasati,1,1,0,0,16
13715,paramamatiginī,paramamatigini,1,1,0,0,14
13716,savaṭṭiparakkamo,savattiparakkamo,1,1,0,0,16
13717,sakalajutikaro,sakalajutikaro,1,1,0,0,14
13718,sudhammapadīpako,sudhammapadipako,1,1,0,0,16
13719,ima,ima,73,32,41,0,3
13720,mupajalito,mupajalito,1,1,0,0,10
13721,namāmahaṃ,namamaham,8,8,0,0,9
13722,para53,para53,412,412,0,0,6
13723,vigatagatamalaṃ,vigatagatamalam,1,1,0,0,15
13724,malagatavigataṃ,malagatavigatam,1,1,0,0,15
13725,mahita,mahita,1,1,0,0,6
13726,hitamanaṃ,hitamanam,1,1,0,0,9
13727,manahitamahitaṃ,manahitamahitam,1,1,0,0,15
13728,vibhavabhavakaraṃ,vibhavabhavakaram,1,1,0,0,17
13729,karabhavavibhavaṃ,karabhavavibhavam,1,1,0,0,17
13730,janaguṇaṃ,janagunam,1,1,0,0,9
13731,guṇajanasujanaṃ,gunajanasujanam,1,1,0,0,15
13732,para54,para54,408,408,0,0,6
13733,sīlaggadaṇḍavicitaṃ,silaggadandavicitam,1,1,0,0,19
13734,susamādhipattaṃ,susamadhipattam,1,1,0,0,15
13735,sobhāsamujjala,sobhasamujjala,1,1,0,0,14
13736,manantaga,manantaga,1,1,0,0,9
13737,ñāṇasīkhaṃ,nanasikham,1,1,0,0,10
13738,saddhammaseṭṭharatanañca,saddhammasettharatananca,1,1,0,0,24
13739,tilokaketuṃ,tilokaketum,1,1,0,0,11
13740,locanabhiseka,locanabhiseka,1,1,0,0,13
13741,susobhayuttaṃ,susobhayuttam,1,1,0,0,13
13742,para55,para55,411,411,0,0,6
13743,vinayanaya,vinayanaya,2,1,1,0,10
13744,manayavinaya,manayavinaya,1,1,0,0,12
13745,manamitaṃ,manamitam,1,1,0,0,9
13746,vijayajaya,vijayajaya,1,1,0,0,10
13747,majayavijaya,majayavijaya,1,1,0,0,12
13748,matulitaṃ,matulitam,1,1,0,0,9
13749,vibhajabhaja,vibhajabhaja,1,1,0,0,12
13750,mabhajavibhaja,mabhajavibhaja,1,1,0,0,14
13751,mananakaṃ,mananakam,1,1,0,0,9
13752,visamasama,visamasama,1,1,0,0,10
13753,masamavisama,masamavisama,1,1,0,0,12
13754,mabhiname,mabhiname,1,1,0,0,9
13755,para56,para56,398,398,0,0,6
13756,paramarama,paramarama,1,1,0,0,10
13757,maramaparama,maramaparama,1,1,0,0,12
13758,matiguṇaṃ,matigunam,1,1,0,0,9
13759,pagahagati,pagahagati,1,1,0,0,10
13760,magatipagata,magatipagata,1,1,0,0,12
13761,mamamakaṃ,mamamakam,1,1,0,0,9
13762,pacayacaya,pacayacaya,1,1,0,0,10
13763,macayapapaya,macayapapaya,1,1,0,0,12
13764,manaṇakaṃ,mananakam,1,1,0,0,9
13765,pakatakata,pakatakata,1,1,0,0,10
13766,makatapakata,makatapakata,1,1,0,0,12
13767,macalakaṃ,macalakam,1,1,0,0,9
13768,para57,para57,397,397,0,0,6
13769,ujuka,ujuka,1,1,0,0,5
13770,mayanamagge,mayanamagge,1,1,0,0,11
13771,mokkhadesaṃ,mokkhadesam,1,1,0,0,11
13772,niyāsi,niyasi,1,1,0,0,6
13773,vararathakujarena,vararathakujarena,1,1,0,0,17
13774,cammacakkena,cammacakkena,1,1,0,0,12
13775,hiritapadukapālambena,hiritapadukapalambena,1,1,0,0,21
13776,dhammassutena,dhammassutena,1,1,0,0,13
13777,satinivarayutena,satinivarayutena,1,1,0,0,16
13778,ppāṭihiraddhajena,ppatihiraddhajena,1,1,0,0,17
13779,para58,para58,388,388,0,0,6
13780,avihananakkhinā,avihananakkhina,1,1,0,0,15
13781,suyama,suyama,1,1,0,0,6
13782,nemupakkharā,nemupakkhara,1,1,0,0,12
13783,udariyamabbhinā,udariyamabbhina,1,1,0,0,15
13784,paripuraṅgasaccinā,paripurangasaccina,1,1,0,0,18
13785,kusalavibhūsinā,kusalavibhusina,1,1,0,0,15
13786,nimadakupparena,nimadakupparena,1,1,0,0,15
13787,akharanatesinā,akharanatesina,1,1,0,0,14
13788,gupitasilanandanā,gupitasilanandana,1,1,0,0,17
13789,para59,para59,374,374,0,0,6
13790,anusanughātinā,anusanughatina,1,1,0,0,14
13791,matipurejavena,matipurejavena,1,1,0,0,14
13792,kāla,kala,31,24,7,0,4
13793,ññutamatisārike,nnutamatisarike,1,1,0,0,15
13794,visāradatthidaṇḍā,visaradatthidanda,1,1,0,0,17
13795,satituda,satituda,1,1,0,0,8
13796,dhītirasmi,dhitirasmi,1,1,0,0,10
13797,manadammasindhavena,manadammasindhavena,1,1,0,0,19
13798,vinayagaṇe,vinayagane,1,1,0,0,10
13799,matulyasatthavāhaṃ,matulyasatthavaham,1,1,0,0,18
13800,para60,para60,381,381,0,0,6
13801,yamakkaggijālaṃ,yamakkaggijalam,1,1,0,0,15
13802,paravisaya,paravisaya,1,1,0,0,10
13803,maccherasahitaṃ,maccherasahitam,1,1,0,0,15
13804,dudiṭṭhandhubbāhaṃ,duditthandhubbaham,1,1,0,0,18
13805,yugagahaṇatitthīna,yugagahanatitthina,1,1,0,0,18
13806,makarī,makari,2,2,0,0,6
13807,bahūnaṃ,bahunam,451,423,28,0,7
13808,ratanakamane,ratanakamane,1,1,0,0,12
13809,pāṭihariyaṃ,patihariyam,1,1,0,0,11
13810,jayakketussāpi,jayakketussapi,1,1,0,0,14
13811,mabhinami,mabhinami,1,1,0,0,9
13812,kaṇṭambasamipe,kantambasamipe,1,1,0,0,14
13813,para61,para61,378,378,0,0,6
13814,nakhajutirajaṃ,nakhajutirajam,1,1,0,0,14
13815,cakkaṅgopeta,cakkangopeta,1,1,0,0,12
13816,pādavarambujaṃ,padavarambujam,1,1,0,0,14
13817,subhasirimato,subhasirimato,1,1,0,0,13
13818,raṃsijālaṅgulidasasaṃsubhiṃ,ramsijalangulidasasamsubhim,1,1,0,0,27
13819,pavarasirasā,pavarasirasa,1,1,0,0,12
13820,devādevā,devadeva,1,1,0,0,8
13821,pilandhayuṃ,pilandhayum,1,1,0,0,11
13822,mativa,mativa,1,1,0,0,6
13823,manorammaṃ,manorammam,5,5,0,0,10
13824,tittīkarā,tittikara,1,1,0,0,9
13825,nami,nami,54,54,0,0,4
13826,ke,ke,629,558,71,0,2
13827,para62,para62,379,379,0,0,6
13828,buddhopyeko,buddhopyeko,1,1,0,0,11
13829,nidhanaguṇino,nidhanagunino,1,1,0,0,13
13830,vaṇṇaye,vannaye,3,3,0,0,7
13831,yāvajīvaṃ,yavajivam,694,684,10,0,9
13832,kathamabhaṇa,kathamabhana,1,1,0,0,12
13833,māsuṃ,masum,3,3,0,0,5
13834,khiyethā,khiyetha,1,1,0,0,8
13835,yukappo,yukappo,1,1,0,0,7
13836,tvevā,tveva,2,2,0,0,5
13837,khaya,khaya,8,4,4,0,5
13838,mupavajje,mupavajje,1,1,0,0,9
13839,sakalarirī,sakalariri,1,1,0,0,10
13840,nekanāthaṃ,nekanatham,1,1,0,0,10
13841,para63,para63,385,385,0,0,6
13842,pādidīpādaṃ,padidipadam,1,1,0,0,11
13843,dvinayanadijaṃ,dvinayanadijam,1,1,0,0,14
13844,dhammakāyaṃ,dhammakayam,9,8,1,0,11
13845,dhisoṇḍaṃ,dhisondam,1,1,0,0,9
13846,bhāṇīsoṇḍaggaṃ,bhanisondaggam,1,1,0,0,14
13847,saraṇasirasiṃ,saranasirasim,1,1,0,0,13
13848,maggāvālaṃ,maggavalam,1,1,0,0,10
13849,subhaṅgaṃ,subhangam,1,1,0,0,9
13850,sīlālaṅkāraṃ,silalankaram,1,1,0,0,12
13851,vimalibhavu,vimalibhavu,1,1,0,0,11
13852,sattatiṭṭhidhidabbaṃ,sattatitthidhidabbam,1,1,0,0,20
13853,nāthebhindaggaṃ,nathebhindaggam,1,1,0,0,15
13854,phalakariṇukaṃ,phalakarinukam,1,1,0,0,14
13855,mokkhabhojaṃ,mokkhabhojam,1,1,0,0,12
13856,para64,para64,374,374,0,0,6
13857,malāloḷullolaṃ,malalolullolam,1,1,0,0,14
13858,atibhayajanaṃ,atibhayajanam,1,1,0,0,13
13859,duggasaṃsārasinduṃ,duggasamsarasindum,1,1,0,0,18
13860,phiyabbhāniggāho,phiyabbhaniggaho,1,1,0,0,16
13861,sivataṭamukho,sivatatamukho,1,1,0,0,13
13862,nāvi,navi,2,2,0,0,4
13863,kajjeṭṭhanātho,kajjetthanatho,1,1,0,0,14
13864,padappārakkāmaṃ,padapparakkamam,1,1,0,0,15
13865,bahujanagaṇaṃ,bahujanaganam,1,1,0,0,13
13866,ekamaggattaramhi,ekamaggattaramhi,1,1,0,0,16
13867,samāropetvā,samaropetva,6,6,0,0,11
13868,mattari,mattari,1,1,0,0,7
13869,matulasādarañcā,matulasadaranca,1,1,0,0,15
13870,para65,para65,369,369,0,0,6
13871,byāmaṃsugghanadhāra,byamamsugghanadhara,1,1,0,0,19
13872,makkuḷusatabbhāṇujjalantattanaṃ,makkulusatabbhanujjalantattanam,1,1,0,0,31
13873,ukkaṃsajjuti,ukkamsajjuti,1,1,0,0,12
13874,ketumālavicitaṃ,ketumalavicitam,1,1,0,0,15
13875,saddhammajotindharaṃ,saddhammajotindharam,1,1,0,0,20
13876,bundinniggatapajjalanta,bundinniggatapajjalanta,1,1,0,0,23
13877,didhitiṃ,didhitim,1,1,0,0,8
13878,ajjatthanā,ajjatthana,1,1,0,0,10
13879,vandetaṃ,vandetam,2,2,0,0,8
13880,sakyapuṅgava,sakyapungava,2,2,0,0,12
13881,puṇṇinduvattampi,punninduvattampi,1,1,0,0,16
13882,para66,para66,366,366,0,0,6
13883,sattamaṃtamaṃ,sattamamtamam,1,1,0,0,13
13884,vināsakaṃsakaṃ,vinasakamsakam,1,1,0,0,14
13885,vineyyakānameva,vineyyakanameva,1,1,0,0,15
13886,bhāvanaṃvanaṃ,bhavanamvanam,1,1,0,0,13
13887,dhulīkaraṃ,dhulikaram,1,1,0,0,10
13888,tidukkaraṃ,tidukkaram,3,3,0,0,10
13889,pajābhibhuñja,pajabhibhunja,1,1,0,0,13
13890,gāravaṃravaṃ,garavamravam,1,1,0,0,12
13891,manoharaṃharaṃ,manoharamharam,1,1,0,0,14
13892,narānarānayaṃ,naranaranayam,1,1,0,0,13
13893,sādaraṃdaraṃ,sadaramdaram,1,1,0,0,12
13894,vinodakaṃdakaṃ,vinodakamdakam,1,1,0,0,14
13895,pavassakaṃ,pavassakam,1,1,0,0,10
13896,pajānamiva,pajanamiva,1,1,0,0,10
13897,para67,para67,366,366,0,0,6
13898,mudodātuṇṇalomo,mudodatunnalomo,1,1,0,0,15
13899,thomyarassaggasaggī,thomyarassaggasaggi,1,1,0,0,19
13900,para68,para68,355,355,0,0,6
13901,antaraṃsappapīṇo,antaramsappapino,1,1,0,0,16
13902,cakkenaṅkītapādo,cakkenankitapado,1,1,0,0,16
13903,tiṭṭhantonomento,titthantonomento,1,1,0,0,16
13904,bhayakaramudunā,bhayakaramuduna,1,1,0,0,15
13905,jaṇṇukānā,jannukana,1,1,0,0,9
13906,masanto,masanto,2,2,0,0,7
13907,sīhapubbaḍḍhukāyo,sihapubbaddhukayo,1,1,0,0,17
13908,para69,para69,357,357,0,0,6
13909,sattappīṇo,sattappino,1,1,0,0,10
13910,dīghaṅgulaṃ,dighangulam,1,1,0,0,11
13911,para70,para70,353,353,0,0,6
13912,vaṭṭacitānupubbakasubhaṅgulī,vattacitanupubbakasubhanguli,1,1,0,0,28
13913,ruhiramaṭṭhatuṅganakhako,ruhiramatthatunganakhako,1,1,0,0,24
13914,nigguḷagopphako,niggulagopphako,1,1,0,0,15
13915,samapado,samapado,1,1,0,0,8
13916,sīhosabhibha,sihosabhibha,1,1,0,0,12
13917,haṃsasannibhakamo,hamsasannibhakamo,1,1,0,0,17
13918,dakkhiṇatāvatakkami,dakkhinatavatakkami,1,1,0,0,19
13919,samantamaṇḍala,samantamandala,1,1,0,0,14
13920,nigaṇṭhi,niganthi,1,1,0,0,8
13921,jāṇusubhako,janusubhako,1,1,0,0,11
13922,byañjanapuṇṇaposatanu,byanjanapunnaposatanu,1,1,0,0,21
13923,nābhigambhīra,nabhigambhira,1,1,0,0,13
13924,achiddadakkhiṇavaṭo,achiddadakkhinavato,1,1,0,0,19
13925,para71,para71,348,348,0,0,6
13926,dviradakarappakāsurubhujo,dviradakarappakasurubhujo,1,1,0,0,25
13927,suvibbhajanupubbamaṭṭhaanunā,suvibbhajanupubbamatthaanuna,1,1,0,0,28
13928,nunaalinānupubbarucira,nunaalinanupubbarucira,1,1,0,0,22
13929,ttilādirahitabbisuddhatanuko,ttiladirahitabbisuddhatanuko,1,1,0,0,28
13930,dasasatakoṭi,dasasatakoti,1,1,0,0,12
13931,hatthibaladhāraṇo,hatthibaladharano,1,1,0,0,17
13932,kanakatuṅganāsikasubho,kanakatunganasikasubho,1,1,0,0,22
13933,suruhiradantamaṃsatha,suruhiradantamamsatha,1,1,0,0,21
13934,sucisiniddhadasano,sucisiniddhadasano,1,1,0,0,18
13935,lokasaraṇo,lokasarano,5,5,0,0,10
13936,para72,para72,336,336,0,0,6
13937,suddhapasādindri,suddhapasadindri,1,1,0,0,16
13938,vaṭṭataradāṭho,vattataradatho,1,1,0,0,14
13939,ruhiroṭṭha,ruhirottha,1,1,0,0,10
13940,suranaranātho,suranaranatho,1,1,0,0,13
13941,āyatasobhabbadano,ayatasobhabbadano,1,1,0,0,17
13942,gambhīrujukāyatasuruciralekho,gambhirujukayatasuruciralekho,1,1,0,0,29
13943,byāmapabhāmaṇḍalabundi,byamapabhamandalabundi,1,1,0,0,22
13944,supuraggaṇṇi,supuragganni,1,1,0,0,12
13945,āyatavisaṭasubhakkhī,ayatavisatasubhakkhi,1,1,0,0,20
13946,pañcapasādakkhi,pancapasadakkhi,1,1,0,0,15
13947,kuñcikasubhaggapakhumo,kuncikasubhaggapakhumo,1,1,0,0,22
13948,mudutanuruṇajivho,mudutanurunajivho,1,1,0,0,17
13949,para73,para73,344,344,0,0,6
13950,sommasiniddha,sommasiniddha,1,1,0,0,13
13951,tyujjalakomala,tyujjalakomala,1,1,0,0,14
13952,varuṇavimalatanu,varunavimalatanu,1,1,0,0,16
13953,komala,komala,2,2,0,0,6
13954,dakkhiṇāvaṭa,dakkhinavata,1,1,0,0,12
13955,añjanabhidasarisanilaka,anjanabhidasarisanilaka,1,1,0,0,23
13956,mudutanuruho,mudutanuruho,1,1,0,0,12
13957,dakkhiṇavaṭṭakomala,dakkhinavattakomala,1,1,0,0,19
13958,saṇusamasunila,sanusamasunila,1,1,0,0,14
13959,alulita,alulita,1,1,0,0,7
13960,siraruhi,siraruhi,1,1,0,0,8
13961,sobhaṇasaṇṭhāno,sobhanasanthano,1,1,0,0,15
13962,siniddhasiraruhi,siniddhasiraruhi,1,1,0,0,16
13963,supacitasatakusala,supacitasatakusala,1,1,0,0,18
13964,jo,jo,67,42,25,0,2
13965,para74,para74,336,336,0,0,6
13966,nigguḷonigganticchattassarisaatisubhagasira,niggulonigganticchattassarisaatisubhagasira,1,1,0,0,43
13967,cāyatāruci,cayataruci,1,1,0,0,10
13968,kaṇṇako,kannako,1,1,0,0,7
13969,sosaṇṭhānassaṇhāhārānukamapahutabhamutha,sosanthanassanhaharanukamapahutabhamutha,1,1,0,0,40
13970,suāyatabbhamuko,suayatabbhamuko,1,1,0,0,15
13971,suggandhaggatto,suggandhaggatto,1,1,0,0,15
13972,muddhicātha,muddhicatha,1,1,0,0,11
13973,vadani,vadani,3,3,0,0,6
13974,puthulakanalāṭa,puthulakanalata,1,1,0,0,15
13975,āyatasobhaṇo,ayatasobhano,1,1,0,0,12
13976,assāsappassāsātissaṇu,assasappassasatissanu,1,1,0,0,21
13977,dharamasamasama,dharamasamasama,1,1,0,0,15
13978,ketumālavicittakaṃ,ketumalavicittakam,1,1,0,0,18
13979,para75,para75,338,338,0,0,6
13980,kimaṅgaṃ,kimangam,133,126,7,0,8
13981,atidulabhataraṃ,atidulabhataram,1,1,0,0,15
13982,ghosamattampi,ghosamattampi,1,1,0,0,13
13983,saparahitasukhaṃ,saparahitasukham,1,1,0,0,16
13984,viddhasū,viddhasu,1,1,0,0,8
13985,yātiṭṭhatthāva,yatitthatthava,1,1,0,0,14
13986,haṃ,ham,140,122,18,0,3
13987,suranarasaraṇaṃ,suranarasaranam,1,1,0,0,15
13988,antarāyappahānaṃ,antarayappahanam,1,1,0,0,16
13989,puññakkhettekabhūtaṃ,punnakkhettekabhutam,1,1,0,0,20
13990,sugatamavirataṃ,sugatamaviratam,1,1,0,0,15
13991,vandantu,vandantu,6,6,0,0,8
13992,para76,para76,328,328,0,0,6
13993,khettavaraṅgatatthutipure,khettavarangatatthutipure,1,1,0,0,25
13994,javapaṇama,javapanama,1,1,0,0,10
13995,rogabhayādyupaddavahato,rogabhayadyupaddavahato,1,1,0,0,23
13996,anunasukha,anunasukha,1,1,0,0,10
13997,bhogapuññamatiko,bhogapunnamatiko,1,1,0,0,16
13998,devamanussabhogapavaraṃ,devamanussabhogapavaram,1,1,0,0,23
13999,paratthanubhāvañca,paratthanubhavanca,1,1,0,0,18
14000,antimabhave,antimabhave,9,9,0,0,11
14001,tibodhipavare,tibodhipavare,1,1,0,0,13
14002,yathāsayaṃ,yathasayam,2,2,0,0,10
14003,katanato,katanato,1,1,0,0,8
14004,para77,para77,326,326,0,0,6
14005,puññenānena,punnenanena,1,1,0,0,11
14006,nipuṇajavamati,nipunajavamati,1,1,0,0,14
14007,sakhīlo,sakhilo,1,1,0,0,7
14008,kalyāṇamittotisaraṇagamano,kalyanamittotisaranagamano,1,1,0,0,26
14009,sīlavā,silava,610,585,25,0,6
14010,cāgayogo,cagayogo,1,1,0,0,8
14011,hirottappī,hirottappi,2,2,0,0,10
14012,sudakkho,sudakkho,2,2,0,0,8
14013,avitasucarito,avitasucarito,1,1,0,0,13
14014,saccabhāṇī,saccabhani,1,1,0,0,10
14015,bāhussacci,bahussacci,1,1,0,0,10
14016,vibhāgi,vibhagi,1,1,0,0,7
14017,saparahitakaro,saparahitakaro,1,1,0,0,14
14018,vaggurāvo,vagguravo,1,1,0,0,9
14019,bhirupo,bhirupo,1,1,0,0,7
14020,para78,para78,320,320,0,0,6
14021,dīghajjīvi,dighajjivi,1,1,0,0,10
14022,nirogo,nirogo,14,14,0,0,6
14023,sucikulapassuto,sucikulapassuto,1,1,0,0,15
14024,dhammaratto,dhammaratto,1,1,0,0,11
14025,niccāpalyo,niccapalyo,1,1,0,0,10
14026,kataññu,katannu,3,3,0,0,7
14027,atimudujumano,atimudujumano,1,1,0,0,13
14028,sādhubhāvādiviññū,sadhubhavadivinnu,1,1,0,0,17
14029,dhammājīvo,dhammajivo,1,1,0,0,10
14030,bahukusalarato,bahukusalarato,1,1,0,0,14
14031,aluddho,aluddho,25,25,0,0,7
14032,evañcaññaṃ,evancannam,1,1,0,0,10
14033,kareyyaṃ,kareyyam,176,170,6,0,8
14034,carimake,carimake,1,1,0,0,8
14035,mokkhanibbānabhāgī,mokkhanibbanabhagi,1,1,0,0,18
14036,para79,para79,314,314,0,0,6
14037,mahākathaṃ,mahakatham,2,2,0,0,10
14038,buddhaghoso,buddhaghoso,28,24,4,0,11
14039,tanumeva,tanumeva,2,2,0,0,8
14040,karaṃapi,karamapi,1,1,0,0,8
14041,cajaṃ,cajam,3,3,0,0,5
14042,heyyā,heyya,2,1,1,0,5
14043,diyā,diya,1,1,0,0,4
14044,deyyaṃ,deyyam,40,35,5,0,6
14045,akarittha,akarittha,9,9,0,0,9
14046,para80,para80,320,320,0,0,6
14047,mahāpaṇāmaporāṇaṃ,mahapanamaporanam,1,1,0,0,17
14048,kāmokkamaṃ,kamokkamam,1,1,0,0,10
14049,dudhārañca,dudharanca,1,1,0,0,10
14050,deyyā,deyya,6,5,1,0,5
14051,diyaññattha,diyannattha,1,1,0,0,11
14052,para81,para81,317,317,0,0,6
14053,sutajjaya,sutajjaya,1,1,0,0,9
14054,anubhavaṭṭhapanatthena,anubhavatthapanatthena,1,1,0,0,22
14055,lañchinā,lanchina,1,1,0,0,8
14056,sutena,sutena,371,348,23,0,6
14057,garunānena,garunanena,1,1,0,0,10
14058,katoyaṃ,katoyam,4,4,0,0,7
14059,paṇāmo,panamo,26,23,3,0,6
14060,navo,navo,100,94,6,0,4
14061,para82,para82,310,310,0,0,6
14062,ekakkharāya,ekakkharaya,1,1,0,0,11
14063,chabbisatakkharā,chabbisatakkhara,1,1,0,0,16
14064,jātiya,jatiya,4,4,0,0,6
14065,pajjasattatyā,pajjasattatya,1,1,0,0,13
14066,saṅkhato,sankhato,75,71,4,0,8
14067,caturādhikā,caturadhika,1,1,0,0,11
14068,para83,para83,321,321,0,0,6
14069,aṭṭhādhikā,atthadhika,1,1,0,0,10
14070,sahevuyyo,sahevuyyo,1,1,0,0,9
14071,janādīhi,janadihi,9,8,1,0,8
14072,midaṃ,midam,37,33,4,0,5
14073,nataṃ,natam,23,22,1,0,5
14074,yathāvuttatthakā,yathavuttatthaka,1,1,0,0,16
14075,kāmā,kama,955,873,82,0,4
14076,dhārayantu,dharayantu,5,5,0,0,10
14077,para84,para84,321,321,0,0,6
14078,rājātirājātimanoharo,rajatirajatimanoharo,1,1,0,0,20
14079,devātidevātiguṇoghadhārī,devatidevatigunoghadhari,1,1,0,0,24
14080,brahmātibrahmātibhavantagū,brahmatibrahmatibhavantagu,1,1,0,0,26
14081,saṅghātisaṅghātivirāva,sanghatisanghativirava,1,1,0,0,22
14082,para85,para85,305,305,0,0,6
14083,anaṅganaṅgaṃ,ananganangam,1,1,0,0,12
14084,naradevadevaṃ,naradevadevam,1,1,0,0,13
14085,aniñjaniñjaṃ,aninjaninjam,1,1,0,0,12
14086,bhayatāṇatāṇaṃ,bhayatanatanam,1,1,0,0,14
14087,anaṇḍanaṇḍañca,anandanandanca,1,1,0,0,14
14088,anāthanāthaṃ,anathanatham,1,1,0,0,12
14089,khayantayantaṃ,khayantayantam,1,1,0,0,14
14090,māmi,mami,1,1,0,0,4
14091,para86,para86,315,315,0,0,6
14092,tambasiniddhatuṅganakhako,tambasiniddhatunganakhako,1,1,0,0,25
14093,nuṃvaṭṭasucituraṅguli,numvattasucituranguli,1,1,0,0,21
14094,muniso,muniso,1,1,0,0,6
14095,sīhusabhobhahaṃsasamago,sihusabhobhahamsasamago,1,1,0,0,23
14096,nigūḷasama,nigulasama,1,1,0,0,10
14097,gopphakāyatamukho,gopphakayatamukho,1,1,0,0,17
14098,komaladakkhāṇāvaṭatanuruho,komaladakkhanavatatanuruho,1,1,0,0,26
14099,sucimalujjalābhasariro,sucimalujjalabhasariro,1,1,0,0,22
14100,pañcapasādayuttanayano,pancapasadayuttanayano,1,1,0,0,22
14101,sugandhamukhatuṅganāsikayuto,sugandhamukhatunganasikayuto,1,1,0,0,28
14102,para87,para87,314,314,0,0,6
14103,koṭisahassanāgabaliko,kotisahassanagabaliko,1,1,0,0,21
14104,surattamadharo,surattamadharo,1,1,0,0,14
14105,suvaṭṭadasano,suvattadasano,1,1,0,0,13
14106,āyatasaṇulomabhamūko,ayatasanulomabhamuko,1,1,0,0,20
14107,muduttanukaratta,muduttanukaratta,1,1,0,0,16
14108,jivhasahito,jivhasahito,1,1,0,0,11
14109,chattasamānasobhaṇasiro,chattasamanasobhanasiro,1,1,0,0,23
14110,sukesavara,sukesavara,1,1,0,0,10
14111,ketumālavicito,ketumalavicito,1,1,0,0,14
14112,iccanubyañjanebhi,iccanubyanjanebhi,1,1,0,0,17
14113,munindapavaraṃ,munindapavaram,1,1,0,0,14
14114,para88,para88,309,309,0,0,6
14115,sakalamalehi,sakalamalehi,1,1,0,0,12
14116,sudūratāya,sudurataya,1,1,0,0,10
14117,malāriniṃ,malarinim,1,1,0,0,9
14118,hatatayā,hatataya,1,1,0,0,8
14119,tibhavarathe,tibhavarathe,11,8,3,0,12
14120,samānitamanārakāni,samanitamanarakani,1,1,0,0,18
14121,namālayo,namalayo,1,1,0,0,8
14122,naravaro,naravaro,20,17,3,0,8
14123,malakaraṇe,malakarane,1,1,0,0,10
14124,rahāraha,raharaha,1,1,0,0,8
14125,manantañeyya,manantaneyya,1,1,0,0,12
14126,mabhijānanā,mabhijanana,1,1,0,0,11
14127,caraṇayuto,caranayuto,1,1,0,0,10
14128,tivijji,tivijji,1,1,0,0,7
14129,suvācatā,suvacata,1,1,0,0,8
14130,sugamanā,sugamana,1,1,0,0,8
14131,janesu,janesu,67,63,4,0,6
14132,para89,para89,303,303,0,0,6
14133,lokavidū,lokavidu,217,207,10,0,8
14134,nitalokatayatā,nitalokatayata,1,1,0,0,14
14135,sākalato,sakalato,1,1,0,0,8
14136,asamanaradamā,asamanaradama,1,1,0,0,13
14137,sārathi,sarathi,258,252,6,0,7
14138,anusāsanakaro,anusasanakaro,1,1,0,0,13
14139,satthavaho,satthavaho,1,1,0,0,10
14140,dupathataraṇasattā,dupathataranasatta,1,1,0,0,18
14141,catusaccamakhilaṃ,catusaccamakhilam,1,1,0,0,17
14142,bodhayi,bodhayi,4,4,0,0,7
14143,jantugaṇamiti,jantuganamiti,1,1,0,0,13
14144,bhākaraābhāphuṭapaṅkajasamo,bhakaraabhaphutapankajasamo,1,1,0,0,27
14145,maggiyañāṇaphuvikasito,maggiyananaphuvikasito,1,1,0,0,22
14146,para90,para90,311,311,0,0,6
14147,bhaggakileso,bhaggakileso,1,1,0,0,12
14148,vamita,vamita,2,2,0,0,6
14149,gamana,gamana,22,20,2,0,6
14150,bhajanato,bhajanato,3,3,0,0,9
14151,bhaji,bhaji,78,75,3,0,5
14152,pavibhatta,pavibhatta,1,1,0,0,10
14153,sarasa,sarasa,4,4,0,0,6
14154,chabhagayuta,chabhagayuta,1,1,0,0,12
14155,garukaraṇiyato,garukaraniyato,1,1,0,0,14
14156,sattanikāye,sattanikaye,93,90,3,0,11
14157,kenapitulyaguṇamapamita,kenapitulyagunamapamita,1,1,0,0,23
14158,sirighaṃnajutisusubhaṃ,sirighamnajutisusubham,1,1,0,0,22
14159,devanarānaṃ,devanaranam,4,4,0,0,11
14160,ekapatiṭṭha,ekapatittha,1,1,0,0,11
14161,mavitathutiyasa,mavitathutiyasa,1,1,0,0,15
14162,masaki,masaki,1,1,0,0,6
14163,mabhaṃname,mabhamname,1,1,0,0,10
14164,para91,para91,303,303,0,0,6
14165,kimmaṅgaṃ,kimmangam,1,1,0,0,9
14166,atidulabhataramidha,atidulabhataramidha,1,1,0,0,19
14167,sughosa,sughosa,1,1,0,0,7
14168,mapāparo,mapaparo,1,1,0,0,8
14169,patthentā,patthenta,15,15,0,0,9
14170,vividhahitasukha,vividhahitasukha,1,1,0,0,16
14171,manadhikaṃ,manadhikam,1,1,0,0,10
14172,namantu,namantu,1,1,0,0,7
14173,puññenānenete,punnenanenete,1,1,0,0,13
14174,diṭṭhe,ditthe,450,381,69,0,6
14175,bhayaaghaṃpīḷanaṭṭha,bhayaaghampilanattha,1,1,0,0,20
14176,virahitā,virahita,18,17,1,0,8
14177,parattha,parattha,93,88,5,0,8
14178,cubho,cubho,53,53,0,0,5
14179,subhe,subhe,63,62,1,0,5
14180,bhutvānante,bhutvanante,1,1,0,0,11
14181,ve,ve,1077,919,158,0,2
14182,hessante,hessante,3,3,0,0,8
14183,avikalasukhasirimatikā,avikalasukhasirimatika,1,1,0,0,22
14184,anuttara,anuttara,4,3,1,0,8
14185,bhāgino,bhagino,22,22,0,0,7
14186,para92,para92,296,296,0,0,6
14187,cakkopetapādo,cakkopetapado,1,1,0,0,13
14188,mudubhujacaraṇo,mudubhujacarano,1,1,0,0,15
14189,eṇījaṅgho,enijangho,1,1,0,0,9
14190,kanakanibhataco,kanakanibhataco,1,1,0,0,15
14191,kosonaddhaṅgajāto,kosonaddhangajato,1,1,0,0,17
14192,atisudhumachavī,atisudhumachavi,1,1,0,0,15
14193,jālikappānaheṭṭhā,jalikappanahettha,1,1,0,0,17
14194,ussaṅkhapādayutto,ussankhapadayutto,1,1,0,0,17
14195,abhinilanayano,abhinilanayano,1,1,0,0,14
14196,āyataṅguliyogo,ayatanguliyogo,1,1,0,0,14
14197,para93,para93,294,294,0,0,6
14198,kirubhayaputhunājāṇuyo,kirubhayaputhunajanuyo,1,1,0,0,22
14199,lomakūpekekalomo,lomakupekekalomo,1,1,0,0,16
14200,samataladasano,samataladasano,1,1,0,0,14
14201,añjanuddhaggalomo,anjanuddhaggalomo,1,1,0,0,17
14202,brahmaddehujjugatto,brahmaddehujjugatto,1,1,0,0,19
14203,aviraḷamukhato,aviralamukhato,1,1,0,0,14
14204,sattakaṅgussado,sattakangussado,1,1,0,0,15
14205,nigrodhappāribimbo,nigrodhapparibimbo,1,1,0,0,18
14206,migapatihanuko,migapatihanuko,1,1,0,0,14
14207,para94,para94,295,295,0,0,6
14208,puṇṇattālīsadanto,punnattalisadanto,1,1,0,0,17
14209,supahutarasano,supahutarasano,1,1,0,0,14
14210,sobhaṇodātadāṭho,sobhanodatadatho,1,1,0,0,16
14211,saṇhodātuṇṇalomo,sanhodatunnalomo,1,1,0,0,16
14212,samavaṭalagalo,samavatalagalo,1,1,0,0,14
14213,antaraṃsapiṇo,antaramsapino,1,1,0,0,13
14214,brahmagghoso,brahmagghoso,1,1,0,0,12
14215,punapi,punapi,542,537,5,0,6
14216,gupakhumo,gupakhumo,1,1,0,0,9
14217,uṇhisasamphullasīso,unhisasamphullasiso,1,1,0,0,19
14218,bāttiṃsaṅgopasobhaṃ,battimsangopasobham,1,1,0,0,19
14219,mudurasahaṇī,mudurasahani,1,1,0,0,12
14220,lokajeṭṭhaṃ,lokajettham,41,40,1,0,11
14221,mahāpaṇāma,mahapanama,1,1,0,0,10
14222,tigumbacetiya,tigumbacetiya,1,1,0,0,13
14223,dīpaṅkaramūlamhi,dipankaramulamhi,1,1,0,0,16
14224,hattagataṃ,hattagatam,2,2,0,0,10
14225,sammāsambodhi,sammasambodhi,27,25,2,0,13
14226,mākaṅkhaṃ,makankham,1,1,0,0,9
14227,siroruhaṃ,siroruham,5,5,0,0,9
14228,pathyāvattagāthā,pathyavattagatha,11,11,0,0,16
14229,bodhisambhāramahesaṃ,bodhisambharamahesam,1,1,0,0,20
14230,alattha,alattha,113,104,9,0,7
14231,kesadhātuvaraṃ,kesadhatuvaram,1,1,0,0,14
14232,laddhā,laddha,626,585,41,0,6
14233,chaṭhānamatikkamma,chathanamatikkamma,1,1,0,0,18
14234,pavedayi,pavedayi,4,4,0,0,8
14235,vimuttiṃ,vimuttim,172,149,23,0,8
14236,kesavaraṃ,kesavaram,1,1,0,0,9
14237,rakāra,rakara,2,2,0,0,6
14238,bhakāravipulā,bhakaravipula,1,1,0,0,13
14239,sakkadattiyampi,sakkadattiyampi,1,1,0,0,15
14240,nāgalataṃ,nagalatam,1,1,0,0,9
14241,harītakaṃ,haritakam,32,30,2,0,9
14242,anotattodakaṃ,anotattodakam,3,3,0,0,13
14243,bhuñji,bhunji,82,82,0,0,6
14244,rakāravipulā,rakaravipula,5,5,0,0,12
14245,muggaselapattaṃ,muggaselapattam,1,1,0,0,15
14246,mahārājūhi,maharajuhi,6,6,0,0,10
14247,dinnakaṃ,dinnakam,17,15,2,0,8
14248,paṭiggaṇhi,patigganhi,36,36,0,0,10
14249,sīsajaṃ,sisajam,1,1,0,0,7
14250,dvebhātikajanehi,dvebhatikajanehi,1,1,0,0,16
14251,madhupiṇḍikaṃ,madhupindikam,8,6,2,0,13
14252,paribhuñjesi,paribhunjesi,1,1,0,0,12
14253,manthampi,manthampi,1,1,0,0,9
14254,sīsasiriṃ,sisasirim,1,1,0,0,9
14255,takāravipulā,takaravipula,1,1,0,0,12
14256,tapussabhallikānaṃ,tapussabhallikanam,10,8,2,0,18
14257,dvisaraṇaṃ,dvisaranam,1,1,0,0,10
14258,adā,ada,195,190,5,0,3
14259,lokamhi,lokamhi,73,67,6,0,7
14260,sabbapaṭhamaṃ,sabbapathamam,191,182,9,0,13
14261,sīrivahaṃ,sirivaham,1,1,0,0,9
14262,nakāra,nakara,2,2,0,0,6
14263,vipulāpathyāvattagāthā,vipulapathyavattagatha,1,1,0,0,22
14264,tatthupaṭṭhakānaṃ,tatthupatthakanam,1,1,0,0,17
14265,kese,kese,275,267,8,0,4
14266,aṭha,atha,1,1,0,0,4
14267,lokahita,lokahita,2,2,0,0,8
14268,mapekkhanto,mapekkhanto,1,1,0,0,11
14269,tepi,tepi,1175,1149,26,0,4
14270,āhāritvāna,aharitvana,1,1,0,0,10
14271,pokkharabbatiyaṃ,pokkharabbatiyam,1,1,0,0,16
14272,karuṃ,karum,13,13,0,0,5
14273,sajīvakesa,sajivakesa,1,1,0,0,10
14274,cetiyaṃ,cetiyam,520,485,35,0,7
14275,nametaṃ,nametam,3,2,1,0,7
14276,sabbapubbakaṃ,sabbapubbakam,1,1,0,0,13
14277,makāravipulā,makaravipula,1,1,0,0,12
14278,uposathuposathamhi,uposathuposathamhi,1,1,0,0,18
14279,muñcantaṃ,muncantam,20,20,0,0,9
14280,nīlarasmiyo,nilarasmiyo,6,4,2,0,11
14281,bhagavāva,bhagavava,33,32,1,0,9
14282,lokaatthaṃ,lokaattham,1,1,0,0,10
14283,cūḷāmaṇidussacetyaṃ,culamanidussacetyam,1,1,0,0,19
14284,kālamhi,kalamhi,18,17,1,0,7
14285,bodhisattake,bodhisattake,1,1,0,0,12
14286,buddhakāle,buddhakale,60,54,6,0,10
14287,vandāmahaṃ,vandamaham,8,8,0,0,10
14288,pūjemahaṃ,pujemaham,1,1,0,0,9
14289,puññamidaṃ,punnamidam,4,3,1,0,10
14290,bhavatu,bhavatu,54,53,1,0,7
14291,āsavakkhaye,asavakkhaye,11,10,1,0,11
14292,takāra,takara,3,3,0,0,6
14293,nakāravipulā,nakaravipula,1,1,0,0,12
14294,tigumbacetiyathomanā,tigumbacetiyathomana,1,1,0,0,20
14295,vāsamālinīkya,vasamalinikya,1,1,0,0,13
14296,vuḍḍhopi,vuddhopi,1,1,0,0,8
14297,jinānaṃ,jinanam,11,10,1,0,7
14298,buddhosi,buddhosi,4,4,0,0,8
14299,vijānaṃ,vijanam,1,1,0,0,7
14300,pubboditi,pubboditi,1,1,0,0,9
14301,māhaṃ,maham,71,59,12,0,5
14302,kubbomi,kubbomi,1,1,0,0,7
14303,vimānaṃ,vimanam,367,338,29,0,7
14304,tanumajjhāgāthā,tanumajjhagatha,1,1,0,0,15
14305,mahāsamatakūlaṃ,mahasamatakulam,1,1,0,0,15
14306,narāpavarapūjaṃ,narapavarapujam,1,1,0,0,15
14307,jahā,jaha,3,3,0,0,4
14308,abhayapūraṃ,abhayapuram,1,1,0,0,11
14309,namā,nama,1,1,0,0,4
14310,kanakarūpaṃ,kanakarupam,1,1,0,0,11
14311,kumāralalitāgāthā,kumaralalitagatha,3,3,0,0,17
14312,narāsabhasubuddhaṃ,narasabhasubuddham,1,1,0,0,18
14313,pajāmatanuruttaṃ,pajamatanuruttam,1,1,0,0,16
14314,dayākaramuduttaṃ,dayakaramuduttam,1,1,0,0,16
14315,namāma,namama,5,5,0,0,6
14316,ha,ha,258,134,124,0,2
14317,usukkaṃ,usukkam,1,1,0,0,7
14318,vahasusīlo,vahasusilo,1,1,0,0,10
14319,pamodati,pamodati,31,30,1,0,8
14320,sukhatte,sukhatte,2,2,0,0,8
14321,tamapabuddhaṃ,tamapabuddham,1,1,0,0,13
14322,gatasukhantaṃ,gatasukhantam,1,1,0,0,13
14323,bandhu,bandhu,81,72,9,0,6
14324,santakileso,santakileso,3,3,0,0,11
14325,pitavaṇṇapabhāso,pitavannapabhaso,1,1,0,0,16
14326,gotamagottasuññato,gotamagottasunnato,1,1,0,0,18
14327,narasīho,narasiho,45,42,3,0,8
14328,citrapadāgāthā,citrapadagatha,1,1,0,0,14
14329,lokesītaṃ,lokesitam,1,1,0,0,9
14330,ukkaṃ,ukkam,36,31,5,0,5
14331,yoge,yoge,152,144,8,0,4
14332,vantātītaṃ,vantatitam,1,1,0,0,10
14333,oghe,oghe,39,35,4,0,4
14334,sīdaṃ,sidam,3,2,1,0,5
14335,vandāpīhaṃ,vandapiham,1,1,0,0,10
14336,sokehīhaṃ,sokehiham,1,1,0,0,9
14337,vijjummālāgāthā,vijjummalagatha,1,1,0,0,15
14338,bhogavatī,bhogavati,8,7,1,0,9
14339,yopakhamī,yopakhami,1,1,0,0,9
14340,sītadayā,sitadaya,1,1,0,0,8
14341,lokasakhā,lokasakha,3,3,0,0,9
14342,dhātutaye,dhatutaye,1,1,0,0,9
14343,dātu,datu,6,6,0,0,4
14344,jayetassa,jayetassa,1,1,0,0,9
14345,māṇavakagāthā,manavakagatha,1,1,0,0,13
14346,mānito,manito,83,82,1,0,6
14347,lukho,lukho,1,1,0,0,5
14348,rutotha,rutotha,1,1,0,0,7
14349,sannibho,sannibho,8,7,1,0,8
14350,subho,subho,95,88,7,0,5
14351,sukho,sukho,217,194,23,0,5
14352,jānito,janito,3,3,0,0,6
14353,thuto,thuto,16,16,0,0,5
14354,guṇova,gunova,7,7,0,0,6
14355,samānikāgāthā,samanikagatha,1,1,0,0,13
14356,pajāpuge,pajapuge,1,1,0,0,8
14357,lilaṃ,lilam,3,3,0,0,5
14358,mahāsukhe,mahasukhe,1,1,0,0,9
14359,phuṭaṃ,phutam,53,42,11,0,6
14360,pabhaṃ,pabham,28,23,5,0,6
14361,dadātu,dadatu,13,12,1,0,6
14362,pamāṇikāgāthā,pamanikagatha,1,1,0,0,13
14363,puṇṇapuññajanitasubhaṃ,punnapunnajanitasubham,1,1,0,0,22
14364,jātiñātithutiyaguṇaṃ,jatinatithutiyagunam,1,1,0,0,20
14365,bhedaveravimalajinaṃ,bhedaveravimalajinam,1,1,0,0,20
14366,ñāṇapādacaraṇamahaṃ,nanapadacaranamaham,1,1,0,0,19
14367,halamukhīgāthā,halamukhigatha,1,1,0,0,14
14368,yobhāso,yobhaso,1,1,0,0,7
14369,sukhito,sukhito,199,187,12,0,7
14370,manujapumasuto,manujapumasuto,1,1,0,0,14
14371,jayavara,jayavara,1,1,0,0,8
14372,musabho,musabho,1,1,0,0,7
14373,bhujagasusugāthā,bhujagasusugatha,1,1,0,0,16
14374,pavaro,pavaro,147,137,10,0,6
14375,lilo,lilo,1,1,0,0,4
14376,puge,puge,1,1,0,0,4
14377,lokutto,lokutto,1,1,0,0,7
14378,sukhe,sukhe,161,154,7,0,5
14379,uttiṇṇaṃ,uttinnam,10,9,1,0,8
14380,nisabhaṃ,nisabham,6,6,0,0,8
14381,vahe,vahe,18,17,1,0,4
14382,monindaṃ,monindam,1,1,0,0,8
14383,vimalaṃ,vimalam,71,63,8,0,7
14384,suddhavirājitagāthā,suddhavirajitagatha,1,1,0,0,19
14385,devindaṃ,devindam,7,7,0,0,8
14386,varagaṇatherindaṃ,varaganatherindam,1,1,0,0,17
14387,niṭṭhānaṃ,nitthanam,59,58,1,0,9
14388,bhavajananibbānaṃ,bhavajananibbanam,1,1,0,0,17
14389,niddosaṃ,niddosam,54,49,5,0,8
14390,raṇarajanipphoṭaṃ,ranarajanipphotam,1,1,0,0,17
14391,vandehaṃ,vandeham,5,5,0,0,8
14392,subhamukhasoṇṇemaṃ,subhamukhasonnemam,1,1,0,0,18
14393,paṇavagāthā,panavagatha,1,1,0,0,11
14394,gotamagotte,gotamagotte,2,2,0,0,11
14395,ketuva,ketuva,1,1,0,0,6
14396,ñātaṃ,natam,222,209,13,0,5
14397,lokajakhette,lokajakhette,1,1,0,0,12
14398,meruva,meruva,3,3,0,0,6
14399,thandilajeṭṭhe,thandilajetthe,1,1,0,0,14
14400,bheditamāraṃ,bheditamaram,1,1,0,0,12
14401,paṇḍitamajjhe,panditamajjhe,1,1,0,0,13
14402,medhiva,medhiva,1,1,0,0,7
14403,bhāṇaṃ,bhanam,1,1,0,0,6
14404,mantiya,mantiya,5,5,0,0,7
14405,sevitanāthaṃ,sevitanatham,1,1,0,0,12
14406,rummavatīgāthā,rummavatigatha,1,1,0,0,14
14407,sukko,sukko,52,46,6,0,5
14408,amitaguṇīso,amitaguniso,1,1,0,0,11
14409,sasiva,sasiva,1,1,0,0,6
14410,timīto,timito,1,1,0,0,6
14411,tejo,tejo,231,213,18,0,4
14412,tapasiva,tapasiva,1,1,0,0,8
14413,phelo,phelo,1,1,0,0,5
14414,theto,theto,30,28,2,0,5
14415,namakāro,namakaro,1,1,0,0,8
14416,mattāgāthā,mattagatha,1,1,0,0,10
14417,jitamāre,jitamare,1,1,0,0,8
14418,aji,aji,1,1,0,0,3
14419,mitasāre,mitasare,1,1,0,0,8
14420,hedhitapattaṃ,hedhitapattam,1,1,0,0,13
14421,saṃsitapuṇṇo,samsitapunno,1,1,0,0,12
14422,paṇḍitaphullo,panditaphullo,1,1,0,0,13
14423,matikassa,matikassa,1,1,0,0,9
14424,campakamālāgāthā,campakamalagatha,1,1,0,0,16
14425,kanakarūpa,kanakarupa,1,1,0,0,10
14426,mūpameyyakaṃ,mupameyyakam,1,1,0,0,12
14427,pavarasūra,pavarasura,1,1,0,0,10
14428,pūjasevataṃ,pujasevatam,1,1,0,0,11
14429,kamalabhūma,kamalabhuma,1,1,0,0,11
14430,dhūradesakaṃ,dhuradesakam,1,1,0,0,12
14431,naramarūpa,naramarupa,1,1,0,0,10
14432,tahaṃ,taham,179,174,5,0,5
14433,manoramāgāthā,manoramagatha,1,1,0,0,13
14434,dvevārā,dvevara,1,1,0,0,7
14435,gamāsi,gamasi,4,4,0,0,6
14436,sele,sele,46,32,14,0,4
14437,cale,cale,14,11,3,0,4
14438,ñātā,nata,145,141,4,0,4
14439,pacāyi,pacayi,1,1,0,0,6
14440,tevāsaṃ,tevasam,1,1,0,0,7
14441,mate,mate,170,161,9,0,4
14442,esāhaṃ,esaham,109,88,21,0,6
14443,ubbhāsakantagāthā,ubbhasakantagatha,1,1,0,0,17
14444,ukke,ukke,3,3,0,0,4
14445,sunutaṃ,sunutam,1,1,0,0,7
14446,puthukañca,puthukanca,1,1,0,0,10
14447,theraṃ,theram,1057,1044,13,0,6
14448,tathetaṃ,tathetam,2,2,0,0,8
14449,dibbe,dibbe,80,76,4,0,5
14450,paṭimaṃ,patimam,23,22,1,0,7
14451,kiriyaṃ,kiriyam,477,450,27,0,7
14452,vadetaṃ,vadetam,2,2,0,0,7
14453,iddhe,iddhe,22,22,0,0,5
14454,mahitaṃ,mahitam,7,7,0,0,7
14455,namehaṃ,nameham,2,2,0,0,7
14456,upaṭṭhitagāthā,upatthitagatha,1,1,0,0,14
14457,dibbassa,dibbassa,68,68,0,0,8
14458,pūre,pure,22,17,5,0,4
14459,pavarehi,pavarehi,1,1,0,0,8
14460,gutto,gutto,54,50,4,0,5
14461,bhūte,bhute,125,112,13,0,5
14462,nagarehi,nagarehi,5,5,0,0,8
14463,vuṭṭho,vuttho,25,25,0,0,6
14464,saṅkassa,sankassa,1,1,0,0,8
14465,magaṇehi,maganehi,1,1,0,0,8
14466,pūje,puje,1,1,0,0,4
14467,paname,paname,7,7,0,0,6
14468,ni,ni,14182,14111,71,0,2
14469,kubbo,kubbo,1,1,0,0,5
14470,thutaṃ,thutam,5,5,0,0,6
14471,rajataṃ,rajatam,159,126,33,0,7
14472,balatthaṃ,balattham,5,5,0,0,9
14473,yugaṃ,yugam,90,72,18,0,5
14474,kamatthaṃ,kamattham,7,6,1,0,9
14475,citaṃ,citam,58,55,3,0,5
14476,lohitakaṃ,lohitakam,101,86,15,0,9
14477,itaṃ,itam,14,14,0,0,4
14478,soraci,soraci,1,1,0,0,6
14479,namāhaṃ,namaham,1,1,0,0,7
14480,upendavajirāgāthā,upendavajiragatha,1,1,0,0,17
14481,pinitaṃ,pinitam,1,1,0,0,7
14482,viṇaṃ,vinam,1,1,0,0,5
14483,sakhilaṃ,sakhilam,14,10,4,0,8
14484,yaji,yaji,7,7,0,0,4
14485,susukhaṃ,susukham,51,43,8,0,8
14486,dhujaṃ,dhujam,1,1,0,0,6
14487,biluvaṃ,biluvam,1,1,0,0,7
14488,niyutaṃ,niyutam,7,5,2,0,7
14489,ṭhapiyaṃ,thapiyam,1,1,0,0,8
14490,simaṃ,simam,1,1,0,0,5
14491,thunutaṃ,thunutam,1,1,0,0,8
14492,puthulaṃ,puthulam,36,34,2,0,8
14493,khiṇaṃ,khinam,2,2,0,0,6
14494,mudukaṃ,mudukam,66,61,5,0,7
14495,sumukhīgāthā,sumukhigatha,1,1,0,0,12
14496,sogati,sogati,1,1,0,0,6
14497,bodhayiṃ,bodhayim,1,1,0,0,8
14498,gāhiya,gahiya,2,2,0,0,6
14499,otari,otari,112,110,2,0,5
14500,sonami,sonami,1,1,0,0,6
14501,jānita,janita,1,1,0,0,6
14502,bhūpati,bhupati,84,82,2,0,7
14503,pūjayi,pujayi,19,19,0,0,6
14504,sākiya,sakiya,2,2,0,0,6
14505,vaṃsaṃ,vamsam,52,46,6,0,6
14506,sūjadhi,sujadhi,1,1,0,0,7
14507,ūpadhi,upadhi,1,1,0,0,6
14508,bhāsita,bhasita,4,2,2,0,7
14509,dodhakagāthā,dodhakagatha,3,3,0,0,12
14510,yācite,yacite,21,20,1,0,6
14511,pavutthe,pavutthe,1,1,0,0,8
14512,bhoge,bhoge,440,426,14,0,5
14513,kāmite,kamite,2,2,0,0,6
14514,oghamutte,oghamutte,1,1,0,0,9
14515,tosetaṃ,tosetam,1,1,0,0,7
14516,colayutte,colayutte,1,1,0,0,9
14517,tatthāloke,tatthaloke,1,1,0,0,10
14518,taṃpate,tampate,1,1,0,0,7
14519,padukke,padukke,1,1,0,0,7
14520,sālinīgāthā,salinigatha,1,1,0,0,11
14521,sattāloko,sattaloko,1,1,0,0,9
14522,sarito,sarito,4,4,0,0,6
14523,dhajukkaṃ,dhajukkam,1,1,0,0,9
14524,tatthāgopo,tatthagopo,1,1,0,0,10
14525,raciyonojamuddhaṃ,raciyonojamuddham,1,1,0,0,17
14526,bhaddāsokopacitobho,bhaddasokopacitobho,1,1,0,0,19
14527,pabuddhaṃ,pabuddham,7,6,1,0,9
14528,saddhāyogo,saddhayogo,1,1,0,0,10
14529,sohonamuccaṃ,sohonamuccam,1,1,0,0,12
14530,vātompīgāthā,vatompigatha,1,1,0,0,12
14531,ñātamarūnaṃ,natamarunam,1,1,0,0,11
14532,ṭhitānaṃ,thitanam,263,257,6,0,8
14533,vālapasūkaṃ,valapasukam,1,1,0,0,11
14534,huvati,huvati,2,2,0,0,6
14535,devasuyāmo,devasuyamo,1,1,0,0,10
14536,jinamiti,jinamiti,1,1,0,0,8
14537,ñāto,nato,300,289,11,0,4
14538,sukhābho,sukhabho,1,1,0,0,8
14539,vinami,vinami,1,1,0,0,6
14540,idā,ida,1,1,0,0,3
14541,sirīgāthā,sirigatha,1,1,0,0,9
14542,puṇṇakena,punnakena,6,4,2,0,9
14543,kusumena,kusumena,2,2,0,0,8
14544,sevataṃ,sevatam,1,1,0,0,7
14545,kuñjareva,kunjareva,1,1,0,0,9
14546,thunutena,thunutena,1,1,0,0,9
14547,sundarena,sundarena,21,21,0,0,9
14548,puññatejakaridhesa,punnatejakaridhesa,1,1,0,0,18
14549,rathoddhatāgāthā,rathoddhatagatha,1,1,0,0,16
14550,khiṇuke,khinuke,1,1,0,0,7
14551,visutedisakucce,visutedisakucce,1,1,0,0,15
14552,vāta,vata,14,12,2,0,4
14553,tāla,tala,8,7,1,0,4
14554,khacitenidha,khacitenidha,1,1,0,0,12
14555,soṇṇe,sonne,1,1,0,0,5
14556,tetisa,tetisa,1,1,0,0,6
14557,svāgatagāthā,svagatagatha,1,1,0,0,12
14558,kamalayoni,kamalayoni,2,2,0,0,10
14559,sobhitaṃ,sobhitam,17,17,0,0,8
14560,juhati,juhati,19,17,2,0,6
14561,dhavalajotidositaṃ,dhavalajotidositam,1,1,0,0,18
14562,sukari,sukari,1,1,0,0,6
14563,yamatabodhimocitaṃ,yamatabodhimocitam,1,1,0,0,18
14564,sunami,sunami,2,2,0,0,6
14565,caraṇalokidhorimaṃ,caranalokidhorimam,1,1,0,0,18
14566,bhaddikāgāthā,bhaddikagatha,1,1,0,0,13
14567,vinayaṃ,vinayam,467,443,24,0,7
14568,supekkhimaṃ,supekkhimam,1,1,0,0,11
14569,ṭhitobho,thitobho,1,1,0,0,8
14570,dijakaṃ,dijakam,1,1,0,0,7
14571,dubajjitaṃ,dubajjitam,1,1,0,0,10
14572,aghenidho,aghenidho,1,1,0,0,9
14573,khobhitaraṃ,khobhitaram,1,1,0,0,11
14574,munecchidaṃ,munecchidam,1,1,0,0,11
14575,namebhito,namebhito,1,1,0,0,9
14576,bodhimahaṃ,bodhimaham,4,4,0,0,10
14577,lukhajjhitaṃ,lukhajjhitam,1,1,0,0,12
14578,jātidomānīmupāsi,jatidomanimupasi,1,1,0,0,16
14579,lambi,lambi,1,1,0,0,5
14580,kodhehi,kodhehi,1,1,0,0,7
14581,dubhāsi,dubhasi,1,1,0,0,7
14582,paṇḍitaṃ,panditam,214,205,9,0,8
14583,pūrepi,purepi,3,3,0,0,6
14584,mūlepi,mulepi,12,9,3,0,6
14585,pahāsi,pahasi,57,51,6,0,6
14586,diṭṭhikaṃ,ditthikam,1,1,0,0,9
14587,sabbehi,sabbehi,400,389,11,0,7
14588,pattehi,pattehi,51,50,1,0,7
14589,indavaṃsāgāthā,indavamsagatha,2,2,0,0,14
14590,verañjake,veranjake,2,2,0,0,9
14591,pūravare,puravare,1,1,0,0,8
14592,vibhūsite,vibhusite,3,3,0,0,9
14593,nelañjane,nelanjane,1,1,0,0,9
14594,dūmavane,dumavane,1,1,0,0,8
14595,vikūjite,vikujite,1,1,0,0,8
14596,khemaṅkare,khemankare,1,1,0,0,10
14597,thūlatare,thulatare,2,2,0,0,9
14598,site,site,7,6,1,0,4
14599,etaṅgame,etangame,1,1,0,0,8
14600,pūna,puna,2,2,0,0,4
14601,virūpi,virupi,1,1,0,0,6
14602,adhunāpi,adhunapi,6,6,0,0,8
14603,sārisuto,sarisuto,1,1,0,0,8
14604,nimalaṃ,nimalam,2,2,0,0,7
14605,tamupāsi,tamupasi,1,1,0,0,8
14606,matāpi,matapi,6,6,0,0,6
14607,ci,ci,90,54,36,0,2
14608,nayaṃ,nayam,283,256,27,0,5
14609,karuṇāyi,karunayi,1,1,0,0,8
14610,dha,dha,2381,2332,49,0,3
14611,yāci,yaci,480,477,3,0,4
14612,garukāpi,garukapi,2,2,0,0,8
14613,suyo,suyo,1,1,0,0,4
14614,jitahaṃ,jitaham,1,1,0,0,7
14615,toṭakagāthā,totakagatha,1,1,0,0,11
14616,janavaro,janavaro,1,1,0,0,8
14617,vasabhato,vasabhato,1,1,0,0,9
14618,uditopari,uditopari,1,1,0,0,9
14619,gotame,gotame,44,43,1,0,6
14620,gamanaso,gamanaso,1,1,0,0,8
14621,guṇiko,guniko,1,1,0,0,6
14622,gamito,gamito,17,17,0,0,6
14623,nagarado,nagarado,1,1,0,0,8
14624,jutimo,jutimo,1,1,0,0,6
14625,ghatitosathe,ghatitosathe,1,1,0,0,12
14626,dutavilambitagāthā,dutavilambitagatha,1,1,0,0,18
14627,bhagavati,bhagavati,807,796,11,0,9
14628,kuṭigāre,kutigare,1,1,0,0,8
14629,nisinne,nisinne,290,287,3,0,7
14630,dhanavati,dhanavati,1,1,0,0,9
14631,suvisāleko,suvisaleko,1,1,0,0,10
14632,isinde,isinde,1,1,0,0,6
14633,yamalabhi,yamalabhi,1,1,0,0,9
14634,lābhe,labhe,91,80,11,0,5
14635,molichinne,molichinne,1,1,0,0,10
14636,panami,panami,3,3,0,0,6
14637,jutimāseto,jutimaseto,1,1,0,0,10
14638,kilinne,kilinne,3,2,1,0,7
14639,puṭagāthā,putagatha,1,1,0,0,9
14640,paṭhapitamiccassa,pathapitamiccassa,1,1,0,0,17
14641,sidatu,sidatu,1,1,0,0,6
14642,paṭhamidha,pathamidha,1,1,0,0,10
14643,sikkhassa,sikkhassa,1,1,0,0,9
14644,hitasukhatthaṃ,hitasukhattham,3,3,0,0,14
14645,pavadiya,pavadiya,1,1,0,0,8
14646,giddhassa,giddhassa,1,1,0,0,9
14647,khiṇalukhatthaṃ,khinalukhattham,1,1,0,0,15
14648,kiccassa,kiccassa,75,73,2,0,8
14649,sikhamukappaṃ,sikhamukappam,1,1,0,0,13
14650,kusumavicittāgāthā,kusumavicittagatha,1,1,0,0,18
14651,nilobhāsi,nilobhasi,1,1,0,0,9
14652,dhūmehi,dhumehi,2,2,0,0,7
14653,yucco,yucco,1,1,0,0,5
14654,cābhi,cabhi,1,1,0,0,5
14655,bhū,bhu,181,67,114,0,3
14656,rukkhodigāhe,rukkhodigahe,1,1,0,0,12
14657,yito,yito,7,7,0,0,4
14658,luddho,luddho,73,69,4,0,6
14659,dvivāre,dvivare,3,3,0,0,7
14660,jinokāsi,jinokasi,3,3,0,0,8
14661,pūjemi,pujemi,17,17,0,0,6
14662,hitāse,hitase,1,1,0,0,6
14663,bhujaṅgappayātagāthā,bhujangappayatagatha,1,1,0,0,20
14664,janarame,janarame,1,1,0,0,8
14665,dasasare,dasasare,1,1,0,0,8
14666,visālake,visalake,1,1,0,0,8
14667,munivare,munivare,1,1,0,0,8
14668,kuṭighareriyāpathe,kutighareriyapathe,1,1,0,0,18
14669,dhutataresubhakathe,dhutataresubhakathe,1,1,0,0,19
14670,tatiyaketamidha,tatiyaketamidha,1,1,0,0,15
14671,ṭhapi,thapi,2,2,0,0,5
14672,piyaṃvadāgāthā,piyamvadagatha,1,1,0,0,14
14673,vesālike,vesalike,8,8,0,0,8
14674,vasi,vasi,384,383,1,0,4
14675,kātu,katu,4,4,0,0,4
14676,cātukaṃ,catukam,1,1,0,0,7
14677,ñāhi,nahi,1,1,0,0,4
14678,labhidhāmukāmukaṃ,labhidhamukamukam,1,1,0,0,17
14679,negāmikesu,negamikesu,1,1,0,0,10
14680,phāsu,phasu,400,365,35,0,5
14681,sāyukaṃ,sayukam,1,1,0,0,7
14682,etādhikesu,etadhikesu,1,1,0,0,10
14683,namikāsudātulaṃ,namikasudatulam,1,1,0,0,15
14684,lalitāgāthā,lalitagatha,1,1,0,0,11
14685,vadi,vadi,12,11,1,0,4
14686,suppiyo,suppiyo,31,29,2,0,7
14687,duvacanaṃ,duvacanam,1,1,0,0,9
14688,tamato,tamato,5,4,1,0,6
14689,sahi,sahi,1,1,0,0,4
14690,muttiko,muttiko,3,3,0,0,7
14691,guṇakathaṃ,gunakatham,67,67,0,0,10
14692,tathato,tathato,70,70,0,0,7
14693,gami,gami,46,35,11,0,4
14694,māṇavo,manavo,585,573,12,0,6
14695,durapathaṃ,durapatham,1,1,0,0,10
14696,carato,carato,109,102,7,0,6
14697,budhavaraṃ,budhavaram,1,1,0,0,10
14698,paraso,paraso,2,2,0,0,6
14699,pamitakkharāgāthā,pamitakkharagatha,1,1,0,0,17
14700,yupagami,yupagami,1,1,0,0,8
14701,vimalo,vimalo,83,71,12,0,6
14702,sakhilo,sakhilo,36,32,4,0,7
14703,yuvavatipivano,yuvavatipivano,1,1,0,0,14
14704,rami,rami,2,2,0,0,4
14705,ekasayi,ekasayi,1,1,0,0,7
14706,ṭhitato,thitato,3,3,0,0,7
14707,kathi,kathi,3,1,2,0,5
14708,esa,esa,3457,3252,205,0,3
14709,jinamo,jinamo,1,1,0,0,6
14710,padhidojuke,padhidojuke,1,1,0,0,11
14711,ujjalāgāthā,ujjalagatha,1,1,0,0,11
14712,desi,desi,50,49,1,0,4
14713,khodhimuttaṃ,khodhimuttam,1,1,0,0,12
14714,ānandattheraṃ,anandattheram,87,86,1,0,13
14715,vedito,vedito,3,3,0,0,6
14716,coḷisuttaṃ,colisuttam,1,1,0,0,10
14717,kāyassammukhe,kayassammukhe,1,1,0,0,13
14718,kātunolokiyaṃse,katunolokiyamse,1,1,0,0,15
14719,ṭhānassappuge,thanassappuge,1,1,0,0,13
14720,kāruṇo,karuno,2,2,0,0,6
14721,vessadevī,vessadevi,2,1,1,0,9
14722,sukathiya,sukathiya,1,1,0,0,9
14723,majjhimasīlamaparaṃ,majjhimasilamaparam,1,1,0,0,19
14724,yupacitametthidha,yupacitametthidha,1,1,0,0,17
14725,cīramanayaṃ,ciramanayam,1,1,0,0,11
14726,budhayi,budhayi,1,1,0,0,7
14727,bhajjitamīṇavataraṃ,bhajjitaminavataram,1,1,0,0,19
14728,pavajjitamīhamamalaṃ,pavajjitamihamamalam,1,1,0,0,20
14729,tāmarasagāthā,tamarasagatha,1,1,0,0,13
14730,mahakañhi,mahakanhi,1,1,0,0,9
14731,sīlampi,silampi,18,18,0,0,7
14732,abhāsi,abhasi,1323,1317,6,0,6
14733,kante,kante,6,6,0,0,5
14734,brahmathandilī,brahmathandili,1,1,0,0,14
14735,mamhi,mamhi,3,3,0,0,5
14736,manāpi,manapi,1,1,0,0,6
14737,ramme,ramme,163,158,5,0,5
14738,calakampi,calakampi,1,1,0,0,9
14739,gīrampi,girampi,1,1,0,0,7
14740,ambe,ambe,30,29,1,0,4
14741,varapaṇḍi,varapandi,1,1,0,0,9
14742,khīṇampi,khinampi,2,2,0,0,8
14743,kamalāgāthā,kamalagatha,1,1,0,0,11
14744,mohante,mohante,1,1,0,0,7
14745,jini,jini,8,7,1,0,4
14746,paṭhame,pathame,851,822,29,0,7
14747,jitāyaṃ,jitayam,1,1,0,0,7
14748,soramme,soramme,1,1,0,0,7
14749,isipatane,isipatane,142,138,4,0,9
14750,nivāsaṃ,nivasam,75,72,3,0,7
14751,khobhante,khobhante,1,1,0,0,9
14752,kiri,kiri,11,11,0,0,4
14753,sakale,sakale,81,78,3,0,6
14754,vilāsaṃ,vilasam,6,6,0,0,7
14755,ghoraṃve,ghoramve,1,1,0,0,8
14756,vinidamane,vinidamane,1,1,0,0,10
14757,jināhaṃ,jinaham,1,1,0,0,7
14758,pahāsinīgāthā,pahasinigatha,1,1,0,0,13
14759,divārakaṃ,divarakam,1,1,0,0,9
14760,bajanagaraṃ,bajanagaram,1,1,0,0,11
14761,phitaṃ,phitam,1,1,0,0,6
14762,nisāya,nisaya,3,3,0,0,6
14763,janagaṇanaṃ,janagananam,1,1,0,0,11
14764,vijānakaṃ,vijanakam,1,1,0,0,9
14765,tamajaṭakaṃ,tamajatakam,1,1,0,0,11
14766,sitaṃ,sitam,215,189,26,0,5
14767,hitāvahaṃ,hitavaham,16,16,0,0,9
14768,narapavaraṃ,narapavaram,1,1,0,0,11
14769,ruciragāthā,ruciragatha,1,1,0,0,11
14770,racitamaviralaṃ,racitamaviralam,1,1,0,0,15
14771,mathā,matha,6,5,1,0,5
14772,paṇaṃ,panam,1,1,0,0,5
14773,pasiya,pasiya,1,1,0,0,6
14774,tatiyakaṃ,tatiyakam,7,7,0,0,9
14775,catuttha,catuttha,37,36,1,0,8
14776,karitamadhikataṃ,karitamadhikatam,1,1,0,0,16
14777,akhubbhamalā,akhubbhamala,1,1,0,0,12
14778,sabhaṃ,sabham,31,23,8,0,6
14779,jahitagatiparaṃ,jahitagatiparam,1,1,0,0,15
14780,panujja,panujja,26,18,8,0,7
14781,parājitāgāthā,parajitagatha,1,1,0,0,13
14782,nagaramajayamesa,nagaramajayamesa,1,1,0,0,16
14783,nivasi,nivasi,3,3,0,0,6
14784,mahati,mahati,62,62,0,0,6
14785,maṇike,manike,9,8,1,0,6
14786,sakuṇakujavane,sakunakujavane,1,1,0,0,14
14787,yapati,yapati,1,1,0,0,6
14788,vasati,vasati,760,751,9,0,6
14789,hitasivavahane,hitasivavahane,1,1,0,0,14
14790,surata,surata,1,1,0,0,6
14791,mubhayamesita,mubhayamesita,1,1,0,0,13
14792,mima,mima,9,3,6,0,4
14793,paharaṇakalikāgāthā,paharanakalikagatha,1,1,0,0,19
14794,athuda,athuda,1,1,0,0,6
14795,mune,mune,45,45,0,0,4
14796,dhare,dhare,1,1,0,0,5
14797,makulapabbatake,makulapabbatake,1,1,0,0,15
14798,upedaṃ,upedam,1,1,0,0,6
14799,cattaṃ,cattam,43,36,7,0,6
14800,male,male,16,15,1,0,4
14801,manuja,manuja,3,2,1,0,6
14802,matthavase,matthavase,1,1,0,0,10
14803,sudesaṃ,sudesam,1,1,0,0,7
14804,bhattaṃ,bhattam,1521,1475,46,0,7
14805,lahuka,lahuka,4,4,0,0,6
14806,mappa,mappa,1,1,0,0,5
14807,mare,mare,2,2,0,0,4
14808,dhune,dhune,2,2,0,0,5
14809,nuna,nuna,7,7,0,0,4
14810,upavasati,upavasati,26,26,0,0,9
14811,parime,parime,2,2,0,0,6
14812,sukhaguṇamahati,sukhagunamahati,1,1,0,0,15
14813,tidasapura,tidasapura,2,2,0,0,10
14814,ajite,ajite,2,2,0,0,5
14815,yuganuta,yuganuta,1,1,0,0,8
14816,mavadi,mavadi,1,1,0,0,6
14817,vitatha,vitatha,1,1,0,0,7
14818,mughatari,mughatari,1,1,0,0,9
14819,hutathuna,hutathuna,1,1,0,0,9
14820,manami,manami,1,1,0,0,6
14821,simada,simada,1,1,0,0,6
14822,mariye,mariye,1,1,0,0,6
14823,sasikalāgāthā,sasikalagatha,1,1,0,0,13
14824,jinapati,jinapati,1,1,0,0,8
14825,susumāraṃ,susumaram,6,6,0,0,9
14826,bhesakallāvanesaṃ,bhesakallavanesam,1,1,0,0,17
14827,puthuñāṇaṃ,puthunanam,1,1,0,0,10
14828,khvesa,khvesa,24,22,2,0,6
14829,nandālayetaṃ,nandalayetam,1,1,0,0,12
14830,vimalami,vimalami,1,1,0,0,8
14831,dhujukāyaṃ,dhujukayam,1,1,0,0,10
14832,bhedasantāpasesaṃ,bhedasantapasesam,1,1,0,0,17
14833,vijahapi,vijahapi,1,1,0,0,8
14834,sukhumālaṃ,sukhumalam,10,10,0,0,10
14835,esamantā,esamanta,1,1,0,0,8
14836,sukantiye,sukantiye,1,1,0,0,9
14837,sītale,sitale,26,26,0,0,6
14838,kusambiye,kusambiye,1,1,0,0,9
14839,navamavassapītare,navamavassapitare,1,1,0,0,17
14840,avahi,avahi,2,2,0,0,5
14841,sukhantime,sukhantime,1,1,0,0,10
14842,pajahamatthamīdha,pajahamatthamidha,1,1,0,0,17
14843,nudaṃ,nudam,8,6,2,0,5
14844,hine,hine,1,1,0,0,4
14845,sakalasatthavasaye,sakalasatthavasaye,1,1,0,0,18
14846,pabhaddakagāthā,pabhaddakagatha,1,1,0,0,15
14847,yudhavati,yudhavati,1,1,0,0,9
14848,pālileyyaka,palileyyaka,6,6,0,0,11
14849,nāge,nage,62,59,3,0,4
14850,upaṭhahi,upathahi,1,1,0,0,8
14851,nāgidhesa,nagidhesa,1,1,0,0,9
14852,dasame,dasame,441,435,6,0,6
14853,jahāya,jahaya,3,3,0,0,6
14854,sukhavasi,sukhavasi,1,1,0,0,9
14855,kāyike,kayike,4,4,0,0,6
14856,manake,manake,1,1,0,0,6
14857,tadāsa,tadasa,1,1,0,0,6
14858,sāte,sate,1,1,0,0,4
14859,yutamadhi,yutamadhi,1,1,0,0,9
14860,vāhite,vahite,1,1,0,0,6
14861,payāta,payata,2,2,0,0,6
14862,māre,mare,22,22,0,0,4
14863,patte,patte,790,755,35,0,5
14864,nāḷe,nale,8,7,1,0,4
14865,dijagāmepi,dijagamepi,1,1,0,0,10
14866,hitopatthenāyeka,hitopatthenayeka,1,1,0,0,16
14867,adhikidha,adhikidha,1,1,0,0,9
14868,vādehi,vadehi,8,8,0,0,6
14869,vadake,vadake,1,1,0,0,6
14870,vilomatthehānekasahi,vilomatthehanekasahi,1,1,0,0,20
14871,ṭhitamāghepi,thitamaghepi,1,1,0,0,12
14872,viyogatthetānejamapi,viyogatthetanejamapi,1,1,0,0,20
14873,pihavāsehi,pihavasehi,1,1,0,0,10
14874,sikharaṇīgāthā,sikharanigatha,1,1,0,0,14
14875,dviadhikitare,dviadhikitare,1,1,0,0,13
14876,verañjāyaṃ,veranjayam,82,73,9,0,10
14877,nilake,nilake,1,1,0,0,6
14878,khedaṅghātaṃ,khedanghatam,1,1,0,0,12
14879,kilami,kilami,10,10,0,0,6
14880,vehaṅgānaṃ,vehanganam,1,1,0,0,10
14881,manoramakaṃ,manoramakam,1,1,0,0,11
14882,virajisigaṇe,virajisigane,1,1,0,0,12
14883,medhaṅkāraṃ,medhankaram,1,1,0,0,11
14884,asokadadaṃ,asokadadam,1,1,0,0,10
14885,hiriṇīgāthā,hirinigatha,1,1,0,0,11
14886,sampuṇṇe,sampunne,8,8,0,0,8
14887,tirase,tirase,1,1,0,0,6
14888,cāliye,caliye,1,1,0,0,6
14889,pabbatepi,pabbatepi,3,3,0,0,9
14890,sobhaṃ,sobham,29,27,2,0,6
14891,phulle,phulle,1,1,0,0,6
14892,suvasi,suvasi,1,1,0,0,6
14893,itare,itare,710,690,20,0,5
14894,appamehi,appamehi,1,1,0,0,8
14895,sāvatthikkenuda,savatthikkenuda,1,1,0,0,15
14896,catudase,catudase,1,1,0,0,8
14897,ālayepi,alayepi,1,1,0,0,7
14898,kāmocchidde,kamocchidde,1,1,0,0,11
14899,bhaya,bhaya,28,20,8,0,5
14900,muname,muname,1,1,0,0,6
14901,ñātime,natime,1,1,0,0,6
14902,dvārakehi,dvarakehi,1,1,0,0,9
14903,mandakkantāgāthā,mandakkantagatha,1,1,0,0,16
14904,kappile,kappile,2,2,0,0,7
14905,kariya,kariya,10,10,0,0,6
14906,madake,madake,1,1,0,0,6
14907,niggaho,niggaho,98,89,9,0,7
14908,pañce,pance,2,2,0,0,5
14909,kappiye,kappiye,80,70,10,0,7
14910,vasidha,vasidha,1,1,0,0,7
14911,yamake,yamake,43,28,15,0,6
14912,iddhako,iddhako,1,1,0,0,7
14913,bhohi,bhohi,1,1,0,0,5
14914,yakkho,yakkho,580,556,24,0,6
14915,dabbike,dabbike,1,1,0,0,7
14916,damiya,damiya,1,1,0,0,6
14917,soḷasetopi,solasetopi,1,1,0,0,10
14918,vaṅke,vanke,23,22,1,0,5
14919,aggoghattite,aggoghattite,1,1,0,0,12
14920,paciya,paciya,1,1,0,0,6
14921,bodhake,bodhake,1,1,0,0,7
14922,monipaññe,monipanne,1,1,0,0,9
14923,kusumitalatāvellitagāthā,kusumitalatavellitagatha,1,1,0,0,24
14924,duladdhe,duladdhe,1,1,0,0,8
14925,yopari,yopari,1,1,0,0,6
14926,dasato,dasato,1,1,0,0,6
14927,rājagehaṃ,rajageham,54,54,0,0,9
14928,bhajanto,bhajanto,13,13,0,0,8
14929,kūle,kule,11,10,1,0,4
14930,kari,kari,99,97,2,0,4
14931,yapato,yapato,2,1,1,0,6
14932,vāsamejaṃ,vasamejam,1,1,0,0,9
14933,jahanto,jahanto,17,17,0,0,7
14934,dumaṭṭhe,dumatthe,1,1,0,0,8
14935,pūneso,puneso,1,1,0,0,6
14936,ramitacalato,ramitacalato,1,1,0,0,12
14937,ṭṭhārasetaṃ,ttharasetam,1,1,0,0,11
14938,guṇasse,gunasse,1,1,0,0,7
14939,vūpeto,vupeto,1,1,0,0,6
14940,namidha,namidha,1,1,0,0,7
14941,karabho,karabho,7,5,2,0,7
14942,kāyakhedaṃ,kayakhedam,1,1,0,0,10
14943,sahanto,sahanto,15,14,1,0,7
14944,meghavipphujjitagāthā,meghavipphujjitagatha,1,1,0,0,21
14945,cālīye,caliye,1,1,0,0,6
14946,acalekūnepi,acalekunepi,1,1,0,0,11
14947,vīse,vise,12,9,3,0,4
14948,bhāgī,bhagi,199,192,7,0,5
14949,hite,hite,79,70,9,0,4
14950,pavase,pavase,1,1,0,0,6
14951,sūrehi,surehi,4,4,0,0,6
14952,nisevitaṃ,nisevitam,30,25,5,0,9
14953,ramike,ramike,1,1,0,0,6
14954,hārite,harite,1,1,0,0,6
14955,vasime,vasime,1,1,0,0,6
14956,jahena,jahena,1,1,0,0,6
14957,khīṇe,khine,57,52,5,0,5
14958,saddūlavikkīlitagāthā,saddulavikkilitagatha,1,1,0,0,21
14959,pañcapañcamākare,pancapancamakare,1,1,0,0,16
14960,tatopi,tatopi,350,337,13,0,6
14961,piṇḍakena,pindakena,58,58,0,0,9
14962,jetakānane,jetakanane,1,1,0,0,10
14963,aññamaññamādarena,annamannamadarena,1,1,0,0,17
14964,nisinnakena,nisinnakena,1,1,0,0,11
14965,māpayeva,mapayeva,1,1,0,0,8
14966,pubbapubbaārāme,pubbapubbaarame,1,1,0,0,15
14967,payojipāsikāya,payojipasikaya,1,1,0,0,14
14968,vāramāvasedha,varamavasedha,1,1,0,0,13
14969,suddhasuddhamāmalena,suddhasuddhamamalena,1,1,0,0,20
14970,poriyātimāya,poriyatimaya,1,1,0,0,12
14971,mānasā,manasa,74,71,3,0,6
14972,namesa,namesa,1,1,0,0,6
14973,vuttagāthā,vuttagatha,15,15,0,0,10
14974,puññenā,punnena,7,6,1,0,7
14975,nena,nena,21,17,4,0,4
14976,saṃsāramupadhi,samsaramupadhi,1,1,0,0,14
14977,sappūrise,sappurise,1,1,0,0,9
14978,vo,vo,2817,2641,176,0,2
14979,paseve,paseve,1,1,0,0,6
14980,tehā,teha,5,5,0,0,4
14981,sugāho,sugaho,1,1,0,0,6
14982,suciparisaupeto,suciparisaupeto,1,1,0,0,15
14983,dīghāyūko,dighayuko,1,1,0,0,9
14984,mahāpañña,mahapanna,8,8,0,0,9
14985,yasadhanasulābho,yasadhanasulabho,1,1,0,0,16
14986,lokādibbo,lokadibbo,1,1,0,0,9
14987,samamatiparivārova,samamatiparivarova,1,1,0,0,18
14988,nibbānapatto,nibbanapatto,4,4,0,0,12
14989,saddharāgāthā,saddharagatha,1,1,0,0,13
14990,nassati,nassati,277,272,5,0,7
14991,sāsane,sasane,1738,1698,40,0,6
14992,chanavutādhike,chanavutadhike,4,4,0,0,14
14993,tivise,tivise,1,1,0,0,6
14994,sate,sate,28,28,0,0,4
14995,kaliyuge,kaliyuge,86,86,0,0,8
14996,dvesatacuddasādhikasahassake,dvesatacuddasadhikasahassake,1,1,0,0,28
14997,sakalaraṭṭhakaṃ,sakalaratthakam,1,1,0,0,15
14998,khubhi,khubhi,1,1,0,0,6
14999,bhātikayuddhakena,bhatikayuddhakena,1,1,0,0,17
15000,nagaraṃ,nagaram,1649,1605,44,0,7
15001,chārikā,charika,49,46,3,0,7
15002,yatigaṇo,yatigano,1,1,0,0,8
15003,dukkhagato,dukkhagato,1,1,0,0,10
15004,mahāpaharaṇehi,mahapaharanehi,1,1,0,0,14
15005,jivitakhayampi,jivitakhayampi,1,1,0,0,14
15006,piṭake,pitake,41,34,7,0,6
15007,bhaddakagāthā,bhaddakagatha,1,1,0,0,13
15008,udisaka,udisaka,1,1,0,0,7
15009,cetyakepi,cetyakepi,1,1,0,0,9
15010,vikiriya,vikiriya,5,5,0,0,8
15011,nāsati,nasati,43,43,0,0,6
15012,thiro,thiro,38,37,1,0,5
15013,sagaṇato,saganato,1,1,0,0,8
15014,vijahiya,vijahiya,1,1,0,0,8
15015,ttaravaneka,ttaravaneka,1,1,0,0,11
15016,kumbhakaragāmakaṃ,kumbhakaragamakam,1,1,0,0,17
15017,nivasaye,nivasaye,1,1,0,0,8
15018,satagaṇakehi,sataganakehi,1,1,0,0,12
15019,janakopi,janakopi,1,1,0,0,8
15020,bhota,bhota,1,1,0,0,5
15021,sabbayatinaṃ,sabbayatinam,1,1,0,0,12
15022,upaṭṭhahamī,upatthahami,1,1,0,0,11
15023,tamhi,tamhi,314,292,22,0,5
15024,katipāhanaṃ,katipahanam,1,1,0,0,11
15025,vimaṃsiya,vimamsiya,1,1,0,0,9
15026,lalitagāthā,lalitagatha,1,1,0,0,11
15027,ga,ga,315,264,51,0,2
15028,araññe,aranne,1039,1012,27,0,6
15029,ramito,ramito,9,7,2,0,6
15030,sucari,sucari,1,1,0,0,6
15031,saddhammatimāni,saddhammatimani,1,1,0,0,15
15032,suyatīhi,suyatihi,1,1,0,0,8
15033,tipīko,tipiko,1,1,0,0,6
15034,dhūrasuyutto,dhurasuyutto,1,1,0,0,12
15035,parigāhiya,parigahiya,1,1,0,0,10
15036,sujāto,sujato,203,189,14,0,6
15037,supaṭṭhāti,supatthati,1,1,0,0,10
15038,kunaditamuyānaṃ,kunaditamuyanam,1,1,0,0,15
15039,satamaccehi,satamaccehi,1,1,0,0,11
15040,nagari,nagari,1,1,0,0,6
15041,daṃ,dam,51,40,11,0,3
15042,pācina,pacina,6,6,0,0,6
15043,raha,raha,22,11,11,0,4
15044,dhikakose,dhikakose,1,1,0,0,9
15045,paccayanāyāsu,paccayanayasu,1,1,0,0,13
15046,da,da,153,34,119,0,2
15047,chāyabahuko,chayabahuko,1,1,0,0,11
15048,suddhayatipi,suddhayatipi,1,1,0,0,12
15049,vasanakāle,vasanakale,12,12,0,0,10
15050,tanugāthā,tanugatha,1,1,0,0,9
15051,gha,gha,207,184,23,0,3
15052,phagguṇamāse,phaggunamase,5,5,0,0,12
15053,chadine,chadine,1,1,0,0,7
15054,raciya,raciya,1,1,0,0,6
15055,niṭṭhaṃva,nitthamva,1,1,0,0,9
15056,paramari,paramari,1,1,0,0,8
15057,imināyaṃ,iminayam,4,4,0,0,8
15058,sijjhatu,sijjhatu,7,7,0,0,8
15059,pemaṃ,pemam,215,182,33,0,5
15060,rakkhatu,rakkhatu,12,12,0,0,8
15061,sudevo,sudevo,29,28,1,0,6
15062,uda,uda,102,74,28,0,3
15063,vaḍḍhatu,vaddhatu,2,2,0,0,8
15064,jinavacane,jinavacane,5,5,0,0,10
15065,vāsamālinī,vasamalini,1,1,0,0,10
15066,lakkhaṇāto,lakkhanato,1,1,0,0,10
15067,buddhathomanāgāthā,buddhathomanagatha,1,1,0,0,18
15068,bhavābhavesu,bhavabhavesu,29,24,5,0,12
15069,nekesu,nekesu,4,4,0,0,6
15070,pūresi,puresi,78,78,0,0,6
15071,tiṃsapāramī,timsaparami,2,2,0,0,11
15072,cariyāyoca,cariyayoca,1,1,0,0,10
15073,pariccāgejahaṃsadā,pariccagejahamsada,1,1,0,0,18
15074,vessantarattabhāvamhi,vessantarattabhavamhi,1,1,0,0,21
15075,ṭhitomaddiṃ,thitomaddim,1,1,0,0,11
15076,pisoadā,pisoada,1,1,0,0,7
15077,nijaṃkaṇhājinaṃjāliṃ,nijamkanhajinamjalim,1,1,0,0,20
15078,viyaṃvaṅkatapabbate,viyamvankatapabbate,1,1,0,0,19
15079,tatocavitvātusite,tatocavitvatusite,1,1,0,0,17
15080,pureuppajjipuññavā,pureuppajjipunnava,1,1,0,0,18
15081,rūpādidasaṭhānehi,rupadidasathanehi,1,1,0,0,17
15082,aññedeveatikkami,annedeveatikkami,1,1,0,0,16
15083,dasahāgammasabbaso,dasahagammasabbaso,1,1,0,0,18
15084,yācitodevabrahmūhi,yacitodevabrahmuhi,1,1,0,0,18
15085,buddhabhāvamanonato,buddhabhavamanonato,1,1,0,0,19
15086,vilokanānisopañca,vilokananisopanca,1,1,0,0,17
15087,viloketvāsirindharo,viloketvasirindharo,1,1,0,0,19
15088,tatocavitvāmāyāya,tatocavitvamayaya,1,1,0,0,17
15089,uppajjisākiyekule,uppajjisakiyekule,1,1,0,0,17
15090,visākhapuṇṇameseṭṭhe,visakhapunnamesetthe,1,1,0,0,20
15091,vijāyilumbinīvane,vijayilumbinivane,1,1,0,0,17
15092,sīhanādaṃpanādento,sihanadampanadento,1,1,0,0,18
15093,sattapādaṃgatotadā,sattapadamgatotada,1,1,0,0,18
15094,virociṃsutadākāse,virocimsutadakase,1,1,0,0,17
15095,tārocandadivākarā,tarocandadivakara,1,1,0,0,17
15096,ratanānicabhūmaṭṭhā,ratananicabhumattha,1,1,0,0,19
15097,nānāpupphācapupphare,nanapupphacapupphare,1,1,0,0,20
15098,sītāyanti,sitayanti,2,2,0,0,9
15099,avīcaggī,avicaggi,1,1,0,0,8
15100,khuppipāsācasohitā,khuppipasacasohita,1,1,0,0,18
15101,lokantaremahāpabhā,lokantaremahapabha,1,1,0,0,18
15102,andhāpassantitāvade,andhapassantitavade,1,1,0,0,19
15103,aghaṭṭitāvāditāni,aghattitavaditani,1,1,0,0,17
15104,tūriyānicaambare,turiyanicaambare,1,1,0,0,16
15105,madhurenapanādiṃsu,madhurenapanadimsu,1,1,0,0,18
15106,yasaṃsarenatāvade,yasamsarenatavade,1,1,0,0,17
15107,thutigītānigāyantā,thutigitanigayanta,1,1,0,0,18
15108,devācakamalāsanā,devacakamalasana,1,1,0,0,16
15109,sammodentāvaaṭṭhaṃsu,sammodentavaatthamsu,1,1,0,0,20
15110,buddhaṅkurassasantike,buddhankurassasantike,1,1,0,0,21
15111,kumārocārudhātīhi,kumarocarudhatihi,1,1,0,0,17
15112,tositārājamandire,tositarajamandire,1,1,0,0,17
15113,vuddhosisusukhaṃkhemaṃ,vuddhosisusukhamkhemam,1,1,0,0,22
15114,sakyakaññānamantare,sakyakannanamantare,1,1,0,0,19
15115,soḷasavassikosakya,solasavassikosakya,1,1,0,0,18
15116,nandanopitarāsatā,nandanopitarasata,1,1,0,0,17
15117,rājatteabhisittosi,rajatteabhisittosi,1,1,0,0,18
15118,modesituvanattaye,modesituvanattaye,1,1,0,0,17
15119,nandanānaṃsovaṇṇa,nandananamsovanna,1,1,0,0,17
15120,vaṇṇasobhaṃyasodharaṃ,vannasobhamyasodharam,1,1,0,0,21
15121,sokāresimahesittaṃ,sokaresimahesittam,1,1,0,0,18
15122,lokanettarasāyanaṃ,lokanettarasayanam,1,1,0,0,18
15123,ekūnatiṃsamevasse,ekunatimsamevasse,1,1,0,0,17
15124,visākhapuṇṇamevare,visakhapunnamevare,1,1,0,0,18
15125,sahasenāyauyyāsi,sahasenayauyyasi,1,1,0,0,16
15126,yānenuyyānamaṇḍalaṃ,yanenuyyanamandalam,1,1,0,0,19
15127,nimittecaturodisvā,nimittecaturodisva,1,1,0,0,18
15128,puttassacavijāyanaṃ,puttassacavijayanam,1,1,0,0,19
15129,sutvāubbiggacittena,sutvaubbiggacittena,1,1,0,0,19
15130,naramitthapuretahiṃ,naramitthapuretahim,1,1,0,0,19
15131,paccāgammapuraṃtamhā,paccagammapuramtamha,1,1,0,0,20
15132,pattopāsādamaṇḍalaṃ,pattopasadamandalam,1,1,0,0,19
15133,nippajjidevarājāva,nippajjidevarajava,1,1,0,0,18
15134,sayanesomahārahe,sayanesomaharahe,1,1,0,0,16
15135,sundarītaṃpurakkhitvā,sundaritampurakkhitva,1,1,0,0,21
15136,naccagītenatosayuṃ,naccagitenatosayum,1,1,0,0,18
15137,evaṃpisonaramitvā,evampisonaramitva,1,1,0,0,17
15138,āhunikkhamamānaso,ahunikkhamamanaso,1,1,0,0,17
15139,pathamaṃrāhulaṃputtaṃ,pathamamrahulamputtam,1,1,0,0,21
15140,passitvānikkhamāmahaṃ,passitvanikkhamamaham,1,1,0,0,21
15141,iticintiyamāneso,iticintiyamaneso,1,1,0,0,16
15142,agājāyānivesanaṃ,agajayanivesanam,1,1,0,0,16
15143,thapetvāpādadummāre,thapetvapadadummare,1,1,0,0,19
15144,gīvamantopavesayaṃ,givamantopavesayam,1,1,0,0,18
15145,olokayaṃsapassittha,olokayamsapassittha,1,1,0,0,19
15146,nippannaṃtaṃsamātaraṃ,nippannamtamsamataram,1,1,0,0,21
15147,gaṇheyyaṃtaṃapanetvā,ganheyyamtamapanetva,1,1,0,0,20
15148,bāhuṃcedeviyāahaṃ,bahumcedeviyaaham,1,1,0,0,17
15149,nadadenikkhamokāsaṃ,nadadenikkhamokasam,1,1,0,0,19
15150,pabujjhitvāyasodharā,pabujjhitvayasodhara,1,1,0,0,20
15151,buddhapattovapasseyyaṃ,buddhapattovapasseyyam,1,1,0,0,22
15152,rāhulaṃiticintiya,rahulamiticintiya,1,1,0,0,17
15153,kaṇḍakaṃāruhitvāna,kandakamaruhitvana,1,1,0,0,18
15154,tamhāchannenanikkhami,tamhachannenanikkhami,1,1,0,0,21
15155,dvārāsayāvivariṃsu,dvarasayavivarimsu,1,1,0,0,18
15156,devatādvāramaṇḍalaṃ,devatadvaramandalam,1,1,0,0,19
15157,ratanukkāsahassāni,ratanukkasahassani,2,2,0,0,18
15158,jālayiṃsumarūtahiṃ,jalayimsumarutahim,1,1,0,0,18
15159,mānikkhamassusiddhattha,manikkhamassusiddhattha,1,1,0,0,23
15160,itotvaṃsattamedine,itotvamsattamedine,1,1,0,0,18
15161,bhavissasecakkavattī,bhavissasecakkavatti,1,1,0,0,20
15162,itinīvāripāpimā,itinivaripapima,1,1,0,0,15
15163,tagghajānāmitaṃmāra,tagghajanamitammara,1,1,0,0,19
15164,idhamātiṭṭhapakkama,idhamatitthapakkama,1,1,0,0,19
15165,itimāraṃ,itimaram,1,1,0,0,8
15166,palāpetvā,palapetva,63,63,0,0,9
15167,vissaṭṭhosoabhikkami,vissatthosoabhikkami,1,1,0,0,20
15168,patvānomanadītīraṃ,patvanomanaditiram,1,1,0,0,18
15169,punāgamesituragaṃ,punagamesituragam,1,1,0,0,17
15170,channañcanagaraṃ,channancanagaram,1,1,0,0,16
15171,bimbā,bimba,10,8,2,0,5
15172,devilāpaṭivedituṃ,devilapativeditum,1,1,0,0,17
15173,bandhitaṃyasodharāya,bandhitamyasodharaya,1,1,0,0,20
15174,moḷiṃsugandhavāsitaṃ,molimsugandhavasitam,1,1,0,0,20
15175,chetvākhaggenatiṇhena,chetvakhaggenatinhena,1,1,0,0,21
15176,ukkhipitthatamambare,ukkhipitthatamambare,1,1,0,0,20
15177,aṭṭhaseṭṭhaparikkhāre,atthasetthaparikkhare,1,1,0,0,21
15178,dhāretvābrahmunābhate,dharetvabrahmunabhate,1,1,0,0,21
15179,hitvārājārahaṃdussaṃ,hitvarajarahamdussam,1,1,0,0,20
15180,samaṇatthamupāgami,samanatthamupagami,1,1,0,0,18
15181,karontodukkaraṃkammaṃ,karontodukkaramkammam,1,1,0,0,21
15182,chabbassāniparakkamo,chabbassaniparakkamo,1,1,0,0,20
15183,oḷārikannapānehi,olarikannapanehi,1,1,0,0,16
15184,dehaṃyāpesiṭhītiyā,dehamyapesithitiya,1,1,0,0,18
15185,visākhapuṇṇamehema,visakhapunnamehema,1,1,0,0,18
15186,pātiṃpāyasapūritaṃ,patimpayasapuritam,1,1,0,0,18
15187,sujātāyābhataṃgayha,sujatayabhatamgayha,1,1,0,0,19
15188,nerañcaramupāgami,nerancaramupagami,1,1,0,0,17
15189,nerañcarāyatīramhi,nerancarayatiramhi,1,1,0,0,18
15190,sutvāpāyāsamuttamaṃ,sutvapayasamuttamam,1,1,0,0,19
15191,paṭiyatthavaramaggena,patiyatthavaramaggena,1,1,0,0,21
15192,bodhimaṇḍamupāgami,bodhimandamupagami,1,1,0,0,18
15193,jayāsanepallaṅkamhi,jayasanepallankamhi,1,1,0,0,19
15194,ṭhitodhiṭṭhesidhītimā,thitodhitthesidhitima,1,1,0,0,21
15195,navīriyaṃjahissāmi,naviriyamjahissami,1,1,0,0,18
15196,apattoitibuddhataṃ,apattoitibuddhatam,1,1,0,0,18
15197,devindodhamayaṃsaṅkhaṃ,devindodhamayamsankham,1,1,0,0,22
15198,setacchattaṃpitāmaho,setacchattampitamaho,1,1,0,0,20
15199,dhārayaṃvādentovīṇaṃ,dharayamvadentovinam,1,1,0,0,20
15200,pañcasīkhoṭhitotahiṃ,pancasikhothitotahim,1,1,0,0,20
15201,thutigītānigāyantī,thutigitanigayanti,1,1,0,0,18
15202,aṭṭhāsuṃdevasundarī,atthasumdevasundari,1,1,0,0,19
15203,gahetvāhemamañjūsā,gahetvahemamanjusa,1,1,0,0,18
15204,surapupphehipūritā,surapupphehipurita,1,1,0,0,18
15205,anatthamentesūriye,anatthamentesuriye,1,1,0,0,18
15206,mārasenaṃpalāpayī,marasenampalapayi,1,1,0,0,17
15207,aruṇuggamanekāle,arunuggamanekale,1,1,0,0,16
15208,pattosibuddhataṃvaraṃ,pattosibuddhatamvaram,1,1,0,0,21
15209,paṭṭhānaṃsammasantassa,patthanamsammasantassa,1,1,0,0,22
15210,nāthassadehatosubhā,nathassadehatosubha,1,1,0,0,19
15211,chabbaṇṇabhānicchadhanti,chabbannabhanicchadhanti,1,1,0,0,24
15212,vidhāvanti,vidhavanti,9,9,0,0,10
15213,nīlānīlāpitāpītā,nilanilapitapita,1,1,0,0,16
15214,rattārattācanicchare,rattarattacanicchare,1,1,0,0,20
15215,setāsetācamañciṭṭhā,setasetacamancittha,1,1,0,0,19
15216,tamhātamhāpabhassarā,tamhatamhapabhassara,1,1,0,0,20
15217,buddhapattopibodheyya,buddhapattopibodheyya,1,1,0,0,21
15218,dhammagambhīrataṃjino,dhammagambhiratamjino,1,1,0,0,21
15219,nisāmetvānadesetuṃ,nisametvanadesetum,1,1,0,0,18
15220,nirussāhamupāgato,nirussahamupagato,1,1,0,0,17
15221,sahampatitadābrahmā,sahampatitadabrahma,1,1,0,0,19
15222,desanāyābhiyācati,desanayabhiyacati,1,1,0,0,17
15223,tenasopathamaṃseṭṭhaṃ,tenasopathamamsettham,1,1,0,0,21
15224,dhammacakkamadesayi,dhammacakkamadesayi,1,1,0,0,19
15225,ekavassovasambuddho,ekavassovasambuddho,1,1,0,0,19
15226,varephagguṇapuṇṇame,varephaggunapunname,1,1,0,0,19
15227,sakyānaṃnagaraṃgañchī,sakyanamnagaramganchi,1,1,0,0,21
15228,sāvakehipurakkhato,savakehipurakkhato,1,1,0,0,18
15229,samāgamamhiñātīnaṃ,samagamamhinatinam,1,1,0,0,18
15230,vassāpesisusītalaṃ,vassapesisusitalam,1,1,0,0,18
15231,mahāmeghañcadesesi,mahameghancadesesi,1,1,0,0,18
15232,vessantarassajātakaṃ,vessantarassajatakam,1,1,0,0,20
15233,gantvāsāvakayugena,gantvasavakayugena,1,1,0,0,18
15234,yasodharāyamandiraṃ,yasodharayamandiram,1,1,0,0,19
15235,taṃtosetvānadesesi,tamtosetvanadesesi,1,1,0,0,18
15236,candakinnarajātakaṃ,candakinnarajatakam,2,2,0,0,19
15237,vasitvāsattamevasse,vasitvasattamevasse,1,1,0,0,19
15238,abhidhammena,abhidhammena,4,4,0,0,12
15239,tosesi,tosesi,36,34,2,0,6
15240,devabrahmagaṇaṃbahuṃ,devabrahmaganambahum,1,1,0,0,20
15241,pattharaṃñāṇajālena,pattharamnanajalena,1,1,0,0,19
15242,lokaṃlokesisabbadā,lokamlokesisabbada,1,1,0,0,18
15243,bodhetuṃbodhiyābhāya,bodhetumbodhiyabhaya,1,1,0,0,20
15244,bodheyyajanapaṅkajaṃ,bodheyyajanapankajam,1,1,0,0,20
15245,bodhaneyyaṃjanaṃdisvā,bodhaneyyamjanamdisva,1,1,0,0,21
15246,cakkavāḷaparaṃparā,cakkavalaparampara,1,1,0,0,18
15247,gantvāpivibodhesi,gantvapivibodhesi,1,1,0,0,17
15248,buddhaseṭṭhosubodhimā,buddhasetthosubodhima,1,1,0,0,21
15249,bakādikecabrahmāno,bakadikecabrahmano,1,1,0,0,18
15250,yakkhecāḷavakādike,yakkhecalavakadike,1,1,0,0,18
15251,purindadādikedeve,purindadadikedeve,1,1,0,0,17
15252,sūcilomādirakkhase,sucilomadirakkhase,1,1,0,0,18
15253,jāṇusoṇādikeneke,janusonadikeneke,1,1,0,0,16
15254,brāhmaṇecāvikakkhaḷe,brahmanecavikakkhale,1,1,0,0,20
15255,cūḷodarādikenāge,culodaradikenage,1,1,0,0,16
15256,dhanapālādikegaje,dhanapaladikegaje,1,1,0,0,17
15257,buddhāmayaṃtimaññante,buddhamayamtimannante,1,1,0,0,21
15258,titthiyenekaladdhike,titthiyenekaladdhike,1,1,0,0,20
15259,damesidamataṃseṭṭho,damesidamatamsettho,1,1,0,0,19
15260,paravādappamaddano,paravadappamaddano,3,3,0,0,18
15261,anubyañjanasampanno,anubyanjanasampanno,8,8,0,0,19
15262,esabāttiṃsalakkhaṇo,esabattimsalakkhano,1,1,0,0,19
15263,byāmappabhāparikkhitto,byamappabhaparikkhitto,2,2,0,0,22
15264,ketumālāsilaṅkhato,ketumalasilankhato,1,1,0,0,18
15265,caturāsītisahassa,caturasitisahassa,2,2,0,0,17
15266,dhammakkhandhesadesayi,dhammakkhandhesadesayi,1,1,0,0,22
15267,pañcatāthīsavassāni,pancatathisavassani,1,1,0,0,19
15268,tilokassahitāyave,tilokassahitayave,1,1,0,0,17
15269,buddhakiccaṃkarontoso,buddhakiccamkarontoso,1,1,0,0,21
15270,vahaṃlokahitaṃvaraṃ,vahamlokahitamvaram,1,1,0,0,19
15271,mocayaṃbandhanāsatte,mocayambandhanasatte,1,1,0,0,20
15272,kālaṃkhepetisabbadā,kalamkhepetisabbada,1,1,0,0,19
15273,yahiṃ,yahim,96,80,16,0,5
15274,āsītikonātho,asitikonatho,1,1,0,0,12
15275,nibbutovaramañjake,nibbutovaramanjake,1,1,0,0,18
15276,mahāsālavaneramme,mahasalavaneramme,1,1,0,0,17
15277,mallānaṃnigametahiṃ,mallanamnigametahim,1,1,0,0,19
15278,aggikkhandhovalokasmiṃ,aggikkhandhovalokasmim,1,1,0,0,22
15279,jāletvānasasāvako,jaletvanasasavako,1,1,0,0,17
15280,nibbāyitthasaṅkhatānaṃ,nibbayitthasankhatanam,1,1,0,0,22
15281,pakāsentoaniccataṃti,pakasentoaniccatamti,1,1,0,0,20
15282,namotebhagavānātha,namotebhagavanatha,1,1,0,0,18
15283,namotejayataṃjaya,namotejayatamjaya,1,1,0,0,17
15284,namotesirisampanna,namotesirisampanna,1,1,0,0,18
15285,namotelokanandana,namotelokanandana,1,1,0,0,17
15286,cavitvāna,cavitvana,66,66,0,0,9
15287,mahāmāyāya,mahamayaya,18,18,0,0,10
15288,kucchiyaṃ,kucchiyam,151,150,1,0,9
15289,uppajji,uppajji,735,724,11,0,7
15290,guruvāramhi,guruvaramhi,1,1,0,0,11
15291,sakyapuṅgavaṃ,sakyapungavam,25,24,1,0,13
15292,dasamā,dasama,57,57,0,0,6
15293,saccaye,saccaye,1,1,0,0,7
15294,neso,neso,129,120,9,0,4
15295,vijāyi,vijayi,184,184,0,0,6
15296,mātukucchito,matukucchito,142,141,1,0,12
15297,sukkavāre,sukkavare,4,4,0,0,9
15298,lumbiniyaṃ,lumbiniyam,1,1,0,0,10
15299,lokapūjitaṃ,lokapujitam,3,3,0,0,11
15300,cakkavattisiriṃ,cakkavattisirim,24,24,0,0,15
15301,mahāsinikkhamaṃ,mahasinikkhamam,1,1,0,0,15
15302,sudhī,sudhi,31,24,7,0,5
15303,nikkhamī,nikkhami,7,5,2,0,8
15304,candavāramhi,candavaramhi,1,1,0,0,12
15305,munikuñjaraṃ,munikunjaram,1,1,0,0,12
15306,assatthabodhimūlamhi,assatthabodhimulamhi,1,1,0,0,20
15307,pallaṅke,pallanke,122,121,1,0,8
15308,aparājite,aparajite,8,5,3,0,9
15309,budhavāsare,budhavasare,1,1,0,0,11
15310,pañcavaggiyamukhānaṃ,pancavaggiyamukhanam,1,1,0,0,20
15311,migadāvane,migadavane,1,1,0,0,10
15312,sorivāre,sorivare,1,1,0,0,8
15313,sabbasaṅkhatadhammānaṃ,sabbasankhatadhammanam,3,3,0,0,22
15314,pakāsiyaaniccataṃ,pakasiyaaniccatam,1,1,0,0,17
15315,nibbutaṃaṅgavāramhi,nibbutamangavaramhi,1,1,0,0,19
15316,namādhiamatandadaṃ,namadhiamatandadam,1,1,0,0,18
15317,sūriyavāre,suriyavare,1,1,0,0,10
15318,soṇṇāya,sonnaya,1,1,0,0,7
15319,doṇiyā,doniya,34,33,1,0,6
15320,jinaviggaho,jinaviggaho,1,1,0,0,11
15321,agginujjalito,agginujjalito,1,1,0,0,13
15322,dhātusarīrakaṃ,dhatusarirakam,1,1,0,0,14
15323,uṇṇālomikanātha,unnalomikanatha,1,1,0,0,15
15324,uṇṇālodhikanāthassa,unnalodhikanathassa,1,1,0,0,19
15325,uṇṇāya,unnaya,4,4,0,0,6
15326,vajirāviya,vajiraviya,1,1,0,0,10
15327,sobhanti,sobhanti,63,61,2,0,8
15328,nikkhanti,nikkhanti,10,10,0,0,9
15329,supaṇḍarā,supandara,1,1,0,0,9
15330,vajiragghanakāyassa,vajiragghanakayassa,1,1,0,0,19
15331,subhā,subha,131,122,9,0,5
15332,vajireyyā,vajireyya,1,1,0,0,9
15333,niccharanti,niccharanti,46,45,1,0,11
15334,vijjūva,vijjuva,6,6,0,0,7
15335,gagaṇantare,gaganantare,1,1,0,0,11
15336,rinindamandahāsena,rinindamandahasena,1,1,0,0,18
15337,dāṭhāya,dathaya,10,10,0,0,7
15338,niccharā,nicchara,1,1,0,0,8
15339,vipphūrisā,vipphurisa,1,1,0,0,10
15340,disāsabbā,disasabba,1,1,0,0,9
15341,vajirāyanti,vajirayanti,1,1,0,0,11
15342,paṇḍarā,pandara,6,5,1,0,7
15343,suttavandanā,suttavandana,1,1,0,0,12
15344,dhammattha,dhammattha,1,1,0,0,10
15345,vedha,vedha,2,1,1,0,5
15346,catugambhīra,catugambhira,2,1,1,0,12
15347,lokassa,lokassa,1111,1078,33,0,7
15348,arahā,araha,1278,1242,36,0,5
15349,cakkavattīti,cakkavattiti,29,18,11,0,12
15350,thūpāthūpārahaṃ,thupathuparaham,1,1,0,0,15
15351,catuthūpārahesu,catuthuparahesu,1,1,0,0,15
15352,petaseyyo,petaseyyo,1,1,0,0,9
15353,kāmabhogī,kamabhogi,133,133,0,0,9
15354,sīhaseyyo,sihaseyyo,1,1,0,0,9
15355,sayantaṃ,sayantam,14,13,1,0,8
15356,catuseyyesu,catuseyyesu,1,1,0,0,11
15357,catutthena,catutthena,99,96,3,0,10
15358,aṇḍajā,andaja,44,38,6,0,6
15359,jalābujā,jalabuja,29,24,5,0,8
15360,saṃsedajo,samsedajo,3,3,0,0,9
15361,papātikā,papatika,2,1,1,0,8
15362,catuyoni,catuyoni,2,2,0,0,8
15363,pariccheda,pariccheda,67,66,1,0,10
15364,ñāṇavantaṃ,nanavantam,3,3,0,0,10
15365,sutabuddhonubuddho,sutabuddhonubuddho,1,1,0,0,18
15366,pacceko,pacceko,1,1,0,0,7
15367,jinabuddhoti,jinabuddhoti,1,1,0,0,12
15368,catubuddhesu,catubuddhesu,2,2,0,0,12
15369,rāhuggaṃ,rahuggam,5,5,0,0,8
15370,attabhāgīnaṃ,attabhaginam,1,1,0,0,12
15371,mandhātā,mandhata,40,40,0,0,8
15372,kāmabhogīnaṃ,kamabhoginam,16,15,1,0,12
15373,adhipateyyānaṃ,adhipateyyanam,1,1,0,0,14
15374,catuagga,catuagga,1,1,0,0,8
15375,paññattīnaṃ,pannattinam,30,30,0,0,11
15376,aggapattaṃ,aggapattam,5,5,0,0,10
15377,piyakathā,piyakatha,1,1,0,0,9
15378,cariyā,cariya,287,281,6,0,6
15379,sadisattatā,sadisattata,1,1,0,0,11
15380,catusaṅgaha,catusangaha,1,1,0,0,11
15381,vatthūhi,vatthuhi,184,182,2,0,8
15382,asaṅkhiyesu,asankhiyesu,1,1,0,0,11
15383,jātisu,jatisu,27,27,0,0,6
15384,saṅgahetāraṃ,sangahetaram,1,1,0,0,12
15385,mohoti,mohoti,35,22,13,0,6
15386,dujjaye,dujjaye,1,1,0,0,7
15387,sabbaverīhi,sabbaverihi,1,1,0,0,11
15388,sañjitaṃpi,sanjitampi,1,1,0,0,10
15389,sudhiṃ,sudhim,1,1,0,0,6
15390,mahattāni,mahattani,1,1,0,0,9
15391,guṇamahattamuttamaṃ,gunamahattamuttamam,1,1,0,0,19
15392,timahatthehi,timahatthehi,1,1,0,0,12
15393,phala,phala,40,24,16,0,5
15394,sampadāyo,sampadayo,6,5,1,0,9
15395,sattupakārasampadā,sattupakarasampada,2,2,0,0,18
15396,tisampadāhi,tisampadahi,1,1,0,0,11
15397,ñāṇappahānānubhāva,nanappahananubhava,1,1,0,0,18
15398,surūpakārasampadā,surupakarasampada,1,1,0,0,17
15399,catuphala,catuphala,1,1,0,0,9
15400,sampadāhi,sampadahi,8,8,0,0,9
15401,āsayo,asayo,120,101,19,0,5
15402,payogoti,payogoti,33,14,19,0,8
15403,sattupakāra,sattupakara,1,1,0,0,11
15404,sampadā,sampada,128,123,5,0,7
15405,pātu,patu,55,39,16,0,4
15406,mahosadhe,mahosadhe,1,1,0,0,9
15407,vessantare,vessantare,24,24,0,0,10
15408,pacchimabhavike,pacchimabhavike,3,3,0,0,15
15409,tijātīsu,tijatisu,1,1,0,0,8
15410,bhāsentaṃ,bhasentam,1,1,0,0,9
15411,jāyanakkhaṇe,jayanakkhane,1,1,0,0,12
15412,nemimhi,nemimhi,1,1,0,0,7
15413,sādhine,sadhine,1,1,0,0,7
15414,mandhātari,mandhatari,1,1,0,0,10
15415,guttile,guttile,1,1,0,0,7
15416,manujattena,manujattena,1,1,0,0,11
15417,devalokaṃ,devalokam,184,182,2,0,9
15418,saṅkhāro,sankharo,348,325,23,0,8
15419,rūpavikāro,rupavikaro,10,10,0,0,10
15420,vānanissaṭaṃ,vananissatam,1,1,0,0,12
15421,paññatticeti,pannatticeti,1,1,0,0,12
15422,ñeyyantaguṃ,neyyantagum,1,1,0,0,11
15423,dāra,dara,7,2,5,0,4
15424,pariccāgā,pariccaga,6,6,0,0,9
15425,rajjaṅgaṃ,rajjangam,1,1,0,0,9
15426,jīva,jiva,77,66,11,0,4
15427,cāgīti,cagiti,1,1,0,0,6
15428,sudukkare,sudukkare,1,1,0,0,9
15429,vedanā,vedana,3981,3850,131,0,6
15430,saññā,sanna,2090,2010,80,0,5
15431,viññāṇantime,vinnanantime,1,1,0,0,12
15432,pañcakkhandhe,pancakkhandhe,152,146,6,0,13
15433,parijānaṃ,parijanam,50,50,0,0,9
15434,tipariññāhi,tiparinnahi,1,1,0,0,11
15435,peto,peto,143,139,4,0,4
15436,nirayo,nirayo,200,168,32,0,6
15437,tiracchānoti,tiracchanoti,2,1,1,0,12
15438,pañcetā,panceta,1,1,0,0,7
15439,abhisaṅkhāra,abhisankhara,10,10,0,0,12
15440,mārako,marako,11,11,0,0,6
15441,maccūti,maccuti,6,2,4,0,7
15442,pañcete,pancete,34,32,2,0,7
15443,vijitavaṃ,vijitavam,1,1,0,0,9
15444,purebhattaṃ,purebhattam,339,306,33,0,11
15445,pacchābhattaṃ,pacchabhattam,464,437,27,0,13
15446,purimañceva,purimanceva,1,1,0,0,11
15447,majjhimaṃ,majjhimam,291,253,38,0,9
15448,pacchimanti,pacchimanti,7,6,1,0,11
15449,buddhakiccaṃ,buddhakiccam,14,14,0,0,12
15450,rūpā,rupa,535,516,19,0,4
15451,saddā,sadda,574,559,15,0,5
15452,gandhā,gandha,252,241,11,0,6
15453,phoṭṭhabbā,photthabba,199,196,3,0,10
15454,manoramā,manorama,160,147,13,0,8
15455,kāmaguṇe,kamagune,161,154,7,0,8
15456,kheḷaṃva,khelamva,1,1,0,0,8
15457,niggataṃ,niggatam,18,16,2,0,8
15458,rāgasallaṃ,ragasallam,17,16,1,0,10
15459,dosasallaṃ,dosasallam,15,15,0,0,10
15460,mohā,moha,180,170,10,0,4
15461,diṭṭhīti,ditthiti,96,53,43,0,8
15462,vajjātivajjantaṃ,vajjativajjantam,1,1,0,0,16
15463,pañcasallapanūdanaṃ,pancasallapanudanam,1,1,0,0,19
15464,aṅguttaro,anguttaro,4,4,0,0,9
15465,khuddako,khuddako,106,104,2,0,8
15466,nikāyehi,nikayehi,5,5,0,0,8
15467,suvinentaṃ,suvinentam,1,1,0,0,10
15468,payattīti,payattiti,1,1,0,0,9
15469,bhagyehi,bhagyehi,1,1,0,0,8
15470,piyāpiyaṃ,piyapiyam,7,5,2,0,9
15471,bhūtābhūtaṃ,bhutabhutam,2,2,0,0,11
15472,missā,missa,30,24,6,0,5
15473,suvācaṃva,suvacamva,1,1,0,0,9
15474,bhāsantaṃ,bhasantam,13,12,1,0,9
15475,atthakaṃ,atthakam,1,1,0,0,8
15476,alaso,alaso,46,44,2,0,5
15477,anuṭṭhānaṃ,anutthanam,13,11,2,0,10
15478,asaṃyamo,asamyamo,5,5,0,0,8
15479,niddā,nidda,82,77,5,0,5
15480,tantīti,tantiti,5,2,3,0,7
15481,chiddehi,chiddehi,8,8,0,0,8
15482,muttaṃ,muttam,293,253,40,0,6
15483,mahākaruṇāsamāpatti,mahakarunasamapatti,3,3,0,0,19
15484,yamakappāṭihāriyaṃ,yamakappatihariyam,2,2,0,0,18
15485,āsayānusaye,asayanusaye,17,13,4,0,11
15486,indriyāna,indriyana,1,1,0,0,9
15487,paropare,paropare,5,5,0,0,8
15488,sabbaññutā,sabbannuta,34,31,3,0,10
15489,nāvaraṇaṃ,navaranam,1,1,0,0,9
15490,chā,cha,27,19,8,0,3
15491,sādhāraṇikaṃ,sadharanikam,1,1,0,0,12
15492,kāmacchando,kamacchando,274,255,19,0,11
15493,byāpādo,byapado,400,354,46,0,7
15494,thinamiddhañca,thinamiddhanca,30,30,0,0,14
15495,saṃsayo,samsayo,194,167,27,0,7
15496,avijjuddhacca,avijjuddhacca,1,1,0,0,13
15497,kukkuccaṃ,kukkuccam,709,668,41,0,9
15498,chavinīvaraṇaṃ,chavinivaranam,1,1,0,0,14
15499,iddhividhaṃ,iddhividham,116,104,12,0,11
15500,dibbasotaṃ,dibbasotam,53,49,4,0,10
15501,vijānanā,vijanana,4,4,0,0,8
15502,dibbacakkhāsavakkhayo,dibbacakkhasavakkhayo,1,1,0,0,21
15503,chaḷabhiññāhi,chalabhinnahi,2,2,0,0,13
15504,purisuttamaṃ,purisuttamam,17,16,1,0,12
15505,nīla,nila,17,11,6,0,4
15506,pītā,pita,81,75,6,0,4
15507,mañjiṭṭhā,manjittha,10,9,1,0,9
15508,pabhassarā,pabhassara,40,39,1,0,10
15509,lohitāti,lohitati,3,1,2,0,8
15510,raṃsīhī,ramsihi,1,1,0,0,7
15511,vijjotantaṃ,vijjotantam,1,1,0,0,11
15512,assādādīnavo,assadadinavo,1,1,0,0,12
15513,nissaraṇaphalaṃ,nissaranaphalam,2,2,0,0,15
15514,upāyāṇattīti,upayanattiti,1,1,0,0,12
15515,chadhā,chadha,112,105,7,0,6
15516,saddhammadesakaṃ,saddhammadesakam,1,1,0,0,16
15517,vitakkacariyā,vitakkacariya,1,1,0,0,13
15518,buddhīti,buddhiti,4,4,0,0,8
15519,bhājentaṃ,bhajentam,1,1,0,0,9
15520,chaḷecariyā,chalecariya,1,1,0,0,11
15521,muttā,mutta,254,238,16,0,5
15522,veḷuriyāni,veluriyani,3,3,0,0,10
15523,vajirañca,vajiranca,3,3,0,0,9
15524,pavāḷanti,pavalanti,3,3,0,0,9
15525,seṭṭhi,setthi,424,420,4,0,6
15526,sattadhano,sattadhano,1,1,0,0,10
15527,saddhāsīlaṃ,saddhasilam,1,1,0,0,11
15528,sutaṃcāgo,sutamcago,1,1,0,0,9
15529,hirī,hiri,324,297,27,0,4
15530,ottappiyaṃ,ottappiyam,9,9,0,0,10
15531,paññādhananti,pannadhananti,3,3,0,0,13
15532,sattamahādhanaṃ,sattamahadhanam,1,1,0,0,15
15533,hatthi,hatthi,43,36,7,0,6
15534,asso,asso,158,152,6,0,4
15535,gahapatitthiyo,gahapatitthiyo,1,1,0,0,14
15536,supariṇāyakocāti,suparinayakocati,1,1,0,0,16
15537,sattaratano,sattaratano,5,5,0,0,11
15538,cakkavattīva,cakkavattiva,5,5,0,0,12
15539,dhammavicayo,dhammavicayo,199,189,10,0,12
15540,passaddhi,passaddhi,154,140,14,0,9
15541,samādhupekkhā,samadhupekkha,1,1,0,0,13
15542,saddhamma,saddhamma,13,13,0,0,9
15543,bojjhaṅgaratanaṃ,bojjhangaratanam,4,4,0,0,16
15544,yugandharo,yugandharo,24,22,2,0,10
15545,īsadharo,isadharo,18,15,3,0,8
15546,sudassano,sudassano,103,95,8,0,9
15547,nemindharo,nemindharo,16,13,3,0,10
15548,vinatako,vinatako,16,15,1,0,8
15549,assakaṇṇo,assakanno,21,18,3,0,9
15550,mahānage,mahanage,1,1,0,0,8
15551,sattete,sattete,16,16,0,0,7
15552,hattharūpaṃva,hattharupamva,1,1,0,0,13
15553,sampassantaṃ,sampassantam,1,1,0,0,12
15554,kaṇṇamuṇḍo,kannamundo,9,8,1,0,10
15555,anotatto,anotatto,10,6,4,0,8
15556,kuṇālo,kunalo,50,48,2,0,6
15557,rathakārako,rathakarako,6,5,1,0,11
15558,sīhappapāta,sihappapata,1,1,0,0,11
15559,chaddantā,chaddanta,5,5,0,0,9
15560,mandākinī,mandakini,6,4,2,0,9
15561,mahāsare,mahasare,17,16,1,0,8
15562,sabbathā,sabbatha,690,660,30,0,8
15563,diṭṭheva,dittheva,878,831,47,0,8
15564,pātikaṃ,patikam,4,3,1,0,7
15565,manussattaṃ,manussattam,161,148,13,0,11
15566,liṅgasampatti,lingasampatti,26,26,0,0,13
15567,satthāradassanaṃ,sattharadassanam,36,29,7,0,16
15568,pabbajjā,pabbajja,590,559,31,0,8
15569,guṇasampatti,gunasampatti,22,22,0,0,12
15570,adhikāro,adhikaro,147,144,3,0,8
15571,chandatā,chandata,27,26,1,0,8
15572,aṭṭhadhamma,atthadhamma,2,2,0,0,11
15573,samodhānā,samodhana,8,7,1,0,9
15574,bhinīhārantaguṃ,bhiniharantagum,1,1,0,0,15
15575,visaṭṭhaṃ,visattham,4,4,0,0,9
15576,viññeyyaṃ,vinneyyam,195,182,13,0,9
15577,savanīyāvisāriṇā,savaniyavisarina,1,1,0,0,16
15578,binduninnādo,binduninnado,1,1,0,0,12
15579,aṭṭhaṅgikasaraṃ,atthangikasaram,1,1,0,0,15
15580,rūpajhānāni,rupajhanani,1,1,0,0,11
15581,tathevārūpajhānāni,tathevarupajhanani,1,1,0,0,18
15582,samāpattiyo,samapattiyo,395,375,20,0,11
15583,sevantaṃ,sevantam,3,2,1,0,8
15584,ruciyā,ruciya,221,211,10,0,6
15585,aṇimā,anima,15,10,5,0,5
15586,laṅghimā,langhima,1,1,0,0,8
15587,mahimā,mahima,16,13,3,0,6
15588,pattimā,pattima,1,1,0,0,7
15589,īsitā,isita,7,4,3,0,5
15590,vasitā,vasita,78,72,6,0,6
15591,yatthakāmāvasāyitā,yatthakamavasayita,4,1,3,0,18
15592,aṭṭhissariya,atthissariya,1,1,0,0,12
15593,puṇṇattā,punnatta,5,5,0,0,8
15594,issarātissaraṃ,issaratissaram,1,1,0,0,14
15595,manomayiddhiñāṇañca,manomayiddhinananca,1,1,0,0,19
15596,chaḷabhiññā,chalabhinna,188,179,9,0,11
15597,aṭṭhavijjāhi,atthavijjahi,1,1,0,0,12
15598,tilokaketukaṃ,tilokaketukam,1,1,0,0,13
15599,rujā,ruja,12,11,1,0,4
15600,kālo,kalo,999,942,57,0,4
15601,caturāpāyadukkhāti,caturapayadukkhati,1,1,0,0,18
15602,saṃvegavatthūni,samvegavatthuni,16,8,8,0,15
15603,suttaṅgaṃ,suttangam,22,22,0,0,9
15604,veyyākaraṇaṃ,veyyakaranam,193,174,19,0,12
15605,geyyaṃ,geyyam,132,124,8,0,6
15606,jātakaṃ,jatakam,793,777,16,0,7
15607,abbhūtadhamma,abbhutadhamma,1,1,0,0,13
15608,vedallā,vedalla,3,3,0,0,7
15609,udānamiti,udanamiti,1,1,0,0,9
15610,vuttakaṃ,vuttakam,1,1,0,0,8
15611,navaṅgaṃ,navangam,59,54,5,0,8
15612,dadantaṃ,dadantam,11,10,1,0,8
15613,sāsanaṃ,sasanam,2847,2721,126,0,7
15614,nava,nava,7791,7670,121,0,4
15615,anupubbavihāre,anupubbavihare,2,2,0,0,14
15616,ekattañceva,ekattanceva,1,1,0,0,11
15617,nānattaṃ,nanattam,371,339,32,0,8
15618,kāyasaññīhi,kayasannihi,1,1,0,0,11
15619,yogato,yogato,42,42,0,0,6
15620,tathāruppā,tatharuppa,2,2,0,0,10
15621,asaññīcāti,asannicati,1,1,0,0,10
15622,sattavāse,sattavase,1,1,0,0,9
15623,seyyassa,seyyassa,86,76,10,0,8
15624,seyyo,seyyo,615,575,40,0,5
15625,hīnoti,hinoti,21,11,10,0,6
15626,tividho,tividho,362,334,28,0,7
15627,vidho,vidho,14,13,1,0,5
15628,sadisahīnānaṃ,sadisahinanam,1,1,0,0,13
15629,navavidhe,navavidhe,6,6,0,0,9
15630,anatthaṃ,anattham,305,294,11,0,8
15631,cari,cari,74,71,3,0,4
15632,carissati,carissati,45,44,1,0,9
15633,mittassa,mittassa,42,41,1,0,8
15634,arinotvatthaṃ,arinotvattham,1,1,0,0,13
15635,navāghāte,navaghate,1,1,0,0,9
15636,nikkhamaṃ,nikkhamam,11,9,2,0,9
15637,vīriyapañcamaṃ,viriyapancamam,1,1,0,0,14
15638,saccamadhiṭṭhānaṃ,saccamadhitthanam,4,4,0,0,17
15639,tādasa,tadasa,1,1,0,0,6
15640,sammāsambodhimajjhavaṃ,sammasambodhimajjhavam,1,1,0,0,22
15641,kāḷāvakañca,kalavakanca,11,11,0,0,11
15642,tamba,tamba,6,6,0,0,5
15643,piṅgalaṃ,pingalam,8,7,1,0,8
15644,hemañca,hemanca,10,8,2,0,7
15645,uposatha,uposatha,12,9,3,0,8
15646,dasaposānaṃ,dasaposanam,1,1,0,0,11
15647,nāgo,nago,614,588,26,0,4
15648,kāḷāvako,kalavako,3,2,1,0,8
15649,sahassakoṭiposānaṃ,sahassakotiposanam,1,1,0,0,18
15650,chaddantovāranuttamo,chaddantovaranuttamo,1,1,0,0,20
15651,sahassakoṭīnaṃ,sahassakotinam,1,1,0,0,14
15652,posānaṃ,posanam,1,1,0,0,7
15653,baladhāraṇaṃ,baladharanam,1,1,0,0,12
15654,dasannañca,dasannanca,13,13,0,0,10
15655,dasakāyabalaṃ,dasakayabalam,1,1,0,0,13
15656,ṭhānāṭhāne,thanathane,35,32,3,0,10
15657,vipāke,vipake,686,674,12,0,6
15658,sabbatthagāminaṃ,sabbatthagaminam,1,1,0,0,16
15659,nānādhātūsu,nanadhatusu,7,7,0,0,11
15660,lokesu,lokesu,11,11,0,0,6
15661,adhimuttimhi,adhimuttimhi,1,1,0,0,12
15662,pāṇinaṃ,paninam,145,125,20,0,7
15663,paropariyatte,paropariyatte,1,1,0,0,13
15664,indriyānañca,indriyananca,17,13,4,0,12
15665,jhānādīsu,jhanadisu,29,29,0,0,9
15666,mūlagandho,mulagandho,29,26,3,0,10
15667,sāro,saro,192,178,14,0,4
15668,pheggu,pheggu,45,40,5,0,6
15669,papaṭiko,papatiko,1,1,0,0,8
15670,raso,raso,367,323,44,0,4
15671,phalañceva,phalanceva,6,5,1,0,10
15672,gandhagandhoti,gandhagandhoti,4,4,0,0,14
15673,saṃvaraṃ,samvaram,261,237,24,0,8
15674,sugandhaṃ,sugandham,99,96,3,0,9
15675,dasagandhehi,dasagandhehi,1,1,0,0,12
15676,vilimpantaṃ,vilimpantam,1,1,0,0,11
15677,adhiṭṭhānaṃ,adhitthanam,449,409,40,0,11
15678,vikubbanā,vikubbana,20,16,4,0,9
15679,manomayāriyā,manomayariya,1,1,0,0,12
15680,payoga,payoga,13,11,2,0,6
15681,paccayiddhiti,paccayiddhiti,1,1,0,0,13
15682,aggapatta,aggapatta,1,1,0,0,9
15683,dasiddhīnaṃ,dasiddhinam,1,1,0,0,11
15684,veḷuriyaṃ,veluriyam,19,17,2,0,9
15685,sallo,sallo,16,13,3,0,5
15686,pavāḷakaṃ,pavalakam,2,2,0,0,9
15687,lohi,lohi,1,1,0,0,4
15688,taṅko,tanko,1,1,0,0,5
15689,masāragallanti,masaragallanti,4,4,0,0,14
15690,dasadhā,dasadha,132,108,24,0,7
15691,ratanehiggaṃ,ratanehiggam,1,1,0,0,12
15692,bhogiṃ,bhogim,1,1,0,0,6
15693,paññāmaṇiṃ,pannamanim,1,1,0,0,10
15694,sithilaṃ,sithilam,127,98,29,0,8
15695,dhanitaṃ,dhanitam,26,12,14,0,8
15696,dīghaṃ,digham,587,514,73,0,6
15697,rassañca,rassanca,8,8,0,0,8
15698,garukaṃ,garukam,390,330,60,0,7
15699,niggahitaṃ,niggahitam,46,33,13,0,10
15700,vimuttañca,vimuttanca,4,4,0,0,10
15701,sambandhañca,sambandhanca,8,8,0,0,12
15702,vavatthitaṃ,vavatthitam,43,31,12,0,11
15703,vivarantaṃ,vivarantam,3,3,0,0,10
15704,dasabyañjanabheditaṃ,dasabyanjanabheditam,1,1,0,0,20
15705,pasādojo,pasadojo,2,1,1,0,8
15706,madhuratā,madhurata,9,6,3,0,9
15707,samatā,samata,23,18,5,0,6
15708,sukhumālatā,sukhumalata,15,10,5,0,11
15709,silesodāratā,silesodarata,1,1,0,0,12
15710,atthabyatti,atthabyatti,9,5,4,0,11
15711,samādhayo,samadhayo,21,20,1,0,9
15712,saddaguṇopetaṃ,saddagunopetam,1,1,0,0,14
15713,uddhaccaṃ,uddhaccam,529,496,33,0,9
15714,ahirikamanottappaṃ,ahirikamanottappam,1,1,0,0,18
15715,thinanti,thinanti,2,2,0,0,8
15716,dāhake,dahake,1,1,0,0,6
15717,saterā,satera,4,3,1,0,6
15718,daṇḍamaṇikā,dandamanika,5,4,1,0,11
15719,macchavilolagaggarā,macchavilolagaggara,1,1,0,0,19
15720,sukkhāsani,sukkhasani,2,2,0,0,10
15721,kapisisā,kapisisa,1,1,0,0,8
15722,vicakkā,vicakka,3,3,0,0,7
15723,sañña,sanna,3,3,0,0,5
15724,kukkuṭā,kukkuta,18,18,0,0,7
15725,navāsanīhi,navasanihi,1,1,0,0,10
15726,phālentaṃ,phalentam,3,3,0,0,9
15727,tibbaṃ,tibbam,73,55,18,0,6
15728,paññāsaniṃ,pannasanim,1,1,0,0,10
15729,rodanā,rodana,3,3,0,0,6
15730,kodhāvudho,kodhavudho,1,1,0,0,10
15731,ujjhantissariyaṃ,ujjhantissariyam,1,1,0,0,16
15732,paṭisaṅkhānaṃ,patisankhanam,25,18,7,0,13
15733,aṭṭhabalesu,atthabalesu,1,1,0,0,11
15734,pathavīsadisaṃ,pathavisadisam,2,1,1,0,14
15735,aṭṭhamena,atthamena,20,20,0,0,9
15736,vināyakaṃ,vinayakam,65,60,5,0,9
15737,kāmarogo,kamarogo,1,1,0,0,8
15738,bhavarāgo,bhavarago,43,41,2,0,9
15739,avijjāti,avijjati,81,28,53,0,8
15740,sattānusayinaṃ,sattanusayinam,1,1,0,0,14
15741,titthiyāpakatimahāsāvakā,titthiyapakatimahasavaka,1,1,0,0,24
15742,aggasāvakā,aggasavaka,251,245,6,0,10
15743,paccekabuddhasambuddhā,paccekabuddhasambuddha,1,1,0,0,22
15744,visiṭṭhaṃ,visittham,94,90,4,0,9
15745,nivāsa,nivasa,8,5,3,0,6
15746,viññūsu,vinnusu,19,19,0,0,7
15747,tilokamakuṭaṃ,tilokamakutam,1,1,0,0,13
15748,cakkhūhi,cakkhuhi,90,81,9,0,8
15749,dassāviṃ,dassavim,1,1,0,0,8
15750,mārajiṃ,marajim,2,2,0,0,7
15751,khuddakā,khuddaka,69,69,0,0,8
15752,khaṇikā,khanika,19,14,5,0,7
15753,okkantikā,okkantika,11,9,2,0,9
15754,pharaṇā,pharana,31,28,3,0,7
15755,ubbegā,ubbega,15,13,2,0,6
15756,pītīhi,pitihi,1,1,0,0,6
15757,pinentaṃ,pinentam,1,1,0,0,8
15758,maggasaccakaṃ,maggasaccakam,1,1,0,0,13
15759,catusaccamabhijānaṃ,catusaccamabhijanam,1,1,0,0,19
15760,catukiccehi,catukiccehi,1,1,0,0,11
15761,pīḷanā,pilana,6,6,0,0,6
15762,saṅkhatattho,sankhatattho,1,1,0,0,12
15763,vipariṇāmanā,viparinamana,1,1,0,0,12
15764,catukkehi,catukkehi,11,11,0,0,9
15765,vibhattāviṃ,vibhattavim,4,4,0,0,11
15766,āyūhanaṃ,ayuhanam,82,52,30,0,8
15767,nidānañca,nidananca,20,18,2,0,9
15768,saṃyogo,samyogo,62,58,4,0,7
15769,palibodhanaṃ,palibodhanam,2,1,1,0,12
15770,samudayaṃ,samudayam,219,195,24,0,9
15771,nissaraṇañca,nissarananca,227,225,2,0,12
15772,viveko,viveko,76,66,10,0,6
15773,asaṅkhatāmataṃ,asankhatamatam,1,1,0,0,14
15774,nirodhañca,nirodhanca,22,22,0,0,10
15775,niyyāniko,niyyaniko,114,101,13,0,9
15776,hetvattho,hetvattho,10,8,2,0,9
15777,dassanādhipateyyakaṃ,dassanadhipateyyakam,1,1,0,0,20
15778,satthako,satthako,1,1,0,0,8
15779,asammoho,asammoho,10,9,1,0,8
15780,sappāyo,sappayo,31,31,0,0,7
15781,gocaro,gocaro,256,235,21,0,6
15782,catusampajaññā,catusampajanna,1,1,0,0,14
15783,bhāviṃ,bhavim,14,13,1,0,6
15784,pahinākhila,pahinakhila,1,1,0,0,11
15785,dukkhāhaṃ,dukkhaham,1,1,0,0,9
15786,bhavasāgara,bhavasagara,2,2,0,0,11
15787,pāraguṃ,paragum,51,39,12,0,7
15788,sāraguṇopetaṃ,saragunopetam,4,4,0,0,13
15789,tenamhi,tenamhi,76,73,3,0,7
15790,bhavapārago,bhavaparago,1,1,0,0,11
15791,rūpārūpavilāsagga,ruparupavilasagga,1,1,0,0,17
15792,rūpācinteyya,rupacinteyya,1,1,0,0,12
15793,tenamhātularūpavā,tenamhatularupava,1,1,0,0,17
15794,vilāsagga,vilasagga,3,3,0,0,9
15795,cinteyya,cinteyya,37,37,0,0,8
15796,sāraguṇepetaṃ,saragunepetam,1,1,0,0,13
15797,tenamhā,tenamha,6,6,0,0,7
15798,tulaiddhimā,tulaiddhima,1,1,0,0,11
15799,tulavācako,tulavacako,1,1,0,0,10
15800,ñāṇācinteyya,nanacinteyya,1,1,0,0,12
15801,tulañāṇavā,tulananava,1,1,0,0,10
15802,sajjhaṃ,sajjham,14,10,4,0,7
15803,ratanaṃ,ratanam,427,348,79,0,7
15804,gehaṃ,geham,1006,988,18,0,5
15805,vatthañca,vatthanca,23,22,1,0,9
15806,tadaññepi,tadannepi,15,15,0,0,9
15807,yathācittaṃ,yathacittam,4,4,0,0,11
15808,māpeyyāhaṃ,mapeyyaham,1,1,0,0,10
15809,māpeyyaṃ,mapeyyam,6,6,0,0,8
15810,kammajiddhiyā,kammajiddhiya,3,3,0,0,13
15811,sattabojjhaṅga,sattabojjhanga,1,1,0,0,14
15812,ratano,ratano,1,1,0,0,6
15813,saddhādiratano,saddhadiratano,1,1,0,0,14
15814,satippabhutiratano,satippabhutiratano,1,1,0,0,18
15815,cakkādisattaratanaṃ,cakkadisattaratanam,1,1,0,0,19
15816,muttādiratanaṃ,muttadiratanam,3,3,0,0,14
15817,vatthappabhutiratanaṃ,vatthappabhutiratanam,1,1,0,0,21
15818,chandakkhaṇe,chandakkhane,1,1,0,0,12
15819,labhāmahaṃ,labhamaham,48,47,1,0,10
15820,sampuṇṇacittasaṅkappo,sampunnacittasankappo,2,2,0,0,21
15821,yathākaṅkhitamāpako,yathakankhitamapako,2,2,0,0,19
15822,kenacinabhibhūto,kenacinabhibhuto,1,1,0,0,16
15823,sabbābhibhū,sabbabhibhu,34,33,1,0,11
15824,kenacinabhibhūtamhi,kenacinabhibhutamhi,1,1,0,0,19
15825,chaddantarājāva,chaddantarajava,1,1,0,0,15
15826,kāyabalo,kayabalo,1,1,0,0,8
15827,ñāṇabbalotulyo,nanabbalotulyo,1,1,0,0,14
15828,samaṇuttamaṃ,samanuttamam,2,2,0,0,12
15829,atikāyajavo,atikayajavo,1,1,0,0,11
15830,raññājavanahaṃsato,rannajavanahamsato,1,1,0,0,18
15831,ñāṇavegassa,nanavegassa,3,2,1,0,11
15832,chaddantanāgarājāva,chaddantanagarajava,1,1,0,0,19
15833,rājājavanahaṃsova,rajajavanahamsova,1,1,0,0,17
15834,paramaggajavo,paramaggajavo,1,1,0,0,13
15835,udakā,udaka,89,86,3,0,5
15836,kāsacārī,kasacari,2,2,0,0,8
15837,mahinimujjako,mahinimujjako,2,2,0,0,13
15838,māpako,mapako,4,4,0,0,6
15839,ñeyyapāraguṃ,neyyaparagum,1,1,0,0,12
15840,bhavaso,bhavaso,2,2,0,0,7
15841,ābhatānantalābhassa,abhatanantalabhassa,1,1,0,0,19
15842,pattalābhaggataṃ,pattalabhaggatam,1,1,0,0,16
15843,munipuṅgavaṃ,munipungavam,7,6,1,0,12
15844,ābhatā,abhata,38,38,0,0,6
15845,nantalābho,nantalabho,1,1,0,0,10
15846,hotu,hotu,1685,1661,24,0,4
15847,bhavābhave,bhavabhave,110,107,3,0,10
15848,puññassimassa,punnassimassa,1,1,0,0,13
15849,tejena,tejena,98,97,1,0,6
15850,samijjhatu,samijjhatu,44,44,0,0,10
15851,sabbicchā,sabbiccha,3,3,0,0,9
15852,sabbacintā,sabbacinta,1,1,0,0,10
15853,jātijātiyaṃ,jatijatiyam,9,9,0,0,11
15854,dehīti,dehiti,127,107,20,0,6
15855,para95,para95,278,278,0,0,6
15856,paravasaṃ,paravasam,10,8,2,0,9
15857,sabbamissariyaṃ,sabbamissariyam,2,2,0,0,15
15858,paravasamatthu,paravasamatthu,1,1,0,0,14
15859,para96,para96,278,278,0,0,6
15860,vitakkento,vitakkento,40,38,2,0,10
15861,bhajjakāyo,bhajjakayo,1,1,0,0,10
15862,sabbāvudha,sabbavudha,1,1,0,0,10
15863,vāraṇo,varano,40,35,5,0,6
15864,chaddanta,chaddanta,7,7,0,0,9
15865,vāraṇabalo,varanabalo,1,1,0,0,10
15866,jātijā,jatija,1,1,0,0,6
15867,tiyaṃ,tiyam,3,3,0,0,5
15868,para97,para97,283,283,0,0,6
15869,subhalakkhaṇasampanno,subhalakkhanasampanno,1,1,0,0,21
15870,suvaṇṇavaṇṇavā,suvannavannava,1,1,0,0,14
15871,karavika,karavika,2,2,0,0,8
15872,bhāṇī,bhani,2,2,0,0,5
15873,para98,para98,279,279,0,0,6
15874,bhūrimapañño,bhurimapanno,1,1,0,0,12
15875,sippānaṃ,sippanam,38,36,2,0,8
15876,visajjetuṃ,visajjetum,6,6,0,0,10
15877,samatthova,samatthova,5,4,1,0,10
15878,sabbapucchānaṃ,sabbapucchanam,6,5,1,0,14
15879,ṭhānaso,thanaso,164,145,19,0,7
15880,para99,para99,270,270,0,0,6
15881,verādhaṃsīya,veradhamsiya,1,1,0,0,12
15882,bhogā,bhoga,343,333,10,0,5
15883,anantākhīṇa,anantakhina,1,1,0,0,11
15884,anantābhajja,anantabhajja,1,1,0,0,12
15885,pariso,pariso,1,1,0,0,6
15886,pāpuṇe,papune,38,32,6,0,6
15887,para100,para100,275,275,0,0,7
15888,nasseyyaṃ,nasseyyam,1,1,0,0,9
15889,pasayheyyaṃ,pasayheyyam,1,1,0,0,11
15890,ussukkehi,ussukkehi,1,1,0,0,9
15891,pyahaṃ,pyaham,1,1,0,0,6
15892,pañcaverehi,pancaverehi,1,1,0,0,11
15893,koṭīhi,kotihi,18,18,0,0,6
15894,bhaṇḍaṃ,bhandam,714,677,37,0,7
15895,akātukāmitaṃ,akatukamitam,1,1,0,0,12
15896,para101,para101,262,262,0,0,7
15897,meghaṃ,megham,12,12,0,0,6
15898,vātañca,vatanca,6,6,0,0,7
15899,sabbicchitaṃ,sabbicchitam,1,1,0,0,12
15900,tadaññampi,tadannampi,6,6,0,0,10
15901,para102,para102,263,263,0,0,7
15902,pappomi,pappomi,4,4,0,0,7
15903,tāvatā,tavata,163,152,11,0,6
15904,sabbajātīsu,sabbajatisu,1,1,0,0,11
15905,catusampattiyā,catusampattiya,1,1,0,0,14
15906,catucakkena,catucakkena,2,2,0,0,11
15907,saddhammehi,saddhammehi,15,15,0,0,11
15908,para103,para103,265,265,0,0,7
15909,vasupete,vasupete,1,1,0,0,8
15910,kulamhi,kulamhi,13,12,1,0,7
15911,seṭṭhasammate,setthasammate,2,2,0,0,13
15912,sabbasakkata,sabbasakkata,1,1,0,0,12
15913,saṃsuddhe,samsuddhe,1,1,0,0,9
15914,tihetusandhiko,tihetusandhiko,1,1,0,0,14
15915,para104,para104,250,250,0,0,7
15916,ghāsacchādanaṃ,ghasacchadanam,5,5,0,0,14
15917,bhogañca,bhoganca,6,6,0,0,8
15918,kātuna,katuna,19,19,0,0,6
15919,bhuñjeyyamiddhiyātveva,bhunjeyyamiddhiyatveva,1,1,0,0,22
15920,yāvadatthakaṃ,yavadatthakam,2,2,0,0,13
15921,para105,para105,252,252,0,0,7
15922,vatthaṃ,vattham,577,549,28,0,7
15923,parivārātisundarā,parivaratisundara,1,1,0,0,17
15924,para106,para106,251,251,0,0,7
15925,dasāsuttaṃpi,dasasuttampi,1,1,0,0,12
15926,pañcaverā,pancavera,1,1,0,0,9
15927,māgaṇheyyuñca,maganheyyunca,1,1,0,0,13
15928,nasseyyuṃ,nasseyyum,3,3,0,0,9
15929,asoko,asoko,111,109,2,0,5
15930,bhogahetume,bhogahetume,1,1,0,0,11
15931,para107,para107,250,250,0,0,7
15932,sabbaṅgasubha,sabbangasubha,1,1,0,0,13
15933,siṅgīnikkha,singinikkha,1,1,0,0,11
15934,savaṇṇa,savanna,1,1,0,0,7
15935,lakkhaṇūpeto,lakkhanupeto,2,2,0,0,12
15936,atappana,atappana,1,1,0,0,8
15937,rūpa,rupa,106,87,19,0,4
15938,para108,para108,249,249,0,0,7
15939,candanagandho,candanagandho,27,27,0,0,13
15940,uppalagandhikaṃ,uppalagandhikam,1,1,0,0,15
15941,mañjūghoso,manjughoso,1,1,0,0,10
15942,para109,para109,236,236,0,0,7
15943,gambhīra,gambhira,12,11,1,0,8
15944,pañño,panno,66,64,2,0,5
15945,hāsātijavapaññavā,hasatijavapannava,1,1,0,0,17
15946,bhūri,bhuri,50,41,9,0,5
15947,nibbedha,nibbedha,1,1,0,0,8
15948,sabbapañhavisajjano,sabbapanhavisajjano,1,1,0,0,19
15949,para111,para111,243,243,0,0,7
15950,soḷasavassassa,solasavassassa,2,2,0,0,14
15951,tipeṭakadharo,tipetakadharo,1,1,0,0,13
15952,sabbakammesu,sabbakammesu,20,20,0,0,12
15953,sippesu,sippesu,10,10,0,0,7
15954,vijjāṭhānesu,vijjathanesu,3,3,0,0,12
15955,pāragū,paragu,269,250,19,0,6
15956,jinālaṅkāra,jinalankara,1,1,0,0,11
15957,paṇāmadīpanīgāthā,panamadipanigatha,1,1,0,0,17
15958,lokatthāya,lokatthaya,1,1,0,0,10
15959,dhanasutabhariyāaṅgajīve,dhanasutabhariyaangajive,1,1,0,0,24
15960,āramiyo,aramiyo,1,1,0,0,7
15961,tidasamanupame,tidasamanupame,1,1,0,0,14
15962,bodhipakkhīyadhamme,bodhipakkhiyadhamme,1,1,0,0,19
15963,sakalaguṇadadaṃ,sakalagunadadam,2,2,0,0,15
15964,seṭṭhabhūto,setthabhuto,5,5,0,0,11
15965,katasubhajanataṃ,katasubhajanatam,1,1,0,0,16
15966,dukkhato,dukkhato,694,661,33,0,8
15967,mocayittha,mocayittha,1,1,0,0,10
15968,natvānāhaṃ,natvanaham,1,1,0,0,10
15969,jinantaṃ,jinantam,3,3,0,0,8
15970,samupacitasubhaṃ,samupacitasubham,1,1,0,0,16
15971,sabbalokekabandhuṃ,sabbalokekabandhum,1,1,0,0,18
15972,nāhu,nahu,20,15,5,0,4
15973,yenapi,yenapi,8,6,2,0,6
15974,tulyo,tulyo,34,31,3,0,5
15975,kusalamahimato,kusalamahimato,1,1,0,0,14
15976,bhūtaloke,bhutaloke,1,1,0,0,9
15977,tassevāyaṃ,tassevayam,6,6,0,0,10
15978,uvimhaṃ,uvimham,1,1,0,0,7
15979,suvipulamamalaṃ,suvipulamamalam,1,1,0,0,15
15980,bodhisambhārabhūtaṃ,bodhisambharabhutam,4,4,0,0,19
15981,hetuṃ,hetum,1014,987,27,0,5
15982,hetvānurūpaṃ,hetvanurupam,1,1,0,0,12
15983,sugatagataphalaṃ,sugatagataphalam,1,1,0,0,16
15984,bhāsato,bhasato,182,175,7,0,7
15985,yogāvacarasampattidīpanīgāthā,yogavacarasampattidipanigatha,1,1,0,0,29
15986,navame,navame,437,432,5,0,6
15987,sutadharo,sutadharo,80,74,6,0,9
15988,suddhindriyo,suddhindriyo,1,1,0,0,12
15989,saṃsāraṃ,samsaram,125,112,13,0,8
15990,bhavakkayakaraṃ,bhavakkayakaram,1,1,0,0,15
15991,khemato,khemato,61,55,6,0,7
15992,sampāpakamaggadesakamuniṃ,sampapakamaggadesakamunim,1,1,0,0,25
15993,sampūjayanto,sampujayanto,3,3,0,0,12
15994,uddhānussatibhāvanādikamato,uddhanussatibhavanadikamato,1,1,0,0,27
15995,sampādaye,sampadaye,3,3,0,0,9
15996,vatthuvisodhanīgāthā,vatthuvisodhanigatha,1,1,0,0,20
15997,buddhaguṇoti,buddhagunoti,1,1,0,0,12
15998,acintayādittamupāgato,acintayadittamupagato,1,1,0,0,21
15999,anaññasādhāraṇabhūtamatthaṃ,anannasadharanabhutamattham,1,1,0,0,27
16000,kimavoca,kimavoca,4,4,0,0,8
16001,visuddhakhandhasantāno,visuddhakhandhasantano,1,1,0,0,22
16002,niyamo,niyamo,218,205,13,0,6
16003,khandhasantānasuddhī,khandhasantanasuddhi,1,1,0,0,20
16004,kiccāni,kiccani,172,168,4,0,7
16005,dinesu,dinesu,3,3,0,0,6
16006,pasādayañciddhibalena,pasadayanciddhibalena,1,1,0,0,21
16007,janānasesaṃ,jananasesam,1,1,0,0,11
16008,cariyānukūlaṃ,cariyanukulam,18,17,1,0,13
16009,ñatvānavocānusayappahānaṃ,natvanavocanusayappahanam,1,1,0,0,25
16010,anaññasādhāraṇadīpanīgāthā,anannasadharanadipanigatha,1,1,0,0,26
16011,abbhuggatā,abbhuggata,8,8,0,0,10
16012,anantā,ananta,40,35,5,0,6
16013,tibuddhakhettekadivākaroti,tibuddhakhettekadivakaroti,1,1,0,0,26
16014,lokamimaṃ,lokamimam,53,43,10,0,9
16015,parañca,paranca,461,450,11,0,7
16016,sacetanañceva,sacetananceva,1,1,0,0,13
16017,acetanañca,acetananca,1,1,0,0,10
16018,sakassa,sakassa,33,31,2,0,7
16019,santānagataṃ,santanagatam,1,1,0,0,12
16020,byatītamappattakamatrabhūtaṃ,byatitamappattakamatrabhutam,1,1,0,0,28
16021,pubbādisu,pubbadisu,1,1,0,0,9
16022,cakkavāḷā,cakkavala,19,19,0,0,9
16023,sahassasaṅkhāyapi,sahassasankhayapi,1,1,0,0,17
16024,appameyyā,appameyya,26,24,2,0,9
16025,manujā,manuja,78,70,8,0,6
16026,ekattha,ekattha,115,106,9,0,7
16027,saṅgamma,sangamma,148,143,5,0,8
16028,mantayantā,mantayanta,2,2,0,0,10
16029,anādikālāgatanāmarūpinaṃ,anadikalagatanamarupinam,1,1,0,0,24
16030,yathāsakaṃ,yathasakam,248,244,4,0,10
16031,hetuphalattavuttinaṃ,hetuphalattavuttinam,1,1,0,0,20
16032,tabbhāvabhāvittamasambhuṇantā,tabbhavabhavittamasambhunanta,1,1,0,0,29
16033,nānāvipallāsamanupaviṭṭhā,nanavipallasamanupavittha,1,1,0,0,25
16034,kammappavattiñca,kammappavattinca,1,1,0,0,16
16035,phalappavattiṃ,phalappavattim,5,5,0,0,14
16036,ekattanānattanirīhadhammataṃ,ekattananattanirihadhammatam,1,1,0,0,28
16037,viññattisantānaghanena,vinnattisantanaghanena,1,1,0,0,22
16038,channato,channato,2,2,0,0,8
16039,sivañjasaṃ,sivanjasam,3,3,0,0,10
16040,bhaṇituṃ,bhanitum,7,7,0,0,8
16041,samatthā,samattha,180,172,8,0,8
16042,va,va,1170,1002,168,0,2
16043,santikaro,santikaro,4,4,0,0,9
16044,pabhaṅkaro,pabhankaro,55,53,2,0,10
16045,saṅkhāya,sankhaya,79,66,13,0,8
16046,ñeyyāni,neyyani,22,18,4,0,7
16047,asesitāni,asesitani,1,1,0,0,9
16048,tesañhi,tesanhi,226,217,9,0,7
16049,paramāsambhīvadaṃ,paramasambhivadam,1,1,0,0,17
16050,dīpayituṃ,dipayitum,2,2,0,0,9
16051,sakyasuto,sakyasuto,1,1,0,0,9
16052,sabbassa,sabbassa,378,355,23,0,8
16053,padīpabhūto,padipabhuto,1,1,0,0,11
16054,anantasatte,anantasatte,2,2,0,0,11
16055,bhavabandhanamhā,bhavabandhanamha,1,1,0,0,16
16056,mocesi,mocesi,42,42,0,0,6
16057,kāruññaphalānupekkhī,karunnaphalanupekkhi,1,1,0,0,20
16058,abhinīhāradīpanīgāthā,abhiniharadipanigatha,1,1,0,0,21
16059,vadetha,vadetha,140,137,3,0,7
16060,tassīdha,tassidha,19,15,4,0,8
16061,anappakaṃ,anappakam,146,138,8,0,9
16062,sadisena,sadisena,11,10,1,0,8
16063,sayaṃkataṃ,sayamkatam,120,102,18,0,10
16064,kinnu,kinnu,140,138,2,0,5
16065,adhiccaladdhaṃ,adhiccaladdham,12,9,3,0,14
16066,nādhiccaladdhaṃ,nadhiccaladdham,10,10,0,0,15
16067,pubbabuddhā,pubbabuddha,22,21,1,0,11
16068,brahmādinaṃ,brahmadinam,1,1,0,0,11
16069,sammutiyā,sammutiya,36,36,0,0,9
16070,sayaṃkateneva,sayamkateneva,1,1,0,0,13
16071,anopamena,anopamena,5,5,0,0,9
16072,dānādinā,danadina,8,8,0,0,8
16073,laddhamidaṃ,laddhamidam,38,38,0,0,11
16074,asaṅkhiyānaṃ,asankhiyanam,3,3,0,0,12
16075,sataṃsahassānadhikānamatthake,satamsahassanadhikanamatthake,1,1,0,0,29
16076,atītamhi,atitamhi,5,5,0,0,8
16077,sumedhatāpaso,sumedhatapaso,21,21,0,0,13
16078,vehāyasaṃ,vehayasam,47,39,8,0,9
16079,dipaṅkaro,dipankaro,1,1,0,0,9
16080,sasaṅgho,sasangho,20,20,0,0,8
16081,rammaṃ,rammam,166,154,12,0,6
16082,manussadevehibhipūjiyanto,manussadevehibhipujiyanto,1,1,0,0,25
16083,sahassaraṃsi,sahassaramsi,9,8,1,0,12
16084,bhāṇumā,bhanuma,36,31,5,0,7
16085,nabhe,nabhe,77,75,2,0,5
16086,tassañjasaṃ,tassanjasam,1,1,0,0,11
16087,kātubahussahānaṃ,katubahussahanam,1,1,0,0,16
16088,sumano,sumano,452,422,30,0,6
16089,patīto,patito,45,43,2,0,6
16090,mamajja,mamajja,20,20,0,0,7
16091,panimassa,panimassa,26,25,1,0,9
16092,datvā,datva,3926,3858,68,0,5
16093,hessamanāgatediso,hessamanagatediso,1,1,0,0,17
16094,tasmiñjase,tasminjase,1,1,0,0,10
16095,kandaratamhi,kandaratamhi,1,1,0,0,12
16096,katvāna,katvana,418,401,17,0,7
16097,setuṃ,setum,70,68,2,0,5
16098,sayi,sayi,41,41,0,0,4
16099,sadehaṃ,sadeham,2,2,0,0,7
16100,gacchatu,gacchatu,98,98,0,0,8
16101,piṭṭhiyā,pitthiya,42,40,2,0,8
16102,mamaṃ,mamam,623,566,57,0,5
16103,bodhissace,bodhissace,1,1,0,0,10
16104,hessati,hessati,195,192,3,0,7
16105,ussīsakaṃ,ussisakam,11,11,0,0,9
16106,ajjhāsayo,ajjhasayo,164,155,9,0,9
16107,sijjhatimassanāgate,sijjhatimassanagate,1,1,0,0,19
16108,ñatvāna,natvana,68,58,10,0,7
16109,byākāsi,byakasi,500,494,6,0,7
16110,asesato,asesato,63,57,6,0,7
16111,hessatināgatesu,hessatinagatesu,2,2,0,0,15
16112,sutvāna,sutvana,390,353,37,0,7
16113,mahābhisekaṃ,mahabhisekam,1,1,0,0,12
16114,samanussaranto,samanussaranto,9,9,0,0,14
16115,pūjetvā,pujetva,317,315,2,0,7
16116,yāte,yate,12,7,5,0,4
16117,munidevamānuse,munidevamanuse,1,1,0,0,14
16118,uṭṭhāya,utthaya,667,659,8,0,7
16119,sammasi,sammasi,30,29,1,0,7
16120,samatiṃsapāramī,samatimsaparami,3,3,0,0,15
16121,sikkhattayañcassa,sikkhattayancassa,1,1,0,0,17
16122,pi,pi,1359,1022,337,0,2
16123,bhavassa,bhavassa,186,170,16,0,8
16124,kāruññabalā,karunnabala,1,1,0,0,11
16125,uppannuppannake,uppannuppannake,1,1,0,0,15
16126,jinavaramatule,jinavaramatule,1,1,0,0,14
16127,pūjayitvā,pujayitva,24,24,0,0,9
16128,oso,oso,3,3,0,0,3
16129,niyamato,niyamato,117,111,6,0,8
16130,byākato,byakato,83,83,0,0,7
16131,acanamanupamaṃ,acanamanupamam,1,1,0,0,14
16132,sirena,sirena,8,7,1,0,6
16133,sahitvā,sahitva,3,3,0,0,7
16134,pūrayittha,purayittha,2,2,0,0,10
16135,bodhisambhāradīpanīgāthā,bodhisambharadipanigatha,1,1,0,0,24
16136,dukkhakhinnajanadassanadukkhakhinno,dukkhakhinnajanadassanadukkhakhinno,1,1,0,0,35
16137,kāruññameva,karunnameva,1,1,0,0,11
16138,janatāya,janataya,19,16,3,0,8
16139,mocanamupāyamidanti,mocanamupayamidanti,1,1,0,0,19
16140,tādīparādhamapi,tadiparadhamapi,1,1,0,0,15
16141,ropayī,ropayi,1,1,0,0,6
16142,dānādinekavarapāramisāgaresu,danadinekavaraparamisagaresu,1,1,0,0,28
16143,ogāḷhatāyapi,ogalhatayapi,1,1,0,0,12
16144,paduṭṭhajanena,padutthajanena,1,1,0,0,14
16145,atimahantatarampi,atimahantatarampi,1,1,0,0,17
16146,nāññāsi,nannasi,4,4,0,0,7
16147,sattahitamevea,sattahitamevea,1,1,0,0,14
16148,gavesayanto,gavesayanto,2,2,0,0,11
16149,chetvāna,chetvana,89,79,10,0,8
16150,pacitvāna,pacitvana,6,6,0,0,9
16151,cattagatto,cattagatto,1,1,0,0,10
16152,paṇidhānakāle,panidhanakale,2,2,0,0,13
16153,duṭṭhassa,dutthassa,24,24,0,0,9
16154,dussati,dussati,116,112,4,0,7
16155,chedanena,chedanena,9,9,0,0,9
16156,anantamapi,anantamapi,1,1,0,0,10
16157,jātisatesu,jatisatesu,3,3,0,0,10
16158,sattahitameva,sattahitameva,1,1,0,0,13
16159,dīpaṅkare,dipankare,6,6,0,0,9
16160,gahitasīlasamādhipaññaṃ,gahitasilasamadhipannam,1,1,0,0,23
16161,pālesi,palesi,7,7,0,0,6
16162,sakabodhitale,sakabodhitale,1,1,0,0,13
16163,suniṭṭho,sunittho,1,1,0,0,8
16164,yadābhinīhāramakā,yadabhiniharamaka,1,1,0,0,17
16165,sumedho,sumedho,155,136,19,0,7
16166,maddiṃ,maddim,45,45,0,0,6
16167,adadā,adada,14,13,1,0,5
16168,sivindo,sivindo,1,1,0,0,7
16169,kiñcipekaṃ,kincipekam,1,1,0,0,10
16170,niratthakaṃ,niratthakam,146,137,9,0,11
16171,jalabindutopi,jalabindutopi,1,1,0,0,13
16172,tadantre,tadantre,1,1,0,0,8
16173,anappakā,anappaka,13,12,1,0,8
16174,kuhiṃ,kuhim,643,610,33,0,5
16175,maggapasse,maggapasse,7,7,0,0,10
16176,madhurambabījaṃ,madhurambabijam,2,2,0,0,15
16177,chāyāphalatthāya,chayaphalatthaya,1,1,0,0,16
16178,mahājanānaṃ,mahajananam,7,7,0,0,11
16179,ropesi,ropesi,13,13,0,0,6
16180,khaṇeva,khaneva,5,5,0,0,7
16181,chāyāphale,chayaphale,1,1,0,0,10
16182,puññamaladdhamuddhaṃ,punnamaladdhamuddham,1,1,0,0,20
16183,saṃsārapathe,samsarapathe,1,1,0,0,12
16184,janānaṃ,jananam,247,239,8,0,7
16185,hitāya,hitaya,670,654,16,0,6
16186,attanamabhiropitakkhaṇe,attanamabhiropitakkhane,1,1,0,0,23
16187,siddhaṃ,siddham,543,538,5,0,7
16188,puññūpari,punnupari,1,1,0,0,9
16189,dhanaṅgajīvaṃ,dhanangajivam,1,1,0,0,13
16190,haranti,haranti,218,211,7,0,7
16191,ruhiraṃ,ruhiram,29,29,0,0,7
16192,bhūmāparājiya,bhumaparajiya,1,1,0,0,13
16193,gabbhokkantidīpanīgāthā,gabbhokkantidipanigatha,1,1,0,0,23
16194,gambhīrapānadānādisāgaresu,gambhirapanadanadisagaresu,1,1,0,0,26
16195,thāmasā,thamasa,49,45,4,0,7
16196,taranto,taranto,21,21,0,0,7
16197,maddidānena,maddidanena,1,1,0,0,11
16198,niṭṭhāpetvāna,nitthapetvana,7,7,0,0,13
16199,vasanto,vasanto,463,452,11,0,7
16200,tusīte,tusite,1,1,0,0,6
16201,bodhiparipākamāgamma,bodhiparipakamagamma,1,1,0,0,20
16202,āyācanāya,ayacanaya,7,7,0,0,9
16203,mātugabbhamupāgami,matugabbhamupagami,1,1,0,0,18
16204,sampajāno,sampajano,942,890,52,0,9
16205,mātukucchimhi,matukucchimhi,39,39,0,0,13
16206,okkami,okkami,102,101,1,0,6
16207,okkantiyaṃ,okkantiyam,1,1,0,0,10
16208,dasasahassī,dasasahassi,138,127,11,0,11
16209,pakampittha,pakampittha,18,17,1,0,11
16210,pubbanimittāni,pubbanimittani,56,50,6,0,14
16211,dvattiṃsāni,dvattimsani,3,3,0,0,11
16212,tuṭṭhahaṭṭhā,tutthahattha,26,25,1,0,12
16213,vijāyanamaṅgaladīpanīgāthā,vijayanamangaladipanigatha,1,1,0,0,26
16214,puṇṇagabbhā,punnagabbha,1,1,0,0,11
16215,dasamāsato,dasamasato,1,1,0,0,10
16216,gantvāna,gantvana,234,229,5,0,8
16217,phullaṃ,phullam,38,28,10,0,7
16218,varalumbinīvanaṃ,varalumbinivanam,1,1,0,0,16
16219,varasālasākhaṃ,varasalasakham,1,1,0,0,14
16220,puttavaraṃ,puttavaram,9,9,0,0,10
16221,sahassīdasalokadhātusu,sahassidasalokadhatusu,1,1,0,0,22
16222,asurā,asura,237,223,14,0,5
16223,yakkhā,yakkha,207,196,11,0,6
16224,nānādisā,nanadisa,8,7,1,0,8
16225,maṅgalacakkavāḷaṃ,mangalacakkavalam,1,1,0,0,17
16226,sumaṅgalaṃ,sumangalam,13,12,1,0,10
16227,maṅgalamāgamiṃsu,mangalamagamimsu,1,1,0,0,16
16228,anekasākhañca,anekasakhanca,8,8,0,0,13
16229,sahassamaṇḍalaṃ,sahassamandalam,11,8,3,0,15
16230,marū,maru,44,41,3,0,4
16231,dhārayumantalikkhe,dharayumantalikkhe,8,8,0,0,18
16232,suvaṇṇadaṇḍā,suvannadanda,14,13,1,0,12
16233,vipatanti,vipatanti,3,3,0,0,9
16234,cāmarā,camara,15,14,1,0,6
16235,khajjiṃsu,khajjimsu,1,1,0,0,9
16236,bherī,bheri,42,42,0,0,5
16237,nadiṃsu,nadimsu,8,8,0,0,7
16238,saṅkhā,sankha,215,186,29,0,6
16239,malenakenāpi,malenakenapi,1,1,0,0,12
16240,anūpalitto,anupalitto,33,29,4,0,10
16241,pādāni,padani,91,88,3,0,6
16242,pasārayanto,pasarayanto,3,3,0,0,11
16243,kathī,kathi,3,3,0,0,5
16244,dhammāsanatotaranto,dhammasanatotaranto,1,1,0,0,19
16245,yathādiccavaro,yathadiccavaro,1,1,0,0,14
16246,nabhamhā,nabhamha,4,4,0,0,8
16247,brahmagaṇopagantvā,brahmaganopagantva,1,1,0,0,18
16248,suvaṇṇajālena,suvannajalena,19,19,0,0,13
16249,paṭiggahesuṃ,patiggahesum,32,32,0,0,12
16250,devājinacammakena,devajinacammakena,1,1,0,0,17
16251,dukūlena,dukulena,3,3,0,0,8
16252,varabhūmiyaṃ,varabhumiyam,1,1,0,0,12
16253,vilokesi,vilokesi,27,27,0,0,8
16254,vadiṃsu,vadimsu,171,171,0,0,7
16255,brahmakāyikā,brahmakayika,63,52,11,0,12
16256,uttaraṃ,uttaram,208,174,34,0,7
16257,padavārehi,padavarehi,3,3,0,0,10
16258,vikkamo,vikkamo,18,13,5,0,7
16259,nadī,nadi,534,508,26,0,4
16260,sāvayaṃ,savayam,1,1,0,0,7
16261,sakaṅgharaṃ,sakangharam,1,1,0,0,11
16262,deaputtattamāgami,deaputtattamagami,1,1,0,0,17
16263,brahmaṇā,brahmana,5,5,0,0,8
16264,pañcamiyaṃ,pancamiyam,40,38,2,0,10
16265,subhuttā,subhutta,2,2,0,0,8
16266,gahetuṃ,gahetum,837,788,49,0,7
16267,varalakkhaṇāni,varalakkhanani,1,1,0,0,14
16268,disvāna,disvana,819,777,42,0,7
16269,ekaṅgulimukkhipiṃsu,ekangulimukkhipimsu,1,1,0,0,19
16270,vītarāgo,vitarago,214,194,20,0,8
16271,jiṇṇañca,jinnanca,15,13,2,0,8
16272,byādhikaṃ,byadhikam,6,4,2,0,9
16273,matañca,matanca,12,12,0,0,7
16274,avhāyitaṃ,avhayitam,1,1,0,0,9
16275,pabbajitañca,pabbajitanca,8,7,1,0,12
16276,ohāya,ohaya,133,129,4,0,5
16277,pabbajjamupeti,pabbajjamupeti,7,7,0,0,14
16278,kāme,kame,933,816,117,0,4
16279,agāriyasampattidīpanīgāthā,agariyasampattidipanigatha,1,1,0,0,26
16280,kālakkamena,kalakkamena,2,2,0,0,11
16281,vaḍḍhanto,vaddhanto,41,37,4,0,9
16282,vaḍḍhite,vaddhite,14,14,0,0,8
16283,puññodayenudento,punnodayenudento,1,1,0,0,16
16284,ambare,ambare,71,67,4,0,6
16285,siddhathako,siddhathako,1,1,0,0,11
16286,siddhattho,siddhattho,97,83,14,0,10
16287,deviṃ,devim,132,131,1,0,5
16288,yasodharaṃ,yasodharam,10,10,0,0,10
16289,cattālīsasahassehi,cattalisasahassehi,4,4,0,0,18
16290,pūritthīhi,puritthihi,1,1,0,0,10
16291,purakkhito,purakkhito,1,1,0,0,10
16292,rammasurammasubhesu,rammasurammasubhesu,1,1,0,0,19
16293,gharesu,gharesu,35,32,3,0,7
16294,tiṇṇamutūnamanucchavikesu,tinnamutunamanucchavikesu,1,1,0,0,25
16295,dibbasukhaṃ,dibbasukham,43,43,0,0,11
16296,acchariyabbhutarājavibhūtiṃ,acchariyabbhutarajavibhutim,1,1,0,0,27
16297,nekkhammajjhāsayadīpanīyamakagāthā,nekkhammajjhasayadipaniyamakagatha,1,1,0,0,34
16298,mahimato,mahimato,2,2,0,0,8
16299,tamo,tamo,194,173,21,0,4
16300,nimittāni,nimittani,225,216,9,0,9
16301,madacchidāni,madacchidani,1,1,0,0,12
16302,thīnaṃ,thinam,59,52,7,0,6
16303,virūpāni,virupani,11,11,0,0,8
16304,ratacchidāni,ratacchidani,1,1,0,0,12
16305,pāpāni,papani,159,147,12,0,6
16306,sukhacchidāni,sukhacchidani,1,1,0,0,13
16307,laddhāni,laddhani,22,22,0,0,8
16308,bhavacchidāni,bhavacchidani,1,1,0,0,13
16309,padittagehā,padittageha,1,1,0,0,11
16310,bheravaṃ,bheravam,53,41,12,0,8
16311,ravaṃ,ravam,26,26,0,0,5
16312,sammuṭṭhāya,sammutthaya,1,1,0,0,11
16313,mahesi,mahesi,107,94,13,0,6
16314,mahesimolokiyaputtamattano,mahesimolokiyaputtamattano,1,1,0,0,26
16315,tanosi,tanosi,3,3,0,0,6
16316,pemamahoghamattano,pemamahoghamattano,1,1,0,0,18
16317,ummāraummāragatuddharitvā,ummaraummaragatuddharitva,1,1,0,0,25
16318,yātanarāsabhassa,yatanarasabhassa,1,1,0,0,16
16319,alaṃkāratarena,alamkaratarena,1,1,0,0,14
16320,gantuṃ,gantum,1058,1010,48,0,6
16321,matī,mati,65,63,2,0,4
16322,matīvetimanaṅgabhaṅge,mativetimanangabhange,1,1,0,0,21
16323,ummāraummāragato,ummaraummaragato,1,1,0,0,16
16324,anaṅgabhaṅgaṃ,anangabhangam,1,1,0,0,13
16325,samacintayittha,samacintayittha,1,1,0,0,15
16326,jarāmaccumukhe,jaramaccumukhe,1,1,0,0,14
16327,ṭhitassa,thitassa,794,769,25,0,8
16328,kāmavase,kamavase,1,1,0,0,8
16329,kāmena,kamena,80,79,1,0,6
16330,sādhyamokkhaṃ,sadhyamokkham,1,1,0,0,13
16331,mānena,manena,124,114,10,0,6
16332,mamatthi,mamatthi,12,12,0,0,8
16333,avāraṇīyo,avaraniyo,1,1,0,0,9
16334,yantena,yantena,15,15,0,0,7
16335,ucchuṃ,ucchum,62,62,0,0,6
16336,maddatī,maddati,2,1,1,0,7
16337,ādittamuyātapayātamūnaṃ,adittamuyatapayatamunam,1,1,0,0,23
16338,atāṇāleṇāsaraṇe,atanalenasarane,1,1,0,0,15
16339,vineyya,vineyya,438,401,37,0,7
16340,vijjāvijjāya,vijjavijjaya,2,2,0,0,12
16341,cutañcupetaṃ,cutancupetam,1,1,0,0,12
16342,asārasārūpagatañjanaṃ,asarasarupagatanjanam,1,1,0,0,21
16343,janaṃ,janam,410,353,57,0,5
16344,vijjāyavijjāya,vijjayavijjaya,1,1,0,0,14
16345,yuto,yuto,36,32,4,0,4
16346,cutohaṃ,cutoham,3,3,0,0,7
16347,pahomi,pahomi,29,28,1,0,6
16348,tāretumasaṅgaho,taretumasangaho,1,1,0,0,15
16349,diṭṭhigatāpavaggaṃ,ditthigatapavaggam,1,1,0,0,18
16350,tevāhu,tevahu,1,1,0,0,6
16351,samaggā,samagga,366,356,10,0,7
16352,naggaṃ,naggam,20,19,1,0,6
16353,aho,aho,1487,1391,96,0,3
16354,mohatamassa,mohatamassa,1,1,0,0,11
16355,vaggaṃ,vaggam,119,88,31,0,6
16356,hanissāmi,hanissami,5,5,0,0,9
16357,tamaggamaggā,tamaggamagga,1,1,0,0,12
16358,paseyhakārena,paseyhakarena,1,1,0,0,13
16359,aseyhadukkhaṃ,aseyhadukkham,2,2,0,0,13
16360,janentīha,janentiha,1,1,0,0,9
16361,janānameva,jananameva,1,1,0,0,10
16362,paseyhakārenā,paseyhakarena,1,1,0,0,13
16363,nidānaṃ,nidanam,452,376,76,0,7
16364,oghayogāsavasaṃkilesā,oghayogasavasamkilesa,1,1,0,0,21
16365,tameva,tameva,1392,1327,65,0,6
16366,nāsenti,nasenti,25,24,1,0,7
16367,samuṭṭhitā,samutthita,84,79,5,0,10
16368,ekantikaṃ,ekantikam,48,44,4,0,9
16369,maccu,maccu,144,128,16,0,5
16370,byasanañcanekaṃ,byasanancanekam,1,1,0,0,15
16371,cīraṃ,ciram,25,20,5,0,5
16372,kilesānasamujjalantaṃ,kilesanasamujjalantam,1,1,0,0,21
16373,sattānusayaṃ,sattanusayam,1,1,0,0,12
16374,sādhemi,sadhemi,1,1,0,0,7
16375,vinayāmi,vinayami,1,1,0,0,8
16376,pacchāpi,pacchapi,107,99,8,0,8
16377,passāmi,passami,730,697,33,0,7
16378,sutantaṃ,sutantam,1,1,0,0,8
16379,dibbacakkaṃ,dibbacakkam,1,1,0,0,11
16380,khuracakkamālaṃ,khuracakkamalam,1,1,0,0,15
16381,rajjaṃ,rajjam,2081,2049,32,0,6
16382,sasārajjasamajjamajjaṃ,sasarajjasamajjamajjam,1,1,0,0,22
16383,bandhavā,bandhava,42,42,0,0,8
16384,bandhanamāgatā,bandhanamagata,1,1,0,0,14
16385,suto,suto,196,182,14,0,4
16386,pasūtoyamanaṅgadūto,pasutoyamanangaduto,1,1,0,0,19
16387,samujjalantaṃ,samujjalantam,4,4,0,0,13
16388,vasatī,vasati,113,108,5,0,6
16389,satīsirī,satisiri,1,1,0,0,8
16390,sirīsapāgāramidaṃ,sirisapagaramidam,1,1,0,0,17
16391,mahāvisaṃ,mahavisam,4,4,0,0,9
16392,daddallamānā,daddallamana,37,35,2,0,12
16393,yuvatī,yuvati,7,6,1,0,6
16394,vatīmā,vatima,1,1,0,0,6
16395,sakaṇṭakāyeva,sakantakayeva,1,1,0,0,13
16396,samañjasañjase,samanjasanjase,1,1,0,0,14
16397,virājitasirī,virajitasiri,1,1,0,0,12
16398,siriyāpi,siriyapi,1,1,0,0,8
16399,tassāvalokiya,tassavalokiya,1,1,0,0,13
16400,tittivasānamatthi,tittivasanamatthi,1,1,0,0,17
16401,gacchāmi,gacchami,437,431,6,0,8
16402,handa,handa,515,483,32,0,5
16403,tavanaṅga,tavananga,1,1,0,0,9
16404,sirappabhedaṃ,sirappabhedam,1,1,0,0,13
16405,mattebhakumbhupari,mattebhakumbhupari,1,1,0,0,18
16406,sīhavilāsagāmiṃ,sihavilasagamim,1,1,0,0,15
16407,anaṅgasucira,anangasucira,1,1,0,0,12
16408,panuṇṇabāṇa,panunnabana,1,1,0,0,11
16409,bāṇāni,banani,1,1,0,0,6
16410,saṃhara,samhara,1,1,0,0,7
16411,panuṇṇamito,panunnamito,1,1,0,0,11
16412,rodhena,rodhena,1,1,0,0,7
16413,cāpadagato,capadagato,1,1,0,0,10
16414,manaso,manaso,236,217,19,0,6
16415,soca,soca,55,55,0,0,4
16416,socaṃ,socam,9,8,1,0,5
16417,tavappanavalokiya,tavappanavalokiya,1,1,0,0,17
16418,yāmi,yami,22,21,1,0,4
16419,ratī,rati,63,56,7,0,4
16420,viveke,viveke,60,51,9,0,6
16421,alanteva,alanteva,1,1,0,0,8
16422,vicintayanto,vicintayanto,5,5,0,0,12
16423,manaṅgālayasampadālayaṃ,manangalayasampadalayam,1,1,0,0,23
16424,diṭṭhabālā,ditthabala,1,1,0,0,10
16425,pakkami,pakkami,25,25,0,0,7
16426,pāduddhāravimhayadīpanīgāthā,paduddharavimhayadipanigatha,1,1,0,0,28
16427,yāvañcayaṃ,yavancayam,1,1,0,0,10
16428,caratyacalena,caratyacalena,1,1,0,0,13
16429,ruddhe,ruddhe,9,9,0,0,6
16430,yāvañca,yavanca,28,24,4,0,7
16431,cakkaratanañca,cakkaratananca,4,4,0,0,14
16432,payāti,payati,6,6,0,0,6
16433,tāvissaro,tavissaro,1,1,0,0,9
16434,nabhacaro,nabhacaro,1,1,0,0,9
16435,jitacāturanto,jitacaturanto,1,1,0,0,13
16436,padamuddhari,padamuddhari,8,8,0,0,12
16437,nirāso,niraso,65,57,8,0,6
16438,dīpe,dipe,194,189,5,0,4
16439,caturādhikadvesahasse,caturadhikadvesahasse,1,1,0,0,21
16440,tatrāpi,tatrapi,368,353,15,0,7
16441,seṭṭhabhajitaṃ,setthabhajitam,1,1,0,0,14
16442,varajambudīpaṃ,varajambudipam,1,1,0,0,14
16443,bhūnābhikaṃ,bhunabhikam,1,1,0,0,11
16444,kapilavatthupuraṃ,kapilavatthupuram,12,12,0,0,17
16445,surammaṃ,surammam,26,24,2,0,8
16446,ñātīnasīti,natinasiti,1,1,0,0,10
16447,kulato,kulato,17,17,0,0,6
16448,sahassa,sahassa,56,52,4,0,7
16449,sākye,sakye,1,1,0,0,5
16450,hatthissadhaññadhanino,hatthissadhannadhanino,1,1,0,0,22
16451,vijitārisaṇghe,vijitarisanghe,1,1,0,0,14
16452,gottena,gottena,302,295,7,0,7
16453,gotamabhavaṃ,gotamabhavam,1,1,0,0,12
16454,pitarañjanaggaṃ,pitaranjanaggam,1,1,0,0,15
16455,surammavasatiṃ,surammavasatim,1,1,0,0,14
16456,ratanujjalantaṃ,ratanujjalantam,2,2,0,0,15
16457,gimhepi,gimhepi,3,3,0,0,7
16458,vimhayakaraṃ,vimhayakaram,6,4,2,0,12
16459,suramandirābhaṃ,suramandirabham,1,1,0,0,15
16460,ussāpitaddhajapaṭākasitātapattaṃ,ussapitaddhajapatakasitatapattam,1,1,0,0,32
16461,sapokkharā,sapokkhara,1,1,0,0,10
16462,pokkharaṇī,pokkharani,186,177,9,0,10
16463,supupphitā,supupphita,23,23,0,0,10
16464,mandirato,mandirato,1,1,0,0,9
16465,kokā,koka,12,11,1,0,4
16466,nadantūpari,nadantupari,1,1,0,0,11
16467,kokanāde,kokanade,1,1,0,0,8
16468,saroje,saroje,2,2,0,0,6
16469,ruditāḷipāḷi,ruditalipali,1,1,0,0,12
16470,pañjarañjasā,panjaranjasa,1,1,0,0,12
16471,disvāravindāni,disvaravindani,1,1,0,0,14
16472,mukhāravindaṃ,mukharavindam,1,1,0,0,13
16473,saṃkujanti,samkujanti,1,1,0,0,10
16474,madhurā,madhura,47,38,9,0,7
16475,madhurābhirutā,madhurabhiruta,1,1,0,0,14
16476,caritā,carita,25,24,1,0,6
16477,padume,padume,32,30,2,0,6
16478,padumeḷigaṇā,padumeligana,1,1,0,0,12
16479,vasatiṃ,vasatim,9,9,0,0,7
16480,adhunā,adhuna,117,110,7,0,6
16481,madhunā,madhuna,32,32,0,0,7
16482,akaruṃ,akarum,19,19,0,0,6
16483,patinā,patina,30,28,2,0,6
16484,tamhā,tamha,594,548,46,0,5
16485,madhukarā,madhukara,4,4,0,0,9
16486,bhavanaṃ,bhavanam,257,243,14,0,8
16487,haritvā,haritva,175,166,9,0,7
16488,ninnādino,ninnadino,1,1,0,0,9
16489,samadhuraṃ,samadhuram,14,14,0,0,10
16490,nādena,nadena,5,5,0,0,6
16491,nādamatiriccupavīṇayanti,nadamatiriccupavinayanti,1,1,0,0,24
16492,naccanti,naccanti,102,99,3,0,8
16493,surapure,surapure,1,1,0,0,8
16494,vaṇitā,vanita,2,2,0,0,6
16495,sañcoditā,sancodita,6,6,0,0,9
16496,pīṇapayodharādharā,pinapayodharadhara,1,1,0,0,18
16497,virājitānaṅgajamekhalākhalā,virajitanangajamekhalakhala,1,1,0,0,27
16498,suraṅgaṇā,surangana,1,1,0,0,9
16499,vaṅgajaphassadā,vangajaphassada,1,1,0,0,15
16500,ramā,rama,7,7,0,0,4
16501,ramāpenti,ramapenti,2,2,0,0,9
16502,varaṅgadāgadā,varangadagada,1,1,0,0,13
16503,karātirattā,karatiratta,1,1,0,0,11
16504,ratirattarāmā,ratirattarama,1,1,0,0,13
16505,tāḷenti,talenti,28,28,0,0,7
16506,tāḷāvacare,talavacare,2,2,0,0,10
16507,naccuggatānekasahassahatthā,naccuggatanekasahassahattha,1,1,0,0,27
16508,sakkopi,sakkopi,71,70,1,0,7
16509,sakyasamoti,sakyasamoti,1,1,0,0,11
16510,codayuṃ,codayum,1,1,0,0,7
16511,visālanettā,visalanetta,5,5,0,0,11
16512,hasulā,hasula,16,15,1,0,6
16513,sumajjhā,sumajjha,2,2,0,0,8
16514,nimbatthanī,nimbatthani,1,1,0,0,11
16515,vimhayagītasaddā,vimhayagitasadda,1,1,0,0,16
16516,alaṅkatā,alankata,113,109,4,0,8
16517,malladharā,malladhara,1,1,0,0,10
16518,suvatthā,suvattha,7,7,0,0,8
16519,tāḷāvacarehi,talavacarehi,1,1,0,0,12
16520,ghuṭṭhā,ghuttha,1,1,0,0,7
16521,yāsaṃ,yasam,97,94,3,0,5
16522,phassesu,phassesu,21,16,5,0,8
16523,kathāvakāsā,kathavakasa,1,1,0,0,11
16524,kāmaratiṃnubhonto,kamaratimnubhonto,1,1,0,0,17
16525,pādepāde,padepade,1,1,0,0,8
16526,valayaviravāmekhalāvīṇānādā,valayaviravamekhalavinanada,1,1,0,0,27
16527,gītaṃgītaṃ,gitamgitam,1,1,0,0,10
16528,patiratikaraṃ,patiratikaram,1,1,0,0,13
16529,gāyatī,gayati,6,6,0,0,6
16530,hatthehatthe,hatthehatthe,1,1,0,0,12
16531,valayacalitā,valayacalita,1,1,0,0,12
16532,sambhamaṃ,sambhamam,2,2,0,0,9
16533,sambhamanti,sambhamanti,2,2,0,0,11
16534,disvādisvā,disvadisva,1,1,0,0,10
16535,ratikaraṃ,ratikaram,4,3,1,0,9
16536,hāhā,haha,4,3,1,0,4
16537,kimīhā,kimiha,1,1,0,0,6
16538,apunarāvattigamanadīpanīyamakagāthā,apunaravattigamanadipaniyamakagatha,1,1,0,0,35
16539,anantakālopacitena,anantakalopacitena,1,1,0,0,18
16540,nibbattavimānayāne,nibbattavimanayane,1,1,0,0,18
16541,jātasutaṃ,jatasutam,1,1,0,0,9
16542,pajāpatiṃ,pajapatim,58,54,4,0,9
16543,jīvamānaṃ,jivamanam,8,8,0,0,9
16544,pitarañca,pitaranca,36,32,4,0,9
16545,ñātake,natake,173,165,8,0,6
16546,tādisiyo,tadisiyo,3,3,0,0,8
16547,itthiyo,itthiyo,695,683,12,0,7
16548,tādise,tadise,323,309,14,0,6
16549,rammakare,rammakare,1,1,0,0,9
16550,nikete,nikete,7,6,1,0,6
16551,khomañca,khomanca,2,2,0,0,8
16552,pattuṇṇadukūlacīnaṃ,pattunnadukulacinam,1,1,0,0,19
16553,sakāsikaṃ,sakasikam,1,1,0,0,9
16554,sādhusugandhavāsitaṃ,sadhusugandhavasitam,1,1,0,0,20
16555,nivāsito,nivasito,2,2,0,0,8
16556,vāsavo,vasavo,51,47,4,0,6
16557,vidhippakāsā,vidhippakasa,1,1,0,0,12
16558,nidhiyo,nidhiyo,1,1,0,0,7
16559,samuggatā,samuggata,10,9,1,0,9
16560,bhūtadharā,bhutadhara,7,6,1,0,10
16561,vasundharā,vasundhara,37,35,2,0,10
16562,sattāvasattāvasudhā,sattavasattavasudha,1,1,0,0,19
16563,sudhāsā,sudhasa,1,1,0,0,7
16564,suvaṇṇathāle,suvannathale,7,7,0,0,12
16565,satarājike,satarajike,3,3,0,0,10
16566,sādhuṃ,sadhum,35,34,1,0,6
16567,sucisālibhojanaṃ,sucisalibhojanam,1,1,0,0,16
16568,bhutvā,bhutva,220,204,16,0,6
16569,savāsīhi,savasihi,1,1,0,0,8
16570,vilāsinīhi,vilasinihi,1,1,0,0,10
16571,gata,gata,11,11,0,0,4
16572,manuññagandhena,manunnagandhena,1,1,0,0,15
16573,asuññagandho,asunnagandho,1,1,0,0,12
16574,sugandhagandhena,sugandhagandhena,1,1,0,0,16
16575,vilittagatto,vilittagatto,2,2,0,0,12
16576,sugandhavātena,sugandhavatena,1,1,0,0,14
16577,suvijjitaṅgo,suvijjitango,1,1,0,0,12
16578,sulakkhaṇe,sulakkhane,1,1,0,0,10
16579,hevabhilakkhitaṅgo,hevabhilakkhitango,1,1,0,0,18
16580,pasādhito,pasadhito,2,1,1,0,9
16581,devapasādhanena,devapasadhanena,1,1,0,0,15
16582,samarājinīhi,samarajinihi,1,1,0,0,12
16583,nānāsanāni,nanasanani,1,1,0,0,10
16584,sayanāni,sayanani,8,8,0,0,8
16585,nivesanāni,nivesanani,67,63,4,0,10
16586,bhābhānibhāni,bhabhanibhani,1,1,0,0,13
16587,ratanākarasannibhāni,ratanakarasannibhani,1,1,0,0,20
16588,tatrussitāni,tatrussitani,1,1,0,0,12
16589,ratanaddhajabhūsitāni,ratanaddhajabhusitani,1,1,0,0,21
16590,himabindusamāni,himabindusamani,1,1,0,0,15
16591,nānāvidhehi,nanavidhehi,42,41,1,0,11
16592,ratanehi,ratanehi,108,108,0,0,8
16593,samujjalehi,samujjalehi,1,1,0,0,11
16594,nārīhi,narihi,7,7,0,0,6
16595,niccamupagāyitahammiyehi,niccamupagayitahammiyehi,1,1,0,0,24
16596,rajjehi,rajjehi,3,3,0,0,7
16597,cakkaratanādivibhūsitehi,cakkaratanadivibhusitehi,1,1,0,0,24
16598,yāto,yato,13,13,0,0,4
16599,purisassarehi,purisassarehi,1,1,0,0,13
16600,dvipādabyāsayamakagāthā,dvipadabyasayamakagatha,1,1,0,0,23
16601,pīṇapayodharādharaṃ,pinapayodharadharam,2,2,0,0,19
16602,anaṅgaraṅgaddhajabhūtamaṅgaṃ,anangarangaddhajabhutamangam,1,1,0,0,28
16603,devaccharāvujjalitaṃ,devaccharavujjalitam,1,1,0,0,20
16604,patibbataṃ,patibbatam,19,19,0,0,10
16605,nūna,nuna,577,540,37,0,4
16606,sabhāvanicchandamatiṃ,sabhavanicchandamatim,1,1,0,0,21
16607,pabhāvatiṃ,pabhavatim,34,33,1,0,10
16608,bhatto,bhatto,13,11,2,0,6
16609,kuso,kuso,59,55,4,0,4
16610,saṃhari,samhari,2,2,0,0,7
16611,bhattakājaṃ,bhattakajam,6,6,0,0,11
16612,tāyābhirūpaṃ,tayabhirupam,1,1,0,0,12
16613,saṇcari,sancari,1,1,0,0,7
16614,khaggahattho,khaggahattho,6,6,0,0,12
16615,paritthīnaṃ,paritthinam,1,1,0,0,11
16616,anitthigandho,anitthigandho,3,1,2,0,13
16617,siriñca,sirinca,1,1,0,0,7
16618,riñcāpi,rincapi,1,1,0,0,7
16619,riñci,rinci,1,1,0,0,5
16620,nāriṃ,narim,28,24,4,0,5
16621,hitvānimandāni,hitvanimandani,1,1,0,0,14
16622,harittaco,harittaco,1,1,0,0,9
16623,rāgabalena,ragabalena,3,3,0,0,10
16624,deviyā,deviya,337,332,5,0,6
16625,avatthaliṅgena,avatthalingena,1,1,0,0,14
16626,liṅganussari,linganussari,1,1,0,0,12
16627,asevi,asevi,1,1,0,0,5
16628,tamidāni,tamidani,2,2,0,0,8
16629,apameyyakappesu,apameyyakappesu,1,1,0,0,15
16630,vivekasevī,vivekasevi,1,1,0,0,10
16631,rajjasiriṃ,rajjasirim,34,34,0,0,10
16632,varitthiṃ,varitthim,1,1,0,0,9
16633,aṇuṃ,anum,84,66,18,0,4
16634,kaliṃ,kalim,46,38,8,0,5
16635,vaṇṇayi,vannayi,6,6,0,0,7
16636,purāṇaṃ,puranam,173,147,26,0,7
16637,vatthamhi,vatthamhi,2,2,0,0,9
16638,tunnakāro,tunnakaro,6,6,0,0,9
16639,tathāti,tathati,238,49,189,0,7
16640,mantvāna,mantvana,20,20,0,0,8
16641,idāninaṅgo,idaninango,1,1,0,0,10
16642,paggahito,paggahito,1,1,0,0,9
16643,matto,matto,98,88,10,0,5
16644,jitomhīti,jitomhiti,1,1,0,0,9
16645,pamattabandhu,pamattabandhu,21,15,6,0,13
16646,passi,passi,203,198,5,0,5
16647,ñāṇāsanipātamantaraṃ,nanasanipatamantaram,2,2,0,0,20
16648,dukkhānalasambhavaṃbhavaṃ,dukkhanalasambhavambhavam,1,1,0,0,25
16649,taduppādakanaṅgabhaṅgaṃ,taduppadakanangabhangam,1,1,0,0,23
16650,buddhabalappadaṃ,buddhabalappadam,1,1,0,0,16
16651,anantasattānamanantakāle,anantasattanamanantakale,1,1,0,0,24
16652,manaṅgahetvāna,manangahetvana,1,1,0,0,14
16653,jito,jito,75,67,8,0,4
16654,anaṅgo,anango,4,4,0,0,6
16655,parājito,parajito,137,130,7,0,8
16656,ekakassa,ekakassa,44,42,2,0,8
16657,punāgato,punagato,8,8,0,0,8
16658,disvānañāṇāsanipātamantaraṃ,disvanananasanipatamantaram,1,1,0,0,27
16659,tipādabyāsayamakagāthā,tipadabyasayamakagatha,1,1,0,0,22
16660,tathāgataccheramahosi,tathagataccheramahosi,1,1,0,0,21
16661,himāropitadāhasantiṃ,himaropitadahasantim,1,1,0,0,20
16662,tadāha,tadaha,41,40,1,0,6
16663,hasantiṃ,hasantim,2,2,0,0,8
16664,pādabyāsamahāyamakagāthā,padabyasamahayamakagatha,1,1,0,0,24
16665,sakāmadātā,sakamadata,4,4,0,0,10
16666,vinayāmanatagū,vinayamanatagu,1,1,0,0,14
16667,vinayāmanantagū,vinayamanantagu,3,3,0,0,15
16668,abyāpetādyantayamakagāthā,abyapetadyantayamakagatha,1,1,0,0,25
16669,raveraverorabhimārabherave,raveraverorabhimarabherave,1,1,0,0,26
16670,raveraveriva,raveraveriva,1,1,0,0,12
16671,bherave,bherave,16,15,1,0,7
16672,rave,rave,16,13,3,0,4
16673,sūditagārave,suditagarave,1,1,0,0,12
16674,raveravedesi,raveravedesi,1,1,0,0,12
16675,jinorave,jinorave,1,1,0,0,8
16676,paṭilomayamakagāthā,patilomayamakagatha,1,1,0,0,19
16677,lokāyātatayā,lokayatataya,1,1,0,0,12
16678,visesaṃ,visesam,625,593,32,0,7
16679,saṃsevi,samsevi,4,4,0,0,7
16680,yātatayā,yatataya,1,1,0,0,8
16681,rājarājayasopetavisesaṃ,rajarajayasopetavisesam,1,1,0,0,23
16682,yāmataṃ,yamatam,1,1,0,0,7
16683,cirasaṃsevitapeso,cirasamsevitapeso,1,1,0,0,17
16684,yajarājarā,yajarajara,1,1,0,0,10
16685,ekaṭhānikādiyamakagāthā,ekathanikadiyamakagatha,1,1,0,0,23
16686,ākaṅkhakkhākaṅkhaṅga,akankhakkhakankhanga,1,1,0,0,20
16687,kaṅkhāgaṅgākhāgahaka,kankhagangakhagahaka,1,1,0,0,20
16688,kaṅkhāgāhakakaṅkhāgha,kankhagahakakankhagha,1,1,0,0,21
16689,hā,ha,77,44,33,0,2
16690,kaṅkhā,kankha,646,617,29,0,6
16691,appagabbho,appagabbho,24,19,5,0,10
16692,apagabbho,apagabbho,25,23,2,0,9
16693,amoho,amoho,382,371,11,0,5
16694,pamohako,pamohako,2,2,0,0,8
16695,maggamukhaṃ,maggamukham,1,1,0,0,11
16696,mokhamāha,mokhamaha,1,1,0,0,9
16697,māhā,maha,4,4,0,0,4
16698,mohamūhakkhamaṃ,mohamuhakkhamam,1,1,0,0,15
16699,pāpāpāpabhavaṃ,papapapabhavam,1,1,0,0,14
16700,pāpāpabhavuggato,papapabhavuggato,1,1,0,0,16
16701,pāpāpāpabhavāsaṅgā,papapapabhavasanga,1,1,0,0,18
16702,pāpāpāpabhavāgato,papapapabhavagato,1,1,0,0,17
16703,kusalākusalaṃ,kusalakusalam,147,141,6,0,13
16704,kusalākusalāsaṅga,kusalakusalasanga,1,1,0,0,17
16705,kusalākusalā,kusalakusala,138,123,15,0,12
16706,cuto,cuto,565,537,28,0,4
16707,akkharuttarikayamakagāthā,akkharuttarikayamakagatha,1,1,0,0,25
16708,nonānino,nonanino,1,1,0,0,8
16709,nanūnāni,nanunani,1,1,0,0,8
16710,nanenāni,nanenani,1,1,0,0,8
16711,nanānino,nananino,1,1,0,0,8
16712,nunnānenāni,nunnanenani,1,1,0,0,11
16713,nānanaṃ,nananam,1,1,0,0,7
16714,nānanena,nananena,1,1,0,0,8
16715,sāre,sare,36,30,6,0,4
16716,surāsure,surasure,1,1,0,0,8
16717,sārī,sari,6,6,0,0,4
16718,rasasārasarissaro,rasasarasarissaro,1,1,0,0,17
16719,rasasārarase,rasasararase,1,1,0,0,12
16720,sāri,sari,3,3,0,0,4
16721,surāsurasarassire,surasurasarassire,1,1,0,0,17
16722,nandano,nandano,4,4,0,0,7
16723,devadeva,devadeva,2,1,1,0,8
16724,vedadīnena,vedadinena,1,1,0,0,10
16725,vedana,vedana,6,6,0,0,6
16726,vedi,vedi,62,51,11,0,4
16727,vedino,vedino,1,1,0,0,6
16728,devāsane,devasane,10,9,1,0,8
16729,devadevo,devadevo,56,47,9,0,8
16730,sasāsane,sasasane,1,1,0,0,8
16731,nisinnānaṃ,nisinnanam,76,75,1,0,10
16732,sadevānaṃ,sadevanam,1,1,0,0,9
16733,desesi,desesi,674,670,4,0,6
16734,dassanāsanaṃ,dassanasanam,1,1,0,0,12
16735,paheḷigāthā,paheligatha,1,1,0,0,11
16736,dasanāvagato,dasanavagato,1,1,0,0,12
16737,sañño,sanno,22,21,1,0,5
16738,tamado,tamado,1,1,0,0,6
16739,aṭṭhamāpuṇṇasaṅkappo,atthamapunnasankappo,1,1,0,0,20
16740,pātvanaññamanaññiva,patvanannamananniva,1,1,0,0,19
16741,byāpetādiyamakagāthā,byapetadiyamakagatha,1,1,0,0,20
16742,para110,para110,241,241,0,0,7
16743,ekantameva,ekantameva,13,12,1,0,10
16744,saparatthaparo,saparatthaparo,1,1,0,0,14
16745,dasapāramitābalena,dasaparamitabalena,1,1,0,0,18
16746,hatamārabalena,hatamarabalena,1,1,0,0,14
16747,suvisuddhamalattha,suvisuddhamalattha,1,1,0,0,18
16748,mahāpadhānadīpanīgāthā,mahapadhanadipanigatha,1,1,0,0,22
16749,orohitotohitapāpadhammo,orohitotohitapapadhammo,1,1,0,0,23
16750,channena,channena,27,25,2,0,8
16751,channahayena,channahayena,1,1,0,0,12
16752,anomatīramhi,anomatiramhi,1,1,0,0,12
16753,anomasatto,anomasatto,2,2,0,0,10
16754,anomapabbajjamupāgato,anomapabbajjamupagato,1,1,0,0,21
16755,para112,para112,246,246,0,0,7
16756,nirāmisaṃ,niramisam,130,115,15,0,9
16757,anūpamaṃ,anupamam,5,5,0,0,8
16758,anūpiye,anupiye,1,1,0,0,7
16759,ambavane,ambavane,87,83,4,0,8
16760,sarūpasobhāya,sarupasobhaya,1,1,0,0,13
16761,virūpasobhaṃ,virupasobham,1,1,0,0,12
16762,sarājikaṃ,sarajikam,5,4,1,0,9
16763,karittha,karittha,41,41,0,0,8
16764,para113,para113,238,238,0,0,7
16765,aḷāra,alara,19,19,0,0,5
16766,ūdakatāpasānaṃ,udakatapasanam,1,1,0,0,14
16767,jhānenasantuṭṭhamano,jhanenasantutthamano,1,1,0,0,20
16768,vihāya,vihaya,98,94,4,0,6
16769,mahāpadhānāya,mahapadhanaya,1,1,0,0,13
16770,uruvelabhūmiṃ,uruvelabhumim,1,1,0,0,13
16771,sikhappattamakāsi,sikhappattamakasi,1,1,0,0,17
16772,para114,para114,237,237,0,0,7
16773,kāmato,kamato,63,59,4,0,6
16774,nevatidukkaramhi,nevatidukkaramhi,1,1,0,0,16
16775,sijjhati,sijjhati,270,265,5,0,8
16776,majjhimāya,majjhimaya,64,60,4,0,10
16777,pubbaguṇopaladdhaṃ,pubbagunopaladdham,1,1,0,0,18
16778,samānetumagā,samanetumaga,1,1,0,0,12
16779,subodhiṃ,subodhim,5,5,0,0,8
16780,māraparājayadīpanīgāthā,maraparajayadipanigatha,1,1,0,0,23
16781,para115,para115,240,240,0,0,7
16782,tibuddhakhettamhi,tibuddhakhettamhi,1,1,0,0,17
16783,tisetachattaṃ,tisetachattam,1,1,0,0,13
16784,laddhāna,laddhana,94,88,6,0,8
16785,lokādhipatī,lokadhipati,8,8,0,0,11
16786,bodhimhiparājitāsane,bodhimhiparajitasane,1,1,0,0,20
16787,yuddhāya,yuddhaya,32,30,2,0,8
16788,mārenacalo,marenacalo,1,1,0,0,10
16789,para116,para116,242,242,0,0,7
16790,datvāna,datvana,196,194,2,0,7
16791,namassamāno,namassamano,117,107,10,0,11
16792,setachattena,setachattena,1,1,0,0,12
16793,para118,para118,238,238,0,0,7
16794,nārāyanabalo,narayanabalo,1,1,0,0,12
16795,abhiññābalapāragū,abhinnabalaparagu,1,1,0,0,17
16796,jetuṃ,jetum,27,27,0,0,5
16797,bodhimaṇḍaṃupāgami,bodhimandamupagami,1,1,0,0,18
16798,para119,para119,227,227,0,0,7
16799,vasavattīrājā,vasavattiraja,1,1,0,0,13
16800,chakāmavacarissaro,chakamavacarissaro,1,1,0,0,18
16801,sasenāvāhano,sasenavahano,1,1,0,0,12
16802,yuddhāyupāgami,yuddhayupagami,1,1,0,0,14
16803,para120,para120,220,220,0,0,7
16804,etha,etha,357,345,12,0,4
16805,gaṇgatha,gangatha,1,1,0,0,8
16806,bandhatha,bandhatha,20,20,0,0,9
16807,chaṭṭetha,chattetha,1,1,0,0,9
16808,ceṭakaṃ,cetakam,3,3,0,0,7
16809,manussakalale,manussakalale,1,1,0,0,13
16810,kimihanti,kimihanti,1,1,0,0,9
16811,maññati,mannati,779,747,32,0,7
16812,para121,para121,225,225,0,0,7
16813,jalantaṃ,jalantam,39,37,2,0,8
16814,navavidhaṃ,navavidham,86,71,15,0,10
16815,vassaṃ,vassam,880,820,60,0,6
16816,vassāpeti,vassapeti,8,8,0,0,9
16817,dhūmandhakāraṃ,dhumandhakaram,1,1,0,0,14
16818,pātesi,patesi,99,99,0,0,6
16819,asinaṃ,asinam,1,1,0,0,6
16820,para122,para122,230,230,0,0,7
16821,khipento,khipento,2,2,0,0,8
16822,kātave,katave,23,23,0,0,6
16823,itibravi,itibravi,1,1,0,0,8
16824,para123,para123,223,223,0,0,7
16825,āsi,asi,1034,1012,22,0,3
16826,āsane,asane,816,786,30,0,5
16827,mama,mama,6663,6488,175,0,4
16828,santake,santake,100,98,2,0,7
16829,uṭṭhehi,utthehi,124,116,8,0,7
16830,āsanā,asana,190,180,10,0,5
16831,phālemi,phalemi,2,2,0,0,7
16832,para124,para124,213,213,0,0,7
16833,sapādamūle,sapadamule,1,1,0,0,10
16834,kīḷantaṃ,kilantam,7,7,0,0,8
16835,taruṇaṃ,tarunam,32,29,3,0,7
16836,vudikkhi,vudikkhi,1,1,0,0,8
16837,mettāyanto,mettayanto,9,9,0,0,10
16838,dayaparo,dayaparo,1,1,0,0,8
16839,para125,para125,213,213,0,0,7
16840,asambhivācaṃ,asambhivacam,1,1,0,0,12
16841,dāsabhāvapiyaṃ,dasabhavapiyam,1,1,0,0,14
16842,khaḷo,khalo,1,1,0,0,5
16843,para126,para126,210,210,0,0,7
16844,devapure,devapure,19,19,0,0,8
16845,vare,vare,156,148,8,0,4
16846,gatiṃ,gatim,300,255,45,0,5
16847,lokajeṭṭhoti,lokajetthoti,4,1,3,0,12
16848,para127,para127,204,204,0,0,7
16849,anantalokakhātumhi,anantalokakhatumhi,1,1,0,0,18
16850,mayhekapāramiyā,mayhekaparamiya,1,1,0,0,15
16851,kalaṃ,kalam,164,151,13,0,5
16852,nagghati,nagghati,2,2,0,0,8
16853,soḷasiṃ,solasim,97,86,11,0,7
16854,para128,para128,209,209,0,0,7
16855,tiracchāno,tiracchano,21,20,1,0,10
16856,yācakamāgataṃ,yacakamagatam,4,4,0,0,13
16857,patiioggimhi,patiioggimhi,1,1,0,0,12
16858,dātave,datave,24,24,0,0,6
16859,para129,para129,207,207,0,0,7
16860,anantakālesu,anantakalesu,1,1,0,0,12
16861,kareyyañño,kareyyanno,1,1,0,0,10
16862,anummatto,anummatto,5,5,0,0,9
16863,para130,para130,205,205,0,0,7
16864,anantapuññehi,anantapunnehi,1,1,0,0,13
16865,dehamimaṃ,dehamimam,4,4,0,0,9
16866,yathābhutaṃ,yathabhutam,1,1,0,0,11
16867,manussosīti,manussositi,2,1,1,0,11
16868,para131,para131,209,209,0,0,7
16869,nāhaṃ,naham,1322,1228,94,0,5
16870,manussomanusso,manussomanusso,1,1,0,0,14
16871,jarāmaraṇaṃ,jaramaranam,734,699,35,0,11
16872,panidhāgato,panidhagato,1,1,0,0,11
16873,para132,para132,206,206,0,0,7
16874,anupalitto,anupalitto,52,49,3,0,10
16875,jātonantajino,jatonantajino,1,1,0,0,13
16876,bodhitale,bodhitale,13,13,0,0,9
16877,para133,para133,199,199,0,0,7
16878,dhajinaṃ,dhajinam,1,1,0,0,8
16879,savāhanaṃ,savahanam,26,23,3,0,9
16880,paccugacchāmi,paccugacchami,1,1,0,0,13
16881,ṭhānā,thana,377,337,40,0,5
16882,acāvayi,acavayi,3,2,1,0,7
16883,para134,para134,199,199,0,0,7
16884,yante,yante,24,20,4,0,5
16885,nappasahati,nappasahati,9,9,0,0,11
16886,senaṃ,senam,277,254,23,0,5
16887,sadevako,sadevako,85,80,5,0,8
16888,tante,tante,26,22,4,0,5
16889,āmaṃ,amam,32,29,3,0,4
16890,asmanā,asmana,5,5,0,0,6
16891,para135,para135,206,206,0,0,7
16892,icchanto,icchanto,123,123,0,0,8
16893,sāsape,sasape,4,4,0,0,6
16894,gabbhe,gabbhe,183,180,3,0,6
16895,caṅkamāmi,cankamami,8,8,0,0,9
16896,cito,cito,502,484,18,0,4
16897,lokadhātumhi,lokadhatumhi,2,2,0,0,12
16898,attabhāvena,attabhavena,91,90,1,0,11
16899,chādayi,chadayi,6,6,0,0,7
16900,para136,para136,198,198,0,0,7
16901,ete,ete,2624,2431,193,0,3
16902,cuṇṇetuṃ,cunnetum,2,2,0,0,8
16903,accharāyapi,accharayapi,1,1,0,0,11
16904,thāmaṃ,thamam,51,41,10,0,6
16905,pāṇaghāto,panaghato,3,3,0,0,9
16906,para137,para137,191,191,0,0,7
16907,gaṇḍuppādassa,ganduppadassa,1,1,0,0,13
16908,āyudhena,ayudhena,1,1,0,0,8
16909,pāpena,papena,109,101,8,0,6
16910,sallāpo,sallapo,24,13,11,0,7
16911,para138,para138,197,197,0,0,7
16912,bhāvāya,bhavaya,13,13,0,0,7
16913,kimatthaññena,kimatthannena,1,1,0,0,13
16914,sakkhinā,sakkhina,11,11,0,0,8
16915,kampitā,kampita,34,33,1,0,7
16916,maddiyā,maddiya,13,13,0,0,7
16917,dānā,dana,42,36,6,0,4
16918,mahī,mahi,107,104,3,0,4
16919,para139,para139,186,186,0,0,7
16920,dakkhiṇaṃ,dakkhinam,448,413,35,0,9
16921,bāhuṃ,bahum,66,59,7,0,5
16922,pathaviyā,pathaviya,313,299,14,0,9
16923,paṇamayi,panamayi,1,1,0,0,8
16924,kampittha,kampittha,55,55,0,0,9
16925,mahāghoso,mahaghoso,11,11,0,0,9
16926,ajāyatha,ajayatha,32,32,0,0,8
16927,para140,para140,208,208,0,0,7
16928,pathavīghosena,pathavighosena,1,1,0,0,14
16929,gajjanto,gajjanto,26,26,0,0,8
16930,asani,asani,43,41,2,0,5
16931,phali,phali,12,12,0,0,5
16932,sapariso,sapariso,100,99,1,0,8
16933,bhayatajjito,bhayatajjito,10,9,1,0,12
16934,para141,para141,192,192,0,0,7
16935,mahāvātasamuddhatabhasmaṃ,mahavatasamuddhatabhasmam,1,1,0,0,25
16936,vikiriyyatha,vikiriyyatha,1,1,0,0,12
16937,ajāyittha,ajayittha,1,1,0,0,9
16938,siddhatassa,siddhatassa,1,1,0,0,11
16939,abhisambodhidīpanīgāthā,abhisambodhidipanigatha,1,1,0,0,23
16940,para142,para142,188,188,0,0,7
16941,rajatacakkaṃ,rajatacakkam,2,2,0,0,12
16942,suriyo,suriyo,26,26,0,0,6
16943,pacchimenupagacchati,pacchimenupagacchati,1,1,0,0,20
16944,para143,para143,181,181,0,0,7
16945,bodhidumacchatte,bodhidumacchatte,1,1,0,0,16
16946,apparājite,apparajite,2,2,0,0,10
16947,pallaṅkena,pallankena,202,191,11,0,10
16948,sammasate,sammasate,2,2,0,0,9
16949,para144,para144,190,190,0,0,7
16950,abhidhāvati,abhidhavati,3,3,0,0,11
16951,tiyojanaṃ,tiyojanam,112,107,5,0,9
16952,munimuddhani,munimuddhani,1,1,0,0,12
16953,para145,para145,178,178,0,0,7
16954,maṇitālavaṇṭaṃ,manitalavantam,5,4,1,0,14
16955,tusīto,tusito,1,1,0,0,6
16956,suyāmo,suyamo,18,18,0,0,6
16957,vāḷabījaniṃ,valabijanim,10,10,0,0,11
16958,nānāmaṅgalabhaṇḍāni,nanamangalabhandani,1,1,0,0,19
16959,gahito,gahito,759,712,47,0,6
16960,sesadevatā,sesadevata,9,8,1,0,10
16961,para146,para146,184,184,0,0,7
16962,dasasahassamhi,dasasahassamhi,2,2,0,0,14
16963,saṅkhādīnī,sankhadini,1,1,0,0,10
16964,dhamantā,dhamanta,8,6,2,0,8
16965,cakkavāḷamhi,cakkavalamhi,5,5,0,0,12
16966,pūrayuṃ,purayum,7,6,1,0,7
16967,para147,para147,181,181,0,0,7
16968,maṇgalāni,mangalani,1,1,0,0,9
16969,dhajamāla,dhajamala,1,1,0,0,9
16970,puṇṇaghaṭādayo,punnaghatadayo,1,1,0,0,14
16971,para148,para148,190,190,0,0,7
16972,gāyanti,gayanti,64,63,1,0,7
16973,seḷenti,selenti,6,6,0,0,7
16974,vādayanti,vadayanti,31,25,6,0,9
16975,para149,para149,188,188,0,0,7
16976,dhammāmatarasassādaṃ,dhammamatarasassadam,2,2,0,0,20
16977,labhissāmassa,labhissamassa,1,1,0,0,13
16978,nayanāmatarasassādaṃ,nayanamatarasassadam,1,1,0,0,20
16979,passituṃ,passitum,293,287,6,0,8
16980,para150,para150,196,196,0,0,7
16981,jāramaraṇakantārā,jaramaranakantara,1,1,0,0,17
16982,sokopāyāsasallato,sokopayasasallato,1,1,0,0,17
16983,kāmapāsamhā,kamapasamha,1,1,0,0,11
16984,para151,para151,172,172,0,0,7
16985,tuṭṭhehi,tutthehi,2,2,0,0,8
16986,pūjiyanto,pujiyanto,1,1,0,0,9
16987,narāsabho,narasabho,146,142,4,0,9
16988,pūjaṃ,pujam,375,368,7,0,5
16989,acintento,acintento,5,5,0,0,9
16990,cintento,cintento,212,208,4,0,8
16991,dhammamuttamaṃ,dhammamuttamam,41,31,10,0,14
16992,para152,para152,169,169,0,0,7
16993,sabbatthasādhito,sabbatthasadhito,1,1,0,0,16
16994,apparājito,apparajito,1,1,0,0,10
16995,cakkavāḷasilāsāṇipākārehi,cakkavalasilasanipakarehi,1,1,0,0,25
16996,para153,para153,181,181,0,0,7
16997,tārāmaṇikhacitākāsavitāne,taramanikhacitakasavitane,1,1,0,0,25
16998,candadīpake,candadipake,1,1,0,0,11
16999,mānāratamapajjote,manaratamapajjote,1,1,0,0,17
17000,mālāgandhādipūjite,malagandhadipujite,1,1,0,0,18
17001,para154,para154,172,172,0,0,7
17002,chaṇabherīhi,chanabherihi,1,1,0,0,12
17003,ghuṭṭhe,ghutthe,8,8,0,0,7
17004,maṅgalagītiyā,mangalagitiya,1,1,0,0,13
17005,suppāsāde,suppasade,1,1,0,0,9
17006,bodhimaṇḍamahātale,bodhimandamahatale,1,1,0,0,18
17007,para155,para155,173,173,0,0,7
17008,bodhirukkhamaṇicchatte,bodhirukkhamanicchatte,1,1,0,0,22
17009,nissinno,nissinno,1,1,0,0,8
17010,yāme,yame,147,146,1,0,4
17011,purimaṃ,purimam,545,485,60,0,7
17012,jātimanussari,jatimanussari,1,1,0,0,13
17013,para156,para156,187,187,0,0,7
17014,namarūpāmanuppatti,namarupamanuppatti,1,1,0,0,18
17015,sudiṭṭhā,sudittha,45,43,2,0,8
17016,tenidhā,tenidha,1,1,0,0,7
17017,sakkātadiṭṭhi,sakkataditthi,1,1,0,0,13
17018,para157,para157,172,172,0,0,7
17019,dutiye,dutiye,1033,1006,27,0,6
17020,yathāyammupage,yathayammupage,1,1,0,0,14
17021,sari,sari,24,23,1,0,4
17022,sudiṭṭhaṃ,sudittham,69,64,5,0,9
17023,kammakklesehi,kammakklesehi,1,1,0,0,13
17024,para158,para158,170,170,0,0,7
17025,kaṅkhāvitaraṇī,kankhavitarani,7,3,4,0,14
17026,ñāṇantaṃ,nanantam,1,1,0,0,8
17027,samupāgataṃ,samupagatam,11,10,1,0,11
17028,tenasesa,tenasesa,1,1,0,0,8
17029,pahīyittha,pahiyittha,2,2,0,0,10
17030,soḷasadhā,solasadha,21,21,0,0,9
17031,para159,para159,169,169,0,0,7
17032,dvādasaṅge,dvadasange,3,3,0,0,10
17033,paṭiccasamuppāde,paticcasamuppade,38,36,2,0,16
17034,ñāṇamotārayī,nanamotarayi,1,1,0,0,12
17035,para160,para160,172,172,0,0,7
17036,avijjavādyānulomena,avijjavadyanulomena,1,1,0,0,19
17037,jarādipaṭilomato,jaradipatilomato,1,1,0,0,16
17038,sammasanto,sammasanto,134,127,7,0,10
17039,ñāṇadassanamāgami,nanadassanamagami,1,1,0,0,17
17040,para161,para161,172,172,0,0,7
17041,kappakoṭisatenāpi,kappakotisatenapi,1,1,0,0,17
17042,appameyyesu,appameyyesu,2,2,0,0,11
17043,lobhaṃ,lobham,177,165,12,0,6
17044,asesadānena,asesadanena,1,1,0,0,11
17045,vināsento,vinasento,16,15,1,0,9
17046,para162,para162,170,170,0,0,7
17047,khantimettāya,khantimettaya,1,1,0,0,13
17048,kokhadosaṃ,kokhadosam,1,1,0,0,10
17049,nivāresi,nivaresi,57,55,2,0,8
17050,mohaṃ,moham,339,327,12,0,5
17051,micchādiṭṭhi,micchaditthi,554,517,37,0,12
17052,para163,para163,169,169,0,0,7
17053,garūpasevanādīhi,garupasevanadihi,1,1,0,0,16
17054,vicikicchaṃ,vicikiccham,158,153,5,0,11
17055,vinodayaṃ,vinodayam,5,4,1,0,9
17056,mānuddhaccaṃ,manuddhaccam,1,1,0,0,12
17057,vinodento,vinodento,21,20,1,0,9
17058,jeṭṭhopacāyinā,jetthopacayina,1,1,0,0,14
17059,para164,para164,170,170,0,0,7
17060,nekkhammena,nekkhammena,83,73,10,0,11
17061,kāmarāgaṃ,kamaragam,75,70,5,0,9
17062,saccena,saccena,202,183,19,0,7
17063,visaṃvādaṃ,visamvadam,1,1,0,0,10
17064,kosajjaṃ,kosajjam,117,98,19,0,8
17065,para165,para165,174,174,0,0,7
17066,kilesaṇgaṃ,kilesangam,1,1,0,0,10
17067,suvaḍḍhitā,suvaddhita,10,6,4,0,10
17068,mahāpaññā,mahapanna,135,125,10,0,9
17069,rūhati,ruhati,49,47,2,0,6
17070,para166,para166,166,166,0,0,7
17071,sudukkaraṃ,sudukkaram,33,31,2,0,10
17072,karitvāna,karitvana,175,172,3,0,9
17073,dānādipaccayaṃ,danadipaccayam,1,1,0,0,14
17074,bhavasampattiṃ,bhavasampattim,3,3,0,0,14
17075,patthesi,patthesi,98,97,1,0,8
17076,bodhimuttamaṃ,bodhimuttamam,45,44,1,0,13
17077,para167,para167,169,169,0,0,7
17078,paṇidhānamhā,panidhanamha,1,1,0,0,12
17079,puññañca,punnanca,45,45,0,0,8
17080,ekkattha,ekkattha,1,1,0,0,8
17081,sampattiṃ,sampattim,477,469,8,0,9
17082,asaṃsayaṃ,asamsayam,41,39,2,0,9
17083,para168,para168,168,168,0,0,7
17084,sabbasaṅkhāre,sabbasankhare,33,31,2,0,13
17085,aniccadukkhanattato,aniccadukkhanattato,1,1,0,0,19
17086,sammasantonulomena,sammasantonulomena,1,1,0,0,18
17087,samupāgami,samupagami,9,9,0,0,10
17088,para169,para169,163,163,0,0,7
17089,savāsane,savasane,7,7,0,0,8
17090,jhāpentonumattaṃ,jhapentonumattam,1,1,0,0,16
17091,arahattappattiyā,arahattappattiya,51,50,1,0,16
17092,ahu,ahu,1016,962,54,0,3
17093,para170,para170,158,158,0,0,7
17094,vimettiṃ,vimettim,1,1,0,0,8
17095,varasetachattaṃ,varasetachattam,1,1,0,0,15
17096,pītivegena,pitivegena,19,19,0,0,10
17097,udānudīrayi,udanudirayi,1,1,0,0,11
17098,vijitārisaṅgho,vijitarisangho,2,2,0,0,14
17099,tibuddhakhettekadivākaro,tibuddhakhettekadivakaro,1,1,0,0,24
17100,para171,para171,155,155,0,0,7
17101,rājādhirājā,rajadhiraja,11,11,0,0,11
17102,varamevamāsi,varamevamasi,1,1,0,0,12
17103,tichattadhāri,tichattadhari,1,1,0,0,13
17104,varadhammarājā,varadhammaraja,2,2,0,0,14
17105,mahāsahassaṃ,mahasahassam,1,1,0,0,12
17106,viññāpayituṃ,vinnapayitum,1,1,0,0,12
17107,para172,para172,161,161,0,0,7
17108,lokāloke,lokaloke,1,1,0,0,8
17109,konummatto,konummatto,1,1,0,0,10
17110,oghā,ogha,115,97,18,0,4
17111,para173,para173,161,161,0,0,7
17112,bhajitaṃ,bhajitam,5,5,0,0,8
17113,cajitaṃ,cajitam,1,1,0,0,7
17114,pavanaṃ,pavanam,62,45,17,0,7
17115,gahitaṃ,gahitam,1078,1008,70,0,7
17116,samalaṃ,samalam,17,14,3,0,7
17117,agatiṃ,agatim,63,52,11,0,6
17118,namitaṃ,namitam,7,7,0,0,7
17119,namatiṃ,namatim,1,1,0,0,7
17120,sumatiṃ,sumatim,1,1,0,0,7
17121,dhammacakkapavattanadīpanīgāthā,dhammacakkapavattanadipanigatha,1,1,0,0,31
17122,para174,para174,164,164,0,0,7
17123,sammāsambodhiñānaṃ,sammasambodhinanam,1,1,0,0,18
17124,hatasakalamalaṃ,hatasakalamalam,1,1,0,0,15
17125,suddhato,suddhato,1,1,0,0,8
17126,cātisuddhaṃ,catisuddham,1,1,0,0,11
17127,addhā,addha,903,817,86,0,5
17128,suladdhaṃ,suladdham,147,137,10,0,9
17129,vatamiti,vatamiti,1,1,0,0,8
17130,cintayanto,cintayanto,39,36,3,0,10
17131,sattāhaṃ,sattaham,925,882,43,0,8
17132,sattamevaṃ,sattamevam,1,1,0,0,10
17133,vividhaphalasukhaṃ,vividhaphalasukham,1,1,0,0,18
17134,vitināmesi,vitinamesi,1,1,0,0,10
17135,brahmenāyācito,brahmenayacito,1,1,0,0,14
17136,isipatanavane,isipatanavane,1,1,0,0,13
17137,vattayī,vattayi,3,3,0,0,7
17138,pāṭihāriyadīpanīgāthā,patihariyadipanigatha,1,1,0,0,21
17139,para175,para175,158,158,0,0,7
17140,brahmassa,brahmassa,25,25,0,0,9
17141,karavīkabhāṇiṃ,karavikabhanim,1,1,0,0,14
17142,yathicchitaṃ,yathicchitam,41,40,1,0,12
17143,sāvayituṃ,savayitum,1,1,0,0,9
17144,bhūtahitaṃ,bhutahitam,1,1,0,0,10
17145,vadantaṃ,vadantam,32,32,0,0,8
17146,pūjaye,pujaye,17,17,0,0,6
17147,para176,para176,165,165,0,0,7
17148,ādesanānusāsanī,adesananusasani,3,3,0,0,15
17149,pāṭihīre,patihire,5,5,0,0,8
17150,vasī,vasi,264,253,11,0,4
17151,accherasupāṭihīraṃ,accherasupatihiram,1,1,0,0,18
17152,anukampimaṃ,anukampimam,3,3,0,0,11
17153,navaguṇadīpanīgāthā,navagunadipanigatha,1,1,0,0,19
17154,para177,para177,159,159,0,0,7
17155,buddhattamupāgato,buddhattamupagato,1,1,0,0,17
17156,sanarāmarānaṃ,sanaramaranam,4,4,0,0,13
17157,nānānayehībhisamesi,nananayehibhisamesi,1,1,0,0,19
17158,jhāto,jhato,1,1,0,0,5
17159,tibhavesu,tibhavesu,6,6,0,0,9
17160,para178,para178,159,159,0,0,7
17161,diṭṭhā,dittha,304,277,27,0,6
17162,pattā,patta,559,547,12,0,5
17163,tiññārāgādosamohā,tinnaragadosamoha,1,1,0,0,17
17164,thomesuṃ,thomesum,1,1,0,0,8
17165,para179,para179,160,160,0,0,7
17166,munirājavaro,munirajavaro,2,2,0,0,12
17167,nararājavaro,nararajavaro,1,1,0,0,12
17168,dividevavaro,dividevavaro,1,1,0,0,12
17169,sucibrahmavaro,sucibrahmavaro,1,1,0,0,14
17170,sakapāpaharo,sakapapaharo,1,1,0,0,12
17171,parapāpaharo,parapapaharo,1,1,0,0,12
17172,sakavuḍḍhikaro,sakavuddhikaro,1,1,0,0,14
17173,paravuḍḍhikaro,paravuddhikaro,1,1,0,0,14
17174,para180,para180,152,152,0,0,7
17175,sanarāmarubrahmagaṇebhi,sanaramarubrahmaganebhi,1,1,0,0,23
17176,rutā,ruta,3,2,1,0,4
17177,arahādiguṇā,arahadiguna,1,1,0,0,11
17178,vipulā,vipula,98,90,8,0,6
17179,vimalā,vimala,36,33,3,0,6
17180,navadhā,navadha,84,76,8,0,7
17181,vasudhāgagaṇe,vasudhagagane,1,1,0,0,13
17182,tidive,tidive,23,19,4,0,6
17183,visaṭā,visata,26,22,4,0,6
17184,para181,para181,169,169,0,0,7
17185,pissa,pissa,11,11,0,0,5
17186,acintiyādī,acintiyadi,1,1,0,0,10
17187,suddhātisuddhatarabuddhaguṇā,suddhatisuddhatarabuddhaguna,1,1,0,0,28
17188,saṅkhepato,sankhepato,681,654,27,0,10
17189,navavidhesu,navavidhesu,2,2,0,0,11
17190,khittā,khitta,67,65,2,0,6
17191,vakkhāmi,vakkhami,223,213,10,0,8
17192,arahādiguṇe,arahadigune,2,2,0,0,11
17193,para182,para182,149,149,0,0,7
17194,cīdha,cidha,10,10,0,0,5
17195,sammābhisambuddhasamantacakkhu,sammabhisambuddhasamantacakkhu,1,1,0,0,30
17196,sampannavijjācaraṇoghatiṇṇo,sampannavijjacaranoghatinno,1,1,0,0,27
17197,sammāgato,sammagato,1,1,0,0,9
17198,para183,para183,154,154,0,0,7
17199,avedi,avedi,49,39,10,0,5
17200,amuttaro,amuttaro,1,1,0,0,8
17201,sārathidammasatte,sarathidammasatte,1,1,0,0,17
17202,sadevakānaṃ,sadevakanam,1,1,0,0,11
17203,varasatthukiccaṃ,varasatthukiccam,1,1,0,0,16
17204,guṇadīpanīgāthā,gunadipanigatha,1,1,0,0,15
17205,para184,para184,159,159,0,0,7
17206,adiṭṭhanamidhatthi,aditthanamidhatthi,1,1,0,0,18
17207,ato,ato,171,152,19,0,3
17208,para185,para185,152,152,0,0,7
17209,mahitamanantākittisambhārasāraṃ,mahitamanantakittisambharasaram,1,1,0,0,31
17210,sakaladasasahassīlokadhātumhi,sakaladasasahassilokadhatumhi,1,1,0,0,29
17211,upacitasubhahetupayutānantakālaṃ,upacitasubhahetupayutanantakalam,1,1,0,0,32
17212,tadiha,tadiha,5,5,0,0,6
17213,sugatabodhisādhukaṃ,sugatabodhisadhukam,1,1,0,0,19
17214,cintanīyaṃ,cintaniyam,4,4,0,0,10
17215,para186,para186,147,147,0,0,7
17216,takkabyākaraṇañca,takkabyakarananca,1,1,0,0,17
17217,dhammavinayaṃ,dhammavinayam,165,161,4,0,13
17218,paññavā,pannava,424,410,14,0,7
17219,tenāyaṃ,tenayam,70,70,0,0,7
17220,sucisārabhūtavacanaṃ,sucisarabhutavacanam,1,1,0,0,20
17221,viññāyate,vinnayate,30,30,0,0,9
17222,hetuñcāpi,hetuncapi,1,1,0,0,9
17223,saphalaṃ,saphalam,76,73,3,0,8
17224,sampassamāno,sampassamano,170,169,1,0,12
17225,saddahateva,saddahateva,1,1,0,0,11
17226,mahatāvāyamato,mahatavayamato,1,1,0,0,14
17227,para187,para187,148,148,0,0,7
17228,saddahanto,saddahanto,64,57,7,0,10
17229,vuttānusārena,vuttanusarena,62,60,2,0,13
17230,guṇerahādī,gunerahadi,1,1,0,0,10
17231,katheti,katheti,684,656,28,0,7
17232,muhuttaṃ,muhuttam,309,291,18,0,8
17233,para188,para188,144,144,0,0,7
17234,saddheyyā,saddheyya,9,9,0,0,9
17235,cinteyyā,cinteyya,2,2,0,0,8
17236,vandeyyā,vandeyya,2,2,0,0,8
17237,pūjeyyāte,pujeyyate,1,1,0,0,9
17238,buddholokāloke,buddholokaloke,1,1,0,0,14
17239,patthentena,patthentena,12,12,0,0,11
17240,pūjānidhānadīpanīgāthā,pujanidhanadipanigatha,1,1,0,0,22
17241,para189,para189,155,155,0,0,7
17242,tasamā,tasama,1,1,0,0,6
17243,jātovarakamhi,jatovarakamhi,1,1,0,0,13
17244,āyattake,ayattake,1,1,0,0,8
17245,maṅgalacakkavāḷe,mangalacakkavale,1,1,0,0,16
17246,bhūtehi,bhutehi,23,23,0,0,7
17247,manoramehi,manoramehi,4,4,0,0,10
17248,pūjitpūjitaṃ,pujitpujitam,1,1,0,0,12
17249,para190,para190,156,156,0,0,7
17250,panetasmiṃ,panetasmim,14,14,0,0,10
17251,pupphite,pupphite,20,20,0,0,8
17252,thalaje,thalaje,1,1,0,0,7
17253,jalaje,jalaje,1,1,0,0,6
17254,vāpi,vapi,854,756,98,0,4
17255,sugandhe,sugandhe,4,4,0,0,8
17256,agandhake,agandhake,1,1,0,0,9
17257,para191,para191,156,156,0,0,7
17258,manussesu,manussesu,719,713,6,0,9
17259,anekattha,anekattha,4,3,1,0,9
17260,taḷākuyyānavāpisu,talakuyyanavapisu,1,1,0,0,17
17261,himavantasmiṃ,himavantasmim,6,6,0,0,13
17262,para192,para192,147,147,0,0,7
17263,parittadīpe,parittadipe,1,1,0,0,11
17264,mahādīpe,mahadipe,9,9,0,0,8
17265,supupphite,supupphite,10,10,0,0,10
17266,sattaparibhaṇḍaselesu,sattaparibhandaselesu,1,1,0,0,21
17267,sinerupabbatuttame,sinerupabbatuttame,3,3,0,0,18
17268,para193,para193,154,154,0,0,7
17269,kumuduppalakādīni,kumuduppalakadini,1,1,0,0,17
17270,bhavanesupi,bhavanesupi,1,1,0,0,11
17271,pāṭalādīni,pataladini,1,1,0,0,10
17272,asurānaṃ,asuranam,56,55,1,0,8
17273,ālaye,alaye,26,23,3,0,5
17274,para194,para194,145,145,0,0,7
17275,koviḷārādikāni,kovilaradikani,1,1,0,0,14
17276,evamādī,evamadi,3,3,0,0,7
17277,dharaṇīruhe,dharaniruhe,7,7,0,0,11
17278,para195,para195,146,146,0,0,7
17279,campakā,campaka,10,10,0,0,7
17280,salalā,salala,1,1,0,0,6
17281,nimbā,nimba,10,10,0,0,5
17282,nāgapunnāgaketakā,nagapunnagaketaka,4,4,0,0,17
17283,vassikā,vassika,25,18,7,0,7
17284,mallikā,mallika,79,73,6,0,7
17285,sālā,sala,123,120,3,0,4
17286,koviḷārā,kovilara,9,9,0,0,8
17287,pāṭali,patali,11,10,1,0,6
17288,para196,para196,148,148,0,0,7
17289,indīvarā,indivara,4,3,1,0,8
17290,asokā,asoka,27,27,0,0,5
17291,kaṇikārā,kanikara,13,13,0,0,8
17292,makulā,makula,1,1,0,0,6
17293,padumā,paduma,53,52,1,0,6
17294,puṇḍarikā,pundarika,2,2,0,0,9
17295,sogandhikumuduppalā,sogandhikumuduppala,1,1,0,0,19
17296,para197,para197,144,144,0,0,7
17297,caññe,canne,182,175,7,0,5
17298,rukkhā,rukkha,334,322,12,0,6
17299,valliyo,valliyo,21,17,4,0,7
17300,pupphitā,pupphita,122,118,4,0,8
17301,sugandhā,sugandha,13,13,0,0,8
17302,sukhasamphassā,sukhasamphassa,9,9,0,0,14
17303,nānāvaṇṇanibhā,nanavannanibha,1,1,0,0,14
17304,para198,para198,136,136,0,0,7
17305,victrā,victra,1,1,0,0,6
17306,nīlānekāni,nilanekani,4,3,1,0,10
17307,setā,seta,75,69,6,0,4
17308,mañjaṭṭha,manjattha,1,1,0,0,9
17309,nekavaṇṇā,nekavanna,2,2,0,0,9
17310,para199,para199,142,142,0,0,7
17311,sobhate,sobhate,48,46,2,0,7
17312,sarehi,sarehi,23,22,1,0,6
17313,vanarājihi,vanarajihi,1,1,0,0,10
17314,sandamānāhi,sandamanahi,1,1,0,0,11
17315,gaṅgāhi,gangahi,1,1,0,0,7
17316,ratanākaro,ratanakaro,9,9,0,0,10
17317,para200,para200,139,139,0,0,7
17318,pattakiñjakkhareṇūhi,pattakinjakkharenuhi,1,1,0,0,20
17319,okiṇṇaṃ,okinnam,9,9,0,0,7
17320,bhamarā,bhamara,15,15,0,0,7
17321,pupphgandhehi,pupphgandhehi,1,1,0,0,13
17322,abhināditā,abhinadita,3,3,0,0,10
17323,para201,para201,140,140,0,0,7
17324,athetta,athetta,1,1,0,0,7
17325,sakuṇā,sakuna,120,120,0,0,6
17326,santi,santi,1512,1419,93,0,5
17327,dijā,dija,57,53,4,0,4
17328,mañjussarā,manjussara,8,8,0,0,10
17329,kūjantamupakūjanti,kujantamupakujanti,7,7,0,0,18
17330,utusampupphite,utusampupphite,5,5,0,0,14
17331,dume,dume,27,25,2,0,4
17332,para202,para202,135,135,0,0,7
17333,niccharānaṃ,niccharanam,2,2,0,0,11
17334,nipātena,nipatena,13,13,0,0,8
17335,pabbatā,pabbata,159,159,0,0,7
17336,pañcaṅgikāni,pancangikani,4,4,0,0,12
17337,tūriyāni,turiyani,51,50,1,0,8
17338,dibbāni,dibbani,98,93,5,0,7
17339,suyyare,suyyare,6,6,0,0,7
17340,para203,para203,140,140,0,0,7
17341,jalantaggisikhūpamā,jalantaggisikhupama,1,1,0,0,19
17342,kinnarā,kinnara,23,23,0,0,7
17343,padīpena,padipena,10,9,1,0,8
17344,karīyati,kariyati,226,217,9,0,8
17345,para205,para205,140,140,0,0,7
17346,muttājālāva,muttajalava,1,1,0,0,11
17347,pātakā,pataka,1,1,0,0,6
17348,maṇiveḷuriyādayo,maniveluriyadayo,1,1,0,0,16
17349,para206,para206,135,135,0,0,7
17350,kāḷānusāri,kalanusari,1,1,0,0,10
17351,taggaraṃ,taggaram,1,1,0,0,8
17352,kappūraṃ,kappuram,10,10,0,0,8
17353,sakuṇānaṃ,sakunanam,37,32,5,0,9
17354,mayūrānaṃ,mayuranam,2,2,0,0,9
17355,kekayā,kekaya,1,1,0,0,6
17356,para207,para207,141,141,0,0,7
17357,bhamarānaṃ,bhamaranam,3,3,0,0,10
17358,ninnādā,ninnada,1,1,0,0,7
17359,koñcanādena,koncanadena,2,2,0,0,11
17360,hatthinaṃ,hatthinam,14,11,3,0,9
17361,vijambhitena,vijambhitena,1,1,0,0,12
17362,vāḷānaṃ,valanam,16,14,2,0,7
17363,kinnarānaṃ,kinnaranam,12,12,0,0,10
17364,gītiyā,gitiya,1,1,0,0,6
17365,para208,para208,133,133,0,0,7
17366,pabbatānaṃ,pabbatanam,51,44,7,0,10
17367,obhāsā,obhasa,6,6,0,0,6
17368,maṇīnaṃ,maninam,9,8,1,0,7
17369,jotiyāpi,jotiyapi,1,1,0,0,8
17370,vicitrabbhavitānehi,vicitrabbhavitanehi,1,1,0,0,19
17371,dumānaṃ,dumanam,2,2,0,0,7
17372,pupphadhūpiyā,pupphadhupiya,1,1,0,0,13
17373,sabbaṅgasampannaṃ,sabbangasampannam,22,18,4,0,17
17374,nandanaṃ,nandanam,84,75,9,0,8
17375,para209,para209,146,146,0,0,7
17376,susamphullavanaṃ,susamphullavanam,1,1,0,0,16
17377,pupphitapupphitaṃ,pupphitapupphitam,1,1,0,0,17
17378,mālaṃ,malam,151,137,14,0,5
17379,susaddañca,susaddanca,1,1,0,0,10
17380,manuññagandhaṃ,manunnagandham,1,1,0,0,14
17381,pūjitapūjitaṃ,pujitapujitam,1,1,0,0,13
17382,purā,pura,164,134,30,0,4
17383,para210,para210,134,134,0,0,7
17384,nāgaloke,nagaloke,4,4,0,0,8
17385,sāmuddikaṃ,samuddikam,10,8,2,0,10
17386,bhūmigataṃ,bhumigatam,12,11,1,0,10
17387,ākāsaṭṭhañca,akasatthanca,1,1,0,0,12
17388,dhamaṃ,dhamam,7,6,1,0,6
17389,para211,para211,135,135,0,0,7
17390,jātarūpañca,jatarupanca,19,18,1,0,11
17391,veḷuriyā,veluriya,27,25,2,0,8
17392,masāragallaṃ,masaragallam,45,32,13,0,12
17393,phalikaṃ,phalikam,3,3,0,0,8
17394,lohitaṅgaṃ,lohitangam,2,1,1,0,10
17395,para212,para212,140,140,0,0,7
17396,anantakappesu,anantakappesu,1,1,0,0,13
17397,bodhesi,bodhesi,26,26,0,0,7
17398,para213,para213,139,139,0,0,7
17399,khomaṃ,khomam,60,42,18,0,6
17400,koseyyaṃ,koseyyam,63,47,16,0,8
17401,kappāsaṃ,kappasam,16,15,1,0,8
17402,sāṇaṃ,sanam,40,28,12,0,5
17403,bhaṅgañca,bhanganca,13,11,2,0,9
17404,kambalaṃ,kambalam,111,96,15,0,8
17405,dukūlāni,dukulani,1,1,0,0,8
17406,dussāni,dussani,36,36,0,0,7
17407,vividhāni,vividhani,65,64,1,0,9
17408,para214,para214,134,134,0,0,7
17409,anantavatthadānena,anantavatthadanena,1,1,0,0,18
17410,hirottappādisaṃvaraṃ,hirottappadisamvaram,1,1,0,0,20
17411,pujayāmahaṃ,pujayamaham,2,2,0,0,11
17412,para215,para215,144,144,0,0,7
17413,jātarukkhānaṃ,jatarukkhanam,1,1,0,0,13
17414,nānāphalarasuttamaṃ,nanaphalarasuttamam,1,1,0,0,19
17415,ambā,amba,61,58,3,0,4
17416,kapiṭṭhā,kapittha,4,4,0,0,8
17417,pansā,pansa,1,1,0,0,5
17418,cocamocādinappakā,cocamocadinappaka,1,1,0,0,17
17419,para216,para216,137,137,0,0,7
17420,gandharasaṃ,gandharasam,1,1,0,0,11
17421,ojaṃ,ojam,54,50,4,0,4
17422,buddhaseṭṭhassa,buddhasetthassa,109,101,8,0,15
17423,para217,para217,131,131,0,0,7
17424,acintiyaṃ,acintiyam,8,8,0,0,9
17425,vijjamānehi,vijjamanehi,10,9,1,0,11
17426,vatthuhi,vatthuhi,2,2,0,0,8
17427,para218,para218,132,132,0,0,7
17428,pāramīnantu,paraminantu,1,1,0,0,11
17429,pūritaṭṭhānamuttamaṃ,puritatthanamuttamam,1,1,0,0,20
17430,sālavane,salavane,58,58,0,0,8
17431,jātaṭṭhānaṃ,jatatthanam,8,8,0,0,11
17432,carimakaṃ,carimakam,2,2,0,0,9
17433,para219,para219,134,134,0,0,7
17434,chabbasāni,chabbasani,2,2,0,0,10
17435,padhānasmiṃ,padhanasmim,23,17,6,0,11
17436,karaṇaṃ,karanam,547,500,47,0,7
17437,apparājitapallaṅkaṃ,apparajitapallankam,2,2,0,0,19
17438,para220,para220,141,141,0,0,7
17439,cuddasa,cuddasa,375,346,29,0,7
17440,buddhañāṇāni,buddhananani,25,23,2,0,12
17441,aṭṭharsa,attharsa,1,1,0,0,8
17442,āveṇikaṃ,avenikam,57,53,4,0,8
17443,catuvesārajjamuttamaṃ,catuvesarajjamuttamam,1,1,0,0,21
17444,para221,para221,130,130,0,0,7
17445,āsayānusayañāṇaṃ,asayanusayananam,15,15,0,0,16
17446,paroparaṃ,paroparam,14,9,5,0,9
17447,yamakapāṭihīrañca,yamakapatihiranca,1,1,0,0,17
17448,para222,para222,134,134,0,0,7
17449,mahākaruṇāpattiñāṇaṃ,mahakarunapattinanam,1,1,0,0,20
17450,anāvaraṇmiti,anavaranmiti,1,1,0,0,12
17451,asādhāraṇānete,asadharananete,1,1,0,0,14
17452,pūjayāmahaṃ,pujayamaham,8,8,0,0,11
17453,para223,para223,131,131,0,0,7
17454,sattasattāhe,sattasattahe,2,2,0,0,12
17455,dhammasammasitaṃ,dhammasammasitam,1,1,0,0,16
17456,yācitaṭṭhānaṃ,yacitatthanam,1,1,0,0,13
17457,desayituṃ,desayitum,1,1,0,0,9
17458,para224,para224,128,128,0,0,7
17459,dhammacakkapavattanaṃ,dhammacakkapavattanam,3,3,0,0,21
17460,veḷuvanārāme,veluvanarame,2,2,0,0,12
17461,vasitaṭhānañca,vasitathananca,1,1,0,0,14
17462,para225,para225,129,129,0,0,7
17463,jetavanaṃ,jetavanam,310,301,9,0,9
17464,ciravutthaṃ,ciravuttham,1,1,0,0,11
17465,mahesinā,mahesina,189,179,10,0,8
17466,asādhāraṇamaññesaṃ,asadharanamannesam,8,6,2,0,18
17467,yamakapāṭihariyaṃ,yamakapatihariyam,1,1,0,0,17
17468,para226,para226,132,132,0,0,7
17469,pāricchattakamūlamhi,paricchattakamulamhi,6,6,0,0,20
17470,abhidhammañca,abhidhammanca,4,4,0,0,13
17471,desanaṃ,desanam,709,655,54,0,7
17472,saṅkassanagaradvāre,sankassanagaradvare,20,20,0,0,19
17473,devorohaṇakaṃ,devorohanakam,1,1,0,0,13
17474,para227,para227,129,129,0,0,7
17475,mahāsamayadesanaṃ,mahasamayadesanam,1,1,0,0,17
17476,vuttānetāni,vuttanetani,4,4,0,0,11
17477,ṭhānāni,thanani,437,411,26,0,7
17478,natvāna,natvana,14,14,0,0,7
17479,para228,para228,143,143,0,0,7
17480,caturāsītisahassehi,caturasitisahassehi,8,7,1,0,19
17481,dhammakkhandhehi,dhammakkhandhehi,14,14,0,0,16
17482,saṅgahaṃ,sangaham,692,659,33,0,8
17483,yathāvuttavidhinā,yathavuttavidhina,5,5,0,0,17
17484,para229,para229,135,135,0,0,7
17485,āyusaṅkhārosajjanaṃ,ayusankharosajjanam,1,1,0,0,19
17486,kusinārāya,kusinaraya,21,20,1,0,10
17487,mallānaṃ,mallanam,96,87,9,0,8
17488,yamakasālamantare,yamakasalamantare,1,1,0,0,17
17489,para230,para230,130,130,0,0,7
17490,paṇidhānamhi,panidhanamhi,1,1,0,0,12
17491,niṭṭhapetvāna,nitthapetvana,1,1,0,0,13
17492,parinibbāyināsavo,parinibbayinasavo,1,1,0,0,17
17493,para231,para231,135,135,0,0,7
17494,nibbāyamānassa,nibbayamanassa,2,2,0,0,14
17495,katakiccassa,katakiccassa,8,8,0,0,12
17496,ciragatā,ciragata,1,1,0,0,8
17497,nibbāyittha,nibbayittha,1,1,0,0,11
17498,kiñcipi,kincipi,148,135,13,0,7
17499,para232,para232,131,131,0,0,7
17500,svāyaṃ,svayam,434,404,30,0,6
17501,vinayo,vinayo,609,539,70,0,6
17502,desito,desito,439,428,11,0,6
17503,sādhukaṃ,sadhukam,765,721,44,0,8
17504,mamaccayena,mamaccayena,84,83,1,0,11
17505,sarīrajā,sariraja,1,1,0,0,8
17506,para233,para233,136,136,0,0,7
17507,bodhirukkhañca,bodhirukkhanca,8,8,0,0,14
17508,satthāti,satthati,60,36,24,0,8
17509,anujāni,anujani,73,73,0,0,7
17510,mahāmuni,mahamuni,293,286,7,0,8
17511,para234,para234,137,137,0,0,7
17512,ṭhane,thane,2,2,0,0,5
17513,ṭhapetvāna,thapetvana,70,68,2,0,10
17514,dhātubodhiñca,dhatubodhinca,1,1,0,0,13
17515,sādhanatthaṃ,sadhanattham,20,20,0,0,12
17516,para235,para235,136,136,0,0,7
17517,saddhammaṃ,saddhammam,308,286,22,0,10
17518,uggaṇhitvā,ugganhitva,232,230,2,0,10
17519,yathātathaṃ,yathatatham,91,79,12,0,11
17520,deseti,deseti,1063,1028,35,0,6
17521,para236,para236,127,127,0,0,7
17522,sāsapamattaṃ,sasapamattam,7,6,1,0,12
17523,jinadhātuṃ,jinadhatum,4,4,0,0,10
17524,asesiya,asesiya,1,1,0,0,7
17525,vitthinnacakkavāḷamhi,vitthinnacakkavalamhi,1,1,0,0,21
17526,para237,para237,135,135,0,0,7
17527,paramparābhatānaṃ,paramparabhatanam,1,1,0,0,17
17528,boddhirukkhato,boddhirukkhato,1,1,0,0,14
17529,bodhirukkhānaṃ,bodhirukkhanam,1,1,0,0,14
17530,para238,para238,129,129,0,0,7
17531,paribhuñji,paribhunji,146,146,0,0,10
17532,pattacīvaramādikaṃ,pattacivaramadikam,1,1,0,0,18
17533,paribhogadhātuṃ,paribhogadhatum,2,2,0,0,15
17534,para239,para239,128,128,0,0,7
17535,sayito,sayito,43,42,1,0,6
17536,āsinno,asinno,1,1,0,0,6
17537,caṅkamepi,cankamepi,1,1,0,0,9
17538,pādalañchankaṃ,padalanchankam,1,1,0,0,14
17539,para240,para240,122,122,0,0,7
17540,sañjānanti,sanjananti,100,98,2,0,10
17541,evarūpoti,evarupoti,15,5,10,0,9
17542,ñātve,natve,1,1,0,0,5
17543,para241,para241,131,131,0,0,7
17544,buddhañca,buddhanca,47,46,1,0,9
17545,saṇghañca,sanghanca,1,1,0,0,9
17546,patthanādīpanīgāthā,patthanadipanigatha,1,1,0,0,19
17547,para242,para242,128,128,0,0,7
17548,pubbepi,pubbepi,519,514,5,0,7
17549,puññehi,punnehi,26,26,0,0,7
17550,katehi,katehi,16,15,1,0,6
17551,pūjāvidhānehi,pujavidhanehi,5,5,0,0,13
17552,saññamehi,sannamehi,1,1,0,0,9
17553,pemaniyo,pemaniyo,2,2,0,0,8
17554,para243,para243,140,140,0,0,7
17555,hirottappabahussutattaṃ,hirottappabahussutattam,1,1,0,0,23
17556,parakkamo,parakkamo,65,57,8,0,9
17557,satissamādhi,satissamadhi,1,1,0,0,12
17558,nibbedhabhāgī,nibbedhabhagi,1,1,0,0,13
17559,vajirūpamāti,vajirupamati,1,1,0,0,12
17560,para244,para244,128,128,0,0,7
17561,rāgañca,raganca,45,36,9,0,7
17562,dosañca,dosanca,136,130,6,0,7
17563,diṭṭhiñca,ditthinca,35,22,13,0,9
17564,mānaṃ,manam,607,559,48,0,5
17565,vicikicchitañca,vicikicchitanca,10,8,2,0,15
17566,macchereissāmalavippahīno,macchereissamalavippahino,1,1,0,0,25
17567,anuddhato,anuddhato,80,76,4,0,9
17568,accapalo,accapalo,1,1,0,0,8
17569,para245,para245,127,127,0,0,7
17570,bhaveyyahaṃ,bhaveyyaham,2,2,0,0,11
17571,nappaseyho,nappaseyho,1,1,0,0,10
17572,dinnehi,dinnehi,7,7,0,0,7
17573,paṭehi,patehi,1,1,0,0,6
17574,mamesa,mamesa,7,7,0,0,6
17575,laddho,laddho,340,333,7,0,6
17576,parūpakārāya,parupakaraya,1,1,0,0,12
17577,para246,para246,128,128,0,0,7
17578,dhammenā,dhammena,16,12,4,0,8
17579,mālāpitaro,malapitaro,1,1,0,0,10
17580,bhareyyaṃ,bhareyyam,4,4,0,0,9
17581,vuḍḍhapacāyī,vuddhapacayi,1,1,0,0,12
17582,bahūpakārī,bahupakari,3,3,0,0,10
17583,ñātīsu,natisu,33,28,5,0,6
17584,mittesu,mittesu,31,30,1,0,7
17585,sapattakesu,sapattakesu,1,1,0,0,11
17586,hitamattano,hitamattano,10,10,0,0,11
17587,para247,para247,126,126,0,0,7
17588,metteyyanāthaṃ,metteyyanatham,1,1,0,0,14
17589,tassattabhāvaṃ,tassattabhavam,1,1,0,0,14
17590,abhipūjayitvā,abhipujayitva,2,2,0,0,13
17591,para248,para248,124,124,0,0,7
17592,kenāpi,kenapi,12,9,3,0,6
17593,rato,rato,239,220,19,0,4
17594,sīlaguṇe,silagune,2,2,0,0,8
17595,susāṇṭhito,susanthito,1,1,0,0,10
17596,nekkhammabhāgi,nekkhammabhagi,1,1,0,0,14
17597,varañāṇalābhī,varananalabhi,1,1,0,0,13
17598,thāmabalupapanno,thamabalupapanno,1,1,0,0,16
17599,para249,para249,121,121,0,0,7
17600,samaṃsamaṃ,samamsamam,1,1,0,0,10
17601,hatthapāde,hatthapade,103,102,1,0,10
17602,saṃchinadamānepi,samchinadamanepi,1,1,0,0,16
17603,kareyyakhantiṃ,kareyyakhantim,1,1,0,0,14
17604,kālumadhiṭṭhite,kalumadhitthite,1,1,0,0,15
17605,mettāyupekkhāya,mettayupekkhaya,1,1,0,0,15
17606,para250,para250,116,116,0,0,7
17607,mahāpariccāgaṃ,mahapariccagam,5,5,0,0,14
17608,sambodhimaggaṃ,sambodhimaggam,1,1,0,0,14
17609,avirādhayanto,aviradhayanto,1,1,0,0,13
17610,chetvā,chetva,437,407,30,0,6
17611,citapañcamāro,citapancamaro,1,1,0,0,13
17612,bhavissāmi,bhavissami,368,358,10,0,10
17613,anāgatesu,anagatesu,52,51,1,0,9
17614,kamalāñjali,kamalanjali,1,1,0,0,11
17615,kamalāsana,kamalasana,1,1,0,0,10
17616,kamalāpati,kamalapati,1,1,0,0,10
17617,pamathādhipa,pamathadhipa,1,1,0,0,12
17618,yudhadānava,yudhadanava,1,1,0,0,11
17619,manujoraga,manujoraga,1,1,0,0,10
17620,bhujagāsana,bhujagasana,1,1,0,0,11
17621,patinaṃ,patinam,2,2,0,0,7
17622,makuṭāhita,makutahita,1,1,0,0,10
17623,manidīdhiti,manididhiti,1,1,0,0,11
17624,bhamarāvali,bhamaravali,1,1,0,0,11
17625,paṇamā,panama,15,15,0,0,6
17626,anaghaṃ,anagham,10,10,0,0,7
17627,caraṇāmala,caranamala,3,3,0,0,10
17628,kamalālaya,kamalalaya,1,1,0,0,10
17629,sadi,sadi,2,2,0,0,4
17630,saṅkita,sankita,1,1,0,0,7
17631,kalamaṅgala,kalamangala,1,1,0,0,11
17632,ruciraṃ,ruciram,56,47,9,0,7
17633,jutirañjitaṃ,jutiranjitam,1,1,0,0,12
17634,abhinijjita,abhinijjita,1,1,0,0,11
17635,subhakañcana,subhakancana,1,1,0,0,12
17636,nalinaṃ,nalinam,3,2,1,0,7
17637,janitā,janita,18,17,1,0,6
17638,cira,cira,12,12,0,0,4
17639,nija,nija,6,6,0,0,4
17640,pitu,pitu,699,682,17,0,4
17641,saraṇāgata,saranagata,2,2,0,0,10
17642,rajanīpati,rajanipati,1,1,0,0,10
17643,dinasekhara,dinasekhara,1,1,0,0,11
17644,bhajitākhila,bhajitakhila,1,1,0,0,12
17645,janapāvanaṃ,janapavanam,1,1,0,0,11
17646,abhikaṅkhita,abhikankhita,1,1,0,0,12
17647,sukhadaṃ,sukhadam,5,5,0,0,8
17648,vasudhātala,vasudhatala,1,1,0,0,11
17649,sayamuggata,sayamuggata,1,1,0,0,11
17650,sarasīruha,sarasiruha,1,1,0,0,10
17651,diradāsana,diradasana,1,1,0,0,10
17652,tarupantika,tarupantika,1,1,0,0,11
17653,ghaṭitāsanaṃ,ghatitasanam,1,1,0,0,12
17654,vijayāsana,vijayasana,1,1,0,0,10
17655,samadhiṭṭhita,samadhitthita,1,1,0,0,13
17656,caturaṅgika,caturangika,1,1,0,0,11
17657,viriyaṃ,viriyam,16,16,0,0,7
17658,dharamānaka,dharamanaka,1,1,0,0,11
17659,suriyehani,suriyehani,1,1,0,0,10
17660,vijitantaka,vijitantaka,3,3,0,0,11
17661,dhajiniṃ,dhajinim,5,3,2,0,8
17662,abhipātita,abhipatita,1,1,0,0,10
17663,namuciddhaja,namuciddhaja,1,1,0,0,12
17664,vibhavaṃ,vibhavam,134,109,25,0,8
17665,sadayodita,sadayodita,1,1,0,0,10
17666,piyabhārati,piyabharati,1,1,0,0,11
17667,samaraṃ,samaram,4,3,1,0,7
17668,dasapārami,dasaparami,2,2,0,0,10
17669,balakampita,balakampita,1,1,0,0,11
17670,sadharādhara,sadharadhara,1,1,0,0,12
17671,dharaniṃ,dharanim,1,1,0,0,8
17672,girimekhala,girimekhala,2,2,0,0,11
17673,varavārana,varavarana,1,1,0,0,10
17674,sirasānata,sirasanata,1,1,0,0,10
17675,abhinandita,abhinandita,1,1,0,0,11
17676,sanarāmara,sanaramara,3,3,0,0,10
17677,bhuvanaṃ,bhuvanam,14,12,2,0,8
17678,nikhilāsava,nikhilasava,1,1,0,0,11
17679,vigame,vigame,4,3,1,0,6
17680,nativimalīkata,nativimalikata,1,1,0,0,14
17681,tadanantara,tadanantara,1,1,0,0,11
17682,viditākhila,viditakhila,1,1,0,0,11
17683,matigocara,matigocara,1,1,0,0,10
17684,visayīkata,visayikata,1,1,0,0,10
17685,bhuvanattayaṃ,bhuvanattayam,2,2,0,0,13
17686,atilokiya,atilokiya,1,1,0,0,9
17687,caritaṃ,caritam,188,164,24,0,7
17688,aparājitaṃ,aparajitam,46,44,2,0,10
17689,mudubhārati,mudubharati,1,1,0,0,11
17690,madhupāsita,madhupasita,1,1,0,0,11
17691,nalinopama,nalinopama,1,1,0,0,10
17692,vadanaṃ,vadanam,46,36,10,0,7
17693,rucirāyata,rucirayata,2,2,0,0,10
17694,nalinīdala,nalinidala,1,1,0,0,10
17695,nibha,nibha,3,2,1,0,5
17696,locana,locana,3,3,0,0,6
17697,yugalaṃ,yugalam,4,4,0,0,7
17698,udayodita,udayodita,1,1,0,0,9
17699,ravimaṇḍala,ravimandala,1,1,0,0,11
17700,jalitāmala,jalitamala,1,1,0,0,10
17701,niṭilaṃ,nitilam,1,1,0,0,7
17702,maha,maha,30,9,21,0,4
17703,akutobhayaṃ,akutobhayam,34,20,14,0,11
17704,asitambuda,asitambuda,1,1,0,0,10
17705,rucikuñcita,rucikuncita,1,1,0,0,11
17706,kuntala,kuntala,3,3,0,0,7
17707,bhuvanodara,bhuvanodara,2,2,0,0,11
17708,vitatāmita,vitatamita,1,1,0,0,10
17709,jutisañcaya,jutisancaya,1,1,0,0,11
17710,jalitaṃ,jalitam,52,48,4,0,7
17711,madamodita,madamodita,1,1,0,0,10
17712,diradopama,diradopama,1,1,0,0,10
17713,gativibbhama,gativibbhama,1,1,0,0,12
17714,amatandada,amatandada,5,3,2,0,10
17715,karuṇārasa,karunarasa,1,1,0,0,10
17716,paribhāvita,paribhavita,4,4,0,0,11
17717,savaṇāmata,savanamata,1,1,0,0,10
17718,virudāvali,virudavali,1,1,0,0,10
17719,sataghosita,sataghosita,1,1,0,0,11
17720,yasapūrita,yasapurita,1,1,0,0,10
17721,sumanohara,sumanohara,1,1,0,0,10
17722,varalakkhaṇa,varalakkhana,2,2,0,0,12
17723,sirisañcaya,sirisancaya,1,1,0,0,11
17724,sadanaṃ,sadanam,5,4,1,0,7
17725,uditāmala,uditamala,1,1,0,0,9
17726,sasimaṇḍala,sasimandala,1,1,0,0,11
17727,vinayāraha,vinayaraha,1,1,0,0,10
17728,janamānasa,janamanasa,2,2,0,0,10
17729,kumudākara,kumudakara,1,1,0,0,10
17730,sasinaṃ,sasinam,1,1,0,0,7
17731,tasināpaga,tasinapaga,1,1,0,0,10
17732,parisosana,parisosana,1,1,0,0,10
17733,satadīdhiti,satadidhiti,1,1,0,0,11
17734,tulitaṃ,tulitam,32,29,3,0,7
17735,tamanāsava,tamanasava,1,1,0,0,10
17736,munisevitaṃ,munisevitam,1,1,0,0,11
17737,apalokita,apalokita,1,1,0,0,9
17738,aniketanaṃ,aniketanam,1,1,0,0,10
17739,akhilāgati,akhilagati,1,1,0,0,10
17740,vigataṃ,vigatam,86,82,4,0,7
17741,sahitākhila,sahitakhila,1,1,0,0,11
17742,bhayabheravaṃ,bhayabheravam,93,84,9,0,13
17743,abhayāgata,abhayagata,1,1,0,0,10
17744,saranaṃ,saranam,2,2,0,0,7
17745,ajarāmara,ajaramara,2,2,0,0,9
17746,sukhadāyakaṃ,sukhadayakam,5,5,0,0,12
17747,anirākata,anirakata,1,1,0,0,9
17748,karuṇaṃ,karunam,110,96,14,0,7
17749,tamupāsaka,tamupasaka,1,1,0,0,10
17750,janasevita,janasevita,1,1,0,0,10
17751,supatiṭṭhita,supatitthita,1,1,0,0,12
17752,ahitāpahaṃ,ahitapaham,1,1,0,0,10
17753,anaghuttama,anaghuttama,1,1,0,0,11
17754,karuṇāmata,karunamata,1,1,0,0,10
17755,rasapurita,rasapurita,1,1,0,0,10
17756,vīmalākhila,vimalakhila,1,1,0,0,11
17757,vihitāmita,vihitamita,1,1,0,0,10
17758,janatāhitaṃ,janatahitam,1,1,0,0,11
17759,anukampita,anukampita,1,1,0,0,10
17760,bhuvane,bhuvane,16,13,3,0,7
17761,avanīpati,avanipati,1,1,0,0,9
17762,sevita,sevita,1,1,0,0,6
17763,aghanāsana,aghanasana,1,1,0,0,10
17764,caturaṃ,caturam,2,2,0,0,7
17765,aratīrati,aratirati,1,1,0,0,9
17766,paripīlita,paripilita,1,1,0,0,10
17767,yatimānasa,yatimanasa,1,1,0,0,10
17768,damanaṃ,damanam,27,27,0,0,7
17769,nijasāsana,nijasasana,1,1,0,0,10
17770,vinivārita,vinivarita,1,1,0,0,10
17771,puthutitthiya,puthutitthiya,1,1,0,0,13
17772,samaṇaṃ,samanam,525,505,20,0,7
17773,paravādika,paravadika,1,1,0,0,10
17774,janatākata,janatakata,1,1,0,0,10
17775,paribhāsita,paribhasita,1,1,0,0,11
17776,atidevata,atidevata,1,1,0,0,9
17777,vara,vara,59,25,34,0,4
17778,gotama,gotama,1387,1359,28,0,6
17779,bhayanāsana,bhayanasana,1,1,0,0,11
17780,vajirālaya,vajiralaya,1,1,0,0,10
17781,paṇibhaṃ,panibham,1,1,0,0,8
17782,patitāmita,patitamita,1,1,0,0,10
17783,janatārana,janatarana,1,1,0,0,10
17784,nirataṃ,niratam,3,3,0,0,7
17785,sirasāvahaṃ,sirasavaham,1,1,0,0,11
17786,amalañjali,amalanjali,1,1,0,0,10
17787,puṭapaṅkaja,putapankaja,1,1,0,0,11
17788,makulaṃ,makulam,4,3,1,0,7
17789,akhilalāya,akhilalaya,1,1,0,0,10
17790,vimalīkata,vimalikata,1,1,0,0,10
17791,vigatāsava,vigatasava,1,1,0,0,10
17792,bhagavaṃ,bhagavam,21,21,0,0,8
17793,bhavapāraga,bhavaparaga,1,1,0,0,11
17794,vibhavāmata,vibhavamata,1,1,0,0,11
17795,sukhadāyaka,sukhadayaka,1,1,0,0,11
17796,paramādara,paramadara,1,1,0,0,10
17797,garugārava,garugarava,2,2,0,0,10
17798,vinataṃ,vinatam,8,8,0,0,7
17799,jina,jina,42,25,17,0,4
17800,payataṃ,payatam,3,2,1,0,7
17801,padapaṅkaja,padapankaja,1,1,0,0,11
17802,rajasā,rajasa,11,10,1,0,6
17803,samalaṅkuru,samalankuru,1,1,0,0,11
17804,sirasaṃ,sirasam,10,9,1,0,7
17805,pavanāhata,pavanahata,1,1,0,0,10
17806,dumapallavaṃ,dumapallavam,1,1,0,0,12
17807,nārata,narata,2,2,0,0,6
17808,capalaṃ,capalam,8,6,2,0,7
17809,bhavalālasa,bhavalalasa,1,1,0,0,11
17810,malinīkataṃ,malinikatam,1,1,0,0,11
17811,ajitindriya,ajitindriya,1,1,0,0,11
17812,nivahaṃ,nivaham,3,3,0,0,7
17813,sañcita,sancita,2,2,0,0,7
17814,duritāhataṃ,duritahatam,1,1,0,0,11
17815,anivārita,anivarita,2,2,0,0,9
17816,timisaṃ,timisam,7,6,1,0,7
17817,vimalīkuru,vimalikuru,1,1,0,0,10
17818,karuṇābhara,karunabhara,2,2,0,0,11
17819,sutaraṃ,sutaram,3,3,0,0,7
17820,adaye,adaye,1,1,0,0,5
17821,dayaṃ,dayam,16,14,2,0,5
17822,anaye,anaye,24,22,2,0,5
17823,aguṇe,agune,8,7,1,0,5
17824,ahite,ahite,17,17,0,0,5
17825,akaro,akaro,8,8,0,0,5
17826,kvacida,kvacida,1,1,0,0,7
17827,nakataṃ,nakatam,2,2,0,0,7
17828,sadaye,sadaye,5,4,1,0,6
17829,sunaye,sunaye,1,1,0,0,6
17830,guṇasadane,gunasadane,1,1,0,0,10
17831,tayi,tayi,144,137,7,0,4
17832,nitaraṃ,nitaram,1,1,0,0,7
17833,suhite,suhite,1,1,0,0,6
17834,hitacarite,hitacarite,1,1,0,0,10
17835,nagha,nagha,1,1,0,0,5
17836,ramate,ramate,43,41,2,0,6
17837,bhavasaṅkaṭa,bhavasankata,2,2,0,0,12
17838,patitenapi,patitenapi,1,1,0,0,10
17839,bhavatā,bhavata,88,88,0,0,7
17840,visame,visame,127,105,22,0,6
17841,sama,sama,29,11,18,0,4
17842,bharaṇaṃ,bharanam,11,11,0,0,8
17843,sarato,sarato,22,22,0,0,6
17844,hani,hani,31,29,2,0,4
17845,nisi,nisi,6,5,1,0,4
17846,supinenapi,supinenapi,4,4,0,0,10
17847,sumate,sumate,1,1,0,0,6
17848,tvayi,tvayi,23,21,2,0,5
17849,sadayaṃ,sadayam,1,1,0,0,7
17850,atiduddadaṃ,atiduddadam,1,1,0,0,11
17851,adadī,adadi,2,2,0,0,5
17852,atidukkaraṃ,atidukkaram,19,19,0,0,11
17853,akarī,akari,16,15,1,0,5
17854,atidukkhamaṃ,atidukkhamam,1,1,0,0,12
17855,akhamī,akhami,1,1,0,0,6
17856,karuṇānidhi,karunanidhi,3,3,0,0,11
17857,rasamo,rasamo,1,1,0,0,6
17858,atiduccaraṃ,atiduccaram,1,1,0,0,11
17859,acarī,acari,56,56,0,0,5
17860,atiduddamaṃ,atiduddamam,1,1,0,0,11
17861,adamī,adami,1,1,0,0,5
17862,atiduddayaṃ,atiduddayam,1,1,0,0,11
17863,adayī,adayi,1,1,0,0,5
17864,sadayāpara,sadayapara,1,1,0,0,10
17865,hadayo,hadayo,9,9,0,0,6
17866,atiduggamaṃ,atiduggamam,1,1,0,0,11
17867,agamī,agami,17,16,1,0,5
17868,atidujjayaṃ,atidujjayam,1,1,0,0,11
17869,ajayī,ajayi,1,1,0,0,5
17870,atidussahaṃ,atidussaham,1,1,0,0,11
17871,asahī,asahi,1,1,0,0,5
17872,samupekkhita,samupekkhita,1,1,0,0,12
17873,atidāruna,atidaruna,1,1,0,0,9
17874,palayānala,palayanala,1,1,0,0,10
17875,sadisānala,sadisanala,1,1,0,0,10
17876,jalite,jalite,13,12,1,0,6
17877,niraye,niraye,778,759,19,0,6
17878,vinipatito,vinipatito,1,1,0,0,10
17879,ciraṃ,ciram,742,690,52,0,5
17880,aghatāpita,aghatapita,1,1,0,0,10
17881,sariṃ,sarim,34,32,2,0,5
17882,sakida,sakida,2,2,0,0,6
17883,pita,pita,25,25,0,0,4
17884,bhajituṃ,bhajitum,19,19,0,0,8
17885,padanalinaṃ,padanalinam,16,16,0,0,11
17886,khama,khama,61,60,1,0,5
17887,narasārathi,narasarathi,22,22,0,0,11
17888,tamidaṃ,tamidam,17,17,0,0,7
17889,khalitaṃ,khalitam,71,61,10,0,8
17890,tiriyaggatagatiyaṃ,tiriyaggatagatiyam,1,1,0,0,18
17891,anavaṭṭhita,anavatthita,1,1,0,0,11
17892,carito,carito,23,21,2,0,6
17893,atiniṭṭhura,atinitthura,1,1,0,0,11
17894,vadhatajjita,vadhatajjita,1,1,0,0,12
17895,bhayakampita,bhayakampita,1,1,0,0,12
17896,sakidapi,sakidapi,15,15,0,0,8
17897,purisuttama,purisuttama,50,49,1,0,11
17898,paridevana,paridevana,1,1,0,0,10
17899,nirato,nirato,35,33,2,0,6
17900,pettiya,pettiya,1,1,0,0,7
17901,visaye,visaye,392,384,8,0,6
17902,sujighacchita,sujighacchita,1,1,0,0,13
17903,supipāsita,supipasita,1,1,0,0,10
17904,parisosita,parisosita,1,1,0,0,10
17905,jaṭhare,jathare,2,2,0,0,7
17906,dipaduttama,dipaduttama,2,2,0,0,11
17907,vivaso,vivaso,6,5,1,0,6
17908,aghadūsita,aghadusita,1,1,0,0,10
17909,manasāsura,manasasura,1,1,0,0,10
17910,janito,janito,16,15,1,0,6
17911,ghanatimire,ghanatimire,1,1,0,0,11
17912,atidukkhita,atidukkhita,1,1,0,0,11
17913,vasisattama,vasisattama,1,1,0,0,11
17914,vihitaṃ,vihitam,31,26,5,0,7
17915,saraṃ,saram,302,279,23,0,5
17916,atikibbisa,atikibbisa,1,1,0,0,10
17917,samathenatha,samathenatha,1,1,0,0,12
17918,suvirājiya,suvirajiya,1,1,0,0,10
17919,asaññitaṃ,asannitam,1,1,0,0,9
17920,upago,upago,2,2,0,0,5
17921,vasipuṅgava,vasipungava,1,1,0,0,11
17922,vijigucchiya,vijigucchiya,3,3,0,0,12
17923,duritaṃ,duritam,7,6,1,0,7
17924,vapusā,vapusa,2,2,0,0,6
17925,tanu,tanu,74,37,37,0,4
17926,vajjitaṃ,vajjitam,12,11,1,0,8
17927,bhāvita,bhavita,2,2,0,0,7
17928,samatho,samatho,396,355,41,0,7
17929,yatikuñjara,yatikunjara,1,1,0,0,11
17930,ratanattaya,ratanattaya,9,9,0,0,11
17931,rahite,rahite,6,6,0,0,6
17932,bhusa,bhusa,24,17,7,0,5
17933,bahulīkata,bahulikata,1,1,0,0,10
17934,durite,durite,1,1,0,0,6
17935,paravisaye,paravisaye,22,22,0,0,10
17936,budhajana,budhajana,1,1,0,0,9
17937,nindiya,nindiya,1,1,0,0,7
17938,carite,carite,3,3,0,0,6
17939,manujesupi,manujesupi,1,1,0,0,10
17940,vikalindriya,vikalindriya,1,1,0,0,12
17941,tanunā,tanuna,2,2,0,0,6
17942,karacaraṇādihi,karacaranadihi,1,1,0,0,14
17943,vikate,vikate,5,3,2,0,6
17944,niha,niha,1,1,0,0,4
17945,dukhito,dukhito,2,2,0,0,7
17946,matisāgara,matisagara,1,1,0,0,10
17947,vidhināhita,vidhinahita,1,1,0,0,11
17948,matibhāvana,matibhavana,1,1,0,0,11
17949,rahito,rahito,35,34,1,0,6
17950,tamapihito,tamapihito,1,1,0,0,10
17951,visadesupi,visadesupi,1,1,0,0,10
17952,kusalādisu,kusaladisu,1,1,0,0,10
17953,tathadassana,tathadassana,1,1,0,0,12
17954,vimukho,vimukho,4,4,0,0,7
17955,narakesari,narakesari,1,1,0,0,10
17956,sucirenapi,sucirenapi,2,2,0,0,10
17957,bhuvi,bhuvi,60,58,2,0,5
17958,khaṇaṃ,khanam,307,289,18,0,6
17959,alabhaṃ,alabham,1,1,0,0,7
17960,janatāhita,janatahita,1,1,0,0,10
17961,jananaṃ,jananam,41,39,2,0,7
17962,vadataṃvara,vadatamvara,1,1,0,0,11
17963,nisitāyudha,nisitayudha,1,1,0,0,11
17964,vadhasajjita,vadhasajjita,1,1,0,0,12
17965,khaḷaniddaya,khalaniddaya,1,1,0,0,12
17966,parahiṃsana,parahimsana,2,2,0,0,11
17967,ruci,ruci,86,73,13,0,4
17968,bhiṃsana,bhimsana,1,1,0,0,8
17969,yamasodara,yamasodara,1,1,0,0,10
17970,munisattama,munisattama,1,1,0,0,11
17971,parasantaka,parasantaka,1,1,0,0,11
17972,katamati,katamati,1,1,0,0,8
17973,bañcana,bancana,1,1,0,0,7
17974,bahulo,bahulo,15,15,0,0,6
17975,gharasandhika,gharasandhika,1,1,0,0,13
17976,paripanthika,paripanthika,1,1,0,0,12
17977,sahasākati,sahasakati,1,1,0,0,10
17978,munipuṅgava,munipungava,5,2,3,0,11
17979,navayobbana,navayobbana,3,3,0,0,11
17980,madagabbita,madagabbita,1,1,0,0,11
17981,parimucchita,parimucchita,1,1,0,0,12
17982,sucisajjana,sucisajjana,1,1,0,0,11
17983,paradārika,paradarika,2,2,0,0,10
17984,madirāsavarata,madirasavarata,1,1,0,0,14
17985,nāgarajana,nagarajana,1,1,0,0,10
17986,santata,santata,2,2,0,0,7
17987,bhajito,bhajito,1,1,0,0,7
17988,hiridūrita,hiridurita,1,1,0,0,10
17989,tiriyaggata,tiriyaggata,1,1,0,0,11
17990,vihatāsava,vihatasava,1,1,0,0,10
17991,sapitāmaha,sapitamaha,1,1,0,0,10
17992,papitāmaha,papitamaha,1,1,0,0,10
17993,nicitaṃ,nicitam,13,13,0,0,7
17994,pitusañcitamapi,pitusancitamapi,1,1,0,0,15
17995,nāsiya,nasiya,1,1,0,0,6
17996,kitavo,kitavo,7,6,1,0,6
17997,hatavibhavo,hatavibhavo,2,2,0,0,11
17998,vitathālika,vitathalika,1,1,0,0,11
17999,vacano,vacano,2,2,0,0,6
18000,parapiyasuññata,parapiyasunnata,1,1,0,0,15
18001,karaṇo,karano,8,5,3,0,6
18002,pharusaṃ,pharusam,192,174,18,0,8
18003,bhaṇaṃ,bhanam,38,31,7,0,6
18004,atinipphala,atinipphala,1,1,0,0,11
18005,bahubhāsana,bahubhasana,1,1,0,0,11
18006,nipuṇo,nipuno,85,78,7,0,6
18007,bhuvanesuta,bhuvanesuta,1,1,0,0,11
18008,parasampadaṃ,parasampadam,1,1,0,0,12
18009,abhijhāyana,abhijhayana,1,1,0,0,11
18010,nirantara,nirantara,2,2,0,0,9
18011,nabhirajjhana,nabhirajjhana,1,1,0,0,13
18012,kvaci,kvaci,792,731,61,0,5
18013,phaladassana,phaladassana,1,1,0,0,12
18014,guṇasāgara,gunasagara,1,1,0,0,10
18015,bhavato,bhavato,194,182,12,0,7
18016,aparāparaṃ,aparaparam,516,487,29,0,10
18017,ayatāciraṃ,ayataciram,1,1,0,0,10
18018,vacasāpi,vacasapi,1,1,0,0,8
18019,duritāpaha,duritapaha,1,1,0,0,10
18020,bahuvihitaṃ,bahuvihitam,1,1,0,0,11
18021,dada,dada,17,12,5,0,4
18022,sivapadaṃ,sivapadam,6,6,0,0,9
18023,accutaṃ,accutam,57,43,14,0,7
18024,bhavavigataṃ,bhavavigatam,1,1,0,0,12
18025,timirāvuta,timiravuta,1,1,0,0,10
18026,kuṇapākula,kunapakula,1,1,0,0,10
18027,janikāsuci,janikasuci,1,1,0,0,10
18028,bahu,bahu,397,371,26,0,4
18029,kimisantati,kimisantati,1,1,0,0,11
18030,sadane,sadane,1,1,0,0,6
18031,asayiṃ,asayim,1,1,0,0,6
18032,bhavagahaṇe,bhavagahane,17,17,0,0,11
18033,caraṃ,caram,209,153,56,0,5
18034,appaṭisaraṇe,appatisarane,24,24,0,0,12
18035,bhava,bhava,158,144,14,0,5
18036,bhavanīradhi,bhavaniradhi,19,19,0,0,12
18037,taraṇe,tarane,28,28,0,0,6
18038,bahi,bahi,1675,1568,107,0,4
18039,asakiṃ,asakim,10,7,3,0,6
18040,bhagatiriyaṃ,bhagatiriyam,1,1,0,0,12
18041,patha,patha,18,7,11,0,5
18042,patito,patito,149,145,4,0,6
18043,agadaṅkara,agadankara,1,1,0,0,10
18044,kata,kata,37,28,9,0,4
18045,sallaka,sallaka,1,1,0,0,7
18046,satakhaṇdita,satakhandita,1,1,0,0,12
18047,amariṃ,amarim,11,11,0,0,6
18048,tarane,tarane,1,1,0,0,6
18049,ratipillaka,ratipillaka,1,1,0,0,11
18050,tanurāmaya,tanuramaya,1,1,0,0,10
18051,mathito,mathito,6,4,2,0,7
18052,vadituṃ,vaditum,3,3,0,0,7
18053,kimu,kimu,10,9,1,0,4
18054,viditumpi,viditumpi,1,1,0,0,9
18055,sahaṃ,saham,10,9,1,0,5
18056,matirahito,matirahito,1,1,0,0,10
18057,apphṭisaraṇe,apphtisarane,1,1,0,0,12
18058,janadayito,janadayito,1,1,0,0,10
18059,piyajanako,piyajanako,1,1,0,0,10
18060,puthuko,puthuko,4,3,1,0,7
18061,bahuvidhakīlananirato,bahuvidhakilananirato,1,1,0,0,21
18062,gadagahito,gadagahito,2,2,0,0,10
18063,tarunopi,tarunopi,1,1,0,0,8
18064,gharabandhana,gharabandhana,1,1,0,0,13
18065,gathitomita,gathitomita,1,1,0,0,11
18066,vibhavo,vibhavo,60,52,8,0,7
18067,sahasā,sahasa,408,383,25,0,6
18068,piyabhariyāsuta,piyabhariyasuta,1,1,0,0,15
18069,viyuto,viyuto,1,1,0,0,6
18070,ajaraṃ,ajaram,47,42,5,0,6
18071,tanuṃ,tanum,34,31,3,0,5
18072,abhimaññiya,abhimanniya,2,2,0,0,11
18073,vasiko,vasiko,2,2,0,0,6
18074,jarasā,jarasa,8,5,3,0,6
18075,parimathito,parimathito,1,1,0,0,11
18076,ananuṭṭhita,ananutthita,1,1,0,0,11
18077,nirujo,nirujo,1,1,0,0,6
18078,dhuvaṃ,dhuvam,402,363,39,0,6
18079,arujaṃ,arujam,3,2,1,0,6
18080,samado,samado,1,1,0,0,6
18081,kusalāsaya,kusalasaya,1,1,0,0,10
18082,avaso,avaso,10,7,3,0,5
18083,gadanihato,gadanihato,1,1,0,0,10
18084,pavicintiya,pavicintiya,1,1,0,0,11
18085,sakajīvitaṃ,sakajivitam,1,1,0,0,11
18086,amaraṃ,amaram,41,33,8,0,6
18087,jīvitamadagabbita,jivitamadagabbita,1,1,0,0,17
18088,matirujjhita,matirujjhita,1,1,0,0,12
18089,dhanamosana,dhanamosana,1,1,0,0,11
18090,dharanīpati,dharanipati,1,1,0,0,11
18091,vadhabandhana,vadhabandhana,1,1,0,0,13
18092,nihato,nihato,62,57,5,0,6
18093,narakodaka,narakodaka,1,1,0,0,10
18094,giritarumatthaka,giritarumatthaka,1,1,0,0,16
18095,galito,galito,2,2,0,0,6
18096,migavāḷaka,migavalaka,1,1,0,0,10
18097,visadhara,visadhara,2,1,1,0,9
18098,jātihi,jatihi,1,1,0,0,6
18099,ḍasito,dasito,1,1,0,0,6
18100,abhicāraka,abhicaraka,1,1,0,0,10
18101,vidhikopita,vidhikopita,1,1,0,0,11
18102,nisicāraka,nisicaraka,1,1,0,0,10
18103,savisodana,savisodana,1,1,0,0,10
18104,sahasādana,sahasadana,1,1,0,0,10
18105,pabhutīhi,pabhutihi,2,2,0,0,9
18106,khalito,khalito,8,7,1,0,7
18107,sayamevaca,sayamevaca,1,1,0,0,10
18108,sajanopari,sajanopari,1,1,0,0,10
18109,kupito,kupito,231,215,16,0,6
18110,mativiyuto,mativiyuto,1,1,0,0,10
18111,savisādana,savisadana,1,1,0,0,10
18112,galakantana,galakantana,1,1,0,0,11
18113,pabhutāmita,pabhutamita,1,1,0,0,11
18114,pitupūjana,pitupujana,1,1,0,0,10
18115,niratāsaya,niratasaya,1,1,0,0,10
18116,pitudayito,pitudayito,1,1,0,0,10
18117,maraṇenaca,maranenaca,2,2,0,0,10
18118,pituno,pituno,103,103,0,0,6
18119,anusocana,anusocana,3,3,0,0,9
18120,parudiṃ,parudim,6,6,0,0,7
18121,atidussaha,atidussaha,5,5,0,0,10
18122,kasire,kasire,5,5,0,0,6
18123,samupaṭṭhiya,samupatthiya,1,1,0,0,12
18124,janikaṃ,janikam,11,9,2,0,7
18125,nijaṃ,nijam,13,13,0,0,5
18126,abhivādana,abhivadana,6,3,3,0,10
18127,janikāyanusaritā,janikayanusarita,1,1,0,0,16
18128,guṇamahimaṃ,gunamahimam,1,1,0,0,11
18129,gurudevata,gurudevata,1,1,0,0,10
18130,patimānana,patimanana,1,1,0,0,10
18131,piyasuvaco,piyasuvaco,1,1,0,0,10
18132,samupāsitacaraṇo,samupasitacarano,1,1,0,0,16
18133,gurumaraṇenatidukhito,gurumaranenatidukhito,1,1,0,0,21
18134,gharamedhitaṃ,gharamedhitam,1,1,0,0,13
18135,upagomitavibhavo,upagomitavibhavo,1,1,0,0,16
18136,ratibahulo,ratibahulo,1,1,0,0,10
18137,maraṇe,marane,116,110,6,0,6
18138,piyabhariyāsutaduhitū,piyabhariyasutaduhitu,1,1,0,0,21
18139,natikaruṇaṃ,natikarunam,1,1,0,0,11
18140,piyapubbaja,piyapubbaja,1,1,0,0,11
18141,sahajānuja,sahajanuja,1,1,0,0,10
18142,bhagiṇidvaya,bhaginidvaya,1,1,0,0,12
18143,bandhavasakhasissaka,bandhavasakhasissaka,1,1,0,0,20
18144,pyatikaruṇaṃ,pyatikarunam,1,1,0,0,12
18145,jagatīpati,jagatipati,7,7,0,0,10
18146,gahaṇā,gahana,14,14,0,0,6
18147,ripujanatakkara,ripujanatakkara,1,1,0,0,15
18148,haraṇā,harana,1,1,0,0,6
18149,saritodaka,saritodaka,1,1,0,0,10
18150,vahaṇā,vahana,1,1,0,0,6
18151,puthujalitānala,puthujalitanala,1,1,0,0,15
18152,dahaṇā,dahana,1,1,0,0,6
18153,ciramiha,ciramiha,1,1,0,0,8
18154,duggatigahaṇe,duggatigahane,1,1,0,0,13
18155,atiduggama,atiduggama,1,1,0,0,10
18156,visamākula,visamakula,1,1,0,0,10
18157,byasanaṃ,byasanam,221,195,26,0,8
18158,ciramiti,ciramiti,1,1,0,0,8
18159,dussahaṃ,dussaham,13,13,0,0,8
18160,anubhūyapi,anubhuyapi,1,1,0,0,10
18161,vimitaṃ,vimitam,1,1,0,0,7
18162,jahe,jahe,81,70,11,0,4
18163,sukhalavavañcitahadayo,sukhalavavancitahadayo,1,1,0,0,22
18164,bhavatasinaṃ,bhavatasinam,1,1,0,0,12
18165,tamapākuru,tamapakuru,1,1,0,0,10
18166,tasinaṃ,tasinam,2,2,0,0,7
18167,kasiṇaṃ,kasinam,100,88,12,0,7
18168,jananāvadhi,jananavadhi,2,2,0,0,11
18169,maraṇāvadhi,maranavadhi,2,2,0,0,11
18170,ubhayenapi,ubhayenapi,88,80,8,0,10
18171,bhayamevahi,bhayamevahi,1,1,0,0,11
18172,niyataṃ,niyatam,86,80,6,0,7
18173,sivamevaca,sivamevaca,1,1,0,0,10
18174,rahitaṃ,rahitam,15,13,2,0,7
18175,anāsava,anasava,2,1,1,0,7
18176,ciradikkhitamapi,ciradikkhitamapi,1,1,0,0,16
18177,ratipīlitaṃ,ratipilitam,1,1,0,0,11
18178,ahaho,ahaho,5,5,0,0,5
18179,kalighaṭitaṃ,kalighatitam,1,1,0,0,12
18180,mamamava,mamamava,1,1,0,0,8
18181,taraṇaṃ,taranam,32,29,3,0,7
18182,pajjamadhu,pajjamadhu,1,1,0,0,10
18183,rañña,ranna,5,5,0,0,5
18184,ratanādi,ratanadi,2,2,0,0,8
18185,yatinda,yatinda,2,2,0,0,7
18186,niccappabuddha,niccappabuddha,2,2,0,0,14
18187,padumappiya,padumappiya,2,2,0,0,11
18188,sevinaṅgī,sevinangi,2,2,0,0,9
18189,buddhappiyena,buddhappiyena,3,3,0,0,13
18190,ghana,ghana,5,3,2,0,5
18191,guṇappiyena,gunappiyena,2,2,0,0,11
18192,therālinā,theralina,2,2,0,0,9
18193,racita,racita,2,2,0,0,6
18194,pajjamadhuṃ,pajjamadhum,2,2,0,0,11
18195,pibantu,pibantu,2,2,0,0,7
18196,uṇṇāpapuṇṇasasimaṇdalato,unnapapunnasasimandalato,1,1,0,0,24
18197,galitvā,galitva,5,5,0,0,7
18198,pādambujaṅguli,padambujanguli,1,1,0,0,14
18199,dalaṭṭha,dalattha,1,1,0,0,8
18200,sudhā,sudha,43,39,4,0,5
18201,lavānaṃ,lavanam,1,1,0,0,7
18202,pantīva,pantiva,1,1,0,0,7
18203,satthu,satthu,2840,2785,55,0,6
18204,nakhapanti,nakhapanti,1,1,0,0,10
18205,pajāvisesaṃ,pajavisesam,1,1,0,0,11
18206,pīṇetu,pinetu,1,1,0,0,6
18207,suddha,suddha,9,5,4,0,6
18208,sukhitammaṇa,sukhitammana,1,1,0,0,12
18209,tunḍapītā,tundapita,1,1,0,0,9
18210,khittāya,khittaya,3,3,0,0,8
18211,māraripunā,mararipuna,1,1,0,0,10
18212,parivatya,parivatya,1,1,0,0,9
18213,pādassayā,padassaya,1,1,0,0,9
18214,jita,jita,3,3,0,0,4
18215,sitattalāya,sitattalaya,1,1,0,0,11
18216,jeti,jeti,50,46,4,0,4
18217,kañcana,kancana,10,10,0,0,7
18218,sarāvaliyā,saravaliya,1,1,0,0,10
18219,siriṃ,sirim,85,73,12,0,5
18220,detanginaṃ,detanginam,1,1,0,0,10
18221,raṇajayaṅgulipantikantā,ranajayangulipantikanta,1,1,0,0,23
18222,sovaṇṇa,sovanna,9,9,0,0,7
18223,sukhumacchavi,sukhumacchavi,4,4,0,0,13
18224,somma,somma,2,2,0,0,5
18225,kumma,kumma,15,15,0,0,5
18226,piṭṭhīva,pitthiva,1,1,0,0,8
18227,piṭṭhi,pitthi,57,51,6,0,6
18228,kamatunnati,kamatunnati,1,1,0,0,11
18229,tesuppatiṭṭhitasukomaladīghapaṇhi,tesuppatitthitasukomaladighapanhi,1,1,0,0,33
18230,padadantu,padadantu,2,2,0,0,9
18231,janassa,janassa,299,294,5,0,7
18232,acchera,acchera,4,4,0,0,7
18233,paṅkajasiraṃ,pankajasiram,1,1,0,0,12
18234,sakāya,sakaya,172,166,6,0,6
18235,maddino,maddino,1,1,0,0,7
18236,saroja,saroja,2,1,1,0,6
18237,sīse,sise,487,469,18,0,4
18238,sañcumbitā,sancumbita,1,1,0,0,10
18239,parāga,paraga,1,1,0,0,6
18240,rāgā,raga,71,57,14,0,4
18241,nīrajā,niraja,3,3,0,0,6
18242,munipadā,munipada,1,1,0,0,8
18243,lakkhiṃ,lakkhim,14,13,1,0,7
18244,agāmi,agami,1,1,0,0,5
18245,bhattu,bhattu,96,92,4,0,6
18246,vyākattumatra,vyakattumatra,1,1,0,0,13
18247,kusaleniva,kusaleniva,1,1,0,0,10
18248,nimmitāni,nimmitani,4,4,0,0,9
18249,yātrāsumaṭṭhasatamaṅgalakkhaṇāni,yatrasumatthasatamangalakkhanani,1,1,0,0,32
18250,sādhetu,sadhetu,4,4,0,0,7
18251,padayugaṃ,padayugam,2,2,0,0,9
18252,jayamaṅgalāni,jayamangalani,1,1,0,0,13
18253,sassevijantuvarasantipurappavese,sassevijantuvarasantipurappavese,1,1,0,0,32
18254,susajja,susajja,2,2,0,0,7
18255,ṭhapitāniva,thapitaniva,1,1,0,0,11
18256,maṅgalāya,mangalaya,7,7,0,0,9
18257,dadhanti,dadhanti,3,3,0,0,8
18258,kalamaṅgalalakkhaṇāni,kalamangalalakkhanani,1,1,0,0,21
18259,vattantu,vattantu,6,5,1,0,8
18260,jinapadā,jinapada,1,1,0,0,8
18261,jayamaṅgalāya,jayamangalaya,2,2,0,0,13
18262,sabbebhibhūya,sabbebhibhuya,1,1,0,0,13
18263,sapadesu,sapadesu,1,1,0,0,8
18264,nipātanassa,nipatanassa,2,2,0,0,11
18265,saññāṇakaṃ,sannanakam,1,1,0,0,10
18266,yadassitasabbaloko,yadassitasabbaloko,1,1,0,0,18
18267,pādātyadhokatatilokasirovarā,padatyadhokatatilokasirovara,1,1,0,0,28
18268,puṇantu,punantu,1,1,0,0,7
18269,jayamaṅgalakāraṇāni,jayamangalakaranani,1,1,0,0,19
18270,lokattayekasaraṇattavibhāvanāya,lokattayekasaranattavibhavanaya,1,1,0,0,31
18271,sajjo,sajjo,7,7,0,0,5
18272,suvibhattaloko,suvibhattaloko,1,1,0,0,14
18273,sabbalokapaṭibimbitadappaṇābhaṃ,sabbalokapatibimbitadappanabham,1,1,0,0,31
18274,pādadvayaṃ,padadvayam,8,8,0,0,10
18275,janasusajjanahetu,janasusajjanahetu,1,1,0,0,17
18276,lokuttarāya,lokuttaraya,27,27,0,0,11
18277,siriyādhigamāya,siriyadhigamaya,1,1,0,0,15
18278,rajanti,rajanti,8,8,0,0,7
18279,diguṇāniva,digunaniva,1,1,0,0,10
18280,cakkāsanābhisahanemisahassarāni,cakkasanabhisahanemisahassarani,1,1,0,0,31
18281,tyaṅghī,tyanghi,1,1,0,0,7
18282,disantu,disantu,1,1,0,0,7
18283,sakalissariyaṃ,sakalissariyam,1,1,0,0,14
18284,yatrullasanti,yatrullasanti,1,1,0,0,13
18285,duvidhāniva,duvidhaniva,1,1,0,0,11
18286,pātū,patu,1,1,0,0,4
18287,dhammassasabbabhuvanassa,dhammassasabbabhuvanassa,1,1,0,0,24
18288,issaratte,issaratte,3,3,0,0,9
18289,cakkasadisāni,cakkasadisani,1,1,0,0,13
18290,sudassanassa,sudassanassa,7,7,0,0,12
18291,tānajja,tanajja,3,3,0,0,7
18292,jantu,jantu,150,125,25,0,5
18293,caraṇāni,caranani,12,10,2,0,8
18294,vacchatu,vacchatu,1,1,0,0,8
18295,sirivacchakena,sirivacchakena,1,1,0,0,14
18296,sovatthi,sovatthi,2,2,0,0,8
18297,sotthimanutiṭṭhatu,sotthimanutitthatu,1,1,0,0,18
18298,puggalesu,puggalesu,114,110,4,0,9
18299,nandiṃ,nandim,112,93,19,0,6
18300,janānamanuvattatu,jananamanuvattatu,2,2,0,0,17
18301,nandivattī,nandivatti,1,1,0,0,10
18302,sīsānalaṃkurutu,sisanalamkurutu,1,1,0,0,15
18303,pādavataṃsako,padavatamsako,1,1,0,0,13
18304,bhaddāya,bhaddaya,57,56,1,0,8
18305,pīṭhamupagacchatu,pithamupagacchatu,1,1,0,0,17
18306,vuddhiṃ,vuddhim,264,235,29,0,7
18307,vaddhamānaṃ,vaddhamanam,1,1,0,0,11
18308,puṇṇattamaṅgimanukubbatu,punnattamangimanukubbatu,1,1,0,0,24
18309,apāyā,apaya,53,47,6,0,5
18310,setātapattamapanetamaghātape,setatapattamapanetamaghatape,1,1,0,0,28
18311,vichindatu,vichindatu,1,1,0,0,10
18312,duritārivagge,duritarivagge,1,1,0,0,13
18313,saṃklesadāhamapanetu,samklesadahamapanetu,1,1,0,0,20
18314,satālavanṭa,satalavanta,1,1,0,0,11
18315,saṃvījanī,samvijani,1,1,0,0,9
18316,kumatimakkhikamorahattho,kumatimakkhikamorahattho,1,1,0,0,24
18317,ākaḍḍhano,akaddhano,1,1,0,0,9
18318,janavilocanamattaninnaṃ,janavilocanamattaninnam,1,1,0,0,23
18319,vāretu,varetu,2,2,0,0,6
18320,sabbagativāranamaṅkuso,sabbagativaranamankuso,1,1,0,0,22
18321,pādambujassirivilāsaniketanaṃ,padambujassirivilasaniketanam,1,1,0,0,29
18322,pāsādalakhaṇamupetu,pasadalakhanamupetu,1,1,0,0,19
18323,manopasādaṃ,manopasadam,1,1,0,0,11
18324,pāṇīnamattabhajataṃ,paninamattabhajatam,1,1,0,0,19
18325,varapuṇṇapattaṃ,varapunnapattam,1,1,0,0,15
18326,padanissitapuṇṇapatto,padanissitapunnapatto,1,1,0,0,21
18327,pādesu,padesu,314,306,8,0,6
18328,manabandhanadāmabhūtaṃ,manabandhanadamabhutam,1,1,0,0,22
18329,dāmaṃ,damam,19,17,2,0,5
18330,dametu,dametu,1,1,0,0,6
18331,janatammanāni,janatammanani,1,1,0,0,13
18332,uṇhīsakuppalamaṇīpadumehi,unhisakuppalamanipadumehi,1,1,0,0,25
18333,sassevijantukaraṇāni,sassevijantukaranani,1,1,0,0,20
18334,vibhūsayantu,vibhusayantu,1,1,0,0,12
18335,sannettanāvupagatānamanagghakāni,sannettanavupagatanamanagghakani,1,1,0,0,32
18336,bojjhaṅgasattaratanāni,bojjhangasattaratanani,1,1,0,0,22
18337,dade,dade,55,53,2,0,4
18338,uttuṅga,uttunga,2,2,0,0,7
18339,niccalaguṅā,niccalaguna,1,1,0,0,11
18340,jitatāya,jitataya,1,1,0,0,8
18341,sevīva,seviva,1,1,0,0,6
18342,pādasiri,padasiri,1,1,0,0,8
18343,nicca,nicca,25,22,3,0,5
18344,samubbahaṃ,samubbaham,3,3,0,0,10
18345,atrāpi,atrapi,11,11,0,0,6
18346,sakkabhavanubbahaṇe,sakkabhavanubbahane,1,1,0,0,19
18347,niyutto,niyutto,220,174,46,0,7
18348,pādaṭṭhameru,padatthameru,1,1,0,0,12
18349,bhavataṃ,bhavatam,93,91,2,0,8
18350,vibhūtyā,vibhutya,1,1,0,0,8
18351,cakkavāḷasikharī,cakkavalasikhari,1,1,0,0,16
18352,pyavataṃ,pyavatam,1,1,0,0,8
18353,sabbūpasaggavisarājanataṃ,sabbupasaggavisarajanatam,1,1,0,0,25
18354,samaggaṃ,samaggam,114,92,22,0,8
18355,puthūpi,puthupi,5,5,0,0,7
18356,dvisahassa,dvisahassa,1,1,0,0,10
18357,khuddā,khudda,17,15,2,0,6
18358,dhārentvapāyapatamānamadatva,dharentvapayapatamanamadatva,1,1,0,0,28
18359,jantuṃ,jantum,37,32,5,0,6
18360,pabodhayatu,pabodhayatu,1,1,0,0,11
18361,saroruhāni,saroruhani,1,1,0,0,10
18362,kumudāni,kumudani,25,21,4,0,8
18363,manodahesu,manodahesu,3,3,0,0,10
18364,nakkhattajātamakhilaṃ,nakkhattajatamakhilam,1,1,0,0,21
18365,subhatāya,subhataya,1,1,0,0,9
18366,ripujayāya,ripujayaya,1,1,0,0,10
18367,jayaddhajāya,jayaddhajaya,1,1,0,0,12
18368,sasaṃsadasudassanacakkavatti,sasamsadasudassanacakkavatti,1,1,0,0,28
18369,cakkānugantalalitaṃ,cakkanugantalalitam,1,1,0,0,19
18370,yahimāvaheyya,yahimavaheyya,1,1,0,0,13
18371,cakkāṇuvatti,cakkanuvatti,1,1,0,0,12
18372,parisāvatacakkavatti,parisavatacakkavatti,1,1,0,0,20
18373,naṃvattataṃ,namvattatam,1,1,0,0,11
18374,pujetumāgata,pujetumagata,1,1,0,0,12
18375,vatā,vata,24,13,11,0,4
18376,vajirāsanaṭṭha,vajirasanattha,1,1,0,0,14
18377,mindena,mindena,2,2,0,0,7
18378,chaḍḍita,chaddita,1,1,0,0,8
18379,mahāvijayuttarākhyaṃ,mahavijayuttarakhyam,1,1,0,0,20
18380,saṃkhaṃ,samkham,1,1,0,0,7
18381,paviṭṭhamiva,pavitthamiva,1,1,0,0,12
18382,mārabhayā,marabhaya,1,1,0,0,9
18383,padādho,padadho,1,1,0,0,7
18384,pādaṭṭhasaṃkhamiha,padatthasamkhamiha,1,1,0,0,18
18385,vattatu,vattatu,4,4,0,0,7
18386,santiyā,santiya,18,17,1,0,7
18387,sovaṇṇamacchayugalaṃ,sovannamacchayugalam,1,1,0,0,20
18388,sivabhatta,sivabhatta,1,1,0,0,10
18389,bahūpakaraṇaṃ,bahupakaranam,1,1,0,0,13
18390,kumbhīladhiggahitato,kumbhiladhiggahitato,1,1,0,0,20
18391,padutthacittā,padutthacitta,1,1,0,0,13
18392,pādambujākara,padambujakara,1,1,0,0,13
18393,vigāhi,vigahi,1,1,0,0,6
18394,nopahontu,nopahontu,1,1,0,0,9
18395,sattāpagā,sattapaga,2,2,0,0,9
18396,janamanoja,janamanoja,1,1,0,0,10
18397,jahantu,jahantu,3,3,0,0,7
18398,saṃklesadāhamapanentu,samklesadahamapanentu,1,1,0,0,21
18399,dahā,daha,9,8,1,0,4
18400,selā,sela,63,60,3,0,4
18401,vidadhantu,vidadhantu,1,1,0,0,10
18402,tānaṃ,tanam,4,4,0,0,5
18403,lokappasiddhijanane,lokappasiddhijanane,1,1,0,0,19
18404,patākā,pataka,3,3,0,0,6
18405,pāṭaṅki,patanki,1,1,0,0,7
18406,bhavatūpakārā,bhavatupakara,1,1,0,0,13
18407,dāhettanesu,dahettanesu,1,1,0,0,11
18408,jahataṃ,jahatam,1,1,0,0,7
18409,padacāmaraṃ,padacamaram,1,1,0,0,11
18410,sallokalocanamahussavaussitaṃ,sallokalocanamahussavaussitam,1,1,0,0,29
18411,vatteyya,vatteyya,69,69,0,0,8
18412,toraṇamanuttaramaṅgalāya,toranamanuttaramangalaya,1,1,0,0,24
18413,miginda,miginda,1,1,0,0,7
18414,bhīti,bhiti,9,7,2,0,5
18415,balāva,balava,1,1,0,0,6
18416,daḍḍha,daddha,1,1,0,0,6
18417,natā,nata,11,10,1,0,4
18418,siravidāraṇa,siravidarana,1,1,0,0,12
18419,pīḷitāva,pilitava,1,1,0,0,8
18420,nālāgirī,nalagiri,1,1,0,0,8
18421,karivaro,karivaro,3,3,0,0,8
18422,sīhavikkamapadaṃ,sihavikkamapadam,1,1,0,0,16
18423,hanatā,hanata,1,1,0,0,6
18424,ghadantiṃ,ghadantim,1,1,0,0,9
18425,pāpāhino,papahino,1,1,0,0,8
18426,hanatu,hanatu,6,6,0,0,6
18427,pādasuvaṇṇarājā,padasuvannaraja,1,1,0,0,15
18428,vyagghādhipo,vyagghadhipo,1,1,0,0,12
18429,kalijane,kalijane,1,1,0,0,8
18430,adataṃ,adatam,1,1,0,0,6
18431,vālāhaassapati,valahaassapati,1,1,0,0,14
18432,sampatituṃ,sampatitum,1,1,0,0,10
18433,pāyesu,payesu,3,3,0,0,6
18434,pāpayatu,papayatu,2,2,0,0,8
18435,santipurampajāyo,santipurampajayo,1,1,0,0,16
18436,danti,danti,9,6,3,0,5
18437,galitaṃ,galitam,4,4,0,0,7
18438,rusamhā,rusamha,1,1,0,0,7
18439,luddetta,luddetta,1,1,0,0,8
18440,dubbhini,dubbhini,1,1,0,0,8
18441,dise,dise,4,3,1,0,4
18442,acalaṃ,acalam,124,108,16,0,6
18443,dadhāno,dadhano,1,1,0,0,7
18444,pādaṭṭhahatthipati,padatthahatthipati,1,1,0,0,18
18445,jantutāse,jantutase,1,1,0,0,9
18446,tāsetu,tasetu,1,1,0,0,6
18447,hāsamaparandisataṃ,hasamaparandisatam,1,1,0,0,18
18448,satānaṃ,satanam,66,62,4,0,7
18449,sabbaṅgino,sabbangino,1,1,0,0,10
18450,caraṇuposatha,caranuposatha,1,1,0,0,13
18451,pāpetu,papetu,5,5,0,0,6
18452,sabbacatudīpikarajjalakkhiṃ,sabbacatudipikarajjalakkhim,1,1,0,0,27
18453,kittīva,kittiva,2,2,0,0,7
18454,pādaparicārikatā,padaparicarikata,1,1,0,0,16
18455,niyuttā,niyutta,72,72,0,0,7
18456,kelasaselapaṭimā,kelasaselapatima,1,1,0,0,16
18457,hitamācareyya,hitamacareyya,1,1,0,0,13
18458,sāmissa,samissa,3,3,0,0,7
18459,haṃsasamaye,hamsasamaye,1,1,0,0,11
18460,dahapāsabaddha,dahapasabaddha,1,1,0,0,14
18461,māsīna,masina,1,1,0,0,6
18462,vesagamako,vesagamako,1,1,0,0,10
18463,pādahaṃso,padahamso,1,1,0,0,9
18464,nigghosa,nigghosa,2,2,0,0,8
18465,gantijitato,gantijitato,1,1,0,0,11
18466,mūgapakkho,mugapakkho,9,9,0,0,10
18467,yāretu,yaretu,1,1,0,0,6
18468,bhavagantukattaṃ,bhavagantukattam,1,1,0,0,16
18469,dibbasarasiṃ,dibbasarasim,1,1,0,0,12
18470,khilaloka,khilaloka,1,1,0,0,9
18471,rammaṅghivāpimavagāhitavāva,rammanghivapimavagahitavava,1,1,0,0,27
18472,erāvaṇo,eravano,30,25,5,0,7
18473,manasābhiruḷhe,manasabhirulhe,1,1,0,0,14
18474,purindadapuraṃ,purindadapuram,1,1,0,0,14
18475,nayataṃ,nayatam,1,1,0,0,7
18476,sakambhavanamaṅghinisevanattha,sakambhavanamanghinisevanattha,1,1,0,0,30
18477,māgamma,magamma,11,11,0,0,7
18478,ramma,ramma,9,5,4,0,5
18479,taratāyiha,taratayiha,1,1,0,0,10
18480,nissito,nissito,121,99,22,0,7
18481,pāletva,paletva,2,2,0,0,7
18482,mūni,muni,1,1,0,0,4
18483,padavāpitaraṅgabhaṅgi,padavapitarangabhangi,1,1,0,0,21
18484,mangī,mangi,1,1,0,0,5
18485,karontatanuvāsuki,karontatanuvasuki,1,1,0,0,17
18486,kañcanasikhāvalajātilīla,kancanasikhavalajatilila,1,1,0,0,24
18487,māvikaraṃ,mavikaram,1,1,0,0,9
18488,padanissitamorarājā,padanissitamoraraja,1,1,0,0,19
18489,dhammadesanaraveniva,dhammadesanaraveniva,1,1,0,0,20
18490,luddakassa,luddakassa,12,12,0,0,10
18491,pāpaphaṇino,papaphanino,1,1,0,0,11
18492,hanataṃ,hanatam,2,2,0,0,7
18493,saṃsārasāgaragate,samsarasagaragate,1,1,0,0,17
18494,sadhane,sadhane,12,11,1,0,7
18495,netampade,netampade,1,1,0,0,9
18496,kalacatummukhahemanāvā,kalacatummukhahemanava,1,1,0,0,22
18497,nibbāṇapaṭṭanavaraṃ,nibbanapattanavaram,1,1,0,0,19
18498,bharukacchakantaṃ,bharukacchakantam,1,1,0,0,17
18499,suppārapaṇḍita,supparapandita,1,1,0,0,14
18500,āsunāvā,asunava,1,1,0,0,7
18501,sambodhi,sambodhi,62,56,6,0,8
18502,paripācayato,paripacayato,1,1,0,0,12
18503,munissa,munissa,12,12,0,0,7
18504,himavataddi,himavataddi,1,1,0,0,11
18505,samādhihetu,samadhihetu,1,1,0,0,11
18506,evammanena,evammanena,1,1,0,0,10
18507,bhajataṃ,bhajatam,5,5,0,0,8
18508,himavaddipāde,himavaddipade,1,1,0,0,13
18509,sambodhiñāṇa,sambodhinana,1,1,0,0,12
18510,paripācanahetu,paripacanahetu,1,1,0,0,14
18511,parājitatayā,parajitataya,1,1,0,0,12
18512,muninā,munina,90,82,8,0,6
18513,suññassaropagata,sunnassaropagata,1,1,0,0,16
18514,pañjara,panjara,2,2,0,0,7
18515,bandhanova,bandhanova,1,1,0,0,10
18516,pādapañjaragato,padapanjaragato,1,1,0,0,15
18517,karavīkapakkhī,karavikapakkhi,1,1,0,0,14
18518,sabbesamappīyāvacañjahatā,sabbesamappiyavacanjahata,1,1,0,0,25
18519,bhavantaṃ,bhavantam,331,317,14,0,9
18520,cakkavāka,cakkavaka,11,10,1,0,9
18521,makarā,makara,16,16,0,0,6
18522,koñca,konca,5,3,2,0,5
18523,jīvaṃ,jivam,416,371,45,0,5
18524,jīvādi,jivadi,3,3,0,0,6
18525,pakkhivisarā,pakkhivisara,1,1,0,0,12
18526,sarasīva,sarasiva,1,1,0,0,8
18527,bhuttaṃ,bhuttam,124,118,6,0,7
18528,vessantarena,vessantarena,22,22,0,0,12
18529,caraṇambuji,caranambuji,1,1,0,0,11
18530,nibbhajantā,nibbhajanta,1,1,0,0,11
18531,suramentu,suramentu,1,1,0,0,9
18532,candakinnaragatiṃva,candakinnaragatimva,1,1,0,0,19
18533,sapajāpatikassa,sapajapatikassa,5,5,0,0,15
18534,saṃsūcayanta,samsucayanta,1,1,0,0,12
18535,kinnara,kinnara,4,4,0,0,7
18536,sāmaggimagga,samaggimagga,1,1,0,0,12
18537,paṭi,pati,1056,1041,15,0,4
18538,pattisu,pattisu,3,3,0,0,7
18539,pāpayantu,papayantu,2,2,0,0,9
18540,saṃrājadhānimusabho,samrajadhanimusabho,1,1,0,0,19
18541,vahatagga,vahatagga,1,1,0,0,9
18542,pītippayo,pitippayo,1,1,0,0,9
18543,pajanayeyya,pajanayeyya,1,1,0,0,11
18544,savacchadhenu,savacchadhenu,1,1,0,0,13
18545,sassevino,sassevino,1,1,0,0,9
18546,abhiramentu,abhiramentu,1,1,0,0,11
18547,chakāmasaggā,chakamasagga,1,1,0,0,12
18548,dhārentu,dharentu,6,6,0,0,8
18549,jhāyimiha,jhayimiha,1,1,0,0,9
18550,dhātudhāmā,dhatudhama,1,1,0,0,10
18551,karavīka,karavika,2,2,0,0,8
18552,sarammanuññaṃ,sarammanunnam,1,1,0,0,13
18553,aññoñña,annonna,1,1,0,0,7
18554,bhītirahitā,bhitirahita,1,1,0,0,11
18555,paccanīkā,paccanika,12,12,0,0,9
18556,padasattarūpā,padasattarupa,1,1,0,0,13
18557,bhavassita,bhavassita,1,1,0,0,10
18558,janānagatiṃ,jananagatim,1,1,0,0,11
18559,hanantu,hanantu,11,11,0,0,7
18560,kāhaḷa,kahala,1,1,0,0,6
18561,yugo,yugo,25,23,2,0,4
18562,pamamindirāya,pamamindiraya,1,1,0,0,13
18563,sannīrapuppha,sannirapuppha,1,1,0,0,13
18564,mukulopamamussavāya,mukulopamamussavaya,1,1,0,0,19
18565,tiṭṭhatante,titthatante,1,1,0,0,11
18566,jaṅghādvayaṃ,janghadvayam,1,1,0,0,12
18567,janavilocana,janavilocana,1,1,0,0,12
18568,lakhyā,lakhya,1,1,0,0,6
18569,vilāsa,vilasa,4,3,1,0,6
18570,mukuradvaya,mukuradvaya,1,1,0,0,11
18571,sannikāsaṃ,sannikasam,2,2,0,0,10
18572,tāḍaṅka,tadanka,1,1,0,0,7
18573,maṇḍana,mandana,4,4,0,0,7
18574,viḍambakamaṃsu,vidambakamamsu,1,1,0,0,14
18575,saṇḍaṃ,sandam,4,3,1,0,6
18576,jānudvayaṃ,janudvayam,1,1,0,0,10
18577,laḷita,lalita,1,1,0,0,6
18578,sāgara,sagara,8,8,0,0,6
18579,bubbalābhaṃ,bubbalabham,1,1,0,0,11
18580,hotaṃ,hotam,9,9,0,0,5
18581,jagattaya,jagattaya,1,1,0,0,9
18582,nijatta,nijatta,1,1,0,0,7
18583,vibhūsitunte,vibhusitunte,1,1,0,0,12
18584,chaddanti,chaddanti,1,1,0,0,9
18585,dinna,dinna,22,11,11,0,5
18586,varadanta,varadanta,1,1,0,0,9
18587,yugopamānā,yugopamana,1,1,0,0,10
18588,soṇḍa,sonda,2,1,1,0,5
18589,kama,kama,15,13,2,0,4
18590,tavorū,tavoru,1,1,0,0,6
18591,līla,lila,1,1,0,0,4
18592,payodhi,payodhi,2,2,0,0,7
18593,siri,siri,21,20,1,0,4
18594,keḷi,keli,11,10,1,0,4
18595,suvaṇṇarambhā,suvannarambha,1,1,0,0,13
18596,khandhāva,khandhava,17,16,1,0,9
18597,dentu,dentu,46,45,1,0,5
18598,gune,gune,1,1,0,0,4
18599,janānāṃ,jananam,1,1,0,0,7
18600,jaṅghakkha,janghakkha,1,1,0,0,10
18601,kadvya,kadvya,1,1,0,0,6
18602,samappita,samappita,1,1,0,0,9
18603,cittapāda,cittapada,1,1,0,0,9
18604,cakkadvayī,cakkadvayi,1,1,0,0,10
18605,manamanojahayo,manamanojahayo,1,1,0,0,14
18606,sonī,soni,1,1,0,0,4
18607,ratho,ratho,243,231,12,0,5
18608,sirivaho,sirivaho,1,1,0,0,8
18609,bhiruḷhaṃ,bhirulham,1,1,0,0,9
18610,lokattayaṃ,lokattayam,8,8,0,0,10
18611,sivapuraṃ,sivapuram,2,2,0,0,9
18612,pāpayātu,papayatu,4,4,0,0,8
18613,rammora,rammora,1,1,0,0,7
18614,pākaṭa,pakata,6,6,0,0,6
18615,taṭāka,tataka,1,1,0,0,6
18616,taṭā,tata,1,1,0,0,4
18617,savanta,savanta,1,1,0,0,7
18618,romāvalī,romavali,1,1,0,0,8
18619,jala,jala,25,15,10,0,4
18620,panālika,panalika,1,1,0,0,8
18621,koṭikaṭṭhā,kotikattha,1,1,0,0,10
18622,nābhī,nabhi,6,6,0,0,5
18623,gabhīra,gabhira,2,2,0,0,7
18624,sarasī,sarasi,15,14,1,0,6
18625,keḷitā,kelita,1,1,0,0,6
18626,sassevinaṃ,sassevinam,1,1,0,0,10
18627,vyasana,vyasana,2,2,0,0,7
18628,ghammamalaṃ,ghammamalam,1,1,0,0,11
18629,sametu,sametu,13,13,0,0,6
18630,kanticchaṭā,kanticchata,1,1,0,0,11
18631,luḷita,lulita,1,1,0,0,6
18632,āvaṭṭa,avatta,2,2,0,0,6
18633,vaṭṭita,vattita,2,2,0,0,7
18634,nimujjita,nimujjita,1,1,0,0,9
18635,sabbaloko,sabbaloko,7,7,0,0,9
18636,sobhagga,sobhagga,3,2,1,0,8
18637,toya,toya,1,1,0,0,4
18638,visaso,visaso,1,1,0,0,6
18639,pivitvā,pivitva,382,374,8,0,7
18640,lokuttarādi,lokuttaradi,1,1,0,0,11
18641,sukha,sukha,59,40,19,0,5
18642,mucchitataṃ,mucchitatam,2,2,0,0,11
18643,payātu,payatu,1,1,0,0,6
18644,cittarahadaṃ,cittarahadam,1,1,0,0,12
18645,paripūrayitvā,paripurayitva,1,1,0,0,13
18646,sandamāna,sandamana,1,1,0,0,9
18647,karuṇambu,karunambu,1,1,0,0,9
18648,pavāha,pavaha,1,1,0,0,6
18649,tulyā,tulya,23,22,1,0,5
18650,romālivallihari,romalivallihari,1,1,0,0,15
18651,subhālavālā,subhalavala,1,1,0,0,11
18652,detaṃ,detam,1,1,0,0,5
18653,sivaphalaṃ,sivaphalam,2,2,0,0,10
18654,cārūra,carura,1,1,0,0,6
18655,sāriphalako,sariphalako,1,1,0,0,11
18656,kuṭilagga,kutilagga,1,1,0,0,9
18657,pantī,panti,3,3,0,0,5
18658,vibhatti,vibhatti,157,147,10,0,8
18659,sahito,sahito,43,42,1,0,6
18660,saggāpavagga,saggapavagga,1,1,0,0,12
18661,jūtaka,jutaka,2,2,0,0,6
18662,tiloka,tiloka,5,5,0,0,6
18663,soṇḍakānaṃ,sondakanam,1,1,0,0,10
18664,rahado,rahado,50,46,4,0,6
18665,gāhamāna,gahamana,1,1,0,0,8
18666,mettādayā,mettadaya,1,1,0,0,9
18667,vadhū,vadhu,43,37,6,0,5
18668,kara,kara,120,51,69,0,4
18669,sanni,sanni,4,4,0,0,5
18670,kāsā,kasa,5,5,0,0,4
18671,sabbaṅginaṃ,sabbanginam,1,1,0,0,11
18672,sākhā,sakha,191,174,17,0,5
18673,bhujā,bhuja,10,8,2,0,5
18674,dadantu,dadantu,11,11,0,0,7
18675,nihāra,nihara,1,1,0,0,6
18676,sahitaggadalopa,sahitaggadalopa,1,1,0,0,15
18677,sobhi,sobhi,4,4,0,0,5
18678,byālamba,byalamba,1,1,0,0,8
18679,ratta,ratta,8,7,1,0,5
18680,padumadvaya,padumadvaya,1,1,0,0,11
18681,bhaṅgi,bhangi,2,2,0,0,6
18682,bhājā,bhaja,1,1,0,0,5
18683,pāpārisīsalunateniva,paparisisalunateniva,1,1,0,0,20
18684,rattā,ratta,102,96,6,0,5
18685,karā,kara,45,42,3,0,4
18686,bhavumbhuvi,bhavumbhuvi,1,1,0,0,11
18687,rupassirī,rupassiri,1,1,0,0,9
18688,carita,carita,1,1,0,0,6
18689,caṅkama,cankama,1,1,0,0,7
18690,vibbhamā,vibbhama,5,5,0,0,8
18691,piṭṭhī,pitthi,7,7,0,0,6
18692,kalala,kalala,2,2,0,0,6
18693,muddhani,muddhani,130,123,7,0,8
18694,setu,setu,82,67,15,0,4
18695,bhavaṇṇava,bhavannava,2,2,0,0,10
18696,samuttaraṇāya,samuttaranaya,2,2,0,0,13
18697,hotammahākanaka,hotammahakanaka,1,1,0,0,15
18698,saṃkama,samkama,1,1,0,0,7
18699,sannikāsā,sannikasa,1,1,0,0,9
18700,desana,desana,2,2,0,0,6
18701,manohara,manohara,7,7,0,0,8
18702,bherināda,bherinada,1,1,0,0,9
18703,saṃcāraṇe,samcarane,1,1,0,0,9
18704,visituṃ,visitum,1,1,0,0,7
18705,gīvā,giva,232,213,19,0,4
18706,suvaṇṇamaya,suvannamaya,2,2,0,0,11
18707,cāru,caru,36,30,6,0,4
18708,mutiṅga,mutinga,1,1,0,0,7
18709,bheri,bheri,11,9,2,0,5
18710,bhāvambhajā,bhavambhaja,1,1,0,0,11
18711,bhūta,bhuta,35,11,24,0,5
18712,vibhūtiyā,vibhutiya,11,8,3,0,9
18713,lakhī,lakhi,2,2,0,0,5
18714,vadanambuja,vadanambuja,1,1,0,0,11
18715,matta,matta,55,6,49,0,5
18716,ninna,ninna,2,2,0,0,5
18717,mākaḍḍhayaṃ,makaddhayam,1,1,0,0,11
18718,vilocana,vilocana,5,5,0,0,8
18719,cañcarīke,cancarike,1,1,0,0,9
18720,sorabbha,sorabbha,1,1,0,0,8
18721,makaranda,makaranda,3,3,0,0,9
18722,nisandamānaṃ,nisandamanam,1,1,0,0,12
18723,piṇetu,pinetu,1,1,0,0,6
18724,sarasena,sarasena,30,27,3,0,8
18725,sabhā,sabha,74,63,11,0,5
18726,samāruhita,samaruhita,1,1,0,0,10
18727,vattarathe,vattarathe,1,1,0,0,10
18728,rathaṅga,rathanga,3,3,0,0,8
18729,dvandānu,dvandanu,1,1,0,0,8
18730,kāri,kari,1,1,0,0,4
18731,miga,miga,22,11,11,0,4
18732,rāja,raja,521,488,33,0,4
18733,kapola,kapola,1,1,0,0,6
18734,līlaṃ,lilam,4,4,0,0,5
18735,tādaṅka,tadanka,1,1,0,0,7
18736,maṇḍalayugaṃ,mandalayugam,1,1,0,0,12
18737,kaṇṇabhājaṃ,kannabhajam,1,1,0,0,11
18738,gaṇḍatthaladvyamalaṃkurutaṃ,gandatthaladvyamalamkurutam,1,1,0,0,27
18739,janatte,janatte,1,1,0,0,7
18740,lāvaṇṇa,lavanna,2,2,0,0,7
18741,maṇṇava,mannava,1,1,0,0,7
18742,pavāḷa,pavala,5,4,1,0,6
18743,dvayābhaṃ,dvayabham,1,1,0,0,9
18744,tandeha,tandeha,1,1,0,0,7
18745,taru,taru,10,9,1,0,4
18746,mantaṃ,mantam,217,209,8,0,6
18747,vattāravinda,vattaravinda,1,1,0,0,12
18748,parājisobhaṃ,parajisobham,1,1,0,0,12
18749,rattādharadvayamadho,rattadharadvayamadho,1,1,0,0,20
18750,kurutaṃ,kurutam,13,13,0,0,7
18751,janāghaṃ,janagham,1,1,0,0,8
18752,sakuntigata,sakuntigata,1,1,0,0,11
18753,matthaka,matthaka,3,3,0,0,8
18754,natthu,natthu,9,7,2,0,6
18755,kūpa,kupa,4,3,1,0,4
18756,subbhū,subbhu,4,4,0,0,6
18757,lakāra,lakara,2,2,0,0,6
18758,sahitoṭṭha,sahitottha,1,1,0,0,10
18759,gattuttararaṇṇava,gattuttararannava,1,1,0,0,17
18760,jantukānaṃ,jantukanam,1,1,0,0,10
18761,samuttaranaya,samuttaranaya,1,1,0,0,13
18762,isaṃ,isam,1,1,0,0,4
18763,vikāsa,vikasa,4,4,0,0,6
18764,padumodara,padumodara,1,1,0,0,10
18765,kesarāli,kesarali,2,2,0,0,8
18766,līlā,lila,16,11,5,0,4
18767,vinaddha,vinaddha,3,3,0,0,8
18768,rucirā,rucira,29,24,5,0,6
18769,danta,danta,12,10,2,0,5
18770,vānī,vani,1,1,0,0,4
18771,dharita,dharita,1,1,0,0,7
18772,mālati,malati,1,1,0,0,6
18773,mālya,malya,1,1,0,0,5
18774,jānassa,janassa,1,1,0,0,7
18775,manarañjana,manaranjana,1,1,0,0,11
18776,mācareyya,macareyya,1,1,0,0,9
18777,nijjhara,nijjhara,4,4,0,0,8
18778,suratta,suratta,7,3,4,0,7
18779,silātalābhā,silatalabha,1,1,0,0,11
18780,vacī,vaci,54,51,3,0,4
18781,naṭa,nata,9,4,5,0,4
18782,kala,kala,44,14,30,0,4
18783,raṅga,ranga,2,1,1,0,5
18784,seṭṭha,settha,31,31,0,0,6
18785,taraṇī,tarani,5,4,1,0,6
18786,nihitappiyā,nihitappiya,1,1,0,0,11
18787,dantaṃsu,dantamsu,1,1,0,0,8
18788,kañcukīta,kancukita,1,1,0,0,9
18789,rattadharo,rattadharo,1,1,0,0,10
18790,padhāne,padhane,39,36,3,0,7
18791,sayane,sayane,116,112,4,0,6
18792,mukha,mukha,23,13,10,0,5
18793,mandiraṭṭhe,mandiratthe,1,1,0,0,11
18794,āmokkha,amokkha,1,1,0,0,7
18795,mutti,mutti,98,86,12,0,5
18796,vadhuyā,vadhuya,24,24,0,0,7
18797,sayitāya,sayitaya,5,5,0,0,8
18798,kubbantu,kubbantu,4,4,0,0,8
18799,saṃgama,samgama,2,2,0,0,7
18800,sotu,sotu,9,9,0,0,4
18801,kāmi,kami,2,2,0,0,4
18802,tathābhinava,tathabhinava,1,1,0,0,12
18803,patta,patta,28,22,6,0,5
18804,varābhi,varabhi,1,1,0,0,7
18805,rāmā,rama,18,18,0,0,4
18806,līlollasanta,lilollasanta,1,1,0,0,12
18807,bhamukadvaya,bhamukadvaya,1,1,0,0,12
18808,ghānoru,ghanoru,1,1,0,0,7
18809,kadalī,kadali,43,35,8,0,6
18810,vadanā,vadana,2,2,0,0,6
18811,lavālā,lavala,1,1,0,0,6
18812,pavattatu,pavattatu,20,20,0,0,9
18813,bālatthalī,balatthali,1,1,0,0,10
18814,hari,hari,35,29,6,0,4
18815,silātala,silatala,1,1,0,0,8
18816,piṭṭhikaṭṭha,pitthikattha,1,1,0,0,12
18817,bhūvallaridvaya,bhuvallaridvaya,1,1,0,0,15
18818,mayūra,mayura,3,3,0,0,6
18819,yugassa,yugassa,8,8,0,0,7
18820,pañcappabhā,pancappabha,1,1,0,0,11
18821,rucira,rucira,9,7,2,0,6
18822,piccha,piccha,2,2,0,0,6
18823,yugassirīkaṃ,yugassirikam,1,1,0,0,12
18824,nettadvayaṃ,nettadvayam,1,1,0,0,11
18825,manasi,manasi,1817,1687,130,0,6
18826,puñchatu,punchatu,1,1,0,0,8
18827,pāpadhūliṃ,papadhulim,1,1,0,0,10
18828,indīvarāntagata,indivarantagata,1,1,0,0,15
18829,bhiṅgika,bhingika,1,1,0,0,8
18830,pañambujassaratate,panambujassaratate,1,1,0,0,18
18831,gacchapantī,gacchapanti,1,1,0,0,11
18832,nettambujassiri,nettambujassiri,1,1,0,0,15
18833,tirokaraṇīva,tirokaraniva,1,1,0,0,12
18834,pamhāvalī,pamhavali,1,1,0,0,9
18835,sirigateha,sirigateha,1,1,0,0,10
18836,tiro,tiro,34,27,7,0,4
18837,karontu,karontu,58,56,2,0,7
18838,vattullasambuja,vattullasambuja,1,1,0,0,15
18839,haṃsa,hamsa,31,29,2,0,5
18840,tuṇḍa,tunda,3,3,0,0,5
18841,kañjaṃsu,kanjamsu,1,1,0,0,8
18842,piñjara,pinjara,3,1,2,0,7
18843,mulāla,mulala,1,1,0,0,6
18844,dvyābhaṃ,dvyabham,1,1,0,0,8
18845,dolādvayaṃva,doladvayamva,1,1,0,0,12
18846,savaṇadvyamatta,savanadvyamatta,1,1,0,0,15
18847,lakkhyā,lakkhya,10,9,1,0,7
18848,tavajja,tavajja,17,13,4,0,7
18849,maticārahetu,maticarahetu,1,1,0,0,12
18850,vammīka,vammika,1,1,0,0,7
18851,sayānaka,sayanaka,1,1,0,0,8
18852,bhūridatta,bhuridatta,8,7,1,0,10
18853,bhoginda,bhoginda,1,1,0,0,8
18854,bhogavali,bhogavali,1,1,0,0,9
18855,vibbhamamā,vibbhamama,1,1,0,0,10
18856,vahanti,vahanti,42,38,4,0,7
18857,ghānopariṭṭhitamune,ghanoparitthitamune,1,1,0,0,19
18858,tuṇṇamuṇṇā,tunnamunna,1,1,0,0,10
18859,taggāhino,taggahino,1,1,0,0,9
18860,rūpindirāya,rupindiraya,2,2,0,0,11
18861,vijaye,vijaye,4,4,0,0,6
18862,khila,khila,3,3,0,0,5
18863,ghāṇoru,ghanoru,2,2,0,0,7
18864,parighopari,parighopari,1,1,0,0,11
18865,baddha,baddha,8,7,1,0,6
18866,siddhā,siddha,242,230,12,0,6
18867,nīlābha,nilabha,1,1,0,0,7
18868,viluthanta,viluthanta,1,1,0,0,10
18869,vayaddhajābhā,vayaddhajabha,1,1,0,0,13
18870,tiṭṭhantu,titthantu,80,74,6,0,9
18871,sajja,sajja,11,6,5,0,5
18872,duritāri,duritari,1,1,0,0,8
18873,jayāya,jayaya,1,1,0,0,6
18874,uṇṇassitopala,unnassitopala,1,1,0,0,13
18875,nivesita,nivesita,1,1,0,0,8
18876,bunda,bunda,1,1,0,0,5
18877,piṇḍakamaghā,pindakamagha,1,1,0,0,12
18878,tapa,tapa,30,10,20,0,4
18879,rundhitunte,rundhitunte,1,1,0,0,11
18880,hotammukhambuja,hotammukhambuja,1,1,0,0,15
18881,sirasussitābhaṃ,sirasussitabham,1,1,0,0,15
18882,paṭṭika,pattika,1,1,0,0,7
18883,lalāta,lalata,1,1,0,0,6
18884,rupaṅka,rupanka,1,1,0,0,7
18885,bāna,bana,1,1,0,0,4
18886,diṭṭhī,ditthi,61,43,18,0,6
18887,dhārā,dhara,50,48,2,0,5
18888,nisāna,nisana,3,3,0,0,6
18889,maṇivaṭṭa,manivatta,1,1,0,0,9
18890,siro,siro,83,72,11,0,4
18891,matosadha,matosadha,1,1,0,0,9
18892,katañjana,katanjana,1,1,0,0,9
18893,puñja,punja,3,2,1,0,5
18894,lakkhī,lakkhi,32,26,6,0,6
18895,nayanāmaya,nayanamaya,1,1,0,0,10
18896,nāsanāya,nasanaya,2,2,0,0,8
18897,sakkhandha,sakkhandha,1,1,0,0,10
18898,bāhuyuga,bahuyuga,1,1,0,0,8
18899,torana,torana,1,1,0,0,6
18900,dharappitassirighato,dharappitassirighato,1,1,0,0,20
18901,pari,pari,636,595,41,0,4
18902,mussavāya,mussavaya,1,1,0,0,9
18903,nīluppalāva,niluppalava,1,1,0,0,11
18904,savibhatti,savibhatti,2,1,1,0,10
18905,kesā,kesa,374,345,29,0,4
18906,bhavantu,bhavantu,70,66,4,0,8
18907,bhuvanattaya,bhuvanattaya,2,2,0,0,12
18908,hemagghiye,hemagghiye,1,1,0,0,10
18909,silā,sila,103,98,5,0,4
18910,kapāle,kapale,41,41,0,0,6
18911,pajjota,pajjota,2,2,0,0,7
18912,jāla,jala,7,6,1,0,4
18913,sārayantī,sarayanti,1,1,0,0,9
18914,rūpassirī,rupassiri,1,1,0,0,9
18915,sirasi,sirasi,111,109,2,0,6
18916,bhūsita,bhusita,2,1,1,0,7
18917,hema,hema,8,7,1,0,4
18918,mālā,mala,113,95,18,0,4
18919,kārā,kara,52,48,4,0,4
18920,karotu,karotu,109,107,2,0,6
18921,ketu,ketu,50,44,6,0,4
18922,bhyāmappabhāli,bhyamappabhali,1,1,0,0,14
18923,mora,mora,7,7,0,0,4
18924,surodaye,surodaye,1,1,0,0,8
18925,vitata,vitata,3,3,0,0,6
18926,candaka,candaka,1,1,0,0,7
18927,cakkalakkhī,cakkalakkhi,1,1,0,0,11
18928,meghāvanaddha,meghavanaddha,1,1,0,0,13
18929,sikharunnata,sikharunnata,1,1,0,0,12
18930,yantindacāpa,yantindacapa,1,1,0,0,12
18931,vikatīva,vikativa,1,1,0,0,8
18932,paṇidhito,panidhito,3,2,1,0,9
18933,dāna,dana,30,25,5,0,4
18934,nekkhamma,nekkhamma,8,8,0,0,9
18935,pañña,panna,2,2,0,0,5
18936,viriyakkhama,viriyakkhama,1,1,0,0,12
18937,saccadhiṭṭhā,saccadhittha,1,1,0,0,12
18938,upekkhiti,upekkhiti,1,1,0,0,9
18939,pūratova,puratova,2,2,0,0,8
18940,pūrentu,purentu,19,19,0,0,7
18941,janatānamatte,janatanamatte,1,1,0,0,13
18942,pattuttaruttaradasā,pattuttaruttaradasa,1,1,0,0,19
18943,paṇidhāna,panidhana,1,1,0,0,9
18944,bījā,bija,6,5,1,0,4
18945,cetoradharāya,cetoradharaya,1,1,0,0,13
18946,sekha,sekha,1,1,0,0,5
18947,phaladā,phalada,1,1,0,0,7
18948,vāṭa,vata,2,2,0,0,4
18949,guttā,gutta,32,29,3,0,5
18950,samphalandisatu,samphalandisatu,1,1,0,0,15
18951,ābodhi,abodhi,1,1,0,0,6
18952,puṇṇami,punnami,1,1,0,0,7
18953,padiṭṭha,padittha,2,2,0,0,8
18954,dinādito,dinadito,1,1,0,0,8
18955,sambhāra,sambhara,4,4,0,0,8
18956,sita,sita,9,4,5,0,4
18957,pakkha,pakkha,6,5,1,0,6
18958,kamābhi,kamabhi,1,1,0,0,7
18959,sampuṇṇa,sampunna,4,4,0,0,8
18960,guṇāmataraṃsi,gunamataramsi,1,1,0,0,13
18961,taṃva,tamva,12,9,3,0,5
18962,sabbaṅgi,sabbangi,1,1,0,0,8
18963,kunda,kunda,4,4,0,0,5
18964,pabodhayeyya,pabodhayeyya,1,1,0,0,12
18965,āpacchimabbhava,apacchimabbhava,1,1,0,0,15
18966,sivapphala,sivapphala,1,1,0,0,10
18967,lābha,labha,17,10,7,0,5
18968,dānappabandhamapidāna,danappabandhamapidana,1,1,0,0,21
18969,phalappabhandaṃ,phalappabhandam,1,1,0,0,15
18970,saṃvaḍḍhayi,samvaddhayi,1,1,0,0,11
18971,abhipatthanato,abhipatthanato,1,1,0,0,14
18972,yathevaṃ,yathevam,3,2,1,0,8
18973,jantuttaruttara,jantuttaruttara,1,1,0,0,15
18974,sambhunantu,sambhunantu,1,1,0,0,11
18975,ārambhatoppabhuti,arambhatoppabhuti,1,1,0,0,17
18976,tavaggamaggā,tavaggamagga,1,1,0,0,12
18977,vikkhālita,vikkhalita,1,1,0,0,10
18978,ghakalusaṃ,ghakalusam,1,1,0,0,10
18979,toyaṃ,toyam,31,28,3,0,5
18980,madhura,madhura,9,8,1,0,7
18981,sītalatāyupetaṃ,sitalatayupetam,1,1,0,0,15
18982,sodhetu,sodhetu,3,3,0,0,7
18983,tvaṃva,tvamva,1,1,0,0,6
18984,nissita,nissita,3,3,0,0,7
18985,āpaccimattamabhinikkhamanābhiyogā,apaccimattamabhinikkhamanabhiyoga,1,1,0,0,33
18986,tampabhavato,tampabhavato,1,1,0,0,12
18987,gehā,geha,81,77,4,0,4
18988,gahato,gahato,4,4,0,0,6
18989,nikkhamittho,nikkhamittho,1,1,0,0,12
18990,dukhā,dukha,40,36,4,0,5
18991,nikkhamantu,nikkhamantu,4,4,0,0,11
18992,ekaggato,ekaggato,1,1,0,0,8
18993,pala,pala,12,3,9,0,4
18994,nisitā,nisita,5,5,0,0,6
18995,cirandhi,cirandhi,1,1,0,0,8
18996,sucittu,sucittu,1,1,0,0,7
18997,sutale,sutale,1,1,0,0,6
18998,daṇḍa,danda,9,4,5,0,5
18999,baddhe,baddhe,34,34,0,0,6
19000,nibbijjhi,nibbijjhi,1,1,0,0,9
19001,dhanuṭṭhiti,dhanutthiti,1,1,0,0,11
19002,lakkhaṃ,lakkham,58,53,5,0,7
19003,tayonamanu,tayonamanu,1,1,0,0,10
19004,vijjhatu,vijjhatu,4,4,0,0,8
19005,nidhiṃ,nidhim,84,75,9,0,6
19006,caturiha,caturiha,1,1,0,0,8
19007,bāhu,bahu,15,14,1,0,4
19008,sattīhi,sattihi,27,27,0,0,7
19009,suttari,suttari,1,1,0,0,7
19010,janakova,janakova,3,2,1,0,8
19011,sindhuṃ,sindhum,5,5,0,0,7
19012,vikkama,vikkama,12,11,1,0,7
19013,phalosi,phalosi,1,1,0,0,7
19014,casova,casova,1,1,0,0,6
19015,viriyatapphalame,viriyatapphalame,1,1,0,0,16
19016,dhayantu,dhayantu,1,1,0,0,8
19017,paradha,paradha,1,1,0,0,7
19018,dahanesu,dahanesu,1,1,0,0,8
19019,sudhantaṃ,sudhantam,3,3,0,0,9
19020,samantimattā,samantimatta,1,1,0,0,12
19021,parādhamasahi,paradhamasahi,1,1,0,0,13
19022,tvaṃasayhamevaṃ,tvamasayhamevam,1,1,0,0,15
19023,janāpi,janapi,4,4,0,0,6
19024,khamanena,khamanena,4,4,0,0,9
19025,bhajantu,bhajantu,7,7,0,0,8
19026,lakkhādhikaṃ,lakkhadhikam,3,3,0,0,12
19027,catura,catura,1,1,0,0,6
19028,saṃkhiya,samkhiya,1,1,0,0,8
19029,kappa,kappa,59,20,39,0,5
19030,vācino,vacino,1,1,0,0,6
19031,phusitāya,phusitaya,1,1,0,0,9
19032,visuddha,visuddha,5,3,2,0,8
19033,vacanā,vacana,48,42,6,0,6
19034,ādinna,adinna,2,1,1,0,6
19035,mahiyatthira,mahiyatthira,1,1,0,0,12
19036,suppatiṭṭhā,suppatittha,2,2,0,0,11
19037,dhiṭṭhāna,dhitthana,3,2,1,0,9
19038,vajiraddi,vajiraddi,1,1,0,0,9
19039,sattena,sattena,39,39,0,0,7
19040,yathāhi,yathahi,15,14,1,0,7
19041,abhejja,abhejja,2,2,0,0,7
19042,nejjo,nejjo,1,1,0,0,5
19043,adhiṭṭha,adhittha,1,1,0,0,8
19044,hantu,hantu,18,15,3,0,5
19045,cirabhāvita,cirabhavita,1,1,0,0,11
19046,metta,metta,4,4,0,0,5
19047,toyehi,toyehi,2,2,0,0,6
19048,saṃsamita,samsamita,1,1,0,0,9
19049,kodha,kodha,32,22,10,0,5
19050,hutāso,hutaso,4,3,1,0,6
19051,taditaraṃ,taditaram,4,4,0,0,9
19052,hitamāvahittho,hitamavahittho,1,1,0,0,14
19053,hitamāvahantū,hitamavahantu,1,1,0,0,13
19054,mittopakāra,mittopakara,1,1,0,0,11
19055,paṭipakkha,patipakkha,6,6,0,0,10
19056,janāpakāre,janapakare,1,1,0,0,10
19057,nibbikāra,nibbikara,1,1,0,0,9
19058,cirabhāvanāya,cirabhavanaya,1,1,0,0,13
19059,pattosilābha,pattosilabha,1,1,0,0,12
19060,pabhutaṭṭusu,pabhutattusu,1,1,0,0,12
19061,nibbikāraṃ,nibbikaram,19,17,2,0,10
19062,janānunaya,jananunaya,1,1,0,0,10
19063,kopa,kopa,3,2,1,0,4
19064,nudā,nuda,2,1,1,0,4
19065,tusite,tusite,35,34,1,0,6
19066,navabhippadavī,navabhippadavi,1,1,0,0,14
19067,vādhiparamidhirohiniyā,vadhiparamidhirohiniya,1,1,0,0,22
19068,tiloko,tiloko,1,1,0,0,6
19069,ārohatu,arohatu,2,2,0,0,7
19070,padavī,padavi,4,3,1,0,6
19071,tvaṃverahaṃsi,tvamverahamsi,1,1,0,0,13
19072,samabujjhi,samabujjhi,1,1,0,0,10
19073,yathāca,yathaca,19,19,0,0,7
19074,vijja,vijja,3,3,0,0,5
19075,sugatosi,sugatosi,1,1,0,0,8
19076,vido,vido,3,3,0,0,4
19077,purisadammasusārathī,purisadammasusarathi,1,1,0,0,20
19078,si,si,531,348,183,0,2
19079,satthāsi,satthasi,1,1,0,0,8
19080,bujjhi,bujjhi,126,125,1,0,6
19081,saccitta,saccitta,1,1,0,0,8
19082,nidahitaṃ,nidahitam,9,9,0,0,9
19083,kalyāṇavaṇṇaratanaṇṇavajātibhinnaṃ,kalyanavannaratanannavajatibhinnam,1,1,0,0,34
19084,dukkhaggi,dukkhaggi,1,1,0,0,9
19085,cora,cora,4,4,0,0,4
19086,jalupaddutajāti,jalupaddutajati,1,1,0,0,15
19087,gehe,gehe,950,940,10,0,4
19088,jīvitumāpadāya,jivitumapadaya,1,1,0,0,14
19089,vicitta,vicitta,4,4,0,0,7
19090,tantu,tantu,10,9,1,0,5
19091,gataṅgi,gatangi,1,1,0,0,7
19092,kaṇṭhe,kanthe,100,92,8,0,6
19093,svā,sva,11,9,2,0,3
19094,mutta,mutta,6,4,2,0,5
19095,sagguṇa,sagguna,1,1,0,0,7
19096,ratanā,ratana,25,20,5,0,6
19097,valī,vali,6,6,0,0,4
19098,vevaṇṇi,vevanni,1,1,0,0,7
19099,yattani,yattani,1,1,0,0,7
19100,sakalampahāya,sakalampahaya,1,1,0,0,13
19101,hotañjanassa,hotanjanassa,1,1,0,0,12
19102,saṅgama,sangama,2,2,0,0,7
19103,sagguṇatthava,saggunatthava,1,1,0,0,13
19104,dahaṭṭha,dahattha,1,1,0,0,8
19105,sutippanāli,sutippanali,1,1,0,0,11
19106,nissandamāna,nissandamana,1,1,0,0,12
19107,guṇanīra,gunanira,1,1,0,0,8
19108,nipāna,nipana,1,1,0,0,6
19109,tinte,tinte,6,6,0,0,5
19110,khettetta,khettetta,1,1,0,0,9
19111,saññini,sannini,1,1,0,0,7
19112,bījankurī,bijankuri,1,1,0,0,9
19113,labhantu,labhantu,25,24,1,0,8
19114,āpāyikappabhuti,apayikappabhuti,1,1,0,0,15
19115,dukkha,dukkha,58,48,10,0,6
19116,nidāgha,nidagha,3,3,0,0,7
19117,santāpitā,santapita,7,7,0,0,9
19118,nikhila,nikhila,4,3,1,0,7
19119,kadambā,kadamba,14,14,0,0,7
19120,vaṅṇa,vanna,1,1,0,0,5
19121,phusanā,phusana,97,96,1,0,7
19122,hasanaṅkurehi,hasanankurehi,1,1,0,0,13
19123,vallari,vallari,1,1,0,0,7
19124,vellītā,vellita,1,1,0,0,7
19125,hetuddasā,hetuddasa,1,1,0,0,9
19126,phaladasā,phaladasa,1,1,0,0,9
19127,samavaṭṭhitaṃ,samavatthitam,3,3,0,0,13
19128,hitamāvahaṇena,hitamavahanena,1,1,0,0,14
19129,cintāpathātiganubhāva,cintapathatiganubhava,1,1,0,0,21
19130,vibhāvanante,vibhavanante,1,1,0,0,12
19131,bhūtānamatthu,bhutanamatthu,1,1,0,0,13
19132,caritabbhutamattha,caritabbhutamattha,1,1,0,0,18
19133,sidhyā,sidhya,1,1,0,0,6
19134,aṅgārakāsumabhilaṅghiya,angarakasumabhilanghiya,1,1,0,0,23
19135,bhattattano,bhattattano,1,1,0,0,11
19136,paṭicchaka,paticchaka,1,1,0,0,10
19137,paṅkajā,pankaja,4,3,1,0,7
19138,yātakkhaṇe,yatakkhane,1,1,0,0,10
19139,dhaṭamuṭṭhahitvā,dhatamutthahitva,1,1,0,0,16
19140,paṅkeruhāṃ,pankeruham,1,1,0,0,10
19141,siva,siva,9,8,1,0,4
19142,madhuṃ,madhum,141,134,7,0,6
19143,sarataṃ,saratam,2,2,0,0,7
19144,maccha,maccha,8,5,3,0,6
19145,vassita,vassita,8,2,6,0,7
19146,vassadhārā,vassadhara,4,4,0,0,10
19147,dayāya,dayaya,25,21,4,0,6
19148,gimhe,gimhe,61,57,4,0,5
19149,samayiṃsu,samayimsu,1,1,0,0,9
19150,tathātā,tathata,1,1,0,0,7
19151,dhamambuvuṭṭhiva,dhamambuvutthiva,1,1,0,0,16
19152,samentu,samentu,5,5,0,0,7
19153,dāhe,dahe,41,34,7,0,4
19154,nāga,naga,86,77,9,0,4
19155,khamatā,khamata,2,2,0,0,7
19156,parādhaṃ,paradham,1,1,0,0,8
19157,kare,kare,190,175,15,0,4
19158,dantavarāva,dantavarava,1,1,0,0,11
19159,luddaṃ,luddam,46,43,3,0,6
19160,temiyākhya,temiyakhya,1,1,0,0,10
19161,yatinossama,yatinossama,1,1,0,0,11
19162,mālakamhi,malakamhi,1,1,0,0,9
19163,okiṇṇa,okinna,2,2,0,0,6
19164,kanakā,kanaka,1,1,0,0,6
19165,vuja,vuja,1,1,0,0,4
19166,vippakiṇṇā,vippakinna,14,14,0,0,10
19167,kāruñña,karunna,1,1,0,0,7
19168,vārida,varida,1,1,0,0,6
19169,daka,daka,6,5,1,0,4
19170,bandhū,bandhu,32,25,7,0,6
19171,jantusu,jantusu,2,2,0,0,7
19172,dukkhadāhe,dukkhadahe,1,1,0,0,10
19173,raṭṭhassa,ratthassa,41,40,1,0,9
19174,caraṇāya,caranaya,1,1,0,0,8
19175,asammukhassa,asammukhassa,1,1,0,0,12
19176,rāmena,ramena,2,2,0,0,6
19177,tiṇa,tina,18,12,6,0,4
19178,saṃkhata,samkhata,1,1,0,0,8
19179,pādukāva,padukava,1,1,0,0,8
19180,bhuttā,bhutta,38,36,2,0,6
19181,ciramasammukha,ciramasammukha,1,1,0,0,14
19182,nāgatassa,nagatassa,1,1,0,0,9
19183,atthamanu,atthamanu,1,1,0,0,9
19184,janānamupadissa,jananamupadissa,1,1,0,0,15
19185,varāha,varaha,13,13,0,0,6
19186,raññā,ranna,916,896,20,0,5
19187,satthiṃ,satthim,17,14,3,0,7
19188,saradaṃ,saradam,8,8,0,0,7
19189,ñāya,naya,1,1,0,0,4
19190,ādeyya,adeyya,2,2,0,0,6
19191,heyyamupadissa,heyyamupadissa,1,1,0,0,14
19192,pavutto,pavutto,24,24,0,0,7
19193,mārāri,marari,14,9,5,0,6
19194,maddana,maddana,1,1,0,0,7
19195,hitādhigamaṃ,hitadhigamam,3,3,0,0,12
19196,karotā,karota,6,5,1,0,6
19197,jaya,jaya,3,3,0,0,4
19198,saggā,sagga,56,50,6,0,5
19199,pavavagga,pavavagga,1,1,0,0,9
19200,hitahetu,hitahetu,3,3,0,0,8
19201,sabbantarāyamiha,sabbantarayamiha,1,1,0,0,16
19202,sāmoda,samoda,2,2,0,0,6
19203,bhajanī,bhajani,1,1,0,0,7
19204,mañjarīyaṃ,manjariyam,1,1,0,0,10
19205,vikasitā,vikasita,5,5,0,0,8
19206,sapphalaṅgaṃ,sapphalangam,1,1,0,0,12
19207,madhupe,madhupe,2,2,0,0,7
19208,rasa,rasa,48,26,22,0,4
19209,pīṇayanti,pinayanti,1,1,0,0,9
19210,sambhāvitā,sambhavita,11,11,0,0,10
19211,matthakehi,matthakehi,1,1,0,0,10
19212,sambuddha,sambuddha,18,16,2,0,9
19213,selavalayantara,selavalayantara,1,1,0,0,15
19214,jānanavhā,jananavha,1,1,0,0,9
19215,nottattato,nottattato,1,1,0,0,10
19216,tipathagā,tipathaga,1,1,0,0,9
19217,sāgaraṭṭhā,sagarattha,1,1,0,0,10
19218,pagā,paga,1,1,0,0,4
19219,suti,suti,58,44,14,0,4
19220,tarite,tarite,1,1,0,0,6
19221,puṇanti,punanti,1,1,0,0,7
19222,sassamiha,sassamiha,1,1,0,0,9
19223,pacayanti,pacayanti,1,1,0,0,9
19224,paññāṇa,pannana,1,1,0,0,7
19225,paggaha,paggaha,2,1,1,0,7
19226,vāyu,vayu,35,26,9,0,4
19227,gāhī,gahi,1,1,0,0,4
19228,sahitā,sahita,106,90,16,0,6
19229,pota,pota,1,1,0,0,4
19230,vāhā,vaha,12,11,1,0,4
19231,sampāpayātu,sampapayatu,1,1,0,0,11
19232,pāra,para,19,8,11,0,4
19233,tīra,tira,6,3,3,0,4
19234,sappattanaṃ,sappattanam,1,1,0,0,11
19235,varadhane,varadhane,1,1,0,0,9
19236,patti,patti,134,123,11,0,5
19237,bojjhaṅga,bojjhanga,13,12,1,0,9
19238,ratanākara,ratanakara,1,1,0,0,10
19239,khandha,khandha,33,15,18,0,7
19240,nīra,nira,4,4,0,0,4
19241,caya,caya,3,1,2,0,4
19242,sāsana,sasana,15,15,0,0,6
19243,sāgaro,sagaro,147,135,12,0,6
19244,sīlyananta,silyananta,1,1,0,0,10
19245,veṭitha,vetitha,1,1,0,0,7
19246,mantha,mantha,5,1,4,0,6
19247,selena,selena,4,4,0,0,6
19248,manthitavataṃ,manthitavatam,1,1,0,0,13
19249,disatā,disata,5,5,0,0,6
19250,vidhinā,vidhina,114,108,6,0,7
19251,nubhūtamamataṃ,nubhutamamatam,1,1,0,0,14
19252,dosa,dosa,36,35,1,0,4
19253,nāsaṃ,nasam,45,40,5,0,5
19254,accanta,accanta,13,11,2,0,7
19255,roga,roga,8,4,4,0,4
19256,jaratā,jarata,82,77,5,0,6
19257,bhi,bhi,19,16,3,0,3
19258,arogaṃ,arogam,157,149,8,0,6
19259,raviniggata,raviniggata,1,1,0,0,11
19260,phullo,phullo,5,5,0,0,6
19261,dhutaṅgadala,dhutangadala,1,1,0,0,12
19262,saṃvara,samvara,6,6,0,0,7
19263,saṅghāravinda,sangharavinda,1,1,0,0,13
19264,samadhuṃ,samadhum,1,1,0,0,8
19265,sakkiṇṇiko,sakkinniko,1,1,0,0,10
19266,disatu,disatu,1,1,0,0,6
19267,jato,jato,3,3,0,0,4
19268,guṇānukittanavasā,gunanukittanavasa,1,1,0,0,17
19269,hitā,hita,69,63,6,0,4
19270,siṃ,sim,16,13,3,0,3
19271,vatthānussati,vatthanussati,1,1,0,0,13
19272,vattita,vattita,1,1,0,0,7
19273,tābhi,tabhi,7,7,0,0,5
19274,bhavanta,bhavanta,24,10,14,0,8
19275,ruttara,ruttara,1,1,0,0,7
19276,tarā,tara,5,5,0,0,4
19277,saṃyogoca,samyogoca,1,1,0,0,9
19278,dhanehi,dhanehi,4,4,0,0,7
19279,santihi,santihi,1,1,0,0,7
19280,kalyāna,kalyana,1,1,0,0,7
19281,mittehi,mittehi,41,38,3,0,7
19282,buddhaguṇagāthāvalī,buddhagunagathavali,1,1,0,0,19
19283,yatheva,yatheva,337,320,17,0,7
19284,puppharāsimhā,puppharasimha,5,5,0,0,13
19285,gantheyya,gantheyya,3,3,0,0,9
19286,sobhanā,sobhana,95,91,4,0,7
19287,buddhaguṇagāthā,buddhagunagatha,1,1,0,0,15
19288,viraciṃ,viracim,1,1,0,0,7
19289,sahassādhikā,sahassadhika,1,1,0,0,12
19290,vijjācaraṇasampanno,vijjacaranasampanno,151,144,7,0,19
19291,paṇamāmyahaṃ,panamamyaham,1226,1226,0,0,12
19292,purisadammasārathī,purisadammasarathi,11,11,0,0,18
19293,anuttaro,anuttaro,410,383,27,0,8
19294,satthādevamanussānaṃ,satthadevamanussanam,7,7,0,0,20
19295,sugado,sugado,5,5,0,0,6
19296,sāmī,sami,332,322,10,0,4
19297,sukhado,sukhado,11,9,2,0,7
19298,santipadāyako,santipadayako,1,1,0,0,13
19299,sabbalokānukampako,sabbalokanukampako,9,9,0,0,18
19300,varaññū,varannu,12,10,2,0,7
19301,varado,varado,15,15,0,0,6
19302,varuttamo,varuttamo,4,4,0,0,9
19303,varāharo,varaharo,13,13,0,0,8
19304,varadhammaṃ,varadhammam,4,4,0,0,11
19305,mahāmaṅgalamaṅgalyo,mahamangalamangalyo,1,1,0,0,19
19306,maṅgalālayo,mangalalayo,1,1,0,0,11
19307,maṅgalāyatano,mangalayatano,1,1,0,0,13
19308,maṅgalindo,mangalindo,1,1,0,0,10
19309,maṅgaliko,mangaliko,1,1,0,0,9
19310,mahāmaṅgalanāyako,mahamangalanayako,1,1,0,0,17
19311,maṅgaladhammaṃ,mangaladhammam,1,1,0,0,14
19312,maṅgalaggo,mangalaggo,1,1,0,0,10
19313,maṅgalaññū,mangalannu,1,1,0,0,10
19314,maṅgalatthapadāyako,mangalatthapadayako,1,1,0,0,19
19315,maṅgalapanthadassāvī,mangalapanthadassavi,1,1,0,0,20
19316,maṅgaliccho,mangaliccho,1,1,0,0,11
19317,maṅgaliddho,mangaliddho,1,1,0,0,11
19318,maṅgalamabhivaddhano,mangalamabhivaddhano,1,1,0,0,20
19319,maṅgalehi,mangalehi,1,1,0,0,9
19320,maṅgalābhā,mangalabha,1,1,0,0,10
19321,ujjotesi,ujjotesi,3,3,0,0,8
19322,maṅgalatthapabhākaro,mangalatthapabhakaro,1,1,0,0,20
19323,maṅgalālokamaṇḍito,mangalalokamandito,1,1,0,0,18
19324,maṅgalatthamanuppatto,mangalatthamanuppatto,1,1,0,0,21
19325,maṅgalatthaparāyaṇo,mangalatthaparayano,1,1,0,0,19
19326,maṅgalakaro,mangalakaro,1,1,0,0,11
19327,maṅgalamaggamanvesi,mangalamaggamanvesi,1,1,0,0,19
19328,maṅgalamuttamaṃ,mangalamuttamam,49,43,6,0,15
19329,maṅgalāyanaṃ,mangalayanam,1,1,0,0,12
19330,dassetā,dasseta,12,11,1,0,7
19331,maṅgalamahimādhārī,mangalamahimadhari,1,1,0,0,18
19332,maṅgalakārī,mangalakari,2,2,0,0,11
19333,maṅgaladātā,mangaladata,1,1,0,0,11
19334,kovido,kovido,276,265,11,0,6
19335,amaṅgalassa,amangalassa,1,1,0,0,11
19336,sabbamaṅgalasampanno,sabbamangalasampanno,1,1,0,0,20
19337,maṅgalaghosaghosako,mangalaghosaghosako,1,1,0,0,19
19338,maṅgaluttamaṃ,mangaluttamam,1,1,0,0,13
19339,mahāmaṅgalatthaṃ,mahamangalattham,1,1,0,0,16
19340,maggī,maggi,2,2,0,0,5
19341,dhammasumaṅgalo,dhammasumangalo,1,1,0,0,15
19342,ddhānaṃ,ddhanam,4,3,1,0,7
19343,ñāpesi,napesi,35,35,0,0,6
19344,agārikatthaṃ,agarikattham,1,1,0,0,12
19345,mahāmaṅgalamuttamaṃ,mahamangalamuttamam,1,1,0,0,19
19346,gihī,gihi,369,358,11,0,4
19347,sahāyako,sahayako,90,90,0,0,8
19348,mahāmaṅgala,mahamangala,2,2,0,0,11
19349,laṅkito,lankito,3,3,0,0,7
19350,mahāmaṅgalabhūsano,mahamangalabhusano,1,1,0,0,18
19351,mahāmaṅgalasekharo,mahamangalasekharo,1,1,0,0,18
19352,mahāmaṅgalaṃsumālī,mahamangalamsumali,1,1,0,0,18
19353,maṅgalābho,mangalabho,1,1,0,0,10
19354,samujjalo,samujjalo,3,3,0,0,9
19355,maṅgalaṃsuṃ,mangalamsum,1,1,0,0,11
19356,mahaggha,mahaggha,4,4,0,0,8
19357,maṅgalodadhi,mangalodadhi,1,1,0,0,12
19358,mahantamaṅgalaṇṇavo,mahantamangalannavo,1,1,0,0,19
19359,mahāmaṅgalasāgaro,mahamangalasagaro,1,1,0,0,17
19360,amaṅgalanisāhantā,amangalanisahanta,1,1,0,0,17
19361,maṅgalabhānubhassaro,mangalabhanubhassaro,1,1,0,0,20
19362,maṅgalālokavikiṇṇo,mangalalokavikinno,1,1,0,0,18
19363,bāhusacco,bahusacco,1,1,0,0,9
19364,bujjhanako,bujjhanako,2,2,0,0,10
19365,dhammacakkhuuppādako,dhammacakkhuuppadako,1,1,0,0,20
19366,tibhavamaṅgalaṅkārī,tibhavamangalankari,1,1,0,0,19
19367,mahāvattā,mahavatta,1,1,0,0,9
19368,pabhū,pabhu,28,26,2,0,5
19369,viññū,vinnu,391,357,34,0,5
19370,tapati,tapati,106,103,3,0,6
19371,rattiṃ,rattim,1039,952,87,0,6
19372,candimā,candima,213,196,17,0,7
19373,rattiṃdivaṃ,rattimdivam,2,2,0,0,11
19374,tapi,tapi,3,3,0,0,4
19375,sannaddho,sannaddho,31,30,1,0,9
19376,khattiyo,khattiyo,671,653,18,0,8
19377,jhāyī,jhayi,366,352,14,0,5
19378,dukkhadomanassanāsī,dukkhadomanassanasi,1,1,0,0,19
19379,sokaparidevakkhayo,sokaparidevakkhayo,1,1,0,0,18
19380,jātimaccujarātigo,jatimaccujaratigo,1,1,0,0,17
19381,yathāvādī,yathavadi,49,46,3,0,9
19382,tathākārī,tathakari,47,46,1,0,9
19383,tathavādī,tathavadi,9,9,0,0,9
19384,yathākārī,yathakari,45,44,1,0,9
19385,tathāvādī,tathavadi,43,42,1,0,9
19386,bhaggarāgo,bhaggarago,6,6,0,0,10
19387,bhaggadoso,bhaggadoso,5,5,0,0,10
19388,bhaggamoho,bhaggamoho,5,5,0,0,10
19389,bhaggamāno,bhaggamano,1,1,0,0,10
19390,bhaggamāyo,bhaggamayo,1,1,0,0,10
19391,bhaggakāmo,bhaggakamo,1,1,0,0,10
19392,bhaggakodho,bhaggakodho,1,1,0,0,11
19393,bhaggakopo,bhaggakopo,1,1,0,0,10
19394,bhaggakuho,bhaggakuho,1,1,0,0,10
19395,bhaggakasāvo,bhaggakasavo,1,1,0,0,12
19396,bhaggindho,bhaggindho,1,1,0,0,10
19397,bhaggajāti,bhaggajati,1,1,0,0,10
19398,bhaggamaccū,bhaggamaccu,1,1,0,0,11
19399,bhaggaloko,bhaggaloko,1,1,0,0,10
19400,bhaggabhavo,bhaggabhavo,1,1,0,0,11
19401,bhaggasaṃsāro,bhaggasamsaro,1,1,0,0,13
19402,bhaggogho,bhaggogho,1,1,0,0,9
19403,bhogabhaggo,bhogabhaggo,1,1,0,0,11
19404,sokabhaggo,sokabhaggo,1,1,0,0,10
19405,rogabhaggo,rogabhaggo,1,1,0,0,10
19406,bhaggarajo,bhaggarajo,1,1,0,0,10
19407,sūlabhaggo,sulabhaggo,1,1,0,0,10
19408,sallabhaggo,sallabhaggo,1,1,0,0,11
19409,āsābhaggo,asabhaggo,1,1,0,0,9
19410,issābhaggo,issabhaggo,1,1,0,0,10
19411,ejābhaggo,ejabhaggo,1,1,0,0,9
19412,bhaggajaṭā,bhaggajata,1,1,0,0,10
19413,chandabhaggo,chandabhaggo,1,1,0,0,12
19414,bandhabhaggo,bandhabhaggo,1,1,0,0,12
19415,vītadoso,vitadoso,62,61,1,0,8
19416,vītamoho,vitamoho,62,61,1,0,8
19417,vītāsavo,vitasavo,1,1,0,0,8
19418,vītakāmo,vitakamo,2,2,0,0,8
19419,vītakodho,vitakodho,1,1,0,0,9
19420,vītapāpo,vitapapo,1,1,0,0,8
19421,vītapuñño,vitapunno,1,1,0,0,9
19422,vītabhāro,vitabharo,1,1,0,0,9
19423,vītamalo,vitamalo,8,8,0,0,8
19424,vītavikāro,vitavikaro,1,1,0,0,10
19425,vītindho,vitindho,1,1,0,0,8
19426,vantarāgo,vantarago,14,14,0,0,9
19427,vantadoso,vantadoso,4,4,0,0,9
19428,vantamoho,vantamoho,2,2,0,0,9
19429,vantamalo,vantamalo,7,7,0,0,9
19430,vantakasāvo,vantakasavo,6,6,0,0,11
19431,vantīgho,vantigho,2,2,0,0,8
19432,sagguru,sagguru,1,1,0,0,7
19433,tilokaguru,tilokaguru,1,1,0,0,10
19434,sabbasattānamaggagurū,sabbasattanamaggaguru,1,1,0,0,21
19435,netāresu,netaresu,1,1,0,0,8
19436,mahānetā,mahaneta,1,1,0,0,8
19437,mahāguru,mahaguru,1,1,0,0,8
19438,naraguru,naraguru,1,1,0,0,8
19439,devaguru,devaguru,1,1,0,0,8
19440,guruttamo,guruttamo,1,1,0,0,9
19441,jeṭṭhaguru,jetthaguru,1,1,0,0,10
19442,seṭṭhaguru,setthaguru,1,1,0,0,10
19443,vissaguru,vissaguru,1,1,0,0,9
19444,lokaguru,lokaguru,1,1,0,0,8
19445,dhammaguru,dhammaguru,1,1,0,0,10
19446,gurūttamo,guruttamo,1,1,0,0,9
19447,etādiso,etadiso,44,42,2,0,7
19448,guru,guru,32,27,5,0,4
19449,mahāsatthā,mahasattha,1,1,0,0,10
19450,mahāsotthi,mahasotthi,1,1,0,0,10
19451,mahāmitto,mahamitto,1,1,0,0,9
19452,mahāsakhā,mahasakha,3,3,0,0,9
19453,mahākalyāṇamitto,mahakalyanamitto,1,1,0,0,16
19454,mahāviññū,mahavinnu,1,1,0,0,9
19455,mahāvidvā,mahavidva,1,1,0,0,9
19456,mahāvidū,mahavidu,1,1,0,0,8
19457,mahāmedhāvī,mahamedhavi,1,1,0,0,11
19458,mahāsuddho,mahasuddho,1,1,0,0,10
19459,mahābhaddo,mahabhaddo,1,1,0,0,10
19460,mahādayo,mahadayo,17,17,0,0,8
19461,mahāsayo,mahasayo,2,2,0,0,8
19462,mahādibbo,mahadibbo,1,1,0,0,9
19463,mahābhabbo,mahabhabbo,1,1,0,0,10
19464,mahāvīro,mahaviro,202,198,4,0,8
19465,mahādhīro,mahadhiro,1,1,0,0,9
19466,mahāsūro,mahasuro,1,1,0,0,8
19467,mahāmāracamū,mahamaracamu,1,1,0,0,12
19468,maddi,maddi,53,53,0,0,5
19469,mahājeṭṭho,mahajettho,1,1,0,0,10
19470,mahāseṭṭho,mahasettho,1,1,0,0,10
19471,mahaggo,mahaggo,1,1,0,0,7
19472,mahānāyako,mahanayako,1,1,0,0,10
19473,mahācheko,mahacheko,1,1,0,0,9
19474,mahādakkho,mahadakkho,1,1,0,0,10
19475,mahābyatto,mahabyatto,1,1,0,0,10
19476,mahāñāto,mahanato,1,1,0,0,8
19477,mahākhyāto,mahakhyato,1,1,0,0,10
19478,mahāyasī,mahayasi,1,1,0,0,8
19479,mahiddho,mahiddho,1,1,0,0,8
19480,mahāvikhyāto,mahavikhyato,1,1,0,0,12
19481,mahātuṭṭho,mahatuttho,1,1,0,0,10
19482,mahāhaṭṭho,mahahattho,1,1,0,0,10
19483,mahājavo,mahajavo,1,1,0,0,8
19484,mahājayo,mahajayo,1,1,0,0,8
19485,mahāsantuṭṭho,mahasantuttho,2,2,0,0,13
19486,visiṭṭho,visittho,79,76,3,0,8
19487,mahānātho,mahanatho,1,1,0,0,9
19488,mahāsāmī,mahasami,1,1,0,0,8
19489,mahāpabhū,mahapabhu,1,1,0,0,9
19490,mahāvibhū,mahavibhu,1,1,0,0,9
19491,mahissaro,mahissaro,9,8,1,0,9
19492,bodhissaro,bodhissaro,1,1,0,0,10
19493,mahāvaṇṇo,mahavanno,1,1,0,0,9
19494,mahākanto,mahakanto,1,1,0,0,9
19495,manopiyo,manopiyo,1,1,0,0,8
19496,manāpiko,manapiko,1,1,0,0,8
19497,mahāsobhano,mahasobhano,1,1,0,0,11
19498,manuñño,manunno,18,18,0,0,7
19499,mahājhāyī,mahajhayi,9,8,1,0,9
19500,mahāñāṇī,mahanani,11,10,1,0,8
19501,mahādhīmā,mahadhima,1,1,0,0,9
19502,mahāsudhī,mahasudhi,1,1,0,0,9
19503,mahāvibhāvī,mahavibhavi,1,1,0,0,11
19504,mahākhantī,mahakhanti,1,1,0,0,10
19505,titikkho,titikkho,1,1,0,0,8
19506,mahānikkaṅkho,mahanikkankho,1,1,0,0,13
19507,dhammagū,dhammagu,4,4,0,0,8
19508,mahāsaṃyato,mahasamyato,1,1,0,0,11
19509,saṃvuto,samvuto,167,156,11,0,7
19510,mahāthomito,mahathomito,1,1,0,0,11
19511,mahāmānito,mahamanito,1,1,0,0,10
19512,vandito,vandito,13,13,0,0,7
19513,mahābhivādito,mahabhivadito,1,1,0,0,13
19514,mahatattho,mahatattho,1,1,0,0,10
19515,mahatthiko,mahatthiko,4,4,0,0,10
19516,mahantattho,mahantattho,1,1,0,0,11
19517,mahattaro,mahattaro,12,12,0,0,9
19518,mahanto,mahanto,404,394,10,0,7
19519,mahattappatto,mahattappatto,1,1,0,0,13
19520,mahālābhī,mahalabhi,2,2,0,0,9
19521,mahākārī,mahakari,1,1,0,0,8
19522,mahādāyī,mahadayi,1,1,0,0,8
19523,mahādhanī,mahadhani,1,1,0,0,9
19524,mahāvijjo,mahavijjo,1,1,0,0,9
19525,mahāpujjo,mahapujjo,1,1,0,0,9
19526,mahābuddhi,mahabuddhi,4,4,0,0,10
19527,mahābudhā,mahabudha,1,1,0,0,9
19528,mahāpabodhipuṅgavo,mahapabodhipungavo,1,1,0,0,18
19529,mahābhavaṇṇavaṃ,mahabhavannavam,1,1,0,0,15
19530,tiṇṇo,tinno,212,187,25,0,5
19531,mahābhāgo,mahabhago,1,1,0,0,9
19532,mahābāho,mahabaho,1,1,0,0,8
19533,mahiddhiko,mahiddhiko,256,249,7,0,10
19534,mahāyodho,mahayodho,28,28,0,0,9
19535,mahaggato,mahaggato,173,170,3,0,9
19536,mahādanto,mahadanto,3,3,0,0,9
19537,mahāsanto,mahasanto,1,1,0,0,9
19538,mahāgaṇī,mahagani,9,9,0,0,8
19539,mahāguṇī,mahaguni,1,1,0,0,8
19540,mahāsantipadāyako,mahasantipadayako,1,1,0,0,17
19541,mahāsīlo,mahasilo,1,1,0,0,8
19542,mahācitto,mahacitto,1,1,0,0,9
19543,mahābudho,mahabudho,1,1,0,0,9
19544,mahāmohodadhiṃ,mahamohodadhim,1,1,0,0,14
19545,mahātapassī,mahatapassi,2,2,0,0,11
19546,dhammesī,dhammesi,1,1,0,0,8
19547,mahāyasassī,mahayasassi,3,3,0,0,11
19548,mahāpatāpī,mahapatapi,1,1,0,0,10
19549,tejassī,tejassi,34,30,4,0,7
19550,mahāābho,mahaabho,1,1,0,0,8
19551,mahāpabho,mahapabho,1,1,0,0,9
19552,mohandhakārabhindako,mohandhakarabhindako,1,1,0,0,20
19553,ñāṇapadīpaṃ,nanapadipam,2,2,0,0,11
19554,dīpesi,dipesi,9,9,0,0,6
19555,mahāpassaddhidāyako,mahapassaddhidayako,1,1,0,0,19
19556,munirājā,muniraja,6,6,0,0,8
19557,munissaro,munissaro,11,10,1,0,9
19558,santidado,santidado,1,1,0,0,9
19559,sukhadado,sukhadado,2,2,0,0,9
19560,mahānīvaraṇā,mahanivarana,1,1,0,0,12
19561,tīto,tito,3,3,0,0,4
19562,mahāmohasamūhato,mahamohasamuhato,1,1,0,0,16
19563,mahoghatiṇṇo,mahoghatinno,1,1,0,0,12
19564,mokkhako,mokkhako,1,1,0,0,8
19565,mahābhavopadhicatto,mahabhavopadhicatto,1,1,0,0,19
19566,lobhadosavināsako,lobhadosavinasako,1,1,0,0,17
19567,mahāripuṃ,maharipum,1,1,0,0,9
19568,nimaddesi,nimaddesi,1,1,0,0,9
19569,bhiññābalappatto,bhinnabalappatto,2,2,0,0,16
19570,mahāmaññitanāsako,mahamannitanasako,1,1,0,0,17
19571,mahāsaddhamaṃ,mahasaddhamam,1,1,0,0,13
19572,niddisi,niddisi,22,20,2,0,7
19573,ahorattiṃ,ahorattim,1,1,0,0,9
19574,sadāsuddho,sadasuddho,1,1,0,0,10
19575,mahālokagganāyako,mahalokagganayako,1,1,0,0,17
19576,samattavissavissuto,samattavissavissuto,1,1,0,0,19
19577,mahāavijjāucchinno,mahaavijjaucchinno,1,1,0,0,18
19578,mahāāsattiriñcako,mahaasattirincako,1,1,0,0,17
19579,mahājaṭā,mahajata,3,3,0,0,8
19580,vijaṭesi,vijatesi,3,3,0,0,8
19581,mahāsūlavivattako,mahasulavivattako,1,1,0,0,17
19582,mahāsallavinodano,mahasallavinodano,1,1,0,0,17
19583,mahāsavaṃ,mahasavam,1,1,0,0,9
19584,byantikaro,byantikaro,1,1,0,0,10
19585,mahāparakkamī,mahaparakkami,1,1,0,0,13
19586,aparājayo,aparajayo,1,1,0,0,9
19587,accantaabhayo,accantaabhayo,1,1,0,0,13
19588,mahātaṇhāvītivatto,mahatanhavitivatto,1,1,0,0,18
19589,mahāsokapanūdano,mahasokapanudano,1,1,0,0,16
19590,mahādukkhamatikkanto,mahadukkhamatikkanto,1,1,0,0,20
19591,mahāmānamatikkamo,mahamanamatikkamo,1,1,0,0,17
19592,mārasenanimmaddano,marasenanimmaddano,1,1,0,0,18
19593,kammaklesaṃ,kammaklesam,1,1,0,0,11
19594,nijjaresi,nijjaresi,5,5,0,0,9
19595,mahābhavodadhittiṇṇo,mahabhavodadhittinno,1,1,0,0,20
19596,pāpaṇṇavapāraṅgato,papannavaparangato,1,1,0,0,18
19597,mahāsaṃsaraṇātigo,mahasamsaranatigo,1,1,0,0,17
19598,mahāsaṃyojanātīto,mahasamyojanatito,1,1,0,0,17
19599,mahāvaṭṭavināsako,mahavattavinasako,1,1,0,0,17
19600,mahāsaṃsāroghatiṇṇo,mahasamsaroghatinno,1,1,0,0,19
19601,mahārāgavirañjako,maharagaviranjako,1,1,0,0,17
19602,mahādosanimmaddako,mahadosanimmaddako,1,1,0,0,18
19603,mahāsotaṃ,mahasotam,1,1,0,0,9
19604,visosesi,visosesi,4,4,0,0,8
19605,mahāmettāvihārī,mahamettavihari,1,1,0,0,15
19606,mahāpuñño,mahapunno,62,62,0,0,9
19607,mahāraho,maharaho,4,4,0,0,8
19608,mahākaruṇāsāgaro,mahakarunasagaro,1,1,0,0,16
19609,mahābhavasindhulaṅghī,mahabhavasindhulanghi,1,1,0,0,21
19610,bhavamutto,bhavamutto,2,2,0,0,10
19611,bhavantagū,bhavantagu,3,3,0,0,10
19612,sokasūlasamucchinno,sokasulasamucchinno,1,1,0,0,19
19613,mahāvanapathātīto,mahavanapathatito,1,1,0,0,17
19614,mahākantārapāragū,mahakantaraparagu,1,1,0,0,17
19615,mahābhavoghanittiṇṇo,mahabhavoghanittinno,2,2,0,0,20
19616,mahāmaggaphalappatto,mahamaggaphalappatto,1,1,0,0,20
19617,supatto,supatto,7,7,0,0,7
19618,amatodadhī,amatodadhi,1,1,0,0,10
19619,bhavacakkaṃ,bhavacakkam,60,57,3,0,11
19620,vibhañjesi,vibhanjesi,4,4,0,0,10
19621,mahāsubodhisampanno,mahasubodhisampanno,1,1,0,0,19
19622,muttimaggasubhāvito,muttimaggasubhavito,1,1,0,0,19
19623,bhavabandhanaṃ,bhavabandhanam,11,11,0,0,14
19624,bhañjesi,bhanjesi,9,9,0,0,8
19625,mahānandīsamucchinno,mahanandisamucchinno,1,1,0,0,20
19626,mahākilesanissaṭo,mahakilesanissato,1,1,0,0,17
19627,mahāpāpoghamuttiṇṇo,mahapapoghamuttinno,1,1,0,0,19
19628,mahāpihāparikkhīṇo,mahapihaparikkhino,1,1,0,0,18
19629,mahāsaṃyojane,mahasamyojane,1,1,0,0,13
19630,nudo,nudo,5,5,0,0,4
19631,sabbāsave,sabbasave,108,104,4,0,9
19632,vinodesi,vinodesi,30,27,3,0,8
19633,mohatimiraṃ,mohatimiram,3,3,0,0,11
19634,mahājutiṃ,mahajutim,6,5,1,0,9
19635,pabhāsesi,pabhasesi,11,11,0,0,9
19636,mahābhayaṃ,mahabhayam,21,19,2,0,10
19637,padālesi,padalesi,8,8,0,0,8
19638,chambhacchinno,chambhacchinno,1,1,0,0,14
19639,bhayanudo,bhayanudo,1,1,0,0,9
19640,mahādukkhakkhandhanudo,mahadukkhakkhandhanudo,1,1,0,0,22
19641,mahāsattuṃ,mahasattum,1,1,0,0,10
19642,vināsesi,vinasesi,23,23,0,0,8
19643,sattidhārī,sattidhari,1,1,0,0,10
19644,mahābalī,mahabali,1,1,0,0,8
19645,mahāsiddho,mahasiddho,2,2,0,0,10
19646,panudi,panudi,4,4,0,0,6
19647,mahājotipabhāsako,mahajotipabhasako,1,1,0,0,17
19648,mahābhogapariccāgī,mahabhogapariccagi,1,1,0,0,18
19649,tiṇṇamahātaṇhaṇṇavo,tinnamahatanhannavo,1,1,0,0,19
19650,mohudadhiṃ,mohudadhim,1,1,0,0,10
19651,pāraṅgato,parangato,93,82,11,0,9
19652,mahābhiññābalappatto,mahabhinnabalappatto,3,3,0,0,20
19653,mahāpadhānanāyako,mahapadhananayako,1,1,0,0,17
19654,mahābandhanavimutto,mahabandhanavimutto,1,1,0,0,19
19655,mahābodhimahaṇṇavo,mahabodhimahannavo,1,1,0,0,18
19656,mahāsambodhisāgaro,mahasambodhisagaro,1,1,0,0,18
19657,mahāñāṇamahodadhi,mahananamahodadhi,1,1,0,0,17
19658,mahābhisakko,mahabhisakko,7,7,0,0,12
19659,yatīndo,yatindo,1,1,0,0,7
19660,taṇhārogatikicchako,tanharogatikicchako,1,1,0,0,19
19661,mahāmahimāmaṇḍito,mahamahimamandito,1,1,0,0,17
19662,chabbaṇṇaraṃsidhārako,chabbannaramsidharako,1,1,0,0,21
19663,mahāpabhāya,mahapabhaya,1,1,0,0,11
19664,byāpako,byapako,3,3,0,0,7
19665,mahākaruṇāsampatto,mahakarunasampatto,1,1,0,0,18
19666,bhirato,bhirato,2,2,0,0,7
19667,mahājanahitarato,mahajanahitarato,1,1,0,0,16
19668,mahāmicchādiṭṭhiṃ,mahamicchaditthim,1,1,0,0,17
19669,hantā,hanta,56,54,2,0,5
19670,mahāsaddhammuddesako,mahasaddhammuddesako,1,1,0,0,20
19671,mahāantakupacchinno,mahaantakupacchinno,1,1,0,0,19
19672,mahāsokasallakatto,mahasokasallakatto,1,1,0,0,18
19673,mahākhīlavisodhano,mahakhilavisodhano,1,1,0,0,18
19674,mahāsantikaro,mahasantikaro,2,2,0,0,13
19675,mahāpāpapaṅkaṃ,mahapapapankam,1,1,0,0,14
19676,dhotā,dhota,24,24,0,0,5
19677,mahādukkhavimocako,mahadukkhavimocako,1,1,0,0,18
19678,mahāsajjanaṃ,mahasajjanam,1,1,0,0,12
19679,sodhesi,sodhesi,11,10,1,0,7
19680,mahāantakahantā,mahaantakahanta,1,1,0,0,15
19681,maccusenavināsako,maccusenavinasako,1,1,0,0,17
19682,mahātaṇhaṃ,mahatanham,3,3,0,0,10
19683,mahādiṭṭhiṃ,mahaditthim,3,3,0,0,11
19684,viddhaṃsesi,viddhamsesi,21,21,0,0,11
19685,pāpapuññasamūhato,papapunnasamuhato,1,1,0,0,17
19686,māyañca,mayanca,15,8,7,0,7
19687,maddesi,maddesi,5,5,0,0,7
19688,mahāmohaṃ,mahamoham,2,2,0,0,9
19689,mahārāganirodhako,maharaganirodhako,1,1,0,0,17
19690,mahādosaṃ,mahadosam,1,1,0,0,9
19691,niddhaṃsesi,niddhamsesi,5,5,0,0,11
19692,vicitradhammakathiko,vicitradhammakathiko,1,1,0,0,20
19693,abbhutamagguddesako,abbhutamagguddesako,1,1,0,0,19
19694,mahakkhāto,mahakkhato,1,1,0,0,10
19695,mahākathī,mahakathi,13,13,0,0,9
19696,mahāvādī,mahavadi,7,7,0,0,8
19697,kammavādī,kammavadi,8,8,0,0,9
19698,mahāsakyamunīvaro,mahasakyamunivaro,1,1,0,0,17
19699,munipuṅgavo,munipungavo,14,11,3,0,11
19700,mahāmohanisānāsī,mahamohanisanasi,1,1,0,0,16
19701,mahāpabhā,mahapabha,1,1,0,0,9
19702,vitthārako,vittharako,1,1,0,0,10
19703,mahājuṇhā,mahajunha,1,1,0,0,9
19704,pajjotesi,pajjotesi,4,4,0,0,9
19705,vijjānisā,vijjanisa,1,1,0,0,9
19706,vijjāraṃsivibhūsito,vijjaramsivibhusito,1,1,0,0,19
19707,mahādhammābhā,mahadhammabha,1,1,0,0,13
19708,vikari,vikari,1,1,0,0,6
19709,nimmaddesi,nimmaddesi,5,5,0,0,10
19710,māyājālavimocano,mayajalavimocano,1,1,0,0,16
19711,micchāvādaṃ,micchavadam,32,32,0,0,11
19712,pamaddesi,pamaddesi,1,1,0,0,9
19713,āsavasotaṃ,asavasotam,1,1,0,0,10
19714,sosesi,sosesi,3,3,0,0,6
19715,mahāvyāpādamaddano,mahavyapadamaddano,1,1,0,0,18
19716,mohamahodadhitiṇṇo,mohamahodadhitinno,1,1,0,0,18
19717,mahāmohamatikkanto,mahamohamatikkanto,1,1,0,0,18
19718,mahāsaṅkāvinodano,mahasankavinodano,1,1,0,0,17
19719,virato,virato,204,172,32,0,6
19720,cattadaṇḍo,cattadando,1,1,0,0,10
19721,ahiṃsako,ahimsako,13,12,1,0,8
19722,amitamettavāridhi,amitamettavaridhi,1,1,0,0,17
19723,adinnādānā,adinnadana,264,260,4,0,10
19724,apariggaho,apariggaho,19,14,5,0,10
19725,cāgī,cagi,15,15,0,0,4
19726,virāgī,viragi,3,3,0,0,6
19727,abrahmacariyātīto,abrahmacariyatito,1,1,0,0,17
19728,kāmabhogapariccajo,kamabhogapariccajo,1,1,0,0,18
19729,māradhītāmānaṃ,maradhitamanam,1,1,0,0,14
19730,kāyānurakkhī,kayanurakkhi,2,2,0,0,12
19731,sudanto,sudanto,29,27,2,0,7
19732,vācānurakkhī,vacanurakkhi,10,9,1,0,12
19733,mahāsīlena,mahasilena,1,1,0,0,10
19734,sammāājīvasampanno,sammaajivasampanno,1,1,0,0,18
19735,suddhācaraṇacārako,suddhacaranacarako,1,1,0,0,18
19736,sīlasiromaṇi,silasiromani,1,1,0,0,12
19737,subharo,subharo,36,30,6,0,7
19738,suddhācārasiromaṇī,suddhacarasiromani,1,1,0,0,18
19739,thāmavā,thamava,70,68,2,0,7
19740,javasampanno,javasampanno,80,80,0,0,12
19741,avikappo,avikappo,2,2,0,0,8
19742,avitakko,avitakko,138,135,3,0,8
19743,avicāro,avicaro,39,38,1,0,7
19744,acintako,acintako,1,1,0,0,8
19745,cittaekaggatāppatto,cittaekaggatappatto,1,1,0,0,19
19746,surakkhesi,surakkhesi,1,1,0,0,10
19747,saṃvaramānaso,samvaramanaso,1,1,0,0,13
19748,sammāsamāhitacitto,sammasamahitacitto,2,2,0,0,18
19749,pabalapañño,pabalapanno,1,1,0,0,11
19750,paññaññū,pannannu,1,1,0,0,8
19751,gambhīrapaññāsobhano,gambhirapannasobhano,1,1,0,0,20
19752,sampannapañño,sampannapanno,2,2,0,0,13
19753,paññakkho,pannakkho,2,2,0,0,9
19754,pahūtapañño,pahutapanno,6,6,0,0,11
19755,supañño,supanno,4,4,0,0,7
19756,puthulapañño,puthulapanno,2,2,0,0,12
19757,paguṇañāṇo,pagunanano,1,1,0,0,10
19758,ñāṇakkho,nanakkho,2,2,0,0,8
19759,tikkhapañño,tikkhapanno,67,64,3,0,11
19760,khippapañño,khippapanno,2,2,0,0,11
19761,puṇṇapañño,punnapanno,1,1,0,0,10
19762,paññāpabhū,pannapabhu,1,1,0,0,10
19763,paññānātho,pannanatho,1,1,0,0,10
19764,paññāsāmī,pannasami,1,1,0,0,9
19765,dhuvapañño,dhuvapanno,1,1,0,0,10
19766,ṭhitapañño,thitapanno,1,1,0,0,10
19767,thirapañño,thirapanno,1,1,0,0,10
19768,paññādado,pannadado,1,1,0,0,9
19769,pariyodātapañño,pariyodatapanno,1,1,0,0,15
19770,pāramīppatto,paramippatto,2,2,0,0,12
19771,anantapaññasekharo,anantapannasekharo,1,1,0,0,18
19772,puññapāramīsampanno,punnaparamisampanno,1,1,0,0,19
19773,paññādhanī,pannadhani,2,2,0,0,10
19774,paññābalī,pannabali,5,4,1,0,9
19775,paññāsīlasamāhito,pannasilasamahito,15,14,1,0,17
19776,paññāpati,pannapati,1,1,0,0,9
19777,paññādhārī,pannadhari,2,2,0,0,10
19778,paññavanto,pannavanto,93,89,4,0,10
19779,sudhīmanto,sudhimanto,1,1,0,0,10
19780,sīdhapañño,sidhapanno,1,1,0,0,10
19781,paññānidhi,pannanidhi,1,1,0,0,10
19782,paññāvāridhi,pannavaridhi,2,2,0,0,12
19783,paññagū,pannagu,1,1,0,0,7
19784,paguṇapaññākusalo,pagunapannakusalo,1,1,0,0,17
19785,anantapaññavā,anantapannava,1,1,0,0,13
19786,seṭṭhapañño,setthapanno,1,1,0,0,11
19787,jeṭṭhapañño,jetthapanno,1,1,0,0,11
19788,paripuṇṇapañño,paripunnapanno,2,2,0,0,14
19789,puṇṇo,punno,177,170,7,0,5
19790,pavarapaññapāragū,pavarapannaparagu,1,1,0,0,17
19791,paññissaro,pannissaro,1,1,0,0,10
19792,ñāṇissaro,nanissaro,1,1,0,0,9
19793,accantaamalapañño,accantaamalapanno,1,1,0,0,17
19794,sampuṇṇapaṭibhānavā,sampunnapatibhanava,1,1,0,0,19
19795,paṭivedhapaññādhārī,pativedhapannadhari,1,1,0,0,19
19796,anomapañño,anomapanno,3,3,0,0,10
19797,anomo,anomo,24,23,1,0,5
19798,bhūripañño,bhuripanno,60,54,6,0,10
19799,paññavaro,pannavaro,1,1,0,0,9
19800,parisuddhapañño,parisuddhapanno,1,1,0,0,15
19801,nibbedhikapañño,nibbedhikapanno,40,40,0,0,15
19802,paṭibodhapañño,patibodhapanno,1,1,0,0,14
19803,paṭū,patu,2,2,0,0,4
19804,visuddhapañño,visuddhapanno,2,2,0,0,13
19805,saṃsuddho,samsuddho,3,3,0,0,9
19806,sucakkhumā,sucakkhuma,1,1,0,0,10
19807,sampuṇṇo,sampunno,31,29,2,0,8
19808,pabalapaññāsaṃyutto,pabalapannasamyutto,1,1,0,0,19
19809,tikkhamedho,tikkhamedho,1,1,0,0,11
19810,medhāmayo,medhamayo,1,1,0,0,9
19811,puṇṇābhiññā,punnabhinna,1,1,0,0,11
19812,aññātāvī,annatavi,130,130,0,0,8
19813,paññāvudhena,pannavudhena,9,9,0,0,12
19814,ajito,ajito,103,94,9,0,5
19815,asaṅkhatamanuppatto,asankhatamanuppatto,1,1,0,0,19
19816,bharaṇabhūsito,bharanabhusito,1,1,0,0,14
19817,paññāpesi,pannapesi,48,48,0,0,9
19818,paññaṃ,pannam,366,337,29,0,6
19819,ñāṇī,nani,58,56,2,0,4
19820,ñāṇasaṃvaḍḍhano,nanasamvaddhano,1,1,0,0,15
19821,adhammadhaṃsako,adhammadhamsako,1,1,0,0,15
19822,dhammī,dhammi,59,52,7,0,6
19823,paññāsekharo,pannasekharo,1,1,0,0,12
19824,paññindo,pannindo,2,2,0,0,8
19825,ñāṇindo,nanindo,1,1,0,0,7
19826,ñāṇasekharo,nanasekharo,1,1,0,0,11
19827,dhammasekharo,dhammasekharo,1,1,0,0,13
19828,dhammindo,dhammindo,1,1,0,0,9
19829,javanapañño,javanapanno,42,42,0,0,11
19830,jitatto,jitatto,1,1,0,0,7
19831,sabbaganthappamocano,sabbaganthappamocano,6,5,1,0,20
19832,gaṇṭhimutto,ganthimutto,1,1,0,0,11
19833,guttadvāro,guttadvaro,94,86,8,0,10
19834,bahupañño,bahupanno,1,1,0,0,9
19835,bahukārī,bahukari,1,1,0,0,8
19836,bahuñāṇī,bahunani,1,1,0,0,8
19837,bahuguṇo,bahuguno,3,3,0,0,8
19838,bahulaguṇasampanno,bahulagunasampanno,1,1,0,0,18
19839,paññāvimuttisampanno,pannavimuttisampanno,1,1,0,0,20
19840,mohātīto,mohatito,1,1,0,0,8
19841,dukkhātigo,dukkhatigo,1,1,0,0,10
19842,kilesasallakantako,kilesasallakantako,1,1,0,0,18
19843,bodhihadayo,bodhihadayo,1,1,0,0,11
19844,paññamānaso,pannamanaso,1,1,0,0,11
19845,ñāṇacetaso,nanacetaso,1,1,0,0,10
19846,ñāṇābho,nanabho,1,1,0,0,7
19847,dhuvasīlo,dhuvasilo,12,12,0,0,9
19848,dhuvacitto,dhuvacitto,1,1,0,0,10
19849,dhuvamedho,dhuvamedho,1,1,0,0,10
19850,dhuvaṅgato,dhuvangato,1,1,0,0,10
19851,dhuvamutto,dhuvamutto,1,1,0,0,10
19852,dhuvaladdho,dhuvaladdho,1,1,0,0,11
19853,sīlabalī,silabali,1,1,0,0,8
19854,cittabalī,cittabali,1,1,0,0,9
19855,aññābalī,annabali,1,1,0,0,8
19856,dhammabalī,dhammabali,1,1,0,0,10
19857,dhīrabalī,dhirabali,1,1,0,0,9
19858,sīladhanī,siladhani,1,1,0,0,9
19859,cittadhanī,cittadhani,1,1,0,0,10
19860,aññādhanī,annadhani,1,1,0,0,9
19861,dhammadhanī,dhammadhani,1,1,0,0,11
19862,dhīradhanī,dhiradhani,1,1,0,0,10
19863,kāyāsaṃvarasaṃyato,kayasamvarasamyato,1,1,0,0,18
19864,saṃyatavācāsaṃvaro,samyatavacasamvaro,1,1,0,0,18
19865,cittasaṃvara,cittasamvara,1,1,0,0,12
19866,saṃyato,samyato,50,50,0,0,7
19867,sīlaggo,silaggo,1,1,0,0,7
19868,samādhippatto,samadhippatto,2,2,0,0,13
19869,paññappatto,pannappatto,1,1,0,0,11
19870,subhāvito,subhavito,40,35,5,0,9
19871,dhammasudhārasaṃ,dhammasudharasam,2,2,0,0,16
19872,pāyī,payi,3,3,0,0,4
19873,susīlo,susilo,15,14,1,0,6
19874,paññālaṅkāra,pannalankara,1,1,0,0,12
19875,laṅkato,lankato,11,11,0,0,7
19876,dhammābharaṇabhūsito,dhammabharanabhusito,1,1,0,0,20
19877,sammāsamādhi,sammasamadhi,520,500,20,0,12
19878,sīlapaññavibhūsato,silapannavibhusato,1,1,0,0,18
19879,sabbābhiññābalappatto,sabbabhinnabalappatto,9,9,0,0,21
19880,suddhasīlo,suddhasilo,2,2,0,0,10
19881,suddhacitto,suddhacitto,18,17,1,0,11
19882,suddhapañño,suddhapanno,1,1,0,0,11
19883,suddhamano,suddhamano,3,3,0,0,10
19884,suddhadhammaṃ,suddhadhammam,3,3,0,0,13
19885,pakāsesi,pakasesi,226,220,6,0,8
19886,yasavā,yasava,50,49,1,0,6
19887,lokavissuto,lokavissuto,2,2,0,0,11
19888,vidito,vidito,231,206,25,0,6
19889,sīlasamādhisampanno,silasamadhisampanno,1,1,0,0,19
19890,vidhuro,vidhuro,50,47,3,0,7
19891,paññapuṅgavo,pannapungavo,1,1,0,0,12
19892,anantañāṇī,anantanani,1,1,0,0,10
19893,nijjhānī,nijjhani,1,1,0,0,8
19894,ñāṇasīsacūḷāmaṇi,nanasisaculamani,1,1,0,0,16
19895,narapāmokkho,narapamokkho,1,1,0,0,12
19896,nāyakānaṃ,nayakanam,2,2,0,0,9
19897,ñāṇiko,naniko,3,3,0,0,6
19898,ñāṇapuṇṇiko,nanapunniko,2,2,0,0,11
19899,ñāṇasamattho,nanasamattho,1,1,0,0,12
19900,ñāṇaṭṭho,nanattho,1,1,0,0,8
19901,ñāṇarāmo,nanaramo,1,1,0,0,8
19902,ñāṇarato,nanarato,1,1,0,0,8
19903,gambhīrañāṇakovido,gambhirananakovido,1,1,0,0,18
19904,ñāṇadassanasampanno,nanadassanasampanno,1,1,0,0,19
19905,ñāṇasobhito,nanasobhito,1,1,0,0,11
19906,ñāṇaggū,nanaggu,1,1,0,0,7
19907,laṅkāra,lankara,2,2,0,0,7
19908,ñāṇasiromaṇi,nanasiromani,1,1,0,0,12
19909,ñāṇavanto,nanavanto,1,1,0,0,9
19910,ñāṇavaro,nanavaro,1,1,0,0,8
19911,ñāṇaneru,nananeru,1,1,0,0,8
19912,suññāṇavā,sunnanava,1,1,0,0,9
19913,ñāṇasindhu,nanasindhu,1,1,0,0,10
19914,ñāṇodadhi,nanodadhi,1,1,0,0,9
19915,ñāṇamoli,nanamoli,1,1,0,0,8
19916,ñāṇamuddho,nanamuddho,1,1,0,0,10
19917,ñāṇadīpo,nanadipo,1,1,0,0,8
19918,ñāṇasikho,nanasikho,1,1,0,0,9
19919,ñāṇameru,nanameru,1,1,0,0,8
19920,ñāṇasiṅgo,nanasingo,1,1,0,0,9
19921,gambhīraññāṇī,gambhirannani,1,1,0,0,13
19922,tikkhaññāṇī,tikkhannani,1,1,0,0,11
19923,vicakkhaṇo,vicakkhano,149,143,6,0,10
19924,aññāṇamūlaṃ,annanamulam,2,2,0,0,11
19925,sabbañāṇī,sabbanani,1,1,0,0,9
19926,sabbaññāto,sabbannato,2,2,0,0,10
19927,sammapavattako,sammapavattako,1,1,0,0,14
19928,vitthāresi,vittharesi,11,11,0,0,10
19929,sabbaññutañāṇapatto,sabbannutananapatto,1,1,0,0,19
19930,sabbaviññū,sabbavinnu,1,1,0,0,10
19931,vināyako,vinayako,94,76,18,0,8
19932,nibbānasukhasampatto,nibbanasukhasampatto,1,1,0,0,20
19933,sabbañāṇiko,sabbananiko,1,1,0,0,11
19934,sabbato,sabbato,185,161,24,0,7
19935,maññanājaho,mannanajaho,1,1,0,0,11
19936,sabbamathitavikkhīṇo,sabbamathitavikkhino,1,1,0,0,20
19937,sabbañāṇādhipatiko,sabbananadhipatiko,1,1,0,0,18
19938,ñāṇadassāvī,nanadassavi,1,1,0,0,11
19939,dasabalādhipo,dasabaladhipo,1,1,0,0,13
19940,amitañāṇādhipati,amitananadhipati,1,1,0,0,16
19941,anuppatto,anuppatto,356,340,16,0,9
19942,paṭivedhañāṇayutto,pativedhananayutto,1,1,0,0,18
19943,māyāpaṭapacchedako,mayapatapacchedako,1,1,0,0,18
19944,avijjaṃ,avijjam,175,164,11,0,7
19945,paridhaṃsesi,paridhamsesi,1,1,0,0,12
19946,muttiñāṇaṃ,muttinanam,1,1,0,0,10
19947,maggasaccapakāsako,maggasaccapakasako,1,1,0,0,18
19948,kkhāyī,kkhayi,1,1,0,0,6
19949,maggavidū,maggavidu,30,26,4,0,9
19950,sabbāññāṇaṃ,sabbannanam,1,1,0,0,11
19951,mahāpaññānamuttamo,mahapannanamuttamo,1,1,0,0,18
19952,bodhiñāṇamahāsindhu,bodhinanamahasindhu,1,1,0,0,19
19953,sammādassanasampatto,sammadassanasampatto,1,1,0,0,20
19954,sammāñāṇapatiṭṭhito,sammananapatitthito,1,1,0,0,19
19955,sammāvimuttijitatto,sammavimuttijitatto,1,1,0,0,19
19956,vijjāsampanno,vijjasampanno,9,8,1,0,13
19957,ñāṇasikharasekharo,nanasikharasekharo,1,1,0,0,18
19958,sampatto,sampatto,169,160,9,0,8
19959,paramañāṇasampanno,paramananasampanno,1,1,0,0,18
19960,pavarapaññāpuṇṇiko,pavarapannapunniko,1,1,0,0,18
19961,sammāvimuttiṃ,sammavimuttim,11,9,2,0,13
19962,sabbadassāvī,sabbadassavi,40,39,1,0,12
19963,suññāṇī,sunnani,1,1,0,0,7
19964,sabbakiccesu,sabbakiccesu,42,42,0,0,12
19965,suguṇupeto,sugunupeto,1,1,0,0,10
19966,saṃvedanā,samvedana,1,1,0,0,9
19967,saṃveditvā,samveditva,2,2,0,0,10
19968,sokavigato,sokavigato,1,1,0,0,10
19969,sumato,sumato,1,1,0,0,6
19970,vedanāsu,vedanasu,880,865,15,0,8
19971,vītagijjho,vitagijjho,1,1,0,0,10
19972,vedanāmutto,vedanamutto,1,1,0,0,11
19973,vedagū,vedagu,149,121,28,0,6
19974,vedantagū,vedantagu,18,14,4,0,9
19975,vissāsabhūmi,vissasabhumi,1,1,0,0,12
19976,andhānaṃ,andhanam,29,26,3,0,8
19977,nayanūpamo,nayanupamo,3,3,0,0,10
19978,arakkheyyo,arakkheyyo,1,1,0,0,10
19979,ārakkhako,arakkhako,3,3,0,0,9
19980,dukkhasakkhī,dukkhasakkhi,1,1,0,0,12
19981,dukkhakkhīṇo,dukkhakkhino,1,1,0,0,12
19982,dukkhavidū,dukkhavidu,1,1,0,0,10
19983,dukkhantagū,dukkhantagu,1,1,0,0,11
19984,dukkhappahīno,dukkhappahino,1,1,0,0,13
19985,dukkhaññū,dukkhannu,1,1,0,0,9
19986,kāyasakkhī,kayasakkhi,119,103,16,0,10
19987,cittasakkhī,cittasakkhi,2,2,0,0,11
19988,vedanānusakkhī,vedananusakkhi,1,1,0,0,14
19989,dhammānusakkhī,dhammanusakkhi,1,1,0,0,14
19990,susakkhī,susakkhi,2,2,0,0,8
19991,santakāyo,santakayo,5,5,0,0,9
19992,santavāco,santavaco,6,5,1,0,9
19993,santacitto,santacitto,16,16,0,0,10
19994,samāhito,samahito,296,278,18,0,8
19995,sabbūpadhivūpasanto,sabbupadhivupasanto,1,1,0,0,19
19996,sammāsīle,sammasile,1,1,0,0,9
19997,sammāpaññāparipuṇṇo,sammapannaparipunno,1,1,0,0,19
19998,nikhilaniṭṭha,nikhilanittha,1,1,0,0,13
19999,dhigamo,dhigamo,1,1,0,0,7
