30000,dvebhāvo,dvebhavo,27,24,3,0,8
30001,pubbassikāro,pubbassikaro,1,1,0,0,12
30002,daddarasaddaṃ,daddarasaddam,3,3,0,0,13
30003,daddarikā,daddarika,1,0,1,0,9
30004,ubhayatalaṃ,ubhayatalam,10,8,2,0,11
30005,murajādikaṃ,murajadikam,2,2,0,0,11
30006,vitataṃ,vitatam,24,18,6,0,7
30007,sabbavinaddhaṃ,sabbavinaddham,1,0,1,0,14
30008,sabbapassesu,sabbapassesu,2,2,0,0,12
30009,pubbapacchābhāgesu,pubbapacchabhagesu,1,1,0,0,18
30010,pariyonaddhaṃ,pariyonaddham,20,14,6,0,13
30011,paṇavādikaṃ,panavadikam,2,2,0,0,11
30012,caturassaālambaragomukhīādayo,caturassaalambaragomukhiadayo,1,1,0,0,29
30013,ātatavitataṃ,atatavitatam,21,14,7,0,12
30014,cammapariyonaddhaṃ,cammapariyonaddham,4,4,0,0,18
30015,tantibaddhaṃ,tantibaddham,5,4,1,0,12
30016,paṇīyatīti,paniyatiti,2,2,0,0,10
30017,paṇavo,panavo,10,8,2,0,6
30018,vaṃsasaṅkhādikaṃ,vamsasankhadikam,1,1,0,0,16
30019,susiraṃ,susiram,44,32,12,0,7
30020,randhaṃ,randham,30,29,1,0,7
30021,vaṃso,vamso,152,144,8,0,5
30022,upasamakhedesu,upasamakhedesu,1,1,0,0,14
30023,sammatāḷādikaṃ,sammataladikam,2,2,0,0,14
30024,accantaṃ,accantam,196,179,17,0,8
30025,pīḷanato,pilanato,10,9,1,0,8
30026,analasaṃyogato,analasamyogato,1,1,0,0,14
30027,dravībhūtaṃ,dravibhutam,2,2,0,0,11
30028,ghanāyateti,ghanayateti,1,1,0,0,11
30029,ghanā,ghana,14,11,3,0,5
30030,khyaṃ,khyam,3,3,0,0,5
30031,ghanabhāvena,ghanabhavena,14,14,0,0,12
30032,sammaṃ,sammam,13,7,6,0,6
30033,daṇḍādīhi,dandadihi,20,20,0,0,9
30034,tāḷitabbato,talitabbato,1,1,0,0,11
30035,tāḷaṃ,talam,21,15,6,0,5
30036,taḷa,tala,6,1,5,0,4
30037,sammañca,sammanca,4,4,0,0,8
30038,tāḷañceti,talanceti,1,1,0,0,9
30039,sammatāḷaṃ,sammatalam,9,4,5,0,10
30040,kaṃsatāḷasilātāḷādīnaṃ,kamsatalasilataladinam,1,1,0,0,22
30041,kaṭṭhamayatāḷaṃ,katthamayatalam,1,1,0,0,15
30042,kaṃsatāḷaṃ,kamsatalam,14,9,5,0,10
30043,lohamayaṃ,lohamayam,25,23,2,0,9
30044,silāya,silaya,59,58,1,0,6
30045,ayopaṭṭena,ayopattena,7,7,0,0,10
30046,vādanatāḷaṃ,vadanatalam,3,3,0,0,11
30047,silātāḷaṃ,silatalam,1,0,1,0,9
30048,ātatādīnaṃ,atatadinam,1,1,0,0,10
30049,tujjate,tujjate,2,2,0,0,7
30050,tāḷīyateti,taliyateti,1,1,0,0,10
30051,ātojjaṃ,atojjam,2,1,1,0,7
30052,vaṃsādikepi,vamsadikepi,1,1,0,0,11
30053,mukhavāyunā,mukhavayuna,2,2,0,0,11
30054,ātojjanamattheva,atojjanamattheva,1,1,0,0,16
30055,dhanayanti,dhanayanti,1,1,0,0,10
30056,vādittaṃ,vadittam,5,4,1,0,8
30057,vāditañca,vaditanca,13,12,1,0,9
30058,itto,itto,1,1,0,0,4
30059,vajjaṃ,vajjam,238,208,30,0,6
30060,bheriyaṃ,bheriyam,2,2,0,0,8
30061,sattujanā,sattujana,1,1,0,0,9
30062,ri,ri,33,15,18,0,2
30063,ubhanaṃ,ubhanam,1,1,0,0,7
30064,ubhi,ubhi,4,4,0,0,4
30065,dunda,dunda,1,1,0,0,5
30066,dundubhi,dundubhi,7,5,2,0,8
30067,pumitthiyamete,pumitthiyamete,1,1,0,0,14
30068,serī,seri,38,36,2,0,4
30069,thī,thi,49,40,9,0,3
30070,pumā,puma,108,102,6,0,4
30071,mudiṅge,mudinge,1,1,0,0,7
30072,modaṃ,modam,3,2,1,0,5
30073,iṅgati,ingati,3,3,0,0,6
30074,mudiṅgo,mudingo,6,5,1,0,7
30075,murā,mura,1,1,0,0,4
30076,murajo,murajo,5,4,1,0,6
30077,murajassa,murajassa,1,1,0,0,9
30078,āliṅgaṅkyoddhakā,alingankyoddhaka,1,1,0,0,16
30079,haritakyākati,haritakyakati,1,1,0,0,13
30080,tvaṅkyo,tvankyo,1,1,0,0,7
30081,yavamajjho,yavamajjho,1,1,0,0,10
30082,tatho,tatho,65,62,3,0,5
30083,ddhako,ddhako,1,1,0,0,6
30084,āliṅgyo,alingyo,1,1,0,0,7
30085,gopuccho,gopuccho,1,1,0,0,8
30086,ākatyā,akatya,1,1,0,0,6
30087,sampakittito,sampakittito,1,1,0,0,12
30088,āliṅgyateti,alingyateti,1,1,0,0,11
30089,āliṅgo,alingo,3,1,2,0,6
30090,ucchaṅke,ucchanke,2,2,0,0,8
30091,akyo,akyo,1,0,1,0,4
30092,ekena,ekena,2084,1986,98,0,5
30093,mukhena,mukhena,434,408,26,0,7
30094,vādanato,vadanato,1,1,0,0,8
30095,uddho,uddho,2,1,1,0,5
30096,saddāyatīti,saddayatiti,6,5,1,0,11
30097,uddhako,uddhako,1,0,1,0,7
30098,uddhasaddoyaṃ,uddhasaddoyam,1,1,0,0,13
30099,tiliṅgiko,tilingiko,18,18,0,0,9
30100,nerutto,nerutto,15,15,0,0,7
30101,tiṇavā,tinava,1,0,1,0,6
30102,paṇavassa,panavassa,2,2,0,0,9
30103,tiṇavo,tinavo,2,1,1,0,6
30104,ḍiṇḍi,dindi,1,1,0,0,5
30105,māyate,mayate,1,1,0,0,6
30106,ḍiṇḍimo,dindimo,10,8,2,0,7
30107,ālamba,alamba,2,2,0,0,6
30108,ālambaro,alambaro,4,2,2,0,8
30109,tūriyarave,turiyarave,1,1,0,0,10
30110,gajendānañca,gajendananca,1,1,0,0,12
30111,gajjite,gajjite,2,2,0,0,7
30112,nānatthasaṅgahesu,nanatthasangahesu,1,0,1,0,17
30113,vīṇādīnaṃ,vinadinam,3,2,1,0,9
30114,vādanakaṭṭhakuṭilādikaṃ,vadanakatthakutiladikam,1,1,0,0,23
30115,koṇo,kono,12,9,3,0,4
30116,kuṇyate,kunyate,1,1,0,0,7
30117,saddāyatenenāti,saddayatenenati,1,1,0,0,15
30118,dadda,dadda,1,1,0,0,5
30119,daddari,daddari,3,1,2,0,7
30120,daddati,daddati,1,1,0,0,7
30121,saddavisesena,saddavisesena,1,1,0,0,13
30122,pariṇamatīti,parinamatiti,10,6,4,0,12
30123,jahātīti,jahatiti,14,13,1,0,8
30124,paṭaho,pataho,4,1,3,0,6
30125,paṭaṃ,patam,27,26,1,0,5
30126,maddalā,maddala,3,0,3,0,7
30127,bherippabhedā,bherippabheda,2,2,0,0,13
30128,madda,madda,6,4,2,0,5
30129,lā,la,39,17,22,0,2
30130,mandalā,mandala,2,1,1,0,7
30131,ḍamaruādayopi,damaruadayopi,1,1,0,0,13
30132,janappiye,janappiye,2,1,1,0,9
30133,piyāyitabbe,piyayitabbe,2,2,0,0,11
30134,vimaddoṭṭhe,vimaddotthe,1,1,0,0,11
30135,vilepanakuṅkumādīnaṃ,vilepanakunkumadinam,1,1,0,0,20
30136,nānāgandhadabbānañca,nanagandhadabbananca,1,1,0,0,20
30137,vimaddanobbhūte,vimaddanobbhute,1,1,0,0,15
30138,parimalo,parimalo,3,1,2,0,8
30139,pavattayatyāsayanti,pavattayatyasayanti,1,1,0,0,19
30140,malla,malla,5,0,5,0,5
30141,parimalyate,parimalyate,1,1,0,0,11
30142,dhārīyateti,dhariyateti,1,1,0,0,11
30143,vimadda,vimadda,1,0,1,0,7
30144,ggahaṇena,ggahanena,250,250,0,0,9
30145,vāpikūpādino,vapikupadino,1,1,0,0,12
30146,vimaddagandhādino,vimaddagandhadino,1,1,0,0,17
30147,makkhikādino,makkhikadino,1,1,0,0,12
30148,dūragāmī,duragami,3,2,1,0,8
30149,atinihārī,atinihari,1,1,0,0,9
30150,atidūrapātī,atidurapati,1,1,0,0,11
30151,āmodo,amodo,2,1,1,0,5
30152,āmodante,amodante,1,1,0,0,8
30153,iṭṭhagandhā,itthagandha,1,0,1,0,11
30154,vissa,vissa,6,5,1,0,5
30155,saddapariyantā,saddapariyanta,1,1,0,0,14
30156,vattante,vattante,22,21,1,0,8
30157,iṭṭhagandhe,itthagandhe,1,1,0,0,11
30158,iṭṭho,ittho,80,80,0,0,5
30159,iṭṭhagandho,itthagandho,4,2,2,0,11
30160,rabhanti,rabhanti,1,1,0,0,8
30161,tussantyanenāti,tussantyanenati,1,1,0,0,15
30162,surabhi,surabhi,16,13,3,0,7
30163,sugandho,sugandho,32,30,2,0,8
30164,sugandhi,sugandhi,17,10,7,0,8
30165,antassikārādeso,antassikaradeso,1,1,0,0,15
30166,duggandhe,duggandhe,13,12,1,0,9
30167,kammadhārayasamāsaṃ,kammadharayasamasam,2,2,0,0,19
30168,assatthyatthepi,assatthyatthepi,1,1,0,0,15
30169,kattumicchanti,kattumicchanti,1,1,0,0,14
30170,pakriyālāghavatthaṃ,pakriyalaghavattham,1,1,0,0,19
30171,bahubbīhiyeva,bahubbihiyeva,1,1,0,0,13
30172,nyāyoti,nyayoti,1,1,0,0,7
30173,duggandho,duggandho,80,75,5,0,9
30174,kaccāyanena,kaccayanena,16,14,2,0,11
30175,kammadhārayamantatthiyehi,kammadharayamantatthiyehi,1,1,0,0,25
30176,laghutaro,laghutaro,1,1,0,0,9
30177,lāghava,laghava,1,1,0,0,7
30178,manādaramānā,manadaramana,1,1,0,0,12
30179,icchanteva,icchanteva,5,5,0,0,10
30180,mantatthiyaṃ,mantatthiyam,1,1,0,0,12
30181,vāccadhammo,vaccadhammo,1,1,0,0,11
30182,bahubbīhinā,bahubbihina,2,2,0,0,11
30183,kammadhārayamantatthiyenagaru,kammadharayamantatthiyenagaru,1,1,0,0,29
30184,kiñca,kinca,491,469,22,0,5
30185,atisāyanādyattho,atisayanadyattho,1,1,0,0,16
30186,gamyateti,gamyateti,12,12,0,0,9
30187,tappaṭipādanāya,tappatipadanaya,1,1,0,0,15
30188,kammadhārayapubbako,kammadharayapubbako,1,1,0,0,19
30189,mantatthiyeva,mantatthiyeva,1,1,0,0,13
30190,citādhūmādigandhe,citadhumadigandhe,1,1,0,0,17
30191,visa,visa,36,10,26,0,4
30192,vippayoge,vippayoge,10,9,1,0,9
30193,āmassa,amassa,1,1,0,0,6
30194,vasādivatthuno,vasadivatthuno,1,1,0,0,14
30195,napuṃsakattadīpako,napumsakattadipako,1,1,0,0,18
30196,kuṅkumā,kunkuma,1,0,1,0,7
30197,catujjātigandho,catujjatigandho,1,1,0,0,15
30198,kuka,kuka,25,12,13,0,4
30199,vaka,vaka,18,5,13,0,4
30200,kuṅkumaṃ,kunkumam,12,10,2,0,8
30201,lohitacandanaṃ,lohitacandanam,24,24,0,0,14
30202,kasmīrajaṃ,kasmirajam,4,3,1,0,10
30203,kuṅkā,kunka,1,0,1,0,5
30204,missane,missane,17,16,1,0,7
30205,yavanaṃ,yavanam,1,1,0,0,7
30206,yavanapupphaṃ,yavanapuppham,2,0,2,0,13
30207,devakusumaṃ,devakusumam,3,2,1,0,11
30208,yavanadese,yavanadese,1,1,0,0,10
30209,pupphanti,pupphanti,71,67,4,0,9
30210,lavaṅgaṃ,lavangam,2,2,0,0,8
30211,nuhīpupphasamānaṃ,nuhipupphasamanam,1,1,0,0,17
30212,tagi,tagi,2,0,2,0,4
30213,tagaraṃ,tagaram,17,16,1,0,7
30214,taruto,taruto,3,2,1,0,6
30215,turukkho,turukkho,3,2,1,0,8
30216,sallakīdavo,sallakidavo,1,1,0,0,11
30217,charasānaṃ,charasanam,1,1,0,0,10
30218,sevateti,sevateti,1,1,0,0,8
30219,kasāvo,kasavo,22,20,2,0,6
30220,savāpetīti,savapetiti,1,1,0,0,10
30221,tuvaropi,tuvaropi,1,1,0,0,8
30222,kasāyopi,kasayopi,1,1,0,0,8
30223,tija,tija,27,10,17,0,4
30224,kaṭu,katu,4,2,2,0,4
30225,madhu,madhu,141,111,30,0,5
30226,mādhuriyaṃ,madhuriyam,1,1,0,0,10
30227,jaḷattanti,jalattanti,1,1,0,0,10
30228,lavaṇo,lavano,2,1,1,0,6
30229,amba,amba,15,6,9,0,4
30230,lattañca,lattanca,1,1,0,0,8
30231,kaṭa,kata,20,6,14,0,4
30232,kasāvā,kasava,27,23,4,0,6
30233,disaddā,disadda,9,9,0,0,7
30234,phoṭṭhabbe,photthabbe,197,197,0,0,10
30235,phusitabbo,phusitabbo,2,2,0,0,10
30236,phoṭṭhabbo,photthabbo,45,44,1,0,10
30237,tabbo,tabbo,13,11,2,0,5
30238,ṭo,to,87,72,15,0,2
30239,visayimhi,visayimhi,3,3,0,0,9
30240,gayhaṭṭhenātthīti,gayhatthenatthiti,1,1,0,0,17
30241,visayi,visayi,1,0,1,0,6
30242,visayeti,visayeti,18,12,6,0,8
30243,akkhaṃ,akkham,35,28,7,0,6
30244,ussattaṃ,ussattam,12,12,0,0,8
30245,dvittañca,dvittanca,37,37,0,0,9
30246,sukhavedanādayo,sukhavedanadayo,1,1,0,0,15
30247,sampayogavasena,sampayogavasena,45,42,3,0,15
30248,pañcasu,pancasu,1157,1114,43,0,7
30249,indriyesu,indriyesu,398,373,25,0,9
30250,javanādīsu,javanadisu,1,1,0,0,10
30251,manindriye,manindriye,47,47,0,0,10
30252,tūpacārā,tupacara,4,4,0,0,8
30253,manindriyesupacārā,manindriyesupacara,1,1,0,0,18
30254,nantarena,nantarena,1,1,0,0,9
30255,payojakaṃ,payojakam,2,2,0,0,9
30256,cakkhādayo,cakkhadayo,70,66,4,0,10
30257,byāpārayante,byaparayante,1,1,0,0,12
30258,cakkhādīnaṃ,cakkhadinam,205,197,8,0,11
30259,payojakoti,payojakoti,3,3,0,0,10
30260,cakkhādikaṃ,cakkhadikam,6,6,0,0,11
30261,liṅgamattano,lingamattano,1,1,0,0,12
30262,nikāyantarikā,nikayantarika,4,3,1,0,13
30263,tikkhamandādibhāve,tikkhamandadibhave,1,1,0,0,18
30264,tikkhamandādibhāvasambhavato,tikkhamandadibhavasambhavato,1,1,0,0,28
30265,nissitaṃ,nissitam,79,72,7,0,8
30266,visayesu,visayesu,49,49,0,0,8
30267,byāpī,byapi,4,4,0,0,5
30268,akkha,akkha,4,0,4,0,5
30269,byāpanadassanesu,byapanadassanesu,1,1,0,0,16
30270,akkhati,akkhati,3,3,0,0,7
30271,byāpībhavati,byapibhavati,1,1,0,0,12
30272,locati,locati,2,2,0,0,6
30273,locanaṃ,locanam,19,16,3,0,7
30274,accha,accha,11,10,1,0,5
30275,dassanabyāpanesu,dassanabyapanesu,1,1,0,0,16
30276,acchi,acchi,33,31,2,0,5
30277,assādeti,assadeti,569,563,6,0,8
30278,rūpanti,rupanti,197,189,8,0,7
30279,sote,sote,46,44,2,0,4
30280,sotaṃ,sotam,789,723,66,0,5
30281,saddaggaho,saddaggaho,2,1,1,0,10
30282,kaṇṇo,kanno,27,23,4,0,5
30283,kaṇṇati,kannati,2,2,0,0,7
30284,savanaṃ,savanam,176,148,28,0,7
30285,ghāne,ghane,7,7,0,0,5
30286,nasanti,nasanti,5,5,0,0,7
30287,nāsā,nasa,43,38,5,0,4
30288,aka,aka,17,6,11,0,3
30289,nāsikā,nasika,43,41,2,0,6
30290,ghā,gha,17,10,7,0,3
30291,gandhopādāne,gandhopadane,6,4,2,0,12
30292,ghāyati,ghayati,37,37,0,0,7
30293,gandhopādānaṃ,gandhopadanam,3,3,0,0,13
30294,ghānaṃ,ghanam,368,341,27,0,6
30295,ghāyantyanenāti,ghayantyanenati,1,1,0,0,15
30296,jivhāyaṃ,jivhayam,3,3,0,0,8
30297,jīvitanimittaṃ,jivitanimittam,10,10,0,0,14
30298,hiṃsantīti,himsantiti,10,6,4,0,10
30299,vapa,vapa,15,4,11,0,4
30300,kusalākusalametenāti,kusalakusalametenati,1,1,0,0,20
30301,gattaṃ,gattam,45,43,2,0,6
30302,gamu,gamu,49,8,41,0,4
30303,gaha,gaha,37,7,30,0,4
30304,upādāne,upadane,76,74,2,0,7
30305,vuṇoti,vunoti,4,4,0,0,6
30306,bondi,bondi,11,9,2,0,5
30307,vu,vu,30,8,22,0,2
30308,diha,diha,4,0,4,0,4
30309,kusalākusalanti,kusalakusalanti,3,3,0,0,15
30310,deha,deha,3,2,1,0,4
30311,pulliṅgevattati,pullingevattati,1,1,0,0,15
30312,kucchitānaṃ,kucchitanam,85,79,6,0,11
30313,āyo,ayo,93,83,10,0,3
30314,uppattiṭṭhānanti,uppattitthananti,5,5,0,0,16
30315,sambandhitabbo,sambandhitabbo,33,33,0,0,14
30316,aṅgenāṅgaṃ,angenangam,1,1,0,0,10
30317,gāḷhatattena,galhatattena,1,1,0,0,12
30318,tattaṃ,tattam,98,92,6,0,6
30319,uttaramegha,uttaramegha,1,1,0,0,11
30320,meghadūte,meghadute,1,0,1,0,9
30321,kaḷe,kale,2,2,0,0,4
30322,retasi,retasi,2,2,0,0,6
30323,kaḷevaraṃ,kalevaram,40,36,4,0,9
30324,aluttasamāsoyaṃ,aluttasamasoyam,10,10,0,0,15
30325,para152-154,para152-154,1,1,0,0,11
30326,cintetīti,cintetiti,42,39,3,0,9
30327,ceto,ceto,250,232,18,0,4
30328,nalopo,nalopo,6,6,0,0,6
30329,vijānātīti,vijanatiti,99,83,16,0,10
30330,ādhāranti,adharanti,2,2,0,0,9
30331,mānasaṃ,manasam,489,437,52,0,7
30332,saṇa,sana,16,9,7,0,4
30333,buddhākhyassa,buddhakhyassa,1,1,0,0,13
30334,guṇassa,gunassa,42,41,1,0,7
30335,jhāyatīti,jhayatiti,69,46,23,0,9
30336,jhe,jhe,21,4,17,0,3
30337,jhassa,jhassa,5,5,0,0,6
30338,saṅkhāresu,sankharesu,406,399,7,0,10
30339,dhīkāro,dhikaro,2,2,0,0,7
30340,paññāyate,pannayate,6,6,0,0,9
30341,bujjhate,bujjhate,9,9,0,0,8
30342,medha,medha,7,1,6,0,5
30343,hiṃ,him,57,48,9,0,3
30344,sāsaṅgamesu,sasangamesu,1,1,0,0,11
30345,mi,mi,229,204,25,0,2
30346,medhā,medha,102,88,14,0,5
30347,muti,muti,10,5,5,0,4
30348,muna,muna,10,3,7,0,4
30349,bhūrī,bhuri,74,64,10,0,5
30350,bhūsaṅkhāte,bhusankhate,1,1,0,0,11
30351,mantā,manta,196,164,32,0,5
30352,yamati,yamati,6,6,0,0,6
30353,missībhavati,missibhavati,2,2,0,0,12
30354,ñeyyesūti,neyyesuti,1,1,0,0,9
30355,paṭimukhaṃ,patimukham,71,70,1,0,10
30356,upaṭṭhahanti,upatthahanti,274,269,5,0,12
30357,paṭibhānaṃ,patibhanam,112,84,28,0,10
30358,vīmaṃsā,vimamsa,148,133,15,0,7
30359,vicayo,vicayo,147,128,19,0,6
30360,samupekkhā,samupekkha,1,1,0,0,10
30361,upaladdhi,upaladdhi,14,13,1,0,9
30362,paṭipatti,patipatti,227,216,11,0,9
30363,utticetanādīnipi,utticetanadinipi,1,1,0,0,16
30364,buddhināmāni,buddhinamani,1,1,0,0,12
30365,nepakka,nepakka,1,0,1,0,7
30366,pariyāyā,pariyaya,31,30,1,0,8
30367,paññābhedā,pannabheda,2,1,1,0,10
30368,paññāvisesā,pannavisesa,2,2,0,0,11
30369,aniccādikaṃ,aniccadikam,2,2,0,0,11
30370,sammādassanalakkhaṇā,sammadassanalakkhana,5,4,1,0,20
30371,lokiyalokuttaravasena,lokiyalokuttaravasena,33,29,4,0,21
30372,purimā,purima,1189,1148,41,0,6
30373,chabbisuddhippavattikāle,chabbisuddhippavattikale,1,1,0,0,24
30374,ñāṇadassanavisuddhikāle,nanadassanavisuddhikale,1,1,0,0,23
30375,anaññātaññassāmītindriyādayo,anannatannassamitindriyadayo,1,1,0,0,28
30376,kāriyesu,kariyesu,3,3,0,0,8
30377,vicāraṇā,vicarana,117,111,6,0,8
30378,vīmaṃsāyaṃ,vimamsayam,8,6,2,0,10
30379,cittābhogādi,cittabhogadi,1,1,0,0,12
30380,vicārayate,vicarayate,1,1,0,0,10
30381,cara,cara,246,190,56,0,4
30382,sañcaye,sancaye,12,11,1,0,7
30383,curādigaṇo,curadigano,6,6,0,0,10
30384,sampajānātīti,sampajanatiti,21,16,5,0,13
30385,dhammasamūho,dhammasamuho,18,18,0,0,12
30386,sampajaññaṃ,sampajannam,168,141,27,0,11
30387,sātthakasampajaññādivasena,satthakasampajannadivasena,3,3,0,0,26
30388,pāceti,paceti,22,22,0,0,6
30389,kusaladhammeti,kusaladhammeti,1,1,0,0,14
30390,nepakkaṃ,nepakkam,33,26,7,0,8
30391,vedanāyaṃ,vedanayam,11,11,0,0,9
30392,vedayatīti,vedayatiti,62,50,12,0,10
30393,vedayitaṃ,vedayitam,561,525,36,0,9
30394,vida,vida,53,13,40,0,4
30395,curā,cura,3,2,1,0,4
30396,ṇayo,nayo,4,2,2,0,4
30397,vitakke,vitakke,102,93,9,0,7
30398,takka,takka,17,8,9,0,5
30399,takketi,takketi,7,7,0,0,7
30400,abhiniropetīti,abhiniropetiti,8,6,2,0,14
30401,takko,takko,142,130,12,0,5
30402,vitakkoti,vitakkoti,31,22,9,0,9
30403,upasaggamattameva,upasaggamattameva,11,10,1,0,17
30404,saṅkappanti,sankappanti,7,7,0,0,11
30405,pabhavantyanenāti,pabhavantyanenati,3,3,0,0,17
30406,saṅkappo,sankappo,153,139,14,0,8
30407,sāmatthiye,samatthiye,15,11,4,0,10
30408,bhūvādi,bhuvadi,105,43,62,0,7
30409,saṅkappayanti,sankappayanti,1,1,0,0,13
30410,appeti,appeti,69,66,3,0,6
30411,pāpeti,papeti,174,164,10,0,6
30412,appanā,appana,269,246,23,0,6
30413,ūha,uha,6,1,5,0,3
30414,ūhantyanenāti,uhantyanenati,1,1,0,0,13
30415,ūho,uho,2,1,1,0,3
30416,takkaūha,takkauha,1,0,1,0,8
30417,ajjhāhāravācakāpi,ajjhaharavacakapi,1,1,0,0,17
30418,ajjhāhāraṃ,ajjhaharam,3,3,0,0,10
30419,ūnapūraṇatthamadhikappabhedāharaṇaṃ,unapuranatthamadhikappabhedaharanam,1,1,0,0,35
30420,madhikopādānaṃ,madhikopadanam,1,1,0,0,14
30421,ajjhāhāro,ajjhaharo,8,8,0,0,9
30422,ūhā,uha,7,7,0,0,3
30423,jīvitindriye,jivitindriye,7,7,0,0,12
30424,addhānaṃ,addhanam,426,361,65,0,8
30425,isse,isse,13,13,0,0,4
30426,nānālambaṇavisāraṇābhāvato,nanalambanavisaranabhavato,1,1,0,0,26
30427,ārammaṇametassāti,arammanametassati,4,4,0,0,17
30428,ekaggaṃ,ekaggam,209,184,25,0,7
30429,ālambaṇavācako,alambanavacako,1,1,0,0,14
30430,saddhammaṭīkāyaṃ,saddhammatikayam,1,0,1,0,16
30431,ekaggatā,ekaggata,184,169,15,0,8
30432,kāmacchandaṃ,kamacchandam,103,94,9,0,12
30433,sametīti,sametiti,149,114,35,0,8
30434,samu,samu,18,1,17,0,4
30435,kāmacchandassa,kamacchandassa,152,145,7,0,14
30436,paṭipakkho,patipakkho,177,170,7,0,10
30437,pārā,para,2066,2065,1,0,4
30438,vikkhipanaṃ,vikkhipanam,5,4,1,0,11
30439,nānārammaṇaperaṇaṃ,nanarammanaperanam,1,1,0,0,18
30440,avikkhepo,avikkhepo,543,516,27,0,9
30441,ādhānaṃ,adhanam,26,24,2,0,7
30442,saññāyami,sannayami,1,1,0,0,9
30443,nānālambaṇavikkhepavasappavattaṃ,nanalambanavikkhepavasappavattam,1,1,0,0,32
30444,adhisaṅkhātaṃ,adhisankhatam,1,1,0,0,13
30445,cittabyadhaṃ,cittabyadham,1,1,0,0,12
30446,vīriyassa,viriyassa,170,157,13,0,9
30447,dukkhalābhaṃ,dukkhalabham,1,1,0,0,12
30448,cittañca,cittanca,419,411,8,0,8
30449,tāpetīti,tapetiti,9,9,0,0,8
30450,ātappo,atappo,1,0,1,0,6
30451,ātāpo,atapo,29,27,2,0,5
30452,santāpe,santape,19,17,2,0,7
30453,līnaṃ,linam,85,77,8,0,5
30454,paggaṇhāti,pagganhati,249,244,5,0,10
30455,ukkhipatīti,ukkhipatiti,16,4,12,0,11
30456,paggaho,paggaho,61,47,14,0,7
30457,paramatthepī,paramatthepi,1,1,0,0,12
30458,vāyāmo,vayamo,237,222,15,0,6
30459,vāyama,vayama,12,10,2,0,6
30460,ussāhane,ussahane,3,3,0,0,8
30461,vaya,vaya,9,2,7,0,4
30462,vayati,vayati,5,5,0,0,6
30463,sabbakālanti,sabbakalanti,9,9,0,0,12
30464,akkamatīti,akkamatiti,10,6,4,0,10
30465,paccanīkabhūtaṃ,paccanikabhutam,1,1,0,0,15
30466,padahati,padahati,223,221,2,0,8
30467,daha,daha,15,1,14,0,4
30468,bhasmīkaraṇe,bhasmikarane,11,10,1,0,12
30469,papubbadhādhātunā,papubbadhadhatuna,1,1,0,0,17
30470,sādhetabbaṃ,sadhetabbam,35,35,0,0,11
30471,maññe,manne,789,719,70,0,5
30472,īrayitabbaṃ,irayitabbam,10,10,0,0,11
30473,īra,ira,9,2,7,0,3
30474,subhāsubhaphalanti,subhasubhaphalanti,2,2,0,0,18
30475,ceṭṭhāyaṃ,cetthayam,1,1,0,0,9
30476,uyyāmo,uyyamo,32,26,6,0,6
30477,vuttapariyāyassa,vuttapariyayassa,1,1,0,0,16
30478,tacādīnaṃ,tacadinam,2,2,0,0,9
30479,avasissanaṃ,avasissanam,1,0,1,0,11
30480,avasesatā,avasesata,1,1,0,0,9
30481,maṃsalohitehi,mamsalohitehi,13,13,0,0,13
30482,avadhibhūtehi,avadhibhutehi,2,2,0,0,13
30483,maṃsalohitānaṃ,mamsalohitanam,2,2,0,0,14
30484,sussanaṃ,sussanam,3,2,1,0,8
30485,sukkhatā,sukkhata,1,1,0,0,8
30486,adhiṭṭhānavasappavattāni,adhitthanavasappavattani,1,1,0,0,24
30487,kāraṇāni,karanani,193,190,3,0,8
30488,siddhiṃ,siddhim,18,16,2,0,7
30489,vīriyaphalametehīti,viriyaphalametehiti,1,1,0,0,19
30490,taca,taca,6,3,3,0,4
30491,naha,naha,23,6,17,0,4
30492,āru,aru,1,1,0,0,3
30493,nhārū,nharu,24,20,4,0,5
30494,ntassa,ntassa,60,57,3,0,6
30495,sisa,sisa,23,15,8,0,4
30496,asabbappayoge,asabbappayoge,2,1,1,0,13
30497,addhānanti,addhananti,11,11,0,0,10
30498,niggahītaṃ,niggahitam,96,82,14,0,10
30499,lohitaṃ,lohitam,444,409,35,0,7
30500,asājhasādhanepi,asajhasadhanepi,1,1,0,0,15
30501,adhimattehā,adhimatteha,1,0,1,0,11
30502,adhikasattiyuttā,adhikasattiyutta,1,1,0,0,16
30503,ussoḷhī,ussolhi,71,65,6,0,7
30504,pabalaṃ,pabalam,2,2,0,0,7
30505,dukkarakammaṃ,dukkarakammam,4,4,0,0,13
30506,yāyāti,yayati,17,7,10,0,6
30507,ussoḷī,ussoli,2,0,2,0,6
30508,soḷho,solho,1,0,1,0,5
30509,ussāhānaṃ,ussahanam,1,1,0,0,9
30510,ūhāti,uhati,1,1,0,0,5
30511,ākārasso,akarasso,1,1,0,0,8
30512,vāyāmamattepi,vayamamattepi,1,1,0,0,13
30513,satiyaṃ,satiyam,8,8,0,0,7
30514,saraṇamattameva,saranamattameva,8,8,0,0,15
30515,esāti,esati,124,55,69,0,5
30516,anussati,anussati,129,122,7,0,8
30517,lajjāyaṃ,lajjayam,4,2,2,0,8
30518,laji,laji,3,0,3,0,4
30519,pīḷe,pile,2,2,0,0,4
30520,lajja,lajja,4,1,3,0,5
30521,lajjane,lajjane,4,3,1,0,7
30522,moggallānadhātu,moggallanadhatu,1,1,0,0,15
30523,lajjati,lajjati,21,21,0,0,7
30524,pāpāti,papati,7,2,5,0,6
30525,lajjiyaṃ,lajjiyam,1,1,0,0,8
30526,hiriyati,hiriyati,13,12,1,0,8
30527,ottappe,ottappe,3,3,0,0,7
30528,ottappati,ottappati,72,72,0,0,9
30529,ottappaṃ,ottappam,217,198,19,0,8
30530,pāpato,papato,95,90,5,0,6
30531,pāpabhīru,papabhiru,1,0,1,0,9
30532,pajjaddhena,pajjaddhena,1,1,0,0,11
30533,upekkhāya,upekkhaya,357,347,10,0,9
30534,majjhatte,majjhatte,24,22,2,0,9
30535,majjhattasabhāve,majjhattasabhave,1,1,0,0,16
30536,majjhattikā,majjhattika,1,0,1,0,11
30537,vedanānaṃ,vedananam,273,250,23,0,9
30538,anubhavananti,anubhavananti,10,10,0,0,13
30539,upekkhā,upekkha,804,731,73,0,7
30540,ikkha,ikkha,14,6,8,0,5
30541,adukkhā,adukkha,7,7,0,0,7
30542,asukhā,asukha,2,2,0,0,6
30543,adukkhamasukhā,adukkhamasukha,276,256,20,0,14
30544,manasikāre,manasikare,35,35,0,0,10
30545,bhavaṅgavasena,bhavangavasena,21,21,0,0,14
30546,ābhujanato,abhujanato,2,2,0,0,10
30547,āvaṭṭāpanato,avattapanato,1,1,0,0,12
30548,cittābhogo,cittabhogo,4,2,2,0,10
30549,pālanajjhohārattho,palanajjhoharattho,1,1,0,0,18
30550,bhuja,bhuja,47,16,31,0,5
30551,āvaṭṭanattho,avattanattho,1,1,0,0,12
30552,pubbattā,pubbatta,14,14,0,0,8
30553,vīthijavanapaṭipādake,vithijavanapatipadake,4,4,0,0,21
30554,cittassārammaṇe,cittassarammane,2,2,0,0,15
30555,ābhujanaṃ,abhujanam,7,6,1,0,9
30556,ārammaṇapaṭipādakavasena,arammanapatipadakavasena,1,1,0,0,24
30557,bhavaṅgamanato,bhavangamanato,3,3,0,0,14
30558,manakkāro,manakkaro,13,8,5,0,9
30559,manasmiṃ,manasmim,81,79,2,0,8
30560,paṭhamavikappena,pathamavikappena,1,1,0,0,16
30561,paṭipādakā,patipadaka,1,1,0,0,10
30562,itaro,itaro,685,674,11,0,5
30563,adhimokkhe,adhimokkhe,12,10,2,0,10
30564,muca,muca,30,12,18,0,4
30565,mocane,mocane,30,26,4,0,6
30566,adhimuccanaṃ,adhimuccanam,33,31,2,0,12
30567,idamevā,idameva,10,5,5,0,7
30568,sanniṭṭhānakaraṇaṃ,sannitthanakaranam,2,2,0,0,18
30569,adhimokkho,adhimokkho,196,178,18,0,10
30570,nicchayanaṃ,nicchayanam,7,7,0,0,11
30571,niṇṇayanaṃ,ninnayanam,1,1,0,0,10
30572,nicchayo,nicchayo,54,50,4,0,8
30573,chedanaṃ,chedanam,62,50,12,0,8
30574,chidi,chidi,17,3,14,0,5
30575,issattaṃ,issattam,24,19,5,0,8
30576,dayāyaṃ,dayayam,2,1,1,0,7
30577,daya,daya,10,5,5,0,4
30578,dānagatihiṃsārakkhaṇesu,danagatihimsarakkhanesu,1,1,0,0,23
30579,attasukhañca,attasukhanca,1,1,0,0,12
30580,kapi,kapi,52,38,14,0,4
30581,calane,calane,30,23,7,0,6
30582,attādhārassa,attadharassa,1,1,0,0,12
30583,anukampā,anukampa,42,37,5,0,8
30584,rudhi,rudhi,13,5,8,0,5
30585,attānamadhīnametāyāti,attanamadhinametayati,1,1,0,0,21
30586,anuddayāti,anuddayati,4,0,4,0,10
30587,viratiyaṃ,viratiyam,3,2,1,0,9
30588,ramu,ramu,13,1,12,0,4
30589,viramaṇaṃ,viramanam,19,19,0,0,9
30590,veramaṇī,veramani,422,397,25,0,8
30591,maṇati,manati,15,14,1,0,6
30592,dūrato,durato,158,150,8,0,6
30593,ārati,arati,66,59,7,0,5
30594,titikkhanaṃ,titikkhanam,7,7,0,0,11
30595,kattādi,kattadi,4,4,0,0,7
30596,khamate,khamate,4,4,0,0,7
30597,khamā,khama,48,42,6,0,5
30598,khamu,khamu,7,0,7,0,5
30599,mettiyaṃ,mettiyam,33,29,4,0,8
30600,mida,mida,19,6,13,0,4
30601,snehe,snehe,11,10,1,0,5
30602,metti,metti,65,57,8,0,5
30603,diṭṭhiyaṃ,ditthiyam,11,11,0,0,9
30604,disa,disa,54,14,40,0,4
30605,pekkhane,pekkhane,13,12,1,0,8
30606,labha,labha,32,18,14,0,5
30607,micchādiṭṭhiyameva,micchaditthiyameva,1,1,0,0,18
30608,ubhayatra,ubhayatra,7,7,0,0,9
30609,ṭhitapakkho,thitapakkho,1,1,0,0,11
30610,siddhanto,siddhanto,5,4,1,0,9
30611,pubbapakkhaṃ,pubbapakkham,7,6,1,0,12
30612,nirasya,nirasya,2,2,0,0,7
30613,siddhapakkhaṭṭhāpane,siddhapakkhatthapane,1,1,0,0,20
30614,dohaḷa,dohala,1,0,1,0,6
30615,taṇhāyaṃ,tanhayam,4,4,0,0,8
30616,tasa,tasa,17,7,10,0,4
30617,pipāsāyaṃ,pipasayam,11,8,3,0,9
30618,tasanti,tasanti,55,55,0,0,7
30619,iṇa,ina,10,8,2,0,3
30620,mhi,mhi,218,208,10,0,3
30621,tasiṇā,tasina,13,12,1,0,6
30622,eja,eja,2,0,2,0,3
30623,jālinī,jalini,31,26,5,0,6
30624,upamāne,upamane,20,18,2,0,7
30625,visatā,visata,15,10,5,0,6
30626,patthatāti,patthatati,1,1,0,0,10
30627,visattikā,visattika,179,172,7,0,9
30628,chanda,chanda,17,11,6,0,6
30629,chandanaṃ,chandanam,8,8,0,0,9
30630,chando,chando,945,892,53,0,6
30631,kattukamyatāpi,kattukamyatapi,1,1,0,0,14
30632,tesvārammaṇesu,tesvarammanesu,1,1,0,0,14
30633,ākulībhūtattā,akulibhutatta,1,1,0,0,13
30634,jaṭā,jata,79,70,9,0,4
30635,kamu,kamu,44,7,37,0,4
30636,nikanti,nikanti,130,112,18,0,7
30637,sivu,sivu,6,1,5,0,4
30638,tantasantāne,tantasantane,14,10,4,0,12
30639,bhavādīhi,bhavadihi,1,1,0,0,9
30640,bhavādayo,bhavadayo,12,11,1,0,9
30641,sibbatīti,sibbatiti,7,2,5,0,9
30642,sibbinī,sibbini,28,25,3,0,7
30643,bhavanetti,bhavanetti,85,77,8,0,10
30644,ārammaṇābhimukhaṃ,arammanabhimukham,25,24,1,0,17
30645,abhijjhā,abhijjha,312,278,34,0,8
30646,vanati,vanati,11,11,0,0,6
30647,vanatho,vanatho,46,37,9,0,7
30648,lubha,lubha,8,1,7,0,5
30649,lubbhanaṃ,lubbhanam,6,5,1,0,9
30650,layatyārammaṇesūti,layatyarammanesuti,1,1,0,0,18
30651,saṃsilesati,samsilesati,1,1,0,0,11
30652,saṃsilese,samsilese,1,1,0,0,9
30653,sāmye,samye,1,1,0,0,5
30654,toriyattikassa,toriyattikassa,1,1,0,0,14
30655,piha,piha,8,3,5,0,4
30656,pihayati,pihayati,4,4,0,0,8
30657,nānārammaṇesu,nanarammanesu,38,38,0,0,13
30658,vibbhamakaraṇato,vibbhamakaranato,2,2,0,0,16
30659,manoratho,manoratho,78,71,7,0,9
30660,cchā,ccha,19,3,16,0,4
30661,lasati,lasati,7,7,0,0,6
30662,duha,duha,11,4,7,0,4
30663,papūraṇe,papurane,6,5,1,0,8
30664,duhanaṃ,duhanam,2,2,0,0,7
30665,doho,doho,3,3,0,0,4
30666,dohaḷo,dohalo,63,59,4,0,6
30667,duṭṭhaṃ,duttham,36,33,3,0,7
30668,hadayametenāti,hadayametenati,1,1,0,0,14
30669,haḷo,halo,2,0,2,0,4
30670,dvisaddūpapado,dvisaddupapado,1,1,0,0,14
30671,halati,halati,1,1,0,0,6
30672,dvissa,dvissa,50,45,5,0,6
30673,hadayā,hadaya,23,20,3,0,6
30674,paramatthassāti,paramatthassati,1,1,0,0,15
30675,icchāvisesattepi,icchavisesattepi,1,1,0,0,16
30676,dohaḷassa,dohalassa,2,2,0,0,9
30677,sāmaññavatticchāya,samannavatticchaya,1,1,0,0,18
30678,ataṇhāsabhāvampi,atanhasabhavampi,1,1,0,0,16
30679,ruciṃ,rucim,148,143,5,0,5
30680,ālambaṇicchāsabhāvasāmaññena,alambanicchasabhavasamannena,1,1,0,0,28
30681,idheva,idheva,958,886,72,0,6
30682,vattumāha,vattumaha,16,16,0,0,9
30683,ākaṅkhātu,akankhatu,1,0,1,0,9
30684,kaṅkha,kankha,9,6,3,0,6
30685,ruca,ruca,22,7,15,0,4
30686,rocanaṃ,rocanam,12,10,2,0,7
30687,kattukāmatā,kattukamata,12,10,2,0,11
30688,kattukāmateva,kattukamateva,1,1,0,0,13
30689,lasatīti,lasatiti,3,3,0,0,8
30690,mahicchāyaṃ,mahicchayam,1,1,0,0,11
30691,taṇhātireke,tanhatireke,1,1,0,0,11
30692,ussukke,ussukke,1,1,0,0,7
30693,dvisū,dvisu,5,5,0,0,5
30694,virodhe,virodhe,6,6,0,0,7
30695,vīresu,viresu,1,1,0,0,6
30696,paṭighapāpesupi,patighapapesupi,1,1,0,0,15
30697,rudha,rudha,17,3,14,0,5
30698,paṭighāte,patighate,12,5,7,0,9
30699,virujjhanaṃ,virujjhanam,10,10,0,0,11
30700,virodho,virodho,209,199,10,0,7
30701,appītiyaṃ,appitiyam,7,5,2,0,9
30702,viddesanaṃ,viddesanam,1,1,0,0,10
30703,viddeso,viddeso,2,1,1,0,7
30704,rosa,rosa,2,0,2,0,4
30705,dusa,dusa,14,3,11,0,4
30706,dussanaṃ,dussanam,7,7,0,0,8
30707,paṭihaññatīti,patihannatiti,34,24,10,0,13
30708,paṭighaṃ,patigham,134,116,18,0,8
30709,paṭigha,patigha,6,3,3,0,7
30710,kudha,kudha,22,11,11,0,5
30711,kope,kope,24,21,3,0,4
30712,kujjhanaṃ,kujjhanam,15,14,1,0,9
30713,haññatīti,hannatiti,18,12,6,0,9
30714,āghāto,aghato,212,200,12,0,6
30715,kupa,kupa,10,2,8,0,4
30716,kuppatīti,kuppatiti,55,32,23,0,9
30717,kopo,kopo,95,84,11,0,4
30718,kopayati,kopayati,4,4,0,0,8
30719,rusa,rusa,9,5,4,0,4
30720,rosane,rosane,3,1,2,0,6
30721,rusanaṃ,rusanam,1,1,0,0,7
30722,roso,roso,3,2,1,0,4
30723,parānatthacintane,paranatthacintane,1,1,0,0,17
30724,byāpajjati,byapajjati,101,101,0,0,10
30725,vinassati,vinassati,332,330,2,0,9
30726,cittametenāti,cittametenati,8,8,0,0,13
30727,paṭighepi,patighepi,1,1,0,0,9
30728,parasampattīsu,parasampattisu,9,9,0,0,14
30729,nābhiramatīti,nabhiramatiti,4,3,1,0,13
30730,anabhirati,anabhirati,93,89,4,0,10
30731,ramaṇe,ramane,1,1,0,0,6
30732,upanāhe,upanahe,2,2,0,0,7
30733,upanāho,upanaho,137,117,20,0,7
30734,bajjhati,bajjhati,77,75,2,0,8
30735,veramanenāti,veramanenati,1,1,0,0,12
30736,baddhaveraṃ,baddhaveram,3,2,1,0,11
30737,sucanaṃ,sucanam,1,1,0,0,7
30738,soko,soko,270,242,28,0,4
30739,sucate,sucate,1,1,0,0,6
30740,socanaṃ,socanam,26,25,1,0,7
30741,rudite,rudite,1,1,0,0,6
30742,rudi,rudi,7,3,4,0,4
30743,assuvimocane,assuvimocane,6,5,1,0,12
30744,kadi,kadi,7,2,5,0,4
30745,rodane,rodane,12,9,3,0,6
30746,paccayassa,paccayassa,172,168,4,0,10
30747,aṇṇā,anna,7,6,1,0,4
30748,ruṇṇaṃ,runnam,25,18,7,0,6
30749,devanaṃ,devanam,3,2,1,0,7
30750,sokena,sokena,76,73,3,0,6
30751,cittutrāsasaṅkhāte,cittutrasasankhate,1,1,0,0,18
30752,bhī,bhi,21,6,15,0,3
30753,bhāyanaṃ,bhayanam,5,5,0,0,8
30754,ubbeje,ubbeje,1,1,0,0,6
30755,uttasate,uttasate,3,3,0,0,8
30756,uttāso,uttaso,14,13,1,0,6
30757,bhīruno,bhiruno,3,3,0,0,7
30758,mahantañca,mahantanca,57,56,1,0,10
30759,bhayajanakattā,bhayajanakatta,1,1,0,0,14
30760,mahabbhayaṃ,mahabbhayam,88,70,18,0,11
30761,bhāyitabbasāmaññe,bhayitabbasamanne,1,1,0,0,17
30762,bherava,bherava,1,0,1,0,7
30763,sāmaññavācakopi,samannavacakopi,1,1,0,0,15
30764,bhiṃsanaṃ,bhimsanam,13,11,2,0,9
30765,bhīmaṃ,bhimam,5,4,1,0,6
30766,darīyatīti,dariyatiti,4,4,0,0,10
30767,dāruṇaṃ,darunam,45,40,5,0,7
30768,uṇo,uno,4,4,0,0,3
30769,bhayānakaṃ,bhayanakam,89,75,14,0,10
30770,anakā,anaka,9,5,4,0,5
30771,ghura,ghura,3,1,2,0,5
30772,bhīme,bhime,4,4,0,0,5
30773,ghurati,ghurati,2,2,0,0,7
30774,bhiṃsatīti,bhimsatiti,1,1,0,0,10
30775,paṭivattati,pativattati,6,6,0,0,11
30776,cittutrāso,cittutraso,25,18,7,0,10
30777,paṭibhayaṃ,patibhayam,7,5,2,0,10
30778,bhesmaṃ,bhesmam,4,2,2,0,7
30779,sma,sma,1,0,1,0,3
30780,bhayaṅkaraṃ,bhayankaram,1,0,1,0,11
30781,bheravā,bherava,9,7,2,0,7
30782,bhayabheravādihetumhi,bhayabheravadihetumhi,1,1,0,0,21
30783,visesanabhāvena,visesanabhavena,34,34,0,0,15
30784,parābhyudayāsahane,parabhyudayasahane,1,1,0,0,18
30785,issatthe,issatthe,11,11,0,0,8
30786,issāyanti,issayanti,1,1,0,0,9
30787,santesupi,santesupi,32,32,0,0,9
30788,guṇesu,gunesu,38,37,1,0,6
30789,dosāropanaṃ,dosaropanam,11,11,0,0,11
30790,ussuya,ussuya,1,0,1,0,6
30791,usūya,usuya,5,4,1,0,5
30792,dosāvikaraṇe,dosavikarane,3,3,0,0,12
30793,macchere,macchere,6,6,0,0,8
30794,masu,masu,7,0,7,0,4
30795,āmasane,amasane,30,27,3,0,7
30796,ccheracchara,ccheracchara,1,0,1,0,12
30797,maccharameva,maccharameva,1,1,0,0,12
30798,macchariyaṃ,macchariyam,271,228,43,0,11
30799,iccetassa,iccetassa,141,141,0,0,9
30800,pāṭipadikassa,patipadikassa,10,10,0,0,13
30801,ccheraccharā,ccheracchara,1,0,1,0,12
30802,maccheretipi,maccheretipi,1,1,0,0,12
30803,aññāṇe,annane,16,14,2,0,6
30804,mūha,muha,3,0,3,0,4
30805,vecitte,vecitte,12,11,1,0,7
30806,muyhanamattameva,muyhanamattameva,9,9,0,0,16
30807,vidatīti,vidatiti,5,5,0,0,8
30808,aññāṇaṃ,annanam,451,410,41,0,7
30809,bhūtenābhūtena,bhutenabhutena,1,1,0,0,14
30810,ukkaṃsakappanena,ukkamsakappanena,1,1,0,0,16
30811,unnati,unnati,44,39,5,0,6
30812,atthavāha,atthavaha,1,1,0,0,9
30813,masmi,masmi,3,3,0,0,5
30814,buddhisampanno,buddhisampanno,29,28,1,0,14
30815,avehi,avehi,1,1,0,0,5
30816,bhalavā,bhalava,1,1,0,0,7
30817,asmi,asmi,64,61,3,0,4
30818,buddhisaṃyuto,buddhisamyuto,1,1,0,0,13
30819,dhāraṇattho,dharanattho,3,3,0,0,11
30820,karotyatthe,karotyatthe,7,7,0,0,11
30821,seyyādibhāve,seyyadibhave,1,1,0,0,12
30822,vidadhāti,vidadhati,9,9,0,0,9
30823,vidhā,vidha,122,107,15,0,5
30824,itthiyanti,itthiyanti,22,22,0,0,10
30825,uddhacce,uddhacce,65,62,3,0,8
30826,uddhato,uddhato,71,68,3,0,7
30827,uddhatassa,uddhatassa,23,22,1,0,10
30828,dhāva,dhava,4,1,3,0,5
30829,uddhavaṃ,uddhavam,2,1,1,0,8
30830,tāpā,tapa,1,0,1,0,4
30831,kukkucce,kukkucce,21,20,1,0,8
30832,dhupa,dhupa,1,0,1,0,5
30833,tāpo,tapo,11,9,2,0,4
30834,kukkutaṃ,kukkutam,1,1,0,0,8
30835,taṃsamaṅgī,tamsamangi,32,30,2,0,10
30836,pacchātāpo,pacchatapo,3,1,2,0,10
30837,anutāpo,anutapo,5,4,1,0,7
30838,vippaṭisāro,vippatisaro,160,154,6,0,11
30839,vicikicchāyaṃ,vicikicchayam,3,3,0,0,13
30840,likha,likha,8,1,7,0,5
30841,lekhane,lekhane,5,4,1,0,7
30842,vilekhati,vilekhati,5,5,0,0,9
30843,dvidhākaraṇavasenāti,dvidhakaranavasenati,1,1,0,0,20
30844,manovilekho,manovilekho,62,61,1,0,11
30845,saṃsaye,samsaye,27,26,1,0,7
30846,kaṅkhāyaṃ,kankhayam,7,6,1,0,9
30847,kathamida,kathamida,2,2,0,0,9
30848,kathayati,kathayati,13,13,0,0,9
30849,kathaṃkathā,kathamkatha,66,53,13,0,11
30850,kita,kita,47,12,35,0,4
30851,rogāpanayane,rogapanayane,7,6,1,0,12
30852,dvittādi,dvittadi,19,19,0,0,8
30853,vigatā,vigata,110,100,10,0,6
30854,cikicchā,cikiccha,13,13,0,0,8
30855,ñāṇappaṭikāro,nanappatikaro,2,2,0,0,13
30856,ila,ila,16,0,16,0,3
30857,gatikampanesu,gatikampanesu,2,1,1,0,13
30858,ilati,ilati,7,7,0,0,5
30859,dveḷhakaṃ,dvelhakam,32,25,7,0,9
30860,saṅka,sanka,5,0,5,0,5
30861,saṅkāyaṃ,sankayam,11,7,4,0,8
30862,vividhenākārena,vividhenakarena,19,19,0,0,15
30863,vimati,vimati,155,139,16,0,6
30864,nīcapakatidosasambhūtarūpissariyādinimittike,nicapakatidosasambhutarupissariyadinimittike,1,1,0,0,44
30865,uttaradānasādarolokanādivimukho,uttaradanasadarolokanadivimukho,1,1,0,0,31
30866,madopyatra,madopyatra,1,1,0,0,10
30867,katthūrīgabbaretesu,katthurigabbaretesu,1,1,0,0,19
30868,madohassebhadānesū,madohassebhadanesu,1,1,0,0,18
30869,gabbharetesu,gabbharetesu,1,1,0,0,12
30870,purisamānesūti,purisamanesuti,1,1,0,0,14
30871,nissaya,nissaya,35,33,2,0,7
30872,gabba,gabba,7,1,6,0,5
30873,gara,gara,20,10,10,0,4
30874,mānetīti,manetiti,8,7,1,0,8
30875,abhimāno,abhimano,16,13,3,0,8
30876,ahaṃkāre,ahamkare,2,2,0,0,8
30877,amha,amha,70,28,42,0,4
30878,ahaṃkāro,ahamkaro,19,14,5,0,8
30879,cinta,cinta,10,3,7,0,5
30880,jhāyate,jhayate,8,8,0,0,7
30881,vitakkacintānaṃ,vitakkacintanam,1,1,0,0,15
30882,pubbabhāgappavatto,pubbabhagappavatto,1,1,0,0,18
30883,vitakketvā,vitakketva,45,44,1,0,10
30884,bhindatī,bhindati,29,25,4,0,8
30885,apubbabhāgappavattāpīti,apubbabhagappavattapiti,1,1,0,0,23
30886,ayametāsaṃ,ayametasam,9,9,0,0,10
30887,pakiṇṇakapariyāpanno,pakinnakapariyapanno,1,1,0,0,20
30888,cetasikadhammo,cetasikadhammo,5,5,0,0,14
30889,sabbasādhāraṇapariyāpanno,sabbasadharanapariyapanno,1,1,0,0,25
30890,manasikāranāmako,manasikaranamako,1,1,0,0,16
30891,cetasikadhammoti,cetasikadhammoti,2,2,0,0,16
30892,nicchaye,nicchaye,14,12,2,0,8
30893,naya,naya,15,11,4,0,4
30894,nicchinanto,nicchinanto,2,2,0,0,11
30895,niṇṇayo,ninnayo,5,4,1,0,7
30896,adhimokkhaniṇṇayānaṃ,adhimokkhaninnayanam,1,1,0,0,20
30897,ajjhogāhetvā,ajjhogahetva,126,123,3,0,12
30898,vinicchayamattamevāti,vinicchayamattamevati,1,1,0,0,21
30899,pasādepi,pasadepi,1,1,0,0,8
30900,ayaṃpyetesaṃ,ayampyetesam,1,1,0,0,12
30901,nicchaya,nicchaya,6,4,2,0,8
30902,abhyupagamassa,abhyupagamassa,2,2,0,0,14
30903,abhyupagame,abhyupagame,1,1,0,0,11
30904,suṇoti,sunoti,19,19,0,0,6
30905,paṭissavo,patissavo,12,8,4,0,9
30906,saṃvidā,samvida,1,1,0,0,7
30907,gū,gu,1,1,0,0,2
30908,paṭiññānaṃ,patinnanam,2,2,0,0,10
30909,assavo,assavo,8,5,3,0,6
30910,saṃsavo,samsavo,1,1,0,0,7
30911,aṅgīkāro,angikaro,1,1,0,0,8
30912,abhyupagamo,abhyupagamo,3,3,0,0,11
30913,samādhiiccādīnipi,samadhiiccadinipi,1,1,0,0,17
30914,anādarassa,anadarassa,3,3,0,0,10
30915,avamānaṃ,avamanam,22,20,2,0,8
30916,yenānādarito,yenanadarito,1,1,0,0,12
30917,avassameva,avassameva,19,17,2,0,10
30918,kāyavacīmanānaṃ,kayavacimananam,1,1,0,0,15
30919,aññatarenāvadhīyateti,annatarenavadhiyateti,1,1,0,0,21
30920,anādarepi,anadarepi,3,2,1,0,9
30921,byavadhānābhicārato,byavadhanabhicarato,1,1,0,0,19
30922,tira,tira,4,2,2,0,4
30923,antaradhāne,antaradhane,6,6,0,0,11
30924,vattamāno,vattamano,109,106,3,0,9
30925,tirodhānakaraṇaṃ,tirodhanakaranam,1,1,0,0,16
30926,tirakkāro,tirakkaro,2,1,1,0,9
30927,parā,para,184,172,12,0,4
30928,avaññāṇe,avannane,1,1,0,0,8
30929,sakkāro,sakkaro,139,132,7,0,7
30930,tabbiparīto,tabbiparito,10,10,0,0,11
30931,anādaro,anadaro,48,41,7,0,7
30932,parābhavanaṃ,parabhavanam,5,4,1,0,12
30933,parābhavo,parabhavo,61,56,5,0,9
30934,avajānanaṃ,avajananam,10,10,0,0,10
30935,avaññā,avanna,7,6,1,0,6
30936,ummāde,ummade,20,17,3,0,6
30937,vibbhamo,vibbhamo,17,11,6,0,8
30938,uggatehi,uggatehi,4,4,0,0,8
30939,ummaggasaṇṭhitehi,ummaggasanthitehi,1,1,0,0,17
30940,dosehi,dosehi,57,57,0,0,6
30941,madanaṃ,madanam,5,4,1,0,7
30942,sneha,sneha,2,1,1,0,5
30943,piyassa,piyassa,57,53,4,0,7
30944,piya,piya,21,18,3,0,4
30945,pīnayatīti,pinayatiti,4,4,0,0,10
30946,vāpī,vapi,29,22,7,0,4
30947,pino,pino,2,2,0,0,4
30948,siniha,siniha,3,0,3,0,6
30949,sniha,sniha,1,0,1,0,5
30950,pītiyaṃ,pitiyam,13,9,4,0,7
30951,mucchāyaṃ,mucchayam,2,2,0,0,9
30952,pīḷa,pila,4,1,3,0,4
30953,vibādhāyaṃ,vibadhayam,5,4,1,0,10
30954,cittapīḷā,cittapila,3,2,1,0,9
30955,nīlādisañjānanalakkhaṇā,niladisanjananalakkhana,1,1,0,0,23
30956,visaññī,visanni,37,35,2,0,7
30957,visaññitā,visannita,2,1,1,0,9
30958,pamāde,pamade,57,53,4,0,6
30959,pamajjanaṃ,pamajjanam,17,15,2,0,10
30960,saja,saja,17,5,12,0,4
30961,visajjanāliṅgananimmānesu,visajjanalingananimmanesu,3,3,0,0,25
30962,visajjanaṃ,visajjanam,16,16,0,0,10
30963,sativosaggo,sativosaggo,2,1,1,0,11
30964,apubbavatthuparikkhātisaye,apubbavatthuparikkhatisaye,1,1,0,0,26
30965,kotūhalā,kotuhala,3,1,2,0,8
30966,tuja,tuja,3,0,3,0,4
30967,tojatīti,tojatiti,1,1,0,0,8
30968,kotūhalaṃ,kotuhalam,4,3,1,0,9
30969,nikkase,nikkase,1,1,0,0,7
30970,tulayatīti,tulayatiti,1,1,0,0,10
30971,kutūhalaṃ,kutuhalam,5,4,1,0,9
30972,kotukaṃ,kotukam,1,1,0,0,7
30973,kutukañca,kutukanca,1,1,0,0,9
30974,pariyāyāni,pariyayani,2,1,1,0,10
30975,vilāsā,vilasa,3,2,1,0,6
30976,ceṭṭhā,cettha,2,2,0,0,6
30977,kiṃvisiṭṭhā,kimvisittha,1,1,0,0,11
30978,nārisiṅgārabhāvajā,narisingarabhavaja,1,0,1,0,18
30979,ratibhāvajā,ratibhavaja,1,1,0,0,11
30980,hāva,hava,1,0,1,0,4
30981,saddenoccante,saddenoccante,1,1,0,0,13
30982,huyante,huyante,1,1,0,0,7
30983,hāvo,havo,4,2,2,0,4
30984,havane,havane,4,4,0,0,6
30985,vicchittipabhutīnaṃ,vicchittipabhutinam,1,1,0,0,19
30986,nāṭakaratanakose,natakaratanakose,1,0,1,0,16
30987,vilāso,vilaso,11,7,4,0,6
30988,vicchitti,vicchitti,2,1,1,0,9
30989,kilakiñcitaṃ,kilakincitam,1,1,0,0,12
30990,moṭṭāyitaṃ,mottayitam,1,1,0,0,10
30991,kuṭṭamitaṃ,kuttamitam,1,1,0,0,10
30992,vibboko,vibboko,1,1,0,0,7
30993,vikatañceti,vikatanceti,1,1,0,0,11
30994,sabhāvajā,sabhavaja,2,2,0,0,9
30995,helā,hela,2,1,1,0,4
30996,vikkhepasammūḷhamadakapaṇyaṃ,vikkhepasammulhamadakapanyam,1,1,0,0,28
30997,piyasamīpagamane,piyasamipagamane,1,1,0,0,16
30998,ṭhānāsanagamanavilokitesu,thanasanagamanavilokitesu,1,1,0,0,25
30999,akasmā,akasma,3,3,0,0,6
31000,kodhamihitacamakkāramukhavikūṇanaṃ,kodhamihitacamakkaramukhavikunanam,1,1,0,0,34
31001,pubbā,pubba,130,113,17,0,5
31002,dhātumhā,dhatumha,26,26,0,0,8
31003,sukumāravidhānena,sukumaravidhanena,1,1,0,0,17
31004,bhamukanettādikriyāsacivakaracaraṇaṅgavinyāso,bhamukanettadikriyasacivakaracaranangavinyaso,1,1,0,0,45
31005,lala,lala,10,1,9,0,4
31006,aladdhapiyasamāgamena,aladdhapiyasamagamena,1,1,0,0,21
31007,kucittavinodanatthaṃ,kucittavinodanattham,1,1,0,0,20
31008,vesagatidiṭṭhihasitabhaṇitehānukati,vesagatiditthihasitabhanitehanukati,1,1,0,0,35
31009,karīyate,kariyate,24,24,0,0,8
31010,upasevāyanti,upasevayanti,2,2,0,0,12
31011,surate,surate,1,1,0,0,6
31012,pavaḍḍhecchā,pavaddheccha,1,1,0,0,12
31013,heḷā,hela,2,2,0,0,4
31014,hila,hila,3,1,2,0,4
31015,hāvakaraṇe,havakarane,6,3,3,0,10
31016,madarāgahassajanito,madaragahassajanito,1,1,0,0,19
31017,vipariyāso,vipariyaso,10,7,3,0,10
31018,ābharaṇavilepanādīnaṃ,abharanavilepanadinam,1,1,0,0,21
31019,kutoci,kutoci,179,171,8,0,6
31020,piyāparādhato,piyaparadhato,1,1,0,0,13
31021,issāyānādarena,issayanadarena,1,1,0,0,14
31022,cattānaṃ,cattanam,11,10,1,0,8
31023,sakhīnaṃ,sakhinam,25,22,3,0,8
31024,payatanena,payatanena,1,1,0,0,10
31025,vāraṇaṃ,varanam,23,21,2,0,7
31026,dvedhākaraṇe,dvedhakarane,7,5,2,0,12
31027,dattaṃ,dattam,18,18,0,0,6
31028,pītinibandhanaṃ,pitinibandhanam,1,1,0,0,15
31029,svappamapi,svappamapi,1,1,0,0,10
31030,bhūsanaṃ,bhusanam,16,16,0,0,8
31031,vicchittītyaññe,vicchittityanne,1,1,0,0,15
31032,kilakiñcitā,kilakincita,1,0,1,0,11
31033,nāṭakasatthānusārato,natakasatthanusarato,1,1,0,0,20
31034,byākhyāsudhāṭīkāṭīppaṇe,byakhyasudhatikatippane,1,1,0,0,23
31035,hasite,hasite,7,7,0,0,6
31036,hasa,hasa,12,3,9,0,4
31037,hasane,hasane,13,7,6,0,6
31038,mihitaṃ,mihitam,4,4,0,0,7
31039,sitañcuccate,sitancuccate,1,1,0,0,12
31040,miha,miha,16,6,10,0,4
31041,īsaṃhasane,isamhasane,2,1,1,0,10
31042,mandassitaṃ,mandassitam,1,1,0,0,11
31043,mhitantipi,mhitantipi,1,1,0,0,10
31044,īsaṃhasanetipi,isamhasanetipi,1,1,0,0,14
31045,mihi,mihi,2,1,1,0,4
31046,syā,sya,8332,8289,43,0,3
31047,īsaṃphullitadantehi,isamphullitadantehi,1,1,0,0,19
31048,kaṭākkhehi,katakkhehi,1,1,0,0,10
31049,soṭṭhavehi,sotthavehi,1,1,0,0,10
31050,alakkhitadvijadvāraṃ,alakkhitadvijadvaram,1,1,0,0,20
31051,sitamicchanti,sitamicchanti,1,1,0,0,13
31052,sūrayo,surayo,1,1,0,0,6
31053,mahāhasite,mahahasite,1,1,0,0,10
31054,aṭa,ata,18,11,7,0,3
31055,dūragāmihāso,duragamihaso,1,1,0,0,12
31056,aṭahāso,atahaso,2,0,2,0,7
31057,atikkanto,atikkanto,147,143,4,0,9
31058,ikārassattañca,ikarassattanca,1,1,0,0,14
31059,sitātihasitānaṃ,sitatihasitanam,1,1,0,0,15
31060,antarāḷikaṃ,antaralikam,1,1,0,0,11
31061,vihasitaṃ,vihasitam,6,3,3,0,9
31062,ākuñcitakapola,akuncitakapola,1,1,0,0,14
31063,kkhaṃ,kkham,1,1,0,0,5
31064,sassanaṃ,sassanam,1,1,0,0,8
31065,nissanaṃ,nissanam,1,1,0,0,8
31066,patthāvotthaṃ,patthavottham,1,1,0,0,13
31067,sānurāgaṃ,sanuragam,1,1,0,0,9
31068,budhā,budha,29,28,1,0,5
31069,lomuggame,lomuggame,1,1,0,0,9
31070,romānaṃ,romanam,2,2,0,0,7
31071,añcanaṃ,ancanam,1,1,0,0,7
31072,lomānaṃ,lomanam,23,21,2,0,7
31073,haṃsanaṃ,hamsanam,12,11,1,0,8
31074,uddhaggabhāvo,uddhaggabhavo,8,6,2,0,13
31075,lomahaṃsano,lomahamsano,26,24,2,0,11
31076,parihāsā,parihasa,2,0,2,0,8
31077,vallabhādīnaṃ,vallabhadinam,1,1,0,0,13
31078,parihāse,parihase,4,3,1,0,8
31079,parihasantyatrāti,parihasantyatrati,1,1,0,0,17
31080,parihāso,parihaso,5,3,2,0,8
31081,paribhavitukāmena,paribhavitukamena,1,1,0,0,17
31082,hāsoti,hasoti,6,4,2,0,6
31083,anādareti,anadareti,4,2,2,0,9
31084,dava,dava,5,1,4,0,4
31085,dāheti,daheti,1,1,0,0,6
31086,khiḍa,khida,1,0,1,0,5
31087,khiḍḍā,khidda,64,55,9,0,6
31088,khiddā,khidda,1,0,1,0,6
31089,tucchaṃ,tuccham,140,126,14,0,7
31090,iḍḍā,idda,1,1,0,0,4
31091,kīḷa,kila,4,1,3,0,4
31092,pītiyakīḷanesu,pitiyakilanesu,1,1,0,0,14
31093,vihāreti,vihareti,38,13,25,0,8
31094,kīḷanaṃ,kilanam,22,17,5,0,7
31095,kīḷā,kila,47,42,5,0,4
31096,kīḷitañca,kilitanca,1,0,1,0,9
31097,dichakkesupi,dichakkesupi,1,1,0,0,12
31098,adhikaraṇasādhanampi,adhikaranasadhanampi,1,1,0,0,20
31099,niddāyaṃ,niddayam,3,3,0,0,8
31100,supane,supane,6,4,2,0,6
31101,supa,supa,15,4,11,0,4
31102,supinaṃ,supinam,253,229,24,0,7
31103,soppaṃ,soppam,20,17,3,0,6
31104,accantaparissamādikāraṇā,accantaparissamadikarana,1,1,0,0,24
31105,sabbaṅganimīlanaṃ,sabbanganimilanam,1,1,0,0,17
31106,middhaṃ,middham,171,142,29,0,7
31107,mucchāpāyaṃ,mucchapayam,1,1,0,0,11
31108,kāriyakkhamane,kariyakkhamane,1,1,0,0,14
31109,medhayati,medhayati,1,1,0,0,9
31110,akammaññabhāvena,akammannabhavena,5,5,0,0,16
31111,vihiṃ,vihim,5,5,0,0,5
31112,satītyattho,satityattho,1,1,0,0,11
31113,kampanattho,kampanattho,1,1,0,0,11
31114,cala,cala,19,5,14,0,4
31115,mucchāpāye,mucchapaye,1,1,0,0,10
31116,akkhidalānaṃ,akkhidalanam,4,4,0,0,12
31117,pacalabhāvena,pacalabhavena,1,1,0,0,13
31118,pacalāyikā,pacalayika,13,10,3,0,10
31119,assittaṃ,assittam,13,13,0,0,8
31120,para177-178,para177-178,1,1,0,0,11
31121,ketava,ketava,1,0,1,0,6
31122,kūṭe,kute,15,15,0,0,4
31123,ninditā,nindita,5,5,0,0,7
31124,nikati,nikati,18,13,5,0,6
31125,aṭatīti,atatiti,1,1,0,0,7
31126,kūṭaṃ,kutam,158,129,29,0,5
31127,kuṭa,kuta,28,2,26,0,4
31128,chedaneti,chedaneti,1,1,0,0,9
31129,saddanītidhātumālāyaṃ,saddanitidhatumalayam,22,22,0,0,21
31130,kūṭa,kuta,8,5,3,0,4
31131,appasāde,appasade,3,2,1,0,8
31132,dhātunā,dhatuna,18,17,1,0,7
31133,sādhitaṃ,sadhitam,18,18,0,0,8
31134,rabhi,rabhi,4,2,2,0,5
31135,byāje,byaje,2,2,0,0,5
31136,byājo,byajo,2,2,0,0,5
31137,ketavaṃ,ketavam,6,4,2,0,7
31138,saṭha,satha,12,3,9,0,5
31139,ketave,ketave,8,5,3,0,6
31140,saṭhaṃ,satham,13,9,4,0,6
31141,saṭhayati,sathayati,6,6,0,0,9
31142,kitavassa,kitavassa,9,9,0,0,9
31143,jūtakāro,jutakaro,2,2,0,0,8
31144,kapaṭo,kapato,1,1,0,0,6
31145,upadhi,upadhi,39,32,7,0,6
31146,ketavassa,ketavassa,1,1,0,0,9
31147,sabhāve,sabhave,37,35,2,0,7
31148,saṃvijjamāno,samvijjamano,66,66,0,0,12
31149,visajjanametassāti,visajjanametassati,1,1,0,0,18
31150,saṃvijjamānaṃ,samvijjamanam,18,17,1,0,13
31151,paṭhamakāle,pathamakale,10,10,0,0,11
31152,sambhūtā,sambhuta,31,30,1,0,8
31153,sabbadāpītyattho,sabbadapityattho,1,1,0,0,16
31154,lakkha,lakkha,11,3,8,0,6
31155,dassanaṅkesu,dassanankesu,9,7,2,0,12
31156,lakkhitabbanti,lakkhitabbanti,2,2,0,0,14
31157,ussave,ussave,10,10,0,0,6
31158,usavanti,usavanti,1,1,0,0,8
31159,uggirayantyatrāti,uggirayantyatrati,1,1,0,0,17
31160,ussavo,ussavo,21,17,4,0,6
31161,nānāsamiddhīhi,nanasamiddhihi,1,1,0,0,14
31162,savanti,savanti,109,97,12,0,7
31163,chi,chi,13,10,3,0,3
31164,sokametthāti,sokametthati,1,1,0,0,12
31165,chaṇo,chano,12,9,3,0,5
31166,sokaṃ,sokam,156,151,5,0,5
31167,pāpañca,papanca,47,43,4,0,7
31168,chindantā,chindanta,14,14,0,0,9
31169,aṇanti,ananti,2,2,0,0,6
31170,sasnehaṃ,sasneham,29,26,3,0,8
31171,pakatitilatelādisnehasahitaṃ,pakatitilateladisnehasahitam,1,1,0,0,28
31172,pajjotaṃ,pajjotam,10,9,1,0,8
31173,atyandhakāragabbhādīsvapi,atyandhakaragabbhadisvapi,1,1,0,0,25
31174,khuddakānyatthajātāni,khuddakanyatthajatani,2,1,1,0,21
31175,atisukhumānipi,atisukhumanipi,2,2,0,0,14
31176,nānādabbasamūhāni,nanadabbasamuhani,1,1,0,0,17
31177,sukhaṃva,sukhamva,1,1,0,0,8
31178,sampassati,sampassati,5,5,0,0,10
31179,buddhapariyāyādianekapariyāyasnehasahitaṃ,buddhapariyayadianekapariyayasnehasahitam,1,1,0,0,41
31180,uggahaṇadhāraṇādinā,uggahanadharanadina,1,1,0,0,19
31181,sotujano,sotujano,1,1,0,0,8
31182,khuddakāni,khuddakani,39,37,2,0,10
31183,atthajātāni,atthajatani,2,1,1,0,11
31184,nānāsatthesu,nanasatthesu,1,1,0,0,12
31185,atigambhīrāni,atigambhirani,1,1,0,0,13
31186,sampassatīti,sampassatiti,1,1,0,0,12
31187,sakalabyākaraṇamahāvanāsaṅgañāṇacārinā,sakalabyakaranamahavanasangananacarina,3,3,0,0,38
31188,kavikuñjarakesarinā,kavikunjarakesarina,3,3,0,0,19
31189,sirimahācaturaṅgabalena,sirimahacaturangabalena,3,3,0,0,23
31190,mahāmaccena,mahamaccena,4,4,0,0,11
31191,viracitāyaṃ,viracitayam,3,3,0,0,11
31192,abhidhānappadīpikāvaṇṇanāyaṃ,abhidhanappadipikavannanayam,3,3,0,0,28
31193,bhūkaṇḍa,bhukanda,3,3,0,0,8
31194,bhūmivaggavaṇṇanā,bhumivaggavannana,2,2,0,0,17
31195,bhūkaṇḍe,bhukande,1,1,0,0,8
31196,sāṅgopāṅgehi,sangopangehi,2,0,2,0,12
31197,bhūmyādīhi,bhumyadihi,1,1,0,0,10
31198,pātālena,patalena,3,3,0,0,8
31199,ekādasahi,ekadasahi,196,187,9,0,9
31200,koṭṭhāsehi,kotthasehi,46,44,2,0,10
31201,vaggā,vagga,269,256,13,0,5
31202,bhūmivaggādināmakā,bhumivaggadinamaka,1,1,0,0,18
31203,sappadhānopakārakāni,sappadhanopakarakani,1,1,0,0,20
31204,khārā,khara,7,4,3,0,5
31205,aṅgānaṃ,anganam,147,142,5,0,7
31206,upakārakāni,upakarakani,10,10,0,0,11
31207,upaṅgāni,upangani,1,1,0,0,8
31208,bhūmiyā,bhumiya,429,423,6,0,7
31209,dhārayatīti,dharayatiti,9,9,0,0,11
31210,chamā,chama,66,57,9,0,5
31211,sattānamadhopatanaṃ,sattanamadhopatanam,1,1,0,0,19
31212,itthiyamā,itthiyama,3,3,0,0,9
31213,bhavantyassaṃ,bhavantyassam,2,2,0,0,13
31214,bhūtānīti,bhutaniti,29,12,17,0,9
31215,putha,putha,30,16,14,0,5
31216,pāṭipadike,patipadike,7,7,0,0,10
31217,ādese,adese,2,2,0,0,5
31218,vuddhimhi,vuddhimhi,17,17,0,0,9
31219,puthavī,puthavi,20,18,2,0,7
31220,ussuvādese,ussuvadese,1,1,0,0,10
31221,puthuvī,puthuvi,8,7,1,0,7
31222,pathā,patha,23,17,6,0,5
31223,avā,ava,29,2,27,0,3
31224,thava,thava,2,1,1,0,5
31225,pathavati,pathavati,1,1,0,0,9
31226,thara,thara,10,2,8,0,5
31227,santharaṇe,santharane,5,4,1,0,10
31228,assu,assu,396,381,15,0,4
31229,madhuno,madhuno,12,12,0,0,7
31230,keṭabhassāpi,ketabhassapi,1,1,0,0,12
31231,medamaṃsapariplutā,medamamsaparipluta,1,1,0,0,18
31232,medinī,medini,11,9,2,0,6
31233,brahmavādibhī,brahmavadibhi,1,1,0,0,13
31234,medayogā,medayoga,1,1,0,0,8
31235,snehane,snehane,3,3,0,0,7
31236,issettañca,issettanca,1,1,0,0,10
31237,vitthiṇṇattā,vitthinnatta,2,2,0,0,12
31238,ubbī,ubbi,4,2,2,0,4
31239,avati,avati,16,16,0,0,5
31240,santyassaṃ,santyassam,2,2,0,0,10
31241,vasumatī,vasumati,6,5,1,0,8
31242,māravijayakāleti,maravijayakaleti,1,1,0,0,16
31243,ku,ku,98,41,57,0,2
31244,vasudhā,vasudha,29,26,3,0,7
31245,dharayatīti,dharayatiti,1,1,0,0,11
31246,dharaṇī,dharani,36,32,4,0,7
31247,dharā,dhara,10,9,1,0,5
31248,gacchantyassaṃ,gacchantyassam,1,1,0,0,14
31249,kvimhi,kvimhi,26,22,4,0,6
31250,bhūtaro,bhutaro,1,0,1,0,7
31251,rakkhaṇe,rakkhane,59,53,6,0,8
31252,avanī,avani,2,1,1,0,5
31253,lavaṇarasā,lavanarasa,1,1,0,0,10
31254,mattikā,mattika,100,95,5,0,7
31255,ūsotyuccate,usotyuccate,1,1,0,0,11
31256,khādatīti,khadatiti,17,12,5,0,9
31257,padesakattā,padesakatta,1,1,0,0,11
31258,mattena,mattena,19,18,1,0,7
31259,pamāṇena,pamanena,111,107,4,0,8
31260,ūsa,usa,1,0,1,0,3
31261,ūso,uso,5,3,2,0,3
31262,ūsayogā,usayoga,1,1,0,0,7
31263,ūsavā,usava,2,1,1,0,5
31264,vantu,vantu,35,22,13,0,5
31265,ūsaro,usaro,5,4,1,0,5
31266,thala,thala,5,2,3,0,5
31267,kittimaṃ,kittimam,10,8,2,0,8
31268,thalaṃ,thalam,96,84,12,0,6
31269,akittimā,akittima,6,6,0,0,8
31270,thalī,thali,1,1,0,0,5
31271,thaddhalūkhamhi,thaddhalukhamhi,2,2,0,0,15
31272,bhūbhāge,bhubhage,3,2,1,0,8
31273,bhūmippadese,bhumippadese,16,16,0,0,12
31274,jaṅgala,jangala,2,0,2,0,7
31275,nijjalattā,nijjalatta,1,1,0,0,10
31276,kakkhaḷattā,kakkhalatta,2,2,0,0,11
31277,thaddho,thaddho,117,112,5,0,7
31278,tikkhasakkharādividāragavādikhuragaṇḍuppādavaccādisahitattā,tikkhasakkharadividaragavadikhuraganduppadavaccadisahitatta,1,1,0,0,59
31279,lūkho,lukho,48,46,2,0,5
31280,gala,gala,5,0,5,0,4
31281,cavanādhopatanādanesu,cavanadhopatanadanesu,1,1,0,0,21
31282,galati,galati,16,16,0,0,6
31283,galanti,galanti,5,5,0,0,7
31284,jaṅgalo,jangalo,7,5,2,0,7
31285,nijjalo,nijjalo,1,1,0,0,7
31286,nijjale,nijjale,2,2,0,0,7
31287,tiliṅgo,tilingo,10,10,0,0,7
31288,pisite,pisite,2,2,0,0,6
31289,thiyaṃ,thiyam,44,41,3,0,6
31290,pubbadisābhāgattā,pubbadisabhagatta,1,1,0,0,17
31291,evamaparuttaresu,evamaparuttaresu,1,1,0,0,16
31292,yantyetthāti,yantyetthati,1,1,0,0,12
31293,kappaṭṭhāyitādippabhāvena,kappatthayitadippabhavena,1,1,0,0,25
31294,tappadhānodīpoti,tappadhanodipoti,1,1,0,0,16
31295,uru,uru,20,16,4,0,3
31296,mahantametthāti,mahantametthati,1,1,0,0,15
31297,dīpa,dipa,17,8,9,0,4
31298,dittippakāsanesu,dittippakasanesu,1,1,0,0,16
31299,dippantīti,dippantiti,2,2,0,0,10
31300,pamāṇato,pamanato,102,95,7,0,8
31301,janapadantarā,janapadantara,2,0,2,0,13
31302,janapadavisesā,janapadavisesa,1,1,0,0,14
31303,suramahapaccuggatā,suramahapaccuggata,1,1,0,0,18
31304,talakuṭā,talakuta,1,1,0,0,8
31305,asmākādayo,asmakadayo,1,1,0,0,10
31306,pumbahutte,pumbahutte,2,1,1,0,10
31307,bahutte,bahutte,12,11,1,0,7
31308,jānapadino,janapadino,21,21,0,0,10
31309,nivāso,nivaso,150,145,5,0,6
31310,janapado,janapado,206,195,11,0,8
31311,rūḷhīsaddena,rulhisaddena,4,4,0,0,12
31312,kurū,kuru,11,7,4,0,4
31313,bahuvacanena,bahuvacanena,51,48,3,0,12
31314,khattiyakumārā,khattiyakumara,4,4,0,0,14
31315,paccayalopato,paccayalopato,3,3,0,0,13
31316,arivijayalokamariyādātikkamādīsu,arivijayalokamariyadatikkamadisu,1,1,0,0,32
31317,kosaṃ,kosam,14,14,0,0,5
31318,pucchantīti,pucchantiti,36,24,12,0,11
31319,kosalā,kosala,26,20,6,0,6
31320,magena,magena,3,3,0,0,6
31321,dhāvantīti,dhavantiti,12,10,2,0,10
31322,magadhā,magadha,24,19,5,0,7
31323,maṃsesu,mamsesu,18,14,4,0,7
31324,gijjhantīti,gijjhantiti,5,4,1,0,11
31325,gidha,gidha,7,1,6,0,5
31326,abhikaṅkhāyaṃ,abhikankhayam,5,3,2,0,13
31327,sevanti,sevanti,122,119,3,0,7
31328,sivi,sivi,17,13,4,0,4
31329,sivī,sivi,7,5,2,0,4
31330,iṅga,inga,5,0,5,0,4
31331,kaliṅgā,kalinga,12,7,5,0,7
31332,uttarāpatho,uttarapatho,3,3,0,0,11
31333,jagannāthā,jagannatha,1,1,0,0,10
31334,kaṇhātīrantaraṃ,kanhatirantaram,1,1,0,0,15
31335,sive,sive,17,16,1,0,4
31336,kaliṅgadeso,kalingadeso,1,1,0,0,11
31337,saṃvutto,samvutto,1,1,0,0,8
31338,ityuttadese,ityuttadese,1,1,0,0,11
31339,thomanidhi,thomanidhi,1,1,0,0,10
31340,gāyantītivā,gayantitiva,1,1,0,0,11
31341,liṅgantīti,lingantiti,1,1,0,0,10
31342,liṅga,linga,32,21,11,0,5
31343,khāditaṃ,khaditam,49,48,1,0,8
31344,lañjaṃ,lanjam,103,102,1,0,6
31345,parājitehi,parajitehi,1,1,0,0,10
31346,yācitepi,yacitepi,1,1,0,0,8
31347,vamantīti,vamantiti,3,2,1,0,9
31348,avantī,avanti,5,4,1,0,6
31349,pañcālassa,pancalassa,6,6,0,0,10
31350,pañcālā,pancala,33,32,1,0,7
31351,vajjetabbāti,vajjetabbati,2,1,1,0,12
31352,vajjī,vajji,117,113,4,0,5
31353,vajjetabbā,vajjetabba,22,20,2,0,10
31354,pavattavacanamupādāya,pavattavacanamupadaya,1,1,0,0,21
31355,vajjīti,vajjiti,10,4,6,0,7
31356,laddhanāmā,laddhanama,48,48,0,0,10
31357,vajjīraṭṭhassa,vajjiratthassa,2,2,0,0,14
31358,taṃsamaññā,tamsamanna,6,6,0,0,10
31359,taṃnivāsirājakumāravasena,tamnivasirajakumaravasena,1,1,0,0,25
31360,dhārentīti,dharentiti,85,72,13,0,10
31361,kittigandhena,kittigandhena,1,1,0,0,13
31362,arantīti,arantiti,1,1,0,0,8
31363,cita,cita,10,5,5,0,4
31364,cetanti,cetanti,1,1,0,0,7
31365,yuddhakammādīsūti,yuddhakammadisuti,1,1,0,0,17
31366,cetayo,cetayo,2,1,1,0,6
31367,vaṅga,vanga,1,0,1,0,5
31368,visiṭṭhāni,visitthani,5,5,0,0,10
31369,dehāni,dehani,1,1,0,0,6
31370,videhā,videha,4,2,2,0,6
31371,pubbavidehadīpato,pubbavidehadipato,1,1,0,0,17
31372,oja,oja,4,3,1,0,3
31373,kambunā,kambuna,2,2,0,0,7
31374,sambukena,sambukena,1,1,0,0,9
31375,ojanti,ojanti,1,1,0,0,6
31376,vohārakaraṇatoti,voharakaranatoti,1,1,0,0,16
31377,kambojā,kamboja,8,6,2,0,7
31378,kambukajo,kambukajo,1,1,0,0,9
31379,balametesanti,balametesanti,1,1,0,0,13
31380,maddane,maddane,15,13,2,0,7
31381,maddantīti,maddantiti,7,7,0,0,10
31382,maddā,madda,9,6,3,0,5
31383,dadantīti,dadantiti,6,4,2,0,9
31384,modantīti,modantiti,3,3,0,0,9
31385,bhañja,bhanja,3,2,1,0,6
31386,bhaggā,bhagga,84,71,13,0,6
31387,sīhaṃ,siham,65,60,5,0,5
31388,lantīti,lantiti,1,1,0,0,7
31389,sīhaḷā,sihala,9,7,2,0,6
31390,kāsa,kasa,23,6,17,0,4
31391,kāsantīti,kasantiti,1,1,0,0,9
31392,kasmīrā,kasmira,2,1,1,0,7
31393,mīro,miro,2,2,0,0,4
31394,kāsī,kasi,21,19,2,0,4
31395,nissitānaṃ,nissitanam,14,13,1,0,10
31396,adassane,adassane,239,234,5,0,8
31397,jagati,jagati,11,10,1,0,6
31398,viṭṭhapādīnipi,vitthapadinipi,1,1,0,0,14
31399,bhuvanapariyāyāni,bhuvanapariyayani,1,1,0,0,17
31400,desasāmaññe,desasamanne,1,1,0,0,11
31401,atisajjane,atisajjane,6,5,1,0,10
31402,atisajjanaṃ,atisajjanam,17,17,0,0,11
31403,pabodhanaṃ,pabodhanam,18,18,0,0,10
31404,itthannāmo,itthannamo,468,459,9,0,10
31405,apadisatīti,apadisatiti,3,1,2,0,11
31406,siṭṭhācārarahito,sitthacararahito,1,1,0,0,16
31407,milakkhadeso,milakkhadeso,4,3,1,0,12
31408,kāmarūpā,kamarupa,1,0,1,0,8
31409,paccanto,paccanto,43,42,1,0,8
31410,milakkha,milakkha,3,1,2,0,8
31411,abyattiyaṃ,abyattiyam,2,2,0,0,10
31412,milakkhanti,milakkhanti,1,1,0,0,11
31413,abyattavācaṃ,abyattavacam,2,2,0,0,12
31414,bhāsantīti,bhasantiti,11,5,6,0,10
31415,milakkhā,milakkha,5,4,1,0,8
31416,siṭṭhācāramaggadassanatthāya,sitthacaramaggadassanatthaya,1,1,0,0,28
31417,paññācakkhuno,pannacakkhuno,14,12,2,0,13
31418,rāgādimalaṃ,ragadimalam,3,3,0,0,11
31419,akkhimhi,akkhimhi,43,43,0,0,8
31420,yesanti,yesanti,53,53,0,0,7
31421,nivāsaṭṭhānaṃ,nivasatthanam,65,65,0,0,13
31422,paccante,paccante,66,66,0,0,8
31423,majjhimadesassa,majjhimadesassa,3,3,0,0,15
31424,bahiddhābhāge,bahiddhabhage,1,1,0,0,13
31425,byavatthā,byavattha,1,1,0,0,9
31426,catuvaṇṇānaṃ,catuvannanam,2,2,0,0,12
31427,vijjate,vijjate,30,29,1,0,7
31428,majjhabhūmi,majjhabhumi,1,1,0,0,11
31429,ariyācārabhūmittā,ariyacarabhumitta,1,1,0,0,17
31430,majjho,majjho,25,20,5,0,6
31431,majjhadeso,majjhadeso,2,1,1,0,10
31432,navayojanasataparikkhepo,navayojanasataparikkhepo,1,1,0,0,24
31433,majjhimadeso,majjhimadeso,13,12,1,0,12
31434,salilappāyo,salilappayo,2,1,1,0,11
31435,bahūdako,bahudako,1,1,0,0,8
31436,anūpo,anupo,6,4,2,0,5
31437,anugatā,anugata,86,80,6,0,7
31438,āpā,apa,19,14,5,0,3
31439,āpassa,apassa,17,16,1,0,6
31440,ādino,adino,3,3,0,0,5
31441,paralopo,paralopo,17,17,0,0,8
31442,kaca,kaca,16,2,14,0,4
31443,kacchaṃ,kaccham,59,48,11,0,7
31444,anūpadeso,anupadeso,1,1,0,0,9
31445,abhinavoggamanena,abhinavoggamanena,1,1,0,0,17
31446,lakkhite,lakkhite,9,9,0,0,8
31447,harite,harite,66,58,8,0,6
31448,saddalo,saddalo,6,2,4,0,7
31449,dala,dala,20,7,13,0,4
31450,dalo,dalo,1,1,0,0,4
31451,nadiyā,nadiya,507,487,20,0,6
31452,ābhatena,abhatena,14,14,0,0,8
31453,ambunā,ambuna,5,4,1,0,6
31454,nadyambujīvano,nadyambujivano,2,1,1,0,14
31455,nadīmātikoti,nadimatikoti,1,0,1,0,12
31456,bahubbīhimhi,bahubbihimhi,10,8,2,0,12
31457,vuṭṭhiyā,vutthiya,16,15,1,0,8
31458,sassametthāti,sassametthati,1,1,0,0,13
31459,vuṭṭhinipphajjasassako,vutthinipphajjasassako,1,0,1,0,22
31460,devamātikoti,devamatikoti,1,0,1,0,12
31461,bahubbīhimhiyeva,bahubbihimhiyeva,1,1,0,0,16
31462,vuṭṭhimāha,vutthimaha,1,1,0,0,10
31463,anūpā,anupa,1,0,1,0,5
31464,devamātikā,devamatika,1,0,1,0,10
31465,candasūrādo,candasurado,1,0,1,0,11
31466,candasūriyasinerupabbatādimhi,candasuriyasinerupabbatadimhi,1,1,0,0,29
31467,sassati,sassati,3,1,2,0,7
31468,īrito,irito,11,7,4,0,5
31469,sassatiyo,sassatiyo,5,2,3,0,9
31470,raṭha,ratha,2,0,2,0,5
31471,raṭhanti,rathanti,2,2,0,0,8
31472,nagarādayoti,nagaradayoti,1,1,0,0,12
31473,raṭṭhaṃ,rattham,379,346,33,0,7
31474,nāgarehi,nagarehi,26,26,0,0,8
31475,vijinitabbanti,vijinitabbanti,1,1,0,0,14
31476,vijitaṃ,vijitam,112,92,20,0,7
31477,āḷiyaṃ,aliyam,3,2,1,0,6
31478,pavattamāno,pavattamano,118,117,1,0,11
31479,bhūsane,bhusane,17,15,2,0,7
31480,āḷi,ali,19,16,3,0,3
31481,nagarapabbatādino,nagarapabbatadino,1,1,0,0,17
31482,upāntabhū,upantabhu,2,1,1,0,9
31483,samīpabhūmi,samipabhumi,1,1,0,0,11
31484,parisaro,parisaro,2,0,2,0,8
31485,sarantyatrāti,sarantyatrati,1,1,0,0,13
31486,vaje,vaje,83,76,7,0,4
31487,tiṭṭhantyatrāti,titthantyatrati,1,1,0,0,15
31488,goṭṭhaṃ,gottham,9,6,3,0,7
31489,kulantyetthāti,kulantyetthati,1,1,0,0,14
31490,gokulaṃ,gokulam,6,4,2,0,7
31491,gharanti,gharanti,3,3,0,0,8
31492,nivāsanatthāyāti,nivasanatthayati,1,1,0,0,16
31493,vajo,vajo,19,17,2,0,4
31494,goṭṭhānakaṃ,gotthanakam,1,1,0,0,11
31495,goṭṭhānantipi,gotthanantipi,1,1,0,0,13
31496,vajassa,vajassa,3,3,0,0,7
31497,pathikehi,pathikehi,5,5,0,0,9
31498,majjate,majjate,5,5,0,0,7
31499,nittiṇaṃ,nittinam,8,8,0,0,8
31500,karīyateti,kariyateti,9,9,0,0,10
31501,majja,majja,24,14,10,0,5
31502,suddhiyaṃ,suddhiyam,12,9,3,0,9
31503,maggīyateti,maggiyateti,1,1,0,0,11
31504,anvesane,anvesane,6,5,1,0,8
31505,parisāyañce,parisayance,1,1,0,0,11
31506,karotītyattho,karotityattho,4,4,0,0,13
31507,kriyāvisesanametaṃ,kriyavisesanametam,1,1,0,0,18
31508,pathi,pathi,4,2,2,0,5
31509,panthayanti,panthayanti,2,2,0,0,11
31510,yantyanenāti,yantyanenati,1,1,0,0,12
31511,pantho,pantho,48,42,6,0,6
31512,kāritalopo,karitalopo,4,4,0,0,10
31513,pathati,pathati,3,3,0,0,7
31514,yātyanenāti,yatyanenati,1,1,0,0,11
31515,ada,ada,30,18,12,0,3
31516,kālepi,kalepi,77,75,2,0,6
31517,samabhāgatthavacane,samabhagatthavacane,1,1,0,0,19
31518,addha,addha,15,7,8,0,5
31519,pumanapuṃsakavasena,pumanapumsakavasena,1,1,0,0,19
31520,dviliṅgo,dvilingo,9,9,0,0,8
31521,ditte,ditte,2,2,0,0,5
31522,añja,anja,5,0,5,0,4
31523,pajjo,pajjo,23,19,4,0,5
31524,vatta,vatta,19,15,4,0,5
31525,vattane,vattane,19,17,2,0,7
31526,vattanaṃ,vattanam,22,22,0,0,8
31527,gamanādi,gamanadi,8,8,0,0,8
31528,ani,ani,8,7,1,0,3
31529,kantanadaṇḍe,kantanadande,1,1,0,0,12
31530,punnapuṃsakaṃ,punnapumsakam,2,2,0,0,13
31531,pādehi,padehi,286,284,2,0,6
31532,paddhati,paddhati,5,2,3,0,8
31533,saddasamānatthena,saddasamanatthena,1,1,0,0,17
31534,niyatappayogato,niyatappayogato,1,1,0,0,15
31535,vuttinā,vuttina,3,3,0,0,7
31536,saddūpapado,saddupapado,2,2,0,0,11
31537,para191-192,para191-192,2,2,0,0,11
31538,tabbhedā,tabbheda,16,8,8,0,8
31539,jaṅghamaggā,janghamagga,1,0,1,0,11
31540,apatha,apatha,1,0,1,0,6
31541,jaṅghamaggo,janghamaggo,16,14,2,0,11
31542,sakaṭehi,sakatehi,32,32,0,0,8
31543,sakaṭamaggo,sakatamaggo,9,8,1,0,11
31544,jaṅghamaggasakaṭamaggā,janghamaggasakatamagga,4,4,0,0,22
31545,mahāmagge,mahamagge,30,29,1,0,9
31546,tethā,tetha,2,2,0,0,5
31547,vattabbo,vattabbo,1202,1182,20,0,8
31548,matāddhanī,mataddhani,1,1,0,0,10
31549,vattabboyeva,vattabboyeva,6,6,0,0,12
31550,ekapadike,ekapadike,1,1,0,0,9
31551,addhani,addhani,23,23,0,0,7
31552,ekapadī,ekapadi,12,11,1,0,7
31553,matāti,matati,51,37,14,0,6
31554,kātabbā,katabba,981,962,19,0,7
31555,gacchataṃ,gacchatam,27,26,1,0,9
31556,nisinnasseva,nisinnasseva,11,11,0,0,12
31557,yamakoti,yamakoti,1,1,0,0,8
31558,niccamīpaccayo,niccamipaccayo,1,1,0,0,14
31559,ekapadiko,ekapadiko,7,6,1,0,9
31560,rassattaṃ,rassattam,179,178,1,0,9
31561,corakaṇṭakādidose,corakantakadidose,1,1,0,0,17
31562,duggame,duggame,5,5,0,0,7
31563,pathe,pathe,81,72,9,0,5
31564,nnapuṃsake,nnapumsake,1,1,0,0,10
31565,pānīyena,paniyena,87,82,5,0,8
31566,atikkamanti,atikkamanti,35,35,0,0,11
31567,tara,tara,41,15,26,0,4
31568,corakantārādīsu,corakantaradisu,1,1,0,0,15
31569,rūḷhivasena,rulhivasena,5,5,0,0,11
31570,sappaṭibhayattā,sappatibhayatta,1,1,0,0,15
31571,niccagamanāgamanametthāti,niccagamanagamanametthati,1,1,0,0,25
31572,gacchantyetthāti,gacchantyetthati,1,1,0,0,16
31573,duggamo,duggamo,14,12,2,0,7
31574,paṭimagge,patimagge,3,2,1,0,9
31575,abhimukhena,abhimukhena,9,9,0,0,11
31576,gantabbo,gantabbo,252,250,2,0,8
31577,paṭimaggo,patimaggo,2,1,1,0,9
31578,paṭipatho,patipatho,2,1,1,0,9
31579,dīghamañjasaṃ,dighamanjasam,1,0,1,0,13
31580,atidūro,atiduro,1,1,0,0,7
31581,accāyato,accayato,1,1,0,0,8
31582,pasattheddhani,pasattheddhani,1,1,0,0,14
31583,gantabbapathabhāvato,gantabbapathabhavato,1,1,0,0,20
31584,apetaṃ,apetam,28,24,4,0,6
31585,uppathaṃ,uppatham,16,13,3,0,8
31586,apathañca,apathanca,1,0,1,0,9
31587,abyayībhāvasamāso,abyayibhavasamaso,7,7,0,0,17
31588,para194-196,para194-196,1,1,0,0,11
31589,paramāṇūnaṃ,paramanunam,2,2,0,0,11
31590,aṇu,anu,17,14,3,0,3
31591,aṇutopi,anutopi,1,1,0,0,7
31592,aṇutarattā,anutaratta,1,1,0,0,10
31593,aṇuto,anuto,6,5,1,0,5
31594,paramoti,paramoti,8,5,3,0,8
31595,paramāṇu,paramanu,11,9,2,0,8
31596,aṇavo,anavo,1,1,0,0,5
31597,tajjārī,tajjari,10,7,3,0,7
31598,malīnakaraṇavasena,malinakaranavasena,1,1,0,0,18
31599,jarāpetīti,jarapetiti,3,3,0,0,10
31600,jīraṇe,jirane,3,3,0,0,6
31601,vayohānimhi,vayohanimhi,13,12,1,0,11
31602,tāpi,tapi,146,140,6,0,4
31603,tajjāriyo,tajjariyo,2,2,0,0,9
31604,rathareṇu,ratharenu,10,7,3,0,9
31605,rathānaṃ,rathanam,15,15,0,0,8
31606,sañcaraṇavasena,sancaranavasena,4,3,1,0,15
31607,reṇu,renu,87,83,4,0,4
31608,rathareṇavo,ratharenavo,1,1,0,0,11
31609,likkhā,likkha,11,8,3,0,6
31610,ssane,ssane,1,1,0,0,5
31611,pakaticakkhunāpi,pakaticakkhunapi,1,1,0,0,16
31612,lakkhyateti,lakkhyateti,2,2,0,0,11
31613,ūkā,uka,30,28,2,0,3
31614,ūkāti,ukati,4,2,2,0,5
31615,sirovattakimi,sirovattakimi,1,1,0,0,13
31616,tappamāṇattā,tappamanatta,2,2,0,0,12
31617,dhaññamāso,dhannamaso,5,4,1,0,10
31618,vīhiyeva,vihiyeva,1,1,0,0,8
31619,parimāṇitabbattā,parimanitabbatta,1,1,0,0,16
31620,dhaññamāsā,dhannamasa,1,1,0,0,10
31621,aṅgulaṃ,angulam,18,16,2,0,7
31622,ulo,ulo,18,18,0,0,3
31623,uli,uli,2,1,1,0,3
31624,amudviccheti,amudviccheti,1,0,1,0,12
31625,aduṃ,adum,64,56,8,0,4
31626,dvādasaṅgulaṃ,dvadasangulam,3,3,0,0,13
31627,vidatthi,vidatthi,43,36,7,0,8
31628,kaṇiṭṭhasahitenaṅguṭṭhena,kanitthasahitenangutthena,1,1,0,0,25
31629,vitthārīyate,vitthariyate,1,1,0,0,12
31630,vidhīyateti,vidhiyateti,2,2,0,0,11
31631,ubhayatrāpiti,ubhayatrapiti,1,1,0,0,13
31632,pubbapakkhe,pubbapakkhe,12,12,0,0,11
31633,asarūpadvibhāvo,asarupadvibhavo,1,1,0,0,15
31634,vidatthī,vidatthi,9,8,1,0,8
31635,tano,tano,24,22,2,0,4
31636,yaṭṭhi,yatthi,24,21,3,0,6
31637,payatane,payatane,9,6,3,0,8
31638,yaṭṭhiyo,yatthiyo,16,16,0,0,8
31639,usabhanadantaraṃ,usabhanadantaram,1,1,0,0,16
31640,usabhānaṃ,usabhanam,3,3,0,0,9
31641,asītippamāṇaṃ,asitippamanam,1,1,0,0,13
31642,gāvutaṃ,gavutam,44,42,2,0,7
31643,gavehi,gavehi,1,1,0,0,6
31644,yutaṃ,yutam,7,7,0,0,5
31645,gonadantarehi,gonadantarehi,1,1,0,0,13
31646,gahitappamāṇasamādhānantyattho,gahitappamanasamadhanantyattho,1,1,0,0,30
31647,catugāvutaṃ,catugavutam,4,4,0,0,11
31648,catugāvutehi,catugavutehi,1,1,0,0,12
31649,samādhānantyattho,samadhanantyattho,1,1,0,0,17
31650,āropitānaṃ,aropitanam,1,1,0,0,10
31651,ācariyadhanūnaṃ,acariyadhanunam,1,1,0,0,15
31652,pañcasataṃ,pancasatam,31,27,4,0,10
31653,anāropitānantyapare,anaropitanantyapare,1,1,0,0,19
31654,kusanaṃ,kusanam,1,1,0,0,7
31655,avhānaṃ,avhanam,6,5,1,0,7
31656,kosappamāṇattā,kosappamanatta,1,1,0,0,14
31657,dvisahassakarappamāṇo,dvisahassakarappamano,1,1,0,0,21
31658,catukkādhivīsatiyā,catukkadhivisatiya,1,1,0,0,18
31659,aṅgulehi,angulehi,5,5,0,0,8
31660,khyātamaṭṭhasahassehi,khyatamatthasahassehi,1,1,0,0,21
31661,kosamānaṃ,kosamanam,1,1,0,0,9
31662,vibhāvinā,vibhavina,122,112,10,0,9
31663,tyuttaṃ,tyuttam,1,1,0,0,7
31664,caturambaṇaṃ,caturambanam,4,2,2,0,12
31665,caturambaṇavīhibījajātaropanayogyo,caturambanavihibijajataropanayogyo,1,1,0,0,34
31666,bhūmippadeso,bhumippadeso,23,23,0,0,12
31667,karīsaṃ,karisam,94,83,11,0,7
31668,kasanaropanādikanti,kasanaropanadikanti,1,1,0,0,19
31669,caturambaṇabījajātāni,caturambanabijajatani,1,1,0,0,21
31670,ropentyetthāti,ropentyetthati,1,1,0,0,14
31671,ambaṇaṃ,ambanam,19,9,10,0,7
31672,ekādasadoṇamattaṃ,ekadasadonamattam,2,2,0,0,17
31673,catuyaṭṭhikaṃ,catuyatthikam,1,1,0,0,13
31674,karīsabbhantarānaṃ,karisabbhantaranam,1,1,0,0,18
31675,pariyāyabhāvappasaṅgā,pariyayabhavappasanga,1,1,0,0,21
31676,hatthānamaṭṭhavīsappamāṇaṃ,hatthanamatthavisappamanam,1,1,0,0,26
31677,abbhantaraṃ,abbhantaram,156,131,25,0,11
31678,abbhantare,abbhantare,425,412,13,0,10
31679,antokoṭṭhāse,antokotthase,2,2,0,0,12
31680,bahikoṭṭhāseti,bahikotthaseti,1,1,0,0,14
31681,aṭṭhavīsatihatthappamāṇaṃ,atthavisatihatthappamanam,5,5,0,0,25
31682,bhūmyā,bhumya,26,22,4,0,6
31683,bhūmivaggo,bhumivaggo,2,1,1,0,10
31684,aṅgāpekkhāya,angapekkhaya,1,1,0,0,12
31685,bhūmiyeva,bhumiyeva,3,3,0,0,9
31686,bhūmivaggabyappadeso,bhumivaggabyappadeso,1,1,0,0,20
31687,puravaggavaṇṇanā,puravaggavannana,2,2,0,0,16
31688,paṭṭanañca,pattananca,1,1,0,0,10
31689,puṭabhedanaṃ,putabhedanam,14,5,9,0,12
31690,thiyo,thiyo,40,35,5,0,5
31691,pū,pu,16,3,13,0,2
31692,nagarī,nagari,17,17,0,0,6
31693,pūriyo,puriyo,1,1,0,0,6
31694,ṭhānīyaṃ,thaniyam,3,2,1,0,8
31695,kabbaṭaṃ,kabbatam,1,1,0,0,8
31696,puṭaṃ,putam,33,31,2,0,5
31697,silokapariyāyesu,silokapariyayesu,1,1,0,0,16
31698,vopālito,vopalito,30,3,27,0,8
31699,vicittadevāyatanaṃ,vicittadevayatanam,2,2,0,0,18
31700,pāsādāpaṇamandiraṃ,pasadapanamandiram,2,2,0,0,18
31701,rājamaggopasobhitaṃ,rajamaggopasobhitam,1,1,0,0,19
31702,nagaralakkhaṇaṃ,nagaralakkhanam,1,1,0,0,15
31703,pura,pura,28,6,22,0,4
31704,pālaneti,palaneti,2,1,1,0,8
31705,pureti,pureti,59,11,48,0,6
31706,paracakkā,paracakka,1,1,0,0,9
31707,duggatāyāti,duggatayati,1,1,0,0,11
31708,aggagamanetipi,aggagamanetipi,1,1,0,0,14
31709,nagā,naga,33,30,3,0,4
31710,pāsādādayo,pasadadayo,1,1,0,0,10
31711,nagara,nagara,14,12,2,0,6
31712,samuccinoti,samuccinoti,51,51,0,0,11
31713,nagariyo,nagariyo,1,1,0,0,8
31714,pattanaṃ,pattanam,2,2,0,0,8
31715,pattanasāhacariyā,pattanasahacariya,1,1,0,0,17
31716,saddassāpītyācariyā,saddassapityacariya,1,1,0,0,19
31717,akutobhayattā,akutobhayatta,1,1,0,0,13
31718,ṭhānāya,thanaya,2,2,0,0,7
31719,īyo,iyo,27,26,1,0,3
31720,paṇikānaṃ,panikanam,1,1,0,0,9
31721,puṭā,puta,3,3,0,0,4
31722,bhijjante,bhijjante,11,11,0,0,9
31723,niccanivāsanaṭṭhānaṃ,niccanivasanatthanam,1,1,0,0,20
31724,itaraṃ,itaram,659,605,54,0,6
31725,thiya,thiya,1,0,1,0,5
31726,rājaṭhānī,rajathani,2,1,1,0,9
31727,niccanivāsanaṭṭhānepi,niccanivasanatthanepi,1,1,0,0,21
31728,caturāsītinagarasahassāni,caturasitinagarasahassani,4,4,0,0,25
31729,kusavatīrājaṭhānīpamukhānī,kusavatirajathanipamukhani,1,1,0,0,26
31730,dārukkhandhādīhi,darukkhandhadihi,2,2,0,0,16
31731,parikkhipīyanti,parikkhipiyanti,1,1,0,0,15
31732,khandhāvāro,khandhavaro,4,2,2,0,11
31733,patthanattho,patthanattho,1,1,0,0,12
31734,parikkhipanattho,parikkhipanattho,1,1,0,0,16
31735,aciranivāsanaṭṭhānassa,aciranivasanatthanassa,1,1,0,0,22
31736,mūlapurā,mulapura,2,1,1,0,8
31737,mūlapuraṃ,mulapuram,1,1,0,0,9
31738,vajjetvā,vajjetva,423,412,11,0,8
31739,puramatthi,puramatthi,1,1,0,0,10
31740,yojanavitthiṇṇapākārādiparikkhittaṃ,yojanavitthinnapakaradiparikkhittam,1,1,0,0,35
31741,mūlapurassa,mulapurassa,2,2,0,0,11
31742,taruṭṭhāniyassa,tarutthaniyassa,1,1,0,0,15
31743,sākhāsadisattā,sakhasadisatta,1,1,0,0,14
31744,sākhānagaraṃ,sakhanagaram,1,0,1,0,12
31745,para200-201,para200-201,1,1,0,0,11
31746,sāddhapajjadvayena,saddhapajjadvayena,1,1,0,0,18
31747,vānarasīsaṃ,vanarasisam,2,2,0,0,11
31748,taṃsaṇṭhāno,tamsanthano,2,2,0,0,11
31749,vaṇṇavipariyayaṃ,vannavipariyayam,1,1,0,0,16
31750,lopañca,lopanca,14,8,6,0,7
31751,bārāṇasī,baranasi,68,67,1,0,8
31752,savatthassa,savatthassa,7,7,0,0,11
31753,nivāsanaṭṭhānattā,nivasanatthanatta,2,2,0,0,17
31754,dhanamettha,dhanamettha,1,1,0,0,11
31755,dhanavācako,dhanavacako,1,1,0,0,11
31756,visālībhūtattā,visalibhutatta,6,6,0,0,14
31757,vesālī,vesali,83,74,9,0,6
31758,assatthutthe,assatthutthe,1,1,0,0,12
31759,mathi,mathi,1,0,1,0,5
31760,mithilā,mithila,13,12,1,0,7
31761,bhūsanametthāti,bhusanametthati,1,1,0,0,15
31762,āḷavī,alavi,14,13,1,0,5
31763,vī,vi,76,55,21,0,2
31764,ḷa,la,32,21,11,0,2
31765,khādatha,khadatha,37,36,1,0,8
31766,pivathā,pivatha,10,10,0,0,7
31767,tyādīhi,tyadihi,4,4,0,0,7
31768,kosanti,kosanti,2,2,0,0,7
31769,kosambī,kosambi,27,24,3,0,7
31770,kusambarukkhavantatāya,kusambarukkhavantataya,1,1,0,0,22
31771,kusambassa,kusambassa,6,6,0,0,10
31772,assamato,assamato,9,9,0,0,8
31773,avidūre,avidure,734,715,19,0,7
31774,māpitattāti,mapitattati,5,5,0,0,11
31775,uggaṃ,uggam,25,21,4,0,5
31776,ripuṃ,ripum,5,5,0,0,5
31777,ujjenī,ujjeni,2,1,1,0,6
31778,ūhe,uhe,1,1,0,0,3
31779,ūnapūraṇaṃ,unapuranam,1,1,0,0,10
31780,takkanaṃ,takkanam,17,17,0,0,8
31781,takkasīlā,takkasila,1,0,1,0,9
31782,purisakārena,purisakarena,8,8,0,0,12
31783,tamūnaṃ,tamunam,1,1,0,0,7
31784,cama,cama,1,0,1,0,4
31785,campā,campa,24,22,2,0,5
31786,sānaṃ,sanam,56,53,3,0,5
31787,dhanānaṃ,dhananam,16,15,1,0,8
31788,ākaraṃ,akaram,1,1,0,0,6
31789,sākaro,sakaro,1,1,0,0,6
31790,sāgalaṃ,sagalam,7,6,1,0,7
31791,saṃsumārasaṇṭhāno,samsumarasanthano,1,1,0,0,17
31792,saṃsumāragiraṃ,samsumaragiram,4,1,3,0,14
31793,māpitakāleti,mapitakaleti,4,4,0,0,12
31794,rājūnameva,rajunameva,2,2,0,0,10
31795,ādhipaccavasena,adhipaccavasena,2,2,0,0,15
31796,pariggahitabbattā,pariggahitabbatta,1,1,0,0,17
31797,ādikāle,adikale,9,9,0,0,7
31798,kapilanāmassa,kapilanamassa,1,1,0,0,13
31799,kapilavatthu,kapilavatthu,30,27,3,0,12
31800,pumanapuṃsake,pumanapumsake,1,1,0,0,13
31801,sāko,sako,7,6,1,0,4
31802,sāketaṃ,saketam,42,38,4,0,7
31803,sattimhi,sattimhi,6,6,0,0,8
31804,bhūpāle,bhupale,2,2,0,0,7
31805,dumadīpantaresu,dumadipantaresu,1,1,0,0,15
31806,sañjātatthe,sanjatatthe,6,6,0,0,11
31807,sañjātoti,sanjatoti,1,1,0,0,9
31808,indaṃ,indam,23,22,1,0,5
31809,paramissariyabhāvaṃ,paramissariyabhavam,1,1,0,0,19
31810,indapattaṃ,indapattam,3,1,2,0,10
31811,dhārayati,dharayati,13,13,0,0,9
31812,ukkaṭṭhā,ukkattha,36,24,12,0,8
31813,māpitaṭṭhāne,mapitatthane,1,1,0,0,12
31814,pāṭalīnāmako,patalinamako,1,1,0,0,12
31815,taruṇarukkho,tarunarukkho,3,3,0,0,12
31816,pāṭaliputtakaṃ,pataliputtakam,4,2,2,0,14
31817,paṭali,patali,1,1,0,0,6
31818,gāmaṇī,gamani,26,23,3,0,6
31819,vasatiādikāleti,vasatiadikaleti,1,1,0,0,15
31820,cetiyaraṭṭhe,cetiyaratthe,7,7,0,0,12
31821,cetuttaraṃ,cetuttaram,1,0,1,0,10
31822,jetuttaraṃ,jetuttaram,7,6,1,0,10
31823,verijayaṭṭhānattā,verijayatthanatta,1,1,0,0,17
31824,jetañca,jetanca,1,1,0,0,7
31825,uttarañceti,uttaranceti,2,2,0,0,11
31826,māpitakāle,mapitakale,4,4,0,0,10
31827,saṅkassaṃ,sankassam,12,10,2,0,9
31828,kasanti,kasanti,36,34,2,0,7
31829,nimittamolokentā,nimittamolokenta,1,1,0,0,16
31830,brāhmaṇā,brahmana,1427,1366,61,0,8
31831,kusahatthaṃ,kusahattham,2,2,0,0,11
31832,naraṃ,naram,182,167,15,0,5
31833,māpenti,mapenti,21,20,1,0,7
31834,kusināraṃ,kusinaram,35,32,3,0,9
31835,mathura,mathura,1,1,0,0,7
31836,mādhura,madhura,1,1,0,0,7
31837,pāsāṇapurasoṇikādayopyanekapuravisesā,pasanapurasonikadayopyanekapuravisesa,1,1,0,0,37
31838,abbhantaragāmamagge,abbhantaragamamagge,1,1,0,0,19
31839,rathassa,rathassa,119,115,4,0,8
31840,racchā,raccha,33,30,3,0,6
31841,pabbajjādi,pabbajjadi,1,1,0,0,10
31842,visayante,visayante,1,1,0,0,9
31843,pakāsayante,pakasayante,1,1,0,0,11
31844,vikkayena,vikkayena,6,6,0,0,9
31845,dabbāni,dabbani,2,2,0,0,7
31846,visikhā,visikha,16,12,4,0,7
31847,rathikā,rathika,66,60,6,0,7
31848,iko,iko,56,56,0,0,3
31849,thi,thi,10,10,0,0,3
31850,anibbiddhā,anibbiddha,8,7,1,0,10
31851,racchantarena,racchantarena,3,3,0,0,13
31852,byūho,byuho,21,10,11,0,5
31853,byūheti,byuheti,4,2,2,0,7
31854,gantumappadānavasenāti,gantumappadanavasenati,1,1,0,0,22
31855,sampiṇḍane,sampindane,9,9,0,0,10
31856,nibbijjhate,nibbijjhate,1,1,0,0,11
31857,racchantarenāti,racchantarenati,1,1,0,0,15
31858,anibbiddho,anibbiddho,1,0,1,0,10
31859,vidha,vidha,25,6,19,0,5
31860,sampahāre,sampahare,19,17,2,0,9
31861,nibbiddhā,nibbiddha,4,4,0,0,9
31862,addhīti,addhiti,1,0,1,0,7
31863,addhi,addhi,1,1,0,0,5
31864,caccare,caccare,6,6,0,0,7
31865,pathānaṃ,pathanam,3,3,0,0,8
31866,gatibhakkhanesu,gatibhakkhanesu,6,5,1,0,15
31867,caro,caro,10,8,2,0,4
31868,caccaraṃ,caccaram,9,7,2,0,8
31869,aṅgaṇavācako,anganavacako,1,1,0,0,12
31870,maggānaṃ,magganam,168,155,13,0,8
31871,maggasandhi,maggasandhi,1,0,1,0,11
31872,siṅgha,singha,3,0,3,0,6
31873,ghāyane,ghayane,4,4,0,0,7
31874,āṭako,atako,1,1,0,0,5
31875,vappassopari,vappassopari,1,1,0,0,12
31876,iṭṭhakādiracite,itthakadiracite,2,2,0,0,15
31877,veṭhane,vethane,15,9,6,0,7
31878,vappaṃ,vappam,17,14,3,0,6
31879,dugganagare,dugganagare,1,1,0,0,11
31880,parikhāmattikaṃ,parikhamattikam,1,1,0,0,15
31881,kuṭiṃ,kutim,263,243,20,0,5
31882,gohi,gohi,67,64,3,0,4
31883,hatthīhi,hatthihi,35,35,0,0,8
31884,vimaddāpetvā,vimaddapetva,1,1,0,0,12
31885,tiṃsahatthappamāṇaṃ,timsahatthappamanam,1,1,0,0,19
31886,pākārassa,pakarassa,32,30,2,0,9
31887,heṭṭhimatalaṃ,hetthimatalam,22,21,1,0,13
31888,hatthasataṃ,hatthasatam,9,8,1,0,11
31889,paṃsunā,pamsuna,38,36,2,0,7
31890,kāraye,karaye,89,85,4,0,6
31891,tassopari,tassopari,8,8,0,0,9
31892,pākāranti,pakaranti,1,1,0,0,9
31893,pakubbanti,pakubbanti,2,2,0,0,10
31894,vuṇotīti,vunotiti,1,1,0,0,8
31895,varaṇo,varano,6,5,1,0,6
31896,rāgamo,ragamo,4,4,0,0,6
31897,sālo,salo,31,26,5,0,4
31898,rājabhavanasāmaññe,rajabhavanasamanne,1,1,0,0,18
31899,sabbagehānaṃ,sabbagehanam,1,1,0,0,12
31900,uddāpo,uddapo,4,3,1,0,6
31901,īssākāro,issakaro,1,1,0,0,8
31902,upakārikā,upakarika,28,21,7,0,9
31903,thīkatākārapare,thikatakarapare,1,1,0,0,15
31904,desopi,desopi,1,1,0,0,6
31905,datto,datto,53,52,1,0,5
31906,para204,para204,139,139,0,0,7
31907,gehādino,gehadino,1,1,0,0,8
31908,mattikeṭṭhakādimayabhittiyaṃ,mattiketthakadimayabhittiyam,1,1,0,0,28
31909,kuṭati,kutati,8,8,0,0,6
31910,kuṭṭaṃ,kuttam,38,28,10,0,6
31911,bhidi,bhidi,12,2,10,0,5
31912,bhitti,bhitti,66,64,2,0,6
31913,vācānaṃ,vacanam,12,12,0,0,7
31914,gopuraṃ,gopuram,9,7,2,0,7
31915,dvārasamīpe,dvarasamipe,20,20,0,0,11
31916,koṭṭhako,kotthako,52,51,1,0,8
31917,dvārakoṭṭhako,dvarakotthako,10,9,1,0,13
31918,ṭhako,thako,2,2,0,0,5
31919,koṭṭhakoti,kotthakoti,5,1,4,0,10
31920,gehaviseso,gehaviseso,2,2,0,0,10
31921,indakhīle,indakhile,19,18,1,0,9
31922,khīlo,khilo,7,6,1,0,5
31923,kaṇṭako,kantako,102,101,1,0,7
31924,indakhīlo,indakhilo,38,31,7,0,9
31925,dvārapassopasālāyaṃ,dvarapassopasalayam,1,1,0,0,19
31926,hamyādipiṭṭhe,hamyadipitthe,1,1,0,0,13
31927,vātakuṭikāyaṃ,vatakutikayam,1,1,0,0,13
31928,aḍḍa,adda,2,0,2,0,4
31929,atikkamahiṃsāsu,atikkamahimsasu,1,1,0,0,15
31930,ālaka,alaka,1,0,1,0,5
31931,aṭṭālako,attalako,2,0,2,0,8
31932,mālādiyuttaṃ,maladiyuttam,1,1,0,0,12
31933,sobhanathambhadvayamubhayato,sobhanathambhadvayamubhayato,1,1,0,0,28
31934,nikhanitvā,nikhanitva,19,19,0,0,10
31935,bahidvāraṃ,bahidvaram,3,2,1,0,10
31936,kappīyate,kappiyate,1,1,0,0,9
31937,vāraṇe,varane,6,4,2,0,6
31938,thavantā,thavanta,1,1,0,0,8
31939,raṇantyatrāti,ranantyatrati,1,1,0,0,13
31940,raṇa,rana,12,3,9,0,4
31941,dvārassa,dvarassa,38,35,3,0,8
31942,khaññateti,khannateti,6,6,0,0,10
31943,parikhā,parikha,19,17,2,0,7
31944,dīghabhāvena,dighabhavena,10,10,0,0,12
31945,dīghikā,dighika,2,1,1,0,7
31946,para206-207,para206-207,1,1,0,0,11
31947,saduma,saduma,1,0,1,0,6
31948,modanathutijaḷattesu,modanathutijalattesu,1,1,0,0,20
31949,yatthāti,yatthati,176,9,167,0,8
31950,mandiraṃ,mandiram,29,24,5,0,8
31951,tatthāti,tatthati,1325,32,1293,0,8
31952,sada,sada,21,3,18,0,4
31953,visaraṇagatyāvasānesu,visaranagatyavasanesu,7,6,1,0,21
31954,thambhādayo,thambhadayo,3,3,0,0,11
31955,āgāraṃ,agaram,6,5,1,0,6
31956,nicīyate,niciyate,1,1,0,0,8
31957,chādīyateti,chadiyateti,1,1,0,0,11
31958,nikāyo,nikayo,33,27,6,0,6
31959,lī,li,14,6,8,0,2
31960,silesane,silesane,13,12,1,0,8
31961,nilayo,nilayo,2,1,1,0,6
31962,āvasantyatrāti,avasantyatrati,1,1,0,0,14
31963,āvāso,avaso,341,327,14,0,5
31964,bhavantyatrāti,bhavantyatrati,1,1,0,0,14
31965,vesmaṃ,vesmam,6,5,1,0,6
31966,niketanaṃ,niketanam,7,4,3,0,9
31967,nivisanti,nivisanti,5,5,0,0,9
31968,nivasanti,nivasanti,42,42,0,0,9
31969,nivesanaṃ,nivesanam,381,362,19,0,9
31970,ghara,ghara,21,14,7,0,5
31971,kilesametthāti,kilesametthati,1,1,0,0,14
31972,gayhatīti,gayhatiti,103,101,2,0,9
31973,gharā,ghara,145,127,18,0,5
31974,ānītaṃ,anitam,79,78,1,0,6
31975,dhananti,dhananti,11,11,0,0,8
31976,gahaṃ,gaham,19,17,2,0,5
31977,āvasatho,avasatho,30,25,5,0,8
31978,gaticintāhiṃsāsu,gaticintahimsasu,2,2,0,0,16
31979,subhāsubhakammāni,subhasubhakammani,1,1,0,0,17
31980,sūriyasantāpādikanti,suriyasantapadikanti,1,1,0,0,20
31981,patissayo,patissayo,6,4,2,0,9
31982,uca,uca,8,2,6,0,3
31983,okaṃ,okam,31,20,11,0,4
31984,sala,sala,32,5,27,0,4
31985,itthiyamatiyavo,itthiyamatiyavo,12,10,2,0,15
31986,dhātumhi,dhatumhi,12,12,0,0,8
31987,upadhassa,upadhassa,3,2,1,0,9
31988,sadumaṃ,sadumam,2,1,1,0,7
31989,mukharahitadevakulasadise,mukharahitadevakulasadise,1,1,0,0,25
31990,yaññāyatane,yannayatane,1,1,0,0,11
31991,yatane,yatane,5,5,0,0,6
31992,phalakāmāti,phalakamati,1,1,0,0,11
31993,āyatanaṃ,ayatanam,329,283,46,0,8
31994,āyantīti,ayantiti,7,3,4,0,8
31995,āyāni,ayani,2,2,0,0,5
31996,phalakārakantyattho,phalakarakantyattho,1,1,0,0,19
31997,samāgatānaṃ,samagatanam,26,22,4,0,11
31998,pubbāparagamanattho,pubbaparagamanattho,1,1,0,0,19
31999,cetiyāyatanāni,cetiyayatanani,1,1,0,0,14
32000,narapatīnañca,narapatinanca,1,1,0,0,13
32001,iṭṭhakādimaye,itthakadimaye,1,1,0,0,13
32002,aññassāpi,annassapi,16,16,0,0,9
32003,sādisyā,sadisya,2,2,0,0,7
32004,pasīdanti,pasidanti,66,66,0,0,9
32005,nayanamanānyatrāti,nayanamananyatrati,1,1,0,0,18
32006,dīghavidhānasāmatthiyā,dighavidhanasamatthiya,3,3,0,0,22
32007,ttābhāvo,ttabhavo,4,4,0,0,8
32008,rājato,rajato,69,65,4,0,6
32009,dhanīnaṃ,dhaninam,1,1,0,0,8
32010,byavahārakādīnaṃ,byavaharakadinam,1,1,0,0,16
32011,muṇḍo,mundo,62,59,3,0,5
32012,chadanametassa,chadanametassa,1,1,0,0,14
32013,pāsādassa,pasadassa,134,129,5,0,9
32014,muṇḍacchado,mundacchado,2,1,1,0,11
32015,duggapuradvāre,duggapuradvare,1,1,0,0,14
32016,mattikādimaye,mattikadimaye,1,1,0,0,13
32017,gajakumbhamhi,gajakumbhamhi,2,2,0,0,13
32018,yūpo,yupo,42,31,11,0,4
32019,hatthinakho,hatthinakho,7,2,5,0,11
32020,hatthisseva,hatthisseva,3,3,0,0,11
32021,nakho,nakho,15,13,2,0,5
32022,nakha,nakha,10,8,2,0,5
32023,nakhasahito,nakhasahito,1,1,0,0,11
32024,supaṇṇassa,supannassa,8,8,0,0,10
32025,garuḷassa,garulassa,3,3,0,0,9
32026,vaṅkena,vankena,4,4,0,0,7
32027,pakkhena,pakkhena,18,18,0,0,8
32028,sadisachadanaṃ,sadisachadanam,1,1,0,0,14
32029,suvaṇṇavaṅkacchadanaṃ,suvannavankacchadanam,1,0,1,0,21
32030,vaṅka,vanka,20,1,19,0,5
32031,ekapasseyeva,ekapasseyeva,2,2,0,0,12
32032,chadanato,chadanato,8,8,0,0,9
32033,aḍḍhayogo,addhayogo,37,28,9,0,9
32034,ekeneva,ekeneva,173,168,5,0,7
32035,kūṭena,kutena,19,16,3,0,6
32036,anekakoṇo,anekakono,3,3,0,0,9
32037,patissayaviseso,patissayaviseso,22,22,0,0,15
32038,māḷo,malo,27,13,14,0,4
32039,vaṭṭākārena,vattakarena,6,6,0,0,11
32040,katasenāsananti,katasenasananti,1,1,0,0,15
32041,caturasso,caturasso,8,8,0,0,9
32042,āyatacaturassapāsādoti,ayatacaturassapasadoti,1,1,0,0,22
32043,sabhāyaṃ,sabhayam,83,72,11,0,8
32044,purime,purime,110,99,11,0,6
32045,santa,santa,30,11,19,0,5
32046,tūbhayatra,tubhayatra,1,1,0,0,10
32047,maṇḍā,manda,7,7,0,0,5
32048,raviraṃsayo,raviramsayo,1,1,0,0,11
32049,pivati,pivati,138,137,1,0,6
32050,nāsayatīti,nasayatiti,3,3,0,0,10
32051,maṇḍapo,mandapo,49,44,5,0,7
32052,maṇḍapa,mandapa,3,2,1,0,7
32053,sannipātaṭṭhānaṃ,sannipatatthanam,15,15,0,0,16
32054,janālayo,janalayo,3,2,1,0,8
32055,āsanatthāya,asanatthaya,2,2,0,0,11
32056,āsanasālā,asanasala,8,5,3,0,9
32057,paṭikkamanti,patikkamanti,81,81,0,0,12
32058,paṭikkamanaṃ,patikkamanam,29,24,5,0,12
32059,padavikkhepe,padavikkhepe,14,11,3,0,12
32060,vāsabhūtaṃ,vasabhutam,2,2,0,0,10
32061,gandhakuṭi,gandhakuti,20,18,2,0,10
32062,dibbagandhehi,dibbagandhehi,7,7,0,0,13
32063,paribhāvitā,paribhavita,12,12,0,0,11
32064,kuṭi,kuti,117,110,7,0,4
32065,pākaṭṭhāne,pakatthane,1,1,0,0,10
32066,rasāni,rasani,7,7,0,0,6
32067,rasavatī,rasavati,4,3,1,0,8
32068,pacanaṃ,pacanam,25,22,3,0,7
32069,pākaṭṭhānaṃ,pakatthanam,1,0,1,0,11
32070,bahūni,bahuni,526,508,18,0,6
32071,asitabbāni,asitabbani,1,1,0,0,10
32072,santettha,santettha,29,28,1,0,9
32073,mahānasaṃ,mahanasam,12,11,1,0,9
32074,suvaṇṇakārādisippīnaṃ,suvannakaradisippinam,1,1,0,0,21
32075,kammasālā,kammasala,2,2,0,0,9
32076,āvesanaṃ,avesanam,15,13,2,0,8
32077,āvisantyasmiṃ,avisantyasmim,1,1,0,0,13
32078,pānamandiraṃ,panamandiram,2,1,1,0,12
32079,surāpānatthaṃ,surapanattham,1,1,0,0,13
32080,katamandiraṃ,katamandiram,1,1,0,0,12
32081,soṇḍā,sonda,30,25,5,0,5
32082,kattabbākattabbaṃ,kattabbakattabbam,16,16,0,0,17
32083,icchitavatthukāraṇā,icchitavatthukarana,1,1,0,0,19
32084,sanontīti,sanontiti,1,1,0,0,9
32085,tanādi,tanadi,12,3,9,0,6
32086,assottaṃ,assottam,3,3,0,0,8
32087,pāna,pana,5,3,2,0,4
32088,saddasannidhānā,saddasannidhana,1,1,0,0,15
32089,surāsoṇḍāyevidha,surasondayevidha,1,1,0,0,16
32090,vaccassa,vaccassa,3,3,0,0,8
32091,gūthassa,guthassa,14,14,0,0,8
32092,visajjanaṭṭhānaṃ,visajjanatthanam,1,1,0,0,16
32093,vaccaṭṭhānaṃ,vaccatthanam,13,11,2,0,12
32094,visajjanaṭṭhānā,visajjanatthana,1,1,0,0,15
32095,vaccakuṭi,vaccakuti,54,52,2,0,9
32096,assamo,assamo,116,107,9,0,6
32097,kodhaṃ,kodham,225,205,20,0,6
32098,paṇyavikkayasālāyaṃ,panyavikkayasalayam,1,1,0,0,19
32099,byavahāre,byavahare,14,12,2,0,9
32100,paṇitabbāti,panitabbati,1,1,0,0,11
32101,paṇyā,panya,1,1,0,0,5
32102,vatthādayo,vatthadayo,1,1,0,0,10
32103,vikkiṇantīti,vikkinantiti,4,3,1,0,12
32104,paṇyavikkayo,panyavikkayo,1,1,0,0,12
32105,kī,ki,26,17,9,0,2
32106,dabbavinimaye,dabbavinimaye,6,5,1,0,13
32107,gehanti,gehanti,13,13,0,0,7
32108,paṇyavikkayasālā,panyavikkayasala,2,1,1,0,16
32109,āpaṇayante,apanayante,1,1,0,0,10
32110,byavaharante,byavaharante,1,1,0,0,12
32111,āpaṇo,apano,9,8,1,0,5
32112,paṇyānaṃ,panyanam,1,1,0,0,8
32113,vikkayāya,vikkayaya,1,1,0,0,9
32114,nīyamānānaṃ,niyamananam,4,4,0,0,11
32115,paṇyavīthikā,panyavithika,2,1,1,0,12
32116,acchādane,acchadane,17,14,3,0,9
32117,vasitaṃ,vasitam,15,13,2,0,7
32118,acchādanaṃ,acchadanam,30,26,4,0,10
32119,katamanenāti,katamanenati,1,1,0,0,12
32120,udosito,udosito,15,12,3,0,7
32121,vassottaṃ,vassottam,2,2,0,0,9
32122,bhaṇḍaṭṭhapanassa,bhandatthapanassa,1,1,0,0,17
32123,bhaṇḍasālā,bhandasala,7,6,1,0,10
32124,caṅkamatyatrāti,cankamatyatrati,1,1,0,0,15
32125,caṅkamanaṃ,cankamanam,27,26,1,0,10
32126,caṅkamo,cankamo,41,39,2,0,7
32127,jalanti,jalanti,28,24,4,0,7
32128,jantā,janta,7,5,2,0,5
32129,janetyatra,janetyatra,1,1,0,0,10
32130,agginti,agginti,2,2,0,0,7
32131,jantāgharaṃ,jantagharam,72,71,1,0,11
32132,aggisālā,aggisala,35,34,1,0,8
32133,pivane,pivane,9,9,0,0,6
32134,papivantyassanti,papivantyassanti,1,1,0,0,16
32135,papā,papa,30,27,3,0,4
32136,pānīyaṭṭhā,paniyattha,1,1,0,0,10
32137,pānīyasālā,paniyasala,3,3,0,0,10
32138,pānīyasālikā,paniyasalika,2,1,1,0,12
32139,ovarako,ovarako,16,12,4,0,7
32140,assottañca,assottanca,3,3,0,0,10
32141,vasanaṃ,vasanam,32,28,4,0,7
32142,tadatthaṃ,tadattham,252,249,3,0,9
32143,vāsāgāraṃ,vasagaram,21,18,3,0,9
32144,sayati,sayati,137,133,4,0,6
32145,sayanī,sayani,3,2,1,0,6
32146,sayaniggahaṃ,sayaniggaham,2,1,1,0,12
32147,rājitthāgāre,rajitthagare,1,1,0,0,12
32148,tadatthiyato,tadatthiyato,1,1,0,0,12
32149,tadaṭṭhiyato,tadatthiyato,1,1,0,0,12
32150,upacārena,upacarena,104,101,3,0,9
32151,rājitthīsupi,rajitthisupi,1,1,0,0,12
32152,rājitthīnamagāraṃ,rajitthinamagaram,1,1,0,0,17
32153,itthāgāraṃ,itthagaram,26,23,3,0,10
32154,avarundhīyante,avarundhiyante,1,1,0,0,14
32155,rājitthiyo,rajitthiyo,6,6,0,0,10
32156,orodho,orodho,23,21,2,0,6
32157,suddhā,suddha,107,102,5,0,6
32158,kāmāpagamattā,kamapagamatta,1,1,0,0,13
32159,parisuddhā,parisuddha,240,236,4,0,10
32160,rakkhakā,rakkhaka,7,7,0,0,8
32161,suddhanto,suddhanto,11,8,3,0,9
32162,antepuraṃ,antepuram,111,106,5,0,9
32163,purassa,purassa,29,25,4,0,7
32164,anteti,anteti,22,9,13,0,6
32165,antopuraṃ,antopuram,3,3,0,0,9
32166,raññaṃ,rannam,114,99,15,0,6
32167,asabbavisayaṭṭhānaṃ,asabbavisayatthanam,2,1,1,0,19
32168,sabbehyasādhāraṇaṭṭhānaṃ,sabbehyasadharanatthanam,1,1,0,0,24
32169,kacchantaraṃ,kacchantaram,3,1,2,0,12
32170,pamadavanaṃ,pamadavanam,4,3,1,0,11
32171,upakārikāsannihitaṃ,upakarikasannihitam,2,2,0,0,19
32172,purasannihitaṃ,purasannihitam,2,2,0,0,14
32173,antepurocitaṃ,antepurocitam,1,1,0,0,13
32174,antepurasahito,antepurasahito,2,2,0,0,14
32175,viharati,viharati,6081,6020,61,0,8
32176,nāññajanappaveso,nannajanappaveso,2,2,0,0,16
32177,pamadānaṃ,pamadanam,3,3,0,0,9
32178,kārānaṃ,karanam,52,48,4,0,7
32179,īkāra,ikara,3,3,0,0,5
32180,ākārānanti,akarananti,1,1,0,0,10
32181,itthigatānaṃ,itthigatanam,1,1,0,0,12
32182,kvacītirasso,kvacitirasso,1,1,0,0,12
32183,kacchassa,kacchassa,2,2,0,0,9
32184,pakoṭṭhassa,pakotthassa,1,1,0,0,11
32185,pakoṭṭhaṃ,pakottham,1,1,0,0,9
32186,abbhantaradvāraṃ,abbhantaradvaram,1,1,0,0,16
32187,ārohane,arohane,4,3,1,0,7
32188,upānena,upanena,1,1,0,0,7
32189,vattateti,vattateti,13,13,0,0,9
32190,sopāno,sopano,2,1,1,0,6
32191,sopānaṃ,sopanam,34,33,1,0,7
32192,ārūyhate,aruyhate,1,1,0,0,8
32193,ārohanaṃ,arohanam,8,7,1,0,8
32194,kaṭṭhādiracitāyaṃ,katthadiracitayam,1,1,0,0,17
32195,sayanti,sayanti,149,148,1,0,7
32196,pākārādikametāyāti,pakaradikametayati,1,1,0,0,18
32197,nisseṇī,nisseni,10,8,2,0,7
32198,uddhamārohate,uddhamarohate,1,1,0,0,13
32199,adhirohiṇī,adhirohini,1,0,1,0,10
32200,joteti,joteti,80,79,1,0,6
32201,jālake,jalake,4,4,0,0,6
32202,pivatīti,pivatiti,56,53,3,0,8
32203,gavakkho,gavakkho,2,1,1,0,8
32204,samāsantattā,samasantatta,1,1,0,0,12
32205,saññāsaddato,sannasaddato,1,1,0,0,12
32206,gavakkhīti,gavakkhiti,1,1,0,0,10
32207,sīharūpayuttaṃ,siharupayuttam,2,2,0,0,14
32208,pañjaraṃ,panjaram,21,18,3,0,8
32209,sīhapañjaraṃ,sihapanjaram,49,47,2,0,12
32210,ālokānaṃ,alokanam,5,5,0,0,8
32211,ātapānaṃ,atapanam,1,1,0,0,8
32212,pavisanaṭṭhānaṃ,pavisanatthanam,5,5,0,0,15
32213,chiddanti,chiddanti,2,2,0,0,9
32214,ālokasandhi,alokasandhi,7,2,5,0,11
32215,ālokīyanti,alokiyanti,1,1,0,0,10
32216,sandhīti,sandhiti,27,10,17,0,8
32217,laṅgiyaṃ,langiyam,1,1,0,0,8
32218,lagi,lagi,3,1,2,0,4
32219,gamanāgamanavasena,gamanagamanavasena,5,5,0,0,18
32220,paligho,paligho,19,17,2,0,7
32221,kapirūpamatthakattā,kapirupamatthakatta,1,1,0,0,19
32222,kapisīso,kapisiso,2,1,1,0,8
32223,aggaḷaṃ,aggalam,61,45,16,0,7
32224,kavāṭako,kavatako,1,1,0,0,8
32225,kavāṭaphalavidhāraṇo,kavataphalavidharano,1,1,0,0,20
32226,aggaḷatthambho,aggalatthambho,2,1,1,0,14
32227,kallole,kallole,1,1,0,0,7
32228,daṇḍe,dande,53,53,0,0,5
32229,cāntakavāṭesū,cantakavatesu,1,1,0,0,13
32230,aggaḷā,aggala,2,1,1,0,6
32231,vassodakamanenāti,vassodakamanenati,1,1,0,0,17
32232,nibbaṃ,nibbam,2,0,2,0,6
32233,abba,abba,2,0,2,0,4
32234,gatihiṃsāsu,gatihimsasu,2,2,0,0,11
32235,chaddassa,chaddassa,1,1,0,0,9
32236,chadanassa,chadanassa,20,20,0,0,10
32237,heṭṭhimāvasānaṃ,hetthimavasanam,1,1,0,0,15
32238,chaddakoṭi,chaddakoti,1,0,1,0,10
32239,gehacchadane,gehacchadane,1,1,0,0,12
32240,chadanaṃ,chadanam,131,122,9,0,8
32241,paṭyādīhyalaṃ,patyadihyalam,1,1,0,0,13
32242,chaddaṃ,chaddam,1,0,1,0,7
32243,gehaṅgaṇe,gehangane,8,8,0,0,9
32244,ajiraṃ,ajiram,2,1,1,0,6
32245,karaṇādhikaraṇesu,karanadhikaranesu,1,1,0,0,17
32246,gehadvārato,gehadvarato,2,2,0,0,11
32247,bahipakoṭṭhake,bahipakotthake,1,1,0,0,14
32248,vīthiyaṃ,vithiyam,50,49,1,0,8
32249,dvārapiṇḍake,dvarapindake,1,1,0,0,12
32250,alindo,alindo,3,3,0,0,6
32251,tvaññapiṇḍakepicchate,tvannapindakepicchate,1,1,0,0,21
32252,hananti,hananti,118,114,4,0,7
32253,paghāṇo,paghano,2,1,1,0,7
32254,paghaṇo,paghano,1,0,1,0,7
32255,ghaṇā,ghana,1,0,1,0,5
32256,ali,ali,5,5,0,0,3
32257,gehekadese,gehekadese,1,1,0,0,10
32258,paghaṇobhave,paghanobhave,1,1,0,0,12
32259,amaramālāyaṃ,amaramalayam,4,0,4,0,12
32260,ālindo,alindo,1,0,1,0,6
32261,gehassa,gehassa,56,56,0,0,7
32262,mukhesu,mukhesu,12,11,1,0,7
32263,sādhujanāpi,sadhujanapi,1,1,0,0,11
32264,āgantukāpi,agantukapi,5,5,0,0,10
32265,dvāraṃ,dvaram,772,708,64,0,6
32266,pidahati,pidahati,45,44,1,0,8
32267,dvārabandhanaṃ,dvarabandhanam,4,2,2,0,14
32268,dvārabāhāyaṃ,dvarabahayam,1,1,0,0,12
32269,pīṭhāni,pithani,6,6,0,0,7
32270,lohavikatiādīhi,lohavikatiadihi,1,1,0,0,15
32271,saṅghaṭīyanti,sanghatiyanti,1,1,0,0,13
32272,pīṭhasaṅghāṭakaṃ,pithasanghatakam,2,0,2,0,16
32273,pīṭhehi,pithehi,1,1,0,0,7
32274,saṅghaṭīyatīti,sanghatiyatiti,1,1,0,0,14
32275,ghaṭa,ghata,24,10,14,0,5
32276,ghaṭane,ghatane,24,22,2,0,7
32277,dvibhāgena,dvibhagena,1,1,0,0,10
32278,bāhāsadisattā,bahasadisatta,1,1,0,0,13
32279,bāhā,baha,161,154,7,0,4
32280,dvārabāhā,dvarabaha,5,4,1,0,9
32281,kapāṭaṃ,kapatam,1,1,0,0,7
32282,dvārabāhāya,dvarabahaya,5,5,0,0,11
32283,pāṭayati,patayati,4,4,0,0,8
32284,vāṭayati,vatayati,1,1,0,0,8
32285,kapāṭī,kapati,1,0,1,0,6
32286,gehādīnaṃ,gehadinam,9,9,0,0,9
32287,kaṇṇīkā,kannika,1,0,1,0,7
32288,dvāre,dvare,346,330,16,0,5
32289,arantyatrāti,arantyatrati,1,1,0,0,12
32290,dujjane,dujjane,6,5,1,0,7
32291,vārayantyasmā,varayantyasma,1,1,0,0,13
32292,rakkhakāti,rakkhakati,2,2,0,0,10
32293,paṭiharanti,patiharanti,5,5,0,0,11
32294,apanenti,apanenti,20,20,0,0,8
32295,aññātanti,annatanti,3,3,0,0,9
32296,paṭiharo,patiharo,2,2,0,0,8
32297,paṭihāro,patiharo,8,3,5,0,8
32298,ummāre,ummare,36,35,1,0,6
32299,dvārapiṇḍikā,dvarapindika,1,1,0,0,12
32300,ura,ura,5,3,2,0,3
32301,pavesenāti,pavesenati,3,3,0,0,10
32302,dehanī,dehani,2,1,1,0,6
32303,dehalī,dehali,2,1,1,0,6
32304,iṃ,im,40,25,15,0,2
32305,kaṇṭakoti,kantakoti,13,8,5,0,9
32306,vegagabhighātanato,vegagabhighatanato,1,1,0,0,18
32307,thambha,thambha,5,3,2,0,7
32308,paṭibandhane,patibandhane,2,2,0,0,12
32309,dharaṇe,dharane,2,1,1,0,7
32310,rambha,rambha,3,1,2,0,6
32311,thūṇo,thuno,5,4,1,0,5
32312,ralopo,ralopo,6,6,0,0,6
32313,assū,assu,35,34,1,0,4
32314,aḍḍhendupāsāṇe,addhendupasane,1,0,1,0,14
32315,addhacandākāre,addhacandakare,1,1,0,0,14
32316,pāsāṇe,pasane,103,102,1,0,6
32317,paṭikā,patika,10,6,4,0,6
32318,itthikatākārapare,itthikatakarapare,2,2,0,0,17
32319,gaji,gaji,1,0,1,0,4
32320,valabhīti,valabhiti,1,0,1,0,9
32321,sikhāyaṃ,sikhayam,3,3,0,0,8
32322,valabhī,valabhi,1,1,0,0,7
32323,cūḷe,cule,1,1,0,0,4
32324,rassantā,rassanta,1,1,0,0,8
32325,vaḷabhiyaṃ,valabhiyam,1,1,0,0,10
32326,cūḷeti,culeti,1,1,0,0,6
32327,tacchādane,tacchadane,1,1,0,0,10
32328,dārumhi,darumhi,14,13,1,0,7
32329,kaṭṭhe,katthe,10,10,0,0,6
32330,gopānasī,gopanasi,14,11,3,0,8
32331,vaṅketi,vanketi,2,0,2,0,7
32332,dāruvisesanaṃ,daruvisesanam,1,1,0,0,13
32333,vassodakaṃ,vassodakam,17,17,0,0,10
32334,sūriyādikiraṇañca,suriyadikirananca,1,1,0,0,17
32335,vināsayanti,vinasayanti,7,7,0,0,11
32336,abbhantaramappavesanavasenāti,abbhantaramappavesanavasenati,1,1,0,0,29
32337,gopānā,gopana,1,1,0,0,6
32338,iṭṭhakādayo,itthakadayo,6,6,0,0,11
32339,sinonti,sinonti,2,2,0,0,7
32340,bandhanti,bandhanti,117,117,0,0,9
32341,sodhādigehesu,sodhadigehesu,1,1,0,0,13
32342,chekapakkhāvāsatthaṃ,chekapakkhavasattham,1,1,0,0,20
32343,kaṭṭhekadeso,katthekadeso,1,1,0,0,12
32344,ṭhapīyate,thapiyate,3,3,0,0,9
32345,viṭaṅko,vitanko,3,1,2,0,7
32346,kapote,kapote,2,2,0,0,6
32347,pālayatīti,palayatiti,4,4,0,0,10
32348,kapotapālikā,kapotapalika,1,0,1,0,12
32349,ṭaki,taki,1,0,1,0,4
32350,nivāsagatīsu,nivasagatisu,3,3,0,0,12
32351,ṭaṅkanti,tankanti,1,1,0,0,8
32352,kuñcikāchidde,kuncikachidde,1,1,0,0,13
32353,kuñcikāya,kuncikaya,23,21,2,0,9
32354,vivaraṃ,vivaram,103,96,7,0,7
32355,kuñcikāvivaraṃ,kuncikavivaram,2,1,1,0,14
32356,tāḷassa,talassa,1,1,0,0,7
32357,pavesanaṭṭhānabhūto,pavesanatthanabhuto,1,1,0,0,19
32358,chiggaḷo,chiggalo,1,1,0,0,8
32359,tāḷacchiggaḷo,talacchiggalo,1,0,1,0,13
32360,kuñcikāyaṃ,kuncikayam,2,1,1,0,10
32361,kuñca,kunca,3,0,3,0,5
32362,tālo,talo,33,30,3,0,4
32363,tala,tala,8,2,6,0,4
32364,avāpurati,avapurati,3,3,0,0,9
32365,avāpuraṇaṃ,avapuranam,25,16,9,0,10
32366,uttaṃ,uttam,49,46,3,0,5
32367,upasaggassa,upasaggassa,28,28,0,0,11
32368,apārutā,aparuta,25,24,1,0,7
32369,dvārā,dvara,66,63,3,0,5
32370,saṃvaraṇetipi,samvaranetipi,2,2,0,0,13
32371,dhātvatthaṃ,dhatvattham,11,11,0,0,11
32372,paṭhanti,pathanti,394,394,0,0,8
32373,dhātvatthe,dhatvatthe,23,22,1,0,10
32374,saṅghāṭiṃ,sanghatim,276,258,18,0,9
32375,pārupitvā,parupitva,377,374,3,0,9
32376,kāravaṇṇāgamena,karavannagamena,1,1,0,0,15
32377,vedikā,vedika,24,23,1,0,6
32378,itarattha,itarattha,33,32,1,0,9
32379,yeva,yeva,505,498,7,0,4
32380,saṅghāṭā,sanghata,3,1,2,0,8
32381,mandiraṅgā,mandiranga,2,1,1,0,10
32382,gehaṅgavisesā,gehangavisesa,1,1,0,0,13
32383,gopānasyādayoti,gopanasyadayoti,2,2,0,0,15
32384,saṅghāṭo,sanghato,6,2,4,0,8
32385,pubbapacchimadakkhiṇuttarāyāmavasena,pubbapacchimadakkhinuttarayamavasena,1,1,0,0,36
32386,thambhānamupari,thambhanamupari,3,3,0,0,15
32387,kaṭṭhaviseso,katthaviseso,4,4,0,0,12
32388,pubbapacchimayāmā,pubbapacchimayama,1,1,0,0,17
32389,kaṭṭhā,kattha,22,18,4,0,6
32390,dakkhiṇuttarayāmā,dakkhinuttarayama,1,1,0,0,17
32391,heṭṭhimaparicchedato,hetthimaparicchedato,7,7,0,0,20
32392,ukkaṭṭhaparicchedena,ukkatthaparicchedena,45,45,0,0,20
32393,pañcasattanavādayopi,pancasattanavadayopi,1,1,0,0,20
32394,pakkhānaṃ,pakkhanam,19,19,0,0,9
32395,apatanatthaṃ,apatanattham,5,5,0,0,12
32396,bandhanato,bandhanato,28,28,0,0,10
32397,pāso,paso,63,59,4,0,4
32398,pakkhapāso,pakkhapaso,3,0,3,0,10
32399,tulati,tulati,1,1,0,0,6
32400,saṅghāṭesu,sanghatesu,1,1,0,0,10
32401,samavāhitabhāvakaraṇato,samavahitabhavakaranato,1,1,0,0,23
32402,tulayati,tulayati,5,5,0,0,8
32403,sammajjaniyaṃ,sammajjaniyam,1,1,0,0,13
32404,muji,muji,2,0,2,0,4
32405,sudha,sudha,7,2,5,0,5
32406,saṅkārachaḍḍanappadese,sankarachaddanappadese,1,1,0,0,22
32407,chaḍḍanamaddanesu,chaddanamaddanesu,1,1,0,0,17
32408,saṅkaṭanti,sankatanti,1,1,0,0,10
32409,saṅkaṭīraṃ,sankatiram,4,1,3,0,10
32410,saṅkaṭo,sankato,1,1,0,0,7
32411,saṅkāro,sankaro,7,6,1,0,7
32412,īrayanti,irayanti,1,1,0,0,8
32413,saṅkārassa,sankarassa,1,1,0,0,10
32414,saṅkāraṭṭhānaṃ,sankaratthanam,7,5,2,0,14
32415,saṅkāraṃ,sankaram,40,33,7,0,8
32416,kaṭati,katati,5,5,0,0,6
32417,chaḍḍeti,chaddeti,119,116,3,0,8
32418,saṅkārakūṭaṃ,sankarakutam,3,2,1,0,12
32419,sammajjaniyā,sammajjaniya,8,8,0,0,12
32420,nirākate,nirakate,1,1,0,0,8
32421,nirassate,nirassate,2,2,0,0,9
32422,thusādimhi,thusadimhi,1,1,0,0,10
32423,nānāvidhe,nanavidhe,17,17,0,0,9
32424,saṅkāre,sankare,5,5,0,0,7
32425,rāsīkaraṇavasena,rasikaranavasena,2,2,0,0,16
32426,kacati,kacati,6,6,0,0,6
32427,kaco,kaco,3,2,1,0,4
32428,kacavaro,kacavaro,6,5,1,0,8
32429,ucchiṭṭho,ucchittho,7,7,0,0,9
32430,kalāpo,kalapo,26,19,7,0,6
32431,uklāpo,uklapo,54,51,3,0,6
32432,ssākāralopo,ssakaralopo,1,1,0,0,11
32433,tiṇādīhi,tinadihi,16,16,0,0,8
32434,saṅkarīyate,sankariyate,1,1,0,0,11
32435,missīkarīyateti,missikariyateti,1,1,0,0,15
32436,avakarotipyatra,avakarotipyatra,1,1,0,0,15
32437,avakarīyate,avakariyate,1,1,0,0,11
32438,nirassateti,nirassateti,1,1,0,0,11
32439,sammajjo,sammajjo,1,1,0,0,8
32440,majjanī,majjani,1,1,0,0,7
32441,vakaro,vakaro,1,1,0,0,6
32442,halāyudho,halayudho,2,2,0,0,9
32443,ambu,ambu,11,10,1,0,4
32444,gharādibhūmi,gharadibhumi,2,1,1,0,12
32445,gharakhettavihārādīnaṃ,gharakhettaviharadinam,1,1,0,0,22
32446,ratthu,ratthu,10,6,4,0,6
32447,madane,madane,4,3,1,0,6
32448,gasanti,gasanti,7,7,0,0,7
32449,saṃvasantyatrāti,samvasantyatrati,1,1,0,0,16
32450,saṃvasatho,samvasatho,3,2,1,0,10
32451,nigamo,nigamo,139,125,14,0,6
32452,bhusattho,bhusattho,8,7,1,0,9
32453,saññāsaddattā,sannasaddatta,10,10,0,0,13
32454,upabhuñjitabbabhogamanussādīhi,upabhunjitabbabhogamanussadihi,1,1,0,0,30
32455,ibhyo,ibhyo,1,1,0,0,5
32456,vaḍḍhito,vaddhito,46,43,3,0,8
32457,nigamatopi,nigamatopi,1,1,0,0,10
32458,adhikatarattā,adhikataratta,2,2,0,0,13
32459,adhibhū,adhibhu,9,7,2,0,7
32460,gāmādipariyantabhāge,gamadipariyantabhage,1,1,0,0,20
32461,paricchinditvā,paricchinditva,357,350,7,0,14
32462,ādīyateti,adiyateti,1,1,0,0,9
32463,mariyādā,mariyada,53,51,2,0,8
32464,ābhīrakuṭiyaṃ,abhirakutiyam,1,1,0,0,13
32465,ābhīrapallī,abhirapalli,1,1,0,0,11
32466,ghu,ghu,4,0,4,0,3
32467,ghosantyatrāti,ghosantyatrati,1,1,0,0,14
32468,gopālānaṃ,gopalanam,2,2,0,0,9
32469,gopālagāmako,gopalagamako,1,0,1,0,12
32470,naravaggavaṇṇanā,naravaggavannana,2,2,0,0,16
32471,para227-228,para227-228,1,1,0,0,11
32472,porisa,porisa,2,0,2,0,6
32473,ntāni,ntani,8,8,0,0,5
32474,manussajātiyā,manussajatiya,6,6,0,0,13
32475,ussannamassāti,ussannamassati,1,1,0,0,14
32476,satisūrabhāvabrahmacariyayogyatādiguṇavasena,satisurabhavabrahmacariyayogyatadigunavasena,6,6,0,0,44
32477,upacitamānasā,upacitamanasa,3,3,0,0,13
32478,ukkaṭṭhaguṇacittā,ukkatthagunacitta,3,3,0,0,17
32479,jambudīpavāsino,jambudipavasino,26,25,1,0,15
32480,sattavisesā,sattavisesa,11,11,0,0,11
32481,ṭhānehi,thanehi,361,357,4,0,7
32482,jambudīpakā,jambudipaka,18,18,0,0,11
32483,uttarakuruke,uttarakuruke,16,16,0,0,12
32484,adhiggaṇhanti,adhigganhanti,18,18,0,0,13
32485,katamehi,katamehi,893,889,4,0,8
32486,sūrā,sura,144,133,11,0,4
32487,brahmacariyavāso,brahmacariyavaso,127,122,5,0,16
32488,paccekabuddhā,paccekabuddha,280,264,16,0,13
32489,aggasāvakamahāsāvakacakkavattino,aggasavakamahasavakacakkavattino,1,1,0,0,32
32490,mahānubhāvā,mahanubhava,76,74,2,0,11
32491,samānarūpāditāya,samanarupaditaya,8,8,0,0,16
32492,parittadīpavāsīhi,parittadipavasihi,15,15,0,0,17
32493,itaramahādīpavāsinopi,itaramahadipavasinopi,8,8,0,0,21
32494,manussātveva,manussatveva,3,3,0,0,12
32495,paññāyiṃsūti,pannayimsuti,4,3,1,0,12
32496,bhaṇanti,bhananti,228,227,1,0,8
32497,lobhādīhi,lobhadihi,34,33,1,0,9
32498,alobhādīhi,alobhadihi,29,27,2,0,10
32499,sahitassa,sahitassa,24,24,0,0,9
32500,manassa,manassa,129,129,0,0,7
32501,ussadatāya,ussadataya,4,4,0,0,10
32502,manussajātikā,manussajatika,12,11,1,0,13
32503,lobhādayo,lobhadayo,52,51,1,0,9
32504,alobhādayo,alobhadayo,46,45,1,0,10
32505,ussadā,ussada,27,21,6,0,6
32506,apāyamaggaṃ,apayamaggam,14,12,2,0,11
32507,sugatimaggaṃ,sugatimaggam,8,8,0,0,12
32508,nibbānagāmimaggañca,nibbanagamimagganca,5,5,0,0,19
32509,pūrenti,purenti,78,73,5,0,7
32510,catumahādīpavāsino,catumahadipavasino,4,4,0,0,18
32511,manussāti,manussati,46,28,18,0,9
32512,lokiyā,lokiya,308,291,17,0,6
32513,manuno,manuno,25,25,0,0,6
32514,apaccabhāvena,apaccabhavena,6,6,0,0,13
32515,paṭhamakappiko,pathamakappiko,7,7,0,0,14
32516,lokamariyādāya,lokamariyadaya,5,5,0,0,14
32517,ādibhūto,adibhuto,15,15,0,0,8
32518,hitāhitavidhāyako,hitahitavidhayako,5,5,0,0,17
32519,pituṭṭhāniyo,pitutthaniyo,6,6,0,0,12
32520,mahāsammato,mahasammato,31,28,3,0,11
32521,paccakkhato,paccakkhato,335,328,7,0,11
32522,paramparatāya,paramparataya,1,1,0,0,13
32523,ovādānusāsaniyaṃ,ovadanusasaniyam,6,6,0,0,16
32524,puttasadisatāya,puttasadisataya,5,5,0,0,15
32525,mānavā,manava,20,20,0,0,6
32526,voharīyanti,vohariyanti,25,25,0,0,11
32527,mānuso,manuso,23,22,1,0,6
32528,mara,mara,25,8,17,0,4
32529,pāṇacāge,panacage,16,13,3,0,8
32530,macco,macco,133,125,8,0,5
32531,tyapaccayo,tyapaccayo,1,1,0,0,10
32532,yavata,yavata,4,3,1,0,6
32533,miccādinā,miccadina,77,77,0,0,9
32534,mānavo,manavo,30,25,5,0,6
32535,pyatra,pyatra,1,1,0,0,6
32536,ṇavo,navo,4,3,1,0,4
32537,manumhā,manumha,1,1,0,0,7
32538,manujo,manujo,43,39,4,0,6
32539,pusa,pusa,25,6,19,0,4
32540,posane,posane,13,9,4,0,6
32541,puretīti,puretiti,2,2,0,0,8
32542,poso,poso,241,229,12,0,4
32543,ussottaṃ,ussottam,3,3,0,0,8
32544,poriso,poriso,11,9,2,0,6
32545,dīghatāya,dighataya,5,5,0,0,9
32546,pūriso,puriso,1,0,1,0,6
32547,itthiyampi,itthiyampi,2,2,0,0,10
32548,vattate,vattate,567,559,8,0,7
32549,pumeyeva,pumeyeva,1,1,0,0,8
32550,visiṭṭhaliṅgattā,visitthalingatta,1,1,0,0,16
32551,mānusa,manusa,2,2,0,0,6
32552,māṇavehi,manavehi,15,15,0,0,8
32553,ttā,tta,7,5,2,0,3
32554,manusī,manusi,1,1,0,0,6
32555,mānusī,manusi,26,26,0,0,6
32556,manujī,manuji,1,1,0,0,6
32557,māṇavī,manavi,3,3,0,0,6
32558,viddasu,viddasu,6,5,1,0,7
32559,paṇḍite,pandite,127,121,6,0,7
32560,paṇḍā,panda,18,14,4,0,5
32561,taratyādi,taratyadi,1,1,0,0,9
32562,avasānametassāti,avasanametassati,1,1,0,0,16
32563,kinnāma,kinnama,9,9,0,0,7
32564,kavi,kavi,22,20,2,0,4
32565,kavī,kavi,10,10,0,0,4
32566,byañjayatīti,byanjayatiti,10,10,0,0,12
32567,bhujādīnamanto,bhujadinamanto,8,6,2,0,14
32568,dvi,dvi,48,27,21,0,3
32569,cakkha,cakkha,9,5,4,0,6
32570,vicāretīti,vicaretiti,10,5,5,0,10
32571,sārado,sarado,29,24,5,0,6
32572,dhāraṇā,dharana,7,7,0,0,7
32573,atisayamatiyuttatāya,atisayamatiyuttataya,1,1,0,0,20
32574,vidūo,viduo,1,1,0,0,5
32575,dhīyogā,dhiyoga,1,1,0,0,7
32576,visiṭṭhadassanasīlatāya,visitthadassanasilataya,1,1,0,0,23
32577,abbo,abbo,1,1,0,0,4
32578,sūci,suci,60,55,5,0,4
32579,dabbo,dabbo,96,87,9,0,5
32580,dasu,dasu,1,1,0,0,4
32581,para230-231,para230-231,4,4,0,0,11
32582,mahilā,mahila,10,5,5,0,6
32583,itthisāmaññe,itthisamanne,2,2,0,0,12
32584,sīmassa,simassa,2,2,0,0,7
32585,sīmanto,simanto,4,2,2,0,7
32586,kesaveso,kesaveso,2,2,0,0,8
32587,sīmantinī,simantini,4,3,1,0,9
32588,narassāyaṃ,narassayam,1,1,0,0,10
32589,idamatthe,idamatthe,13,10,3,0,9
32590,bandha,bandha,18,7,11,0,6
32591,vadhā,vadha,22,14,8,0,5
32592,suṇisābhariyānampi,sunisabhariyanampi,1,1,0,0,18
32593,visiṭṭhanāriyampi,visitthanariyampi,1,1,0,0,17
32594,kalyāṇaṅganārīlakkhaṇopetaṃ,kalyananganarilakkhanopetam,1,1,0,0,27
32595,pasatthaṃ,pasattham,75,69,6,0,9
32596,hatthapādādikamaṅgamassatthīti,hatthapadadikamangamassatthiti,1,1,0,0,30
32597,aṅgā,anga,50,39,11,0,4
32598,virūpesupi,virupesupi,1,1,0,0,10
32599,rāgamado,ragamado,1,1,0,0,8
32600,pamadā,pamada,26,22,4,0,6
32601,visiṭṭhanāriyaṃpyatra,visitthanariyampyatra,1,1,0,0,21
32602,rūpasobhaggajanito,rupasobhaggajanito,1,1,0,0,18
32603,cetovikāro,cetovikaro,1,1,0,0,10
32604,rūpalāvaṇyasampannatāya,rupalavanyasampannataya,1,1,0,0,23
32605,sundarī,sundari,50,44,6,0,7
32606,visiṭṭhāyampi,visitthayampi,3,3,0,0,13
32607,kamanīyavuttitāya,kamaniyavuttitaya,1,1,0,0,17
32608,kantā,kanta,233,218,15,0,5
32609,kantiyogā,kantiyoga,1,1,0,0,9
32610,ramayati,ramayati,2,2,0,0,8
32611,vinodayati,vinodayati,2,2,0,0,10
32612,ramaṇī,ramani,4,3,1,0,6
32613,nandādīhi,nandadihi,7,5,2,0,9
32614,abalā,abala,53,37,16,0,5
32615,appatthoyaṃ,appatthoyam,1,1,0,0,11
32616,mātugāmo,matugamo,411,393,18,0,8
32617,gasatīti,gasatiti,2,2,0,0,8
32618,gāyatīti,gayatiti,6,6,0,0,8
32619,suciṃ,sucim,115,101,14,0,5
32620,mahantesu,mahantesu,27,27,0,0,9
32621,bahūsupi,bahusupi,30,29,1,0,8
32622,rattacittesu,rattacittesu,1,1,0,0,12
32623,mahelāpyatra,mahelapyatra,1,1,0,0,12
32624,visiṭṭhanāriyameva,visitthanariyameva,1,1,0,0,18
32625,icchāyanti,icchayanti,4,4,0,0,10
32626,gaṇato,ganato,43,41,2,0,6
32627,bhayapakati,bhayapakati,1,1,0,0,11
32628,bhīru,bhiru,31,24,7,0,5
32629,atte,atte,6,6,0,0,4
32630,tthiyaṃ,tthiyam,30,30,0,0,7
32631,atisayitakāmā,atisayitakama,1,1,0,0,13
32632,kāminī,kamini,5,4,1,0,6
32633,siṅgārarūpo,singararupo,1,1,0,0,11
32634,yassātthīti,yassatthiti,3,3,0,0,11
32635,vāmalocanā,vamalocana,1,1,0,0,10
32636,bhāvinī,bhavini,1,1,0,0,7
32637,nitambinī,nitambini,1,1,0,0,9
32638,rāmāiccādīnipi,ramaiccadinipi,1,1,0,0,14
32639,visiṭṭhanārīnāmāni,visitthanarinamani,1,1,0,0,18
32640,paṭhamavayasi,pathamavayasi,1,1,0,0,13
32641,vattamānāyaṃ,vattamanayam,3,3,0,0,12
32642,aṭṭhavassā,atthavassa,2,2,0,0,10
32643,gorī,gori,4,3,1,0,4
32644,dasavassā,dasavassa,5,5,0,0,9
32645,kaññakā,kannaka,2,2,0,0,7
32646,dvādase,dvadase,8,8,0,0,7
32647,kumārītya,kumaritya,1,1,0,0,9
32648,bhidhīyate,bhidhiyate,4,4,0,0,10
32649,tvabhedopacārenekattaṃ,tvabhedopacarenekattam,1,1,0,0,22
32650,panāhu,panahu,112,110,2,0,6
32651,pumunābhisambandhapubbake,pumunabhisambandhapubbake,1,1,0,0,25
32652,sampayoge,sampayoge,7,7,0,0,9
32653,nivattetī,nivatteti,5,4,1,0,9
32654,kumārayatīti,kumarayatiti,1,1,0,0,12
32655,kumārī,kumari,47,44,3,0,6
32656,ṇvunā,nvuna,1,1,0,0,5
32657,kamanīyateti,kamaniyateti,1,1,0,0,12
32658,dittikantigatīsu,dittikantigatisu,2,2,0,0,16
32659,nyassa,nyassa,2,2,0,0,6
32660,ñattaṃ,nattam,14,10,4,0,6
32661,yuva,yuva,25,13,12,0,4
32662,pāṭipadikatoti,patipadikatoti,1,1,0,0,14
32663,varitthipariyāyasāmaññepi,varitthipariyayasamannepi,1,1,0,0,25
32664,pakatyantaramatthīti,pakatyantaramatthiti,1,1,0,0,20
32665,sābhisekā,sabhiseka,2,1,1,0,9
32666,laddhābhisekā,laddhabhiseka,2,2,0,0,13
32667,rājitthī,rajitthi,1,1,0,0,8
32668,mahatiyo,mahatiyo,13,13,0,0,8
32669,īsa,isa,9,1,8,0,3
32670,mahesito,mahesito,1,1,0,0,8
32671,rājanāriyo,rajanariyo,2,2,0,0,10
32672,bhoginiyo,bhoginiyo,1,0,1,0,9
32673,bhogayogā,bhogayoga,1,1,0,0,9
32674,yānārī,yanari,3,3,0,0,6
32675,saṅketaṃ,sanketam,87,75,12,0,8
32676,dhavatthinī,dhavatthini,3,2,1,0,11
32677,abhisārikā,abhisarika,4,4,0,0,10
32678,coccate,coccate,15,15,0,0,7
32679,dhavaṃ,dhavam,2,2,0,0,6
32680,patiṃ,patim,89,85,4,0,5
32681,atthayati,atthayati,2,2,0,0,9
32682,yācanicchāsu,yacanicchasu,1,1,0,0,12
32683,asatīviseso,asativiseso,1,1,0,0,11
32684,abhisarati,abhisarati,1,1,0,0,10
32685,saṅketanti,sanketanti,1,1,0,0,10
32686,vesiyaṃ,vesiyam,1,1,0,0,7
32687,catusaṭṭhikalākusalatāya,catusatthikalakusalataya,1,1,0,0,24
32688,sīlarūpādimattāya,silarupadimattaya,1,1,0,0,17
32689,gaṇyate,ganyate,1,1,0,0,7
32690,ādīyate,adiyate,3,3,0,0,7
32691,gaṇikā,ganika,89,87,2,0,6
32692,veso,veso,15,11,4,0,4
32693,ākappo,akappo,15,9,6,0,6
32694,tenātisobhate,tenatisobhate,1,1,0,0,13
32695,kammavesehi,kammavesehi,1,1,0,0,11
32696,icchīyateti,icchiyateti,3,3,0,0,11
32697,atisobhane,atisobhane,1,1,0,0,10
32698,icchatthe,icchatthe,7,6,1,0,9
32699,vaṇṇasampannā,vannasampanna,14,14,0,0,13
32700,dāsī,dasi,196,187,9,0,4
32701,vaṇṇadāsī,vannadasi,10,9,1,0,9
32702,dāsimpi,dasimpi,4,4,0,0,7
32703,vaṇṇasampannaṃ,vannasampannam,16,16,0,0,14
32704,sāmikā,samika,116,112,4,0,6
32705,dhanalobhena,dhanalobhena,23,21,2,0,12
32706,gaṇikaṃ,ganikam,28,26,2,0,7
32707,sobhetīti,sobhetiti,2,2,0,0,9
32708,nagarasobhinī,nagarasobhini,11,10,1,0,13
32709,rūpena,rupena,337,318,19,0,6
32710,upajīvatīti,upajivatiti,4,2,2,0,11
32711,rūpūpajīvinī,rupupajivini,6,5,1,0,12
32712,atisayavesayuttatāya,atisayavesayuttataya,1,1,0,0,20
32713,vesī,vesi,15,14,1,0,4
32714,asatīsāmaññe,asatisamanne,1,1,0,0,12
32715,aṭati,atati,5,5,0,0,5
32716,kulaṭā,kulata,2,1,1,0,6
32717,bandhamanubandhaṃ,bandhamanubandham,1,1,0,0,17
32718,bandhakī,bandhaki,3,2,1,0,8
32719,uttamanāriyaṃ,uttamanariyam,1,1,0,0,13
32720,āroho,aroho,10,9,1,0,5
32721,soṇi,soni,4,4,0,0,4
32722,varārohā,vararoha,11,10,1,0,8
32723,uttamaguṇayogā,uttamagunayoga,1,1,0,0,14
32724,soṇigāravena,sonigaravena,1,1,0,0,12
32725,mattagajo,mattagajo,1,1,0,0,9
32726,bandhanagāminī,bandhanagamini,1,1,0,0,14
32727,mattakāsinī,mattakasini,1,0,1,0,11
32728,varavaṇṇayogā,varavannayoga,1,1,0,0,13
32729,varavaṇṇinī,varavannini,4,3,1,0,11
32730,sīte,site,37,34,3,0,4
32731,sukhoṇhasabbaṅgī,sukhonhasabbangi,1,1,0,0,16
32732,sukhasītalā,sukhasitala,1,1,0,0,11
32733,bhattā,bhatta,118,113,5,0,6
32734,akhaṇḍitacaritrāyaṃ,akhanditacaritrayam,1,1,0,0,19
32735,sāmikova,samikova,4,4,0,0,8
32736,patibbatā,patibbata,29,26,3,0,9
32737,patimhi,patimhi,24,21,3,0,7
32738,vatamassāti,vatamassati,1,1,0,0,11
32739,ādilopo,adilopo,6,5,1,0,7
32740,satī,sati,158,125,33,0,4
32741,kāmarattarājaputtādino,kamarattarajaputtadino,1,1,0,0,22
32742,kulassa,kulassa,140,137,3,0,7
32743,niyatapatiyaṃ,niyatapatiyam,1,1,0,0,13
32744,kulānurūpā,kulanurupa,2,2,0,0,10
32745,itthī,itthi,1120,1077,43,0,5
32746,kulitthī,kulitthi,2,1,1,0,8
32747,pāleti,paleti,111,107,4,0,6
32748,kulapālikā,kulapalika,2,1,1,0,10
32749,matabhattikāyaṃ,matabhattikayam,1,1,0,0,15
32750,dhavo,dhavo,19,17,2,0,5
32751,vidhavā,vidhava,44,37,7,0,7
32752,patisuññā,patisunna,3,2,1,0,9
32753,atticchāya,atticchaya,1,1,0,0,10
32754,patyanvesiniyaṃ,patyanvesiniyam,1,1,0,0,15
32755,kaññāyaṃ,kannayam,17,16,1,0,8
32756,patimbarā,patimbara,2,1,1,0,9
32757,dutiyāyālopo,dutiyayalopo,2,2,0,0,12
32758,varatīti,varatiti,1,1,0,0,8
32759,sayambarā,sayambara,2,1,1,0,9
32760,paṭhamāyālopo,pathamayalopo,1,1,0,0,13
32761,patthanāyaṃ,patthanayam,9,9,0,0,11
32762,vijātāyaṃ,vijatayam,1,1,0,0,9
32763,vijanī,vijani,1,0,1,0,6
32764,gabbhavimokkhane,gabbhavimokkhane,1,1,0,0,16
32765,vijāyitthāti,vijayitthati,1,1,0,0,12
32766,vijātā,vijata,45,44,1,0,6
32767,sū,su,27,16,11,0,2
32768,abhisave,abhisave,9,8,1,0,8
32769,etissāti,etissati,200,195,5,0,8
32770,jātāpaccā,jatapacca,2,1,1,0,9
32771,pasūtāva,pasutava,1,1,0,0,8
32772,pasūtikā,pasutika,2,1,1,0,8
32773,dūtiyaṃ,dutiyam,1,1,0,0,7
32774,pesīyate,pesiyate,2,2,0,0,8
32775,dūtī,duti,3,2,1,0,4
32776,sañcārayati,sancarayati,1,1,0,0,11
32777,yathābhimatanti,yathabhimatanti,1,1,0,0,15
32778,dāsiyaṃ,dasiyam,17,16,1,0,7
32779,dīyante,diyante,3,3,0,0,7
32780,ciṭa,cita,4,0,4,0,4
32781,pesane,pesane,23,19,4,0,6
32782,kuṭaṃ,kutam,40,37,3,0,5
32783,udakakumbhaṃ,udakakumbham,2,2,0,0,12
32784,kuṭadhārikā,kutadharika,2,1,1,0,11
32785,subhāsubhanirūpiniyaṃ,subhasubhanirupiniyam,1,1,0,0,21
32786,saṃvarikādimhi,samvarikadimhi,1,1,0,0,14
32787,subhāsubhassa,subhasubhassa,1,1,0,0,13
32788,ikkhaṇaṃ,ikkhanam,2,2,0,0,8
32789,nirūpanaṃ,nirupanam,4,4,0,0,9
32790,khattiyajāti,khattiyajati,3,3,0,0,12
32791,khattiyānī,khattiyani,15,14,1,0,10
32792,khattiyā,khattiya,381,368,13,0,8
32793,khattiyassāpaccaṃ,khattiyassapaccam,2,2,0,0,17
32794,āno,ano,15,10,5,0,3
32795,aggisakkhipubbakatapāṇigahitāyaṃ,aggisakkhipubbakatapanigahitayam,1,1,0,0,32
32796,bhariyāyaṃ,bhariyayam,13,12,1,0,10
32797,jāyā,jaya,69,63,6,0,4
32798,jani,jani,2,1,1,0,4
32799,jissa,jissa,3,3,0,0,5
32800,atto,atto,14,12,2,0,4
32801,gharaṇī,gharani,32,27,5,0,7
32802,bharitabbato,bharitabbato,1,1,0,0,12
32803,bhara,bhara,23,9,14,0,5
32804,bharaṇe,bharane,14,11,3,0,7
32805,piyāyitabbato,piyayitabbato,10,10,0,0,13
32806,pī,pi,6126,6103,23,0,2
32807,rassattañca,rassattanca,23,23,0,0,11
32808,paṭhamo,pathamo,1040,990,50,0,7
32809,paricaratīti,paricaratiti,7,4,3,0,12
32810,pādaparicārikā,padaparicarika,41,40,1,0,14
32811,patinī,patini,1,1,0,0,6
32812,pāṇigahitā,panigahita,1,1,0,0,10
32813,sahadhamminītipi,sahadhamminitipi,1,1,0,0,16
32814,sakhiyaṃ,sakhiyam,1,1,0,0,8
32815,kiccesu,kiccesu,79,78,1,0,7
32816,sakhī,sakhi,31,26,5,0,5
32817,khā,kha,31,20,11,0,3
32818,pakāsanakathanesu,pakasanakathanesu,1,1,0,0,17
32819,vayasā,vayasa,61,60,1,0,6
32820,tulye,tulye,7,7,0,0,5
32821,jarovuccati,jarovuccati,1,1,0,0,11
32822,corassāmiko,corassamiko,1,1,0,0,11
32823,jārī,jari,8,6,2,0,4
32824,sāmikaṃ,samikam,247,244,3,0,7
32825,tūti,tuti,15,4,11,0,4
32826,liṅganto,linganto,1,1,0,0,8
32827,bhajate,bhajate,14,12,2,0,7
32828,ara,ara,28,6,22,0,3
32829,ssuttaṃ,ssuttam,1,1,0,0,7
32830,ratiyā,ratiya,85,79,6,0,6
32831,tilopo,tilopo,3,3,0,0,6
32832,puppha,puppha,16,12,4,0,6
32833,rajassalāyaṃ,rajassalayam,1,1,0,0,12
32834,utuyogā,utuyoga,1,1,0,0,7
32835,utunī,utuni,32,27,5,0,5
32836,rajayogā,rajayoga,1,1,0,0,8
32837,rajassalā,rajassala,4,3,1,0,9
32838,salo,salo,2,2,0,0,4
32839,pupphavantatāya,pupphavantataya,1,1,0,0,15
32840,pupphavatī,pupphavati,9,6,3,0,10
32841,thīdhamminī,thidhammini,1,1,0,0,11
32842,avī,avi,3,1,2,0,3
32843,atteyī,atteyi,1,1,0,0,6
32844,malinī,malini,2,2,0,0,6
32845,udakīiccādīnipi,udakiiccadinipi,1,1,0,0,15
32846,gabbhiniyaṃ,gabbhiniyam,1,1,0,0,11
32847,alahuko,alahuko,1,1,0,0,7
32848,kucchi,kucchi,45,39,6,0,6
32849,garugabbhā,garugabbha,15,13,2,0,10
32850,āpanno,apanno,706,693,13,0,6
32851,gabbhaṭṭho,gabbhattho,1,1,0,0,10
32852,āpannasattā,apannasatta,8,5,3,0,11
32853,gabbhayogā,gabbhayoga,1,1,0,0,10
32854,gabbhinī,gabbhini,54,51,3,0,8
32855,veṭhito,vethito,5,5,0,0,7
32856,tatrāsayeti,tatrasayeti,1,1,0,0,11
32857,āsayate,asayate,1,1,0,0,7
32858,tiṭṭhatyatrāti,titthatyatrati,1,1,0,0,14
32859,jaraṃ,jaram,188,168,20,0,5
32860,jalābu,jalabu,2,1,1,0,6
32861,jarāpubbo,jarapubbo,1,1,0,0,9
32862,jarataṃ,jaratam,1,1,0,0,7
32863,kalalo,kalalo,1,0,1,0,6
32864,para240-241,para240-241,2,2,0,0,11
32865,bhattari,bhattari,8,8,0,0,8
32866,dhū,dhu,21,3,18,0,3
32867,santāsaṃ,santasam,91,78,13,0,8
32868,dhunotīti,dhunotiti,1,1,0,0,9
32869,sāmiko,samiko,343,335,8,0,6
32870,āmi,ami,4,3,1,0,3
32871,niggahītassa,niggahitassa,65,64,1,0,12
32872,pakkamādīhi,pakkamadihi,7,5,2,0,11
32873,ntattaṃ,ntattam,1,1,0,0,7
32874,ratikāraṇattā,ratikaranatta,1,1,0,0,13
32875,patino,patino,54,50,4,0,6
32876,upapati,upapati,3,1,2,0,7
32877,appadhānabhūto,appadhanabhuto,2,2,0,0,14
32878,jīyante,jiyante,1,1,0,0,7
32879,jāro,jaro,23,21,2,0,4
32880,narake,narake,55,53,2,0,6
32881,patantyanena,patantyanena,1,1,0,0,12
32882,jātenāti,jatenati,2,1,1,0,8
32883,tya,tya,78,62,16,0,3
32884,vicchindati,vicchindati,9,9,0,0,11
32885,dhītari,dhitari,9,9,0,0,7
32886,niccanapuṃsakoyaṃ,niccanapumsakoyam,1,1,0,0,17
32887,tenāti,tenati,534,94,440,0,6
32888,chadādīhi,chadadihi,7,6,1,0,9
32889,tatraṇa,tatrana,8,4,4,0,7
32890,attato,attato,544,503,41,0,6
32891,atrajo,atrajo,90,86,4,0,6
32892,attajo,attajo,9,8,1,0,6
32893,suyateti,suyateti,1,1,0,0,8
32894,suṇātīti,sunatiti,72,53,19,0,8
32895,tanumhā,tanumha,1,1,0,0,7
32896,tanujo,tanujo,8,7,1,0,6
32897,tanayo,tanayo,14,12,2,0,6
32898,mudanti,mudanti,4,4,0,0,7
32899,sūyateti,suyateti,3,3,0,0,8
32900,sūnu,sunu,8,6,2,0,4
32901,pasave,pasave,17,14,3,0,6
32902,nāriyameva,nariyameva,1,1,0,0,10
32903,rātu,ratu,8,4,4,0,4
32904,ottābhāvo,ottabhavo,13,13,0,0,9
32905,āssī,assi,2,2,0,0,4
32906,puttādayo,puttadayo,14,14,0,0,9
32907,sāmaññeneva,samanneneva,8,8,0,0,11
32908,kuṇḍagolakādīnaṃ,kundagolakadinam,1,1,0,0,16
32909,savaṇṇāyaṃ,savannayam,1,1,0,0,10
32910,ūḍhāyaṃ,udhayam,1,1,0,0,7
32911,sajāto,sajato,3,3,0,0,6
32912,oraso,oraso,110,100,10,0,5
32913,sajāta,sajata,1,0,1,0,6
32914,kuṇḍakagolakakhattādibyavacchedo,kundakagolakakhattadibyavacchedo,1,1,0,0,32
32915,jārajo,jarajo,3,3,0,0,6
32916,kuṇḍā,kunda,2,1,1,0,5
32917,golakā,golaka,1,0,1,0,6
32918,ariyāsuddajo,ariyasuddajo,1,1,0,0,12
32919,khattā,khatta,26,19,7,0,6
32920,ariyāsuddānaṃ,ariyasuddanam,1,1,0,0,13
32921,māgadhādīnaṃ,magadhadinam,1,1,0,0,12
32922,kuṇḍo,kundo,6,5,1,0,5
32923,golako,golako,1,1,0,0,6
32924,māgadho,magadho,219,210,9,0,7
32925,suddakhattājo,suddakhattajo,2,2,0,0,13
32926,abhidhānu,abhidhanu,1,1,0,0,9
32927,urasā,urasa,24,23,1,0,5
32928,tatiyantā,tatiyanta,13,13,0,0,9
32929,nimmitatthe,nimmitatthe,1,1,0,0,11
32930,niviṭṭhattā,nivitthatta,3,3,0,0,11
32931,nimmitoti,nimmitoti,6,3,3,0,9
32932,urasi,urasi,40,36,4,0,5
32933,bhavoti,bhavoti,178,122,56,0,7
32934,catukkaṃpatipatinīnaṃ,catukkampatipatininam,1,1,0,0,21
32935,dārā,dara,51,50,1,0,4
32936,kalatre,kalatre,1,1,0,0,7
32937,amaramālā,amaramala,3,1,2,0,9
32938,jaṃ,jam,21,15,6,0,3
32939,tvabyayo,tvabyayo,1,1,0,0,8
32940,dāravacano,daravacano,1,1,0,0,10
32941,jampati,jampati,2,2,0,0,7
32942,dampatī,dampati,6,6,0,0,7
32943,bhavitabbaṃ,bhavitabbam,1137,1091,46,0,11
32944,kaccāyanamatenodāhaṭā,kaccayanamatenodahata,1,1,0,0,21
32945,jāyāpati,jayapati,2,1,1,0,8
32946,itarītarayogadvando,itaritarayogadvando,3,3,0,0,19
32947,jānipati,janipati,4,3,1,0,8
32948,jāyampati,jayampati,1,0,1,0,9
32949,jāni,jani,55,50,5,0,4
32950,tudañca,tudanca,1,1,0,0,7
32951,jāyañca,jayanca,2,2,0,0,7
32952,rāgassavo,ragassavo,3,3,0,0,9
32953,vassavaro,vassavaro,2,1,1,0,9
32954,liṅgavekalye,lingavekalye,1,1,0,0,12
32955,itthipumānaṃ,itthipumanam,1,0,1,0,12
32956,puṃsaka,pumsaka,1,0,1,0,7
32957,tatiyāpakati,tatiyapakati,1,1,0,0,12
32958,saṇḍo,sando,6,6,0,0,5
32959,kalībantipi,kalibantipi,1,1,0,0,11
32960,tatiyā,tatiya,412,389,23,0,6
32961,tatiyappakāro,tatiyappakaro,1,1,0,0,13
32962,samajātike,samajatike,1,1,0,0,10
32963,itthipurise,itthipurise,4,3,1,0,11
32964,apekkhitvā,apekkhitva,220,217,3,0,10
32965,tatiyattaṃ,tatiyattam,7,7,0,0,10
32966,pakārassa,pakarassa,29,28,1,0,9
32967,paṭhamā,pathama,412,374,38,0,7
32968,itarapakati,itarapakati,1,1,0,0,11
32969,ñātimatte,natimatte,1,1,0,0,9
32970,bandhuyeva,bandhuyeva,1,1,0,0,10
32971,bandhavo,bandhavo,12,10,2,0,8
32972,sajano,sajano,12,11,1,0,6
32973,gottaṃ,gottam,195,167,28,0,6
32974,sagotto,sagotto,4,3,1,0,7
32975,samāna,samana,29,14,15,0,6
32976,kammeti,kammeti,11,8,3,0,7
32977,ñātiyeva,natiyeva,11,10,1,0,8
32978,sva,sva,8,8,0,0,3
32979,sattapurisāvadhikesu,sattapurisavadhikesu,1,1,0,0,20
32980,nikaṭañātīsu,nikatanatisu,1,1,0,0,12
32981,lohitena,lohitena,64,62,2,0,8
32982,sālohito,salohito,11,9,2,0,8
32983,sambandha,sambandha,10,9,1,0,9
32984,piṇḍadānaṃ,pindadanam,4,4,0,0,10
32985,sapiṇḍo,sapindo,2,1,1,0,7
32986,sanābhayopyatra,sanabhayopyatra,1,1,0,0,15
32987,sattapurisāvadhikakule,sattapurisavadhikakule,1,1,0,0,22
32988,pitari,pitari,116,113,3,0,6
32989,janayatīti,janayatiti,10,10,0,0,10
32990,pātīti,patiti,8,6,2,0,6
32991,janetti,janetti,35,33,2,0,7
32992,janikā,janika,108,97,11,0,6
32993,appadhānabhūtā,appadhanabhuta,4,4,0,0,14
32994,upamātā,upamata,2,1,1,0,7
32995,kumāre,kumare,146,143,3,0,6
32996,jāyāya,jayaya,21,17,4,0,6
32997,bhātiko,bhatiko,19,18,1,0,7
32998,kaniṭṭho,kanittho,167,165,2,0,8
32999,bhātari,bhatari,28,27,1,0,7
33000,sāla,sala,10,3,7,0,4
33001,sāmino,samino,116,104,12,0,6
33002,nanandā,nananda,3,1,2,0,7
33003,nandatīti,nandatiti,25,17,8,0,9
33004,vibhāsādhikārā,vibhasadhikara,1,1,0,0,14
33005,nanda,nanda,88,76,12,0,5
33006,ayyikāyaṃ,ayyikayam,1,1,0,0,9
33007,mātāmahī,matamahi,9,7,2,0,8
33008,āmahaṃ,amaham,1,1,0,0,6
33009,ayyikā,ayyika,35,34,1,0,6
33010,mātulo,matulo,58,52,6,0,6
33011,ula,ula,4,0,4,0,3
33012,mātulassa,matulassa,35,35,0,0,9
33013,mātulānī,matulani,17,13,4,0,8
33014,mātulabhariyāyaṃ,matulabhariyayam,1,1,0,0,16
33015,gatihiṃsāpānesu,gatihimsapanesu,1,1,0,0,15
33016,bhāgineyyo,bhagineyyo,85,82,3,0,10
33017,sutassa,sutassa,96,87,9,0,7
33018,sutāya,sutaya,8,8,0,0,6
33019,puttesu,puttesu,90,81,9,0,7
33020,paputto,paputto,4,3,1,0,7
33021,tta,tta,24,15,9,0,3
33022,ussattañca,ussattanca,3,3,0,0,10
33023,sāmibhātā,samibhata,3,3,0,0,9
33024,devaro,devaro,7,6,1,0,6
33025,evoccate,evoccate,1,1,0,0,8
33026,divu,divu,16,2,14,0,4
33027,dhītupatimhi,dhitupatimhi,1,1,0,0,12
33028,assāttaṃ,assattam,1,1,0,0,8
33029,pitupitari,pitupitari,2,2,0,0,10
33030,husā,husa,4,2,2,0,4
33031,mātucchā,matuccha,29,25,4,0,8
33032,ccho,ccho,30,20,10,0,4
33033,pitucchā,pituccha,20,14,6,0,8
33034,pitubhaginī,pitubhagini,8,8,0,0,11
33035,bhavetyattho,bhavetyattho,2,2,0,0,12
33036,pitāmaha,pitamaha,5,3,2,0,8
33037,janakapitarameva,janakapitarameva,1,1,0,0,16
33038,janakapitupitādayopīti,janakapitupitadayopiti,1,1,0,0,22
33039,iccudāhaṭo,iccudahato,1,1,0,0,10
33040,ayyako,ayyako,35,35,0,0,6
33041,payyako,payyako,4,3,1,0,7
33042,ṇisa,nisa,1,0,1,0,4
33043,suṇisā,sunisa,81,79,2,0,6
33044,āpaccayo,apaccayo,20,18,2,0,8
33045,ekodare,ekodare,1,1,0,0,7
33046,samānodare,samanodare,5,5,0,0,10
33047,sodariyo,sodariyo,10,9,1,0,8
33048,sagabbho,sagabbho,8,7,1,0,8
33049,sodaro,sodaro,2,1,1,0,6
33050,sahajo,sahajo,9,7,2,0,6
33051,tulyavacano,tulyavacano,1,1,0,0,11
33052,mātāpitū,matapitu,8,8,0,0,8
33053,ubhinnampi,ubhinnampi,290,277,13,0,10
33054,janakabyappadesaniyatattā,janakabyappadesaniyatatta,1,1,0,0,25
33055,abhedavacanicchāyaṃ,abhedavacanicchayam,1,1,0,0,19
33056,pituttamattheva,pituttamattheva,1,1,0,0,15
33057,nanvabhedā,nanvabheda,1,1,0,0,10
33058,cobhayatra,cobhayatra,1,1,0,0,10
33059,sattādekattaṃ,sattadekattam,1,1,0,0,13
33060,liṅgasaṅkhyā,lingasankhya,3,3,0,0,12
33061,adabbattā,adabbatta,1,1,0,0,9
33062,siyāti,siyati,1168,997,171,0,6
33063,nesa,nesa,35,29,6,0,4
33064,jātipadatthikassa,jatipadatthikassa,2,2,0,0,17
33065,dabbapadatthikassa,dabbapadatthikassa,2,2,0,0,18
33066,kintubhayesaṃpyubhayapadattho,kintubhayesampyubhayapadattho,1,1,0,0,29
33067,ihātthaviseso,ihatthaviseso,1,1,0,0,13
33068,padhānabhūtā,padhanabhuta,36,31,5,0,12
33069,guṇabhūtaṃ,gunabhutam,4,4,0,0,10
33070,vipariyayo,vipariyayo,13,10,3,0,10
33071,jātivacanicchāyaṃ,jativacanicchayam,1,1,0,0,17
33072,viyābhedavacanicchāyaṃ,viyabhedavacanicchayam,1,1,0,0,22
33073,jaññattañhi,jannattanhi,1,1,0,0,11
33074,puttabyapadesaniyataṃ,puttabyapadesaniyatam,1,1,0,0,21
33075,dhītaripyatthi,dhitaripyatthi,1,1,0,0,14
33076,vipariyaye,vipariyaye,2,2,0,0,10
33077,bhavatyanabhidhānato,bhavatyanabhidhanato,1,1,0,0,20
33078,bhedavacanicchāyaṃ,bhedavacanicchayam,2,2,0,0,18
33079,puttadhītaroti,puttadhitaroti,1,1,0,0,14
33080,sasurāti,sasurati,1,1,0,0,8
33081,tadapaccohanasambandhinibandhanā,tadapaccohanasambandhinibandhana,1,1,0,0,32
33082,sassuyampi,sassuyampi,1,1,0,0,10
33083,paccatthaṃ,paccattham,2,2,0,0,10
33084,saddaniveso,saddaniveso,3,3,0,0,11
33085,bhātaro,bhataro,176,172,4,0,7
33086,ekagabbhositattaṃ,ekagabbhositattam,1,1,0,0,17
33087,bhātubyappadesaniyataṃ,bhatubyappadesaniyatam,1,1,0,0,22
33088,bhaginiyaṃpyatthi,bhaginiyampyatthi,1,1,0,0,17
33089,ekagabbhositattassābhedavacanicchāyaṃ,ekagabbhositattassabhedavacanicchayam,1,1,0,0,37
33090,virūpekaseso,virupekaseso,2,2,0,0,12
33091,sarūpāsarūpavasena,sarupasarupavasena,1,1,0,0,18
33092,sarūpekasese,sarupekasese,1,1,0,0,12
33093,bahuvacanameva,bahuvacanameva,15,15,0,0,14
33094,itaratra,itaratra,17,17,0,0,8
33095,dvivacanaṃ,dvivacanam,22,21,1,0,10
33096,nāmarūpañca,namarupanca,53,50,3,0,11
33097,nāmarūpaṃ,namarupam,667,610,57,0,9
33098,pitaroti,pitaroti,5,1,4,0,8
33099,bālyayobbanavuḍḍhattāni,balyayobbanavuddhattani,2,2,0,0,23
33100,vayāni,vayani,2,2,0,0,6
33101,bālye,balye,3,1,2,0,5
33102,yobbane,yobbane,33,31,2,0,7
33103,bālassa,balassa,239,224,15,0,7
33104,bālattaṃ,balattam,2,1,1,0,8
33105,bālatā,balata,3,2,1,0,6
33106,ṇyamhi,nyamhi,7,7,0,0,6
33107,bālyaṃ,balyam,37,29,8,0,6
33108,bala,bala,36,20,16,0,4
33109,paṇantīti,panantiti,1,1,0,0,9
33110,bālā,bala,432,404,28,0,4
33111,balyante,balyante,1,1,0,0,8
33112,saṃvarīyanteti,samvariyanteti,1,1,0,0,14
33113,bālattā,balatta,5,4,1,0,7
33114,yuvassa,yuvassa,15,15,0,0,7
33115,yobbaññaṃ,yobbannam,19,15,4,0,9
33116,yobbana,yobbana,3,2,1,0,7
33117,uvā,uva,10,0,10,0,3
33118,yobbaññā,yobbanna,2,1,1,0,8
33119,para251,para251,120,120,0,0,7
33120,jarākatā,jarakata,1,1,0,0,8
33121,kesādayo,kesadayo,45,43,2,0,8
33122,palitaṃ,palitam,65,59,6,0,7
33123,sukkattaṃ,sukkattam,1,1,0,0,9
33124,paca,paca,50,26,24,0,4
33125,pāke,pake,43,34,9,0,4
33126,valipalitādimati,valipalitadimati,1,1,0,0,16
33127,kāyaparipāke,kayaparipake,1,1,0,0,12
33128,jīyanti,jiyanti,48,48,0,0,7
33129,vuḍḍhā,vuddha,48,44,4,0,6
33130,vissasā,vissasa,2,0,2,0,7
33131,jarāya,jaraya,418,396,22,0,6
33132,saṃsate,samsate,1,1,0,0,7
33133,pātayatīti,patayatiti,2,2,0,0,10
33134,saṃsati,samsati,23,20,3,0,7
33135,rayaṃ,rayam,1,1,0,0,5
33136,pamādattho,pamadattho,1,1,0,0,10
33137,avasaṃsanattho,avasamsanattho,2,2,0,0,14
33138,tabbatināmānyāha,tabbatinamanyaha,1,1,0,0,16
33139,chāpasāmaññe,chapasamanne,1,1,0,0,12
33140,uko,uko,12,12,0,0,3
33141,pillako,pillako,2,1,1,0,7
33142,chupa,chupa,2,1,1,0,5
33143,samphasse,samphasse,5,4,1,0,9
33144,ussāttaṃ,ussattam,2,2,0,0,8
33145,chāpo,chapo,3,2,1,0,5
33146,potakī,potaki,1,0,1,0,6
33147,poto,poto,23,22,1,0,4
33148,sāvako,savako,428,412,16,0,6
33149,abbhako,abbhako,1,1,0,0,7
33150,ḍimbho,dimbho,1,1,0,0,6
33151,susuko,susuko,2,1,1,0,6
33152,susuiccādīnipi,susuiccadinipi,1,1,0,0,14
33153,chāpasāmaññatthāni,chapasamannatthani,1,1,0,0,18
33154,para252,para252,120,120,0,0,7
33155,bālasāmaññavācakāni,balasamannavacakani,1,1,0,0,19
33156,visesabālanāmāni,visesabalanamani,1,1,0,0,16
33157,athu,athu,3,2,1,0,4
33158,uttāno,uttano,95,87,8,0,6
33159,uttānaṃ,uttanam,47,43,4,0,7
33160,uttānasayo,uttanasayo,2,1,1,0,10
33161,uttānaseyyako,uttanaseyyako,23,21,2,0,13
33162,thanaṃ,thanam,22,21,1,0,6
33163,thanapo,thanapo,1,0,1,0,7
33164,ḍimbha,dimbha,1,0,1,0,6
33165,para253,para253,121,121,0,0,7
33166,taruṇe,tarune,8,7,1,0,6
33167,āsoḷasā,asolasa,1,1,0,0,7
33168,sattatyāyumhā,sattatyayumha,1,1,0,0,13
33169,lakkhaye,lakkhaye,14,14,0,0,8
33170,vayasi,vayasi,4,4,0,0,6
33171,vayaṭṭho,vayattho,2,1,1,0,8
33172,vayo,vayo,249,225,24,0,4
33173,bālyādi,balyadi,1,1,0,0,7
33174,pakkhī,pakkhi,168,150,18,0,6
33175,yobbanañca,yobbananca,1,1,0,0,10
33176,kvacī,kvaci,55,53,2,0,5
33177,ssākāro,ssakaro,2,2,0,0,7
33178,plutagatimhi,plutagatimhi,1,1,0,0,12
33179,susu,susu,42,33,9,0,4
33180,taruṇa,taruna,7,5,2,0,6
33181,susvā,susva,1,0,1,0,5
33182,māṇavakoti,manavakoti,3,1,2,0,10
33183,apacce,apacce,26,26,0,0,6
33184,mūḷhe,mulhe,10,9,1,0,5
33185,manutossaggiko,manutossaggiko,1,1,0,0,14
33186,mahābhāssa,mahabhassa,2,2,0,0,10
33187,sukhavaḍḍhite,sukhavaddhite,1,1,0,0,13
33188,sukumāro,sukumaro,5,4,1,0,8
33189,edhati,edhati,7,6,1,0,6
33190,vaddhatīti,vaddhatiti,1,1,0,0,10
33191,sukhedhito,sukhedhito,35,27,8,0,10
33192,sukhocito,sukhocito,2,1,1,0,9
33193,ucitaṃ,ucitam,4,4,0,0,6
33194,para254-255,para254-255,1,1,0,0,11
33195,dvipādena,dvipadena,1,1,0,0,9
33196,vuḍḍhassa,vuddhassa,29,26,3,0,9
33197,āyumahattaṃ,ayumahattam,1,1,0,0,11
33198,mahallako,mahallako,198,186,12,0,9
33199,vaḍḍha,vaddha,32,22,10,0,6
33200,ḍho,dho,11,8,3,0,3
33201,ḍḍha,ddha,1,0,1,0,4
33202,innā,inna,5,0,5,0,4
33203,jiṇṇo,jinno,102,97,5,0,5
33204,jiṇṇako,jinnako,3,2,1,0,7
33205,pakataṃ,pakatam,144,127,17,0,7
33206,yobbanamassāti,yobbanamassati,1,1,0,0,14
33207,pavayo,pavayo,1,0,1,0,6
33208,valina,valina,2,0,2,0,6
33209,jeṭṭhabhātari,jetthabhatari,3,3,0,0,13
33210,aggajo,aggajo,2,1,1,0,6
33211,pubbajo,pubbajo,12,9,3,0,7
33212,vuḍḍho,vuddho,91,84,7,0,6
33213,ayamimesaṃ,ayamimesam,11,11,0,0,10
33214,vuḍḍhoti,vuddhoti,16,10,6,0,8
33215,vuḍḍha,vuddha,11,3,8,0,6
33216,iṭṭha,ittha,16,6,10,0,5
33217,iyiṭṭhesū,iyitthesu,3,3,0,0,9
33218,parassāsavaṇṇattaṃ,parassasavannattam,1,1,0,0,18
33219,pacchājāte,pacchajate,170,167,3,0,10
33220,yuvā,yuva,161,145,16,0,4
33221,yuvāti,yuvati,25,8,17,0,6
33222,kaniyo,kaniyo,10,8,2,0,6
33223,kaṇiṭṭho,kanittho,15,15,0,0,8
33224,kaṇiyo,kaniyo,7,7,0,0,6
33225,iyiṭṭhe,iyitthe,1,0,1,0,7
33226,kanā,kana,5,4,1,0,4
33227,kaṇādeso,kanadeso,1,1,0,0,8
33228,pacchākāle,pacchakale,12,12,0,0,10
33229,anujo,anujo,8,7,1,0,5
33230,jaghaññe,jaghanne,1,1,0,0,8
33231,jaghaññajo,jaghannajo,2,0,2,0,10
33232,aparasmiṃ,aparasmim,59,54,5,0,9
33233,aparajoti,aparajoti,1,0,1,0,9
33234,dvepyatra,dvepyatra,1,1,0,0,9
33235,vali,vali,24,19,5,0,4
33236,valittaco,valittaco,5,3,2,0,9
33237,cammametassatthīti,cammametassatthiti,1,1,0,0,18
33238,valino,valino,3,2,1,0,6
33239,uttānasayā,uttanasaya,2,1,1,0,10
33240,uttānasayaṃ,uttanasayam,1,1,0,0,11
33241,para256,para256,118,118,0,0,7
33242,matthake,matthake,446,434,12,0,8
33243,aṅgesu,angesu,108,106,2,0,6
33244,uttamaṅgattā,uttamangatta,2,2,0,0,12
33245,uttamaṅgaṃ,uttamangam,46,39,7,0,10
33246,aṅgañcātipi,angancatipi,1,1,0,0,11
33247,sīsañca,sisanca,38,36,2,0,7
33248,uttamaṅgañca,uttamanganca,2,2,0,0,12
33249,sīsottamaṅgāni,sisottamangani,1,0,1,0,14
33250,tose,tose,4,4,0,0,4
33251,masa,masa,22,6,16,0,4
33252,keso,keso,8,7,1,0,4
33253,sattamiyālopo,sattamiyalopo,2,2,0,0,13
33254,vala,vala,19,5,14,0,4
33255,vālo,valo,13,11,2,0,4
33256,uttamaṅge,uttamange,21,21,0,0,9
33257,ruhatīti,ruhatiti,77,68,9,0,8
33258,uttamaṅgaruho,uttamangaruho,2,1,1,0,13
33259,muddhajo,muddhajo,5,4,1,0,8
33260,cikuro,cikuro,2,1,1,0,6
33261,kacotipyatra,kacotipyatra,1,1,0,0,12
33262,cayane,cayane,2,2,0,0,6
33263,kura,kura,12,4,8,0,4
33264,cikarīyateti,cikariyateti,1,1,0,0,12
33265,para257,para257,116,116,0,0,7
33266,kusumagabbhā,kusumagabbha,1,1,0,0,12
33267,kesacūḷā,kesacula,1,1,0,0,8
33268,muttikādinā,muttikadina,1,1,0,0,11
33269,saṃyatā,samyata,5,4,1,0,7
33270,santhatā,santhata,16,14,2,0,8
33271,dhammilo,dhammilo,3,1,2,0,8
33272,dharīyati,dhariyati,10,10,0,0,9
33273,bandhīyatīti,bandhiyatiti,7,7,0,0,12
33274,nānādesiyamanussānaṃ,nanadesiyamanussanam,1,1,0,0,20
33275,samācārena,samacarena,3,3,0,0,10
33276,ilatīti,ilatiti,2,2,0,0,7
33277,kumārānaṃ,kumaranam,25,25,0,0,9
33278,sikhāpañcake,sikhapancake,1,1,0,0,12
33279,cūḷattayeti,culattayeti,1,1,0,0,11
33280,kākānaṃ,kakanam,28,26,2,0,7
33281,pakkhasaṇṭhānattā,pakkhasanthanatta,1,1,0,0,17
33282,kākapakkho,kakapakkho,2,1,1,0,10
33283,sikhaṇḍako,sikhandako,2,1,1,0,10
33284,sikhāsikhaṇḍa,sikhasikhanda,1,0,1,0,13
33285,saddānamabhedattāyeva,saddanamabhedattayeva,1,1,0,0,21
33286,sikhaṇḍī,sikhandi,9,9,0,0,8
33287,moro,moro,58,54,4,0,4
33288,kesacaye,kesacaye,3,2,1,0,8
33289,kesapariyāyato,kesapariyayato,1,1,0,0,14
33290,kesānaṃ,kesanam,51,49,2,0,7
33291,kalāpe,kalape,40,40,0,0,6
33292,kevalā,kevala,95,93,2,0,6
33293,kesapāso,kesapaso,2,2,0,0,8
33294,kesahattho,kesahattho,3,3,0,0,10
33295,avayaveti,avayaveti,7,6,1,0,9
33296,pasa,pasa,14,3,11,0,4
33297,bandhaneti,bandhaneti,6,3,3,0,10
33298,nihananti,nihananti,1,1,0,0,9
33299,pakkhopyatra,pakkhopyatra,1,1,0,0,12
33300,tāpasānaṃ,tapasanam,42,41,1,0,9
33301,vatīnaṃ,vatinam,1,1,0,0,7
33302,jaṭa,jata,3,0,3,0,4
33303,jaṭane,jatane,1,1,0,0,6
33304,para258,para258,117,117,0,0,7
33305,positabhattādīhi,positabhattadihi,1,1,0,0,16
33306,banjhate,banjhate,1,1,0,0,8
33307,veṇī,veni,17,13,4,0,4
33308,paveṇī,paveni,59,53,6,0,6
33309,pajane,pajane,2,2,0,0,6
33310,pajanaṃ,pajanam,2,1,1,0,7
33311,gabbhavimokkho,gabbhavimokkho,1,1,0,0,14
33312,sīsamajjhaṭṭhacūḷāyaṃ,sisamajjhatthaculayam,1,1,0,0,21
33313,cūḷa,cula,8,5,3,0,4
33314,sañcodane,sancodane,4,3,1,0,9
33315,kesapāsīpyatra,kesapasipyatra,1,1,0,0,14
33316,nārīnaṃ,narinam,12,11,1,0,7
33317,kesamajjhamhi,kesamajjhamhi,2,2,0,0,13
33318,ujugatamaggo,ujugatamaggo,1,1,0,0,12
33319,sīmantoti,simantoti,1,1,0,0,9
33320,para259,para259,113,113,0,0,7
33321,lome,lome,18,18,0,0,4
33322,lū,lu,28,4,24,0,2
33323,lūyateti,luyateti,2,2,0,0,8
33324,tanumhi,tanumhi,1,1,0,0,7
33325,tanuruhaṃ,tanuruham,3,2,1,0,9
33326,rūha,ruha,1,0,1,0,4
33327,pātubhāve,patubhave,11,8,3,0,9
33328,lassa,lassa,27,27,0,0,5
33329,romaṃ,romam,3,2,1,0,5
33330,pakhumañcoccate,pakhumancoccate,1,1,0,0,15
33331,paminoti,paminoti,2,2,0,0,8
33332,pumamukhe,pumamukhe,2,1,1,0,9
33333,pavuṭṭhaṃ,pavuttham,5,5,0,0,9
33334,massu,massu,21,16,5,0,5
33335,mumhi,mumhi,1,1,0,0,5
33336,bhama,bhama,5,3,2,0,5
33337,anavaṭṭhāne,anavatthane,6,6,0,0,11
33338,umhi,umhi,3,3,0,0,4
33339,bhamuko,bhamuko,2,1,1,0,7
33340,bhamuka,bhamuka,1,0,1,0,7
33341,para260,para260,108,108,0,0,7
33342,nettodake,nettodake,1,1,0,0,9
33343,nette,nette,38,35,3,0,5
33344,nettajalaṃ,nettajalam,1,0,1,0,10
33345,nettajalañca,nettajalanca,1,1,0,0,12
33346,akkhiputtalikāyaṃ,akkhiputtalikayam,1,1,0,0,17
33347,dissamānā,dissamana,30,29,1,0,9
33348,nettatārā,nettatara,2,1,1,0,9
33349,taddhito,taddhito,6,6,0,0,8
33350,kanīnā,kanina,1,0,1,0,6
33351,kāramāpajjate,karamapajjate,8,8,0,0,13
33352,kanīnikā,kaninika,2,1,1,0,8
33353,tārakāpyatra,tarakapyatra,1,1,0,0,12
33354,mukhavivare,mukhavivare,2,2,0,0,11
33355,tadupalakkhitepi,tadupalakkhitepi,1,1,0,0,16
33356,samudāye,samudaye,47,45,2,0,8
33357,yujjante,yujjante,9,9,0,0,8
33358,vada,vada,143,101,42,0,4
33359,mukhanti,mukhanti,22,16,6,0,8
33360,nipātitaṃ,nipatitam,1,1,0,0,9
33361,khanu,khanu,18,0,18,0,5
33362,tuḍi,tudi,3,1,2,0,4
33363,toḍane,todane,2,2,0,0,6
33364,ānanti,ananti,3,3,0,0,6
33365,asanti,asanti,23,23,0,0,6
33366,assaṃpyatra,assampyatra,1,1,0,0,11
33367,para261,para261,115,115,0,0,7
33368,dvijo,dvijo,20,14,6,0,5
33369,dāyati,dayati,10,10,0,0,6
33370,bhakkhamanenāti,bhakkhamanenati,2,2,0,0,15
33371,dasanti,dasanti,1,1,0,0,7
33372,damu,damu,11,0,11,0,4
33373,daṃsa,damsa,13,0,13,0,5
33374,daṃsate,damsate,1,1,0,0,7
33375,vilikhyate,vilikhyate,1,1,0,0,10
33376,daṃsano,damsano,3,1,2,0,7
33377,rada,rada,5,1,4,0,4
33378,radano,radano,3,2,1,0,6
33379,rado,rado,3,2,1,0,4
33380,dantabhedasmiṃ,dantabhedasmim,1,0,1,0,14
33381,dantavisese,dantavisese,1,1,0,0,11
33382,itthiliṅgoyaṃ,itthilingoyam,3,3,0,0,13
33383,dhātuto,dhatuto,83,79,4,0,7
33384,daṃsi,damsi,1,0,1,0,5
33385,muddhajadutiyoyaṃ,muddhajadutiyoyam,4,4,0,0,17
33386,akkhikoṭīsu,akkhikotisu,1,0,1,0,11
33387,vāmadakkhiṇanettānaṃ,vamadakkhinanettanam,1,1,0,0,20
33388,antesu,antesu,49,46,3,0,6
33389,apāṅgo,apango,3,0,3,0,6
33390,sarīraṅgasaṅkhātassa,sarirangasankhatassa,1,1,0,0,20
33391,kaṇṇassa,kannassa,12,12,0,0,8
33392,para262,para262,121,121,0,0,7
33393,oṭṭhe,otthe,15,13,2,0,5
33394,dantāvaraṇaṃ,dantavaranam,15,12,3,0,12
33395,sādisantapucchabhanjahaṃsādīhi,sadisantapucchabhanjahamsadihi,2,2,0,0,30
33396,sahādibyañjanena,sahadibyanjanena,8,8,0,0,16
33397,ttadvittāni,ttadvittani,1,1,0,0,11
33398,oṭṭho,ottho,24,21,3,0,5
33399,gadrabhepyayaṃ,gadrabhepyayam,1,1,0,0,14
33400,ottadvittādi,ottadvittadi,1,1,0,0,12
33401,muddhajadutiyo,muddhajadutiyo,1,1,0,0,14
33402,bhakkhametthāti,bhakkhametthati,1,1,0,0,15
33403,adharo,adharo,12,7,5,0,6
33404,īsattho,isattho,1,1,0,0,7
33405,hyatra,hyatra,1,1,0,0,6
33406,mādhave,madhave,1,1,0,0,7
33407,paṭisedhe,patisedhe,34,34,0,0,9
33408,tadabyayaṃ,tadabyayam,2,2,0,0,10
33409,īsatthe,isatthe,3,3,0,0,7
33410,viruddhatthe,viruddhatthe,2,1,1,0,12
33411,sadisatthe,sadisatthe,11,11,0,0,10
33412,payogato,payogato,50,47,3,0,8
33413,dasane,dasane,1,1,0,0,6
33414,dasanacchado,dasanacchado,6,2,4,0,12
33415,adhara,adhara,8,4,4,0,6
33416,heṭṭhimoṭṭhamevāhu,hetthimotthamevahu,1,1,0,0,18
33417,nettantādharapāṇipādayugalehi,nettantadharapanipadayugalehi,1,1,0,0,29
33418,ccādīhi,ccadihi,2,2,0,0,7
33419,mahākavipayogehi,mahakavipayogehi,1,1,0,0,16
33420,asaṃsandanato,asamsandanato,5,5,0,0,13
33421,kapole,kapole,2,2,0,0,6
33422,gaḍi,gadi,8,2,6,0,4
33423,vadanekadese,vadanekadese,4,3,1,0,12
33424,dhātuppakriyatthañhi,dhatuppakriyatthanhi,1,1,0,0,20
33425,dhātupāṭhavacanaṃ,dhatupathavacanam,1,1,0,0,17
33426,sabbatrāpyevaṃ,sabbatrapyevam,1,1,0,0,14
33427,pūriyateti,puriyateti,1,1,0,0,10
33428,kapolo,kapolo,8,5,3,0,6
33429,kapa,kapa,7,3,4,0,4
33430,olo,olo,9,9,0,0,3
33431,gaṇḍī,gandi,4,3,1,0,5
33432,adharā,adhara,9,9,0,0,6
33433,adhobhāgo,adhobhago,6,6,0,0,9
33434,cubukaṃ,cubukam,2,0,2,0,7
33435,cibukaṃpyatra,cibukampyatra,1,1,0,0,13
33436,cibu,cibu,1,0,1,0,4
33437,olambake,olambake,1,1,0,0,8
33438,para263,para263,121,121,0,0,7
33439,gīvāya,givaya,150,147,3,0,6
33440,purobhāge,purobhage,1,1,0,0,9
33441,gila,gila,10,6,4,0,4
33442,gilane,gilane,1,1,0,0,6
33443,kaṇa,kana,52,23,29,0,4
33444,kaṇṭho,kantho,18,16,2,0,6
33445,ekatthaṃ,ekattham,57,53,4,0,8
33446,īvo,ivo,2,2,0,0,3
33447,kandharā,kandhara,2,1,1,0,8
33448,siraṃ,siram,31,27,4,0,5
33449,sirodharā,sirodhara,3,1,2,0,9
33450,dhiyyate,dhiyyate,2,2,0,0,8
33451,assanti,assanti,13,13,0,0,7
33452,suvaṇṇamayo,suvannamayo,19,19,0,0,11
33453,murajabhedo,murajabhedo,1,1,0,0,11
33454,sadisā,sadisa,166,148,18,0,6
33455,kambugīvā,kambugiva,8,5,3,0,9
33456,mahāpurisalakkhaṇametaṃ,mahapurisalakkhanametam,1,1,0,0,23
33457,lekhāhi,lekhahi,4,4,0,0,7
33458,aṅkitā,ankita,5,3,2,0,6
33459,mahāpurisalakkhaṇametañca,mahapurisalakkhanametanca,1,1,0,0,25
33460,kambu,kambu,11,9,2,0,5
33461,kambumayena,kambumayena,1,1,0,0,11
33462,āliṅgena,alingena,1,1,0,0,8
33463,kamba,kamba,4,1,3,0,5
33464,para264,para264,118,118,0,0,7
33465,bhujānaṃ,bhujanam,2,2,0,0,8
33466,kārakaraṇavasena,karakaranavasena,1,1,0,0,16
33467,bhāranti,bharanti,4,4,0,0,8
33468,khandhassa,khandhassa,76,74,2,0,10
33469,majjhaṃ,majjham,141,123,18,0,7
33470,bāhumūle,bahumule,2,2,0,0,8
33471,bāhūnaṃ,bahunam,3,3,0,0,7
33472,bāhumūlaṃ,bahumulam,2,1,1,0,9
33473,adhobhāgaṭṭhānaṃ,adhobhagatthanam,1,1,0,0,16
33474,para265,para265,126,126,0,0,7
33475,bāhumhi,bahumhi,2,2,0,0,7
33476,vāhu,vahu,3,2,1,0,4
33477,bhuñjate,bhunjate,4,4,0,0,8
33478,bhujo,bhujo,19,18,1,0,5
33479,pālanajjhohāresu,palanajjhoharesu,8,8,0,0,16
33480,aparosaddopyatra,aparosaddopyatra,1,1,0,0,16
33481,pārosaddopyatra,parosaddopyatra,1,1,0,0,15
33482,paveṭṭhasaddopyatra,pavetthasaddopyatra,1,1,0,0,19
33483,nakkhattepyayaṃ,nakkhattepyayam,1,1,0,0,15
33484,pāṇi,pani,102,89,13,0,4
33485,karapāṇayo,karapanayo,1,0,1,0,10
33486,pañcasākho,pancasakho,3,3,0,0,10
33487,sayopyatra,sayopyatra,1,1,0,0,10
33488,pakoṭṭhanto,pakotthanto,2,1,1,0,11
33489,hatthagaṇṭhi,hatthaganthi,1,1,0,0,12
33490,maṇibandho,manibandho,3,1,2,0,10
33491,pakoṭṭho,pakottho,5,3,2,0,8
33492,āmaṇibandhaṃ,amanibandham,1,1,0,0,12
33493,kapparassa,kapparassa,4,4,0,0,10
33494,maṇivikatiṃ,manivikatim,1,1,0,0,11
33495,bhujamajjhagaṇṭhimhi,bhujamajjhaganthimhi,1,1,0,0,20
33496,kapu,kapu,9,1,8,0,4
33497,kupparo,kupparo,1,0,1,0,7
33498,oṇi,oni,1,1,0,0,3
33499,kapoṇi,kaponi,1,1,0,0,6
33500,kaphoṇīpyatra,kaphonipyatra,1,1,0,0,13
33501,para266,para266,112,112,0,0,7
33502,pāṇissa,panissa,4,3,1,0,7
33503,pāṇitalassa,panitalassa,2,2,0,0,11
33504,sambandhīnaṃ,sambandhinam,8,8,0,0,12
33505,maṇibandhakaniṭṭhānaṃ,manibandhakanitthanam,1,1,0,0,21
33506,bahiṭṭhānaṃ,bahitthanam,1,1,0,0,11
33507,kumārakā,kumaraka,44,40,4,0,8
33508,paharanti,paharanti,50,50,0,0,9
33509,aṅgulimatte,angulimatte,2,2,0,0,11
33510,karassa,karassa,67,59,8,0,7
33511,agi,agi,2,0,2,0,3
33512,aṅguliyo,anguliyo,94,90,4,0,8
33513,pañcappabhedā,pancappabheda,1,1,0,0,13
33514,aṅguṭṭho,anguttho,3,1,2,0,8
33515,tajjanī,tajjani,3,2,1,0,7
33516,anāmikā,anamika,2,1,1,0,7
33517,kaniṭṭhā,kanittha,21,20,1,0,8
33518,assuttañca,assuttanca,1,1,0,0,10
33519,tajja,tajja,5,2,3,0,5
33520,tajjeti,tajjeti,12,12,0,0,7
33521,nāmamassāti,namamassati,2,2,0,0,11
33522,khuddakāti,khuddakati,6,1,5,0,10
33523,yuvappānaṃ,yuvappanam,1,1,0,0,10
33524,iyiṭṭhesu,iyitthesu,11,9,2,0,9
33525,para267,para267,114,114,0,0,7
33526,tajjanyādīhi,tajjanyadihi,1,1,0,0,12
33527,yute,yute,3,3,0,0,4
33528,aṅguṭṭhe,angutthe,5,5,0,0,8
33529,tate,tate,7,6,1,0,4
33530,pasārite,pasarite,50,49,1,0,8
33531,padesādikā,padesadika,1,1,0,0,10
33532,tajjanīyute,tajjaniyute,1,1,0,0,11
33533,padeso,padeso,184,177,7,0,6
33534,majjhimayute,majjhimayute,1,1,0,0,12
33535,anāmikāsahite,anamikasahite,1,1,0,0,13
33536,gokaṇṇo,gokanno,9,6,3,0,7
33537,gokaṇṇasadisattā,gokannasadisatta,1,1,0,0,16
33538,migaviseso,migaviseso,5,5,0,0,10
33539,takkaṇṇasadisappamāṇattā,takkannasadisappamanatta,1,1,0,0,24
33540,tālagokaṇṇā,talagokanna,2,1,1,0,11
33541,liṅgabhedā,lingabheda,3,3,0,0,10
33542,tālagokaṇṇavidatthī,talagokannavidatthi,1,1,0,0,19
33543,kaniṭṭhāyute,kanitthayute,1,1,0,0,12
33544,vitanotīti,vitanotiti,1,1,0,0,10
33545,vitatthi,vitatthi,2,2,0,0,8
33546,kuñcito,kuncito,3,2,1,0,7
33547,saṅkocito,sankocito,1,1,0,0,9
33548,pasatā,pasata,1,0,1,0,6
33549,pamāṇappakaraṇato,pamanappakaranato,1,1,0,0,17
33550,vitatañjaliyevāyaṃ,vitatanjaliyevayam,1,1,0,0,18
33551,icchito,icchito,137,136,1,0,7
33552,sampuṭañjali,samputanjali,2,2,0,0,12
33553,pasāritasahitā,pasaritasahita,1,1,0,0,14
33554,pasāritasahitattā,pasaritasahitatta,1,1,0,0,17
33555,tataṅguṭṭho,tatanguttho,1,1,0,0,11
33556,sapatākoti,sapatakoti,1,1,0,0,10
33557,sammato,sammato,154,151,3,0,7
33558,patākehi,patakehi,1,1,0,0,8
33559,garūnañca,garunanca,1,1,0,0,9
33560,pitūnañce,pitunance,1,1,0,0,9
33561,cchito,cchito,1,1,0,0,6
33562,atthappakaraṇādīhi,atthappakaranadihi,1,1,0,0,18
33563,jalañjaliṃ,jalanjalim,1,1,0,0,10
33564,añjalinā,anjalina,4,4,0,0,8
33565,devoyaṃ,devoyam,3,3,0,0,7
33566,katañjaliriti,katanjaliriti,1,1,0,0,13
33567,puṭañjalissa,putanjalissa,1,1,0,0,12
33568,vakkhamānattā,vakkhamanatta,127,127,0,0,13
33569,vitatañjaliyeva,vitatanjaliyeva,1,1,0,0,15
33570,para268,para268,111,111,0,0,7
33571,sappakoṭṭhe,sappakotthe,1,1,0,0,11
33572,vitatakare,vitatakare,1,1,0,0,10
33573,maṇibuddhādīsu,manibuddhadisu,1,1,0,0,14
33574,hatthasahitattā,hatthasahitatta,1,1,0,0,15
33575,sampuṭañjalimhi,samputanjalimhi,1,1,0,0,15
33576,karamayo,karamayo,1,1,0,0,8
33577,puṭo,puto,7,6,1,0,4
33578,karapuṭo,karaputo,6,5,1,0,8
33579,byattigatikantīsu,byattigatikantisu,1,1,0,0,17
33580,añjali,anjali,20,17,3,0,6
33581,karapuṭañjalī,karaputanjali,1,0,1,0,13
33582,nakhe,nakhe,35,35,0,0,5
33583,karajo,karajo,10,6,4,0,6
33584,avisayattā,avisayatta,53,48,5,0,10
33585,kararuho,kararuho,1,1,0,0,8
33586,nakharotipi,nakharotipi,1,1,0,0,11
33587,nakhassa,nakhassa,1,1,0,0,8
33588,puṭaṅgulikaretikhyāte,putangulikaretikhyate,1,1,0,0,21
33589,muṭṭhimhi,mutthimhi,1,1,0,0,9
33590,khaṭa,khata,3,0,3,0,5
33591,khada,khada,4,1,3,0,5
33592,para269,para269,120,120,0,0,7
33593,passadvayavitthatā,passadvayavitthata,2,1,1,0,18
33594,passadvayepi,passadvayepi,1,1,0,0,12
33595,vitatā,vitata,23,18,5,0,6
33596,pasāritā,pasarita,12,12,0,0,8
33597,sahakarā,sahakara,4,3,1,0,8
33598,sapāṇayo,sapanayo,1,1,0,0,8
33599,bāhū,bahu,10,9,1,0,4
33600,byāmīyate,byamiyate,1,1,0,0,9
33601,yāma,yama,22,19,3,0,4
33602,añche,anche,1,1,0,0,5
33603,tatā,tata,11,11,0,0,4
33604,samuditānaṃ,samuditanam,8,8,0,0,11
33605,pamāṇasadisaṃ,pamanasadisam,1,1,0,0,13
33606,uddhantatabhujaposappamāṇe,uddhantatabhujaposappamane,1,0,1,0,26
33607,pamāṇa,pamana,10,8,2,0,6
33608,porisaṃ,porisam,41,30,11,0,7
33609,purisa,purisa,415,313,102,0,6
33610,sakarabhujapurisaṃ,sakarabhujapurisam,1,1,0,0,18
33611,porisī,porisi,2,2,0,0,6
33612,para270,para270,110,110,0,0,7
33613,koḷaṃ,kolam,3,2,1,0,5
33614,koṭṭha,kottha,3,3,0,0,6
33615,bhujantaraṃ,bhujantaram,1,1,0,0,11
33616,vakkhotipi,vakkhotipi,1,1,0,0,10
33617,uronāmāni,uronamani,1,1,0,0,9
33618,uroje,uroje,1,1,0,0,5
33619,thano,thano,5,4,1,0,5
33620,thana,thana,7,3,4,0,5
33621,devasadde,devasadde,4,2,2,0,9
33622,coriye,coriye,5,4,1,0,6
33623,kuca,kuca,13,6,7,0,4
33624,saṅkocane,sankocane,13,9,4,0,9
33625,kuco,kuco,2,1,1,0,4
33626,payodharo,payodharo,3,1,2,0,9
33627,thanaggasmiṃ,thanaggasmim,2,1,1,0,12
33628,thanassa,thanassa,1,1,0,0,8
33629,cūcukaṃ,cucukam,4,1,3,0,7
33630,cūcuko,cucuko,1,1,0,0,6
33631,kucānanaṃ,kucananam,1,1,0,0,9
33632,ratanakoso,ratanakoso,3,0,3,0,10
33633,cu,cu,33,16,17,0,2
33634,cavane,cavane,10,8,2,0,6
33635,cancu,cancu,1,0,1,0,5
33636,assūkāro,assukaro,2,2,0,0,8
33637,piṭṭhe,pitthe,81,80,1,0,6
33638,pacchābhāge,pacchabhage,44,42,2,0,11
33639,piṭa,pita,4,1,3,0,4
33640,saddasaṅghātesu,saddasanghatesu,3,1,2,0,15
33641,itaratrati,itaratrati,1,1,0,0,10
33642,pisu,pisu,3,0,3,0,4
33643,para271,para271,112,112,0,0,7
33644,tanumajjhe,tanumajjhe,1,1,0,0,10
33645,laga,laga,5,2,3,0,4
33646,gahaṇī,gahani,24,10,14,0,6
33647,gabbhaṃ,gabbham,331,305,26,0,7
33648,gabbhāsayasaññito,gabbhasayasannito,7,7,0,0,17
33649,mātukucchippadeso,matukucchippadeso,5,5,0,0,17
33650,tejodhātumhi,tejodhatumhi,2,2,0,0,12
33651,yathābhuttāhārassa,yathabhuttaharassa,1,1,0,0,18
33652,vipācanavasena,vipacanavasena,6,6,0,0,14
33653,gaṇhanato,ganhanato,10,10,0,0,9
33654,achaḍḍanato,achaddanato,5,5,0,0,11
33655,udarati,udarati,1,1,0,0,7
33656,yatrāti,yatrati,22,4,18,0,7
33657,udaraṃ,udaram,80,74,6,0,6
33658,picaṇḍa,picanda,1,1,0,0,7
33659,jaṭhara,jathara,2,2,0,0,7
33660,tundāpyatra,tundapyatra,1,1,0,0,11
33661,kucchisambhave,kucchisambhave,2,1,1,0,14
33662,kucchiṭṭhe,kucchitthe,1,1,0,0,10
33663,koṭṭho,kottho,9,7,2,0,6
33664,para272,para272,106,106,0,0,7
33665,jaghanaṃ,jaghanam,10,7,3,0,8
33666,nitambo,nitambo,7,4,3,0,7
33667,vassāvaraṇesu,vassavaranesu,4,3,1,0,13
33668,kaṭyate,katyate,1,1,0,0,7
33669,āvarīyate,avariyate,1,1,0,0,9
33670,vatthādīhi,vatthadihi,9,9,0,0,10
33671,kaṭi,kati,16,13,3,0,4
33672,jaghana,jaghana,1,0,1,0,7
33673,itthikaṭiyā,itthikatiya,2,2,0,0,11
33674,aggabhāgo,aggabhago,1,1,0,0,9
33675,nitamba,nitamba,1,0,1,0,7
33676,sesadvayena,sesadvayena,1,1,0,0,11
33677,kaṭisāmaññaṃ,katisamannam,1,1,0,0,12
33678,thīkaṭyā,thikatya,1,1,0,0,8
33679,puro,puro,7,7,0,0,4
33680,para273,para273,111,111,0,0,7
33681,liṅgasāmaññe,lingasamanne,1,1,0,0,12
33682,sarīravācako,sariravacako,1,1,0,0,12
33683,aṅgametassatthīti,angametassatthiti,1,1,0,0,17
33684,rahassaṅgaṃ,rahassangam,6,4,2,0,11
33685,vatthena,vatthena,116,115,1,0,8
33686,guyhitabbanti,guyhitabbanti,1,1,0,0,13
33687,vatthaguyhaṃ,vatthaguyham,25,21,4,0,12
33688,mihati,mihati,6,6,0,0,6
33689,retomuttāni,retomuttani,1,1,0,0,11
33690,mehanaṃ,mehanam,4,2,2,0,7
33691,varaṅgaṃ,varangam,4,2,2,0,8
33692,assīkāro,assikaro,1,1,0,0,8
33693,virahattajotako,virahattajotako,1,1,0,0,15
33694,hyettha,hyettha,1,1,0,0,7
33695,nipphattiyaṃ,nipphattiyam,10,10,0,0,12
33696,puttanti,puttanti,6,6,0,0,8
33697,liṅgati,lingati,2,2,0,0,7
33698,aṅganti,anganti,73,72,1,0,7
33699,bījaphala,bijaphala,1,0,1,0,9
33700,aṇḍepi,andepi,1,1,0,0,6
33701,purisaliṅgapasibbake,purisalingapasibbake,1,1,0,0,20
33702,aḍi,adi,5,1,4,0,3
33703,aṇḍatthe,andatthe,4,4,0,0,8
33704,aṇḍa,anda,3,0,3,0,4
33705,bījepi,bijepi,3,3,0,0,6
33706,aṇḍakosoti,andakosoti,3,2,1,0,10
33707,samuditampi,samuditampi,1,1,0,0,11
33708,kosassa,kosassa,2,2,0,0,7
33709,kukkuṭacchāpakasseva,kukkutacchapakasseva,16,14,2,0,20
33710,aṇḍakosamhā,andakosamha,15,15,0,0,11
33711,amarakosepi,amarakosepi,3,1,2,0,11
33712,samuditeneva,samuditeneva,1,1,0,0,12
33713,aṇḍassa,andassa,5,5,0,0,7
33714,bījassa,bijassa,49,48,1,0,7
33715,aṅgajāte,angajate,62,59,3,0,8
33716,adhikaraṇeni,adhikaraneni,1,1,0,0,12
33717,itthipumaṃ,itthipumam,13,12,1,0,10
33718,bhajanti,bhajanti,215,202,13,0,8
33719,māramandira,maramandira,1,1,0,0,11
33720,mārakūpā,marakupa,1,1,0,0,8
33721,cātra,catra,8,8,0,0,5
33722,para274-275,para274-275,1,1,0,0,11
33723,sambhave,sambhave,83,74,9,0,8
33724,sucissa,sucissa,7,7,0,0,7
33725,asuci,asuci,270,265,5,0,5
33726,kāranto,karanto,32,32,0,0,7
33727,sambhavaliṅgo,sambhavalingo,1,1,0,0,13
33728,sāmatthiyaṃ,samatthiyam,49,46,3,0,11
33729,vaccamagge,vaccamagge,27,27,0,0,10
33730,pāyu,payu,4,2,2,0,4
33731,ūssāyo,ussayo,1,1,0,0,6
33732,paya,paya,5,2,3,0,4
33733,payati,payati,8,8,0,0,6
33734,vaccamanenāti,vaccamanenati,1,1,0,0,13
33735,guda,guda,2,0,2,0,4
33736,apānaṃpyatra,apanampyatra,1,1,0,0,12
33737,aṭṭhakaṃ,atthakam,53,53,0,0,8
33738,vacce,vacce,5,5,0,0,5
33739,gūtha,gutha,2,1,1,0,5
33740,karīsossagge,karisossagge,4,3,1,0,12
33741,gopane,gopane,6,6,0,0,6
33742,vikiraṇe,vikirane,8,7,1,0,8
33743,varaṇasambhattīsu,varanasambhattisu,2,2,0,0,17
33744,gūthañca,guthanca,11,10,1,0,8
33745,karīsañca,karisanca,3,3,0,0,9
33746,vaccañceti,vaccanceti,1,1,0,0,10
33747,katthaciyeva,katthaciyeva,5,5,0,0,12
33748,napuṃsakattameva,napumsakattameva,1,1,0,0,16
33749,bahulantyattho,bahulantyattho,1,1,0,0,14
33750,sattiyaṃ,sattiyam,26,22,4,0,8
33751,uccārīyate,uccariyate,5,5,0,0,10
33752,jahyateti,jahyateti,1,1,0,0,9
33753,uccāro,uccaro,32,29,3,0,6
33754,cajane,cajane,1,1,0,0,6
33755,ukkhipane,ukkhipane,6,5,1,0,9
33756,ḷattañca,lattanca,6,6,0,0,8
33757,avakarīyateti,avakariyateti,1,1,0,0,13
33758,ukkāro,ukkaro,2,1,1,0,6
33759,avassuttaṃ,avassuttam,1,1,0,0,10
33760,samalaṃpyatra,samalampyatra,1,1,0,0,13
33761,mutte,mutte,46,43,3,0,5
33762,sandanaṃ,sandanam,27,26,1,0,8
33763,passāve,passave,2,2,0,0,7
33764,kathīyate,kathiyate,12,12,0,0,9
33765,gomutte,gomutte,3,2,1,0,7
33766,sambandhini,sambandhini,3,3,0,0,11
33767,pūtimutta,putimutta,2,0,2,0,9
33768,pavattampi,pavattampi,14,14,0,0,10
33769,duggandhabhāvena,duggandhabhavena,4,4,0,0,16
33770,pūtimuttantveva,putimuttantveva,2,2,0,0,15
33771,pūtikāyo,putikayo,22,21,1,0,8
33772,assādīnaṃ,assadinam,9,9,0,0,9
33773,chakaṇa,chakana,2,0,2,0,7
33774,para276,para276,110,110,0,0,7
33775,vatthi,vatthi,18,15,3,0,6
33776,muttapuṭaṃ,muttaputam,1,1,0,0,10
33777,muttāsayapuṭo,muttasayaputo,1,1,0,0,13
33778,riti,riti,9,7,2,0,4
33779,ratanamālā,ratanamala,3,0,3,0,10
33780,muttametthāti,muttametthati,1,1,0,0,13
33781,ucchaṅgaṃ,ucchangam,4,3,1,0,9
33782,aṅkañca,ankanca,1,1,0,0,7
33783,ussajjati,ussajjati,1,1,0,0,9
33784,aṅka,anka,5,0,5,0,4
33785,ucchaṅgacihanesva,ucchangacihanesva,1,1,0,0,17
33786,ṅko,nko,3,2,1,0,3
33787,kose,kose,14,12,2,0,4
33788,jāṇūparibhāge,januparibhage,1,1,0,0,13
33789,sanja,sanja,10,0,10,0,5
33790,āsajjati,asajjati,1,1,0,0,8
33791,vatthamatrāti,vatthamatrati,1,1,0,0,13
33792,satthi,satthi,20,16,4,0,6
33793,ūru,uru,17,17,0,0,3
33794,jāṇumhi,janumhi,9,9,0,0,7
33795,ūruno,uruno,1,1,0,0,5
33796,pabbaṃ,pabbam,41,27,14,0,6
33797,gaṇṭhi,ganthi,27,24,3,0,6
33798,ūrupabbaṃ,urupabbam,1,0,1,0,9
33799,dvitte,dvitte,98,98,0,0,6
33800,para277,para277,104,104,0,0,7
33801,pādagaṇṭhimhi,padaganthimhi,2,2,0,0,13
33802,pho,pho,9,5,4,0,3
33803,pādagaṇṭhi,padaganthi,1,0,1,0,10
33804,ghuṭikāpyatra,ghutikapyatra,1,1,0,0,13
33805,ghuṭa,ghuta,6,1,5,0,5
33806,parivattane,parivattane,18,17,1,0,11
33807,ghuṭyate,ghutyate,1,1,0,0,8
33808,ghuṭikā,ghutika,1,0,1,0,7
33809,gopphakassādho,gopphakassadho,1,1,0,0,14
33810,bādhanaphusanesu,badhanaphusanesu,4,4,0,0,16
33811,kāravaṇṇāgame,karavannagame,1,1,0,0,13
33812,vuddhiyañca,vuddhiyanca,1,1,0,0,11
33813,pāsaṇhi,pasanhi,1,0,1,0,7
33814,elipyatra,elipyatra,1,1,0,0,9
33815,pādagge,padagge,1,1,0,0,7
33816,pādaggaṃ,padaggam,3,2,1,0,8
33817,pakaṭṭhaṃ,pakattham,23,23,0,0,9
33818,papadaṃ,papadam,2,1,1,0,7
33819,papado,papado,2,2,0,0,6
33820,pajjateti,pajjateti,2,2,0,0,9
33821,pajjate,pajjate,18,18,0,0,7
33822,aṅghipyatra,anghipyatra,1,1,0,0,11
33823,ahi,ahi,92,84,8,0,3
33824,para278,para278,102,102,0,0,7
33825,hatthādyavayave,hatthadyavayave,1,1,0,0,15
33826,aṅgi,angi,1,0,1,0,4
33827,patīko,patiko,1,1,0,0,6
33828,apaghanopyatra,apaghanopyatra,1,1,0,0,14
33829,passaṭṭhimhi,passatthimhi,1,1,0,0,12
33830,ḷi,li,7,5,2,0,2
33831,aḷāgame,alagame,1,1,0,0,7
33832,phāsukā,phasuka,63,54,9,0,7
33833,pāsuḷikā,pasulika,1,1,0,0,8
33834,pāsukā,pasuka,1,1,0,0,6
33835,phusa,phusa,18,7,11,0,5
33836,samphassetipi,samphassetipi,1,1,0,0,13
33837,paccayādi,paccayadi,2,2,0,0,9
33838,aṭṭhimatte,atthimatte,1,1,0,0,10
33839,kīkasaṃ,kikasam,1,1,0,0,7
33840,kullaṃpyatra,kullampyatra,1,1,0,0,12
33841,galassa,galassa,2,1,1,0,7
33842,kaṇṭhassa,kanthassa,5,5,0,0,9
33843,heṭṭhimante,hetthimante,1,1,0,0,11
33844,jātamaṭṭhi,jatamatthi,1,1,0,0,10
33845,galantaṭṭhi,galantatthi,2,1,1,0,11
33846,para279-280,para279-280,2,2,0,0,11
33847,sirasoṭṭhikhaṇḍe,sirasotthikhande,1,1,0,0,16
33848,samudite,samudite,5,5,0,0,8
33849,karoṭi,karoti,9,4,5,0,6
33850,kapparo,kapparo,4,3,1,0,7
33851,kammādimhi,kammadimhi,19,17,2,0,10
33852,siroṭṭhimhi,sirotthimhi,1,1,0,0,11
33853,kapālo,kapalo,4,4,0,0,6
33854,ghaṭādisakalepice,ghatadisakalepice,1,1,0,0,17
33855,athīti,athiti,2,2,0,0,6
33856,anitthīti,anitthiti,1,1,0,0,9
33857,chedo,chedo,54,51,3,0,5
33858,kapāla,kapala,2,1,1,0,6
33859,kaḍi,kadi,8,0,8,0,4
33860,chede,chede,8,7,1,0,5
33861,sirā,sira,10,10,0,0,4
33862,mahāsirā,mahasira,2,1,1,0,8
33863,sirāti,sirati,2,0,2,0,6
33864,susiravatyaṃ,susiravatyam,1,1,0,0,12
33865,vāyuvahantasirāyaṃ,vayuvahantasirayam,1,1,0,0,18
33866,kāyasirā,kayasira,1,1,0,0,8
33867,vāyuvahā,vayuvaha,1,1,0,0,8
33868,suttamivāṭṭhibandhinī,suttamivatthibandhini,1,1,0,0,21
33869,āhāravāhinī,aharavahini,1,1,0,0,11
33870,antakhyā,antakhya,1,1,0,0,8
33871,tatiyena,tatiyena,154,146,8,0,8
33872,paṭhamadutiyehi,pathamadutiyehi,3,3,0,0,15
33873,dīpitā,dipita,207,197,10,0,6
33874,aru,aru,8,6,2,0,3
33875,dhama,dhama,5,1,4,0,5
33876,dhamanī,dhamani,2,1,1,0,7
33877,rasaharaṇī,rasaharani,2,1,1,0,10
33878,maṃse,mamse,36,36,0,0,5
33879,misa,misa,4,1,3,0,4
33880,pisa,pisa,12,3,9,0,4
33881,avayave,avayave,49,42,7,0,7
33882,palalaṃ,palalam,2,2,0,0,7
33883,kabbaṃpyatra,kabbampyatra,1,1,0,0,12
33884,ātapādinā,atapadina,1,1,0,0,9
33885,sukkhamaṃse,sukkhamamse,1,1,0,0,11
33886,tiliṅgakantūti,tilingakantuti,1,1,0,0,14
33887,ūro,uro,15,15,0,0,3
33888,vallūrā,vallura,1,0,1,0,7
33889,uttattaṃ,uttattam,5,4,1,0,8
33890,para281,para281,105,105,0,0,7
33891,lohite,lohite,38,35,3,0,6
33892,runjhate,runjhate,1,1,0,0,8
33893,cammenāti,cammenati,3,1,2,0,9
33894,rañja,ranja,5,2,3,0,5
33895,asaṃ,asam,39,33,6,0,4
33896,khatajaṃpyatra,khatajampyatra,1,1,0,0,14
33897,khatā,khata,7,7,0,0,5
33898,kheḷe,khele,4,4,0,0,5
33899,khela,khela,1,0,1,0,5
33900,khala,khala,13,4,9,0,5
33901,ḷattaṃ,lattam,33,31,2,0,6
33902,kheḷo,khelo,78,70,8,0,5
33903,pitte,pitte,7,7,0,0,5
33904,māyūti,mayuti,2,1,1,0,6
33905,mādhumāyu,madhumayu,1,0,1,0,9
33906,apidadhātīti,apidadhatiti,1,1,0,0,12
33907,pittaṃ,pittam,107,91,16,0,6
33908,pidhāne,pidhane,6,5,1,0,7
33909,bhujādi,bhujadi,11,11,0,0,7
33910,semhe,semhe,1,1,0,0,5
33911,silisa,silisa,10,4,6,0,6
33912,semho,semho,18,16,2,0,5
33913,lisa,lisa,5,2,3,0,4
33914,silesumo,silesumo,2,1,1,0,8
33915,kaphopyatra,kaphopyatra,1,1,0,0,11
33916,para282-283,para282-283,1,1,0,0,11
33917,vilīno,vilino,1,1,0,0,6
33918,vibhūto,vibhuto,28,26,2,0,7
33919,sneho,sneho,61,53,8,0,5
33920,vasā,vasa,187,165,22,0,4
33921,tyuccate,tyuccate,16,16,0,0,8
33922,avilīnasnehe,avilinasnehe,1,1,0,0,12
33923,vapā,vapa,7,6,1,0,4
33924,vivaramedesū,vivaramedesu,1,1,0,0,12
33925,medādīnamekatthatā,medadinamekatthata,1,1,0,0,18
33926,medo,medo,47,41,6,0,4
33927,candanasuvaṇṇādyalaṅkārakatasarīrasobhāyaṃ,candanasuvannadyalankarakatasarirasobhayam,1,1,0,0,42
33928,ākappanaṃ,akappanam,1,1,0,0,9
33929,nepacche,nepacche,1,1,0,0,8
33930,gehamatte,gehamatte,3,3,0,0,9
33931,vesyāgahepi,vesyagahepi,1,1,0,0,11
33932,vessagahepi,vessagahepi,1,1,0,0,11
33933,visi,visi,1,0,1,0,4
33934,pathanaṃ,pathanam,1,1,0,0,8
33935,pakhyānaṃ,pakhyanam,1,1,0,0,9
33936,nepacchaṃ,nepaccham,2,1,1,0,9
33937,pakhyāne,pakhyane,1,1,0,0,8
33938,ghyaṇa,ghyana,15,14,1,0,6
33939,paṭikammaṃ,patikammam,72,62,10,0,10
33940,pasādhanaṃpyatra,pasadhanampyatra,1,1,0,0,16
33941,hārādyābharaṇe,haradyabharane,1,1,0,0,14
33942,maḍi,madi,11,1,10,0,4
33943,bhūsāyaṃ,bhusayam,7,6,1,0,8
33944,sādha,sadha,16,9,7,0,5
33945,sāṭha,satha,2,0,2,0,5
33946,saṅkhāragatīsu,sankharagatisu,2,1,1,0,14
33947,pasāṭhanaṃ,pasathanam,1,0,1,0,10
33948,muddhajadutiyotra,muddhajadutiyotra,1,1,0,0,17
33949,bhūsa,bhusa,5,1,4,0,5
33950,alaṅkāre,alankare,23,18,5,0,8
33951,karaṇeyeva,karaneyeva,5,5,0,0,10
33952,ābhariyyate,abhariyyate,1,1,0,0,11
33953,ābharaṇaṃ,abharanam,57,54,3,0,9
33954,kariyyateneneti,kariyyateneneti,1,1,0,0,15
33955,piḷandha,pilandha,1,0,1,0,8
33956,parikkhāropyatra,parikkharopyatra,1,1,0,0,16
33957,parikaropyatra,parikaropyatra,1,1,0,0,14
33958,makuṭe,makute,10,10,0,0,6
33959,īṭo,ito,2,2,0,0,3
33960,maki,maki,3,1,2,0,4
33961,maṇḍane,mandane,7,6,1,0,7
33962,uṭo,uto,2,2,0,0,3
33963,mukuṭotipi,mukutotipi,1,1,0,0,10
33964,makuṭaggaṭṭhe,makutaggatthe,1,1,0,0,13
33965,nāyakamaṇimhi,nayakamanimhi,1,1,0,0,13
33966,makuṭacūḷāyaṃ,makutaculayam,1,1,0,0,13
33967,cumbitā,cumbita,3,3,0,0,7
33968,cūḷāmaṇi,culamani,13,12,1,0,8
33969,makuṭasirasi,makutasirasi,1,1,0,0,12
33970,siromaṇi,siromani,2,1,1,0,8
33971,para284,para284,104,104,0,0,7
33972,uṇhīsapaṭṭe,unhisapatte,1,1,0,0,11
33973,siraso,siraso,4,4,0,0,6
33974,veṭhanaṃ,vethanam,37,30,7,0,8
33975,siroveṭhanaṃ,sirovethanam,1,0,1,0,12
33976,bahukālaṃ,bahukalam,12,12,0,0,9
33977,debyāmanussesvapi,debyamanussesvapi,1,1,0,0,17
33978,kaṇṇābharaṇe,kannabharane,2,2,0,0,12
33979,kuḍi,kudi,6,1,5,0,4
33980,veṭha,vetha,6,3,3,0,5
33981,kaṇṇaveṭhanaṃ,kannavethanam,2,1,1,0,13
33982,tāḷakākhye,talakakhye,1,1,0,0,10
33983,kaṇṇānaṃ,kannanam,23,23,0,0,8
33984,kaṇṇikā,kannika,57,48,9,0,7
33985,kaṇṇā,kanna,27,26,1,0,5
33986,bahulalakkhaṇe,bahulalakkhane,1,1,0,0,14
33987,kaṇṇacchadanaṃ,kannacchadanam,1,1,0,0,14
33988,kaṇṇapūro,kannapuro,3,1,2,0,9
33989,kaṇṇavibhūsanaṃ,kannavibhusanam,2,1,1,0,15
33990,tālapattaṃpyatra,talapattampyatra,1,1,0,0,16
33991,para285,para285,103,103,0,0,7
33992,gīvābharaṇe,givabharane,1,1,0,0,11
33993,bhūsā,bhusa,3,3,0,0,5
33994,kaṇṭhabhūsā,kanthabhusa,2,1,1,0,11
33995,gīvāyaṃ,givayam,81,81,0,0,7
33996,gīveyyaṃ,giveyyam,9,8,1,0,8
33997,bhavatthe,bhavatthe,38,36,2,0,9
33998,eyyo,eyyo,6,6,0,0,4
33999,gīva,giva,1,0,1,0,4
34000,ābharaṇe,abharane,2,2,0,0,8
34001,muttāvaliyaṃ,muttavaliyam,1,1,0,0,12
34002,harīyate,hariyate,1,1,0,0,8
34003,muttānaṃ,muttanam,15,15,0,0,8
34004,āvali,avali,6,5,1,0,5
34005,muttāvali,muttavali,4,3,1,0,9
34006,hārāsaddopyatra,harasaddopyatra,1,1,0,0,15
34007,pakoṭṭhābharaṇe,pakotthabharane,1,1,0,0,15
34008,kapparassādhobhāgo,kapparassadhobhago,2,2,0,0,18
34009,iyā,iya,21,12,9,0,3
34010,niyuro,niyuro,2,1,1,0,6
34011,vasāvaraṇagatīsu,vasavaranagatisu,1,1,0,0,16
34012,parihārakaṃ,pariharakam,3,2,1,0,11
34013,avāpakopyatra,avapakopyatra,1,1,0,0,13
34014,para286-287,para286-287,5,5,0,0,11
34015,muttādighaṭitavalayavikatyābharaṇe,muttadighatitavalayavikatyabharane,1,1,0,0,34
34016,kaṅkaṇaṃ,kankanam,4,2,2,0,8
34017,kaki,kaki,4,1,3,0,4
34018,gatyatthe,gatyatthe,5,5,0,0,9
34019,lolye,lolye,3,3,0,0,5
34020,kaṅkati,kankati,2,2,0,0,7
34021,karabhūsā,karabhusa,2,1,1,0,9
34022,khuddaghaṇṭikāyaṃ,khuddaghantikayam,1,1,0,0,17
34023,kaṇatīti,kanatiti,1,1,0,0,8
34024,kiṅkaṇī,kinkani,2,1,1,0,7
34025,kiṅkiṇītipi,kinkinitipi,1,1,0,0,11
34026,pāṭhantaraṃ,pathantaram,27,27,0,0,11
34027,yadādi,yadadi,15,14,1,0,6
34028,ghaṇṭā,ghanta,6,6,0,0,6
34029,khuddaghaṇṭikā,khuddaghantika,2,1,1,0,14
34030,aṅgulyābharaṇe,angulyabharane,1,1,0,0,14
34031,aṅguliyaṃ,anguliyam,14,14,0,0,9
34032,aṅgulīyakaṃ,anguliyakam,2,1,1,0,11
34033,aṅgulīnamābharaṇaṃ,angulinamabharanam,1,1,0,0,18
34034,aṅgulyābharaṇaṃ,angulyabharanam,1,0,1,0,15
34035,ummikāpyatra,ummikapyatra,1,1,0,0,12
34036,tamevāṅgulīyakaṃ,tamevanguliyakam,1,1,0,0,16
34037,sākkhara,sakkhara,1,0,1,0,8
34038,makkharavantaṃ,makkharavantam,1,1,0,0,14
34039,muddikā,muddika,31,28,3,0,7
34040,aṅgulimuddā,angulimudda,2,1,1,0,11
34041,phalavisesepyayaṃ,phalavisesepyayam,1,1,0,0,17
34042,muddā,mudda,18,16,2,0,5
34043,itthikaṭyābharaṇe,itthikatyabharane,1,1,0,0,17
34044,rasanī,rasani,1,0,1,0,6
34045,rasanaṃ,rasanam,4,3,1,0,7
34046,mehanassa,mehanassa,8,8,0,0,9
34047,khassa,khassa,15,15,0,0,6
34048,mekhalāti,mekhalati,3,2,1,0,9
34049,mehanindriyassa,mehanindriyassa,1,1,0,0,15
34050,mālātyattho,malatyattho,1,1,0,0,11
34051,kāñcī,kanci,2,2,0,0,5
34052,sattakī,sattaki,1,1,0,0,7
34053,sārasanaṃpyatra,sarasanampyatra,1,1,0,0,15
34054,ekayaṭṭhi,ekayatthi,3,3,0,0,9
34055,ṭṭhayaṭṭhikā,tthayatthika,1,1,0,0,12
34056,soḷasā,solasa,10,9,1,0,6
34057,kalāpā,kalapa,58,55,3,0,6
34058,pañcavīsati,pancavisati,168,155,13,0,11
34059,pañcavīsako,pancavisako,1,1,0,0,11
34060,sovaṇṇe,sovanne,6,6,0,0,7
34061,pagaṇḍabhūsane,pagandabhusane,1,1,0,0,14
34062,pagaṇḍo,pagando,1,1,0,0,7
34063,kapparassoparibhāgo,kapparassoparibhago,1,1,0,0,19
34064,bāhumūlassa,bahumulassa,2,2,0,0,11
34065,bāhumūlavibhūsanaṃ,bahumulavibhusanam,2,1,1,0,18
34066,para288,para288,99,99,0,0,7
34067,itthicaraṇavibhūsane,itthicaranavibhusane,1,1,0,0,20
34068,aṅgadākāraṃ,angadakaram,1,1,0,0,11
34069,pādabhūsanaṃ,padabhusanam,1,1,0,0,12
34070,pādaṅgadaṃ,padangadam,2,1,1,0,10
34071,maji,maji,1,0,1,0,4
34072,kaṭakaṃ,katakam,18,16,2,0,7
34073,pādakaṭakaṃ,padakatakam,1,0,1,0,11
34074,nūpuro,nupuro,2,1,1,0,6
34075,pādakaṭako,padakatako,1,1,0,0,10
34076,kaṭaka,kataka,1,0,1,0,6
34077,pulliṅgepi,pullingepi,4,4,0,0,10
34078,pavattanato,pavattanato,476,476,0,0,11
34079,dvandasamāso,dvandasamaso,10,10,0,0,12
34080,tulākoṭi,tulakoti,2,1,1,0,8
34081,haṃsakopyatra,hamsakopyatra,1,1,0,0,13
34082,gatikoṭilye,gatikotilye,1,1,0,0,11
34083,kuṭilakoṭittā,kutilakotitta,1,1,0,0,13
34084,haṃsagatittā,hamsagatitta,1,1,0,0,12
34085,haṃsako,hamsako,1,0,1,0,7
34086,para289,para289,102,102,0,0,7
34087,mukhaphullādayo,mukhaphulladayo,1,1,0,0,15
34088,alaṅkārappabhedā,alankarappabheda,2,2,0,0,16
34089,mukhaphullaṃ,mukhaphullam,6,2,4,0,12
34090,mukhālaṅkāro,mukhalankaro,1,1,0,0,12
34091,phulla,phulla,5,2,3,0,6
34092,dantādīsu,dantadisu,15,15,0,0,9
34093,suvaṇṇamayālaṅkāropi,suvannamayalankaropi,1,1,0,0,20
34094,mukhaphullameva,mukhaphullameva,1,1,0,0,15
34095,uṇṇataṃ,unnatam,6,4,2,0,7
34096,suvaṇṇādiracitaṃ,suvannadiracitam,1,1,0,0,16
34097,nalāṭābharaṇaṃ,nalatabharanam,1,1,0,0,14
34098,namane,namane,4,3,1,0,6
34099,mukhaphulluṇṇatānaṃ,mukhaphullunnatanam,1,1,0,0,19
34100,vipariyayenāpīti,vipariyayenapiti,1,1,0,0,16
34101,gāvīnaṃ,gavinam,48,46,2,0,7
34102,thanākārattā,thanakaratta,1,1,0,0,12
34103,gatthanaṃ,gatthanam,1,1,0,0,9
34104,ossattaṃ,ossattam,3,3,0,0,8
34105,uggatthanaṃ,uggatthanam,6,3,3,0,11
34106,catuyaṭṭhiko,catuyatthiko,1,1,0,0,12
34107,hārabhedo,harabhedo,1,1,0,0,9
34108,assittañca,assittanca,1,1,0,0,10
34109,giṅgamakaṃ,gingamakam,6,3,3,0,10
34110,bāttiṃsayaṭṭhiko,battimsayatthiko,1,1,0,0,16
34111,hārabhedova,harabhedova,1,1,0,0,11
34112,addhahāro,addhaharo,1,1,0,0,9
34113,māṇavako,manavako,86,85,1,0,8
34114,ekāvalī,ekavali,2,1,1,0,7
34115,nakkhattamālādayo,nakkhattamaladayo,1,1,0,0,17
34116,hārabhedā,harabheda,1,1,0,0,9
34117,saṅgayhanti,sangayhanti,120,120,0,0,11
34118,para290,para290,104,104,0,0,7
34119,vatthamatte,vatthamatte,1,1,0,0,11
34120,cila,cila,3,1,2,0,4
34121,vassane,vassane,3,3,0,0,7
34122,cilyate,cilyate,1,1,0,0,7
34123,acchādīyateti,acchadiyateti,2,2,0,0,13
34124,celī,celi,3,2,1,0,4
34125,vasyate,vasyate,1,1,0,0,7
34126,aṃsukaṃ,amsukam,1,0,1,0,7
34127,raṃsipariyāyopyayaṃ,ramsipariyayopyayam,1,1,0,0,19
34128,sobhanacelepyayaṃ,sobhanacelepyayam,1,1,0,0,17
34129,durūpaṃ,durupam,5,4,1,0,7
34130,dussaṃ,dussam,81,75,6,0,6
34131,vasane,vasane,6,4,2,0,6
34132,saṭa,sata,6,0,6,0,4
34133,rujāvisaraṇagatyāvasānesu,rujavisaranagatyavasanesu,2,1,1,0,25
34134,para291,para291,98,98,0,0,7
34135,vatthabhede,vatthabhede,1,1,0,0,11
34136,tatrādidvayaṃ,tatradidvayam,2,2,0,0,13
34137,dukūlakhye,dukulakhye,1,1,0,0,10
34138,vatthe,vatthe,41,39,2,0,6
34139,khu,khu,244,236,8,0,3
34140,khuma,khuma,1,0,1,0,5
34141,vikāre,vikare,20,19,1,0,6
34142,khumāya,khumaya,1,1,0,0,7
34143,khumā,khuma,1,1,0,0,5
34144,atasī,atasi,3,3,0,0,5
34145,tabbakkalasambhavaṃ,tabbakkalasambhavam,1,1,0,0,19
34146,vāccaliṅgoyaṃ,vaccalingoyam,1,1,0,0,13
34147,kūla,kula,8,3,5,0,4
34148,kulyateti,kulyateti,1,1,0,0,9
34149,dukūlaṃ,dukulam,27,17,10,0,7
34150,dumehi,dumehi,2,2,0,0,6
34151,kūlanti,kulanti,2,2,0,0,7
34152,dukūlampi,dukulampi,1,1,0,0,9
34153,vatthantaraṃ,vatthantaram,4,1,3,0,12
34154,khomanāmaṃ,khomanamam,1,1,0,0,10
34155,khoma,khoma,5,4,1,0,5
34156,maṭṭe,matte,2,2,0,0,5
34157,dukūle,dukule,2,2,0,0,6
34158,atasīvasanepi,atasivasanepi,1,1,0,0,13
34159,dukūlecā,dukuleca,1,1,0,0,8
34160,nānatthasaṅgahatikaṇḍasesesu,nanatthasangahatikandasesesu,1,0,1,0,28
34161,nānatthasaṅgaha,nanatthasangaha,1,1,0,0,15
34162,kimigabbho,kimigabbho,1,1,0,0,10
34163,kimikosotthaṃ,kimikosottham,1,1,0,0,13
34164,koseyyameva,koseyyameva,1,1,0,0,11
34165,dhotaṃ,dhotam,24,16,8,0,6
34166,paṭṭuṇṇaṃ,pattunnam,21,13,8,0,9
34167,dhotakoseyyaṃ,dhotakoseyyam,1,1,0,0,13
34168,pattuṇṇantipi,pattunnantipi,1,1,0,0,13
34169,paṭṭuṇṇaraṭṭhe,pattunnaratthe,1,1,0,0,14
34170,kamanīyattā,kamaniyatta,2,2,0,0,11
34171,raṅkunāmakassa,rankunamakassa,1,1,0,0,14
34172,hariṇavisesassa,harinavisesassa,1,1,0,0,15
34173,lomenasañjātavatthaṃ,lomenasanjatavattham,1,1,0,0,20
34174,rāṅkavaṃ,rankavam,1,1,0,0,8
34175,vigaromajaṃ,vigaromajam,1,1,0,0,11
34176,kambala,kambala,4,3,1,0,7
34177,rallako,rallako,1,0,1,0,7
34178,kambalapariyāyo,kambalapariyayo,1,1,0,0,15
34179,saṇo,sano,1,1,0,0,4
34180,thirattaco,thirattaco,1,1,0,0,10
34181,rukkhayoni,rukkhayoni,1,1,0,0,10
34182,tacena,tacena,27,25,2,0,6
34183,kevaṭṭādayo,kevattadayo,1,1,0,0,11
34184,jālādīni,jaladini,2,2,0,0,8
34185,saṇassa,sanassa,1,1,0,0,7
34186,migalomāni,migalomani,1,1,0,0,10
34187,koṭṭetvā,kottetva,204,197,7,0,8
34188,sukhumāni,sukhumani,21,20,1,0,9
34189,katamambaraṃ,katamambaram,1,1,0,0,12
34190,koṭumbaraṃ,kotumbaram,3,1,2,0,10
34191,koṭumbaraṭṭhejātattā,kotumbaratthejatatta,1,1,0,0,20
34192,bhaṅgaṃ,bhangam,109,86,23,0,7
34193,khomādīni,khomadini,12,10,2,0,9
34194,ekajjhāni,ekajjhani,1,1,0,0,9
34195,vomissetvā,vomissetva,5,5,0,0,10
34196,katavatthaṃ,katavattham,6,5,1,0,11
34197,bhanja,bhanja,5,1,4,0,6
34198,sāṇaphalaṃ,sanaphalam,1,1,0,0,10
34199,tabbikārattā,tabbikaratta,1,1,0,0,12
34200,bhaṅgā,bhanga,197,193,4,0,6
34201,sāṇākhyasassepī,sanakhyasassepi,1,1,0,0,15
34202,sassaṃ,sassam,145,140,5,0,6
34203,bhaṅgampi,bhangampi,7,7,0,0,9
34204,vākamayamevāti,vakamayamevati,7,6,1,0,14
34205,vatthaviseso,vatthaviseso,2,2,0,0,12
34206,kappāsādayopi,kappasadayopi,1,1,0,0,13
34207,para292-293,para292-293,1,1,0,0,11
34208,paridhānabhūte,paridhanabhute,1,1,0,0,14
34209,adhovatthe,adhovatthe,1,1,0,0,10
34210,nivāsanaṃ,nivasanam,95,90,5,0,9
34211,jotako,jotako,18,18,0,0,6
34212,bāhulyena,bahulyena,5,5,0,0,9
34213,antare,antare,768,752,16,0,6
34214,antarīyaṃ,antariyam,3,1,2,0,9
34215,samānaliṅgattā,samanalingatta,2,2,0,0,14
34216,antaravāsako,antaravasako,49,45,4,0,12
34217,upasaṃbyānaṃpyatra,upasambyanampyatra,1,1,0,0,18
34218,uparidhāne,uparidhane,1,1,0,0,10
34219,pāvāro,pavaro,29,22,7,0,6
34220,dehabhāge,dehabhage,3,3,0,0,9
34221,āsajjateti,asajjateti,1,1,0,0,10
34222,uttarāsaṅgo,uttarasango,31,30,1,0,11
34223,sañja,sanja,6,2,4,0,5
34224,saṃvīyate,samviyate,1,1,0,0,9
34225,pidhīyate,pidhiyate,2,2,0,0,9
34226,bāhulyenāti,bahulyenati,2,2,0,0,11
34227,upasaṃ,upasam,3,0,3,0,6
34228,uttarīya,uttariya,2,1,1,0,8
34229,saṃbyānaṃpyatra,sambyanampyatra,1,1,0,0,15
34230,navaṃ,navam,301,262,39,0,5
34231,ahatanti,ahatanti,1,1,0,0,8
34232,haññati,hannati,110,104,6,0,7
34233,pāsāṇādīhīti,pasanadihiti,1,1,0,0,12
34234,ahataṃ,ahatam,7,3,4,0,6
34235,tantato,tantato,4,4,0,0,7
34236,aciramāharitaṃ,aciramaharitam,1,1,0,0,14
34237,anāhataṃ,anahatam,2,2,0,0,8
34238,nippavāṇi,nippavani,2,2,0,0,9
34239,tantakaṃpyatra,tantakampyatra,1,1,0,0,14
34240,tantakañca,tantakanca,1,1,0,0,10
34241,navambare,navambare,1,1,0,0,9
34242,cirakālattā,cirakalatta,2,2,0,0,11
34243,niddase,niddase,1,1,0,0,7
34244,jiṇṇavatthe,jinnavatthe,1,1,0,0,11
34245,nantakaṃ,nantakam,9,6,3,0,8
34246,paṭo,pato,81,80,1,0,4
34247,kappaṭo,kappato,9,7,2,0,7
34248,aṭo,ato,16,16,0,0,3
34249,athiravatthe,athiravatthe,1,1,0,0,12
34250,jiṇṇavasanaṃ,jinnavasanam,2,2,0,0,12
34251,athiraṃ,athiram,2,2,0,0,7
34252,phoṭatīti,photatiti,1,1,0,0,9
34253,paṭaccaraṃ,pataccaram,3,2,1,0,10
34254,paṭaccarameva,pataccarameva,1,1,0,0,13
34255,paḷaccaraṃ,palaccaram,1,0,1,0,10
34256,para294,para294,99,99,0,0,7
34257,koṭikādisannāhe,kotikadisannahe,1,1,0,0,15
34258,coḷe,cole,3,3,0,0,4
34259,vāṇaṃ,vanam,2,2,0,0,5
34260,vārayatīti,varayatiti,2,2,0,0,10
34261,vāravāṇo,varavano,1,0,1,0,8
34262,vāra,vara,2,1,1,0,4
34263,anitthiyamete,anitthiyamete,1,1,0,0,13
34264,vatthassa,vatthassa,73,73,0,0,9
34265,vatyamavatthāyaṃ,vatyamavatthayam,1,1,0,0,16
34266,vatthaṃse,vatthamse,1,1,0,0,9
34267,bahumhi,bahumhi,35,34,1,0,7
34268,uttamaṅgamhi,uttamangamhi,2,1,1,0,12
34269,kañcuko,kancuko,7,5,2,0,7
34270,suvaṇṇādimayo,suvannadimayo,1,1,0,0,13
34271,nāḷipatto,nalipatto,3,3,0,0,9
34272,suvaṇṇādipaṭo,suvannadipato,1,1,0,0,13
34273,sīsakaṃ,sisakam,2,2,0,0,7
34274,sirohantipi,sirohantipi,1,1,0,0,11
34275,para295,para295,99,99,0,0,7
34276,yamu,yamu,20,2,18,0,4
34277,āyāmo,ayamo,8,6,2,0,5
34278,gatipāpuṇesu,gatipapunesu,3,1,2,0,12
34279,dīghassa,dighassa,108,103,5,0,8
34280,vatthavisaye,vatthavisaye,2,2,0,0,12
34281,osāro,osaro,6,5,1,0,5
34282,rūḷhe,rulhe,1,1,0,0,5
34283,nayhatīti,nayhatiti,2,2,0,0,9
34284,pariṇāho,parinaho,4,3,1,0,8
34285,visāro,visaro,5,4,1,0,6
34286,visālatā,visalata,2,1,1,0,8
34287,para296,para296,103,103,0,0,7
34288,arahataṃ,arahatam,219,192,27,0,8
34289,arahaddhajo,arahaddhajo,10,9,1,0,11
34290,tadaññacīvaresu,tadannacivaresu,1,1,0,0,15
34291,kasāyena,kasayena,7,7,0,0,8
34292,kasāvena,kasavena,14,14,0,0,8
34293,kāsāyaṃ,kasayam,12,11,1,0,7
34294,kāsāva,kasava,5,3,2,0,6
34295,īvaro,ivaro,7,5,2,0,5
34296,vatthakhandhehi,vatthakhandhehi,1,1,0,0,15
34297,cīyateti,ciyateti,1,1,0,0,8
34298,maṇḍalādayo,mandaladayo,1,1,0,0,11
34299,tadaṅgāni,tadangani,2,1,1,0,9
34300,samūhabhūtassa,samuhabhutassa,2,2,0,0,14
34301,cīvarassa,civarassa,208,205,3,0,9
34302,avayavāni,avayavani,3,3,0,0,9
34303,cīvarapariyantoyaṃ,civarapariyantoyam,1,1,0,0,18
34304,vivaṭṭo,vivatto,36,28,8,0,7
34305,cīvaramajjhagatamaggo,civaramajjhagatamaggo,1,1,0,0,21
34306,vaṭṭatīti,vattatiti,1736,1341,395,0,9
34307,vivaṭṭoti,vivattoti,7,3,4,0,9
34308,vaṭṭa,vatta,18,12,6,0,5
34309,āvaṭṭane,avattane,1,1,0,0,8
34310,kusi,kusi,5,2,3,0,4
34311,majjhagatavatthakhaṇḍaṃ,majjhagatavatthakhandam,1,1,0,0,23
34312,para297,para297,102,102,0,0,7
34313,phalādīnaṃ,phaladinam,10,9,1,0,10
34314,taduppattito,taduppattito,10,10,0,0,12
34315,kappāsikaṃ,kappasikam,27,21,6,0,10
34316,phālaṃ,phalam,23,19,4,0,6
34317,phalavikārattā,phalavikaratta,1,1,0,0,14
34318,phālo,phalo,21,17,4,0,5
34319,phālā,phala,6,6,0,0,5
34320,khomādayo,khomadayo,1,1,0,0,9
34321,paṭā,pata,12,8,4,0,4
34322,tacabbhavā,tacabbhava,2,1,1,0,10
34323,tacato,tacato,9,9,0,0,6
34324,para298,para298,107,107,0,0,7
34325,kimijaṃ,kimijam,4,3,1,0,7
34326,migalomamayantu,migalomamayantu,1,1,0,0,15
34327,byavadhāyakapaṭe,byavadhayakapate,1,1,0,0,16
34328,kaṇḍapaṭepīti,kandapatepiti,1,1,0,0,13
34329,tulyatthātyattho,tulyatthatyattho,1,1,0,0,16
34330,pidhīyati,pidhiyati,23,22,1,0,9
34331,tirokaraṇī,tirokarani,4,2,2,0,10
34332,patisīrāpyatra,patisirapyatra,1,1,0,0,14
34333,para299,para299,106,106,0,0,7
34334,uparibandhapaṭe,uparibandhapate,1,1,0,0,15
34335,liṅgādijotako,lingadijotako,1,1,0,0,13
34336,locate,locate,1,1,0,0,6
34337,bandhīyateti,bandhiyateti,5,5,0,0,12
34338,ullocaṃ,ullocam,2,1,1,0,7
34339,luca,luca,1,0,1,0,4
34340,candātape,candatape,2,2,0,0,9
34341,vitanyateti,vitanyateti,1,1,0,0,11
34342,vitānaṃ,vitanam,91,84,7,0,7
34343,punnapuṃsakanti,punnapumsakanti,1,1,0,0,15
34344,īritaṃ,iritam,19,16,3,0,6
34345,sināne,sinane,3,3,0,0,6
34346,soce,soce,8,8,0,0,4
34347,sattamyantaṃ,sattamyantam,7,7,0,0,12
34348,kulyādinā,kulyadina,1,1,0,0,9
34349,kuṭyādinā,kutyadina,1,1,0,0,9
34350,kujjanādinā,kujjanadina,1,1,0,0,11
34351,kuṅkumahaliddādinā,kunkumahaliddadina,1,1,0,0,18
34352,aṅganimmalīkaraṇe,anganimmalikarane,1,1,0,0,17
34353,ubbattīyate,ubbattiyate,1,1,0,0,11
34354,visārīyate,visariyate,1,1,0,0,10
34355,malamaneneti,malamaneneti,1,1,0,0,12
34356,ubbattanaṃ,ubbattanam,2,1,1,0,10
34357,vatu,vatu,17,5,12,0,4
34358,dvayamidaṃ,dvayamidam,3,3,0,0,10
34359,samānatthaṃ,samanattham,41,41,0,0,11
34360,para300,para300,110,110,0,0,7
34361,nalāṭakate,nalatakate,1,1,0,0,10
34362,cittake,cittake,9,7,2,0,7
34363,tilakākati,tilakakati,1,1,0,0,10
34364,tilako,tilako,12,7,5,0,6
34365,cittakākati,cittakakati,1,1,0,0,11
34366,cittakaṃ,cittakam,15,10,5,0,8
34367,tamālapattākati,tamalapattakati,1,1,0,0,15
34368,tamālapattaṃ,tamalapattam,10,9,1,0,12
34369,visesakaṃ,visesakam,18,13,5,0,9
34370,visesakatilakā,visesakatilaka,1,0,1,0,14
34371,sesadvayaṃ,sesadvayam,6,5,1,0,10
34372,candane,candane,1,1,0,0,7
34373,cadi,cadi,7,1,6,0,4
34374,hilādane,hiladane,4,3,1,0,8
34375,hilādanaṃ,hiladanam,3,2,1,0,9
34376,sukhāpanaṃ,sukhapanam,1,1,0,0,10
34377,gandhānaṃ,gandhanam,48,48,0,0,9
34378,gandhasāro,gandhasaro,3,2,1,0,10
34379,gandhayutto,gandhayutto,1,1,0,0,11
34380,thiraṃso,thiramso,3,2,1,0,8
34381,malayadīpagirimhi,malayadipagirimhi,1,1,0,0,17
34382,malayajo,malayajo,3,2,1,0,8
34383,bhaddasirīpyatra,bhaddasiripyatra,1,1,0,0,16
34384,para301,para301,105,105,0,0,7
34385,pītacandane,pitacandane,1,1,0,0,11
34386,gosīsa,gosisa,1,1,0,0,6
34387,malaye,malaye,9,9,0,0,6
34388,gosīsaṃ,gosisam,5,2,3,0,7
34389,sītanti,sitanti,4,4,0,0,7
34390,gosītaṃ,gositam,1,1,0,0,7
34391,tilapaṇṇappamāṇapaṇṇayuttatāya,tilapannappamanapannayuttataya,2,2,0,0,30
34392,telapaṇṇikaṃ,telapannikam,3,2,1,0,12
34393,candananti,candananti,1,1,0,0,10
34394,pītasāru,pitasaru,1,1,0,0,8
34395,susītaṃpyatra,susitampyatra,1,1,0,0,13
34396,gosīsā,gosisa,2,0,2,0,6
34397,rattacandane,rattacandane,2,2,0,0,12
34398,tilapaṇṇī,tilapanni,2,1,1,0,9
34399,purimena,purimena,272,257,15,0,8
34400,bhedakaraṇatthaṃ,bhedakaranattham,1,1,0,0,16
34401,pattamaṅgamasseti,pattamangamasseti,1,1,0,0,17
34402,pattaṅgaṃ,pattangam,4,3,1,0,9
34403,khuddapaṇṇatāya,khuddapannataya,1,1,0,0,15
34404,appadhānapattamiccattho,appadhanapattamiccattho,1,1,0,0,23
34405,gattanti,gattanti,1,1,0,0,8
34406,kopāyapatīkesvappadhānake,kopayapatikesvappadhanake,1,1,0,0,25
34407,hetukattari,hetukattari,11,11,0,0,11
34408,rattavaṇṇatāya,rattavannataya,7,7,0,0,14
34409,rattañca,rattanca,2,2,0,0,8
34410,candanañceti,candananceti,1,1,0,0,12
34411,rattacandanaṃ,rattacandanam,8,7,1,0,13
34412,rattacandana,rattacandana,4,3,1,0,12
34413,visese,visese,123,113,10,0,6
34414,vattantī,vattanti,28,22,6,0,8
34415,gosīsassa,gosisassa,2,2,0,0,9
34416,yathāvuttoyevattho,yathavuttoyevattho,3,3,0,0,18
34417,susītalaṃ,susitalam,3,3,0,0,9
34418,candanaṃ,candanam,96,84,12,0,8
34419,malayapabbatadesajameva,malayapabbatadesajameva,1,1,0,0,23
34420,maṇḍūko,manduko,26,25,1,0,7
34421,tadākāre,tadakare,3,3,0,0,8
34422,pakkambaphalagandhi,pakkambaphalagandhi,1,1,0,0,19
34423,pītavaṇṇaṃ,pitavannam,17,17,0,0,10
34424,tilapaṇṇīpattaṅgāni,tilapannipattangani,1,0,1,0,19
34425,rattacandanasadisassa,rattacandanasadisassa,1,1,0,0,21
34426,rattasārassa,rattasarassa,2,2,0,0,12
34427,candanassa,candanassa,12,12,0,0,10
34428,tilapaṇyādīni,tilapanyadini,1,1,0,0,13
34429,lohitacandanasadisassa,lohitacandanasadisassa,1,1,0,0,22
34430,candanavisesassa,candanavisesassa,1,1,0,0,16
34431,kucandanaṃpyatra,kucandanampyatra,1,1,0,0,16
34432,rañjanaṃ,ranjanam,6,5,1,0,8
34433,patraṅgañca,patranganca,1,1,0,0,11
34434,kucandanaṃ,kucandanam,1,1,0,0,10
34435,ratanamālāyaṃ,ratanamalayam,2,0,2,0,13
34436,para302,para302,95,95,0,0,7
34437,vaṇijādīnaṃ,vanijadinam,1,1,0,0,11
34438,kāḷeyā,kaleya,1,1,0,0,6
34439,rūḷhepītakaṭṭhe,rulhepitakatthe,1,1,0,0,15
34440,kāḷavaṇṇaṃ,kalavannam,32,31,1,0,10
34441,kāḷānusārī,kalanusari,3,2,1,0,10
34442,kāḷavaṇṇajanakotyattho,kalavannajanakotyattho,1,1,0,0,22
34443,kāḷaṃ,kalam,26,24,2,0,5
34444,kāḷiyaṃ,kaliyam,2,2,0,0,7
34445,kāḷīya,kaliya,1,0,1,0,6
34446,kantu,kantu,2,2,0,0,5
34447,kāḷeyaṃ,kaleyam,1,1,0,0,7
34448,vaṇṇadaṃ,vannadam,1,1,0,0,8
34449,kantijāsakaṃ,kantijasakam,1,1,0,0,12
34450,jāsakaṃ,jasakam,1,1,0,0,7
34451,kantidāyakaṃ,kantidayakam,1,1,0,0,12
34452,byāḍi,byadi,3,0,3,0,5
34453,agarusāmaññe,agarusamanne,1,1,0,0,12
34454,lahunāmattā,lahunamatta,1,1,0,0,11
34455,agaru,agaru,63,61,2,0,5
34456,agalu,agalu,1,0,1,0,5
34457,vaṃsikaṃ,vamsikam,1,1,0,0,8
34458,rājārahaṃ,rajaraham,20,19,1,0,9
34459,joṅgakaṃpyatra,jongakampyatra,1,1,0,0,14
34460,agarumhi,agarumhi,2,2,0,0,8
34461,kāḷe,kale,55,51,4,0,4
34462,kāḷāgarū,kalagaru,1,1,0,0,8
34463,mallikāpupphagandhi,mallikapupphagandhi,1,1,0,0,19
34464,maṅgalyoccate,mangalyoccate,1,1,0,0,13
34465,sallakīdave,sallakidave,1,1,0,0,11
34466,piḍi,pidi,4,1,3,0,4
34467,sihalo,sihalo,1,1,0,0,6
34468,yāvaṇopyatra,yavanopyatra,1,1,0,0,12
34469,para303,para303,114,114,0,0,7
34470,miganābhiyaṃ,miganabhiyam,1,1,0,0,12
34471,migassa,migassa,32,31,1,0,7
34472,migamado,migamado,3,1,2,0,8
34473,marati,marati,273,267,6,0,6
34474,migamaro,migamaro,1,1,0,0,8
34475,kuṭṭhe,kutthe,9,7,2,0,6
34476,kuṭādīhi,kutadihi,3,2,1,0,8
34477,kuṭṭhaṃ,kuttham,49,41,8,0,7
34478,rogabhedepi,rogabhedepi,2,2,0,0,11
34479,chāyūpagate,chayupagate,1,1,0,0,11
34480,aje,aje,15,15,0,0,3
34481,ajapālakaṃ,ajapalakam,2,1,1,0,10
34482,pāribhābyaṃ,paribhabyam,2,2,0,0,11
34483,pākalaṃ,pakalam,2,2,0,0,7
34484,phālakī,phalaki,1,1,0,0,7
34485,vāppaṃpyatra,vappampyatra,1,1,0,0,12
34486,piḍaṅge,pidange,1,1,0,0,7
34487,rogaṃ,rogam,85,78,7,0,5
34488,lavaṅgo,lavango,1,0,1,0,7
34489,kusumaṃ,kusumam,21,15,6,0,7
34490,sirisaññaṃpyatra,sirisannampyatra,1,1,0,0,16
34491,kuṅkume,kunkume,1,1,0,0,7
34492,kasmīraraṭṭhe,kasmiraratthe,1,1,0,0,13
34493,aggisikhaṃ,aggisikham,1,1,0,0,10
34494,vallīkaṃ,vallikam,1,1,0,0,8
34495,pītanaṃ,pitanam,4,3,1,0,7
34496,rattasaṅkocaṃ,rattasankocam,1,1,0,0,13
34497,pisunaṃ,pisunam,2,2,0,0,7
34498,dhīraṃ,dhiram,108,83,25,0,6
34499,lohitacandanaṃpyatra,lohitacandanampyatra,1,1,0,0,20
34500,para304,para304,108,108,0,0,7
34501,dhunake,dhunake,1,1,0,0,7
34502,yakkhehi,yakkhehi,13,12,1,0,8
34503,dhūpo,dhupo,1,1,0,0,5
34504,yakkhadhūpo,yakkhadhupo,2,1,1,0,11
34505,sajjarukkhassa,sajjarukkhassa,1,1,0,0,14
34506,sileso,sileso,42,25,17,0,6
34507,sajjulaso,sajjulaso,3,2,1,0,9
34508,essattañca,essattanca,1,1,0,0,10
34509,sajjassa,sajjassa,1,1,0,0,8
34510,davo,davo,23,19,4,0,4
34511,sajjarasotipi,sajjarasotipi,1,1,0,0,13
34512,rālo,ralo,1,1,0,0,4
34513,sabbaraso,sabbaraso,1,1,0,0,9
34514,bahurūpopyatra,bahurupopyatra,1,1,0,0,14
34515,takkole,takkole,1,1,0,0,7
34516,kosayuttaṃ,kosayuttam,1,1,0,0,10
34517,phalametassāti,phalametassati,3,3,0,0,14
34518,kosaphalaṃ,kosaphalam,1,0,1,0,10
34519,jātiphale,jatiphale,1,1,0,0,9
34520,kosasahitaṃ,kosasahitam,2,2,0,0,11
34521,jātiphalametassāti,jatiphalametassati,1,1,0,0,18
34522,jātikosaṃ,jatikosam,1,0,1,0,9
34523,jātiphalametassa,jatiphalametassa,1,1,0,0,16
34524,kittimanti,kittimanti,1,1,0,0,10
34525,jātiphalaṃ,jatiphalam,5,3,2,0,10
34526,para305,para305,112,112,0,0,7
34527,kappūre,kappure,1,1,0,0,7
34528,ghanasāro,ghanasaro,3,2,1,0,9
34529,abbhamiva,abbhamiva,4,4,0,0,9
34530,sitabbho,sitabbho,2,1,1,0,8
34531,candasañño,candasanno,1,1,0,0,10
34532,himavāluko,himavaluko,1,1,0,0,10
34533,himāvhayopyatra,himavhayopyatra,1,1,0,0,15
34534,lākhāyaṃ,lakhayam,1,1,0,0,8
34535,alattako,alattako,2,1,1,0,8
34536,lākha,lakha,2,0,2,0,5
34537,sosane,sosane,12,7,5,0,6
34538,dumāmayopyatra,dumamayopyatra,1,1,0,0,14
34539,para306,para306,112,112,0,0,7
34540,saraladdave,saraladdave,1,1,0,0,11
34541,lakkhiyā,lakkhiya,6,6,0,0,8
34542,sirivāso,sirivaso,2,1,1,0,8
34543,saralanāmakassa,saralanamakassa,1,1,0,0,15
34544,saraladdavo,saraladdavo,1,0,1,0,11
34545,vakadhūpo,vakadhupo,1,1,0,0,9
34546,siriveṭṭhopyatra,sirivetthopyatra,1,1,0,0,16
34547,sirivāse,sirivase,1,1,0,0,8
34548,paramanne,paramanne,1,1,0,0,9
34549,añjane,anjane,3,3,0,0,6
34550,añju,anju,2,1,1,0,4
34551,byattimakkhanagatikantīsu,byattimakkhanagatikantisu,1,1,0,0,25
34552,kajja,kajja,3,0,3,0,5
34553,byasane,byasane,13,10,3,0,7
34554,kajjati,kajjati,2,2,0,0,7
34555,roganti,roganti,1,1,0,0,7
34556,kajjalaṃ,kajjalam,3,2,1,0,8
34557,gandhagāhāpanacuṇṇe,gandhagahapanacunne,1,1,0,0,19
34558,hiṃsattho,himsattho,7,7,0,0,9
34559,duggandhanti,duggandhanti,3,3,0,0,12
34560,upasevāyaṃ,upasevayam,4,2,2,0,10
34561,vāsayogo,vasayogo,2,1,1,0,8
34562,vilepanamatte,vilepanamatte,1,1,0,0,13
34563,vaṇṇakriyāvitthāraguṇavacanesu,vannakriyavittharagunavacanesu,3,2,1,0,30
34564,vaṇṇayatīti,vannayatiti,1,1,0,0,11
34565,vaṇṇakaṃ,vannakam,6,4,2,0,8
34566,lipa,lipa,6,0,6,0,4
34567,upadehe,upadehe,1,1,0,0,7
34568,vilepīyateti,vilepiyateti,1,1,0,0,12
34569,vilepanaṃ,vilepanam,72,54,18,0,9
34570,para307,para307,98,98,0,0,7
34571,gandhamālyadhūpādīhi,gandhamalyadhupadihi,1,1,0,0,20
34572,vatthatambulādīnaṃ,vatthatambuladinam,1,1,0,0,18
34573,vāsana,vasana,2,1,1,0,6
34574,mityuccate,mityuccate,9,9,0,0,10
34575,vāsīyate,vasiyate,2,2,0,0,8
34576,saṅkharīyateti,sankhariyateti,1,1,0,0,14
34577,vāsanaṃ,vasanam,15,13,2,0,7
34578,pupphadāme,pupphadame,4,4,0,0,10
34579,mālova,malova,1,1,0,0,6
34580,mālyaṃ,malyam,13,11,2,0,6
34581,dama,dama,12,5,7,0,4
34582,damantyatreti,damantyatreti,1,1,0,0,13
34583,pupphadāmaṃ,pupphadamam,38,35,3,0,11
34584,pupphānaṃ,pupphanam,87,85,2,0,9
34585,rāsikaraṇaṭṭhānamiccattho,rasikaranatthanamiccattho,1,1,0,0,25
34586,lavane,lavane,7,7,0,0,6
34587,mālāmālyāni,malamalyani,1,1,0,0,11
34588,pavattāya,pavattaya,181,177,4,0,9
34589,mālāya,malaya,7,7,0,0,6
34590,nāmānī,namani,9,7,2,0,6
34591,mālamālya,malamalya,1,0,1,0,9
34592,pupphepi,pupphepi,3,3,0,0,8
34593,pasune,pasune,1,1,0,0,6
34594,gandhaggāhite,gandhaggahite,1,1,0,0,13
34595,vatthādo,vatthado,2,2,0,0,8
34596,vuddhādi,vuddhadi,3,3,0,0,8
34597,vāsāpeti,vasapeti,3,3,0,0,8
34598,gāhāpeti,gahapeti,18,18,0,0,8
34599,vāsitaṃ,vasitam,9,8,1,0,7
34600,bhāvitā,bhavita,694,685,9,0,7
34601,bhāvitaṃ,bhavitam,212,182,30,0,8
34602,vāsito,vasito,6,6,0,0,6
34603,vāsitā,vasita,13,13,0,0,6
34604,para308,para308,100,100,0,0,7
34605,muddhamālāyaṃ,muddhamalayam,1,1,0,0,13
34606,tasi,tasi,3,0,3,0,4
34607,tasīyateti,tasiyateti,2,2,0,0,10
34608,uttaṃso,uttamso,4,2,2,0,7
34609,sekharo,sekharo,3,2,1,0,7
34610,muddhaṃ,muddham,29,26,3,0,7
34611,aveḷā,avela,2,0,2,0,5
34612,elo,elo,5,5,0,0,3
34613,āveḷā,avela,3,2,1,0,5
34614,dīghattaṃ,dighattam,15,15,0,0,9
34615,alaṅkataṃ,alankatam,60,54,6,0,9
34616,muddhamālyaṃ,muddhamalyam,1,0,1,0,12
34617,avataṃso,avatamso,1,1,0,0,8
34618,upasagganipātānaṃ,upasagganipatanam,10,10,0,0,17
34619,uddhaṃbhāvajotako,uddhambhavajotako,1,1,0,0,17
34620,tathottaṃ,tathottam,1,1,0,0,9
34621,seyyāyaṃ,seyyayam,2,2,0,0,8
34622,sayantyassaṃ,sayantyassam,1,1,0,0,12
34623,seyyā,seyya,162,140,22,0,5
34624,sayantyatreti,sayantyatreti,1,1,0,0,13
34625,sayanaṃ,sayanam,217,201,16,0,7
34626,ubhayatrapi,ubhayatrapi,1,1,0,0,11
34627,ettaṃ,ettam,36,36,0,0,5
34628,paro,paro,899,816,83,0,4
34629,asarūpā,asarupa,10,8,2,0,7
34630,alopo,alopo,16,16,0,0,5
34631,sayanīpyatra,sayanipyatra,1,1,0,0,12
34632,mañce,mance,175,170,5,0,5
34633,aki,aki,5,2,3,0,3
34634,dhāraṇocchāyapūjanesu,dharanocchayapujanesu,1,1,0,0,21
34635,khaṭāpyatra,khatapyatra,1,1,0,0,11
34636,khaṭyate,khatyate,1,1,0,0,8
34637,ākaṅkhate,akankhate,1,1,0,0,9
34638,sayanatthikehīti,sayanatthikehiti,1,1,0,0,16
34639,khaṭā,khata,1,0,1,0,5
34640,para309,para309,95,95,0,0,7
34641,mañcādhāre,mancadhare,1,1,0,0,10
34642,mañcassa,mancassa,34,34,0,0,8
34643,mañcādhāro,mancadharo,2,1,1,0,10
34644,paṭipādo,patipado,4,3,1,0,8
34645,mañcaṅge,mancange,2,2,0,0,8
34646,mañcāvayave,mancavayave,1,1,0,0,11
34647,aṭani,atani,4,3,1,0,5
34648,para310,para310,99,99,0,0,7
34649,kuḷīrapādādayo,kulirapadadayo,1,1,0,0,14
34650,mañcantarā,mancantara,2,0,2,0,10
34651,mañcabhedā,mancabheda,1,1,0,0,10
34652,kuḷīro,kuliro,13,12,1,0,6
34653,kakkaṭako,kakkatako,43,40,3,0,9
34654,saṇṭhānapādattā,santhanapadatta,1,1,0,0,15
34655,kuḷīrapādo,kulirapado,2,1,1,0,10
34656,aṭaniyaṃ,ataniyam,4,4,0,0,8
34657,āhacco,ahacco,1,1,0,0,6
34658,āhaccapādo,ahaccapado,3,1,2,0,10
34659,riccā,ricca,5,5,0,0,5
34660,yogavibhāgena,yogavibhagena,57,55,2,0,13
34661,ricca,ricca,11,2,9,0,5
34662,parapakkhe,parapakkhe,8,8,0,0,10
34663,tvā,tva,79,33,46,0,3
34664,aṭanichidde,atanichidde,2,2,0,0,11
34665,pavisitvā,pavisitva,1970,1955,15,0,9
34666,pādacchidde,padacchidde,1,1,0,0,11
34667,masārako,masarako,17,14,3,0,8
34668,bundena,bundena,5,5,0,0,7
34669,ekābaddhā,ekabaddha,42,42,0,0,9
34670,bundikābaddho,bundikabaddho,16,13,3,0,13
34671,ekārassittaṃ,ekarassittam,1,1,0,0,12
34672,mañcānaṃ,mancanam,11,10,1,0,8
34673,vipariyayenāpi,vipariyayenapi,1,1,0,0,14
34674,para311,para311,105,105,0,0,7
34675,sīsādhāre,sisadhare,1,1,0,0,9
34676,bibbohanaṃ,bibbohanam,37,32,5,0,10
34677,upadhīyate,upadhiyate,1,1,0,0,10
34678,sīsāsanaṃ,sisasanam,1,1,0,0,9
34679,upadhānaṃ,upadhanam,31,26,5,0,9
34680,sāmaññapīṭhe,samannapithe,1,1,0,0,12
34681,pīṭha,pitha,7,3,4,0,5
34682,hiṃsāsaṃkilesesu,himsasamkilesesu,4,2,2,0,16
34683,itthikatākāre,itthikatakare,1,1,0,0,13
34684,pācakā,pacaka,1,1,0,0,6
34685,vuttakammā,vuttakamma,1,1,0,0,10
34686,kammapaccayoyaṃ,kammapaccayoyam,1,1,0,0,15
34687,pīṭhaṃ,pitham,253,222,31,0,6
34688,suttampi,suttampi,53,53,0,0,8
34689,uttamārahapīṭhe,uttamarahapithe,1,1,0,0,15
34690,saṃpaccanakoṭilyapatithambhavilekhanesu,sampaccanakotilyapatithambhavilekhanesu,1,1,0,0,39
34691,gajadantādimayakesamajjaniyampi,gajadantadimayakesamajjaniyampi,1,1,0,0,31
34692,dvayamidamāhu,dvayamidamahu,1,1,0,0,13
34693,pasādhanī,pasadhani,1,1,0,0,9
34694,kaṅkatikāpyatra,kankatikapyatra,1,1,0,0,15
34695,pīṭhantare,pithantare,2,1,1,0,10
34696,dīghapīṭhe,dighapithe,1,1,0,0,10
34697,āsandī,asandi,13,9,4,0,6
34698,para312,para312,92,92,0,0,7
34699,āyāmavitthāravasena,ayamavittharavasena,3,3,0,0,19
34700,āsanappabhedo,asanappabhedo,2,2,0,0,13
34701,kojavo,kojavo,13,11,2,0,6
34702,kuju,kuju,2,0,2,0,4
34703,theyyakaraṇe,theyyakarane,3,1,2,0,12
34704,lomena,lomena,9,5,4,0,6
34705,gonako,gonako,11,8,3,0,6
34706,attharaṇe,attharane,5,5,0,0,9
34707,migalomapuṇṇatāya,migalomapunnataya,1,1,0,0,17
34708,uṇṇāmayaṃ,unnamayam,6,5,1,0,9
34709,dipubbova,dipubbova,1,1,0,0,9
34710,dirahito,dirahito,1,1,0,0,8
34711,tharīyateti,thariyateti,1,1,0,0,11
34712,attharaṇaṃ,attharanam,42,40,2,0,10
34713,saṃsibbanacittake,samsibbanacittake,1,1,0,0,17
34714,cittarūpamassatthīti,cittarupamassatthiti,1,1,0,0,20
34715,saṃsibbanena,samsibbanena,4,4,0,0,12
34716,cittarūpamassāti,cittarupamassati,1,1,0,0,16
34717,vānacittakaṃ,vanacittakam,2,1,1,0,12
34718,para313,para313,93,93,0,0,7
34719,nirantarapupphapaṭe,nirantarapupphapate,1,1,0,0,19
34720,ghanaṃ,ghanam,64,53,11,0,6
34721,sandhibhūtaṃ,sandhibhutam,1,1,0,0,12
34722,puppharūpametthāti,puppharupametthati,1,1,0,0,18
34723,ghanapupphaṃ,ghanapuppham,2,1,1,0,12
34724,paṭalametissātthīti,patalametissatthiti,1,1,0,0,19
34725,paṭalikā,patalika,9,6,3,0,8
34726,bahumudulome,bahumudulome,1,1,0,0,12
34727,setavatthe,setavatthe,1,1,0,0,10
34728,sivatthikehi,sivatthikehi,1,1,0,0,12
34729,addhendupāsāṇepi,addhendupasanepi,1,1,0,0,16
34730,pariyantesu,pariyantesu,12,12,0,0,11
34731,uddalomī,uddalomi,12,6,6,0,8
34732,uditaṃ,uditam,15,10,5,0,6
34733,pariyanteyeva,pariyanteyeva,2,2,0,0,13
34734,ekantalomī,ekantalomi,8,5,3,0,10
34735,pariyante,pariyante,111,102,9,0,9
34736,uddalomiekantalomino,uddalomiekantalomino,1,0,1,0,20
34737,vatticchāto,vatticchato,4,4,0,0,11
34738,samāsantaragesū,samasantaragesu,1,1,0,0,15
34739,gāthābhāvato,gathabhavato,18,18,0,0,12
34740,chandohānibhayā,chandohanibhaya,1,1,0,0,15
34741,visandhi,visandhi,2,2,0,0,8
34742,gāthāyampi,gathayampi,8,8,0,0,10
34743,agāthāyampi,agathayampi,1,1,0,0,11
34744,dhammasaṃvaṇṇanāyaṃ,dhammasamvannanayam,3,2,1,0,19
34745,itiādimāhā,itiadimaha,23,21,2,0,10
34746,kathanti,kathanti,243,239,4,0,8
34747,samāsantaraṅgesū,samasantarangesu,1,1,0,0,16
34748,imassāniccattā,imassaniccatta,1,1,0,0,14
34749,tatthāpi,tatthapi,472,467,5,0,8
34750,niddiṭṭhamaniccaṃ,nidditthamaniccam,2,2,0,0,17
34751,paribhāsitaṃ,paribhasitam,1,1,0,0,12
34752,naghaṭitaṃ,naghatitam,2,2,0,0,10
34753,aniccaṃ,aniccam,1360,1284,76,0,7
34754,paribhāsendusekhara,paribhasendusekhara,4,4,0,0,19
34755,para314,para314,93,93,0,0,7
34756,yathāvuttadvayameva,yathavuttadvayameva,1,1,0,0,19
34757,naccayoggaṃ,naccayoggam,2,0,2,0,11
34758,naccassa,naccassa,3,3,0,0,8
34759,yogyaṭṭhānabhūtaṃ,yogyatthanabhutam,1,1,0,0,17
34760,kuttaka,kuttaka,1,1,0,0,7
34761,padapūraṇe,padapurane,55,53,2,0,10
34762,naccayogyamhī,naccayogyamhi,1,1,0,0,13
34763,bhāvasattamī,bhavasattami,2,2,0,0,12
34764,kuttakaṃ,kuttakam,21,12,9,0,8
34765,sīhādirūpehi,sihadirupehi,1,1,0,0,12
34766,vicittarūpaṃ,vicittarupam,4,4,0,0,12
34767,vikatikā,vikatika,10,8,2,0,8
34768,kattuno,kattuno,43,43,0,0,7
34769,pakativikatisaṅkhātāvatthāvasena,pakativikatisankhatavatthavasena,1,1,0,0,32
34770,vatticchāvasena,vatticchavasena,8,8,0,0,15
34771,liṅgasaṅkhyāvibhattibhedañca,lingasankhyavibhattibhedanca,1,1,0,0,28
34772,yakkhabhattaṃ,yakkhabhattam,1,1,0,0,13
34773,sattappakaraṇāni,sattappakaranani,6,5,1,0,16
34774,abhidhammo,abhidhammo,89,76,13,0,10
34775,vikatiyā,vikatiya,2,2,0,0,8
34776,vuttatā,vuttata,9,8,1,0,7
34777,pakatiyāyeva,pakatiyayeva,7,7,0,0,12
34778,netarassa,netarassa,6,6,0,0,9
34779,tannissitabhāvenāppadhānato,tannissitabhavenappadhanato,1,1,0,0,27
34780,kaccāyanasāre,kaccayanasare,2,2,0,0,13
34781,sambandhādibhāvaṃ,sambandhadibhavam,1,1,0,0,17
34782,vattabbassa,vattabbassa,33,32,1,0,11
34783,aññatthassābhāvā,annatthassabhava,1,1,0,0,16
34784,vikatipyuccate,vikatipyuccate,1,1,0,0,14
34785,vācakena,vacakena,5,5,0,0,8
34786,liṅgabhedeneva,lingabhedeneva,1,1,0,0,14
34787,vikarīyateti,vikariyateti,1,1,0,0,12
34788,vikati,vikati,24,21,3,0,6
34789,para315,para315,88,88,0,0,7
34790,kaṭṭissakoseyyasaṅkhātānaṃ,kattissakoseyyasankhatanam,1,1,0,0,26
34791,dvinnamattharaṇānaṃ,dvinnamattharananam,1,1,0,0,19
34792,karaṇappakāraṃ,karanappakaram,12,12,0,0,14
34793,ariyāsāmaññamāha,ariyasamannamaha,1,1,0,0,16
34794,kaṭṭissa,kattissa,1,0,1,0,8
34795,kosiyakaṭṭissamayaṃ,kosiyakattissamayam,2,2,0,0,19
34796,kosiyasuttakaṭṭissavākehi,kosiyasuttakattissavakehi,1,1,0,0,25
34797,pakatamattharaṇaṃ,pakatamattharanam,2,2,0,0,17
34798,kaṭṭissaṃ,kattissam,28,16,12,0,9
34799,virūpekasesavasena,virupekasesavasena,4,4,0,0,18
34800,kosiyañca,kosiyanca,2,2,0,0,9
34801,kaṭṭissañca,kattissanca,4,4,0,0,11
34802,kaṭṭissāni,kattissani,2,1,1,0,10
34803,kosiyasuttena,kosiyasuttena,2,2,0,0,13
34804,pakatantu,pakatantu,1,1,0,0,9
34805,ratanapatisibbitaṃ,ratanapatisibbitam,1,0,1,0,18
34806,attharaṇañca,attharananca,2,2,0,0,12
34807,ajjhāharitabbaṃ,ajjhaharitabbam,36,36,0,0,15
34808,attharaṇa,attharana,1,0,1,0,9
34809,saddassānuṇṇāmayesvapi,saddassanunnamayesvapi,1,1,0,0,22
34810,pādantattā,padantatta,1,1,0,0,10
34811,garūsu,garusu,10,10,0,0,6
34812,gaṇhitabbo,ganhitabbo,7,7,0,0,10
34813,sattapaññāsamattā,sattapannasamatta,2,2,0,0,17
34814,paripuṇṇā,paripunna,159,149,10,0,9
34815,paṭhamapāde,pathamapade,27,27,0,0,11
34816,pannarasamattāti,pannarasamattati,1,1,0,0,16
34817,para316,para316,94,94,0,0,7
34818,divādi,divadi,50,8,42,0,6
34819,aññapadanivattanatthaṃ,annapadanivattanattham,1,1,0,0,22
34820,ādāse,adase,58,55,3,0,5
34821,ādissate,adissate,1,1,0,0,8
34822,ādāso,adaso,19,16,3,0,5
34823,dappaṇo,dappano,3,2,1,0,7
34824,makuropyatra,makuropyatra,1,1,0,0,12
34825,cammamayakīḷāguḷake,cammamayakilagulake,1,1,0,0,19
34826,vāsabhavanehi,vasabhavanehi,1,1,0,0,13
34827,yuvatīhi,yuvatihi,1,1,0,0,8
34828,kīḷāsambhavā,kilasambhava,1,1,0,0,12
34829,tappakkamenassābhidhānaṃ,tappakkamenassabhidhanam,1,1,0,0,24
34830,guḍi,gudi,2,1,1,0,4
34831,vedhane,vedhane,11,9,2,0,7
34832,ṇuko,nuko,9,7,2,0,4
34833,usse,usse,5,5,0,0,4
34834,gudda,gudda,1,0,1,0,5
34835,kīḷāyameva,kilayameva,3,2,1,0,10
34836,ṇḍo,ndo,3,1,2,0,3
34837,kudda,kudda,1,0,1,0,5
34838,bbada,bbada,1,0,1,0,5
34839,bījanīmatte,bijanimatte,1,1,0,0,11
34840,vaṭi,vati,5,0,5,0,4
34841,tālavaṇṭehi,talavantehi,5,5,0,0,11
34842,tālavaṇṭaṃ,talavantam,56,48,8,0,10
34843,vaṇṭaṃ,vantam,22,18,4,0,6
34844,bījanādikaraṇatthaṃ,bijanadikaranattham,1,1,0,0,19
34845,bhājito,bhajito,2,2,0,0,7
34846,tālapattāvayavo,talapattavayavo,1,1,0,0,15
34847,tālavaṇṭa,talavanta,2,1,1,0,9
34848,yathāvuttavacanatthayogepi,yathavuttavacanatthayogepi,2,2,0,0,26
34849,bījanīsāmaññe,bijanisamanne,1,1,0,0,13
34850,katabījanimeva,katabijanimeva,1,1,0,0,14
34851,tālatālavaṇṭaṃ,talatalavantam,1,1,0,0,14
34852,tilassa,tilassa,4,4,0,0,7
34853,telaṃ,telam,393,364,29,0,5
34854,sugatacīvaranti,sugatacivaranti,1,1,0,0,15
34855,bijanti,bijanti,1,1,0,0,7
34856,vāyunā,vayuna,38,38,0,0,6
34857,yojayanti,yojayanti,2,2,0,0,9
34858,bījanī,bijani,27,23,4,0,6
34859,ussī,ussi,1,1,0,0,4
34860,assī,assi,8,8,0,0,4
34861,byajanaṃpyatra,byajanampyatra,1,1,0,0,14
34862,para317,para317,95,95,0,0,7
34863,caṅkoṭake,cankotake,5,4,1,0,9
34864,karaḍi,karadi,3,0,3,0,6
34865,bhājanatthe,bhajanatthe,3,3,0,0,11
34866,kappūrādisampuṭe,kappuradisampute,1,1,0,0,16
34867,sarūpakādisampuṭe,sarupakadisampute,1,1,0,0,17
34868,samuggacchatīti,samuggacchatiti,1,1,0,0,15
34869,samuggo,samuggo,8,6,2,0,7
34870,puṭa,puta,9,2,7,0,4
34871,saṃsilesane,samsilesane,2,2,0,0,11
34872,methune,methune,24,20,4,0,7
34873,gāmavāsīnaṃ,gamavasinam,38,33,5,0,11
34874,ācāro,acaro,65,59,6,0,5
34875,gāmadhammo,gamadhammo,14,12,2,0,10
34876,gāma,gama,29,22,7,0,4
34877,gāmavāsino,gamavasino,40,40,0,0,10
34878,asataṃ,asatam,67,60,7,0,6
34879,asappurisānaṃ,asappurisanam,18,17,1,0,13
34880,saddhammapaṭipakkhattā,saddhammapatipakkhatta,1,1,0,0,22
34881,asaddhammo,asaddhammo,28,22,6,0,10
34882,byaya,byaya,4,0,4,0,5
34883,byayati,byayati,5,5,0,0,7
34884,balametenāti,balametenati,1,1,0,0,12
34885,byavāyo,byavayo,3,1,2,0,7
34886,avāyo,avayo,2,2,0,0,5
34887,mithunānaṃ,mithunanam,9,9,0,0,10
34888,samānacchandānaṃ,samanacchandanam,2,2,0,0,16
34889,methunaṃ,methunam,486,430,56,0,8
34890,tadaññesu,tadannesu,11,11,0,0,9
34891,upacāro,upacaro,143,131,12,0,7
34892,para318,para318,99,99,0,0,7
34893,vivāhe,vivahe,2,2,0,0,6
34894,vaha,vaha,22,7,15,0,4
34895,aññamaññassa,annamannassa,342,329,13,0,12
34896,pāṇiggaho,paniggaho,1,0,1,0,9
34897,ubbāho,ubbaho,2,2,0,0,6
34898,pāṇipīḷanaṃpyatra,panipilanampyatra,1,1,0,0,17
34899,dhammakāmatthā,dhammakamattha,2,2,0,0,14
34900,āgamaniddiṭṭho,agamaniddittho,1,1,0,0,14
34901,samācāro,samacaro,15,15,0,0,8
34902,visayavisayisannipātajaṃ,visayavisayisannipatajam,1,1,0,0,24
34903,sabbopakaraṇaṃ,sabbopakaranam,1,1,0,0,14
34904,samokkhakā,samokkhaka,2,1,1,0,10
34905,mokkhasahitā,mokkhasahita,1,1,0,0,12
34906,catubbaggo,catubbaggo,1,1,0,0,10
34907,tivaggena,tivaggena,1,1,0,0,9
34908,visaṃyutto,visamyutto,117,109,8,0,10
34909,tulyabalehi,tulyabalehi,1,1,0,0,11
34910,dhammādīhi,dhammadihi,8,8,0,0,10
34911,padhānehi,padhanehi,1,1,0,0,9
34912,catubhadra,catubhadra,1,0,1,0,10
34913,para319-320,para319-320,1,1,0,0,11
34914,khujje,khujje,15,15,0,0,6
34915,vajjatīti,vajjatiti,5,3,2,0,9
34916,khujjo,khujjo,24,23,1,0,6
34917,nindāyaṃ,nindayam,33,31,2,0,8
34918,rassasarīre,rassasarire,1,1,0,0,11
34919,byāmappamāṇaṃ,byamappamanam,2,2,0,0,13
34920,lakuḍi,lakudi,1,0,1,0,6
34921,vāmanatthe,vamanatthe,1,1,0,0,10
34922,laku,laku,4,4,0,0,4
34923,lakuṇḍako,lakundako,18,11,7,0,9
34924,paṅguḷajane,pangulajane,1,1,0,0,11
34925,parena,parena,268,256,12,0,6
34926,aṅgatīti,angatiti,3,3,0,0,8
34927,paṅguḷo,pangulo,6,4,2,0,7
34928,pīṭhena,pithena,9,9,0,0,7
34929,pīṭhasappī,pithasappi,54,48,6,0,10
34930,paṅgu,pangu,5,4,1,0,5
34931,chinno,chinno,64,62,2,0,6
34932,gamanādiiriyāpatho,gamanadiiriyapatho,1,1,0,0,18
34933,chinniriyāpatho,chinniriyapatho,8,7,1,0,15
34934,akkhasadisā,akkhasadisa,1,1,0,0,11
34935,akkhe,akkhe,14,14,0,0,5
34936,bhinne,bhinne,125,124,1,0,6
34937,akkhajaṅghāya,akkhajanghaya,1,1,0,0,13
34938,bhinnāyāti,bhinnayati,1,1,0,0,10
34939,khañje,khanje,2,2,0,0,6
34940,gativekalye,gativekalye,2,2,0,0,11
34941,khañjatīti,khanjatiti,4,4,0,0,10
34942,khoḍi,khodi,1,0,1,0,5
34943,gatipaṭighāte,gatipatighate,4,1,3,0,13
34944,avākye,avakye,1,1,0,0,6
34945,vattumasakkuṇeyyattā,vattumasakkuneyyatta,4,4,0,0,20
34946,migasadisoti,migasadisoti,1,1,0,0,12
34947,mūgo,mugo,56,52,4,0,4
34948,issū,issu,1,1,0,0,4
34949,suññavaco,sunnavaco,2,1,1,0,9
34950,hatthādivaṅko,hatthadivanko,2,2,0,0,13
34951,kuṇī,kuni,43,36,7,0,4
34952,kuṇanaṃ,kunanam,5,5,0,0,7
34953,kuṇo,kuno,5,5,0,0,4
34954,hatthādivekalyaṃ,hatthadivekalyam,1,1,0,0,16
34955,tametassatthīti,tametassatthiti,2,2,0,0,15
34956,kuṇa,kuna,9,0,9,0,4
34957,iccādipayogā,iccadipayoga,1,1,0,0,12
34958,apāṅgadassane,apangadassane,1,1,0,0,13
34959,kekaro,kekaro,6,4,2,0,6
34960,para321,para321,98,98,0,0,7
34961,nikkesasīse,nikkesasise,1,1,0,0,11
34962,nikkesaṃ,nikkesam,1,1,0,0,8
34963,sīsametassa,sisametassa,1,1,0,0,11
34964,khalane,khalane,2,2,0,0,7
34965,āṭo,ato,6,5,1,0,3
34966,nikkesattā,nikkesatta,1,1,0,0,10
34967,khallāṭo,khallato,2,1,1,0,8
34968,khuramuṇḍasīse,khuramundasise,1,1,0,0,14
34969,muṇḍa,munda,1,0,1,0,5
34970,khaṇḍane,khandane,7,6,1,0,8
34971,bhaṇḍa,bhanda,9,2,7,0,6
34972,paribhāsane,paribhasane,11,7,4,0,11
34973,muṇḍako,mundako,20,17,3,0,7
34974,muṇḍikopyatra,mundikopyatra,1,1,0,0,13
34975,akkhīnaṃ,akkhinam,53,52,1,0,8
34976,ekenākkhinā,ekenakkhina,1,1,0,0,11
34977,kāṇo,kano,50,43,7,0,4
34978,saddagatinimīlanesu,saddagatinimilanesu,1,1,0,0,19
34979,kaṇati,kanati,7,7,0,0,6
34980,nimīlatīti,nimilatiti,5,5,0,0,10
34981,nimīlanaṃ,nimilanam,7,6,1,0,9
34982,ekenevakkhinā,ekenevakkhina,1,1,0,0,13
34983,kāṇoti,kanoti,16,5,11,0,6
34984,ekacchikāṇo,ekacchikano,4,3,1,0,11
34985,ubhayacchikāṇo,ubhayacchikano,4,3,1,0,14
34986,dvayena,dvayena,31,28,3,0,7
34987,akkhidvayena,akkhidvayena,1,1,0,0,12
34988,andho,andho,162,153,9,0,5
34989,andha,andha,11,2,9,0,5
34990,dassanūpasaṃhāre,dassanupasamhare,1,1,0,0,16
34991,para322,para322,95,95,0,0,7
34992,naṭṭhasotappasāde,natthasotappasade,1,1,0,0,17
34993,hīno,hino,253,222,31,0,4
34994,sutihīno,sutihino,3,2,1,0,8
34995,eḷopyatra,elopyatra,1,1,0,0,9
34996,gilānasāmaññe,gilanasamanne,1,1,0,0,13
34997,hāsakkhaye,hasakkhaye,3,3,0,0,10
34998,byādhirogosañjāto,byadhirogosanjato,1,1,0,0,17
34999,byādhito,byadhito,35,32,3,0,8
35000,ata,ata,12,4,8,0,3
35001,sātaccagamane,sataccagamane,6,5,1,0,13
35002,āturo,aturo,34,29,5,0,5
35003,āmayāvī,amayavi,1,1,0,0,7
35004,vikato,vikato,2,2,0,0,6
35005,apaṭu,apatu,2,1,1,0,5
35006,abbhamito,abbhamito,1,1,0,0,9
35007,abbhāntopyatra,abbhantopyatra,1,1,0,0,14
35008,vātādipakopo,vatadipakopo,1,1,0,0,12
35009,rogaviseso,rogaviseso,1,1,0,0,10
35010,ummatto,ummatto,25,23,2,0,7
35011,vātādidosehi,vatadidosehi,1,1,0,0,12
35012,ummatta,ummatta,1,0,1,0,7
35013,vāccaliṅge,vaccalinge,1,1,0,0,10
35014,yuttatāya,yuttataya,21,21,0,0,9
35015,vāccaliṅgikā,vaccalingika,2,2,0,0,12
35016,khujjaṃ,khujjam,23,23,0,0,7
35017,ummattā,ummatta,4,4,0,0,7
35018,ummattaṃ,ummattam,11,11,0,0,8
35019,para323,para323,98,98,0,0,7
35020,navakaṃ,navakam,62,60,2,0,7
35021,rogamatte,rogamatte,1,1,0,0,9
35022,taki,taki,4,1,3,0,4
35023,kicchajīvane,kicchajivane,11,8,3,0,12
35024,taṅkatīti,tankatiti,1,1,0,0,9
35025,ātaṅko,atanko,15,12,3,0,6
35026,roge,roge,81,74,7,0,4
35027,āmayati,amayati,1,1,0,0,7
35028,rujjatīti,rujjatiti,3,3,0,0,9
35029,āmayo,amayo,5,4,1,0,5
35030,kāritalopābhāvo,karitalopabhavo,1,1,0,0,15
35031,vijjhane,vijjhane,5,3,2,0,8
35032,vijjhatīti,vijjhatiti,41,30,11,0,10
35033,bādha,badha,8,3,5,0,5
35034,ādhayo,adhayo,1,1,0,0,6
35035,manopīḷā,manopila,1,1,0,0,8
35036,yasmiṃsa,yasmimsa,1,1,0,0,8
35037,ādhi,adhi,3,3,0,0,4
35038,mānasī,manasi,2,2,0,0,6
35039,byathā,byatha,4,4,0,0,6
35040,rogegado,rogegado,1,1,0,0,8
35041,kuverāyudhe,kuverayudhe,1,1,0,0,11
35042,gado,gado,15,14,1,0,4
35043,bhātharikaṇhassa,bhatharikanhassa,1,1,0,0,16
35044,āmaye,amaye,1,1,0,0,5
35045,cāyudhe,cayudhe,1,1,0,0,7
35046,ruja,ruja,11,2,9,0,4
35047,gilānassa,gilanassa,266,257,9,0,9
35048,gelaññaṃ,gelannam,20,18,2,0,8
35049,gatisaṅkhyānesu,gatisankhyanesu,3,2,1,0,15
35050,akalaṃ,akalam,1,1,0,0,6
35051,akallaṃ,akallam,4,2,2,0,7
35052,upatāpopyatra,upatapopyatra,1,1,0,0,13
35053,khayaroge,khayaroge,2,2,0,0,9
35054,rasādisattadhātuyo,rasadisattadhatuyo,2,2,0,0,18
35055,sosayatīti,sosayatiti,1,1,0,0,10
35056,soso,soso,27,26,1,0,4
35057,susa,susa,15,3,12,0,4
35058,khi,khi,16,2,14,0,3
35059,khayatīti,khayatiti,1,1,0,0,9
35060,rājayakkhāpyatra,rajayakkhapyatra,1,1,0,0,16
35061,para324,para324,95,95,0,0,7
35062,nāsaroge,nasaroge,1,1,0,0,8
35063,apihitā,apihita,6,6,0,0,7
35064,pīnāso,pinaso,1,0,1,0,6
35065,pīnaso,pinaso,3,2,1,0,6
35066,upasaggato,upasaggato,22,17,5,0,10
35067,nāsāya,nasaya,41,36,5,0,6
35068,nasā,nasa,2,1,1,0,4
35069,desaṃ,desam,161,138,23,0,5
35070,kubbanti,kubbanti,53,48,5,0,8
35071,apissākāralopo,apissakaralopo,3,3,0,0,14
35072,vaṇṇanāso,vannanaso,3,3,0,0,9
35073,rājayakkhā,rajayakkha,2,2,0,0,10
35074,patīssāyo,patissayo,1,1,0,0,9
35075,āpīnaso,apinaso,1,1,0,0,7
35076,patissāyo,patissayo,1,1,0,0,9
35077,patissayopyatra,patissayopyatra,1,1,0,0,15
35078,vejjaganthe,vejjaganthe,2,1,1,0,11
35079,pīnasapatissāyānaṃ,pinasapatissayanam,1,1,0,0,18
35080,abhihito,abhihito,4,4,0,0,8
35081,ānahyate,anahyate,1,1,0,0,8
35082,visussate,visussate,1,1,0,0,9
35083,kilidyate,kilidyate,1,1,0,0,9
35084,dhūpati,dhupati,4,4,0,0,7
35085,gandharase,gandharase,3,3,0,0,10
35086,vijaññā,vijanna,31,30,1,0,7
35087,tamapīnasenāti,tamapinasenati,1,1,0,0,14
35088,ānaddhā,anaddha,1,1,0,0,7
35089,pihitā,pihita,45,45,0,0,6
35090,tanusāvappasekinī,tanusavappasekini,1,1,0,0,17
35091,galatāloṭṭhasoso,galatalotthasoso,1,1,0,0,16
35092,nittodo,nittodo,1,1,0,0,7
35093,saṅkhakadvaye,sankhakadvaye,1,1,0,0,13
35094,paghāto,paghato,1,1,0,0,7
35095,patissāyoti,patissayoti,1,1,0,0,11
35096,lakkhitoti,lakkhitoti,1,1,0,0,10
35097,tvabhedenottaṃ,tvabhedenottam,1,1,0,0,14
35098,rujatyattho,rujatyattho,1,1,0,0,11
35099,nāsikāya,nasikaya,17,17,0,0,8
35100,nāsikārogo,nasikarogo,2,1,1,0,10
35101,siṅghānikā,singhanika,4,2,2,0,10
35102,āghāne,aghane,2,1,1,0,6
35103,siṅghatīti,singhatiti,1,1,0,0,10
35104,siṅghānaṃ,singhanam,1,1,0,0,9
35105,sandatīti,sandatiti,17,13,4,0,9
35106,vaṇamatte,vanamatte,1,1,0,0,9
35107,napuṃsakeyeva,napumsakeyeva,1,1,0,0,13
35108,vaṇa,vana,6,1,5,0,4
35109,gattavicuṇṇane,gattavicunnane,2,1,1,0,14
35110,vaṇo,vano,76,74,2,0,4
35111,phoṭe,phote,4,4,0,0,5
35112,phuṭa,phuta,9,0,9,0,5
35113,phoṭo,photo,15,13,2,0,5
35114,pīḷako,pilako,1,1,0,0,6
35115,pīḷakā,pilaka,34,31,3,0,6
35116,pīḷakaṃ,pilakam,7,6,1,0,7
35117,para325,para325,95,95,0,0,7
35118,pakkavaṇādīsu,pakkavanadisu,1,1,0,0,13
35119,sañjātaduggandhavisese,sanjataduggandhavisese,1,1,0,0,22
35120,pūya,puya,1,0,1,0,4
35121,visaraṇe,visarane,10,5,5,0,8
35122,lohitanissaraṇaroge,lohitanissaranaroge,1,1,0,0,19
35123,rattassa,rattassa,30,25,5,0,8
35124,lohitassa,lohitassa,33,33,0,0,9
35125,saṇṭhānamatikkamitvā,santhanamatikkamitva,1,1,0,0,20
35126,rattātisāro,rattatisaro,1,0,1,0,11
35127,pakkhandati,pakkhandati,223,215,8,0,11
35128,nissaratīti,nissaratiti,5,4,1,0,11
35129,pakkhandikā,pakkhandika,15,14,1,0,11
35130,titi,titi,2,2,0,0,4
35131,pakkamādīhinto,pakkamadihinto,1,1,0,0,14
35132,tissaṃ,tissam,96,94,2,0,6
35133,parakakārassa,parakakarassa,1,1,0,0,13
35134,apamāre,apamare,4,4,0,0,7
35135,pādabhede,padabhede,1,1,0,0,9
35136,bhedanaṃ,bhedanam,56,48,8,0,8
35137,daraṇaṃ,daranam,3,3,0,0,7
35138,pādaphoṭo,padaphoto,2,1,1,0,9
35139,bhede,bhede,104,95,9,0,5
35140,virūpo,virupo,57,56,1,0,6
35141,hetubhūtāyāti,hetubhutayati,1,1,0,0,13
35142,vipādikā,vipadika,3,1,2,0,8
35143,pubbākārassittaṃ,pubbakarassittam,1,1,0,0,16
35144,vidārīyamānattā,vidariyamanatta,1,1,0,0,15
35145,vipajjamāno,vipajjamano,4,4,0,0,11
35146,para326,para326,99,99,0,0,7
35147,vuḍḍhippattaṇḍakosaroge,vuddhippattandakosaroge,1,1,0,0,23
35148,vuḍḍhippatto,vuddhippatto,16,16,0,0,12
35149,vuḍḍhirogo,vuddhirogo,2,1,1,0,10
35150,vātaṇḍaṃ,vatandam,2,1,1,0,8
35151,thūlapādaroge,thulapadaroge,1,1,0,0,13
35152,ghanābhāvato,ghanabhavato,1,1,0,0,12
35153,sīpadaṃ,sipadam,2,1,1,0,7
35154,bhāro,bharo,337,319,18,0,5
35155,bhārapādatā,bharapadata,2,1,1,0,11
35156,kaṇḍuyaṃ,kanduyam,1,1,0,0,8
35157,kaṇḍa,kanda,12,10,2,0,5
35158,dīghe,dighe,76,68,8,0,5
35159,kaṇḍū,kandu,2,2,0,0,5
35160,saddova,saddova,20,20,0,0,7
35161,kaṇḍūti,kanduti,9,1,8,0,7
35162,curādittā,curaditta,10,10,0,0,9
35163,kaṇḍūyā,kanduya,2,1,1,0,7
35164,lopābhāvo,lopabhavo,8,8,0,0,9
35165,khajja,khajja,11,5,6,0,6
35166,theyyakaraṇabyathanesu,theyyakaranabyathanesu,1,1,0,0,22
35167,kaṇḍūvanaṃ,kanduvanam,2,1,1,0,10
35168,para327,para327,93,93,0,0,7
35169,kacchuyaṃ,kacchuyam,1,1,0,0,9
35170,khasurogo,khasurogo,1,1,0,0,9
35171,pātyattānanti,patyattananti,1,1,0,0,13
35172,pāmaṃ,pamam,4,3,1,0,5
35173,pāmāpyatthi,pamapyatthi,1,1,0,0,11
35174,rājādi,rajadi,6,6,0,0,6
35175,tacchati,tacchati,16,16,0,0,8
35176,kāsanti,kasanti,2,2,0,0,7
35177,vitacchikā,vitacchika,13,12,1,0,10
35178,taccha,taccha,10,5,5,0,6
35179,M0.0227,M0.0227,59,59,0,0,7
35180,vivacchikā,vivacchika,1,1,0,0,10
35181,viccaccikā,viccaccika,1,1,0,0,10
35182,vaccha,vaccha,217,213,4,0,6
35183,paribhāsanatajjanesu,paribhasanatajjanesu,4,3,1,0,20
35184,tilakāḷakantaṃ,tilakalakantam,1,1,0,0,14
35185,sothe,sothe,1,1,0,0,5
35186,gativuḍḍhīsu,gativuddhisu,1,1,0,0,12
35187,sayathu,sayathu,4,3,1,0,7
35188,sophopyatra,sophopyatra,1,1,0,0,11
35189,bahulaṃ,bahulam,644,626,18,0,7
35190,sopho,sopho,2,0,2,0,5
35191,phāya,phaya,3,0,3,0,5
35192,arisaroge,arisaroge,1,1,0,0,9
35193,amaṅgalatāya,amangalataya,1,1,0,0,12
35194,dunnāmaṃ,dunnamam,4,1,3,0,8
35195,dīghakosikāyaṃ,dighakosikayam,1,1,0,0,14
35196,dunnāmā,dunnama,1,1,0,0,7
35197,ari,ari,24,21,3,0,3
35198,satīti,satiti,339,170,169,0,6
35199,arisaṃ,arisam,4,2,2,0,6
35200,vamanaroge,vamanaroge,1,1,0,0,10
35201,chadda,chadda,4,2,2,0,6
35202,vamane,vamane,4,3,1,0,6
35203,vamu,vamu,16,2,14,0,4
35204,vamidhupyatra,vamidhupyatra,1,1,0,0,13
35205,chaddikā,chaddika,2,1,1,0,8
35206,vami,vami,49,47,2,0,4
35207,vamathu,vamathu,8,7,1,0,7
35208,para328-329,para328-329,1,1,0,0,11
35209,paritāpe,paritape,8,7,1,0,8
35210,paritapanaṃ,paritapanam,1,1,0,0,11
35211,santāpanaṃ,santapanam,15,14,1,0,10
35212,paritāpo,paritapo,4,3,1,0,8
35213,tilakāḷake,tilakalake,3,2,1,0,10
35214,tilasaṇṭhānaṃ,tilasanthanam,2,2,0,0,13
35215,tilaṃ,tilam,20,19,1,0,5
35216,tilakāḷako,tilakalako,3,2,1,0,10
35217,mahāvireko,mahavireko,2,1,1,0,10
35218,visūcikā,visucika,12,10,2,0,8
35219,sūcikā,sucika,5,3,2,0,6
35220,M0.0228,M0.0228,61,61,0,0,7
35221,socetīti,socetiti,4,3,1,0,8
35222,bahumosaraṇattā,bahumosaranatta,1,1,0,0,15
35223,vireko,vireko,4,4,0,0,6
35224,rica,rica,10,2,8,0,4
35225,viyojanasampucchanesu,viyojanasampucchanesu,1,1,0,0,21
35226,bhagandalādayo,bhagandaladayo,1,1,0,0,14
35227,āmayantarā,amayantara,1,0,1,0,10
35228,rogabhedā,rogabheda,2,2,0,0,9
35229,gudasamīpajo,gudasamipajo,1,1,0,0,12
35230,vaṇaviseso,vanaviseso,2,2,0,0,10
35231,bhagandalā,bhagandala,11,9,2,0,10
35232,dārayatīti,darayatiti,2,2,0,0,10
35233,rūḷhīto,rulhito,2,2,0,0,7
35234,nipātito,nipatito,6,6,0,0,8
35235,bhagandaropyatra,bhagandaropyatra,1,1,0,0,16
35236,meho,meho,3,2,1,0,4
35237,muttameho,muttameho,2,2,0,0,9
35238,bahumuttatāya,bahumuttataya,1,1,0,0,13
35239,madhumeho,madhumeho,15,13,2,0,9
35240,rattameho,rattameho,1,0,1,0,9
35241,sukkameho,sukkameho,2,1,1,0,9
35242,tyanekavidho,tyanekavidho,1,1,0,0,12
35243,muttanti,muttanti,17,17,0,0,8
35244,jaratīti,jaratiti,2,2,0,0,8
35245,saddakucchāyaṃ,saddakucchayam,2,1,1,0,14
35246,dittiyañca,dittiyanca,7,5,2,0,10
35247,kāsatīti,kasatiti,3,3,0,0,8
35248,kāso,kaso,27,24,3,0,4
35249,asatīti,asatiti,29,8,21,0,7
35250,kuā,kua,1,0,1,0,3
35251,sasanaṃ,sasanam,7,7,0,0,7
35252,sasanametassatthīti,sasanametassatthiti,1,1,0,0,19
35253,tacovikāre,tacovikare,1,1,0,0,10
35254,sittaṃ,sittam,6,5,1,0,6
35255,sūla,sula,6,1,5,0,4
35256,sūlaṃ,sulam,49,44,5,0,5
35257,viddadhi,viddadhi,1,1,0,0,8
35258,asmarī,asmari,1,1,0,0,6
35259,muttakicchādayopyanekā,muttakicchadayopyaneka,1,1,0,0,22
35260,vejje,vejje,15,15,0,0,5
35261,āyubbedasaṅkhātaṃ,ayubbedasankhatam,2,2,0,0,17
35262,vejjo,vejjo,82,80,2,0,5
35263,tassedamaññatthesu,tassedamannatthesu,4,2,2,0,18
35264,dya,dya,13,4,9,0,3
35265,bhisajjati,bhisajjati,1,1,0,0,10
35266,cikicchatīti,cikicchatiti,1,1,0,0,12
35267,rogahārī,rogahari,2,1,1,0,8
35268,kevalopi,kevalopi,6,6,0,0,8
35269,ānayanāpanayanesu,anayanapanayanesu,1,1,0,0,17
35270,manoharo,manoharo,19,19,0,0,8
35271,dukkhaharo,dukkhaharo,1,1,0,0,10
35272,iccādīsu,iccadisu,51,51,0,0,8
35273,tikicchatīti,tikicchatiti,2,2,0,0,12
35274,agadakaropyatra,agadakaropyatra,1,1,0,0,15
35275,agadaṃ,agadam,20,18,2,0,6
35276,agadakaro,agadakaro,1,0,1,0,9
35277,para330,para330,105,105,0,0,7
35278,M0.0229,M0.0229,57,57,0,0,7
35279,sallanīharaṇe,sallaniharane,1,1,0,0,13
35280,paviṭṭhasarādisallassa,pavitthasaradisallassa,1,1,0,0,22
35281,nīharaṇo,niharano,1,1,0,0,8
35282,sallavejjo,sallavejjo,2,1,1,0,10
35283,sallaṃ,sallam,166,134,32,0,6
35284,sallakatto,sallakatto,48,47,1,0,10
35285,paṭikāre,patikare,1,1,0,0,8
35286,tikicchanaṃ,tikicchanam,10,10,0,0,11
35287,tikicchā,tikiccha,22,21,1,0,8
35288,tikicchāyaṃ,tikicchayam,5,5,0,0,11
35289,ririyā,ririya,2,2,0,0,6
35290,osadhe,osadhe,3,3,0,0,6
35291,bhisajānamidaṃ,bhisajanamidam,2,2,0,0,14
35292,bhesajjaṃ,bhesajjam,511,484,27,0,9
35293,agado,agado,48,46,2,0,5
35294,bhesajaṃ,bhesajam,4,2,2,0,8
35295,rogamosāpetīti,rogamosapetiti,1,1,0,0,14
35296,osadhaṃ,osadham,99,92,7,0,7
35297,asaṃyogadabbaṃ,asamyogadabbam,1,1,0,0,14
35298,saṃyojitaṃ,samyojitam,9,9,0,0,10
35299,jāyupyatra,jayupyatra,1,1,0,0,10
35300,para331,para331,94,94,0,0,7
35301,ārogye,arogye,17,16,1,0,6
35302,anatthakārakattā,anatthakarakatta,1,1,0,0,16
35303,kucchitākārena,kucchitakarena,5,5,0,0,14
35304,rogā,roga,66,56,10,0,4
35305,āmayassābhāvo,amayassabhavo,1,1,0,0,13
35306,anāmayaṃ,anamayam,77,73,4,0,8
35307,abyayībhāvo,abyayibhavo,24,19,5,0,11
35308,arogassa,arogassa,8,8,0,0,8
35309,kusalānāmayārogyanti,kusalanamayarogyanti,1,1,0,0,20
35310,samāhāradvando,samaharadvando,11,11,0,0,14
35311,anāmayajane,anamayajane,1,1,0,0,11
35312,sabbiriyāpathesūti,sabbiriyapathesuti,1,1,0,0,18
35313,kallo,kallo,54,45,9,0,5
35314,arogatā,arogata,11,11,0,0,7
35315,kalyo,kalyo,1,1,0,0,5
35316,aṅguttaranikāyaṭīkāyaṃ,anguttaranikayatikayam,1,0,1,0,22
35317,nirāmayo,niramayo,3,2,1,0,8
35318,vuttopyatra,vuttopyatra,1,1,0,0,11
35319,jīvitavutti,jivitavutti,18,16,2,0,11
35320,rogato,rogato,81,68,13,0,6
35321,niggatajane,niggatajane,1,1,0,0,11
35322,ullāgho,ullagho,1,1,0,0,7
35323,lāgha,lagha,2,0,2,0,5
35324,rogavimutyattho,rogavimutyattho,1,1,0,0,15
35325,narādittā,naraditta,1,1,0,0,9
35326,narappadhānattā,narappadhanatta,1,1,0,0,15
35327,naravaggo,naravaggo,2,2,0,0,9
35328,catubbaṇṇavaggavaṇṇanā,catubbannavaggavannana,2,2,0,0,22
35329,para332,para332,98,98,0,0,7
35330,vaṃse,vamse,76,73,3,0,5
35331,santānabandhūsu,santanabandhusu,1,1,0,0,15
35332,saṃtanu,samtanu,1,0,1,0,7
35333,abhijano,abhijano,2,1,1,0,8
35334,tāyatīti,tayatiti,42,39,3,0,8
35335,gotrampi,gotrampi,1,1,0,0,8
35336,tismāti,tismati,1,1,0,0,7
35337,pantivitthāragottesu,pantivittharagottesu,1,1,0,0,20
35338,kavibhī,kavibhi,1,1,0,0,7
35339,paramparā,parampara,54,53,1,0,9
35340,puttakaññāsu,puttakannasu,1,1,0,0,12
35341,khattiyādayo,khattiyadayo,28,26,2,0,12
35342,khattiyabrāhmaṇavessasuddā,khattiyabrahmanavessasudda,1,1,0,0,26
35343,aññamaññamasaṅkarato,annamannamasankarato,1,1,0,0,20
35344,vaṇṇetabbato,vannetabbato,5,5,0,0,12
35345,ṭhapetabbato,thapetabbato,4,4,0,0,12
35346,vaṇṇāti,vannati,21,6,15,0,7
35347,ṭhapane,thapane,16,16,0,0,7
35348,para333-334,para333-334,1,1,0,0,11
35349,M0.0231,M0.0231,58,58,0,0,7
35350,kulīne,kuline,4,4,0,0,6
35351,kulassāpaccaṃ,kulassapaccam,1,1,0,0,13
35352,kulino,kulino,1,0,1,0,6
35353,saparatthaṃ,saparattham,2,2,0,0,11
35354,sādhetīti,sadhetiti,83,78,5,0,9
35355,saṃsiddhimhi,samsiddhimhi,5,5,0,0,12
35356,sabhyo,sabhyo,4,2,2,0,6
35357,upagantabboti,upagantabboti,1,1,0,0,13
35358,ayyo,ayyo,406,390,16,0,4
35359,mahākulassāpaccaṃ,mahakulassapaccam,1,1,0,0,17
35360,mahākulo,mahakulo,2,1,1,0,8
35361,bhūbhuja,bhubhuja,1,0,1,0,8
35362,rājasāmaññe,rajasamanne,1,1,0,0,11
35363,atitejavantatāya,atitejavantataya,1,1,0,0,16
35364,rājate,rajate,12,9,3,0,6
35365,dibbateti,dibbateti,1,1,0,0,9
35366,bhuyā,bhuya,13,13,0,0,5
35367,bhuṃ,bhum,6,6,0,0,4
35368,patthivo,patthivo,8,7,1,0,8
35369,jagatiṃ,jagatim,8,7,1,0,7
35370,jagatipālo,jagatipalo,3,2,1,0,10
35371,disampati,disampati,64,62,2,0,9
35372,disaṭṭhe,disatthe,1,1,0,0,8
35373,bhūbhujo,bhubhujo,7,6,1,0,8
35374,pālanajjhoharaṇesu,palanajjhoharanesu,1,1,0,0,18
35375,rudhādi,rudhadi,20,3,17,0,7
35376,mahikhitopyatra,mahikhitopyatra,1,1,0,0,15
35377,mahiṃ,mahim,98,88,10,0,5
35378,akhi,akhi,1,1,0,0,4
35379,gatavā,gatava,1,1,0,0,6
35380,mahīkhito,mahikhito,1,1,0,0,9
35381,para335,para335,100,100,0,0,7
35382,muddhābhisitte,muddhabhisitte,4,4,0,0,14
35383,jātikhattiye,jatikhattiye,1,1,0,0,12
35384,rājajacce,rajajacce,1,1,0,0,9
35385,khattiye,khattiye,100,97,3,0,8
35386,rājañño,rajanno,46,44,2,0,7
35387,ñño,nno,17,16,1,0,3
35388,M0.0232,M0.0232,58,58,0,0,7
35389,virā,vira,1,1,0,0,4
35390,khattaṃ,khattam,14,11,3,0,7
35391,rājaññadvijaliṅgano,rajannadvijalingano,1,1,0,0,19
35392,rabhasa,rabhasa,1,0,1,0,7
35393,khattassāpaccaṃ,khattassapaccam,2,2,0,0,15
35394,iya,iya,21,3,18,0,3
35395,khettānaṃ,khettanam,15,15,0,0,9
35396,khattiyotiādikappikarājā,khattiyotiadikappikaraja,1,0,1,0,24
35397,muddhābhisittesvapi,muddhabhisittesvapi,1,1,0,0,19
35398,essattaṃ,essattam,1,1,0,0,8
35399,rajjāropanasamaye,rajjaropanasamaye,1,1,0,0,17
35400,dakkhiṇāvaṭṭasaṅkhodakena,dakkhinavattasankhodakena,1,1,0,0,25
35401,gaṅgānītena,ganganitena,1,1,0,0,11
35402,khattiyakaññādīhi,khattiyakannadihi,1,1,0,0,17
35403,abhisittattā,abhisittatta,1,1,0,0,12
35404,muddhābhisitto,muddhabhisitto,27,26,1,0,14
35405,paṭhamakhattiyo,pathamakhattiyo,1,1,0,0,15
35406,tappabhavatāya,tappabhavataya,1,1,0,0,14
35407,anabhisittā,anabhisitta,6,6,0,0,11
35408,muddhābhisittākhyā,muddhabhisittakhya,1,1,0,0,18
35409,brahmabāhujassa,brahmabahujassa,1,1,0,0,15
35410,jātassāpi,jatassapi,1,1,0,0,9
35411,brahmabāhujo,brahmabahujo,1,1,0,0,12
35412,brahmabāhuto,brahmabahuto,1,1,0,0,12
35413,bāhujoti,bahujoti,1,0,1,0,8
35414,rājini,rajini,43,41,2,0,6
35415,asesā,asesa,21,19,2,0,5
35416,paṇamanti,panamanti,12,12,0,0,9
35417,adhissarākhyo,adhissarakhyo,1,1,0,0,13
35418,savisayānantarā,savisayanantara,1,1,0,0,15
35419,samantāya,samantaya,1,1,0,0,9
35420,anantararājāno,anantararajano,1,1,0,0,14
35421,cakkavattini,cakkavattini,1,1,0,0,12
35422,sabbabhūmiyā,sabbabhumiya,1,1,0,0,12
35423,puññopanītena,punnopanitena,1,1,0,0,13
35424,cakkaratanena,cakkaratanena,13,13,0,0,13
35425,asādhudamanikādirājavattaṃ,asadhudamanikadirajavattam,1,1,0,0,26
35426,anutiṭṭhatīti,anutitthatiti,1,1,0,0,13
35427,cakkaratanaṃ,cakkaratanam,244,228,16,0,12
35428,gamayatīti,gamayatiti,10,8,2,0,10
35429,puññacakkaṃ,punnacakkam,1,1,0,0,11
35430,vattetīti,vattetiti,54,41,13,0,9
35431,cakkaratanuppādanatthaṃ,cakkaratanuppadanattham,1,1,0,0,23
35432,dvādasavassacaritaṃ,dvadasavassacaritam,1,1,0,0,19
35433,dasarājadhammaṃ,dasarajadhammam,2,2,0,0,15
35434,vattametassatthīti,vattametassatthiti,1,1,0,0,18
35435,antojanasmiṃ,antojanasmim,14,11,3,0,12
35436,balakāye,balakaye,11,11,0,0,8
35437,dhammikārakkhāvaraṇaguttiyā,dhammikarakkhavaranaguttiya,1,1,0,0,27
35438,saṃvidhānaṃ,samvidhanam,23,23,0,0,11
35439,khattiyesu,khattiyesu,16,16,0,0,10
35440,anuyuttesu,anuyuttesu,5,5,0,0,10
35441,brāhmaṇagahapatikesu,brahmanagahapatikesu,28,27,1,0,20
35442,negamajānapadesu,negamajanapadesu,14,14,0,0,16
35443,samaṇabrāhmaṇesu,samanabrahmanesu,54,54,0,0,16
35444,migapakkhīsu,migapakkhisu,18,18,0,0,12
35445,adhammakārapaṭikkhepo,adhammakarapatikkhepo,1,1,0,0,21
35446,adhanānaṃ,adhananam,19,18,1,0,9
35447,dhanuppādanaṃ,dhanuppadanam,1,1,0,0,13
35448,samaṇabrāhmaṇe,samanabrahmane,77,77,0,0,14
35449,pañhapucchananti,panhapucchananti,5,5,0,0,16
35450,dasavidhaṃ,dasavidham,125,117,8,0,10
35451,cakkavattivattaṃ,cakkavattivattam,22,20,2,0,16
35452,gahapatike,gahapatike,30,29,1,0,10
35453,pakkhijāte,pakkhijate,5,5,0,0,10
35454,gahaṇavasena,gahanavasena,76,75,1,0,12
35455,dvādasavidhampi,dvadasavidhampi,11,11,0,0,15
35456,dīpesu,dipesu,48,42,6,0,6
35457,catūsvapi,catusvapi,10,8,2,0,9
35458,āṇādhammacakkāni,anadhammacakkani,1,1,0,0,16
35459,M0.0233,M0.0233,58,58,0,0,7
35460,asabbabhummo,asabbabhummo,1,1,0,0,12
35461,sāmanto,samanto,10,9,1,0,7
35462,bhūpo,bhupo,2,2,0,0,5
35463,maṇḍalissaro,mandalissaro,3,1,2,0,12
35464,sayamāṇāpavattiṭṭhānavasena,sayamanapavattitthanavasena,1,1,0,0,27
35465,paricchinnasseva,paricchinnasseva,1,1,0,0,16
35466,maṇḍalassa,mandalassa,8,8,0,0,10
35467,sabbamaṇḍalassāti,sabbamandalassati,1,1,0,0,17
35468,nāmehi,namehi,82,78,4,0,6
35469,idhānāgatepi,idhanagatepi,1,1,0,0,12
35470,saṅgahetvā,sangahetva,255,250,5,0,10
35471,kathitena,kathitena,11,11,0,0,9
35472,adhissara,adhissara,1,0,1,0,9
35473,ekadīpissaro,ekadipissaro,2,1,1,0,12
35474,maṇḍalissara,mandalissara,2,0,2,0,12
35475,padesissaro,padesissaro,3,2,1,0,11
35476,sesehi,sesehi,111,106,5,0,6
35477,rājarājaññā,rajarajanna,1,0,1,0,11
35478,bāhuja,bahuja,1,0,1,0,6
35479,pariyantehi,pariyantehi,5,5,0,0,11
35480,para336,para336,97,97,0,0,7
35481,rājabhede,rajabhede,1,1,0,0,9
35482,sukhumatāya,sukhumataya,8,8,0,0,11
35483,līnā,lina,8,8,0,0,4
35484,chaviyo,chaviyo,2,2,0,0,7
35485,licchavino,licchavino,17,15,2,0,10
35486,licchavī,licchavi,180,177,3,0,8
35487,sammāsambuddhakule,sammasambuddhakule,1,1,0,0,18
35488,purimatarasambhūte,purimatarasambhute,1,1,0,0,18
35489,sañjātattā,sanjatatta,8,7,1,0,10
35490,sakyo,sakyo,9,8,1,0,5
35491,sakye,sakye,11,9,2,0,5
35492,sākiyo,sakiyo,14,12,2,0,6
35493,buddhaputtassāyasmato,buddhaputtassayasmato,1,1,0,0,21
35494,rāhulassa,rahulassa,25,25,0,0,9
35495,bhadda,bhadda,31,30,1,0,6
35496,sokhye,sokhye,1,1,0,0,6
35497,kulācārarūpādivasena,kulacararupadivasena,1,1,0,0,20
35498,kalyāṇattā,kalyanatta,1,1,0,0,10
35499,bhaddā,bhadda,95,92,3,0,6
35500,kaccassāpaccaṃ,kaccassapaccam,2,2,0,0,14
35501,kaccānā,kaccana,8,7,1,0,7
35502,apacca,apacca,6,4,2,0,6
35503,puttiyañca,puttiyanca,1,1,0,0,10
35504,nikkhamanaṃ,nikkhamanam,44,42,2,0,11
35505,lātukāmo,latukamo,1,1,0,0,8
35506,puttoti,puttoti,64,42,22,0,7
35507,rāhuloti,rahuloti,9,5,4,0,8
35508,bandhanaṃ,bandhanam,459,420,39,0,9
35509,sikkhākāmo,sikkhakamo,75,75,0,0,10
35510,rāhuloyevettha,rahuloyevettha,1,1,0,0,14
35511,rāhulo,rahulo,142,136,6,0,6
35512,rāhulamātā,rahulamata,70,67,3,0,10
35513,atisayavaṇṇasarīrayuttatāya,atisayavannasarirayuttataya,1,1,0,0,27
35514,M0.0234,M0.0234,58,58,0,0,7
35515,yasodharā,yasodhara,29,27,2,0,9
35516,manādi,manadi,2,1,1,0,6
35517,para337-339,para337-339,1,1,0,0,11
35518,khattiyānaṃ,khattiyanam,106,105,1,0,11
35519,kīdisaṃ,kidisam,244,238,6,0,7
35520,nidhānagaṃ,nidhanagam,3,2,1,0,10
35521,pathavādīsu,pathavadisu,1,1,0,0,11
35522,nidhānavasena,nidhanavasena,3,3,0,0,13
35523,kahāpaṇānaṃ,kahapananam,29,27,2,0,11
35524,kittakappamāṇānaṃ,kittakappamananam,1,1,0,0,17
35525,koṭīnaṃ,kotinam,19,18,1,0,7
35526,paricchedena,paricchedena,98,97,1,0,12
35527,heṭṭhimantena,hetthimantena,31,30,1,0,13
35528,heṭṭhimakoṭṭhāsena,hetthimakotthasena,1,1,0,0,18
35529,heṭṭhimaparicchedena,hetthimaparicchedena,45,45,0,0,20
35530,divasavaḷañjo,divasavalanjo,5,4,1,0,13
35531,vaḷañjitabbo,valanjitabbo,1,1,0,0,12
35532,kahāpaṇo,kahapano,74,69,5,0,8
35533,vīsatambaṇamattaṃ,visatambanamattam,1,1,0,0,17
35534,khattiyamahāsālā,khattiyamahasala,13,9,4,0,16
35535,tyuccante,tyuccante,3,3,0,0,9
35536,dhanasāro,dhanasaro,2,2,0,0,9
35537,yesante,yesante,10,10,0,0,7
35538,mahāsālā,mahasala,44,41,3,0,8
35539,ambaṇamatra,ambanamatra,1,1,0,0,11
35540,dvijānaṃ,dvijanam,2,1,1,0,8
35541,brāhmaṇānaṃ,brahmananam,442,427,15,0,11
35542,nidhānagāni,nidhanagani,2,1,1,0,11
35543,pavattāni,pavattani,99,96,3,0,9
35544,asītikoṭidhanāni,asitikotidhanani,1,1,0,0,16
35545,dasambaṇamattaṃ,dasambanamattam,1,1,0,0,15
35546,dvijā,dvija,11,11,0,0,5
35547,dvijamahāsālā,dvijamahasala,2,1,1,0,13
35548,nidhānage,nidhanage,2,2,0,0,9
35549,vaḷañje,valanje,6,4,2,0,7
35550,tadupaḍḍhe,tadupaddhe,2,2,0,0,10
35551,dvijamahāsālānaṃ,dvijamahasalanam,1,1,0,0,16
35552,upaḍḍhabhāge,upaddhabhage,5,5,0,0,12
35553,gahapatimahāsālā,gahapatimahasala,10,6,4,0,16
35554,heṭṭhimanteneva,hetthimanteneva,1,1,0,0,15
35555,dhanaparicchedo,dhanaparicchedo,1,1,0,0,15
35556,para340,para340,98,98,0,0,7
35557,M0.0235,M0.0235,58,58,0,0,7
35558,cukkaṭṭho,cukkattho,1,1,0,0,9
35559,majjhimādhikārabyavaṭṭhito,majjhimadhikarabyavatthito,1,1,0,0,26
35560,rājaputtasenāpatimahākaṇittharādi,rajaputtasenapatimahakanittharadi,1,1,0,0,33
35561,mahāmatto,mahamatto,54,50,4,0,9
35562,mattā,matta,179,157,22,0,5
35563,paricchedo,paricchedo,722,705,17,0,10
35564,paṭṭhānaṃ,patthanam,168,146,22,0,9
35565,klīvaṃ,klivam,2,2,0,0,6
35566,pakatiyaṃ,pakatiyam,13,13,0,0,9
35567,mahāmatte,mahamatte,9,9,0,0,9
35568,paññāyaṃ,pannayam,16,15,1,0,8
35569,paramattani,paramattani,3,2,1,0,11
35570,ekatte,ekatte,134,133,1,0,6
35571,ttame,ttame,2,2,0,0,5
35572,paṭṭhāno,patthano,2,2,0,0,8
35573,puṃsakaṇḍe,pumsakande,2,2,0,0,10
35574,pakaṭṭhe,pakatthe,1,1,0,0,8
35575,abhidhānappadīpikā,abhidhanappadipika,8,8,0,0,18
35576,ṭīkā,tika,148,144,4,0,4
35577,gāthāsupi,gathasupi,16,16,0,0,9
35578,mantinimhi,mantinimhi,1,1,0,0,10
35579,matippadhāno,matippadhano,1,1,0,0,12
35580,sacivo,sacivo,5,4,1,0,6
35581,sahāyo,sahayo,241,221,20,0,6
35582,itikattabbatāvadhāraṇaṃ,itikattabbatavadharanam,1,1,0,0,23
35583,mantinī,mantini,4,1,3,0,7
35584,mantena,mantena,39,38,1,0,7
35585,mantayogā,mantayoga,4,4,0,0,9
35586,manti,manti,24,21,3,0,5
35587,matisacivamantinī,matisacivamantini,1,1,0,0,17
35588,sajīvo,sajivo,7,6,1,0,6
35589,sacate,sacate,1,1,0,0,6
35590,samaveto,samaveto,3,3,0,0,8
35591,saca,saca,5,0,5,0,4
35592,amacco,amacco,221,219,2,0,6
35593,sahatthe,sahatthe,42,39,3,0,8
35594,cca,cca,7,4,3,0,3
35595,sajīvamatte,sajivamatte,1,1,0,0,11
35596,cāmacca,camacca,1,0,1,0,7
35597,senāpatimhi,senapatimhi,2,2,0,0,11
35598,camūnaṃ,camunam,1,1,0,0,7
35599,senānaṃ,senanam,11,11,0,0,7
35600,camūpati,camupati,16,15,1,0,8
35601,para341,para341,96,96,0,0,7
35602,nyāsādīnaṃ,nyasadinam,2,1,1,0,10
35603,M0.0236,M0.0236,55,55,0,0,7
35604,iṇādānadāyavibhāgādīnaṃ,inadanadayavibhagadinam,1,1,0,0,23
35605,vivādānaṃ,vivadanam,2,1,1,0,9
35606,upadaṭṭhari,upadatthari,1,0,1,0,11
35607,upadassite,upadassite,1,1,0,0,10
35608,akkhadasso,akkhadasso,12,8,4,0,10
35609,vohāre,vohare,31,29,2,0,6
35610,dhammādhikaraṇiyo,dhammadhikaraniyo,1,1,0,0,17
35611,pucchāvivāko,pucchavivako,1,1,0,0,12
35612,pañhavivākopyatra,panhavivakopyatra,1,1,0,0,17
35613,pajjaḍḍhaṃ,pajjaddham,1,1,0,0,10
35614,paṭihāre,patihare,5,3,2,0,8
35615,dovāriko,dovariko,65,62,3,0,8
35616,dvāraṭṭho,dvarattho,2,1,1,0,9
35617,dvārapālako,dvarapalako,5,4,1,0,11
35618,dvāraṭṭhito,dvaratthito,1,1,0,0,11
35619,dassakopyatra,dassakopyatra,1,1,0,0,13
35620,para342,para342,109,109,0,0,7
35621,aṅgarakkhagaṇo,angarakkhagano,2,2,0,0,14
35622,anīkaṭṭhoti,anikatthoti,2,1,1,0,11
35623,rakkhivaggo,rakkhivaggo,1,1,0,0,11
35624,nīkaṭṭho,nikattho,1,1,0,0,8
35625,amaramālāya,amaramalaya,2,0,2,0,11
35626,anīkena,anikena,1,1,0,0,7
35627,samūhena,samuhena,7,7,0,0,8
35628,anīkaṭṭho,anikattho,1,0,1,0,9
35629,mahallake,mahallake,44,43,1,0,9
35630,kañcukaṃ,kancukam,29,26,3,0,8
35631,coḷaṃ,colam,8,7,1,0,5
35632,kañcukī,kancuki,2,1,1,0,7
35633,sovidallo,sovidallo,2,1,1,0,9
35634,lobhe,lobhe,42,40,2,0,5
35635,thāpati,thapati,1,1,0,0,7
35636,sovidopyatra,sovidopyatra,1,1,0,0,12
35637,sevake,sevake,7,7,0,0,6
35638,pabhuno,pabhuno,2,2,0,0,7
35639,anujīvī,anujivi,2,1,1,0,7
35640,seva,seva,30,28,2,0,4
35641,sevane,sevane,13,13,0,0,6
35642,atthīpyatra,atthipyatra,1,1,0,0,11
35643,atthanamattho,atthanamattho,1,1,0,0,13
35644,āsīso,asiso,5,5,0,0,5
35645,para343,para343,110,110,0,0,7
35646,M0.0237,M0.0237,58,58,0,0,7
35647,adhikamatte,adhikamatte,1,1,0,0,11
35648,anubhavanametassa,anubhavanametassa,1,1,0,0,17
35649,ajjhakkho,ajjhakkho,2,1,1,0,9
35650,adhikato,adhikato,15,12,3,0,8
35651,thāyukagopānaṃ,thayukagopanam,1,1,0,0,14
35652,ekagāme,ekagame,5,5,0,0,7
35653,thāyuko,thayuko,1,0,1,0,7
35654,gāmesvadhikato,gamesvadhikato,1,1,0,0,14
35655,gopo,gopo,31,26,5,0,4
35656,vuttañcā,vuttanca,2,1,1,0,8
35657,marakose,marakose,11,0,11,0,8
35658,thāyukodhikato,thayukodhikato,1,1,0,0,14
35659,bhūrisū,bhurisu,1,1,0,0,7
35660,ruddenā,ruddena,1,0,1,0,7
35661,gāmesvadhikate,gamesvadhikate,1,1,0,0,14
35662,goṭṭhajjhakkhepi,gotthajjhakkhepi,1,1,0,0,16
35663,suvaṇṇarajatajjhakkhānaṃ,suvannarajatajjhakkhanam,1,1,0,0,24
35664,akatasuvaṇṇādi,akatasuvannadi,1,1,0,0,14
35665,heraññiko,heranniko,19,17,2,0,9
35666,nikkho,nikkho,10,8,2,0,6
35667,suvaṇṇādivikāro,suvannadivikaro,1,1,0,0,15
35668,niyogo,niyogo,7,7,0,0,6
35669,nikkhiko,nikkhiko,3,2,1,0,8
35670,suvaṇṇajjhakkhe,suvannajjhakkhe,1,1,0,0,15
35671,bhoriko,bhoriko,3,2,1,0,7
35672,suvaṇṇe,suvanne,113,113,0,0,7
35673,rūpyājjhakkhenikkhiko,rupyajjhakkhenikkhiko,1,1,0,0,21
35674,mubhayatrāpi,mubhayatrapi,1,1,0,0,12
35675,heraññikoti,herannikoti,3,3,0,0,11
35676,kanakājjhakkho,kanakajjhakkho,1,1,0,0,14
35677,rūpyā,rupya,1,1,0,0,5
35678,jjhakkho,jjhakkho,1,1,0,0,8
35679,vijigīsabhūtassa,vijigisabhutassa,1,1,0,0,16
35680,desānantaro,desanantaro,1,1,0,0,11
35681,maṇḍalībhūto,mandalibhuto,1,1,0,0,12
35682,sattu,sattu,96,84,12,0,5
35683,ruccate,ruccate,18,14,4,0,7
35684,ekatthābhinivesitattā,ekatthabhinivesitatta,1,1,0,0,21
35685,vijigīsabhūmyekantariko,vijigisabhumyekantariko,1,1,0,0,23
35686,ekatthakārittanopakārattā,ekatthakarittanopakaratta,1,1,0,0,25
35687,arivijigīsamittānaṃ,arivijigisamittanam,1,1,0,0,19
35688,maṇḍalānaṃ,mandalanam,7,7,0,0,10
35689,bahibhūto,bahibhuto,8,7,1,0,9
35690,dūramaṇḍalaṭṭho,duramandalattho,1,1,0,0,15
35691,vijigīsabhūmiyā,vijigisabhumiya,1,1,0,0,15
35692,accantabyavahito,accantabyavahito,1,1,0,0,16
35693,balādhikopi,baladhikopi,1,1,0,0,11
35694,nāpakarotyupakāroti,napakarotyupakaroti,1,1,0,0,19
35695,udāsīno,udasino,11,9,2,0,7
35696,dūramaṇḍalattenopakārattā,duramandalattenopakaratta,1,1,0,0,25
35697,dūramaṇḍale,duramandale,1,1,0,0,11
35698,M0.0238,M0.0238,58,58,0,0,7
35699,āsatīti,asatiti,3,2,1,0,7
35700,upasevane,upasevane,1,1,0,0,9
35701,sattumabhiyuñjamānassa,sattumabhiyunjamanassa,1,1,0,0,22
35702,vijigīsassa,vijigisassa,5,5,0,0,11
35703,sattuhitāya,sattuhitaya,1,1,0,0,11
35704,paṇhiggāho,panhiggaho,1,1,0,0,10
35705,vijigīsassā,vijigisassa,1,1,0,0,11
35706,paṇhipāde,panhipade,1,1,0,0,9
35707,byūhapiṭṭhe,byuhapitthe,1,1,0,0,11
35708,pacchimabhāge,pacchimabhage,14,14,0,0,13
35709,pādamūlomadiṭṭhisu,padamulomaditthisu,1,1,0,0,18
35710,senāpiṭṭhe,senapitthe,1,1,0,0,10
35711,kumbhiyañce,kumbhiyance,1,1,0,0,11
35712,para344-345,para344-345,1,1,0,0,11
35713,diṭṭha,dittha,21,20,1,0,6
35714,ripumhi,ripumhi,2,2,0,0,7
35715,mittapaṭipakkhattā,mittapatipakkhatta,1,1,0,0,18
35716,rapatyavaṇṇaṃ,rapatyavannam,1,1,0,0,13
35717,rajateti,rajateti,1,1,0,0,8
35718,ripu,ripu,11,10,1,0,4
35719,rapa,rapa,2,1,1,0,4
35720,japa,japa,3,1,2,0,4
35721,jappa,jappa,5,2,3,0,5
35722,verī,veri,67,61,6,0,4
35723,dukkhahetuttā,dukkhahetutta,1,1,0,0,13
35724,sapatti,sapatti,5,5,0,0,7
35725,sapatto,sapatto,51,50,1,0,7
35726,tthe,tthe,15,14,1,0,4
35727,kārapaccayo,karapaccayo,5,5,0,0,11
35728,bhūvādittā,bhuvaditta,1,1,0,0,10
35729,sādane,sadane,2,1,1,0,6
35730,yavādicuṇṇepi,yavadicunnepi,1,1,0,0,13
35731,veramaratīti,veramaratiti,1,1,0,0,12
35732,rassanto,rassanto,7,7,0,0,8
35733,sapattādīnaṃ,sapattadinam,1,1,0,0,12
35734,byañjano,byanjano,28,25,3,0,8
35735,visaṃyogo,visamyogo,14,13,1,0,9
35736,patiyamatthanaṃ,patiyamatthanam,1,1,0,0,15
35737,paccattho,paccattho,3,3,0,0,9
35738,paccatthiko,paccatthiko,50,48,2,0,11
35739,patiyaṃ,patiyam,1,1,0,0,7
35740,viparītagamanaṃ,viparitagamanam,1,1,0,0,15
35741,pantha,pantha,1,0,1,0,6
35742,paripantho,paripantho,75,67,8,0,10
35743,parissavaṭṭhānaṃ,parissavatthanam,1,1,0,0,16
35744,paripanthī,paripanthi,2,1,1,0,10
35745,paṭiviruddho,pativiruddho,23,20,3,0,12
35746,vipakkho,vipakkho,6,5,1,0,8
35747,ahito,ahito,14,12,2,0,5
35748,paratīti,paratiti,4,3,1,0,8
35749,paccāmitto,paccamitto,19,17,2,0,10
35750,anīto,anito,2,2,0,0,5
35751,M0.0239,M0.0239,57,57,0,0,7
35752,tappaṭipakkho,tappatipakkho,15,15,0,0,13
35753,paccanīto,paccanito,1,1,0,0,9
35754,paccanīko,paccaniko,17,14,3,0,9
35755,niyako,niyako,10,10,0,0,6
35756,virodhossatthīti,virodhossatthiti,1,1,0,0,16
35757,virodhī,virodhi,3,1,2,0,7
35758,vidussanasīlatāya,vidussanasilataya,1,1,0,0,17
35759,viddesī,viddesi,2,1,1,0,7
35760,issettaṃ,issettam,1,1,0,0,8
35761,dussatīti,dussatiti,14,10,4,0,9
35762,diso,diso,41,36,5,0,4
35763,ṭṭhā,ttha,11,5,6,0,4
35764,dvesaṇo,dvesano,1,1,0,0,7
35765,duhadayo,duhadayo,2,2,0,0,8
35766,dassu,dassu,3,3,0,0,5
35767,sāttavo,sattavo,1,1,0,0,7
35768,abhighātīpyatra,abhighatipyatra,1,1,0,0,15
35769,anukūlane,anukulane,1,1,0,0,9
35770,anurodhanaṃ,anurodhanam,1,1,0,0,11
35771,anurodho,anurodho,25,22,3,0,8
35772,anuvattanaṃ,anuvattanam,14,12,2,0,11
35773,para346,para346,98,98,0,0,7
35774,mittasāmaññe,mittasamanne,1,1,0,0,12
35775,vayaso,vayaso,4,2,2,0,6
35776,mūlavayosaddehi,mulavayosaddehi,1,1,0,0,15
35777,sabbakāriyesu,sabbakariyesu,1,1,0,0,13
35778,vayatīti,vayatiti,6,6,0,0,8
35779,kiccesūti,kiccesuti,10,5,5,0,9
35780,sahadhammiko,sahadhammiko,64,53,11,0,12
35781,hāni,hani,81,81,0,0,4
35782,tipadabahubbīhi,tipadabahubbihi,4,4,0,0,15
35783,parakkamādhigatasampadā,parakkamadhigatasampada,4,4,0,0,23
35784,hāyā,haya,1,1,0,0,4
35785,hadayametassāti,hadayametassati,1,1,0,0,15
35786,suhadayo,suhadayo,24,24,0,0,8
35787,suhajjo,suhajjo,6,5,1,0,7
35788,parisahanaṃ,parisahanam,3,1,2,0,11
35789,adussanaṃ,adussanam,2,2,0,0,9
35790,M0.0240,M0.0240,56,56,0,0,7
35791,sniddho,sniddho,1,1,0,0,7
35792,savayopyatra,savayopyatra,1,1,0,0,12
35793,sakhyasattapadinā,sakhyasattapadina,1,1,0,0,17
35794,sakhimhi,sakhimhi,1,1,0,0,8
35795,sakhyaṃ,sakhyam,16,14,2,0,7
35796,avagamyateti,avagamyateti,1,1,0,0,12
35797,sattapadinaṃ,sattapadinam,1,0,1,0,12
35798,sattapadīna,sattapadina,1,1,0,0,11
35799,abhejjamitte,abhejjamitte,1,1,0,0,12
35800,bhajatīti,bhajatiti,60,45,15,0,9
35801,sambhatto,sambhatto,35,31,4,0,9
35802,bhaja,bhaja,23,12,11,0,5
35803,daḷhamitto,dalhamitto,19,18,1,0,10
35804,diṭṭhamattamitte,ditthamattamitte,1,1,0,0,16
35805,saddoyamappattho,saddoyamappattho,1,1,0,0,16
35806,pamāṇametassa,pamanametassa,2,2,0,0,13
35807,diṭṭhamattako,ditthamattako,2,1,1,0,13
35808,para347,para347,98,98,0,0,7
35809,carapurise,carapurise,9,9,0,0,10
35810,tāpasādirūpena,tapasadirupena,1,1,0,0,14
35811,caramatte,caramatte,1,1,0,0,9
35812,paracakkanti,paracakkanti,1,1,0,0,12
35813,cāropi,caropi,1,1,0,0,6
35814,guḷhapuriso,gulhapuriso,2,1,1,0,11
35815,guttapuriso,guttapuriso,1,1,0,0,11
35816,yathārahavaṇṇo,yatharahavanno,2,1,1,0,14
35817,appasapo,appasapo,1,1,0,0,8
35818,phassopyatra,phassopyatra,1,1,0,0,12
35819,vāṇijakasibalaliṅgabhikkhukaccāyanādilesena,vanijakasibalalingabhikkhukaccayanadilesena,1,1,0,0,43
35820,thāyinicare,thayinicare,1,1,0,0,11
35821,idhāgatasadisatthe,idhagatasadisatthe,1,1,0,0,18
35822,pakāro,pakaro,91,86,5,0,6
35823,yathārahappakāro,yatharahappakaro,1,1,0,0,16
35824,paracakkaṃ,paracakkam,5,3,2,0,10
35825,ñātuṃ,natum,223,218,5,0,5
35826,tappakāravā,tappakarava,1,1,0,0,11
35827,iccattho,iccattho,7,7,0,0,8
35828,paṇidhiyyate,panidhiyyate,1,1,0,0,12
35829,ñeyyamasmiṃ,neyyamasmim,1,1,0,0,11
35830,apakaṭṭhaṃ,apakattham,4,3,1,0,10
35831,apasappo,apasappo,1,0,1,0,8
35832,pathike,pathike,4,4,0,0,7
35833,pathāvī,pathavi,2,1,1,0,7
35834,pathiko,pathiko,7,6,1,0,7
35835,addhagopyatra,addhagopyatra,1,1,0,0,13
35836,dūte,dute,41,40,1,0,4
35837,sandesaṃ,sandesam,22,17,5,0,8
35838,vācikaṃ,vacikam,2,2,0,0,7
35839,haratyaneneti,haratyaneneti,1,1,0,0,13
35840,M0.0241,M0.0241,57,57,0,0,7
35841,jotisike,jotisike,1,1,0,0,8
35842,gaṇayatīti,ganayatiti,1,1,0,0,10
35843,gaṇako,ganako,20,19,1,0,6
35844,kālavisesaṃ,kalavisesam,5,5,0,0,11
35845,muhuttiko,muhuttiko,4,3,1,0,9
35846,jotisiko,jotisiko,1,1,0,0,8
35847,devaññū,devannu,1,1,0,0,7
35848,mohutto,mohutto,4,4,0,0,7
35849,kātantikopyatra,katantikopyatra,1,1,0,0,15
35850,devamattaṃ,devamattam,1,1,0,0,10
35851,kātantiko,katantiko,1,0,1,0,9
35852,para348,para348,97,97,0,0,7
35853,lekhake,lekhake,1,1,0,0,7
35854,lipena,lipena,1,1,0,0,6
35855,masyopadesena,masyopadesena,1,1,0,0,13
35856,lipi,lipi,6,3,3,0,4
35857,vaṇṇasaṇṭhāno,vannasanthano,1,1,0,0,13
35858,lipikāro,lipikaro,2,1,1,0,8
35859,akkharacaṇo,akkharacano,1,1,0,0,11
35860,akkharacuñcupyatra,akkharacuncupyatra,1,1,0,0,18
35861,cana,cana,4,0,4,0,4
35862,cañcu,cancu,3,1,2,0,5
35863,melānandā,melananda,1,1,0,0,9
35864,masimaṇi,masimani,1,1,0,0,8
35865,melandhu,melandhu,1,1,0,0,8
35866,vaṇṇakūpikā,vannakupika,1,1,0,0,11
35867,masijalantu,masijalantu,1,1,0,0,11
35868,melā,mela,1,1,0,0,4
35869,pattañjanaṃ,pattanjanam,1,1,0,0,11
35870,dvisu,dvisu,18,18,0,0,5
35871,lekhanī,lekhani,2,2,0,0,7
35872,vaṇṇatūlī,vannatuli,1,1,0,0,9
35873,vaṇṇakakkharatūlikā,vannakakkharatulika,1,1,0,0,19
35874,vaṇṇadūto,vannaduto,1,1,0,0,9
35875,sotthimukho,sotthimukho,1,1,0,0,11
35876,lekho,lekho,5,4,1,0,5
35877,vācikahārako,vacikaharako,1,1,0,0,12
35878,kācanakitaliko,kacanakitaliko,1,1,0,0,14
35879,kācanaṃ,kacanam,1,1,0,0,7
35880,tannibandhanaṃ,tannibandhanam,1,1,0,0,14
35881,lekhyaṭṭhānaṃ,lekhyatthanam,1,1,0,0,13
35882,ganthakuṭi,ganthakuti,1,1,0,0,10
35883,paccayakārinī,paccayakarini,1,1,0,0,13
35884,vaṇṇīyati,vanniyati,24,24,0,0,9
35885,pakāsīyati,pakasiyati,22,22,0,0,10
35886,akkharo,akkharo,5,4,1,0,7
35887,khara,khara,15,6,9,0,5
35888,likhanaṃ,likhanam,3,2,1,0,8
35889,likhi,likhi,19,17,2,0,5
35890,vaṇṇasaṇṭhāne,vannasanthane,1,1,0,0,13
35891,lipilikhi,lipilikhi,1,0,1,0,9
35892,bhedādayo,bhedadayo,1,1,0,0,9
35893,upāyā,upaya,6,3,3,0,5
35894,sattuvijayakāraṇāni,sattuvijayakaranani,1,1,0,0,19
35895,sattuvijayamupagacchanti,sattuvijayamupagacchanti,1,1,0,0,24
35896,parasmā,parasma,37,37,0,0,7
35897,visilesanaṃ,visilesanam,1,1,0,0,11
35898,sneharāgāpanayanaṃ,sneharagapanayanam,1,1,0,0,18
35899,M0.0242,M0.0242,56,56,0,0,7
35900,saṃhāsoppādanaṃ,samhasoppadanam,1,1,0,0,15
35901,santajjanañca,santajjananca,1,1,0,0,13
35902,kāmandakīyanītisāra,kamandakiyanitisara,7,7,0,0,19
35903,tavānuggatena,tavanuggatena,1,1,0,0,13
35904,pavuddho,pavuddho,2,2,0,0,8
35905,pāsādataravo,pasadataravo,1,1,0,0,12
35906,attānañcocchindissatīti,attanancocchindissatiti,1,1,0,0,23
35907,janitāyaṃ,janitayam,1,1,0,0,9
35908,snehabhattiñcāpanayati,snehabhattincapanayati,1,1,0,0,22
35909,abhibhavanañcopādayati,abhibhavanancopadayati,1,1,0,0,22
35910,paddhañcopādayati,paddhancopadayati,1,1,0,0,17
35911,pariyapaccāmittānuggahaṇassa,pariyapaccamittanuggahanassa,1,1,0,0,28
35912,maraṇamevanto,maranamevanto,1,1,0,0,13
35913,bhavissatītyevaṃpakāramabhibhayanaṃ,bhavissatityevampakaramabhibhayanam,1,1,0,0,35
35914,santajjanaṃ,santajjanam,5,5,0,0,11
35915,vadhotthaggahaṇañceva,vadhotthaggahananceva,1,1,0,0,21
35916,parikleso,parikleso,4,3,1,0,9
35917,daṇḍavidhaññūhi,dandavidhannuhi,1,1,0,0,15
35918,bandhanatāḷanādi,bandhanatalanadi,1,1,0,0,16
35919,aññamaññopakārānaṃ,annamannopakaranam,1,1,0,0,18
35920,guṇakittanaṃ,gunakittanam,10,10,0,0,12
35921,sambandhassa,sambandhassa,40,40,0,0,12
35922,samakkhānaṃ,samakkhanam,1,1,0,0,11
35923,sampakāsanaṃ,sampakasanam,1,1,0,0,12
35924,pesalayā,pesalaya,1,1,0,0,8
35925,tavāhamiti,tavahamiti,1,1,0,0,10
35926,cappaṇaṃ,cappanam,1,1,0,0,8
35927,sāmavidhaññūhi,samavidhannuhi,1,1,0,0,14
35928,bhavissatī,bhavissati,1755,1714,41,0,10
35929,āsādassanaṃ,asadassanam,1,1,0,0,11
35930,āyatisampakāsanaṃ,ayatisampakasanam,1,0,1,0,17
35931,appaṇamityaṅgassa,appanamityangassa,1,1,0,0,17
35932,dānañca,dananca,103,100,3,0,7
35933,sārassāsārassa,sarassasarassa,1,1,0,0,14
35934,dabbassa,dabbassa,56,52,4,0,8
35935,gahitassa,gahitassa,55,54,1,0,9
35936,samappaṇaṃ,samappanam,2,2,0,0,10
35937,tathāgahitassānumodanaṃ,tathagahitassanumodanam,1,1,0,0,23
35938,apubbadānaṃ,apubbadanam,1,1,0,0,11
35939,amussa,amussa,55,53,2,0,6
35940,gaṇhāhi,ganhahi,91,90,1,0,7
35941,parasesu,parasesu,1,1,0,0,8
35942,gāhappavattanaṃ,gahappavattanam,2,2,0,0,15
35943,iṇappamocanañceti,inappamocananceti,1,1,0,0,17
35944,sampattadhanossaggo,sampattadhanossaggo,1,1,0,0,19
35945,uttamamajjhimādhamo,uttamamajjhimadhamo,1,1,0,0,19
35946,patidānaṃ,patidanam,1,1,0,0,9
35947,gahitassānumodanaṃ,gahitassanumodanam,1,1,0,0,18
35948,dabbadāna,dabbadana,1,1,0,0,9
35949,mapubbañca,mapubbanca,1,1,0,0,10
35950,M0.0243,M0.0243,57,57,0,0,7
35951,deyyassa,deyyassa,2,2,0,0,8
35952,paṭimokkho,patimokkho,5,5,0,0,10
35953,māyādīsvevantogadhā,mayadisvevantogadha,1,1,0,0,19
35954,māyopekkhā,mayopekkha,1,1,0,0,10
35955,daṇḍantogadhā,dandantogadha,1,1,0,0,13
35956,indajālañca,indajalanca,1,1,0,0,11
35957,antogadhaṃ,antogadham,63,56,7,0,10
35958,catukkakaṃ,catukkakam,2,2,0,0,10
35959,māyopekkhindajālañca,mayopekkhindajalanca,1,1,0,0,20
35960,sattopāyā,sattopaya,1,1,0,0,9
35961,para349,para349,93,93,0,0,7
35962,nāmamattena,namamattena,11,11,0,0,11
35963,vuttānaṃ,vuttanam,276,265,11,0,8
35964,bhedādīnamidāni,bhedadinamidani,1,1,0,0,15
35965,pariyāyānyāha,pariyayanyaha,1,1,0,0,13
35966,mānase,manase,19,17,2,0,6
35967,japo,japo,2,2,0,0,4
35968,cintanavācāsu,cintanavacasu,1,1,0,0,13
35969,dhātvatthasaṅgaha,dhatvatthasangaha,1,1,0,0,17
35970,nipātane,nipatane,2,2,0,0,8
35971,saho,saho,13,11,2,0,4
35972,tabbhavaṃ,tabbhavam,4,3,1,0,9
35973,sāhasaṃ,sahasam,22,15,7,0,7
35974,damo,damo,64,45,19,0,4
35975,dīghapaṭisedho,dighapatisedho,1,1,0,0,14
35976,para350,para350,99,99,0,0,7
35977,suddavagge,suddavagge,1,1,0,0,10
35978,brāhmaṇavagge,brahmanavagge,15,15,0,0,13
35979,kathessati,kathessati,68,67,1,0,10
35980,sāmyādayo,samyadayo,1,1,0,0,9
35981,sattarevācariyamate,sattarevacariyamate,1,1,0,0,19
35982,paramparopakārittā,paramparopakaritta,1,1,0,0,18
35983,rajjassaṅgāni,rajjassangani,1,1,0,0,13
35984,pakaṭṭhamupakubbanti,pakatthamupakubbanti,1,1,0,0,20
35985,pakatiyoti,pakatiyoti,2,2,0,0,10
35986,coccante,coccante,2,2,0,0,8
35987,kāmandakīye,kamandakiye,2,0,2,0,11
35988,sāmya,samya,3,3,0,0,5
35989,maccañca,maccanca,2,2,0,0,8
35990,raṭṭhañca,ratthanca,23,22,1,0,9
35991,duggaṃ,duggam,36,31,5,0,6
35992,paramparopakārīdaṃ,paramparopakaridam,1,1,0,0,18
35993,sattaṅgaṃ,sattangam,11,10,1,0,9
35994,rajjamuccate,rajjamuccate,1,1,0,0,12
35995,amaccaraṭṭhaduggāni,amaccaratthaduggani,1,1,0,0,19
35996,M0.0244,M0.0244,55,55,0,0,7
35997,pakatiyo,pakatiyo,5,4,1,0,8
35998,rājino,rajino,182,178,4,0,6
35999,mittaṃ,mittam,142,128,14,0,6
36000,pathavīpati,pathavipati,1,1,0,0,11
36001,sattappakatikaṃ,sattappakatikam,1,1,0,0,15
36002,sūrapūjito,surapujito,1,1,0,0,10
36003,poraseṇīnaṃ,poraseninam,1,1,0,0,11
36004,padhānabhāvepi,padhanabhavepi,1,1,0,0,14
36005,raṭṭha,rattha,7,4,3,0,6
36006,gahaṇasiddhanti,gahanasiddhanti,1,1,0,0,15
36007,siddhepi,siddhepi,40,40,0,0,8
36008,padhānattākhyāpanatthaṃ,padhanattakhyapanattham,1,1,0,0,23
36009,rajjaduggabalāni,rajjaduggabalani,1,1,0,0,16
36010,rajjaṅgāni,rajjangani,1,1,0,0,10
36011,pakatayo,pakatayo,1,1,0,0,8
36012,porānaṃ,poranam,1,1,0,0,7
36013,seṇiyopi,seniyopi,1,1,0,0,8
36014,sāmyamaccaraṭṭhaduggakosabalasakhīnaṃ,samyamaccaratthaduggakosabalasakhinam,1,1,0,0,37
36015,pubbatarassa,pubbatarassa,1,1,0,0,12
36016,garuttaṃ,garuttam,4,4,0,0,8
36017,nāmaliṅgānusāsane,namalinganusasane,1,1,0,0,17
36018,abhidhānasatthe,abhidhanasatthe,2,1,1,0,15
36019,anupayogato,anupayogato,2,2,0,0,11
36020,vattumicchatīti,vattumicchatiti,1,1,0,0,15
36021,byatikkamenopaññāso,byatikkamenopannaso,1,1,0,0,19
36022,suvaṇṇādimayabhaṇḍāgāraṃ,suvannadimayabhandagaram,1,1,0,0,24
36023,pabbatodakarukkhādīhi,pabbatodakarukkhadihi,1,1,0,0,21
36024,duggamaṃ,duggamam,3,3,0,0,8
36025,janapadavatī,janapadavati,1,1,0,0,12
36026,molabhataseṇisahāyāmittāṭavikabhedena,molabhatasenisahayamittatavikabhedena,1,1,0,0,37
36027,kamāgataṃ,kamagatam,3,3,0,0,9
36028,molaṃ,molam,1,0,1,0,5
36029,vetanasambandhaṃ,vetanasambandham,1,1,0,0,16
36030,bhataṃ,bhatam,4,3,1,0,6
36031,poraṃ,poram,2,2,0,0,5
36032,seṇī,seni,6,2,4,0,4
36033,sahāyabhūtaṃ,sahayabhutam,5,5,0,0,12
36034,amittabhūtaṃ,amittabhutam,1,1,0,0,12
36035,amittaṃ,amittam,31,29,2,0,7
36036,aṭavikaṃ,atavikam,1,0,1,0,8
36037,aṭavisahāyo,atavisahayo,1,1,0,0,11
36038,tadapi,tadapi,214,208,6,0,6
36039,sahajjaṃ,sahajjam,1,1,0,0,8
36040,pākataṃ,pakatam,6,4,2,0,7
36041,kittimañceti,kittimanceti,1,1,0,0,12
36042,liṅge,linge,61,56,5,0,5
36043,porāmaccādiyonisu,poramaccadiyonisu,1,1,0,0,17
36044,tiliṅgaṃ,tilingam,4,4,0,0,8
36045,guṇasāmyepī,gunasamyepi,1,1,0,0,11
36046,byākhyāsudhā,byakhyasudha,18,18,0,0,12
36047,para351,para351,96,96,0,0,7
36048,pabhāvādīnaṃ,pabhavadinam,2,2,0,0,12
36049,M0.0245,M0.0245,57,57,0,0,7
36050,sattiyo,sattiyo,15,13,2,0,7
36051,sandhādīnaṃ,sandhadinam,1,1,0,0,11
36052,bhedādīnañca,bhedadinanca,1,1,0,0,12
36053,avaṭṭhāpanaṃ,avatthapanam,2,2,0,0,12
36054,ñāṇabalaṃ,nanabalam,37,29,8,0,9
36055,mantasatti,mantasatti,2,0,2,0,10
36056,sakasampattuppattiyaṃ,sakasampattuppattiyam,1,1,0,0,21
36057,kosadaṇḍā,kosadanda,1,1,0,0,9
36058,pabhūsatti,pabhusatti,3,1,2,0,10
36059,tesaṃyeva,tesamyeva,580,560,20,0,9
36060,pabhuttasampādane,pabhuttasampadane,1,1,0,0,17
36061,kosadaṇḍabalaṃ,kosadandabalam,1,1,0,0,14
36062,balavatī,balavati,168,155,13,0,8
36063,ussāhaceṭṭhā,ussahacettha,1,1,0,0,12
36064,ussāhasatti,ussahasatti,2,0,2,0,11
36065,vikkamabalamussāhasatti,vikkamabalamussahasatti,1,1,0,0,23
36066,sakāraṇaṃ,sakaranam,34,28,6,0,9
36067,pabhāvo,pabhavo,20,14,6,0,7
36068,tadatthiyā,tadatthiya,4,4,0,0,10
36069,balampi,balampi,2,2,0,0,7
36070,pulliṅgena,pullingena,14,14,0,0,10
36071,yojanīyaṃ,yojaniyam,31,31,0,0,9
36072,pabhavanti,pabhavanti,42,35,7,0,10
36073,tejassino,tejassino,2,2,0,0,9
36074,kosajo,kosajo,3,3,0,0,6
36075,dhanena,dhanena,342,324,18,0,7
36076,sattūnamupakaraṇaṃ,sattunamupakaranam,1,1,0,0,18
36077,patapanti,patapanti,1,1,0,0,9
36078,bhavantyaneneti,bhavantyaneneti,1,1,0,0,15
36079,patāpo,patapo,11,8,3,0,6
36080,para352,para352,92,92,0,0,7
36081,mante,mante,213,196,17,0,5
36082,nipphādetabbattāti,nipphadetabbattati,1,1,0,0,18
36083,manta,manta,16,7,9,0,5
36084,guttabhāsane,guttabhasane,5,4,1,0,12
36085,M0.0246,M0.0246,57,57,0,0,7
36086,dvigocaro,dvigocaro,3,2,1,0,9
36087,visayabhūto,visayabhuto,20,20,0,0,11
36088,catukkaṇṇo,catukkanno,15,13,2,0,10
36089,tigocaro,tigocaro,3,2,1,0,8
36090,chakkaṇṇo,chakkanno,5,3,2,0,9
36091,kattabbo,kattabbo,91,88,3,0,8
36092,paranti,paranti,58,57,1,0,7
36093,dvinnamevettha,dvinnamevettha,1,1,0,0,14
36094,chakkaṇṇopi,chakkannopi,1,1,0,0,11
36095,paṭikkhitto,patikkhitto,122,120,2,0,11
36096,achakkaṇṇo,achakkanno,1,1,0,0,10
36097,tatiyādyagocaro,tatiyadyagocaro,1,1,0,0,15
36098,sabbapāṭhipadattā,sabbapathipadatta,1,1,0,0,17
36099,byākaraṇassa,byakaranassa,9,9,0,0,12
36100,samayantaresvapi,samayantaresvapi,1,1,0,0,16
36101,paṭubhāvajananatthaṃ,patubhavajananattham,1,1,0,0,20
36102,idhānāgatāpi,idhanagatapi,1,1,0,0,12
36103,chagguṇādayo,chaggunadayo,1,1,0,0,12
36104,kathetabbā,kathetabba,80,77,3,0,10
36105,sabbapārisadaṃ,sabbaparisadam,1,1,0,0,14
36106,sabbapāṭipadaṃ,sabbapatipadam,1,1,0,0,14
36107,hidaṃ,hidam,335,326,9,0,5
36108,sabbasattha,sabbasattha,2,2,0,0,11
36109,nissīyate,nissiyate,8,8,0,0,9
36110,sabbesa,sabbesa,9,9,0,0,7
36111,matra,matra,2,2,0,0,5
36112,vādinaṃ,vadinam,2,2,0,0,7
36113,chagguṇā,chagguna,2,2,0,0,8
36114,viggahayānāsanadvedhāsayā,viggahayanasanadvedhasaya,1,1,0,0,25
36115,upahāralakkhaṇo,upaharalakkhano,1,1,0,0,15
36116,kosadaṇḍabhūmippadānahetuko,kosadandabhumippadanahetuko,1,1,0,0,27
36117,apahāralakkhaṇo,apaharalakkhano,1,1,0,0,15
36118,pakāsayuddhaṃ,pakasayuddham,1,1,0,0,13
36119,kūṭayuddhaṃ,kutayuddham,1,1,0,0,11
36120,tuṇhiyuddhanti,tunhiyuddhanti,1,1,0,0,14
36121,parabyasanatāsapattidesakālātyudayāvāpayānamattena,parabyasanatasapattidesakalatyudayavapayanamattena,1,1,0,0,50
36122,sāddhe,saddhe,1,1,0,0,6
36123,parasmiṃ,parasmim,76,73,3,0,8
36124,katācarassa,katacarassa,1,1,0,0,11
36125,guṇānurattapakatissa,gunanurattapakatissa,1,1,0,0,20
36126,yātrā,yatra,61,50,11,0,5
36127,kāmandakīyanītisāre,kamandakiyanitisare,1,1,0,0,19
36128,viggayhayānaṃ,viggayhayanam,1,1,0,0,13
36129,sandhāyayānaṃ,sandhayayanam,1,1,0,0,13
36130,sambhūyayānaṃ,sambhuyayanam,2,1,1,0,13
36131,pasaṅgayānaṃ,pasangayanam,2,1,1,0,12
36132,upekkhiyayānamiti,upekkhiyayanamiti,1,1,0,0,17
36133,patiggāhīnaṃ,patiggahinam,1,1,0,0,12
36134,niggayha,niggayha,39,37,2,0,8
36135,upekkhiya,upekkhiya,1,1,0,0,9
36136,viggayhayānādi,viggayhayanadi,1,0,1,0,14
36137,sāmantehi,samantehi,1,1,0,0,9
36138,sahekībhūya,sahekibhuya,1,1,0,0,11
36139,gantabbe,gantabbe,5,5,0,0,8
36140,pasaṅgato,pasangato,11,11,0,0,9
36141,hantuṃ,hantum,63,53,10,0,6
36142,nāhampi,nahampi,1,1,0,0,7
36143,kālādike,kaladike,2,2,0,0,8
36144,parikkhitvā,parikkhitva,3,3,0,0,11
36145,duggādīni,duggadini,1,1,0,0,9
36146,vaḍḍhayato,vaddhayato,4,4,0,0,10
36147,ṭhiti,thiti,358,336,22,0,5
36148,viggayhāsanasandhāyāsanādibhedena,viggayhasanasandhayasanadibhedena,1,1,0,0,33
36149,balīnaṃ,balinam,1,1,0,0,7
36150,M0.0247,M0.0247,56,56,0,0,7
36151,sattūnaṃ,sattunam,9,8,1,0,8
36152,kākakkhivā,kakakkhiva,1,1,0,0,10
36153,lakkhitasso,lakkhitasso,1,1,0,0,11
36154,bhayatra,bhayatra,1,1,0,0,8
36155,vacanenattano,vacanenattano,1,1,0,0,13
36156,dvedhaṃ,dvedham,3,0,3,0,7
36157,balavatarena,balavatarena,12,12,0,0,12
36158,abalena,abalena,1,1,0,0,7
36159,sattuno,sattuno,8,8,0,0,7
36160,pakatīhi,pakatihi,2,2,0,0,8
36161,sattuneva,sattuneva,1,1,0,0,9
36162,sandhiviggahasamudāyahetuko,sandhiviggahasamudayahetuko,1,1,0,0,27
36163,sattunova,sattunova,1,1,0,0,9
36164,sandhiviggahasamudāyahetuno,sandhiviggahasamudayahetuno,1,1,0,0,27
36165,duggāsayassa,duggasayassa,1,1,0,0,12
36166,parasantānamapyobhayavedanānaṃ,parasantanamapyobhayavedananam,1,1,0,0,30
36167,ubhayato,ubhayato,54,50,4,0,8
36168,dvedhamuccate,dvedhamuccate,1,1,0,0,13
36169,ucchijjamāno,ucchijjamano,4,4,0,0,12
36170,ripunā,ripuna,1,1,0,0,6
36171,nirupāya,nirupaya,1,1,0,0,8
36172,patikriyo,patikriyo,1,1,0,0,9
36173,sattihīno,sattihino,1,1,0,0,9
36174,samāsiyate,samasiyate,1,1,0,0,10
36175,hīnenāññassa,hinenannassa,1,1,0,0,12
36176,balavatarassa,balavatarassa,2,2,0,0,13
36177,dhammavijayino,dhammavijayino,1,1,0,0,14
36178,samāsayanaṃ,samasayanam,1,1,0,0,11
36179,balavatā,balavata,54,50,4,0,8
36180,arinā,arina,1,1,0,0,5
36181,ucchijjamānassa,ucchijjamanassa,1,1,0,0,15
36182,hīnasattino,hinasattino,1,1,0,0,11
36183,balavadhammavijayisamāsayanaṃ,balavadhammavijayisamasayanam,1,1,0,0,29
36184,balino,balino,14,14,0,0,6
36185,kosādippadānena,kosadippadanena,1,1,0,0,15
36186,āsayanaṃ,asayanam,3,3,0,0,8
36187,yasmiñca,yasminca,109,103,6,0,8
36188,vijigīso,vijigiso,1,1,0,0,8
36189,sakkotyattano,sakkotyattano,1,1,0,0,13
36190,aṭṭhavaggiyakammāni,atthavaggiyakammani,1,1,0,0,19
36191,pavattayituṃ,pavattayitum,2,2,0,0,12
36192,cetānyupahantuṃ,cetanyupahantum,1,1,0,0,15
36193,guṇamādhiṭṭheyya,gunamadhittheyya,1,1,0,0,16
36194,kasi,kasi,33,29,4,0,4
36195,vaṇijjaṃ,vanijjam,35,34,1,0,8
36196,kuñjarabandhanaṃ,kunjarabandhanam,1,1,0,0,16
36197,khanyākaradhanādānaṃ,khanyakaradhanadanam,1,1,0,0,20
36198,suññānañca,sunnananca,1,1,0,0,10
36199,ityeso,ityeso,1,1,0,0,6
36200,aṭṭhavaggo,atthavaggo,1,1,0,0,10
36201,sakammānaṃ,sakammanam,1,1,0,0,10
36202,nābhipassati,nabhipassati,1,1,0,0,12
36203,sakammānamupaghātaṃ,sakammanamupaghatam,1,1,0,0,19
36204,tiṭṭheyya,tittheyya,278,271,7,0,9
36205,nītivedīnaṃ,nitivedinam,1,1,0,0,11
36206,tivaggo,tivaggo,16,13,3,0,7
36207,dhammatthakāmā,dhammatthakama,1,1,0,0,14
36208,M0.0248,M0.0248,56,56,0,0,7
36209,guyhe,guyhe,6,6,0,0,5
36210,rahassaṃ,rahassam,85,82,3,0,8
36211,rahe,rahe,3,3,0,0,4
36212,guha,guha,15,3,12,0,4
36213,rahasso,rahasso,6,5,1,0,7
36214,rahassā,rahassa,2,2,0,0,7
36215,mantanaṃ,mantanam,13,10,3,0,8
36216,para353,para353,105,105,0,0,7
36217,vijane,vijane,5,4,1,0,6
36218,viji,viji,2,1,1,0,4
36219,puthabhāve,puthabhave,2,2,0,0,10
36220,vici,vici,3,1,2,0,4
36221,vivecane,vivecane,6,6,0,0,8
36222,puthubhāve,puthubhave,1,1,0,0,10
36223,vivittaṃ,vivittam,227,204,23,0,8
36224,asaṃpakkapavittesū,asampakkapavittesu,1,1,0,0,18
36225,asmāti,asmati,14,10,4,0,6
36226,vijano,vijano,1,0,1,0,6
36227,channo,channo,195,189,6,0,6
36228,vittamarahatīti,vittamarahatiti,1,1,0,0,15
36229,raho,raho,547,492,55,0,4
36230,ramante,ramante,7,7,0,0,7
36231,nidhuvane,nidhuvane,1,1,0,0,9
36232,dutiyo,dutiyo,1229,1190,39,0,6
36233,nissalākā,nissalaka,2,2,0,0,9
36234,upāsupyatra,upasupyatra,1,1,0,0,11
36235,upāsu,upasu,1,1,0,0,5
36236,vissāse,vissase,23,21,2,0,7
36237,sambha,sambha,3,1,2,0,6
36238,vissambho,vissambho,2,2,0,0,9
36239,kelikalahe,kelikalahe,1,1,0,0,10
36240,paṇayepi,panayepi,1,1,0,0,8
36241,nyāye,nyaye,1,1,0,0,5
36242,upagantabbattā,upagantabbatta,2,2,0,0,14
36243,upāyikaṃ,upayikam,1,0,1,0,8
36244,opāyikaṃ,opayikam,17,10,7,0,8
36245,opayikampi,opayikampi,1,1,0,0,10
36246,labbhaṃ,labbham,36,28,8,0,7
36247,bhajamānaṃ,bhajamanam,1,1,0,0,10
36248,abhinītaṃ,abhinitam,1,1,0,0,9
36249,nyāyaṃ,nyayam,1,1,0,0,6
36250,ñāyaṃpyatra,nayampyatra,1,1,0,0,11
36251,para354,para354,100,100,0,0,7
36252,silokaṃ,silokam,20,18,2,0,7
36253,ovāde,ovade,187,183,4,0,5
36254,anusiṭṭhimhi,anusitthimhi,4,4,0,0,12
36255,āssi,assi,1,1,0,0,4
36256,anusiṭṭhi,anusitthi,40,37,3,0,9
36257,M0.0249,M0.0249,55,55,0,0,7
36258,anusāsate,anusasate,1,1,0,0,9
36259,pumavajje,pumavajje,2,1,1,0,9
36260,ekassevatthassa,ekassevatthassa,8,8,0,0,15
36261,bhinnaliṅgehi,bhinnalingehi,1,1,0,0,13
36262,vāccaliṅgoyeva,vaccalingoyeva,1,1,0,0,14
36263,vācakaliṅgopyatthīti,vacakalingopyatthiti,1,1,0,0,20
36264,dīpanatthaṃ,dipanattham,52,52,0,0,11
36265,āṇāyaṃ,anayam,5,4,1,0,6
36266,āṇa,ana,5,2,3,0,3
36267,avavādo,avavado,1,1,0,0,7
36268,siṭṭhipyatra,sitthipyatra,1,1,0,0,12
36269,viyogadānato,viyogadanato,1,1,0,0,12
36270,uddānaṃ,uddanam,38,32,6,0,7
36271,para355-356,para355-356,1,1,0,0,11
36272,aparādhe,aparadhe,18,18,0,0,8
36273,apagacchantyanenāti,apagacchantyanenati,1,1,0,0,19
36274,rādho,radho,45,45,0,0,5
36275,aparādho,aparadho,82,72,10,0,8
36276,rādha,radha,148,134,14,0,5
36277,rājagayhe,rajagayhe,1,1,0,0,9
36278,sāhacariyato,sahacariyato,1,1,0,0,12
36279,bhāgadheyyopyatra,bhagadheyyopyatra,1,1,0,0,17
36280,bhāgā,bhaga,48,43,5,0,5
36281,bhāgattena,bhagattena,1,1,0,0,10
36282,bhāgadheyyo,bhagadheyyo,1,0,1,0,11
36283,tuṭṭhidāye,tutthidaye,1,1,0,0,10
36284,manorathapuṇṇattā,manorathapunnatta,1,1,0,0,17
36285,pattabbo,pattabbo,29,29,0,0,8
36286,puṇṇapatto,punnapatto,2,1,1,0,10
36287,tussanaṃ,tussanam,9,9,0,0,8
36288,sossatthīti,sossatthiti,1,1,0,0,11
36289,tuṭṭhī,tutthi,8,7,1,0,6
36290,dātabbo,databbo,709,688,21,0,7
36291,dāyo,dayo,15,12,3,0,4
36292,tuṭṭhidāyo,tutthidayo,3,2,1,0,10
36293,ākārantānamāyo,akarantanamayo,10,8,2,0,14
36294,M0.0250,M0.0250,56,56,0,0,7
36295,pābhate,pabhate,3,2,1,0,7
36296,hemaṃ,hemam,17,16,1,0,5
36297,sīhāsanaṃ,sihasanam,20,17,3,0,9
36298,vesaṃ,vesam,15,15,0,0,5
36299,bhaddāsanaṃ,bhaddasanam,1,1,0,0,11
36300,upāyana,upayana,1,1,0,0,7
36301,mupaggayhaṃ,mupaggayham,1,1,0,0,11
36302,pābhatañco,pabhatanco,1,1,0,0,10
36303,padā,pada,90,79,11,0,4
36304,silokāddhaṃ,silokaddham,1,1,0,0,11
36305,upagantvādātabbāti,upagantvadatabbati,1,1,0,0,18
36306,upadā,upada,3,1,2,0,5
36307,tamatthaṃ,tamattham,1181,1155,26,0,9
36308,patthentehi,patthentehi,11,11,0,0,11
36309,ābharīyate,abhariyate,1,1,0,0,10
36310,ānīyateti,aniyateti,2,2,0,0,9
36311,pābhataṃ,pabhatam,33,21,12,0,8
36312,patthanatthajotakoyaṃ,patthanatthajotakoyam,1,1,0,0,21
36313,pasaddo,pasaddo,11,10,1,0,7
36314,upeyyateti,upeyyateti,1,1,0,0,10
36315,upāyanaṃ,upayanam,21,18,3,0,8
36316,koco,koco,1,1,0,0,4
36317,ukkoco,ukkoco,1,0,1,0,6
36318,paṇṇena,pannena,67,65,2,0,7
36319,satthapaṇṇena,satthapannena,1,1,0,0,13
36320,ākarīyate,akariyate,1,1,0,0,9
36321,paṇṇākāro,pannakaro,18,17,1,0,9
36322,upacārā,upacara,27,23,4,0,7
36323,pahiṇantyaneneti,pahinantyaneneti,1,1,0,0,16
36324,paheṇakaṃ,pahenakam,4,3,1,0,9
36325,padesanaṃ,padesanam,2,1,1,0,9
36326,upaggayhaṃ,upaggayham,1,1,0,0,10
36327,upahāropyatra,upaharopyatra,1,1,0,0,13
36328,gumbādideyyo,gumbadideyyo,1,1,0,0,12
36329,gumbaghaṭādiko,gumbaghatadiko,1,1,0,0,14
36330,gumbaghaṭādito,gumbaghatadito,1,1,0,0,14
36331,deyyosuṅkaṃ,deyyosunkam,1,1,0,0,11
36332,gumbo,gumbo,22,16,6,0,5
36333,jalathalamaggādīsu,jalathalamaggadisu,1,1,0,0,18
36334,laddhabbabhāgo,laddhabbabhago,1,1,0,0,14
36335,ghaṭṭopi,ghattopi,1,1,0,0,8
36336,hete,hete,159,151,8,0,4
36337,pābhatampi,pabhatampi,1,1,0,0,10
36338,suṅka,sunka,1,0,1,0,5
36339,suṅkati,sunkati,1,1,0,0,7
36340,suṅkaṃ,sunkam,67,59,8,0,6
36341,gāmajanapadādito,gamajanapadadito,1,1,0,0,16
36342,laddhabbabhāge,laddhabbabhage,1,1,0,0,14
36343,dhanāgamo,dhanagamo,3,2,1,0,9
36344,para357,para357,98,98,0,0,7
36345,chattasāmaññe,chattasamanne,1,1,0,0,13
36346,ātapato,atapato,2,2,0,0,7
36347,sūriyālokato,suriyalokato,1,1,0,0,12
36348,ātapattaṃ,atapattam,6,5,1,0,9
36349,M0.0251,M0.0251,55,55,0,0,7
36350,apavāraṇe,apavarane,6,4,2,0,9
36351,chatraṃ,chatram,3,3,0,0,7
36352,suvaṇṇakhacitaṃ,suvannakhacitam,8,8,0,0,15
36353,sīhāsanā,sihasana,1,0,1,0,8
36354,sīhākatippadhānattā,sihakatippadhanatta,1,1,0,0,19
36355,sīhākatippadhānaṃ,sihakatippadhanam,1,1,0,0,17
36356,āsananti,asananti,7,7,0,0,8
36357,cāmare,camare,3,3,0,0,6
36358,vālena,valena,8,8,0,0,6
36359,vālabījanī,valabijani,5,4,1,0,10
36360,camaro,camaro,6,3,3,0,6
36361,tassedaṃ,tassedam,12,12,0,0,8
36362,cāmarī,camari,13,9,4,0,6
36363,gucchakañcāvacūlakaṃ,gucchakancavaculakam,1,1,0,0,20
36364,pakiṇṇakaṃpyatra,pakinnakampyatra,1,1,0,0,16
36365,pakarīyate,pakariyate,1,1,0,0,10
36366,vikkhipate,vikkhipate,7,6,1,0,10
36367,pakiṇṇakaṃ,pakinnakam,59,48,11,0,10
36368,para358,para358,87,87,0,0,7
36369,khaggādayo,khaggadayo,1,1,0,0,10
36370,kakudhabhaṇḍāni,kakudhabhandani,5,3,2,0,15
36371,gamanakāle,gamanakale,137,135,2,0,10
36372,ādātabbato,adatabbato,6,6,0,0,10
36373,kakudhāni,kakudhani,3,3,0,0,9
36374,rājadhanattā,rajadhanatta,1,1,0,0,12
36375,bhaṇḍāni,bhandani,16,16,0,0,8
36376,para359,para359,98,98,0,0,7
36377,puṇṇaghaṭe,punnaghate,33,33,0,0,10
36378,jalapuṇṇattā,jalapunnatta,1,1,0,0,12
36379,bhaddakumbho,bhaddakumbho,2,1,1,0,12
36380,hemabhājane,hemabhajane,1,1,0,0,11
36381,posanañca,posananca,2,2,0,0,9
36382,dhāraṇatthassa,dharanatthassa,2,2,0,0,14
36383,tissa,tissa,433,427,6,0,5
36384,bhiṅgā,bhinga,4,3,1,0,6
36385,bharati,bharati,32,31,1,0,7
36386,dadhāti,dadhati,17,17,0,0,7
36387,bhiṅgāro,bhingaro,4,2,2,0,8
36388,karako,karako,4,3,1,0,6
36389,kuṇḍikāpyatra,kundikapyatra,1,1,0,0,13
36390,M0.0252,M0.0252,55,55,0,0,7
36391,hatthissarathapatti,hatthissarathapatti,1,1,0,0,19
36392,caturaṅginī,caturangini,35,32,3,0,11
36393,senātyuccate,senatyuccate,1,1,0,0,12
36394,senaṅgattā,senangatta,1,1,0,0,10
36395,samāhāradvandoyaṃ,samaharadvandoyam,1,1,0,0,17
36396,para360,para360,93,93,0,0,7
36397,dantya,dantya,1,0,1,0,6
36398,hatthini,hatthini,3,3,0,0,8
36399,kuñjo,kunjo,3,3,0,0,5
36400,kuñje,kunje,5,5,0,0,5
36401,girikūṭe,girikute,2,2,0,0,8
36402,ramati,ramati,165,155,10,0,6
36403,koñcanādaṃ,koncanadam,25,25,0,0,10
36404,nadanto,nadanto,65,63,2,0,7
36405,tadāghātena,tadaghatena,1,1,0,0,11
36406,jarayatīti,jarayatiti,3,3,0,0,10
36407,vārayati,varayati,5,5,0,0,8
36408,hatthayogā,hatthayoga,2,2,0,0,10
36409,mataṅgassa,matangassa,2,2,0,0,10
36410,mātaṅgo,matango,55,49,6,0,7
36411,sarīrametassāti,sarirametassati,2,2,0,0,15
36412,assākāro,assakaro,1,1,0,0,8
36413,radā,rada,2,2,0,0,4
36414,dvirado,dvirado,3,2,1,0,7
36415,gaja,gaja,6,1,5,0,4
36416,gajatīti,gajatiti,1,1,0,0,8
36417,nago,nago,24,19,5,0,4
36418,dvipo,dvipo,3,2,1,0,5
36419,dantayogā,dantayoga,1,1,0,0,9
36420,dantī,danti,22,20,2,0,5
36421,saṭṭhihāyano,satthihayano,9,8,1,0,12
36422,dantāvalo,dantavalo,1,1,0,0,9
36423,anekapo,anekapo,1,1,0,0,7
36424,mataṅgajo,matangajo,1,1,0,0,9
36425,karī,kari,61,60,1,0,4
36426,thambheramo,thambheramo,1,1,0,0,11
36427,padmī,padmi,1,1,0,0,5
36428,mahāmigo,mahamigo,6,6,0,0,8
36429,pīlu,pilu,2,2,0,0,4
36430,sindhuro,sindhuro,1,1,0,0,8
36431,dīghamāruto,dighamaruto,1,1,0,0,11
36432,rājīvo,rajivo,1,1,0,0,6
36433,jalakakkho,jalakakkho,1,1,0,0,10
36434,nilluro,nilluro,1,1,0,0,7
36435,karaṭī,karati,1,1,0,0,6
36436,varaṅgo,varango,1,1,0,0,7
36437,suppakaṇṇo,suppakanno,1,1,0,0,10
36438,saṭṭhivassikattā,satthivassikatta,1,1,0,0,16
36439,saṭṭhivassakāle,satthivassakale,7,7,0,0,15
36440,thāmena,thamena,55,52,3,0,7
36441,hāyanato,hayanato,1,1,0,0,8
36442,vanakarīnaṃ,vanakarinam,1,1,0,0,11
36443,yūthajeṭṭho,yuthajettho,3,2,1,0,11
36444,sayūthānaṃ,sayuthanam,1,1,0,0,10
36445,sayūthe,sayuthe,1,1,0,0,7
36446,yūthapoti,yuthapoti,2,0,2,0,9
36447,para361,para361,92,92,0,0,7
36448,kāḷāvakādīni,kalavakadini,1,1,0,0,12
36449,M0.0253,M0.0253,55,55,0,0,7
36450,hatthirājānaṃ,hatthirajanam,2,2,0,0,13
36451,kalambate,kalambate,1,1,0,0,9
36452,gaṅgāyaṃ,gangayam,45,44,1,0,8
36453,gaṅgeyyo,gangeyyo,14,13,1,0,8
36454,ṭhānavasena,thanavasena,18,18,0,0,11
36455,paṇḍaravaṇṇatāya,pandaravannataya,1,1,0,0,16
36456,vaṇṇavasena,vannavasena,39,39,0,0,11
36457,tambavaṇṇatāya,tambavannataya,1,1,0,0,14
36458,piṅgalavaṇṇatāya,pingalavannataya,1,1,0,0,16
36459,gandhayuttatāya,gandhayuttataya,1,1,0,0,15
36460,sobhanagamanayuttatāya,sobhanagamanayuttataya,1,1,0,0,22
36461,atisāyane,atisayane,2,2,0,0,9
36462,hemavaṇṇatāya,hemavannataya,1,1,0,0,13
36463,uposathakule,uposathakule,5,5,0,0,12
36464,arayo,arayo,15,15,0,0,5
36465,usatīti,usatiti,2,2,0,0,7
36466,tithīviseso,tithiviseso,1,1,0,0,11
36467,chabbaṇṇadantatāya,chabbannadantataya,1,1,0,0,18
36468,chaddanto,chaddanto,28,24,4,0,9
36469,etesañca,etesanca,28,28,0,0,8
36470,yāvachaddantā,yavachaddanta,1,1,0,0,13
36471,netabbo,netabbo,148,147,1,0,7
36472,kāḷāvakahatthigaṇanāya,kalavakahatthigananaya,1,1,0,0,22
36473,koṭisahassabalaṃ,kotisahassabalam,1,1,0,0,16
36474,para362,para362,100,100,0,0,7
36475,karipote,karipote,1,1,0,0,8
36476,pañcavassāni,pancavassani,10,10,0,0,12
36477,kalabho,kalabho,5,5,0,0,7
36478,ḷatte,latte,3,3,0,0,5
36479,kaḷabho,kalabho,2,1,1,0,7
36480,mātāpitūhi,matapituhi,201,195,6,0,10
36481,M0.0254,M0.0254,56,56,0,0,7
36482,bharitabbattā,bharitabbatta,1,1,0,0,13
36483,bhiṅko,bhinko,3,1,2,0,6
36484,karisāvakopyatra,karisavakopyatra,1,1,0,0,16
36485,mattamātaṅge,mattamatange,1,1,0,0,12
36486,pabhinno,pabhinno,6,5,1,0,8
36487,majjatīti,majjatiti,5,3,2,0,9
36488,gaje,gaje,18,17,1,0,4
36489,gajjo,gajjo,1,1,0,0,5
36490,sañjāto,sanjato,36,32,4,0,7
36491,gajjito,gajjito,2,1,1,0,7
36492,hatthisamūhe,hatthisamuhe,1,1,0,0,12
36493,hatthighaṭā,hatthighata,5,4,1,0,11
36494,gajatā,gajata,6,5,1,0,6
36495,gāmajanabandhusahāyādīhi,gamajanabandhusahayadihi,3,2,1,0,24
36496,hatthiniyaṃ,hatthiniyam,2,1,1,0,11
36497,hatthinī,hatthini,17,16,1,0,8
36498,kareṇukā,karenuka,12,10,2,0,8
36499,karayogā,karayoga,1,1,0,0,8
36500,iṇu,inu,3,2,1,0,3
36501,kariṇī,karini,1,1,0,0,6
36502,dhenukā,dhenuka,1,1,0,0,7
36503,kareṇupyatra,karenupyatra,1,1,0,0,12
36504,para363,para363,96,96,0,0,7
36505,hatthisiropiṇḍā,hatthisiropinda,2,1,1,0,15
36506,piṇḍā,pinda,7,6,1,0,5
36507,kumbhākhyā,kumbhakhya,1,1,0,0,10
36508,kumbhānaṃ,kumbhanam,3,3,0,0,9
36509,vidu,vidu,3,2,1,0,4
36510,aṅkusasaṅghātaṃ,ankusasanghatam,1,1,0,0,15
36511,vindatyasminti,vindatyasminti,1,1,0,0,14
36512,kaṇṇamūle,kannamule,45,41,4,0,9
36513,nimajjane,nimajjane,1,1,0,0,9
36514,cūḷikā,culika,2,0,2,0,6
36515,cuda,cuda,3,1,2,0,4
36516,codenti,codenti,83,83,0,0,7
36517,ṅkusādīhi,nkusadihi,1,1,0,0,9
36518,adantanti,adantanti,1,1,0,0,9
36519,khandhadeso,khandhadeso,3,2,1,0,11
36520,pucchamūle,pucchamule,1,1,0,0,10
36521,pucchassa,pucchassa,1,1,0,0,9
36522,heṭṭhimabhāgo,hetthimabhago,2,2,0,0,13
36523,para364,para364,101,101,0,0,7
36524,gajabandhanathambhe,gajabandhanathambhe,1,1,0,0,19
36525,ālantyasmiṃ,alantyasmim,1,1,0,0,11
36526,ālānaṃ,alanam,1,0,1,0,6
36527,bandhanattho,bandhanattho,2,2,0,0,12
36528,āhananti,ahananti,4,4,0,0,8
36529,M0.0255,M0.0255,55,55,0,0,7
36530,bandhantyasmiṃ,bandhantyasmim,1,1,0,0,14
36531,āḷhako,alhako,14,10,4,0,6
36532,bandhopyatra,bandhopyatra,1,1,0,0,12
36533,saṅkhale,sankhale,1,1,0,0,8
36534,nigaḷati,nigalati,1,1,0,0,8
36535,nigaḷo,nigalo,9,8,1,0,6
36536,adi,adi,4,0,4,0,3
36537,andatīti,andatiti,1,1,0,0,8
36538,anduko,anduko,1,0,1,0,6
36539,khalatyanena,khalatyanena,1,1,0,0,12
36540,saṅkhalaṃ,sankhalam,3,2,1,0,9
36541,vatthabandhanepi,vatthabandhanepi,1,1,0,0,16
36542,thīkaṭīvatthabandhepi,thikativatthabandhepi,1,1,0,0,21
36543,nigaḷe,nigale,1,1,0,0,6
36544,tisū,tisu,7,7,0,0,4
36545,saṅkhalikāpyatra,sankhalikapyatra,1,1,0,0,16
36546,gajagaṇḍe,gajagande,2,2,0,0,9
36547,gaṇḍa,ganda,7,2,5,0,5
36548,adhātūnampi,adhatunampi,1,1,0,0,11
36549,kriyattho,kriyattho,7,7,0,0,9
36550,gaṇḍo,gando,124,105,19,0,5
36551,kapolasāmaññepi,kapolasamannepi,1,1,0,0,15
36552,karimadajale,karimadajale,1,1,0,0,12
36553,dīyateti,diyateti,5,3,2,0,8
36554,para365,para365,99,99,0,0,7
36555,hatthikare,hatthikare,2,2,0,0,10
36556,vaṇṇagatīsu,vannagatisu,3,2,1,0,11
36557,soḍa,soda,1,0,1,0,4
36558,gabbe,gabbe,4,2,2,0,5
36559,soṇḍagge,sondagge,1,1,0,0,8
36560,soṇḍassa,sondassa,3,3,0,0,8
36561,vuḍḍhimhi,vuddhimhi,5,5,0,0,9
36562,snehasecanapūraṇesu,snehasecanapuranesu,2,2,0,0,19
36563,kiyādi,kiyadi,9,3,6,0,6
36564,hatthissa,hatthissa,71,71,0,0,9
36565,kāyamajjhamhi,kayamajjhamhi,1,1,0,0,13
36566,bandhanarajju,bandhanarajju,1,1,0,0,13
36567,kacchā,kaccha,16,13,3,0,6
36568,dūsā,dusa,1,1,0,0,4
36569,varatrāpyatra,varatrapyatra,1,1,0,0,13
36570,kutho,kutho,4,2,2,0,5
36571,hatthipiṭṭhattharitacitrakambalaṃ,hatthipitthattharitacitrakambalam,1,1,0,0,33
36572,kuthādayo,kuthadayo,3,2,1,0,9
36573,kappano,kappano,2,1,1,0,7
36574,sajjanāyañca,sajjanayanca,1,1,0,0,12
36575,M0.0256,M0.0256,56,56,0,0,7
36576,kappanāpi,kappanapi,1,1,0,0,9
36577,sajjanāyaṃ,sajjanayam,1,1,0,0,10
36578,napuṃsakamattharaṇaṃ,napumsakamattharanam,1,1,0,0,20
36579,kuthaṃ,kutham,1,1,0,0,6
36580,paritthomoti,paritthomoti,1,1,0,0,12
36581,kutha,kutha,5,2,3,0,5
36582,para366,para366,101,101,0,0,7
36583,rājārahe,rajarahe,2,2,0,0,8
36584,rājānamupagantvā,rajanamupagantva,1,1,0,0,16
36585,vahitumarahatīti,vahitumarahatiti,2,2,0,0,16
36586,opavayho,opavayho,6,5,1,0,8
36587,arahatthe,arahatthe,17,16,1,0,9
36588,rājānaṃ,rajanam,1523,1504,19,0,7
36589,rājavayho,rajavayho,2,1,1,0,9
36590,kappitahatthini,kappitahatthini,1,1,0,0,15
36591,sajjā,sajja,18,12,6,0,5
36592,sajjanā,sajjana,14,14,0,0,7
36593,kappanā,kappana,13,12,1,0,7
36594,kappito,kappito,8,7,1,0,7
36595,etasmāyeva,etasmayeva,3,3,0,0,10
36596,pāṭhā,patha,26,26,0,0,5
36597,sajjakappā,sajjakappa,1,1,0,0,10
36598,sajjanākappanānaṃ,sajjanakappananam,1,1,0,0,17
36599,pariyāyāti,pariyayati,2,2,0,0,10
36600,vijjhanakaṇṭako,vijjhanakantako,4,4,0,0,15
36601,tujjateneneti,tujjateneneti,2,2,0,0,13
36602,tuda,tuda,13,4,9,0,4
36603,byathane,byathane,13,10,3,0,8
36604,veṇukaṃpyatra,venukampyatra,1,1,0,0,13
36605,kotraṃ,kotram,1,1,0,0,6
36606,veṇukamālānaṃ,venukamalanam,1,1,0,0,13
36607,veḷukantipi,velukantipi,1,1,0,0,11
36608,para367,para367,96,96,0,0,7
36609,kaṇṇamūlamhi,kannamulamhi,2,2,0,0,12
36610,tutta,tutta,2,2,0,0,5
36611,tuttaṃ,tuttam,5,1,4,0,6
36612,matthakamhi,matthakamhi,4,4,0,0,11
36613,aṅkate,ankate,1,1,0,0,6
36614,M0.0257,M0.0257,56,56,0,0,7
36615,hatthārohe,hattharohe,9,9,0,0,10
36616,maṇḍayati,mandayati,6,6,0,0,9
36617,hatthimaṇḍo,hatthimando,1,1,0,0,11
36618,hatthimeṇḍo,hatthimendo,7,6,1,0,11
36619,hatthipo,hatthipo,2,1,1,0,8
36620,gopayati,gopayati,5,5,0,0,8
36621,hatthigopako,hatthigopako,5,4,1,0,12
36622,ādhoraṇo,adhorano,1,1,0,0,8
36623,nisādinopyatra,nisadinopyatra,1,1,0,0,14
36624,para368,para368,84,84,0,0,7
36625,mātaṅgahayādīnaṃ,matangahayadinam,1,1,0,0,16
36626,gamanādikriyāsikkhāpako,gamanadikriyasikkhapako,1,1,0,0,23
36627,gāmaṇīyo,gamaniyo,5,1,4,0,8
36628,hatthādīnaṃ,hatthadinam,11,10,1,0,11
36629,gamanakriyā,gamanakriya,2,2,0,0,11
36630,sikkhāpetīti,sikkhapetiti,8,8,0,0,12
36631,aññakriyāsikkhāpanetūpacārā,annakriyasikkhapanetupacara,1,1,0,0,27
36632,gāmaṃ,gamam,1214,1168,46,0,5
36633,hatthādisamūhaṃ,hatthadisamuham,1,1,0,0,15
36634,asse,asse,128,126,2,0,4
36635,turaṃ,turam,13,13,0,0,5
36636,turaṅgo,turango,10,9,1,0,7
36637,bindālopo,bindalopo,1,1,0,0,9
36638,turago,turago,8,6,2,0,6
36639,vāha,vaha,5,3,2,0,4
36640,sindhūnamadūrabhavo,sindhunamadurabhavo,1,1,0,0,19
36641,janapadopi,janapadopi,8,8,0,0,10
36642,sindhavo,sindhavo,19,16,3,0,8
36643,ghoṭako,ghotako,6,4,2,0,7
36644,turaṅgamo,turangamo,2,2,0,0,9
36645,vājī,vaji,5,4,1,0,4
36646,sattiriccādīnipi,sattiriccadinipi,1,1,0,0,16
36647,vājayogā,vajayoga,1,1,0,0,8
36648,devetyatyatthitena,devetyatyatthitena,1,1,0,0,18
36649,sālībhūta,salibhuta,1,0,1,0,9
36650,sakkaṃ,sakkam,239,227,12,0,6
36651,payojetvā,payojetva,52,49,3,0,9
36652,vajirachedito,vajirachedito,1,1,0,0,13
36653,sāmatthiyepi,samatthiyepi,1,1,0,0,12
36654,para369,para369,86,86,0,0,7
36655,M0.0258,M0.0258,54,54,0,0,7
36656,assassa,assassa,45,45,0,0,7
36657,assataro,assataro,11,8,3,0,8
36658,atikkamane,atikkamane,11,10,1,0,10
36659,paccayenāpi,paccayenapi,3,3,0,0,11
36660,padhānassabhūmibhavo,padhanassabhumibhavo,1,1,0,0,20
36661,sujātiko,sujatiko,1,1,0,0,8
36662,avikārī,avikari,1,1,0,0,7
36663,kulīnako,kulinako,3,2,1,0,8
36664,ājānīyo,ajaniyo,23,19,4,0,7
36665,kiyādito,kiyadito,8,6,2,0,8
36666,sambhūto,sambhuto,66,64,2,0,8
36667,īno,ino,2,2,0,0,3
36668,saṅgāme,sangame,128,121,7,0,7
36669,garusatthappahārena,garusatthappaharena,1,1,0,0,19
36670,vahanasīlo,vahanasilo,2,2,0,0,10
36671,vinīta,vinita,1,0,1,0,6
36672,saddenoccate,saddenoccate,3,3,0,0,12
36673,dammataṃ,dammatam,2,2,0,0,8
36674,vinīto,vinito,36,32,4,0,6
36675,assapote,assapote,1,1,0,0,8
36676,oro,oro,7,6,1,0,3
36677,kisoro,kisoro,6,4,2,0,6
36678,bindulopo,bindulopo,12,12,0,0,9
36679,hayo,hayo,16,14,2,0,4
36680,hayapotako,hayapotako,2,1,1,0,10
36681,appatthe,appatthe,14,13,1,0,8
36682,para370,para370,77,77,0,0,7
36683,athāmasse,athamasse,1,1,0,0,9
36684,assasāmaññepyayaṃ,assasamannepyayam,1,1,0,0,17
36685,kharaṃ,kharam,36,28,8,0,6
36686,khaluṅgo,khalungo,1,1,0,0,8
36687,khaḷuṅko,khalunko,9,7,2,0,8
36688,ḷattamuttañca,lattamuttanca,1,1,0,0,13
36689,khaḷukotipi,khalukotipi,1,1,0,0,11
36690,sabbesamadhiko,sabbesamadhiko,1,1,0,0,14
36691,javano,javano,6,5,1,0,6
36692,M0.0259,M0.0259,54,54,0,0,7
36693,kavītikhyāte,kavitikhyate,1,1,0,0,12
36694,mukhabandhane,mukhabandhane,1,1,0,0,13
36695,mukhamātiṭṭhatīti,mukhamatitthatiti,1,1,0,0,17
36696,mukhāṭhānaṃ,mukhathanam,2,1,1,0,11
36697,līno,lino,12,12,0,0,4
36698,khalīno,khalino,3,2,1,0,7
36699,kavikā,kavika,2,2,0,0,6
36700,khalīnoti,khalinoti,1,1,0,0,9
36701,khalīne,khaline,1,1,0,0,7
36702,kaviyaṃ,kaviyam,1,1,0,0,7
36703,kathanaṃtyapī,kathanamtyapi,1,1,0,0,13
36704,kavikāpyatra,kavikapyatra,1,1,0,0,12
36705,nitthī,nitthi,38,38,0,0,6
36706,assābhitāḷinī,assabhitalini,1,1,0,0,13
36707,vettavikatādi,vettavikatadi,1,1,0,0,13
36708,kasā,kasa,13,11,2,0,4
36709,para371,para371,83,83,0,0,7
36710,nāsāgatarajjumhi,nasagatarajjumhi,1,1,0,0,16
36711,assāyaṃ,assayam,1,1,0,0,7
36712,vaḷavā,valava,23,21,2,0,6
36713,vāmīpyatra,vamipyatra,1,1,0,0,10
36714,khure,khure,7,6,1,0,5
36715,khura,khura,7,1,6,0,5
36716,pharatyanena,pharatyanena,1,1,0,0,12
36717,saphaṃ,sapham,3,2,1,0,6
36718,klīve,klive,2,2,0,0,5
36719,khuro,khuro,11,10,1,0,5
36720,amarakoso,amarakoso,2,0,2,0,9
36721,pucchamatte,pucchamatte,1,1,0,0,11
36722,naṅguṭṭho,nanguttho,1,0,1,0,9
36723,lūmaṃpyatra,lumampyatra,1,1,0,0,11
36724,kesavati,kesavati,1,1,0,0,8
36725,naṅguṭṭhamatte,nangutthamatte,1,1,0,0,14
36726,vālasamūhayogā,valasamuhayoga,1,1,0,0,14
36727,vālahattho,valahattho,2,1,1,0,10
36728,tathātrāpi,tathatrapi,5,5,0,0,10
36729,vāladhi,valadhi,21,19,2,0,7
36730,etthānāgatāpi,etthanagatapi,1,1,0,0,13
36731,dhārākhyā,dharakhya,1,1,0,0,9
36732,dhāvākhyā,dhavakhya,1,1,0,0,9
36733,akkanditaṃ,akkanditam,2,1,1,0,10
36734,M0.0260,M0.0260,55,55,0,0,7
36735,dhoritakaṃ,dhoritakam,2,1,1,0,10
36736,recitaṃ,recitam,2,1,1,0,7
36737,vaggitaṃ,vaggitam,4,2,2,0,8
36738,plutaṃ,plutam,2,1,1,0,6
36739,gatiyome,gatiyome,1,1,0,0,8
36740,dhāvā,dhava,2,2,0,0,5
36741,viññunā,vinnuna,103,96,7,0,7
36742,vitthambhā,vitthambha,1,1,0,0,10
36743,samāvagati,samavagati,1,1,0,0,10
36744,kandi,kandi,6,5,1,0,5
36745,caturāgati,caturagati,1,1,0,0,10
36746,dhora,dhora,3,0,3,0,5
36747,gaticāturiye,gaticaturiye,3,2,1,0,12
36748,maṇḍalikāyānena,mandalikayanena,1,1,0,0,15
36749,viyojanasambajjhanesu,viyojanasambajjhanesu,2,2,0,0,21
36750,sambajjhanaṃ,sambajjhanam,7,7,0,0,12
36751,missanaṃ,missanam,3,3,0,0,8
36752,parikkhitto,parikkhitto,88,83,5,0,11
36753,paricaraṇaṃ,paricaranam,10,10,0,0,11
36754,vagga,vagga,21,18,3,0,5
36755,samena,samena,251,236,15,0,6
36756,plu,plu,3,1,2,0,3
36757,dutta,dutta,1,1,0,0,5
36758,massasatthe,massasatthe,1,1,0,0,11
36759,dhiko,dhiko,2,2,0,0,5
36760,vegī,vegi,2,2,0,0,4
36761,turitasso,turitasso,1,1,0,0,9
36762,para372,para372,73,73,0,0,7
36763,yuddhatthe,yuddhatthe,1,1,0,0,10
36764,cakkayuttayāne,cakkayuttayane,1,1,0,0,14
36765,sanda,sanda,7,1,6,0,5
36766,sandate,sandate,9,9,0,0,7
36767,gamyateneneti,gamyateneneti,1,1,0,0,13
36768,sandano,sandano,3,2,1,0,7
36769,ramateneneti,ramateneneti,1,1,0,0,12
36770,sataṅgopyatra,satangopyatra,1,1,0,0,13
36771,satamaṅgānyassa,satamanganyassa,1,1,0,0,15
36772,raṇāya,ranaya,1,0,1,0,6
36773,yuddhatthaṃ,yuddhattham,6,6,0,0,11
36774,cakkayuttaṃ,cakkayuttam,2,2,0,0,11
36775,kīḷābhamanādyatthaṃ,kilabhamanadyattham,1,1,0,0,19
36776,pussaratho,pussaratho,4,2,2,0,10
36777,cakkayānaṃ,cakkayanam,1,1,0,0,10
36778,samarāya,samaraya,1,1,0,0,8
36779,pāsane,pasane,1,1,0,0,6
36780,pusanāmakena,pusanamakena,1,1,0,0,12
36781,phalavisesena,phalavisesena,3,3,0,0,13
36782,pussanakkhattena,pussanakkhattena,1,1,0,0,16
36783,rathoti,rathoti,16,8,8,0,7
36784,byagghassa,byagghassa,31,30,1,0,10
36785,cammāvuto,cammavuto,3,3,0,0,9
36786,veyyaggho,veyyaggho,2,1,1,0,9
36787,veyyagghaṃ,veyyaggham,1,1,0,0,10
36788,parivuto,parivuto,376,374,2,0,8
36789,vuḍḍhāgamo,vuddhagamo,1,1,0,0,10
36790,paccattaṃ,paccattam,292,256,36,0,9
36791,M0.0261,M0.0261,55,55,0,0,7
36792,paccattameva,paccattameva,30,27,3,0,12
36793,paccatthameva,paccatthameva,1,1,0,0,13
36794,kāritantasmāpi,karitantasmapi,1,1,0,0,14
36795,payojakavasena,payojakavasena,1,1,0,0,14
36796,anekakāritapaccayā,anekakaritapaccaya,1,1,0,0,18
36797,dīpino,dipino,17,17,0,0,6
36798,para373,para373,82,82,0,0,7
36799,purisayuttayāne,purisayuttayane,1,1,0,0,15
36800,sivikā,sivika,24,21,3,0,6
36801,kitapaccayā,kitapaccaya,2,2,0,0,11
36802,kammādīsupi,kammadisupi,1,1,0,0,11
36803,kiccapaccayā,kiccapaccaya,2,2,0,0,12
36804,kattaripi,kattaripi,6,6,0,0,9
36805,nissayo,nissayo,439,410,29,0,7
36806,tapanīyā,tapaniya,39,34,5,0,8
36807,mahāpadesena,mahapadesena,2,2,0,0,12
36808,kitakiccapaccayānaṃ,kitakiccapaccayanam,1,1,0,0,19
36809,kattukammādīsvapi,kattukammadisvapi,1,1,0,0,17
36810,yāpyehi,yapyehi,1,1,0,0,7
36811,adhamehi,adhamehi,1,1,0,0,8
36812,yāyate,yayate,2,2,0,0,6
36813,niyyateti,niyyateti,3,3,0,0,9
36814,yāpyayānaṃ,yapyayanam,1,0,1,0,10
36815,yāpya,yapya,1,1,0,0,5
36816,pānīyake,paniyake,1,1,0,0,8
36817,nindye,nindye,1,1,0,0,6
36818,sakaṭe,sakate,34,33,1,0,6
36819,anaṃ,anam,3,2,1,0,4
36820,sakaṭo,sakato,9,8,1,0,6
36821,nitthītya,nitthitya,1,1,0,0,9
36822,marakoso,marakoso,3,0,3,0,8
36823,cakke,cakke,14,14,0,0,5
36824,gamanamaneneti,gamanamaneneti,1,1,0,0,14
36825,cakkādi,cakkadi,1,1,0,0,7
36826,rathaṅgaṃ,rathangam,5,3,2,0,9
36827,cakkassa,cakkassa,25,25,0,0,8
36828,nayati,nayati,59,58,1,0,6
36829,nemī,nemi,10,9,1,0,4
36830,padhipyatra,padhipyatra,1,1,0,0,11
36831,para374,para374,94,94,0,0,7
36832,tammajjhe,tammajjhe,2,1,1,0,9
36833,M0.0262,M0.0262,55,55,0,0,7
36834,cakkākāro,cakkakaro,2,2,0,0,9
36835,piṇḍikā,pindika,5,3,2,0,7
36836,kaṭṭhāni,katthani,72,71,1,0,8
36837,āsajjante,asajjante,1,1,0,0,9
36838,sāhacariyā,sahacariya,3,3,0,0,10
36839,piṇḍetīti,pindetiti,2,2,0,0,9
36840,piṇḍa,pinda,3,2,1,0,5
36841,piṇḍīpi,pindipi,1,1,0,0,7
36842,yugakaṭṭhaṃ,yugakattham,1,1,0,0,11
36843,āsajjate,asajjate,1,1,0,0,8
36844,acchādayatīti,acchadayatiti,1,1,0,0,13
36845,kubbaro,kubbaro,2,1,1,0,7
36846,abhidhānā,abhidhana,5,5,0,0,9
36847,akkho,akkho,32,25,7,0,5
36848,sakaṭaṃ,sakatam,120,114,6,0,7
36849,tadavayavo,tadavayavo,4,4,0,0,10
36850,cāhājayācariyo,cahajayacariyo,1,1,0,0,14
36851,vibhīṭake,vibhitake,1,1,0,0,9
36852,nimbe,nimbe,3,3,0,0,5
36853,rathassāvayave,rathassavayave,1,1,0,0,14
36854,kasse,kasse,3,3,0,0,5
36855,pāsakepya,pasakepya,1,1,0,0,9
36856,kkha,kkha,7,3,4,0,4
36857,mindriye,mindriye,2,2,0,0,8
36858,tassaggagate,tassaggagate,1,1,0,0,12
36859,kīle,kile,1,1,0,0,4
36860,āṇī,ani,8,6,2,0,3
36861,aṇipi,anipi,1,1,0,0,5
36862,sīmāssikkhaggakīlesu,simassikkhaggakilesu,1,1,0,0,20
36863,aṇī,ani,2,2,0,0,3
36864,akkhaggakīle,akkhaggakile,2,2,0,0,12
36865,sīmāssisu,simassisu,1,1,0,0,9
36866,nānatthasaṅgahopi,nanatthasangahopi,1,0,1,0,17
36867,kaṇḍakādisatthehi,kandakadisatthehi,1,1,0,0,17
36868,parirakkhaṇatthaṃ,parirakkhanattham,1,1,0,0,17
36869,rathāvaraṇo,rathavarano,1,1,0,0,11
36870,varutho,varutho,2,2,0,0,7
36871,rathaguttī,rathagutti,1,1,0,0,10
36872,varaṇe,varane,9,7,2,0,6
36873,varaṇametthāvaraṇaṃ,varanametthavaranam,1,1,0,0,19
36874,rathaṃ,ratham,379,369,10,0,6
36875,thiratthaṃ,thirattham,15,12,3,0,10
36876,taṭṭhañca,tatthanca,1,1,0,0,9
36877,gopatīti,gopatiti,1,1,0,0,8
36878,rathagutti,rathagutti,1,0,1,0,10
36879,gutti,gutti,18,17,1,0,5
36880,kārāgāre,karagare,1,1,0,0,8
36881,bhūgate,bhugate,1,1,0,0,7
36882,para375,para375,82,82,0,0,7
36883,rathādīnaṃ,rathadinam,3,3,0,0,10
36884,M0.0263,M0.0263,54,54,0,0,7
36885,purobhāgasaṅkhāte,purobhagasankhate,1,1,0,0,17
36886,dhuro,dhuro,8,5,3,0,5
36887,yānamukhaṃpyatra,yanamukhampyatra,1,1,0,0,16
36888,akkhopakkharādayo,akkhopakkharadayo,1,1,0,0,17
36889,rathacakkānaṃ,rathacakkanam,3,3,0,0,13
36890,antaragato,antaragato,1,1,0,0,10
36891,upakkharo,upakkharo,3,2,1,0,9
36892,akkhassopari,akkhassopari,1,1,0,0,12
36893,upakkhara,upakkhara,1,0,1,0,9
36894,sabbarathāvayavavācakattaṃ,sabbarathavayavavacakattam,1,1,0,0,26
36895,rathaṅgantu,rathangantu,1,1,0,0,11
36896,apakkharo,apakkharo,1,1,0,0,9
36897,hatthādike,hatthadike,1,1,0,0,10
36898,vāhane,vahane,11,11,0,0,6
36899,yānā,yana,48,44,4,0,4
36900,yujjatenenāti,yujjatenenati,1,1,0,0,13
36901,yoggaṃ,yoggam,60,53,7,0,6
36902,dhoraṇañcātra,dhoranancatra,1,1,0,0,13
36903,para376,para376,85,85,0,0,7
36904,sārathimhi,sarathimhi,7,7,0,0,10
36905,rathena,rathena,78,75,3,0,7
36906,rathacārī,rathacari,2,1,1,0,9
36907,perayatīti,perayatiti,1,1,0,0,10
36908,pājetīti,pajetiti,2,1,1,0,8
36909,pājitā,pajita,4,3,1,0,6
36910,aññatropacārā,annatropacara,3,3,0,0,13
36911,niyantā,niyanta,7,7,0,0,7
36912,yantā,yanta,5,5,0,0,5
36913,sabyaṭṭho,sabyattho,2,2,0,0,9
36914,dakkhiṇattho,dakkhinattho,2,2,0,0,12
36915,rathakuṭumbīpyatra,rathakutumbipyatra,1,1,0,0,18
36916,rathakuṭumbino,rathakutumbino,1,1,0,0,14
36917,M0.0264,M0.0264,54,54,0,0,7
36918,sārathino,sarathino,13,13,0,0,9
36919,rathakuṭumbī,rathakutumbi,1,1,0,0,12
36920,rathanāyake,rathanayake,1,1,0,0,11
36921,rathāroho,ratharoho,3,3,0,0,9
36922,rathiko,rathiko,17,15,2,0,7
36923,rathī,rathi,4,2,2,0,5
36924,khudi,khudi,2,0,2,0,5
36925,saṃpesane,sampesane,1,1,0,0,9
36926,rathe,rathe,171,165,6,0,5
36927,pājitatarā,pajitatara,1,1,0,0,10
36928,yodhā,yodha,36,36,0,0,5
36929,rathanāyakā,rathanayaka,1,1,0,0,11
36930,rathamārohatīti,rathamarohatiti,1,1,0,0,15
36931,yujjatīti,yujjatiti,185,157,28,0,9
36932,rathino,rathino,1,1,0,0,7
36933,sandanārohopyatra,sandanarohopyatra,1,1,0,0,17
36934,yodhe,yodhe,23,23,0,0,5
36935,yudha,yudha,13,5,8,0,5
36936,bhaṭati,bhatati,4,4,0,0,7
36937,bhaṭo,bhato,29,25,4,0,5
36938,yoddhopi,yoddhopi,1,1,0,0,8
36939,para377-379,para377-379,1,1,0,0,11
36940,padātike,padatike,1,1,0,0,8
36941,atati,atati,10,10,0,0,5
36942,ajatīti,ajatiti,1,1,0,0,7
36943,padāti,padati,9,2,7,0,6
36944,padatīti,padatiti,1,1,0,0,8
36945,padago,padago,2,1,1,0,6
36946,pādātiko,padatiko,1,1,0,0,8
36947,padājayopyatra,padajayopyatra,1,1,0,0,14
36948,padājiṃ,padajim,1,1,0,0,7
36949,M0.0265,M0.0265,55,55,0,0,7
36950,kavace,kavace,5,4,1,0,6
36951,kaṅka,kanka,2,0,2,0,5
36952,varīyate,variyate,1,1,0,0,8
36953,vammaṃ,vammam,10,8,2,0,6
36954,chādayantyanenāti,chadayantyanenati,1,1,0,0,17
36955,uracchado,uracchado,11,10,1,0,9
36956,tanuttaṃ,tanuttam,23,22,1,0,8
36957,daṃsanaṃ,damsanam,2,2,0,0,8
36958,jagaropyatra,jagaropyatra,1,1,0,0,12
36959,jagaro,jagaro,2,2,0,0,6
36960,kaṅkaṭo,kankato,3,3,0,0,7
36961,sannāho,sannaho,6,6,0,0,7
36962,katasannāhe,katasannahe,1,1,0,0,11
36963,naddhavāti,naddhavati,1,1,0,0,10
36964,sajju,sajju,21,18,3,0,5
36965,vammena,vammena,2,2,0,0,7
36966,naddhavā,naddhava,1,1,0,0,8
36967,vammiko,vammiko,72,65,7,0,7
36968,daṃsito,damsito,1,1,0,0,7
36969,uracchadiko,uracchadiko,1,1,0,0,11
36970,byūḷhakaṅkaṭo,byulhakankato,1,1,0,0,13
36971,jagarikopyatra,jagarikopyatra,1,1,0,0,14
36972,paridahite,paridahite,1,1,0,0,10
36973,paridahane,paridahane,1,1,0,0,10
36974,ubhayattha,ubhayattha,301,277,24,0,10
36975,bhūjādi,bhujadi,1,1,0,0,7
36976,susapacasakato,susapacasakato,1,1,0,0,14
36977,kkhakkā,kkhakka,4,1,3,0,7
36978,kko,kko,2,0,2,0,3
36979,pinaddho,pinaddho,1,1,0,0,8
36980,apinaddhopyatra,apinaddhopyatra,1,1,0,0,15
36981,abhicārapadātimhi,abhicarapadatimhi,1,1,0,0,17
36982,caraṇasīlo,caranasilo,7,7,0,0,10
36983,pubbaṅgamo,pubbangamo,93,89,4,0,10
36984,purogo,purogo,1,1,0,0,6
36985,aggesaro,aggesaro,1,1,0,0,8
36986,paṭṭho,pattho,11,9,2,0,6
36987,aggatosaro,aggatosaro,1,1,0,0,10
36988,purassaro,purassaro,1,1,0,0,9
36989,purogamopyatra,purogamopyatra,1,1,0,0,14
36990,asīghagāmini,asighagamini,1,1,0,0,12
36991,mandagāmī,mandagami,2,1,1,0,9
36992,viloḷane,vilolane,13,10,3,0,8
36993,saṃkilese,samkilese,27,26,1,0,9
36994,saṃkilissateti,samkilissateti,1,1,0,0,14
36995,mantharo,mantharo,2,1,1,0,8
36996,vegini,vegini,1,1,0,0,6
36997,turameti,turameti,1,1,0,0,8
36998,turito,turito,29,27,2,0,6
36999,turassi,turassi,1,1,0,0,7
37000,pajavī,pajavi,1,1,0,0,6
37001,javopyatra,javopyatra,1,1,0,0,10
37002,jetuyoggatāmatte,jetuyoggatamatte,1,1,0,0,16
37003,jetabbaṃ,jetabbam,4,3,1,0,8
37004,ṇyapaccaye,nyapaccaye,3,3,0,0,10
37005,para380,para380,79,79,0,0,7
37006,M0.0266,M0.0266,54,54,0,0,7
37007,sūre,sure,31,30,1,0,4
37008,sura,sura,7,5,2,0,4
37009,vikkanteti,vikkanteti,1,1,0,0,10
37010,curādidhātu,curadidhatu,1,1,0,0,11
37011,surayati,surayati,1,1,0,0,8
37012,vīrayatīti,virayatiti,1,1,0,0,10
37013,kanta,kanta,13,6,7,0,5
37014,sahāyamatte,sahayamatte,4,4,0,0,11
37015,pacchāttho,pacchattho,1,1,0,0,10
37016,anuplapo,anuplapo,1,1,0,0,8
37017,abhisaropi,abhisaropi,1,1,0,0,10
37018,sannaddhappabhutī,sannaddhappabhuti,2,1,1,0,17
37019,sannaddha,sannaddha,3,2,1,0,9
37020,saddādayo,saddadayo,35,34,1,0,9
37021,anucara,anucara,1,0,1,0,7
37022,rājādīnaṃ,rajadinam,15,15,0,0,9
37023,yātrāsveva,yatrasveva,1,1,0,0,10
37024,samba,samba,6,2,4,0,5
37025,addhānaparissamametenāti,addhanaparissamametenati,1,1,0,0,24
37026,sambalaṃ,sambalam,26,21,5,0,8
37027,bā,ba,19,10,9,0,2
37028,para381,para381,76,76,0,0,7
37029,senāyaṃ,senayam,4,4,0,0,7
37030,vāhayogā,vahayoga,1,1,0,0,8
37031,vāhinī,vahini,7,5,2,0,6
37032,dhajayogā,dhajayoga,1,1,0,0,9
37033,dhajinī,dhajini,6,5,1,0,7
37034,camu,camu,11,2,9,0,4
37035,camati,camati,5,5,0,0,6
37036,bhīrunti,bhirunti,1,1,0,0,8
37037,camū,camu,20,19,1,0,4
37038,putanā,putana,6,6,0,0,6
37039,anīkinī,anikini,4,4,0,0,7
37040,varūthinīpyatra,varuthinipyatra,1,1,0,0,15
37041,senābhedepi,senabhedepi,1,1,0,0,11
37042,nīkinī,nikini,1,1,0,0,6
37043,senāntarepi,senantarepi,1,1,0,0,11
37044,senāpabhede,senapabhede,1,1,0,0,11
37045,savantyamapi,savantyamapi,1,1,0,0,12
37046,cakkā,cakka,4,3,1,0,5
37047,ditikaṃ,ditikam,1,1,0,0,7
37048,senaṅge,senange,1,1,0,0,7
37049,cāṇakye,canakye,1,0,1,0,7
37050,senāvisese,senavisese,1,1,0,0,10
37051,anīko,aniko,2,2,0,0,5
37052,tikānyanīkaṃ,tikanyanikam,1,1,0,0,12
37053,asseva,asseva,6,6,0,0,6
37054,M0.0267,M0.0267,53,53,0,0,7
37055,vivaraṇaṃ,vivaranam,97,94,3,0,9
37056,pattiyodhā,pattiyodha,1,1,0,0,10
37057,bhaveyyuṃ,bhaveyyum,258,245,13,0,9
37058,pañcassā,pancassa,1,1,0,0,8
37059,vidheyyā,vidheyya,1,1,0,0,8
37060,kuñjarassa,kunjarassa,3,3,0,0,10
37061,pādaṅgo,padango,1,1,0,0,7
37062,pājitāvanto,pajitavanto,1,1,0,0,11
37063,vidhānamiti,vidhanamiti,1,1,0,0,11
37064,nāgassa,nagassa,151,135,16,0,7
37065,sandanassa,sandanassa,1,1,0,0,10
37066,anīkamiti,anikamiti,1,1,0,0,9
37067,viññeyyamiti,vinneyyamiti,1,1,0,0,12
37068,dvipā,dvipa,1,1,0,0,5
37069,caturaṅgabalāya,caturangabalaya,2,2,0,0,15
37070,susannaddhāya,susannaddhaya,1,1,0,0,13
37071,desavidese,desavidese,1,1,0,0,10
37072,vinyāso,vinyaso,4,1,3,0,7
37073,nyasanaṃ,nyasanam,1,1,0,0,8
37074,ūhanaṃ,uhanam,12,11,1,0,6
37075,daṇḍabhogamaṇḍalāsaṃhatā,dandabhogamandalasamhata,1,1,0,0,24
37076,pakatibyūhā,pakatibyuha,1,1,0,0,11
37077,anīkānaṃ,anikanam,2,2,0,0,8
37078,tiriyato,tiriyato,52,52,0,0,8
37079,samatthānamanīkānamanvāvutti,samatthanamanikanamanvavutti,1,1,0,0,28
37080,aññoññato,annonnato,1,1,0,0,9
37081,maṇḍalaracanāya,mandalaracanaya,1,1,0,0,15
37082,sarantānamanīkānaṃ,sarantanamanikanam,1,1,0,0,18
37083,sappasarīramiva,sappasariramiva,1,1,0,0,15
37084,maṇḍalo,mandalo,3,2,1,0,7
37085,ṭhitānamitaretarāsaṃ,thitanamitaretarasam,1,1,0,0,20
37086,hatānaṃ,hatanam,2,2,0,0,7
37087,visiliṭṭhatarānaṃ,visilitthataranam,1,1,0,0,17
37088,puthuvutti,puthuvutti,2,2,0,0,10
37089,asaṃhato,asamhato,3,2,1,0,8
37090,taduttaṃ,taduttam,2,2,0,0,8
37091,kāmandakena,kamandakena,1,0,1,0,11
37092,daṇḍākhyā,dandakhya,1,1,0,0,9
37093,bhogonvāvuttireva,bhogonvavuttireva,1,1,0,0,17
37094,sabbatovutti,sabbatovutti,1,1,0,0,12
37095,byūhasamaveto,byuhasamaveto,1,1,0,0,13
37096,byūhassekadeso,byuhassekadeso,1,1,0,0,14
37097,byūhapaṇhi,byuhapanhi,1,0,1,0,10
37098,byūhassa,byuhassa,1,1,0,0,8
37099,byūhantarameva,byuhantarameva,1,1,0,0,14
37100,sasenaṃ,sasenam,16,14,2,0,7
37101,paṭiggaṇhati,patigganhati,7,7,0,0,12
37102,dhanusatadvayantarena,dhanusatadvayantarena,1,1,0,0,21
37103,ṭhitaparisasahitaṃ,thitaparisasahitam,1,1,0,0,18
37104,anīkaṃ,anikam,11,6,5,0,6
37105,paṭiggaho,patiggaho,132,118,14,0,9
37106,para382-383,para382-383,1,1,0,0,11
37107,M0.0268,M0.0268,54,54,0,0,7
37108,dvādasapurisasahito,dvadasapurisasahito,1,1,0,0,19
37109,adhamantato,adhamantato,2,1,1,0,11
37110,hatthānīkaṃ,hatthanikam,19,15,4,0,11
37111,tipurisasahito,tipurisasahito,1,1,0,0,14
37112,catupurisasahito,catupurisasahito,1,1,0,0,16
37113,hayā,haya,26,24,2,0,4
37114,rathā,ratha,100,93,7,0,5
37115,hayānīkaṃ,hayanikam,3,1,2,0,9
37116,rathānīkaṃ,rathanikam,13,10,3,0,10
37117,gajādayo,gajadayo,3,3,0,0,8
37118,sasatthā,sasattha,11,10,1,0,8
37119,khaggādisatthahatthā,khaggadisatthahattha,1,1,0,0,20
37120,catujjanā,catujjana,3,2,1,0,9
37121,pattānīkaṃ,pattanikam,8,5,3,0,10
37122,heṭṭhimantatoyevetthāpi,hetthimantatoyevetthapi,1,1,0,0,23
37123,tvaññathā,tvannatha,1,1,0,0,9
37124,ekakebharathā,ekakebharatha,1,1,0,0,13
37125,tyassā,tyassa,1,1,0,0,6
37126,pañcapadātikā,pancapadatika,1,1,0,0,13
37127,patyaṅgehi,patyangehi,2,2,0,0,10
37128,tiguṇehi,tigunehi,1,1,0,0,8
37129,yathottaraṃ,yathottaram,3,2,1,0,11
37130,senāmukhaṃ,senamukham,3,3,0,0,10
37131,gumbagaṇā,gumbagana,1,1,0,0,9
37132,tāsantu,tasantu,2,2,0,0,7
37133,akkhobhinī,akkhobhini,6,5,1,0,10
37134,assehi,assehi,18,18,0,0,6
37135,gajenekena,gajenekena,1,1,0,0,10
37136,padātībhi,padatibhi,1,1,0,0,9
37137,senantaraṃ,senantaram,1,1,0,0,10
37138,gajādīhi,gajadihi,1,1,0,0,8
37139,M0.0269,M0.0269,54,54,0,0,7
37140,yathāpubbaṃ,yathapubbam,4,4,0,0,11
37141,senāmukhādikā,senamukhadika,1,1,0,0,13
37142,yathāpubbamityatthamāha,yathapubbamityatthamaha,1,1,0,0,23
37143,tenedaṃ,tenedam,12,12,0,0,7
37144,pattino,pattino,1,1,0,0,7
37145,senāmukhehi,senamukhehi,1,1,0,0,11
37146,gumbattayena,gumbattayena,1,1,0,0,12
37147,gaṇattayaṃ,ganattayam,1,1,0,0,10
37148,vāhinittayaṃ,vahinittayam,1,1,0,0,12
37149,putanattayaṃ,putanattayam,1,1,0,0,12
37150,camuttayaṃ,camuttayam,1,1,0,0,10
37151,anīkinīnaṃ,anikininam,1,1,0,0,10
37152,sattatisahitehi,sattatisahitehi,1,1,0,0,15
37153,aṭṭhasatehādhikānyekavīsatisahassāni,atthasatehadhikanyekavisatisahassani,1,1,0,0,36
37154,gajānampi,gajanampi,1,1,0,0,9
37155,pañcasaṭṭhisahassāni,pancasatthisahassani,1,1,0,0,20
37156,chasatāni,chasatani,11,11,0,0,9
37157,daseva,daseva,50,46,4,0,6
37158,turaṅgānañhi,turangananhi,1,1,0,0,12
37159,turaṅgame,turangame,1,1,0,0,9
37160,satasahassaṃ,satasahassam,286,276,10,0,12
37161,sahassāni,sahassani,314,301,13,0,9
37162,naveva,naveva,21,19,2,0,6
37163,satāni,satani,302,301,1,0,6
37164,ññāni,nnani,3,2,1,0,5
37165,paññāsañca,pannasanca,14,13,1,0,10
37166,padātayoti,padatayoti,1,1,0,0,10
37167,para384,para384,82,82,0,0,7
37168,saṭṭhi,satthi,372,360,12,0,6
37169,yantiyā,yantiya,2,1,1,0,7
37170,kubbantiyā,kubbantiya,1,1,0,0,10
37171,kattubhūtāya,kattubhutaya,3,3,0,0,12
37172,dhūlīkatesu,dhulikatesu,2,2,0,0,11
37173,kesu,kesu,25,23,2,0,4
37174,saṭṭhivaṃsakalāpesu,satthivamsakalapesu,2,2,0,0,19
37175,kittakappamāṇesu,kittakappamanesu,1,1,0,0,16
37176,saṭṭhidaṇḍavantesu,satthidandavantesu,1,1,0,0,18
37177,khobhetumasakkuṇeyyatāya,khobhetumasakkuneyyataya,1,1,0,0,24
37178,khubha,khubha,4,1,3,0,6
37179,para385,para385,82,82,0,0,7
37180,M0.0270,M0.0270,54,54,0,0,7
37181,dhanukkaṃso,dhanukkamso,1,1,0,0,11
37182,yupakkhe,yupakkhe,1,1,0,0,8
37183,devatāvasena,devatavasena,2,2,0,0,12
37184,dhanukkaṃsavasena,dhanukkamsavasena,1,1,0,0,17
37185,sampattiviparītāyaṃ,sampattiviparitayam,1,1,0,0,19
37186,pajjatīti,pajjatiti,6,5,1,0,9
37187,vipatti,vipatti,133,125,8,0,7
37188,padi,padi,2,0,2,0,4
37189,kattariti,kattariti,1,1,0,0,9
37190,pajjanaṃ,pajjanam,19,19,0,0,8
37191,āpadā,apada,29,19,10,0,5
37192,satthamatte,satthamatte,1,1,0,0,11
37193,yujjhante,yujjhante,5,5,0,0,9
37194,jīvitanti,jivitanti,33,32,1,0,9
37195,heti,heti,10,9,1,0,4
37196,tivasena,tivasena,1,1,0,0,8
37197,atthaṃpyatra,atthampyatra,1,1,0,0,12
37198,para386-387,para386-387,3,3,0,0,11
37199,saṅkhepenāyudhaṃ,sankhepenayudham,1,1,0,0,16
37200,muttāmuttañca,muttamuttanca,1,1,0,0,13
37201,amuttañca,amuttanca,1,1,0,0,9
37202,pāṇito,panito,9,9,0,0,6
37203,muttañca,muttanca,12,12,0,0,8
37204,yantamuttañceti,yantamuttanceti,1,1,0,0,15
37205,bahūnampi,bahunampi,34,34,0,0,9
37206,tabbhedānativattanato,tabbhedanativattanato,1,1,0,0,21
37207,sarūpamāha,sarupamaha,3,3,0,0,10
37208,muttāmuttañcā,muttamuttanca,1,0,1,0,13
37209,satthaviseso,satthaviseso,2,2,0,0,12
37210,kattaradaṇḍo,kattaradando,20,17,3,0,12
37211,hāralatāsatthabhedesu,haralatasatthabhedesu,1,1,0,0,21
37212,dhanudaṇḍake,dhanudandake,1,1,0,0,12
37213,tadādi,tadadi,5,5,0,0,6
37214,M0.0271,M0.0271,52,52,0,0,7
37215,amuttañceti,amuttanceti,1,1,0,0,11
37216,muttāmuttaṃ,muttamuttam,1,0,1,0,11
37217,katākataṃ,katakatam,50,45,5,0,9
37218,asiputti,asiputti,1,1,0,0,8
37219,tadādikaṃ,tadadikam,1,1,0,0,9
37220,amuttaṃ,amuttam,3,2,1,0,7
37221,yanta,yanta,9,4,5,0,5
37222,yantaṃ,yantam,126,111,15,0,6
37223,dhanvādi,dhanvadi,1,1,0,0,8
37224,para388-389,para388-389,1,1,0,0,11
37225,dhanumhi,dhanumhi,4,3,1,0,8
37226,usuṃ,usum,34,34,0,0,4
37227,khipatīti,khipatiti,21,17,4,0,9
37228,ussi,ussi,4,4,0,0,4
37229,dhaññe,dhanne,15,12,3,0,6
37230,vaṃsavisuddhopi,vamsavisuddhopi,2,2,0,0,15
37231,nigguṇo,nigguno,10,10,0,0,7
37232,hitopadesa,hitopadesa,1,1,0,0,10
37233,kathāmukha,kathamukha,1,1,0,0,10
37234,vāpo,vapo,3,2,1,0,4
37235,tuṇatā,tunata,1,1,0,0,6
37236,tiṇatāpice,tinatapice,1,1,0,0,10
37237,daṇḍayatīti,dandayatiti,4,4,0,0,11
37238,kodaṇḍaṃ,kodandam,5,1,4,0,8
37239,damyatīti,damyatiti,1,1,0,0,9
37240,dunotīti,dunotiti,3,3,0,0,8
37241,kuṭilattā,kutilatta,2,2,0,0,9
37242,capa,capa,6,2,4,0,4
37243,capo,capo,1,1,0,0,4
37244,vaṃsabhedo,vamsabhedo,1,1,0,0,10
37245,tabbikāro,tabbikaro,1,1,0,0,9
37246,cāpo,capo,24,22,2,0,4
37247,saramasati,saramasati,1,1,0,0,10
37248,sarāsanaṃ,sarasanam,5,4,1,0,9
37249,kammukampi,kammukampi,1,1,0,0,10
37250,kammāya,kammaya,24,23,1,0,7
37251,kammukaṃ,kammukam,1,0,1,0,8
37252,gavati,gavati,9,9,0,0,6
37253,jiyā,jiya,17,16,1,0,4
37254,jayā,jaya,6,5,1,0,4
37255,cāthā,catha,1,1,0,0,5
37256,M0.0272,M0.0272,53,53,0,0,7
37257,mubbī,mubbi,3,2,1,0,5
37258,siñjinīpyatra,sinjinipyatra,1,1,0,0,13
37259,mubbavikāro,mubbavikaro,1,1,0,0,11
37260,siñja,sinja,1,0,1,0,5
37261,tipādo,tipado,1,1,0,0,6
37262,kaṇḍe,kande,25,22,3,0,5
37263,sarantyanenāti,sarantyanenati,1,1,0,0,14
37264,vājo,vajo,6,3,3,0,4
37265,pattī,patti,60,55,5,0,5
37266,tanukaraṇāvasānesu,tanukaranavasanesu,1,1,0,0,18
37267,ssālopo,ssalopo,1,1,0,0,7
37268,vaṇyate,vanyate,1,1,0,0,7
37269,saddāyateneneti,saddayateneneti,1,1,0,0,15
37270,kaṇyateneneti,kanyateneneti,1,1,0,0,13
37271,kaṇḍaṃ,kandam,61,58,3,0,6
37272,apo,apo,8,8,0,0,3
37273,khurappo,khurappo,6,3,3,0,8
37274,khipane,khipane,4,4,0,0,7
37275,visikho,visikho,2,1,1,0,7
37276,ajimhago,ajimhago,1,1,0,0,8
37277,khago,khago,9,6,3,0,5
37278,kalambo,kalambo,1,1,0,0,7
37279,maggaṇo,maggano,1,1,0,0,7
37280,ropopyatra,ropopyatra,1,1,0,0,10
37281,visanto,visanto,1,1,0,0,7
37282,rupa,rupa,4,3,1,0,4
37283,vimohane,vimohane,2,1,1,0,8
37284,ropo,ropo,2,1,1,0,4
37285,thūlakheḍo,thulakhedo,1,1,0,0,10
37286,vipāṭo,vipato,1,1,0,0,6
37287,citrapuṅkho,citrapunkho,1,1,0,0,11
37288,tūṇa,tuna,2,0,2,0,4
37289,tūṇo,tuno,4,4,0,0,4
37290,nisaṅgo,nisango,1,1,0,0,7
37291,tūṇiro,tuniro,3,1,2,0,6
37292,upāsaṅgo,upasango,1,1,0,0,8
37293,vāṇadhi,vanadhi,4,3,1,0,7
37294,tūṇā,tuna,1,1,0,0,4
37295,itthiliṅgappakaraṇe,itthilingappakarane,1,1,0,0,19
37296,tuṇī,tuni,1,1,0,0,4
37297,sarasamūhānaṃ,sarasamuhanam,1,1,0,0,13
37298,ṭhānattā,thanatta,4,4,0,0,8
37299,vāṇā,vana,1,1,0,0,4
37300,dhiyantetreti,dhiyantetreti,1,1,0,0,13
37301,pasaṅga,pasanga,1,1,0,0,7
37302,tūṇiranisaṅgā,tuniranisanga,1,1,0,0,13
37303,marasīhe,marasihe,1,0,1,0,8
37304,para390,para390,79,79,0,0,7
37305,vāje,vaje,1,1,0,0,4
37306,kaṇḍapatta,kandapatta,1,1,0,0,10
37307,M0.0273,M0.0273,51,51,0,0,7
37308,vajatyanenāti,vajatyanenati,1,1,0,0,13
37309,visamapivitthāti,visamapivitthati,1,1,0,0,16
37310,visappīto,visappito,1,0,1,0,9
37311,diddho,diddho,16,10,6,0,6
37312,littopyatra,littopyatra,1,1,0,0,11
37313,vijjhitabbe,vijjhitabbe,2,2,0,0,11
37314,vijjhanatthaṃ,vijjhanattham,4,4,0,0,13
37315,vijjhitabbanti,vijjhitabbanti,3,3,0,0,14
37316,vejjhaṃ,vejjham,2,1,1,0,7
37317,jjho,jjho,7,0,7,0,4
37318,sarabyaṃ,sarabyam,1,0,1,0,8
37319,vassākāralopo,vassakaralopo,1,1,0,0,13
37320,sarānamabhyāsanaṃ,saranamabhyasanam,1,1,0,0,17
37321,vasīkaraṇaṃ,vasikaranam,4,4,0,0,11
37322,sarābhyāso,sarabhyaso,2,1,1,0,10
37323,byādhepyupāsanāyañca,byadhepyupasanayanca,1,1,0,0,20
37324,vāṇābhyāsepyupāsanaṃ,vanabhyasepyupasanam,1,1,0,0,20
37325,lakkhamupagantvā,lakkhamupagantva,1,1,0,0,16
37326,upāsanaṃ,upasanam,15,9,6,0,8
37327,para391,para391,76,76,0,0,7
37328,niggato,niggato,39,38,1,0,7
37329,tiṃsato,timsato,3,3,0,0,7
37330,ṅgulito,ngulito,1,1,0,0,7
37331,asate,asate,2,2,0,0,5
37332,khippateti,khippateti,1,1,0,0,10
37333,khagga,khagga,3,1,2,0,6
37334,khaṇḍabhede,khandabhede,1,1,0,0,11
37335,sarepi,sarepi,2,2,0,0,6
37336,candahāso,candahaso,1,1,0,0,9
37337,riṭṭhi,ritthi,2,1,1,0,6
37338,kakkhalako,kakkhalako,1,1,0,0,10
37339,karavālopyatra,karavalopyatra,1,1,0,0,14
37340,khaggassa,khaggassa,11,11,0,0,9
37341,kosi,kosi,66,61,5,0,4
37342,khaggachurikādīnaṃ,khaggachurikadinam,1,1,0,0,18
37343,muṭṭhiyaṃ,mutthiyam,22,20,2,0,9
37344,tharu,tharu,3,1,2,0,5
37345,satthagatiyaṃ,satthagatiyam,1,1,0,0,13
37346,para392,para392,74,74,0,0,7
37347,satthānaṃ,satthanam,18,18,0,0,9
37348,vāraṇaphalake,varanaphalake,1,1,0,0,13
37349,kheṭa,kheta,2,0,2,0,5
37350,visāraṇe,visarane,1,1,0,0,8
37351,phalatīti,phalatiti,16,12,4,0,9
37352,phalampi,phalampi,41,38,3,0,8
37353,vaṇṭānihārassākhaggākati,vantaniharassakhaggakati,1,1,0,0,24
37354,M0.0274,M0.0274,52,52,0,0,7
37355,hatthakuṇḍādi,hatthakundadi,1,1,0,0,13
37356,illī,illi,2,1,1,0,4
37357,ilī,ili,1,0,1,0,3
37358,karapālikā,karapalika,2,1,1,0,10
37359,asiputtiyaṃ,asiputtiyam,1,1,0,0,11
37360,chura,chura,1,0,1,0,5
37361,sasu,sasu,11,2,9,0,4
37362,asino,asino,6,6,0,0,5
37363,puttī,putti,5,5,0,0,5
37364,asidhenukāpi,asidhenukapi,1,1,0,0,12
37365,vaḍḍhakīnaṃ,vaddhakinam,34,34,0,0,11
37366,muggarehi,muggarehi,11,11,0,0,9
37367,samānākārāyudhabhede,samanakarayudhabhede,1,1,0,0,20
37368,muraṃ,muram,1,1,0,0,5
37369,giratīti,giratiti,2,2,0,0,8
37370,muggaro,muggaro,13,7,6,0,7
37371,gira,gira,6,0,6,0,4
37372,niggiraṇe,niggirane,5,5,0,0,9
37373,muccatīti,muccatiti,221,191,30,0,9
37374,dughaṇo,dughano,1,1,0,0,7
37375,ghanopi,ghanopi,1,1,0,0,7
37376,para393,para393,89,89,0,0,7
37377,salle,salle,13,12,1,0,5
37378,āsugatiyaṃ,asugatiyam,3,2,1,0,10
37379,mpi,mpi,146,142,4,0,3
37380,vāsiyaṃ,vasiyam,1,1,0,0,7
37381,chedanasnehāvahāraṇesu,chedanasnehavaharanesu,1,1,0,0,22
37382,pharasumhi,pharasumhi,5,5,0,0,10
37383,chedakattā,chedakatta,1,1,0,0,10
37384,kucchitā,kucchita,31,30,1,0,8
37385,kudhārī,kudhari,6,5,1,0,7
37386,kudhāropi,kudharopi,1,1,0,0,9
37387,pharasu,pharasu,23,21,2,0,7
37388,parasupi,parasupi,1,1,0,0,8
37389,parasu,parasu,9,7,2,0,6
37390,napuṃsako,napumsako,14,13,1,0,9
37391,parasudhopyatra,parasudhopyatra,1,1,0,0,15
37392,pāsāṇavidāraṇe,pasanavidarane,1,1,0,0,14
37393,ṭaṅka,tanka,2,1,1,0,5
37394,pāsāṇaṃ,pasanam,89,88,1,0,7
37395,pāsāṇadāraṇo,pasanadarano,2,1,1,0,12
37396,pāsāṇadārakopi,pasanadarakopi,1,1,0,0,14
37397,para394,para394,84,84,0,0,7
37398,M0.0275,M0.0275,53,53,0,0,7
37399,hatthappamāṇe,hatthappamane,3,3,0,0,13
37400,kaṇaye,kanaye,1,1,0,0,6
37401,cakkapūraṇādivāyuvasena,cakkapuranadivayuvasena,1,1,0,0,23
37402,khippate,khippate,1,1,0,0,8
37403,bhindanasīlatāya,bhindanasilataya,1,1,0,0,16
37404,bhindī,bhindi,7,7,0,0,6
37405,bhindivālo,bhindivalo,3,3,0,0,10
37406,bhindivāḷo,bhindivalo,2,1,1,0,10
37407,cakkādayo,cakkadayo,1,1,0,0,9
37408,satthabhedā,satthabheda,2,1,1,0,11
37409,āyudhaviseso,ayudhaviseso,1,1,0,0,12
37410,kunto,kunto,5,4,1,0,5
37411,dīghadaṇḍo,dighadando,4,4,0,0,10
37412,koṇabhāge,konabhage,1,1,0,0,9
37413,saddopakaraṇesu,saddopakaranesu,3,3,0,0,15
37414,koṭille,kotille,14,4,10,0,7
37415,para395,para395,85,85,0,0,7
37416,dvipādaṃ,dvipadam,6,6,0,0,8
37417,yātrāyaṃ,yatrayam,2,2,0,0,8
37418,nadādino,nadadino,2,2,0,0,8
37419,ākatigaṇattā,akatiganatta,4,4,0,0,12
37420,īpaccayābhāvo,ipaccayabhavo,2,2,0,0,13
37421,yāne,yane,64,57,7,0,4
37422,patiṭṭhīyate,patitthiyate,2,2,0,0,12
37423,purecārimhi,purecarimhi,1,1,0,0,11
37424,dhūlīmatte,dhulimatte,1,1,0,0,10
37425,paṃsu,pamsu,57,53,4,0,5
37426,khodo,khodo,1,1,0,0,5
37427,cuṇṇo,cunno,4,3,1,0,5
37428,dhūli,dhuli,5,5,0,0,5
37429,maramālā,maramala,3,0,3,0,8
37430,cuṇṇa,cunna,8,4,4,0,5
37431,pisane,pisane,1,1,0,0,6
37432,sañcuṇṇane,sancunnane,3,2,1,0,10
37433,paṃsa,pamsa,4,3,1,0,5
37434,nāsane,nasane,9,5,4,0,6
37435,manogaṇopi,manoganopi,1,1,0,0,10
37436,klivaṃ,klivam,3,3,0,0,6
37437,parādhe,paradhe,1,1,0,0,7
37438,reṇumhī,renumhi,3,2,1,0,7
37439,M0.0276,M0.0276,52,52,0,0,7
37440,cuṇṇarajo,cunnarajo,1,0,1,0,9
37441,vidhunane,vidhunane,3,2,1,0,9
37442,li,li,9,9,0,0,2
37443,para396,para396,74,74,0,0,7
37444,vaṃsakkamavedīvaṃsathutiṃ,vamsakkamavedivamsathutim,1,1,0,0,25
37445,kubbati,kubbati,63,51,12,0,7
37446,madhuko,madhuko,4,3,1,0,7
37447,khattiyāvessasambhavo,khattiyavessasambhavo,1,1,0,0,21
37448,vaṃsamaggaṃ,vamsamaggam,1,1,0,0,11
37449,thavatīti,thavatiti,1,1,0,0,9
37450,dhavatīti,dhavatiti,1,1,0,0,9
37451,ggalopo,ggalopo,1,1,0,0,7
37452,vīriyādithutiṃ,viriyadithutim,1,1,0,0,14
37453,vandī,vandi,7,4,3,0,5
37454,tassīlādīsu,tassiladisu,6,4,2,0,11
37455,nisāvasānaṃ,nisavasanam,1,1,0,0,11
37456,vibhāvento,vibhavento,206,204,2,0,10
37457,bodhayati,bodhayati,9,9,0,0,9
37458,vetāḷiko,vetaliko,3,1,2,0,8
37459,tāḷasaddena,talasaddena,3,3,0,0,11
37460,caranto,caranto,419,415,4,0,7
37461,cakkiko,cakkiko,2,1,1,0,7
37462,caratyatthe,caratyatthe,1,1,0,0,11
37463,ghaṇṭa,ghanta,1,0,1,0,6
37464,para397,para397,75,75,0,0,7
37465,dhaje,dhaje,32,32,0,0,5
37466,kitati,kitati,1,1,0,0,6
37467,dhaja,dhaja,7,4,3,0,5
37468,uppatatīti,uppatatiti,3,2,1,0,10
37469,āko,ako,4,4,0,0,3
37470,dalīyate,daliyate,1,1,0,0,8
37471,vidārīyateti,vidariyateti,1,1,0,0,12
37472,chinnabhinnattā,chinnabhinnatta,1,1,0,0,15
37473,M0.0277,M0.0277,52,52,0,0,7
37474,dalaṃ,dalam,8,5,3,0,5
37475,pattametissātthīti,pattametissatthiti,1,1,0,0,18
37476,mocepi,mocepi,1,1,0,0,6
37477,ketanaṃ,ketanam,7,5,2,0,7
37478,manitthī,manitthi,2,2,0,0,8
37479,aññamaññasseti,annamannasseti,1,0,1,0,14
37480,ekamapekkhitvā,ekamapekkhitva,1,1,0,0,14
37481,aparassāparaṃ,aparassaparam,1,1,0,0,13
37482,ahamahamikā,ahamahamika,1,0,1,0,11
37483,bhavāmi,bhavami,77,76,1,0,7
37484,bhavāmī,bhavami,12,12,0,0,7
37485,aññamaññamatikkamma,annamannamatikkamma,1,1,0,0,19
37486,yodhānaṃ,yodhanam,19,19,0,0,8
37487,samagge,samagge,82,76,6,0,7
37488,dhāvanaṃ,dhavanam,2,1,1,0,8
37489,ahaṃpubbikā,ahampubbika,1,0,1,0,11
37490,vibhattipatirūpako,vibhattipatirupako,2,2,0,0,18
37491,vicchāyaṃ,vicchayam,26,24,2,0,9
37492,gamyamānattā,gamyamanatta,17,17,0,0,12
37493,dvittābhāvo,dvittabhavo,2,2,0,0,11
37494,para398,para398,80,80,0,0,7
37495,sahatenenāti,sahatenenati,1,1,0,0,12
37496,sahopi,sahopi,1,1,0,0,6
37497,draviṇaṃ,dravinam,1,1,0,0,8
37498,taro,taro,20,17,3,0,4
37499,pāṇopi,panopi,1,1,0,0,6
37500,atisūratā,atisurata,1,1,0,0,9
37501,jite,jite,8,8,0,0,4
37502,kāraṇabhūte,karanabhute,9,7,2,0,11
37503,pānaṃ,panam,178,161,17,0,5
37504,jayapānaṃ,jayapanam,17,15,2,0,9
37505,vīrapānaṃ,virapanam,1,1,0,0,9
37506,bhāvini,bhavini,13,12,1,0,7
37507,bhavissatiraṇe,bhavissatirane,1,1,0,0,14
37508,jīvitasaṃsayā,jivitasamsaya,1,1,0,0,13
37509,saṃhāsuppādanatthaṃ,samhasuppadanattham,1,1,0,0,19
37510,devatāyācanapubbakaṃ,devatayacanapubbakam,1,1,0,0,20
37511,sajātiyehi,sajatiyehi,2,2,0,0,10
37512,vijayassa,vijayassa,14,14,0,0,9
37513,sandassanatthaṃ,sandassanattham,10,8,2,0,15
37514,vīrapānamu,virapanamu,1,0,1,0,10
37515,para399-400,para399-400,1,1,0,0,11
37516,sāḍḍhapajjaṃ,saddhapajjam,1,1,0,0,12
37517,M0.0278,M0.0278,51,51,0,0,7
37518,saṅgāma,sangama,10,7,3,0,7
37519,pasayhakaraṇe,pasayhakarane,1,1,0,0,13
37520,dvepyanitthiyaṃ,dvepyanitthiyam,3,3,0,0,15
37521,āji,aji,3,0,3,0,3
37522,āhuyyante,ahuyyante,1,1,0,0,9
37523,asmiṃyodhā,asmimyodha,1,1,0,0,10
37524,yujjhantetra,yujjhantetra,1,1,0,0,12
37525,āyodhanaṃ,ayodhanam,1,0,1,0,9
37526,saṃyugaṃ,samyugam,5,3,2,0,8
37527,saṃyuttampi,samyuttampi,3,3,0,0,11
37528,viggayhanti,viggayhanti,1,1,0,0,11
37529,yujjhantyasmiṃ,yujjhantyasmim,1,1,0,0,14
37530,kalahantyasmiṃ,kalahantyasmim,1,1,0,0,14
37531,kalaho,kalaho,131,124,7,0,6
37532,medhāhiṃsāsaṅgamesu,medhahimsasangamesu,1,1,0,0,19
37533,jaññaṃ,jannam,8,5,3,0,6
37534,pavidāraṇaṃ,pavidaranam,1,1,0,0,11
37535,akkandanaṃ,akkandanam,1,1,0,0,10
37536,samīkaṃ,samikam,1,1,0,0,7
37537,samparāyakaṃ,samparayakam,1,1,0,0,12
37538,abhisampāto,abhisampato,1,1,0,0,11
37539,kalisaṃ,kalisam,1,1,0,0,7
37540,atyāmaddoiccādayopi,atyamaddoiccadayopi,1,1,0,0,19
37541,bhaṇḍanādipañcakaṃ,bhandanadipancakam,1,1,0,0,18
37542,kalahe,kalahe,21,20,1,0,6
37543,bhaṇḍanaṃ,bhandanam,144,127,17,0,9
37544,khalikārepi,khalikarepi,1,1,0,0,11
37545,balakkāre,balakkare,8,7,1,0,9
37546,pasahanaṃ,pasahanam,1,1,0,0,9
37547,pasayho,pasayho,2,1,1,0,7
37548,balakkāro,balakkaro,7,4,3,0,9
37549,haṭha,hatha,2,1,1,0,5
37550,pasaṅgopi,pasangopi,3,3,0,0,9
37551,para401,para401,73,73,0,0,7
37552,subhāsubhānaṃ,subhasubhanam,1,0,1,0,13
37553,phalānaṃ,phalanam,109,104,5,0,8
37554,pakāsakā,pakasaka,11,11,0,0,8
37555,bhūtassa,bhutassa,115,107,8,0,8
37556,uppāto,uppato,6,5,1,0,6
37557,M0.0279,M0.0279,52,52,0,0,7
37558,uppādopi,uppadopi,40,40,0,0,8
37559,pubbapadassa,pubbapadassa,13,13,0,0,12
37560,aparapadassa,aparapadassa,1,1,0,0,12
37561,liṅgamādatte,lingamadatte,2,2,0,0,12
37562,avijjāpaccayo,avijjapaccayo,17,14,3,0,13
37563,vākyañceti,vakyanceti,1,1,0,0,10
37564,viggahavākyaṃ,viggahavakyam,6,6,0,0,13
37565,uppātassa,uppatassa,2,2,0,0,9
37566,yuddhapakkamenābhidhānaṃ,yuddhapakkamenabhidhanam,1,1,0,0,24
37567,ajaññaṃ,ajannam,9,4,5,0,7
37568,pakāsanamattameva,pakasanamattameva,2,2,0,0,17
37569,sajjati,sajjati,80,72,8,0,7
37570,ītyā,itya,1,0,1,0,4
37571,janakepi,janakepi,1,1,0,0,8
37572,jarādīnamupaddavā,jaradinamupaddava,1,1,0,0,17
37573,para402,para402,84,84,0,0,7
37574,mallayuddhamhi,mallayuddhamhi,2,1,1,0,14
37575,bāhuyuddhamhi,bahuyuddhamhi,1,1,0,0,13
37576,nibbuddhaṃ,nibbuddham,16,11,5,0,10
37577,yujjhantyatra,yujjhantyatra,1,1,0,0,13
37578,vedhaṃ,vedham,9,8,1,0,6
37579,nibbedhentyatreti,nibbedhentyatreti,1,1,0,0,17
37580,essu,essu,1,1,0,0,4
37581,jayakriyāyaṃ,jayakriyayam,1,1,0,0,12
37582,yuddhabhaṅge,yuddhabhange,1,1,0,0,12
37583,palāyanamatte,palayanamatte,1,1,0,0,13
37584,saṅgāmatoyeva,sangamatoyeva,1,1,0,0,13
37585,palāyane,palayane,2,2,0,0,8
37586,parivajjetvā,parivajjetva,35,35,0,0,12
37587,palāyanaṃ,palayanam,7,6,1,0,9
37588,apavajjetvā,apavajjetva,1,1,0,0,11
37589,apakkamo,apakkamo,3,1,2,0,8
37590,padāvo,padavo,1,1,0,0,6
37591,dāvo,davo,1,1,0,0,4
37592,sandāvo,sandavo,1,1,0,0,7
37593,viddavo,viddavo,1,1,0,0,7
37594,apayānaṃpyatra,apayanampyatra,1,1,0,0,14
37595,para403,para403,76,76,0,0,7
37596,M0.0280,M0.0280,49,49,0,0,7
37597,māraṇe,marane,14,14,0,0,6
37598,mārīyate,mariyate,1,1,0,0,8
37599,māraṇaṃ,maranam,24,20,4,0,7
37600,ghāto,ghato,53,39,14,0,5
37601,ghātā,ghata,16,10,6,0,5
37602,nasa,nasa,8,2,6,0,4
37603,sūda,suda,12,3,9,0,4
37604,hiṃsa,himsa,2,0,2,0,5
37605,itthiyamāpaccayo,itthiyamapaccayo,1,1,0,0,16
37606,hiṃsā,himsa,46,42,4,0,5
37607,ghātanaṃ,ghatanam,11,11,0,0,8
37608,nibbarahanaṃ,nibbarahanam,1,1,0,0,12
37609,nikāraṇaṃ,nikaranam,1,1,0,0,9
37610,pavāsanaṃ,pavasanam,1,1,0,0,9
37611,saññāpanaṃ,sannapanam,8,7,1,0,10
37612,pamathanaṃ,pamathanam,1,1,0,0,10
37613,ujjāsanaṃ,ujjasanam,1,1,0,0,9
37614,piñjopyatra,pinjopyatra,1,1,0,0,11
37615,varaha,varaha,5,0,5,0,6
37616,bādhānyaparibhāsanahiṃsādānesu,badhanyaparibhasanahimsadanesu,1,1,0,0,30
37617,papubbo,papubbo,20,20,0,0,7
37618,māraṇatosananisāmanesu,maranatosananisamanesu,1,1,0,0,22
37619,katha,katha,28,17,11,0,5
37620,jasu,jasu,1,0,1,0,4
37621,jasi,jasi,2,0,2,0,4
37622,piñja,pinja,2,0,2,0,5
37623,hiṃsābaladānaniketanesu,himsabaladananiketanesu,4,2,2,0,23
37624,yathākkamamidhānāgatānaṃ,yathakkamamidhanagatanam,1,1,0,0,24
37625,para404,para404,86,86,0,0,7
37626,atītādi,atitadi,5,5,0,0,7
37627,kiriyā,kiriya,432,410,22,0,6
37628,bhūtānī,bhutani,12,7,5,0,7
37629,tito,tito,13,12,1,0,4
37630,vajā,vaja,7,5,2,0,4
37631,tyu,tyu,5,4,1,0,3
37632,kiriyattā,kiriyatta,5,5,0,0,9
37633,M0.0281,M0.0281,51,51,0,0,7
37634,attabhāvassa,attabhavassa,132,130,2,0,12
37635,para405,para405,73,73,0,0,7
37636,pareto,pareto,57,49,8,0,6
37637,maratīti,maratiti,30,21,9,0,8
37638,pattapañcattopyatra,pattapancattopyatra,1,1,0,0,19
37639,matadahanakaṭṭharāsimhi,matadahanakattharasimhi,1,1,0,0,23
37640,phullī,phulli,1,1,0,0,6
37641,cīyate,ciyate,7,6,1,0,6
37642,citako,citako,20,17,3,0,6
37643,pubbatra,pubbatra,7,5,2,0,8
37644,citā,cita,17,17,0,0,4
37645,cityā,citya,12,11,1,0,5
37646,citipyatra,citipyatra,1,1,0,0,10
37647,susāne,susane,145,140,5,0,6
37648,āḷahanaṃ,alahanam,7,5,2,0,8
37649,āḷāhana,alahana,3,2,1,0,7
37650,chavassa,chavassa,17,16,1,0,8
37651,sayanaṭṭhānaṃ,sayanatthanam,5,5,0,0,13
37652,susānaṃ,susanam,184,165,19,0,7
37653,chava,chava,3,0,3,0,5
37654,sayana,sayana,8,6,2,0,6
37655,sāno,sano,20,18,2,0,4
37656,senti,senti,67,59,8,0,5
37657,pituvanampi,pituvanampi,1,1,0,0,11
37658,matasarīre,matasarire,26,23,3,0,10
37659,kuṇapa,kunapa,1,0,1,0,6
37660,pūtigandhatthe,putigandhatthe,1,1,0,0,14
37661,kuṇapo,kunapo,6,5,1,0,6
37662,para406,para406,81,81,0,0,7
37663,asīsakattā,asisakatta,2,2,0,0,10
37664,sirosuñño,sirosunno,2,1,1,0,9
37665,naccanādikriyāsahitattā,naccanadikriyasahitatta,1,1,0,0,23
37666,sahakriyo,sahakriyo,2,1,1,0,9
37667,kabandho,kabandho,6,3,3,0,8
37668,yodhesu,yodhesu,8,8,0,0,7
37669,sūresu,suresu,2,2,0,0,6
37670,katta,katta,10,10,0,0,5
37671,khaṇḍa,khanda,2,1,1,0,6
37672,muddhasu,muddhasu,1,1,0,0,8
37673,tadāvesā,tadavesa,1,1,0,0,8
37674,muddhā,muddha,91,87,4,0,6
37675,kriyāndhito,kriyandhito,1,1,0,0,11
37676,kabandhalakkhaṇaṃ,kabandhalakkhanam,1,1,0,0,17
37677,sahassapūraṇo,sahassapurano,1,1,0,0,13
37678,naccatī,naccati,5,5,0,0,7
37679,naccanādikriyārahite,naccanadikriyarahite,1,1,0,0,20
37680,tūpacāro,tupacaro,1,1,0,0,8
37681,avijjamānena,avijjamanena,34,25,9,0,12
37682,kāramajjho,karamajjho,1,1,0,0,10
37683,avijjamānassāpi,avijjamanassapi,4,4,0,0,15
37684,kāraṇabhāvo,karanabhavo,36,35,1,0,11
37685,M0.0282,M0.0282,51,51,0,0,7
37686,subhikkho,subhikkho,18,17,1,0,9
37687,dubbhikkho,dubbhikkho,10,10,0,0,10
37688,sāsanepi,sasanepi,13,13,0,0,8
37689,anantarapaccayādīni,anantarapaccayadini,1,1,0,0,19
37690,āmakehi,amakehi,1,1,0,0,7
37691,kucchitehi,kucchitehi,2,2,0,0,10
37692,apūtigatamatasarīrehi,aputigatamatasarirehi,1,1,0,0,21
37693,āmake,amake,5,5,0,0,5
37694,susānasmiṃ,susanasmim,14,12,2,0,10
37695,sivathikā,sivathika,12,10,2,0,9
37696,atthappadhānaniddesena,atthappadhananiddesena,1,1,0,0,22
37697,puggalappadhānaniddesena,puggalappadhananiddesena,1,1,0,0,24
37698,chavā,chava,11,10,1,0,5
37699,dhiyyantetra,dhiyyantetra,1,1,0,0,12
37700,chavathikāpi,chavathikapi,1,1,0,0,12
37701,para407,para407,72,72,0,0,7
37702,ākaḍḍhitamanussagavādo,akaddhitamanussagavado,1,1,0,0,22
37703,muñcanasaññāya,muncanasannaya,1,1,0,0,14
37704,vandatīti,vandatiti,17,11,6,0,9
37705,vanda,vanda,33,26,7,0,5
37706,rassopi,rassopi,2,2,0,0,7
37707,vandi,vandi,100,97,3,0,5
37708,maritabbattā,maritabbatta,2,2,0,0,12
37709,karamaro,karamaro,2,1,1,0,8
37710,upaggahopi,upaggahopi,1,1,0,0,10
37711,jīvite,jivite,249,241,8,0,6
37712,pāṇanti,pananti,4,4,0,0,7
37713,āsupi,asupi,1,1,0,0,5
37714,khubhane,khubhane,1,1,0,0,8
37715,bandhanāgāraṃ,bandhanagaram,39,35,4,0,13
37716,bandhanagehaṃ,bandhanageham,1,1,0,0,13
37717,bandhanālayopi,bandhanalayopi,1,1,0,0,14
37718,niyyātane,niyyatane,2,2,0,0,9
37719,yatanā,yatana,1,1,0,0,6
37720,tibbavedanāpyatra,tibbavedanapyatra,1,1,0,0,17
37721,khattiyavaggavaṇṇanā,khattiyavaggavannana,1,1,0,0,20
37722,para408,para408,78,78,0,0,7
37723,M0.0283,M0.0283,51,51,0,0,7
37724,brāhmaṇe,brahmane,315,310,5,0,8
37725,brahmabandhu,brahmabandhu,77,70,7,0,12
37726,kulācārabrāhmaṇabhāvavasena,kulacarabrahmanabhavavasena,1,1,0,0,27
37727,ekaje,ekaje,1,1,0,0,5
37728,vapi,vapi,2,1,1,0,4
37729,smā,sma,88,54,34,0,3
37730,sutāyutakathanatthaṃ,sutayutakathanattham,1,1,0,0,20
37731,bhobho,bhobho,1,1,0,0,6
37732,chandojjhetari,chandojjhetari,1,1,0,0,14
37733,brahmasuttaṃ,brahmasuttam,3,3,0,0,12
37734,adhīte,adhite,17,17,0,0,6
37735,sottiyo,sottiyo,22,19,3,0,7
37736,sottiyā,sottiya,2,1,1,0,7
37737,chandaṃ,chandam,751,673,78,0,7
37738,chandaso,chandaso,32,29,3,0,8
37739,sisse,sisse,45,45,0,0,5
37740,sissā,sissa,125,122,3,0,5
37741,ācariyassa,acariyassa,532,528,4,0,10
37742,vasanasīlo,vasanasilo,3,3,0,0,10
37743,para409,para409,78,78,0,0,7
37744,brahmacārīādayo,brahmacariadayo,1,1,0,0,15
37745,assamā,assama,19,18,1,0,6
37746,assama,assama,4,3,1,0,6
37747,muñjamekhalādiyutto,munjamekhaladiyutto,1,1,0,0,19
37748,vedajjhāyako,vedajjhayako,1,1,0,0,12
37749,brahmacariyāyaṃ,brahmacariyayam,1,1,0,0,15
37750,vedajjhayanaṃ,vedajjhayanam,1,1,0,0,13
37751,brahmacariyaṃ,brahmacariyam,1764,1615,149,0,13
37752,dhammatthakāmesu,dhammatthakamesu,1,1,0,0,16
37753,pañcamahāyaññakārī,pancamahayannakari,1,1,0,0,18
37754,gahaṭṭho,gahattho,120,114,6,0,8
37755,M0.0284,M0.0284,50,50,0,0,7
37756,tatiyassapi,tatiyassapi,1,1,0,0,11
37757,vānapattho,vanapattho,2,1,1,0,10
37758,vanapatthe,vanapatthe,5,5,0,0,10
37759,vanekadese,vanekadese,1,1,0,0,10
37760,dūravane,duravane,1,1,0,0,8
37761,bhūmiseyyājaṭājinadhāraṇavanavāsonyahārabhojitādi,bhumiseyyajatajinadharanavanavasonyaharabhojitadi,1,1,0,0,49
37762,vānapatthassameva,vanapatthassameva,1,1,0,0,17
37763,tatiyamāyuso,tatiyamayuso,1,1,0,0,12
37764,bhāgaṃ,bhagam,235,217,18,0,6
37765,khepayitvā,khepayitva,4,4,0,0,10
37766,gahitakāsāvadaṇḍo,gahitakasavadando,1,1,0,0,17
37767,bhikkho,bhikkho,4,4,0,0,7
37768,sabbabhūtesu,sabbabhutesu,49,44,5,0,12
37769,jhānāyatanavaro,jhanayatanavaro,1,1,0,0,15
37770,tapasi,tapasi,7,6,1,0,6
37771,khede,khede,17,14,3,0,5
37772,āsammanti,asammanti,1,1,0,0,9
37773,brahmacariyādi,brahmacariyadi,2,2,0,0,14
37774,catukkepi,catukkepi,4,4,0,0,9
37775,maṭhepi,mathepi,2,2,0,0,7
37776,para410,para410,80,80,0,0,7
37777,sikkhādhamme,sikkhadhamme,1,1,0,0,12
37778,carantā,caranta,102,99,3,0,7
37779,sabrahmacārino,sabrahmacarino,41,37,4,0,14
37780,brahmacārīhi,brahmacarihi,1,1,0,0,12
37781,carantīti,carantiti,78,55,23,0,9
37782,mithū,mithu,2,2,0,0,5
37783,sabrahmacārī,sabrahmacari,150,145,5,0,12
37784,tagguṇasaṃviññāṇattaṃ,taggunasamvinnanattam,1,1,0,0,21
37785,dīpitaṃ,dipitam,193,179,14,0,7
37786,brahmacārīnampi,brahmacarinampi,1,1,0,0,15
37787,sabrahmacārittamupapannaṃ,sabrahmacarittamupapannam,1,1,0,0,25
37788,upasampadādāyake,upasampadadayake,1,1,0,0,16
37789,upecca,upecca,154,152,2,0,6
37790,sissānaṃ,sissanam,34,34,0,0,8
37791,vajjāvajjaṃ,vajjavajjam,29,22,7,0,11
37792,upajjhāyo,upajjhayo,451,432,19,0,9
37793,upajjhā,upajjha,34,30,4,0,7
37794,rājādipakkhepena,rajadipakkhepena,1,1,0,0,16
37795,vedādipāṭhayitā,vedadipathayita,1,1,0,0,15
37796,adhīyate,adhiyate,1,1,0,0,8
37797,nissayadāyake,nissayadayake,8,8,0,0,13
37798,ācaratīti,acaratiti,13,10,3,0,9
37799,para411,para411,83,83,0,0,7
37800,M0.0285,M0.0285,51,51,0,0,7
37801,ācariyaṃ,acariyam,288,274,14,0,8
37802,parasamayepi,parasamayepi,2,2,0,0,12
37803,upanīye,upaniye,1,0,1,0,7
37804,brāhmaṇaṃ,brahmanam,882,833,49,0,9
37805,upanīya,upaniya,11,9,2,0,7
37806,kappādichaḷaṅgikattā,kappadichalangikatta,1,1,0,0,20
37807,sāṅgaṃ,sangam,1,0,1,0,6
37808,saguyhattā,saguyhatta,1,1,0,0,10
37809,rahassa,rahassa,11,9,2,0,7
37810,vedaṃ,vedam,53,44,9,0,5
37811,paṭhamameva,pathamameva,252,249,3,0,11
37812,asikkhāpiteyeva,asikkhapiteyeva,1,1,0,0,15
37813,ajjhāpaye,ajjhapaye,1,0,1,0,9
37814,sikkhāpeyya,sikkhapeyya,1,1,0,0,11
37815,brāhmaṇesu,brahmanesu,106,104,2,0,10
37816,ādito,adito,929,879,50,0,5
37817,cāreti,careti,18,18,0,0,6
37818,upajjhāyā,upajjhaya,56,55,1,0,9
37819,para412,para412,82,82,0,0,7
37820,upadesaparamparāyaṃ,upadesaparamparayam,1,1,0,0,19
37821,pubbācariyā,pubbacariya,14,13,1,0,11
37822,ābhataṃ,abhatam,273,258,15,0,7
37823,pārampariyaṃ,parampariyam,1,0,1,0,12
37824,nipātasamudāyo,nipatasamudayo,26,26,0,0,14
37825,pubbācariyehi,pubbacariyehi,43,43,0,0,13
37826,vuttamidaṃ,vuttamidam,20,19,1,0,10
37827,etihyaṃ,etihyam,1,0,1,0,7
37828,etihaṃ,etiham,1,1,0,0,6
37829,upadeso,upadeso,26,22,4,0,7
37830,disī,disi,11,4,7,0,4
37831,uccāraṇe,uccarane,16,15,1,0,8
37832,yaññe,yanne,55,53,2,0,5
37833,yaja,yaja,19,8,11,0,4
37834,yajanaṃ,yajanam,12,12,0,0,7
37835,yāgo,yago,16,13,3,0,4
37836,saggatthikehi,saggatthikehi,1,1,0,0,13
37837,katu,katu,3,2,1,0,4
37838,ñña,nna,13,9,4,0,3
37839,yañño,yanno,100,94,6,0,5
37840,yāgatthaṃ,yagattham,1,1,0,0,9
37841,mantādinā,mantadina,2,2,0,0,9
37842,parikkhatā,parikkhata,12,11,1,0,10
37843,parisaṅkhatā,parisankhata,2,2,0,0,12
37844,īpaccaye,ipaccaye,3,3,0,0,8
37845,vedī,vedi,10,7,3,0,4
37846,lābhasakkāranti,labhasakkaranti,1,1,0,0,15
37847,para413,para413,80,80,0,0,7
37848,assamedhādayo,assamedhadayo,3,3,0,0,13
37849,M0.0286,M0.0286,51,51,0,0,7
37850,mahāyāgā,mahayaga,2,2,0,0,8
37851,porāṇakarājakāle,poranakarajakale,5,5,0,0,16
37852,sassamedhaṃ,sassamedham,11,6,5,0,11
37853,purisamedhaṃ,purisamedham,19,13,6,0,12
37854,sammāpāsaṃ,sammapasam,25,20,5,0,10
37855,vācāpeyyanti,vacapeyyanti,5,5,0,0,12
37856,saṅgahavatthūni,sangahavatthuni,31,30,1,0,15
37857,saṅgaṇhiṃsu,sanganhimsu,7,7,0,0,11
37858,nipphannasassato,nipphannasassato,9,9,0,0,16
37859,dasamabhāgaggahaṇaṃ,dasamabhagaggahanam,7,5,2,0,19
37860,sassasampādane,sassasampadane,7,5,2,0,14
37861,medhāvitā,medhavita,3,3,0,0,9
37862,mahāyodhānaṃ,mahayodhanam,6,6,0,0,12
37863,chamāsikabhattavetanānuppadānaṃ,chamasikabhattavetananuppadanam,2,2,0,0,31
37864,saṅgaṇhane,sanganhane,3,3,0,0,10
37865,daliddamanussānaṃ,daliddamanussanam,8,7,1,0,17
37866,hatthato,hatthato,549,532,17,0,8
37867,lekhaṃ,lekham,128,122,6,0,6
37868,vassāni,vassani,1025,994,31,0,7
37869,vaḍḍhiyā,vaddhiya,61,59,2,0,8
37870,sahassadvisahassamattadhanānuppadānaṃ,sahassadvisahassamattadhananuppadanam,5,5,0,0,37
37871,pāseti,paseti,6,6,0,0,6
37872,bandhitā,bandhita,6,6,0,0,8
37873,mātulā,matula,19,18,1,0,6
37874,saṇhavācāya,sanhavacaya,4,4,0,0,11
37875,bhaṇanaṃ,bhananam,17,17,0,0,8
37876,vācāpeyyaṃ,vacapeyyam,8,2,6,0,10
37877,peyye,peyye,4,3,1,0,5
37878,vajjapiyavacanatātyattho,vajjapiyavacanatatyattho,1,1,0,0,24
37879,iddhañceva,iddhanceva,49,47,2,0,10
37880,phītañca,phitanca,49,48,1,0,8
37881,pahūtannapānaṃ,pahutannapanam,1,1,0,0,14
37882,nirabbudaṃ,nirabbudam,29,25,4,0,10
37883,mudā,muda,20,19,1,0,4
37884,pamodamānā,pamodamana,7,7,0,0,10
37885,naccentā,naccenta,10,10,0,0,8
37886,apārutagharadvārā,aparutagharadvara,3,3,0,0,17
37887,gharadvāresu,gharadvaresu,14,14,0,0,12
37888,aggaḷānaṃ,aggalanam,6,6,0,0,9
37889,niraggaḷaṃ,niraggalam,19,12,7,0,10
37890,porāṇikapaveṇī,poranikapaveni,1,1,0,0,14
37891,aparabhāge,aparabhage,1041,1029,12,0,10
37892,okkākarājakāle,okkakarajakale,5,5,0,0,14
37893,imañca,imanca,352,334,18,0,6
37894,raṭṭhasampattiṃ,ratthasampattim,5,5,0,0,15
37895,parivattentā,parivattenta,8,8,0,0,12
37896,assamedhaṃ,assamedham,19,11,8,0,10
37897,itiādike,itiadike,59,58,1,0,8
37898,brāhmaṇadhammikasutte,brahmanadhammikasutte,1,0,1,0,21
37899,vipallāso,vipallaso,175,160,15,0,9
37900,aṇunā,anuna,1,1,0,0,5
37901,ganthetvā,ganthetva,57,53,4,0,9
37902,okkākaṃ,okkakam,13,13,0,0,7
37903,tadupāgamuṃ,tadupagamum,6,5,1,0,11
37904,M0.0287,M0.0287,49,49,0,0,7
37905,parivattetvā,parivattetva,400,391,9,0,12
37906,ṭhapitamatthaṃ,thapitamattham,2,2,0,0,14
37907,assamedho,assamedho,8,2,6,0,9
37908,ccādimāha,ccadimaha,16,16,0,0,9
37909,medhanti,medhanti,7,7,0,0,8
37910,vadhantīti,vadhantiti,3,3,0,0,10
37911,purisaṃ,purisam,804,776,28,0,7
37912,purisamedho,purisamedho,6,0,6,0,11
37913,yugacchidde,yugacchidde,5,5,0,0,11
37914,pakkhipitabbadaṇḍakaṃ,pakkhipitabbadandakam,4,4,0,0,21
37915,pāsenti,pasenti,1,1,0,0,7
37916,khipenti,khipenti,2,2,0,0,8
37917,sammāpāso,sammapaso,7,1,6,0,9
37918,mantapadābhisaṅkhatānaṃ,mantapadabhisankhatanam,4,4,0,0,23
37919,sappimadhūnaṃ,sappimadhunam,4,4,0,0,13
37920,vājaṃ,vajam,4,4,0,0,5
37921,tamettha,tamettha,12,11,1,0,8
37922,pivayantīti,pivayantiti,1,1,0,0,11
37923,vājapeyyo,vajapeyyo,6,1,5,0,9
37924,sāpateyyassa,sapateyyassa,10,9,1,0,12
37925,anigūhitvā,aniguhitva,7,7,0,0,10
37926,dinnattā,dinnatta,150,147,3,0,8
37927,aggaḷāti,aggalati,8,6,2,0,8
37928,niraggaḷo,niraggalo,36,26,10,0,9
37929,āgatakkamato,agatakkamato,1,1,0,0,12
37930,atthavaṇṇanā,atthavannana,236,214,22,0,12
37931,idhāgatakkamena,idhagatakkamena,1,1,0,0,15
37932,assamedhapurisamedhaniraggaḷasammāpāsavājapeyyānaṃ,assamedhapurisamedhaniraggalasammapasavajapeyyanam,1,1,0,0,50
37933,likhitabbā,likhitabba,2,2,0,0,10
37934,para414,para414,69,69,0,0,7
37935,yājake,yajake,1,1,0,0,6
37936,yajanasīlo,yajanasilo,2,2,0,0,10
37937,idi,idi,5,1,4,0,3
37938,yassi,yassi,3,3,0,0,5
37939,yajatīti,yajatiti,3,3,0,0,8
37940,ijo,ijo,2,1,1,0,3
37941,utumhi,utumhi,34,33,1,0,6
37942,itthītujo,itthitujo,1,1,0,0,9
37943,nārītvijo,naritvijo,1,1,0,0,9
37944,utujo,utujo,4,4,0,0,5
37945,yājako,yajako,11,11,0,0,6
37946,parasamayaṃ,parasamayam,9,7,2,0,11
37947,amanasi,amanasi,2,1,1,0,7
37948,ācariyena,acariyena,547,535,12,0,9
37949,itidvija,itidvija,1,0,1,0,8
37950,iditvija,iditvija,1,0,1,0,8
37951,samānatthāti,samanatthati,5,5,0,0,12
37952,maññamānena,mannamanena,9,7,2,0,11
37953,tvijo,tvijo,1,1,0,0,5
37954,passitabbā,passitabba,105,102,3,0,10
37955,yāgasabhāyaṃ,yagasabhayam,1,1,0,0,12
37956,aññasabhāyañcārambhake,annasabhayancarambhake,1,1,0,0,22
37957,samājaṃ,samajam,2,2,0,0,7
37958,janasaṅghātaṃ,janasanghatam,1,1,0,0,13
37959,samāvasanti,samavasanti,2,2,0,0,11
37960,ekadesī,ekadesi,1,1,0,0,7
37961,samājā,samaja,1,1,0,0,6
37962,ekībhavatīti,ekibhavatiti,2,1,1,0,12
37963,M0.0288,M0.0288,50,50,0,0,7
37964,sāmājiko,samajiko,2,1,1,0,8
37965,sabhāsado,sabhasado,1,1,0,0,9
37966,sabhātāropyatra,sabhataropyatra,1,1,0,0,15
37967,sabhāsāmaññe,sabhasamanne,1,1,0,0,12
37968,sentyassaṃ,sentyassam,1,1,0,0,10
37969,bhāsantyassaṃ,bhasantyassam,1,1,0,0,13
37970,samajjanti,samajjanti,1,1,0,0,10
37971,saṃgacchanti,samgacchanti,3,3,0,0,12
37972,milantyassaṃ,milantyassam,2,2,0,0,12
37973,samajjā,samajja,11,9,2,0,7
37974,samiti,samiti,23,19,4,0,6
37975,milanamekībhāvo,milanamekibhavo,1,1,0,0,15
37976,sīdantyasmiṃ,sidantyasmim,1,1,0,0,12
37977,saṃsado,samsado,2,1,1,0,7
37978,itthinapuṃsakesu,itthinapumsakesu,1,1,0,0,16
37979,goṭṭhī,gotthi,3,2,1,0,6
37980,aṭṭhānīpyatra,atthanipyatra,1,1,0,0,13
37981,gāvovācā,gavovaca,1,1,0,0,8
37982,tiṭṭhantyassaṃ,titthantyassam,1,1,0,0,14
37983,aṭṭhānī,atthani,1,0,1,0,7
37984,rassādi,rassadi,18,18,0,0,7
37985,para415-416,para415-416,1,1,0,0,11
37986,bhikkhuādikā,bhikkhuadika,1,1,0,0,12
37987,bhikkhanasīlatādīhi,bhikkhanasilatadihi,1,1,0,0,19
37988,ariyāna,ariyana,17,15,2,0,7
37989,yācanā,yacana,58,54,4,0,6
37990,bhikkha,bhikkha,11,3,8,0,7
37991,bhikkhū,bhikkhu,11800,11560,240,0,7
37992,bhikkhunī,bhikkhuni,1829,1652,177,0,9
37993,ratanattayamupagantvā,ratanattayamupagantva,1,1,0,0,21
37994,āsayantīti,asayantiti,1,1,0,0,10
37995,upāsikāyo,upasikayo,63,62,1,0,9
37996,pabbajjāsāmaññato,pabbajjasamannato,1,1,0,0,17
37997,liṅgasāmaññato,lingasamannato,1,1,0,0,14
37998,sāmaṇerā,samanera,158,153,5,0,8
37999,bhikkhūsu,bhikkhusu,390,385,5,0,9
38000,sāmaṇeriyādayo,samaneriyadayo,1,1,0,0,14
38001,bhikkhunīsu,bhikkhunisu,91,83,8,0,11
38002,devamanussādayo,devamanussadayo,5,5,0,0,15
38003,itthipurisavasena,itthipurisavasena,2,2,0,0,17
38004,liṅgasabhāgavasena,lingasabhagavasena,1,1,0,0,18
38005,liṅgābhāvepi,lingabhavepi,1,1,0,0,12
38006,purisasaṇṭhānattā,purisasanthanatta,1,1,0,0,17
38007,purisesu,purisesu,60,60,0,0,8
38008,paṇḍakāpi,pandakapi,4,4,0,0,9
38009,ubhatobyañjanesu,ubhatobyanjanesu,1,1,0,0,16
38010,M0.0289,M0.0289,49,49,0,0,7
38011,purisaubhatobyañjanaṃ,purisaubhatobyanjanam,1,1,0,0,21
38012,itthiubhatobyañjanaṃ,itthiubhatobyanjanam,1,1,0,0,20
38013,itthīsu,itthisu,85,82,3,0,7
38014,saṅgahitanti,sangahitanti,101,101,0,0,12
38015,aṭṭhahipi,atthahipi,7,7,0,0,9
38016,athave,athave,2,1,1,0,6
38017,vasenā,vasena,80,52,28,0,6
38018,ṭṭha,ttha,23,19,4,0,4
38019,tāvatiṃsānaṃ,tavatimsanam,154,147,7,0,12
38020,khattānaṃ,khattanam,1,0,1,0,9
38021,samaṇānaṃ,samananam,175,163,12,0,9
38022,cātumahārājikānaṃ,catumaharajikanam,94,89,5,0,17
38023,brahmūnañca,brahmunanca,3,3,0,0,11
38024,vasenāti,vasenati,156,77,79,0,8
38025,ṭṭhaparisā,tthaparisa,1,1,0,0,10
38026,pākaṭavasena,pakatavasena,14,14,0,0,12
38027,seṭṭhavasena,setthavasena,12,12,0,0,12
38028,tāvatiṃsādikā,tavatimsadika,1,1,0,0,13
38029,samaṇā,samana,798,759,39,0,6
38030,para417,para417,79,79,0,0,7
38031,gāyatti,gayatti,5,4,1,0,7
38032,chaḷakkharāni,chalakkharani,1,1,0,0,13
38033,pamukhamādi,pamukhamadi,1,1,0,0,11
38034,utthādīnaṃ,utthadinam,1,1,0,0,10
38035,pāyenānupayogattā,payenanupayogatta,1,1,0,0,17
38036,gāyattipamukhaṃ,gayattipamukham,1,1,0,0,15
38037,gāyateti,gayateti,1,1,0,0,8
38038,tti,tti,9,9,0,0,3
38039,pajjaviveke,pajjaviveke,1,0,1,0,11
38040,buddhaguttena,buddhaguttena,1,0,1,0,13
38041,bhikkhunā,bhikkhuna,2693,2601,92,0,9
38042,uttha,uttha,3,2,1,0,5
38043,maccutthakaṃ,maccutthakam,1,1,0,0,12
38044,suppatiṭṭhakā,suppatitthaka,1,1,0,0,13
38045,payogabāhyatthā,payogabahyattha,1,1,0,0,15
38046,abhabbattā,abhabbatta,17,17,0,0,10
38047,neritā,nerita,1,1,0,0,6
38048,catuvīsakkharavantaṃ,catuvisakkharavantam,1,1,0,0,20
38049,ādibhūtañca,adibhutanca,1,1,0,0,11
38050,chandānaṃ,chandanam,2,2,0,0,9
38051,catuppadaṃ,catuppadam,18,16,2,0,10
38052,tipadameva,tipadameva,1,1,0,0,10
38053,sāvitti,savitti,4,2,2,0,7
38054,gāyattipariyāyopyatthi,gayattipariyayopyatthi,1,1,0,0,22
38055,sāvittī,savitti,15,12,3,0,7
38056,bhedena,bhedena,114,112,2,0,7
38057,M0.0290,M0.0290,48,48,0,0,7
38058,saṅghaṃ,sangham,1862,1804,58,0,7
38059,gacchāmī,gacchami,168,161,7,0,8
38060,savitussa,savitussa,1,1,0,0,9
38061,para418,para418,73,73,0,0,7
38062,habyaṃ,habyam,24,22,2,0,6
38063,devatātthamannaṃ,devatatthamannam,1,1,0,0,16
38064,tadādhāre,tadadhare,1,1,0,0,9
38065,thālyādimhi,thalyadimhi,1,1,0,0,11
38066,caru,caru,7,5,2,0,4
38067,habyampi,habyampi,1,1,0,0,8
38068,tismā,tisma,18,18,0,0,5
38069,habyapāke,habyapake,2,2,0,0,9
38070,hya,hya,4,4,0,0,3
38071,homadabbiyaṃ,homadabbiyam,2,1,1,0,12
38072,homakammani,homakammani,2,2,0,0,11
38073,habyannādīnamuddharaṇatthaṃ,habyannadinamuddharanattham,2,2,0,0,27
38074,katāyaṃ,katayam,12,12,0,0,7
38075,kaṭacchuyaṃ,katacchuyam,2,2,0,0,11
38076,sujā,suja,29,21,8,0,4
38077,habyannādīnaṃ,habyannadinam,2,2,0,0,13
38078,khīranne,khiranne,1,1,0,0,8
38079,devannattā,devannatta,1,1,0,0,10
38080,pātabbassa,patabbassa,2,2,0,0,10
38081,asitabbassa,asitabbassa,2,2,0,0,11
38082,bhāvānaṃ,bhavanam,9,9,0,0,8
38083,pāyāso,payaso,28,25,3,0,6
38084,kārantānamāyo,karantanamayo,1,1,0,0,13
38085,pāyasopyatra,payasopyatra,1,1,0,0,12
38086,devanne,devanne,1,1,0,0,7
38087,havi,havi,5,2,3,0,4
38088,para419,para419,71,71,0,0,7
38089,thūṇāyaṃ,thunayam,2,2,0,0,8
38090,yaññathambhe,yannathambhe,1,1,0,0,12
38091,beluvo,beluvo,3,2,1,0,6
38092,khādiro,khadiro,1,1,0,0,7
38093,ālambapasubandhaneyaṭṭhi,alambapasubandhaneyatthi,1,1,0,0,24
38094,samattayaññe,samattayanne,1,1,0,0,12
38095,yaṭṭhimāropayati,yatthimaropayati,1,1,0,0,16
38096,yūpa,yupa,2,2,0,0,4
38097,yaññīyapasubandhanakaṭṭhabhede,yanniyapasubandhanakatthabhede,1,1,0,0,30
38098,yāgasamatticihnatthe,yagasamatticihnatthe,1,1,0,0,20
38099,vācappati,vacappati,1,1,0,0,9
38100,kaṭṭhaṃ,kattham,170,146,24,0,7
38101,kaṭṭhantarenā,katthantarena,1,1,0,0,13
38102,gginipphādanatthaṃ,gginipphadanattham,1,1,0,0,18
38103,ghaṃsate,ghamsate,1,1,0,0,8
38104,nimmanthyadārumhi,nimmanthyadarumhi,1,1,0,0,17
38105,araṇī,arani,14,8,6,0,5
38106,aṇi,ani,1,1,0,0,3
38107,īmhi,imhi,13,13,0,0,4
38108,gāhapaccādayo,gahapaccadayo,1,1,0,0,13
38109,M0.0291,M0.0291,49,49,0,0,7
38110,aggayo,aggayo,32,32,0,0,6
38111,gahapatinā,gahapatina,59,55,4,0,10
38112,saṃyutto,samyutto,91,87,4,0,8
38113,gāhapacco,gahapacco,1,0,1,0,9
38114,taṃyoniyaṃrevāhavanīyo,tamyoniyamrevahavaniyo,1,1,0,0,22
38115,hutabbaggiāhavanamarahatīti,hutabbaggiahavanamarahatiti,1,1,0,0,27
38116,āhavanīyo,ahavaniyo,17,16,1,0,9
38117,dakkhiṇaggi,dakkhinaggi,3,2,1,0,11
38118,taṃyoni,tamyoni,1,1,0,0,7
38119,aññayonipi,annayonipi,1,1,0,0,10
38120,vissajjantyasminti,vissajjantyasminti,1,1,0,0,18
38121,aggīyati,aggiyati,4,4,0,0,8
38122,dīyatyasminti,diyatyasminti,1,1,0,0,13
38123,dānaggaṃ,danaggam,38,35,3,0,8
38124,parivesanaṭṭhānaṃ,parivesanatthanam,8,8,0,0,17
38125,aṅguttaranikāyaṭīkā,anguttaranikayatika,1,0,1,0,19
38126,gāhapaccaggādīnaṃ,gahapaccaggadinam,1,1,0,0,17
38127,vippaṭipajjantānaṃ,vippatipajjantanam,1,1,0,0,18
38128,vināsahetubhāvato,vinasahetubhavato,1,1,0,0,17
38129,aggitādaṭṭhabbā,aggitadatthabba,1,1,0,0,15
38130,sattakanipātaaṅguttaranikāyaṭṭhakathāyaṃ,sattakanipataanguttaranikayatthakathayam,1,0,1,0,40
38131,āhunaṃ,ahunam,36,29,7,0,6
38132,arahantīti,arahantiti,42,40,2,0,10
38133,āhuneyyā,ahuneyya,46,42,4,0,8
38134,puttānaṃ,puttanam,198,187,11,0,8
38135,bahūpakāratāya,bahupakarataya,5,5,0,0,14
38136,arahanti,arahanti,125,122,3,0,8
38137,vippaṭipajjamānā,vippatipajjamana,3,3,0,0,16
38138,nirayādīsu,nirayadisu,69,69,0,0,10
38139,nānudahanti,nanudahanti,2,2,0,0,11
38140,anudahamānassa,anudahamanassa,1,1,0,0,14
38141,anudahanaṭṭheneva,anudahanattheneva,1,1,0,0,17
38142,āhuneyyaggī,ahuneyyaggi,1,1,0,0,11
38143,mātugāmassa,matugamassa,309,290,19,0,11
38144,sayanavatthālaṅkārādianuppadānena,sayanavatthalankaradianuppadanena,3,3,0,0,33
38145,bahūpakāro,bahupakaro,95,94,1,0,10
38146,aticaranto,aticaranto,4,4,0,0,10
38147,nibbattati,nibbattati,321,313,8,0,10
38148,purimanayeneva,purimanayeneva,504,494,10,0,14
38149,anudahanaṭṭhena,anudahanatthena,27,26,1,0,15
38150,gahapataggī,gahapataggi,1,1,0,0,11
38151,dakkhiṇeyyaggī,dakkhineyyaggi,2,2,0,0,14
38152,bhikkhusaṅgho,bhikkhusangho,417,406,11,0,13
38153,saraṇesu,saranesu,165,162,3,0,8
38154,sīlesu,silesu,450,418,32,0,6
38155,mātāpitupaṭṭhāne,matapitupatthane,2,2,0,0,16
38156,dhammikasamaṇabrāhmaṇūpaṭṭhāneti,dhammikasamanabrahmanupatthaneti,1,1,0,0,32
38157,evamādīsu,evamadisu,472,471,1,0,9
38158,kalyāṇadhammesu,kalyanadhammesu,3,3,0,0,15
38159,niyojanena,niyojanena,11,11,0,0,10
38160,micchāpaṭipanno,micchapatipanno,29,28,1,0,15
38161,bhikkhusaṅghaṃ,bhikkhusangham,627,616,11,0,14
38162,akkositvā,akkositva,35,35,0,0,9
38163,M0.0292,M0.0292,49,49,0,0,7
38164,kaṭṭhato,katthato,2,2,0,0,8
38165,pākatikova,pakatikova,2,2,0,0,10
38166,kaṭṭhaggi,katthaggi,8,6,2,0,9
38167,para420,para420,74,74,0,0,7
38168,dvitta,dvitta,1,1,0,0,6
38169,ttāni,ttani,2,2,0,0,5
38170,caja,caja,11,4,7,0,4
38171,hānimhi,hanimhi,3,3,0,0,7
38172,visagge,visagge,1,1,0,0,7
38173,visaggo,visaggo,2,2,0,0,7
38174,visajje,visajje,1,1,0,0,7
38175,vosaggo,vosaggo,15,13,2,0,7
38176,pabodhanañca,pabodhananca,1,1,0,0,12
38177,plavanataraṇesu,plavanataranesu,3,3,0,0,15
38178,maccherasotātikkamanamettha,maccherasotatikkamanamettha,1,1,0,0,27
38179,vihāyitaṃ,vihayitam,1,0,1,0,9
38180,vajja,vajja,16,11,5,0,5
38181,vajjane,vajjane,29,23,6,0,7
38182,upasaggavisesenete,upasaggavisesenete,1,1,0,0,18
38183,dānatthābhidhāyino,danatthabhidhayino,1,1,0,0,18
38184,phassanaṃ,phassanam,1,1,0,0,9
38185,patipādanaṃpyatra,patipadanampyatra,1,1,0,0,17
38186,para421,para421,73,73,0,0,7
38187,seṭṭhadhanassa,setthadhanassa,1,1,0,0,14
38188,dārānaṃ,daranam,2,2,0,0,7
38189,rajjassa,rajjassa,87,86,1,0,8
38190,aṅgānañca,angananca,10,6,4,0,9
38191,pañcamahāpariccāgo,pancamahapariccago,1,1,0,0,18
38192,seṭṭhadhanaṃ,setthadhanam,1,0,1,0,12
38193,setahatthādiratanaṃ,setahatthadiratanam,1,1,0,0,19
38194,orasā,orasa,80,71,9,0,5
38195,piyabhariyā,piyabhariya,3,3,0,0,11
38196,pakatirajjaṃ,pakatirajjam,1,1,0,0,12
38197,taduṭṭhito,tadutthito,1,1,0,0,10
38198,mahantehi,mahantehi,78,74,4,0,9
38199,uttamapuriseheva,uttamapuriseheva,1,1,0,0,16
38200,mahāpariccāgo,mahapariccago,5,1,4,0,13
38201,mahatthaṃ,mahattham,4,4,0,0,9
38202,buddhabhāvatthaṃ,buddhabhavattham,2,2,0,0,16
38203,kāpurisehi,kapurisehi,5,5,0,0,10
38204,para422,para422,70,70,0,0,7
38205,dānapāramīādikānaṃ,danaparamiadikanam,1,1,0,0,18
38206,M0.0293,M0.0293,49,49,0,0,7
38207,asādhāraṇadānavatthuṃ,asadharanadanavatthum,1,1,0,0,21
38208,sādhāraṇadānavatthuṃ,sadharanadanavatthum,1,1,0,0,20
38209,pānavajjitaṃ,panavajjitam,1,1,0,0,12
38210,khādanīyādikaṃ,khadaniyadikam,1,1,0,0,14
38211,pātabbaṃ,patabbam,60,60,0,0,8
38212,udakādi,udakadi,2,2,0,0,7
38213,hatthyādi,hatthyadi,2,2,0,0,9
38214,upāhanaṃ,upahanam,80,78,2,0,8
38215,gamanasādhanaṃ,gamanasadhanam,2,2,0,0,14
38216,pupphañca,pupphanca,25,25,0,0,9
38217,chavirāgakaraṇaṃ,chaviragakaranam,12,11,1,0,16
38218,tadaññagandho,tadannagandho,1,1,0,0,13
38219,mañcādi,mancadi,4,4,0,0,7
38220,āsanampi,asanampi,13,13,0,0,8
38221,padīpeyyaṃ,padipeyyam,25,17,8,0,10
38222,padīpassa,padipassa,28,28,0,0,9
38223,telādi,teladi,8,8,0,0,6
38224,dānavatthū,danavatthu,3,2,1,0,10
38225,uppajjanatoti,uppajjanatoti,12,10,2,0,13
38226,annādi,annadi,3,3,0,0,6
38227,dānavatthūni,danavatthuni,8,7,1,0,12
38228,suttantanayena,suttantanayena,32,32,0,0,14
38229,vinayābhidhammanayavasenāpi,vinayabhidhammanayavasenapi,1,1,0,0,27
38230,kathetabbāni,kathetabbani,36,34,2,0,12
38231,rūpādichaḷārammaṇadānavasena,rupadichalarammanadanavasena,1,1,0,0,28
38232,abhidhamme,abhidhamme,415,344,71,0,10
38233,vinaye,vinaye,655,592,63,0,6
38234,cīvarapiṇḍapātabhesajjasenāsanavasena,civarapindapatabhesajjasenasanavasena,1,1,0,0,37
38235,tatthevamācariyā,tatthevamacariya,1,1,0,0,16
38236,suttantanayadānato,suttantanayadanato,1,1,0,0,18
38237,vinayadānameva,vinayadanameva,1,1,0,0,14
38238,annādidānamattavaseneva,annadidanamattavaseneva,1,1,0,0,23
38239,dussīlādikassa,dussiladikassa,1,1,0,0,14
38240,dātabbanti,databbanti,92,92,0,0,10
38241,anujānitvā,anujanitva,33,33,0,0,10
38242,piṇḍapātādikappiyavohāravasena,pindapatadikappiyavoharavasena,1,1,0,0,30
38243,sīlavantādikasseva,silavantadikasseva,1,1,0,0,18
38244,anuññātattā,anunnatatta,148,144,4,0,11
38245,sāmaññadānato,samannadanato,1,1,0,0,13
38246,visesadānameva,visesadanameva,1,1,0,0,14
38247,abhidhammanayadānameva,abhidhammanayadanameva,1,1,0,0,22
38248,paramatthavaseneva,paramatthavaseneva,2,2,0,0,18
38249,abhinivisitvā,abhinivisitva,126,118,8,0,13
38250,dānavasena,danavasena,42,41,1,0,10
38251,atisayadānattā,atisayadanatta,1,1,0,0,14
38252,suttantanayadānaṃ,suttantanayadanam,1,1,0,0,17
38253,vinayābhidhammanayadānaṃ,vinayabhidhammanayadanam,1,1,0,0,24
38254,khettāditividhasampadāyuttaṃ,khettaditividhasampadayuttam,1,1,0,0,28
38255,vadāma,vadama,99,94,5,0,6
38256,para423,para423,66,66,0,0,7
38257,tadahe,tadahe,12,11,1,0,6
38258,M0.0294,M0.0294,49,49,0,0,7
38259,matadivase,matadivase,2,2,0,0,10
38260,matatthaṃ,matattham,2,2,0,0,9
38261,piṇḍapātajalāñjalyādidānaṃ,pindapatajalanjalyadidanam,1,1,0,0,26
38262,dehā,deha,8,5,3,0,4
38263,uddhe,uddhe,1,1,0,0,5
38264,uddhadehikaṃ,uddhadehikam,1,0,1,0,12
38265,pitaraṃ,pitaram,596,579,17,0,7
38266,jalāñjalisuvaṇṇādidānaṃ,jalanjalisuvannadidanam,1,1,0,0,23
38267,nivāpo,nivapo,26,22,4,0,6
38268,kālapattādiniyamena,kalapattadiniyamena,1,1,0,0,19
38269,rājamattaṇḍavisottarā,rajamattandavisottara,1,0,1,0,21
38270,disatthato,disatthato,1,1,0,0,10
38271,pitudānaṃ,pitudanam,2,2,0,0,9
38272,samaṇabrāhmaṇabhojanādi,samanabrahmanabhojanadi,1,1,0,0,23
38273,dānassatthīti,danassatthiti,1,1,0,0,13
38274,satthatoti,satthatoti,2,0,2,0,10
38275,avadhyatthavatticchāya,avadhyatthavatticchaya,1,1,0,0,22
38276,pañcamī,pancami,206,185,21,0,7
38277,para424,para424,78,78,0,0,7
38278,gehāgate,gehagate,1,1,0,0,8
38279,atithi,atithi,21,17,4,0,6
38280,atithī,atithi,17,14,3,0,6
38281,āgantu,agantu,3,2,1,0,6
38282,gehāgatānaṃ,gehagatanam,1,1,0,0,11
38283,dātabbabhattādi,databbabhattadi,1,1,0,0,15
38284,paṭiggaṇhituṃ,patigganhitum,22,22,0,0,13
38285,pāhuno,pahuno,5,4,1,0,6
38286,āveso,aveso,1,1,0,0,5
38287,tamarahatīti,tamarahatiti,2,2,0,0,12
38288,āvesiko,avesiko,1,0,1,0,7
38289,atyāgatopyatra,atyagatopyatra,1,1,0,0,14
38290,gantumicchatīti,gantumicchatiti,2,2,0,0,15
38291,gamiko,gamiko,47,39,8,0,6
38292,pūjitapupphadabbakkhatādimhi,pujitapupphadabbakkhatadimhi,1,1,0,0,28
38293,aggha,aggha,2,1,1,0,5
38294,agghiyaṃ,agghiyam,27,18,9,0,8
38295,agghayampi,agghayampi,1,1,0,0,10
38296,agghato,agghato,3,3,0,0,7
38297,tadatthiye,tadatthiye,2,2,0,0,10
38298,para425,para425,74,74,0,0,7
38299,pādatthe,padatthe,1,1,0,0,8
38300,pādaddhe,padaddhe,1,1,0,0,8
38301,udakādimhi,udakadimhi,2,2,0,0,10
38302,pajja,pajja,18,15,3,0,5
38303,M0.0295,M0.0295,48,48,0,0,7
38304,acca,acca,10,4,6,0,4
38305,itthiyamati,itthiyamati,4,4,0,0,11
38306,upahāro,upaharo,9,7,2,0,7
38307,pāṇanapūjāsaṃvaraṇesu,pananapujasamvaranesu,1,1,0,0,21
38308,namassāpyatra,namassapyatra,1,1,0,0,13
38309,namassa,namassa,5,0,5,0,7
38310,para426,para426,69,69,0,0,7
38311,vandanāyaṃ,vandanayam,1,1,0,0,10
38312,chaṭṭhīlopo,chatthilopo,1,1,0,0,11
38313,tatrākāro,tatrakaro,7,4,3,0,9
38314,kāralope,karalope,7,7,0,0,8
38315,saliṅgo,salingo,6,6,0,0,7
38316,kārantoti,karantoti,1,1,0,0,9
38317,abhivādanaṃ,abhivadanam,115,105,10,0,11
38318,patthanāmatte,patthanamatte,1,1,0,0,13
38319,atthanāpi,atthanapi,1,1,0,0,9
38320,pani,pani,7,6,1,0,4
38321,dvayapubbo,dvayapubbo,1,1,0,0,10
38322,yācanāpyatra,yacanapyatra,1,1,0,0,12
38323,para427,para427,71,71,0,0,7
38324,sakkārapubbaṅgamaṃ,sakkarapubbangamam,1,1,0,0,18
38325,garuādīnaṃ,garuadinam,2,2,0,0,10
38326,ārādhanīyānaṃ,aradhaniyanam,1,1,0,0,13
38327,niyojanaṃ,niyojanam,31,31,0,0,9
38328,patthanāviseso,patthanaviseso,1,1,0,0,14
38329,ajjhesanā,ajjhesana,12,7,5,0,9
38330,gatihiṃsāvadānesuvā,gatihimsavadanesuva,1,1,0,0,19
38331,desetu,desetu,142,139,3,0,6
38332,mahāva,mahava,2212,2212,0,0,6
38333,para428,para428,73,73,0,0,7
38334,M0.0296,M0.0296,48,48,0,0,7
38335,anussaraṇe,anussarane,10,10,0,0,10
38336,game,game,10,10,0,0,4
38337,pariyesanā,pariyesana,90,85,5,0,10
38338,pariyeṭṭhi,pariyetthi,24,21,3,0,10
38339,gavesa,gavesa,4,1,3,0,6
38340,maggane,maggane,3,2,1,0,7
38341,ārādhanīyassa,aradhaniyassa,1,1,0,0,13
38342,cittānukūle,cittanukule,1,1,0,0,11
38343,sotumicchā,sotumiccha,4,4,0,0,10
38344,sussūsā,sussusa,22,18,4,0,7
38345,bhujaghasaharasupādīhi,bhujaghasaharasupadihi,1,1,0,0,22
38346,tumicchatthesū,tumicchatthesu,1,1,0,0,14
38347,pāricariyā,paricariya,56,52,4,0,10
38348,para429,para429,71,71,0,0,7
38349,tuṇhībhāve,tunhibhave,50,45,5,0,10
38350,ṇha,nha,1,0,1,0,3
38351,halopo,halopo,10,9,1,0,6
38352,tuṇho,tunho,1,1,0,0,5
38353,monametassatthīti,monametassatthiti,1,1,0,0,17
38354,tuṇhī,tunhi,782,741,41,0,5
38355,tuṇhībhāvo,tunhibhavo,62,50,12,0,10
38356,atuṇhassa,atunhassa,1,1,0,0,9
38357,tuṇhībhavanaṃ,tunhibhavanam,1,1,0,0,13
38358,tohatīti,tohatiti,1,1,0,0,8
38359,adanaṃ,adanam,2,2,0,0,6
38360,tuṇhino,tunhino,1,1,0,0,7
38361,anukkame,anukkame,6,5,1,0,8
38362,patirūpena,patirupena,27,26,1,0,10
38363,anurūpo,anurupo,26,25,1,0,7
38364,anukkamo,anukkamo,33,32,1,0,8
38365,anatikkamena,anatikkamena,1,1,0,0,12
38366,pubbassānurūpā,pubbassanurupa,1,1,0,0,14
38367,anupubbī,anupubbi,21,18,3,0,8
38368,anupubbampi,anupubbampi,1,1,0,0,11
38369,para430,para430,68,68,0,0,7
38370,uparamo,uparamo,4,3,1,0,7
38371,M0.0297,M0.0297,49,49,0,0,7
38372,samādhāne,samadhane,13,13,0,0,9
38373,adhiṭṭhānabhāvo,adhitthanabhavo,7,7,0,0,15
38374,samādhiratra,samadhiratra,1,1,0,0,12
38375,tupacārā,tupacara,1,1,0,0,8
38376,kusaladhammato,kusaladhammato,2,2,0,0,14
38377,saṃyamanaṃ,samyamanam,15,15,0,0,10
38378,saṃyamo,samyamo,106,92,14,0,7
38379,samādhānañcātrākusaladhammavasenevāti,samadhanancatrakusaladhammavasenevati,1,1,0,0,37
38380,satthavihito,satthavihito,1,1,0,0,12
38381,mantanāyaṃ,mantanayam,2,2,0,0,10
38382,paṭiññāyaṃ,patinnayam,4,4,0,0,10
38383,vate,vate,18,11,7,0,4
38384,upavāsādilakkhaṇaṃ,upavasadilakkhanam,1,1,0,0,18
38385,puññamuccate,punnamuccate,1,1,0,0,12
38386,cārittaṃ,carittam,143,122,21,0,8
38387,vārittamupavāsādipuññaka,varittamupavasadipunnaka,1,1,0,0,24
38388,ntya,ntya,6,6,0,0,4
38389,akkhāralavaṇāsanādi,akkharalavanasanadi,1,1,0,0,19
38390,akhādanābhojanādi,akhadanabhojanadi,1,1,0,0,17
38391,tapā,tapa,16,11,5,0,4
38392,mukhyavasena,mukhyavasena,5,5,0,0,12
38393,kusalasīle,kusalasile,3,3,0,0,10
38394,rūḷhīvasena,rulhivasena,17,17,0,0,11
38395,akusalasīlepi,akusalasilepi,1,1,0,0,13
38396,niyamāda,niyamada,1,0,1,0,8
38397,akusalasīle,akusalasile,1,1,0,0,11
38398,kusalasīleti,kusalasileti,1,1,0,0,12
38399,sīlabbatānaṃ,silabbatanam,3,3,0,0,12
38400,vattanañcātra,vattanancatra,1,1,0,0,13
38401,mariyādātikkame,mariyadatikkame,1,1,0,0,15
38402,atikka,atikka,1,1,0,0,6
38403,vītikkamo,vitikkamo,104,99,5,0,9
38404,mariyādātikkamo,mariyadatikkamo,1,1,0,0,15
38405,ajjhācāro,ajjhacaro,45,38,7,0,9
38406,kāyavivekādayo,kayavivekadayo,8,6,2,0,14
38407,vica,vica,7,2,5,0,4
38408,visuṃbhūto,visumbhuto,3,3,0,0,10
38409,gaṇādīhi,ganadihi,3,3,0,0,8
38410,puthugattā,puthugatta,1,1,0,0,10
38411,puthugattatā,puthugattata,2,1,1,0,12
38412,puthagattatā,puthagattata,1,1,0,0,12
38413,evaṃsarūpoyaṃ,evamsarupoyam,1,1,0,0,13
38414,evaṃsarūpā,evamsarupa,1,1,0,0,10
38415,amhepi,amhepi,33,32,1,0,6
38416,pakatipurisānaṃ,pakatipurisanam,1,1,0,0,15
38417,vibhāgena,vibhagena,111,111,0,0,9
38418,ñāṇaviveko,nanaviveko,1,1,0,0,10
38419,puthubhāvena,puthubhavena,1,1,0,0,12
38420,tabbhāvo,tabbhavo,46,45,1,0,8
38421,puthugattatātyaññe,puthugattatatyanne,2,2,0,0,18
38422,aññato,annato,187,167,20,0,6
38423,vilakkhaṇassa,vilakkhanassa,1,1,0,0,13
38424,para431,para431,75,75,0,0,7
38425,khuddānukhuddakaṃ,khuddanukhuddakam,10,10,0,0,17
38426,M0.0298,M0.0298,47,47,0,0,7
38427,cūḷavattaṃ,culavattam,1,1,0,0,10
38428,mahāvattañca,mahavattanca,1,1,0,0,12
38429,vattapaṭipatti,vattapatipatti,2,1,1,0,14
38430,ābhisamācārika,abhisamacarika,1,1,0,0,14
38431,abhisamācāre,abhisamacare,4,4,0,0,12
38432,uttamasamācāre,uttamasamacare,3,3,0,0,14
38433,ābhisamācārikaṃ,abhisamacarikam,52,41,11,0,15
38434,khuddānukhuddakato,khuddanukhuddakato,2,2,0,0,18
38435,pātimokkhasaṃvarasīlādikaṃ,patimokkhasamvarasiladikam,1,1,0,0,26
38436,brahmacariyassāriyamaggassa,brahmacariyassariyamaggassa,1,1,0,0,27
38437,tadatthāya,tadatthaya,163,159,4,0,10
38438,caritabbattā,caritabbatta,9,9,0,0,12
38439,ādibrahmacariya,adibrahmacariya,1,0,1,0,15
38440,para432,para432,69,69,0,0,7
38441,pāpehi,papehi,34,31,3,0,6
38442,akusaladhammehi,akusaladhammehi,10,10,0,0,15
38443,upāvatto,upavatto,2,2,0,0,8
38444,upāvuto,upavuto,1,1,0,0,7
38445,anāvuto,anavuto,1,1,0,0,7
38446,sabbannapānabhogādīhi,sabbannapanabhogadihi,1,1,0,0,21
38447,vivajjitova,vivajjitova,1,1,0,0,11
38448,thambhanamatthi,thambhanamatthi,1,1,0,0,15
38449,upavāso,upavaso,14,11,3,0,7
38450,vijānitabbo,vijanitabbo,14,14,0,0,11
38451,vasu,vasu,14,11,3,0,4
38452,upavasanaṃ,upavasanam,2,2,0,0,10
38453,vāsoti,vasoti,11,8,3,0,6
38454,para433,para433,66,66,0,0,7
38455,bhikkhumhi,bhikkhumhi,56,54,2,0,10
38456,kammamassatthīti,kammamassatthiti,1,1,0,0,16
38457,dito,dito,52,50,2,0,4
38458,bhayadassanasīlo,bhayadassanasilo,9,9,0,0,16
38459,pabbajā,pabbaja,13,13,0,0,7
38460,seṭṭhattaṃ,setthattam,4,4,0,0,10
38461,vajatīti,vajatiti,11,8,3,0,8
38462,M0.0299,M0.0299,48,48,0,0,7
38463,tapokammaṃ,tapokammam,13,12,1,0,10
38464,monabbate,monabbate,1,1,0,0,9
38465,vācato,vacato,405,402,3,0,6
38466,yamatīti,yamatiti,1,1,0,0,8
38467,vācaṃyamo,vacamyamo,2,1,1,0,9
38468,monamassatthīti,monamassatthiti,1,1,0,0,15
38469,ossu,ossu,2,2,0,0,4
38470,ābhusopavāsanabrahmacariyādiyutte,abhusopavasanabrahmacariyadiyutte,1,1,0,0,33
38471,tapoyogā,tapoyoga,1,1,0,0,8
38472,tāpaso,tapaso,459,455,4,0,6
38473,ñāṇassa,nanassa,514,499,15,0,7
38474,saṃsārassa,samsarassa,100,96,4,0,10
38475,gamanato,gamanato,47,47,0,0,8
38476,pārikaṅkhīpyatra,parikankhipyatra,1,1,0,0,16
38477,pāramassatthīti,paramassatthiti,1,1,0,0,15
38478,pārī,pari,1,1,0,0,4
38479,brahmañāṇaṃ,brahmananam,1,1,0,0,11
38480,kaṅkhatīti,kankhatiti,42,21,21,0,10
38481,pārikaṅkhī,parikankhi,1,0,1,0,10
38482,para434,para434,68,68,0,0,7
38483,jitindriyagaṇe,jitindriyagane,1,1,0,0,14
38484,yatino,yatino,10,9,1,0,6
38485,vasino,vasino,23,14,9,0,6
38486,yataṃ,yatam,25,21,4,0,5
38487,indriyasaṃyamo,indriyasamyamo,1,1,0,0,14
38488,niccametesamatthīti,niccametesamatthiti,1,1,0,0,19
38489,yatayopi,yatayopi,2,2,0,0,8
38490,pāguṇye,pagunye,1,1,0,0,7
38491,yesamatthīti,yesamatthiti,1,1,0,0,12
38492,dhammasenāpatimhi,dhammasenapatimhi,4,4,0,0,17
38493,brāhmaṇī,brahmani,223,219,4,0,8
38494,sāriputto,sariputto,1075,1045,30,0,9
38495,tussantyasmiṃ,tussantyasmim,1,1,0,0,13
38496,atthasiddhitoti,atthasiddhitoti,1,1,0,0,15
38497,tussi,tussi,17,17,0,0,5
38498,upatisso,upatisso,71,67,4,0,8
38499,phusso,phusso,94,86,8,0,6
38500,daharakāle,daharakale,96,95,1,0,10
38501,yadicchāya,yadicchaya,20,19,1,0,10
38502,mātuvasena,matuvasena,1,1,0,0,10
38503,dhammasenāpatī,dhammasenapati,8,8,0,0,14
38504,ariyabhāvappatte,ariyabhavappatte,1,1,0,0,16
38505,sammāsambuddhena,sammasambuddhena,474,454,20,0,16
38506,kusaladhammāvudhehi,kusaladhammavudhehi,1,1,0,0,19
38507,kāmādikā,kamadika,1,1,0,0,8
38508,akusaladhammasenā,akusaladhammasena,1,1,0,0,17
38509,jitā,jita,34,32,2,0,4
38510,dhammasenā,dhammasena,2,2,0,0,10
38511,anekakoṭisatasahassasaṅkhyā,anekakotisatasahassasankhya,1,1,0,0,27
38512,sāvakasaṅghā,savakasangha,1,1,0,0,12
38513,nāyakaṭṭhena,nayakatthena,1,1,0,0,12
38514,dhammasenāpati,dhammasenapati,153,147,6,0,14
38515,para435,para435,64,64,0,0,7
38516,M0.0300,M0.0300,48,48,0,0,7
38517,vāmapassaṭṭhe,vamapassatthe,1,1,0,0,13
38518,mahāmoggallāne,mahamoggallane,3,3,0,0,14
38519,koliko,koliko,1,1,0,0,6
38520,kolito,kolito,54,53,1,0,6
38521,moggallibrāhmaṇiyā,moggallibrahmaniya,2,2,0,0,18
38522,moggallāno,moggallano,154,149,5,0,10
38523,ṇāno,nano,2,2,0,0,4
38524,ariyasāmaññe,ariyasamanne,1,1,0,0,12
38525,kilesārayo,kilesarayo,13,10,3,0,10
38526,araho,araho,37,35,2,0,5
38527,ariyo,ariyo,840,757,83,0,5
38528,maggaphaladhammeti,maggaphaladhammeti,1,1,0,0,18
38529,adhigacchitthāti,adhigacchitthati,1,1,0,0,16
38530,asekkhassa,asekkhassa,69,68,1,0,10
38531,gahitattā,gahitatta,532,524,8,0,9
38532,sotāpannādikā,sotapannadika,2,2,0,0,13
38533,etthādinā,etthadina,1,1,0,0,9
38534,chaḷeva,chaleva,43,40,3,0,7
38535,puggalā,puggala,1361,1313,48,0,7
38536,sotāpattimaggaṭṭhādayo,sotapattimaggatthadayo,1,1,0,0,22
38537,asekkhāti,asekkhati,8,7,1,0,9
38538,sikkhāhi,sikkhahi,12,12,0,0,8
38539,kāralopena,karalopena,3,3,0,0,10
38540,sekhā,sekha,105,94,11,0,5
38541,asekhā,asekha,19,17,2,0,6
38542,tipyatthi,tipyatthi,1,1,0,0,9
38543,anadhigate,anadhigate,27,27,0,0,10
38544,puthujjano,puthujjano,718,690,28,0,10
38545,nānākilese,nanakilese,1,1,0,0,10
38546,para436,para436,61,61,0,0,7
38547,aggaphale,aggaphale,50,50,0,0,9
38548,paṭhamamaggādīhi,pathamamaggadihi,8,8,0,0,16
38549,diṭṭhamariyādamanatikkamitvā,ditthamariyadamanatikkamitva,1,1,0,0,28
38550,jānitthāti,janitthati,3,3,0,0,10
38551,rūparāgādīnaṃ,ruparagadinam,2,2,0,0,13
38552,pañcuddhambhāgiyānaṃ,pancuddhambhagiyanam,1,1,0,0,20
38553,saṃyojanānaṃ,samyojananam,406,393,13,0,12
38554,odhivasena,odhivasena,2,2,0,0,10
38555,māraṇato,maranato,5,5,0,0,8
38556,māraṇatosananisānesu,maranatosananisanesu,2,1,1,0,20
38557,arahattaṃ,arahattam,2535,2470,65,0,9
38558,tto,tto,23,21,2,0,3
38559,bhāvotra,bhavotra,1,1,0,0,8
38560,abhidhānabuddhīnaṃ,abhidhanabuddhinam,3,3,0,0,18
38561,M0.0301,M0.0301,48,48,0,0,7
38562,byuppattipavattinimittavasena,byuppattipavattinimittavasena,1,1,0,0,29
38563,visesehi,visesehi,16,16,0,0,8
38564,kriyāpakatipaccayādīhi,kriyapakatipaccayadihi,1,1,0,0,22
38565,uppajjatīti,uppajjatiti,1646,1508,138,0,11
38566,ādisaddasarūpaṃ,adisaddasarupam,2,2,0,0,15
38567,byuppattinimittaṃ,byuppattinimittam,3,2,1,0,17
38568,kriyāpakatipaccayādayo,kriyapakatipaccayadayo,1,1,0,0,22
38569,kriyādayoyeva,kriyadayoyeva,1,1,0,0,13
38570,pavattayati,pavattayati,11,11,0,0,11
38571,payojayatīti,payojayatiti,5,5,0,0,12
38572,ādiko,adiko,10,10,0,0,5
38573,pavattinimittaṃ,pavattinimittam,28,25,3,0,15
38574,jātikriyāguṇadabbanāmāni,jatikriyagunadabbanamani,1,1,0,0,24
38575,saddasarūpuppattiyā,saddasarupuppattiya,1,1,0,0,19
38576,saddappayojanassa,saddappayojanassa,1,1,0,0,17
38577,lakkhaṇaviseso,lakkhanaviseso,2,2,0,0,14
38578,cetiye,cetiye,258,253,5,0,6
38579,cetitabbaṃ,cetitabbam,1,1,0,0,10
38580,pūjetabbanti,pujetabbanti,6,6,0,0,12
38581,thūpa,thupa,3,1,2,0,5
38582,samukhepi,samukhepi,1,1,0,0,9
38583,cetiya,cetiya,27,25,2,0,6
38584,mukharahiteyeva,mukharahiteyeva,1,1,0,0,15
38585,cetiyamāyatane,cetiyamayatane,1,1,0,0,14
38586,buddhabimbe,buddhabimbe,1,1,0,0,11
38587,coddissapādape,coddissapadape,1,1,0,0,14
38588,ānande,anande,41,41,0,0,6
38589,sukhadāyakato,sukhadayakato,1,1,0,0,13
38590,ṭhapanaṭṭhānaṃ,thapanatthanam,4,4,0,0,14
38591,tabbhāve,tabbhave,28,27,1,0,8
38592,dhammabhaṇḍāgāriko,dhammabhandagariko,21,18,3,0,18
38593,para437,para437,69,69,0,0,7
38594,visākhāyaṃ,visakhayam,1,1,0,0,10
38595,seṭṭhidhītari,setthidhitari,2,2,0,0,13
38596,puttanattapanattādikā,puttanattapanattadika,1,1,0,0,21
38597,migārassa,migarassa,1,1,0,0,9
38598,seṭṭhino,setthino,151,150,1,0,8
38599,mātuṭṭhāniyattā,matutthaniyatta,2,2,0,0,15
38600,migāramātā,migaramata,59,55,4,0,10
38601,anāthapiṇḍikaseṭṭhimhi,anathapindikasetthimhi,1,1,0,0,22
38602,sudatto,sudatto,48,45,3,0,7
38603,dānamassa,danamassa,4,3,1,0,9
38604,idamassa,idamassa,366,349,17,0,8
38605,M0.0302,M0.0302,47,47,0,0,7
38606,anāthapiṇḍiko,anathapindiko,192,184,8,0,13
38607,kriyānāmaṃ,kriyanamam,1,1,0,0,10
38608,para438-439,para438-439,1,1,0,0,11
38609,bhikkhuādayo,bhikkhuadayo,4,4,0,0,12
38610,sahadhammikā,sahadhammika,44,34,10,0,12
38611,pattādayo,pattadayo,1,1,0,0,9
38612,parikkhārā,parikkhara,59,53,6,0,10
38613,ukkaṭṭhavasena,ukkatthavasena,29,29,0,0,14
38614,majjhimavasena,majjhimavasena,1,1,0,0,14
38615,kattaradaṇḍopi,kattaradandopi,1,1,0,0,14
38616,telanāḷipīti,telanalipiti,1,1,0,0,12
38617,omakavasena,omakavasena,2,2,0,0,11
38618,chattampi,chattampi,7,7,0,0,9
38619,upāhanāpīti,upahanapiti,1,1,0,0,11
38620,para440,para440,64,64,0,0,7
38621,sāmaṇere,samanere,77,75,2,0,8
38622,samaṇassāpaccaṃ,samanassapaccam,1,1,0,0,15
38623,sāmaṇero,samanero,626,607,19,0,8
38624,samaṇaliṅgācārattā,samanalingacaratta,1,1,0,0,18
38625,samaṇoyaṃ,samanoyam,2,2,0,0,9
38626,uddisitabboti,uddisitabboti,2,2,0,0,13
38627,samaṇuddeso,samanuddeso,74,70,4,0,11
38628,acelake,acelake,5,5,0,0,7
38629,pakativatthametassa,pakativatthametassa,1,1,0,0,19
38630,digambaro,digambaro,4,2,2,0,9
38631,celaṃ,celam,14,11,3,0,5
38632,vatthametassa,vatthametassa,1,1,0,0,13
38633,ganthehi,ganthehi,26,25,1,0,8
38634,bandhanīyattā,bandhaniyatta,1,1,0,0,13
38635,nigantho,nigantho,1,0,1,0,8
38636,M0.0303,M0.0303,48,48,0,0,7
38637,jaṭāvati,jatavati,1,1,0,0,8
38638,jaṭaṃ,jatam,76,68,8,0,5
38639,jaṭilo,jatilo,134,128,6,0,6
38640,jaṭādharo,jatadharo,6,5,1,0,9
38641,para441,para441,63,63,0,0,7
38642,kuṭisakādikā,kutisakadika,1,1,0,0,12
38643,catuttiṃsa,catuttimsa,58,53,5,0,10
38644,laddhiyo,laddhiyo,8,8,0,0,8
38645,parasamayānamāgamato,parasamayanamagamato,1,1,0,0,20
38646,dvāsaṭṭhi,dvasatthi,152,134,18,0,9
38647,diṭṭhiyo,ditthiyo,321,301,20,0,8
38648,brahmajālasuttantato,brahmajalasuttantato,1,1,0,0,20
38649,parisamāpanattho,parisamapanattho,13,13,0,0,16
38650,eteti,eteti,70,19,51,0,5
38651,nidassanattho,nidassanattho,28,27,1,0,13
38652,channavutiladdhiyo,channavutiladdhiyo,1,1,0,0,18
38653,taṇhāpāsaṃ,tanhapasam,5,5,0,0,10
38654,diṭṭhipāsañca,ditthipasanca,6,6,0,0,13
38655,ḍenti,denti,12,12,0,0,5
38656,pavattentīti,pavattentiti,20,18,2,0,12
38657,pāsaṇḍāti,pasandati,4,0,4,0,9
38658,sampakāsitā,sampakasita,2,1,1,0,11
38659,channavuti,channavuti,30,30,0,0,10
38660,para442,para442,58,58,0,0,7
38661,sucimhi,sucimhi,4,4,0,0,7
38662,timhā,timha,2,2,0,0,5
38663,dantakaṭṭhe,dantakatthe,3,3,0,0,11
38664,dantapono,dantapono,2,1,1,0,9
38665,dantapoṇopi,dantaponopi,1,1,0,0,11
38666,dantasodhanatthaṃ,dantasodhanattham,1,1,0,0,17
38667,dantakaṭṭhaṃ,dantakattham,130,119,11,0,12
38668,rukkhattace,rukkhattace,2,2,0,0,11
38669,vakka,vakka,9,0,9,0,5
38670,tace,tace,19,18,1,0,4
38671,para443,para443,66,66,0,0,7
38672,bhājanasāmaññe,bhajanasamanne,3,3,0,0,14
38673,M0.0304,M0.0304,48,48,0,0,7
38674,kuṇḍikāyaṃ,kundikayam,6,2,4,0,10
38675,jalassa,jalassa,10,10,0,0,7
38676,maṇḍo,mando,63,60,3,0,5
38677,pasannabhāvo,pasannabhavo,5,3,2,0,12
38678,kamaṇḍo,kamando,1,1,0,0,7
38679,kamaṇḍalu,kamandalu,10,9,1,0,9
38680,kattarassa,kattarassa,3,3,0,0,10
38681,jiṇṇassa,jinnassa,48,46,2,0,8
38682,ālambanayaṭṭhi,alambanayatthi,1,1,0,0,14
38683,para444,para444,72,72,0,0,7
38684,brahmacariyakammaṃ,brahmacariyakammam,1,1,0,0,18
38685,yāvajīvamavassambhāvena,yavajivamavassambhavena,1,1,0,0,23
38686,dehasādhanāpekkhaṃ,dehasadhanapekkham,4,3,1,0,18
38687,sarīreneva,sarireneva,6,5,1,0,10
38688,sādhanamapekkhate,sadhanamapekkhate,2,2,0,0,17
38689,bāhirena,bahirena,11,10,1,0,8
38690,sādhanaṃ,sadhanam,59,56,3,0,8
38691,sarīrasādhanāpekkhaniccakammamaye,sarirasadhanapekkhaniccakammamaye,1,1,0,0,33
38692,saṃyame,samyame,20,17,3,0,7
38693,yamarāje,yamaraje,2,2,0,0,8
38694,panāgantunā,panagantuna,1,1,0,0,11
38695,sukkapakkhādivasena,sukkapakkhadivasena,1,1,0,0,19
38696,niyamitakālamupavāsādikaṃ,niyamitakalamupavasadikam,1,1,0,0,25
38697,kālādivasena,kaladivasena,9,9,0,0,12
38698,niyamitabboti,niyamitabboti,1,1,0,0,13
38699,brāhmaṇavaggavaṇṇanā,brahmanavaggavannana,6,6,0,0,20
38700,para445,para445,65,65,0,0,7
38701,vesse,vesse,15,15,0,0,5
38702,iyāna,iyana,1,0,1,0,5
38703,vesiyāno,vesiyano,2,1,1,0,8
38704,ūrujo,urujo,1,1,0,0,5
38705,ariyopyatra,ariyopyatra,1,1,0,0,11
38706,M0.0305,M0.0305,46,46,0,0,7
38707,kasiādijīvikāyaṃ,kasiadijivikayam,1,1,0,0,16
38708,karaṇetyeke,karanetyeke,1,1,0,0,11
38709,ṇvumhi,nvumhi,5,3,2,0,6
38710,jīvikā,jivika,49,46,3,0,6
38711,vuttīnaṃ,vuttinam,2,2,0,0,8
38712,sarūpappakāre,sarupappakare,1,1,0,0,13
38713,kasikamme,kasikamme,4,4,0,0,9
38714,kasanaṃ,kasanam,6,6,0,0,7
38715,kasikammaṃ,kasikammam,24,21,3,0,10
38716,para446,para446,64,64,0,0,7
38717,vāṇijje,vanijje,1,1,0,0,7
38718,vaṇijānaṃ,vanijanam,3,3,0,0,9
38719,vāṇijjaṃ,vanijjam,24,22,2,0,8
38720,vaṇijjā,vanijja,45,40,5,0,7
38721,pasuposane,pasuposane,1,1,0,0,10
38722,rakkhā,rakkha,95,90,5,0,6
38723,gorakkhā,gorakkha,7,6,1,0,8
38724,gomahiṃsādikānaṃ,gomahimsadikanam,1,1,0,0,16
38725,pālanaṃ,palanam,15,12,3,0,7
38726,posanaṃ,posanam,14,11,3,0,7
38727,cikicchādi,cikicchadi,1,1,0,0,10
38728,pasupālanaṃ,pasupalanam,2,2,0,0,11
38729,vuttappakārā,vuttappakara,99,97,2,0,12
38730,vessassa,vessassa,18,18,0,0,8
38731,vuttikāraṇā,vuttikarana,1,1,0,0,11
38732,kasikammādippakārena,kasikammadippakarena,1,1,0,0,20
38733,gihimhi,gihimhi,1,1,0,0,7
38734,gahe,gahe,14,13,1,0,4
38735,pañcakāmaguṇe,pancakamagune,14,11,3,0,13
38736,bhavavasena,bhavavasena,28,24,4,0,11
38737,agāre,agare,67,64,3,0,5
38738,agāriko,agariko,15,12,3,0,7
38739,gahametassatthīti,gahametassatthiti,1,1,0,0,17
38740,para447,para447,62,62,0,0,7
38741,kasibale,kasibale,1,1,0,0,8
38742,khettenājīvati,khettenajivati,1,1,0,0,14
38743,kasatīti,kasatiti,9,7,2,0,8
38744,kassako,kassako,92,86,6,0,7
38745,khette,khette,185,179,6,0,6
38746,khipantyasminti,khipantyasminti,1,1,0,0,15
38747,tāyatītipi,tayatitipi,1,1,0,0,10
38748,khetraṃ,khetram,1,0,1,0,7
38749,kleda,kleda,2,1,1,0,5
38750,klida,klida,1,0,1,0,5
38751,allabhāve,allabhave,1,1,0,0,9
38752,kledīyatīti,klediyatiti,1,1,0,0,11
38753,kedāraṃ,kedaram,17,14,3,0,7
38754,vidāraṇamassāti,vidaranamassati,2,2,0,0,15
38755,vāpopyatra,vapopyatra,1,1,0,0,10
38756,vappate,vappate,3,3,0,0,7
38757,M0.0306,M0.0306,46,46,0,0,7
38758,mattikākhaṇḍe,mattikakhande,1,1,0,0,13
38759,leḍḍa,ledda,1,0,1,0,5
38760,leḍḍu,leddu,23,20,3,0,5
38761,leḍḍavo,leddavo,1,1,0,0,7
38762,khaṇittiyaṃ,khanittiyam,1,1,0,0,11
38763,khaññate,khannate,1,1,0,0,8
38764,khaṇitti,khanitti,6,5,1,0,8
38765,avadārīyate,avadariyate,1,1,0,0,11
38766,avadāraṇaṃ,avadaranam,1,0,1,0,10
38767,para448,para448,61,61,0,0,7
38768,dātte,datte,2,2,0,0,5
38769,lunantyanenāti,lunantyanenati,1,1,0,0,14
38770,dāttaṃ,dattam,8,7,1,0,6
38771,dātrampi,datrampi,1,1,0,0,8
38772,lavittaṃ,lavittam,2,1,1,0,8
38773,asitaṃ,asitam,59,42,17,0,6
38774,pājanadaṇḍe,pajanadande,1,1,0,0,11
38775,patodo,patodo,52,47,5,0,6
38776,pājanaṃ,pajanam,7,2,5,0,7
38777,vaṇṇavikāre,vannavikare,2,2,0,0,11
38778,pācanaṃ,pacanam,14,11,3,0,7
38779,todanaṃpyatra,todanampyatra,1,1,0,0,13
38780,rajjuyaṃ,rajjuyam,3,3,0,0,8
38781,pararūpattañca,pararupattanca,1,1,0,0,14
38782,rajju,rajju,40,37,3,0,5
38783,ābandhopyatra,abandhopyatra,1,1,0,0,13
38784,phāle,phale,14,14,0,0,5
38785,phālayati,phalayati,1,1,0,0,9
38786,kasako,kasako,2,1,1,0,6
38787,phālakasakā,phalakasaka,1,1,0,0,11
38788,nirīsaṃ,nirisam,2,1,1,0,7
38789,kūṭakaṃ,kutakam,2,1,1,0,7
38790,halampi,halampi,1,1,0,0,7
38791,īsāya,isaya,10,10,0,0,5
38792,para449,para449,60,60,0,0,7
38793,naṅgale,nangale,4,4,0,0,7
38794,bhūmīnaṅga,bhuminanga,1,1,0,0,10
38795,manaṅgaṃ,manangam,1,1,0,0,8
38796,lunātīti,lunatiti,27,24,3,0,8
38797,naṅgalaṃ,nangalam,25,21,4,0,8
38798,sīro,siro,4,3,1,0,4
38799,tikkhakare,tikkhakare,1,1,0,0,10
38800,hale,hale,1,1,0,0,4
38801,M0.0307,M0.0307,47,47,0,0,7
38802,godāraṇaṃpyatra,godaranampyatra,1,1,0,0,15
38803,naṅgalassa,nangalassa,8,8,0,0,10
38804,daṇḍake,dandake,30,29,1,0,7
38805,īsā,isa,19,16,3,0,3
38806,pabhumhi,pabhumhi,3,2,1,0,8
38807,saṅkare,sankare,4,4,0,0,7
38808,naṅgaladaṇḍake,nangaladandake,1,1,0,0,14
38809,yugakīlake,yugakilake,1,1,0,0,10
38810,samane,samane,1,1,0,0,6
38811,halapaddhati,halapaddhati,2,1,1,0,12
38812,naṅgalalekhā,nangalalekha,3,3,0,0,12
38813,divagaṅgā,divaganga,1,1,0,0,9
38814,jānakī,janaki,1,1,0,0,6
38815,para450-451,para450-451,1,1,0,0,11
38816,muggādike,muggadike,2,2,0,0,9
38817,dhaññavisese,dhannavisese,3,3,0,0,12
38818,aparanna,aparanna,1,0,1,0,8
38819,pubbannato,pubbannato,1,1,0,0,10
38820,aparannaṃ,aparannam,3,2,1,0,9
38821,aparaṇṇa,aparanna,1,0,1,0,8
38822,sāliādike,saliadike,2,2,0,0,9
38823,pubbanna,pubbanna,1,0,1,0,8
38824,aparannassa,aparannassa,1,1,0,0,11
38825,pubbannaṃ,pubbannam,3,2,1,0,9
38826,pubbaṇṇa,pubbanna,1,0,1,0,8
38827,pubbāparattañca,pubbaparattanca,1,1,0,0,15
38828,ādikappe,adikappe,4,4,0,0,8
38829,sambhavāsambhavavasena,sambhavasambhavavasena,2,2,0,0,22
38830,sālyādayo,salyadayo,1,1,0,0,9
38831,dhaññāni,dhannani,52,46,6,0,8
38832,dhānaṃ,dhanam,5,5,0,0,6
38833,sādhūni,sadhuni,9,8,1,0,7
38834,kalamā,kalama,1,1,0,0,6
38835,rattasāli,rattasali,1,1,0,0,9
38836,mahāsālisaṭṭhikappabhutayo,mahasalisatthikappabhutayo,1,1,0,0,26
38837,sūkadhaññavisesā,sukadhannavisesa,1,1,0,0,16
38838,sālayo,salayo,31,30,1,0,6
38839,saṭṭhidināni,satthidinani,1,1,0,0,12
38840,paripākamassa,paripakamassa,1,1,0,0,13
38841,saṭṭhiko,satthiko,3,2,1,0,8
38842,brūheti,bruheti,16,16,0,0,7
38843,vīhi,vihi,42,38,4,0,4
38844,brūha,bruha,4,2,2,0,5
38845,vuḍḍhiyañca,vuddhiyanca,1,1,0,0,11
38846,M0.0308,M0.0308,44,44,0,0,7
38847,koraṃ,koram,3,3,0,0,5
38848,dūsatīti,dusatiti,2,2,0,0,8
38849,kudrūso,kudruso,7,5,2,0,7
38850,govaḍḍhano,govaddhano,2,2,0,0,10
38851,gudha,gudha,7,3,4,0,5
38852,parivedhane,parivedhane,2,2,0,0,11
38853,godhumo,godhumo,17,15,2,0,7
38854,godhūmasumano,godhumasumano,1,1,0,0,13
38855,pāvaṭo,pavato,1,1,0,0,6
38856,yavo,yavo,31,28,3,0,4
38857,varako,varako,27,21,6,0,6
38858,kaṅgu,kangu,28,23,5,0,5
38859,atisukhumasasse,atisukhumasasse,1,1,0,0,15
38860,sobhanasīsattā,sobhanasisatta,2,2,0,0,14
38861,kamanīyabhāvaṃ,kamaniyabhavam,4,4,0,0,14
38862,sāmā,sama,81,72,9,0,4
38863,piyaṅgu,piyangu,14,11,3,0,7
38864,dhaññānaṃ,dhannanam,60,55,5,0,9
38865,nīvārādayo,nivaradayo,1,1,0,0,10
38866,nīvārāni,nivarani,1,1,0,0,8
38867,tiṇadhaññāni,tinadhannani,1,1,0,0,12
38868,sāmākādayo,samakadayo,3,3,0,0,10
38869,kaḷāye,kalaye,4,4,0,0,6
38870,caṇa,cana,3,1,2,0,4
38871,caṇako,canako,2,1,1,0,6
38872,harimanthakepi,harimanthakepi,1,1,0,0,14
38873,kaḷāyo,kalayo,4,3,1,0,6
38874,kalāyampi,kalayampi,1,1,0,0,9
38875,sāsapasāmaññe,sasapasamanne,1,1,0,0,13
38876,sarisapo,sarisapo,1,1,0,0,8
38877,kaṭusneho,katusneho,1,1,0,0,9
38878,tantubho,tantubho,1,1,0,0,8
38879,suddhodanasute,suddhodanasute,1,1,0,0,14
38880,setasāsape,setasasape,1,1,0,0,10
38881,anusiṭṭhiyaṃ,anusitthiyam,12,11,1,0,12
38882,sāsapassāpi,sasapassapi,1,1,0,0,11
38883,vīhibhedattā,vihibhedatta,1,1,0,0,12
38884,para452,para452,65,65,0,0,7
38885,kaṅguyaṃ,kanguyam,1,1,0,0,8
38886,piyabhāvaṃ,piyabhavam,28,28,0,0,10
38887,atasiyaṃ,atasiyam,1,1,0,0,8
38888,avassu,avassu,1,1,0,0,6
38889,ummā,umma,6,4,2,0,4
38890,khumāpyatra,khumapyatra,1,1,0,0,11
38891,sasse,sasse,32,31,1,0,5
38892,kasito,kasito,2,2,0,0,6
38893,kiṭṭhaṃ,kittham,20,16,4,0,7
38894,kiṭṭhaṭṭhāne,kitthatthane,5,4,1,0,12
38895,uppannasassañhi,uppannasassanhi,2,2,0,0,15
38896,gatihiṃsāpāpuṇanesu,gatihimsapapunanesu,1,1,0,0,19
38897,thambo,thambo,4,3,1,0,6
38898,thambakari,thambakari,1,0,1,0,10
38899,dhaññaṃpyatra,dhannampyatra,1,1,0,0,13
38900,vīhīsu,vihisu,3,3,0,0,6
38901,dhaññake,dhannake,1,1,0,0,8
38902,puññavatīrito,punnavatirito,1,1,0,0,13
38903,dhaññā,dhanna,16,15,1,0,6
38904,vātāmalakīsū,vatamalakisu,1,1,0,0,12
38905,para453,para453,75,75,0,0,7
38906,M0.0309,M0.0309,45,45,0,0,7
38907,sassādīnaṃ,sassadinam,6,6,0,0,10
38908,kaṇḍamatte,kandamatte,1,1,0,0,10
38909,nala,nala,6,0,6,0,4
38910,ganthe,ganthe,115,106,9,0,6
38911,nālaṃ,nalam,291,250,41,0,5
38912,nāḷipi,nalipi,1,1,0,0,6
38913,sassādikaṇḍo,sassadikando,1,1,0,0,12
38914,nipphalo,nipphalo,12,12,0,0,8
38915,palāla,palala,1,0,1,0,6
38916,lavanapavanesu,lavanapavanesu,2,1,1,0,14
38917,palālopi,palalopi,1,1,0,0,8
38918,asāre,asare,23,21,2,0,5
38919,tucchadhaññe,tucchadhanne,1,1,0,0,12
38920,atisayepi,atisayepi,1,1,0,0,9
38921,thusampi,thusampi,1,1,0,0,8
38922,tusa,tusa,12,2,10,0,4
38923,ussagge,ussagge,6,4,2,0,7
38924,iṅgatīti,ingatiti,2,2,0,0,8
38925,kaliṅgaro,kalingaro,12,11,1,0,9
38926,dhaññānameva,dhannanameva,1,1,0,0,12
38927,vakkale,vakkale,5,4,1,0,7
38928,thuso,thuso,9,5,4,0,5
38929,tuṭṭhimhi,tutthimhi,2,2,0,0,9
38930,dhaññattace,dhannattace,2,2,0,0,11
38931,para454,para454,78,78,0,0,7
38932,sassaroge,sassaroge,1,1,0,0,9
38933,setavaṇṇakaraṇavasena,setavannakaranavasena,1,1,0,0,21
38934,setaṭṭikā,setattika,8,7,1,0,9
38935,setaṭṭhikā,setatthika,16,12,4,0,10
38936,taṇḍulakaṇe,tandulakane,1,1,0,0,11
38937,nimīlane,nimilane,6,4,2,0,8
38938,nimīlanasaddagatīsu,nimilanasaddagatisu,1,1,0,0,19
38939,kaṇo,kano,10,5,5,0,4
38940,dhaññamaddanabhūmiyaṃ,dhannamaddanabhumiyam,1,1,0,0,21
38941,maddanti,maddanti,42,40,2,0,8
38942,dhaññakaraṇaṃ,dhannakaranam,13,6,7,0,13
38943,tiṇādīnaṃ,tinadinam,13,12,1,0,9
38944,sassānañca,sassananca,1,1,0,0,10
38945,thamba,thamba,2,0,2,0,6
38946,paṭibandhe,patibandhe,1,1,0,0,10
38947,para455,para455,75,75,0,0,7
38948,M0.0310,M0.0310,44,44,0,0,7
38949,musale,musale,8,6,2,0,6
38950,aggekoṭiyaṃ,aggekotiyam,1,1,0,0,11
38951,ayoggaṃ,ayoggam,2,1,1,0,7
38952,musa,musa,11,2,9,0,4
38953,suppe,suppe,2,2,0,0,5
38954,lunātyapanetīti,lunatyapanetiti,1,1,0,0,15
38955,saratyaneneti,saratyaneneti,1,1,0,0,13
38956,suppaṃ,suppam,17,14,3,0,6
38957,papphoṭanaṃpyatra,papphotanampyatra,1,1,0,0,17
38958,uddhane,uddhane,44,43,1,0,7
38959,thālyādikamasminti,thalyadikamasminti,1,1,0,0,18
38960,uddhanaṃ,uddhanam,39,34,5,0,8
38961,uddhānampi,uddhanampi,1,1,0,0,10
38962,culla,culla,5,3,2,0,5
38963,cullī,culli,2,1,1,0,5
38964,adhisayanī,adhisayani,1,1,0,0,10
38965,antikāpyatra,antikapyatra,1,1,0,0,12
38966,antyate,antyate,1,1,0,0,7
38967,bhikkhādikamassanti,bhikkhadikamassanti,1,1,0,0,19
38968,antikā,antika,2,1,1,0,6
38969,sannidhāne,sannidhane,9,8,1,0,10
38970,kāsādiracito,kasadiracito,1,1,0,0,12
38971,kaṭo,kato,65,64,1,0,4
38972,marāvo,maravo,3,3,0,0,6
38973,bandhīyate,bandhiyate,4,4,0,0,10
38974,vīhyagāraṃ,vihyagaram,1,1,0,0,10
38975,kusūlo,kusulo,13,12,1,0,6
38976,vīhyagārañca,vihyagaranca,1,1,0,0,12
38977,kantaro,kantaro,1,1,0,0,7
38978,marāvako,maravako,1,1,0,0,8
38979,marāvameva,maravameva,1,1,0,0,10
38980,kaṭamāhu,katamahu,1,1,0,0,8
38981,kilañjo,kilanjo,4,3,1,0,7
38982,pādanāma,padanama,1,0,1,0,8
38983,pakaraṇe,pakarane,234,231,3,0,8
38984,kila,kila,6,3,3,0,4
38985,kilanaṃ,kilanam,1,1,0,0,7
38986,kilo,kilo,4,4,0,0,4
38987,para456,para456,67,67,0,0,7
38988,thāliyaṃ,thaliyam,13,13,0,0,8
38989,kumbhī,kumbhi,30,23,7,0,6
38990,kuyā,kuya,10,10,0,0,4
38991,agginā,aggina,278,275,3,0,6
38992,bhaṇatīti,bhanatiti,53,33,20,0,9
38993,bhaṇa,bhana,53,45,8,0,5
38994,M0.0311,M0.0311,44,44,0,0,7
38995,umbhīyati,umbhiyati,2,2,0,0,9
38996,pūrīyatīti,puriyatiti,2,2,0,0,10
38997,ubbha,ubbha,5,1,4,0,5
38998,piṭha,pitha,2,0,2,0,5
38999,ukhā,ukha,3,2,1,0,4
39000,thāli,thali,3,2,1,0,5
39001,thālī,thali,4,3,1,0,5
39002,lapatīti,lapatiti,4,4,0,0,8
39003,kolambo,kolambo,5,1,4,0,7
39004,olambatīti,olambatiti,1,1,0,0,10
39005,maṇiyeva,maniyeva,2,2,0,0,8
39006,maṇikaṃ,manikam,13,8,5,0,7
39007,arañjaro,aranjaro,15,11,4,0,8
39008,para457,para457,71,71,0,0,7
39009,ghaṭe,ghate,79,77,2,0,5
39010,nadādimhi,nadadimhi,1,1,0,0,9
39011,ghaṭī,ghati,8,8,0,0,5
39012,silissatīti,silissatiti,4,4,0,0,11
39013,kalaso,kalaso,4,2,2,0,6
39014,vāraṇasambhattīsu,varanasambhattisu,1,1,0,0,17
39015,kalasa,kalasa,3,2,1,0,6
39016,vārako,varako,4,2,2,0,6
39017,bhuñjitabbanti,bhunjitabbanti,32,32,0,0,14
39018,bhuñjanaṃ,bhunjanam,29,27,2,0,9
39019,bhājanaṃ,bhajanam,240,221,19,0,8
39020,suvaṇṇarajatādinimmitampi,suvannarajatadinimmitampi,1,1,0,0,25
39021,kaṃso,kamso,46,33,13,0,5
39022,racchantare,racchantare,1,1,0,0,11
39023,tejasepi,tejasepi,1,1,0,0,8
39024,pānapatte,panapatte,2,2,0,0,9
39025,kaṃsye,kamsye,1,1,0,0,6
39026,sobhikkhāsu,sobhikkhasu,1,1,0,0,11
39027,kittisū,kittisu,1,1,0,0,7
39028,jayena,jayena,2,1,1,0,6
39029,pānapattepi,panapattepi,1,1,0,0,11
39030,amattaṃ,amattam,2,2,0,0,7
39031,bhāja,bhaja,6,1,5,0,5
39032,puthakammani,puthakammani,2,1,1,0,12
39033,para458,para458,69,69,0,0,7
39034,M0.0312,M0.0312,45,45,0,0,7
39035,bhājanādīnamādhāre,bhajanadinamadhare,1,1,0,0,18
39036,samīpamādheyyassa,samipamadheyyassa,1,1,0,0,17
39037,upagacchatīti,upagacchatiti,69,54,15,0,13
39038,aṇḍupakaṃ,andupakam,5,3,2,0,9
39039,nta,nta,68,60,8,0,3
39040,cumba,cumba,2,1,1,0,5
39041,vadanasaṃyoge,vadanasamyoge,4,3,1,0,13
39042,sarāve,sarave,3,2,1,0,6
39043,sarāvo,saravo,5,4,1,0,6
39044,vaḍḍhamānakopyatra,vaddhamanakopyatra,1,1,0,0,18
39045,vitthiṇṇī,vitthinni,1,1,0,0,9
39046,vaḍḍhamānako,vaddhamanako,2,1,1,0,12
39047,bhelabyañjanādighaṭṭanopayuttabhaṇḍe,bhelabyanjanadighattanopayuttabhande,1,1,0,0,36
39048,chu,chu,3,2,1,0,3
39049,dabbī,dabbi,9,7,2,0,5
39050,rasse,rasse,46,45,1,0,5
39051,dabbi,dabbi,8,7,1,0,5
39052,khajākāpi,khajakapi,1,1,0,0,9
39053,khaja,khaja,5,2,3,0,5
39054,manthane,manthane,2,2,0,0,8
39055,khajākā,khajaka,1,0,1,0,7
39056,dhaññādinilaye,dhannadinilaye,1,1,0,0,14
39057,ūlo,ulo,2,2,0,0,3
39058,para459,para459,67,67,0,0,7
39059,māsādisākamatte,masadisakamatte,1,1,0,0,15
39060,ḍaṃsa,damsa,7,4,3,0,5
39061,siggu,siggu,10,8,2,0,5
39062,haritakampi,haritakampi,1,1,0,0,11
39063,haritā,harita,23,22,1,0,6
39064,sākamattasmiṃ,sakamattasmim,1,1,0,0,13
39065,sobhañjanepi,sobhanjanepi,1,1,0,0,12
39066,addake,addake,1,1,0,0,6
39067,āddāyaṃ,addayam,1,1,0,0,7
39068,addakaṃ,addakam,2,1,1,0,7
39069,siṅgamiva,singamiva,1,1,0,0,9
39070,siṅgiveraṃ,singiveram,14,13,1,0,10
39071,sukkhaṃ,sukkham,50,47,3,0,7
39072,mahosadhādhyaṃ,mahosadhadhyam,1,1,0,0,14
39073,tikkharasattā,tikkharasatta,1,1,0,0,13
39074,suṇṭhī,sunthi,2,1,1,0,6
39075,nāgaraṃ,nagaram,1,1,0,0,7
39076,visaṃ,visam,444,408,36,0,5
39077,visabhesajjampi,visabhesajjampi,1,1,0,0,15
39078,suṭhi,suthi,3,0,3,0,5
39079,suṇṭhi,sunthi,1,0,1,0,6
39080,M0.0313,M0.0313,45,45,0,0,7
39081,marīce,marice,1,1,0,0,6
39082,marīcaṃ,maricam,3,3,0,0,7
39083,kolakaṃ,kolakam,4,4,0,0,7
39084,usanaṃ,usanam,1,1,0,0,6
39085,dhammapattana,dhammapattana,1,1,0,0,13
39086,marasīho,marasiho,8,0,8,0,8
39087,para460,para460,59,59,0,0,7
39088,tipādaṃ,tipadam,8,8,0,0,7
39089,kañjike,kanjike,2,2,0,0,7
39090,suvīraraṭṭhe,suviraratthe,1,1,0,0,12
39091,sovīraṃ,soviram,4,3,1,0,7
39092,añjiyamabhibyattaṃ,anjiyamabhibyattam,1,1,0,0,18
39093,kañjiyaṃ,kanjiyam,21,18,3,0,8
39094,ārānaṃ,aranam,1,1,0,0,6
39095,bhūmyakkajānaṃ,bhumyakkajanam,1,1,0,0,14
39096,vāresu,varesu,133,131,2,0,6
39097,gahitena,gahitena,32,30,2,0,8
39098,nārena,narena,1,1,0,0,6
39099,āranāḷaṃ,aranalam,3,2,1,0,8
39100,kkhiti,kkhiti,1,1,0,0,6
39101,sute,sute,112,90,22,0,4
39102,kkaje,kkaje,1,1,0,0,5
39103,nāro,naro,1,1,0,0,4
39104,taṇḍulanīresū,tandulaniresu,1,1,0,0,13
39105,thusato,thusato,1,1,0,0,7
39106,jātamudakaṃ,jatamudakam,1,1,0,0,11
39107,thusodakaṃ,thusodakam,21,14,7,0,10
39108,thusodakato,thusodakato,1,1,0,0,11
39109,dhaññato,dhannato,1,1,0,0,8
39110,vīhito,vihito,2,2,0,0,6
39111,ambilaṃ,ambilam,43,38,5,0,7
39112,dhaññambilaṃ,dhannambilam,2,1,1,0,12
39113,laṅkati,lankati,1,1,0,0,7
39114,bilaṅko,bilanko,2,0,2,0,7
39115,bi,bi,4,3,1,0,2
39116,laṅkatīti,lankatiti,1,1,0,0,9
39117,kummāso,kummaso,44,38,6,0,7
39118,abhisutaṃ,abhisutam,1,1,0,0,9
39119,avantisomaṃ,avantisomam,1,1,0,0,11
39120,kuñjalaṃ,kunjalam,1,1,0,0,8
39121,kañjikaṃ,kanjikam,28,19,9,0,8
39122,jeṭṭhambu,jetthambu,1,1,0,0,9
39123,khadikāpyatra,khadikapyatra,1,1,0,0,13
39124,lavaṇamatte,lavanamatte,1,1,0,0,11
39125,navādese,navadese,1,1,0,0,8
39126,loṇaṃ,lonam,83,77,6,0,5
39127,para461,para461,60,60,0,0,7
39128,sāmuddādayo,samuddadayo,1,1,0,0,11
39129,lavaṇassa,lavanassa,3,3,0,0,9
39130,pabhedā,pabheda,27,24,3,0,7
39131,samuddabhūmiyamavaṭṭhitaṃ,samuddabhumiyamavatthitam,1,1,0,0,25
39132,loṇodakaṃ,lonodakam,3,3,0,0,9
39133,sukkhasantanaṃ,sukkhasantanam,1,1,0,0,14
39134,sāmudda,samudda,1,0,1,0,7
39135,lavaṇaṃ,lavanam,22,22,0,0,7
39136,akkhivaṃ,akkhivam,1,1,0,0,8
39137,vasirampi,vasirampi,1,1,0,0,9
39138,sindhudese,sindhudese,1,1,0,0,10
39139,sitasivaṃ,sitasivam,1,1,0,0,9
39140,sītasivaṃ,sitasivam,1,1,0,0,9
39141,sakkate,sakkate,21,20,1,0,7
39142,māṇimanthaṃ,manimantham,1,1,0,0,11
39143,sindhujampi,sindhujampi,1,1,0,0,11
39144,kammadhārayasamāso,kammadharayasamaso,20,20,0,0,18
39145,M0.0314,M0.0314,44,44,0,0,7
39146,sitasivanti,sitasivanti,1,1,0,0,11
39147,maṇimantho,manimantho,1,1,0,0,10
39148,kāḷaloṇo,kalalono,1,0,1,0,8
39149,sovaccalavaṇānaṃ,sovaccalavananam,1,1,0,0,16
39150,madhuralavaṇassalavaṇabhedassa,madhuralavanassalavanabhedassa,1,1,0,0,30
39151,mahesvaraṭīkā,mahesvaratika,1,1,0,0,13
39152,tilakaṃ,tilakam,15,10,5,0,7
39153,mecake,mecake,2,2,0,0,6
39154,madaṃ,madam,60,58,2,0,5
39155,visodarādi,visodaradi,1,1,0,0,10
39156,tilakampi,tilakampi,1,1,0,0,9
39157,ubbhidaṃ,ubbhidam,21,9,12,0,8
39158,romakalavaṇaṃ,romakalavanam,1,1,0,0,13
39159,sambharidese,sambharidese,1,1,0,0,12
39160,rumā,ruma,1,1,0,0,4
39161,lavaṇākaro,lavanakaro,1,1,0,0,10
39162,paviṭṭhaṃ,pavittham,211,197,14,0,9
39163,kaṭṭhampi,katthampi,1,1,0,0,9
39164,acirena,acirena,5,5,0,0,7
39165,vilīya,viliya,1,1,0,0,6
39166,romalavaṇaṃ,romalavanam,1,1,0,0,11
39167,vasukampi,vasukampi,1,1,0,0,9
39168,kaṭṭhādīnaṃ,katthadinam,4,4,0,0,11
39169,sabhāvavijahanakarattā,sabhavavijahanakaratta,1,1,0,0,22
39170,sakyatthe,sakyatthe,1,1,0,0,9
39171,bilālaṃ,bilalam,7,3,4,0,7
39172,samuddatīrāsannadesabhavaṃ,samuddatirasannadesabhavam,1,1,0,0,26
39173,mattikaṃ,mattikam,120,111,9,0,8
39174,pācayitvā,pacayitva,2,2,0,0,9
39175,nipphāditalavaṇaṃ,nipphaditalavanam,3,3,0,0,17
39176,samuddavelāsannadese,samuddavelasannadese,1,1,0,0,20
39177,essittaṃ,essittam,2,2,0,0,8
39178,padese,padese,658,652,6,0,6
39179,lavaṇamattikaṃ,lavanamattikam,1,1,0,0,14
39180,lavaṇabhūmiṃ,lavanabhumim,1,1,0,0,12
39181,vidārayitvā,vidarayitva,2,2,0,0,11
39182,pākyaṃ,pakyam,1,1,0,0,6
39183,vaccagandhaṃ,vaccagandham,1,1,0,0,12
39184,kāḷalavaṇaṃ,kalalavanam,1,1,0,0,11
39185,para462,para462,59,59,0,0,7
39186,guḷādayo,guladayo,6,4,2,0,8
39187,ucchuno,ucchuno,2,2,0,0,7
39188,vikārā,vikara,16,16,0,0,6
39189,guḷa,gula,8,5,3,0,4
39190,rakkhāyaṃ,rakkhayam,2,1,1,0,9
39191,guḷo,gulo,59,53,6,0,4
39192,pakkaraso,pakkaraso,2,2,0,0,9
39193,phāṇa,phana,1,0,1,0,5
39194,phāṇitaṃ,phanitam,175,149,26,0,8
39195,guḷato,gulato,2,2,0,0,6
39196,thaddhaṃ,thaddham,62,54,8,0,8
39197,manthe,manthe,3,1,2,0,6
39198,khaṇḍo,khando,33,29,4,0,6
39199,phāṇitatopi,phanitatopi,1,1,0,0,11
39200,ucchuvisesassa,ucchuvisesassa,1,1,0,0,14
39201,rasapāke,rasapake,1,1,0,0,8
39202,khaṇḍayogyasārabhūte,khandayogyasarabhute,1,1,0,0,20
39203,guḷikākārā,gulikakara,1,1,0,0,10
39204,macchaṇḍī,macchandi,4,4,0,0,9
39205,khaṇḍasālūkaṃ,khandasalukam,1,1,0,0,13
39206,M0.0315,M0.0315,45,45,0,0,7
39207,pupphaguḷā,pupphagula,1,1,0,0,10
39208,thaddhapattantu,thaddhapattantu,1,1,0,0,15
39209,khaṇḍakakkaṃ,khandakakkam,1,1,0,0,12
39210,phāṇitamiccaññe,phanitamiccanne,1,1,0,0,15
39211,sakkharā,sakkhara,61,53,8,0,8
39212,sitā,sita,51,41,10,0,4
39213,taṇhaṃ,tanham,491,421,70,0,6
39214,sitasakkharetyatra,sitasakkharetyatra,1,1,0,0,18
39215,dhavalattho,dhavalattho,1,1,0,0,11
39216,sakkharāpamāṇasaṇṭhānattā,sakkharapamanasanthanatta,1,1,0,0,25
39217,thaddhatarā,thaddhatara,1,1,0,0,11
39218,phāṇitā,phanita,1,1,0,0,7
39219,khaṇḍavikārāpi,khandavikarapi,1,1,0,0,14
39220,guḷe,gule,13,13,0,0,4
39221,rogādhikesu,rogadhikesu,1,1,0,0,11
39222,vināsakarattā,vinasakaratta,1,1,0,0,13
39223,visañca,visanca,2,2,0,0,7
39224,kaṇṭakañca,kantakanca,4,4,0,0,10
39225,para463,para463,57,57,0,0,7
39226,bhaṭṭhadhaññe,bhatthadhanne,1,1,0,0,13
39227,lāja,laja,3,1,2,0,4
39228,bhassane,bhassane,7,2,5,0,8
39229,bhassanaṃ,bhassanam,8,5,3,0,9
39230,bhajjanaṃ,bhajjanam,2,1,1,0,9
39231,khataṃ,khatam,46,43,3,0,6
39232,akkhataṃ,akkhatam,30,27,3,0,8
39233,lājesvakkhataṃ,lajesvakkhatam,1,1,0,0,14
39234,hiṃsite,himsite,1,1,0,0,7
39235,bhaṭṭhayave,bhatthayave,3,3,0,0,11
39236,dhānā,dhana,7,5,2,0,5
39237,abhinavo,abhinavo,10,8,2,0,8
39238,bbhide,bbhide,1,1,0,0,6
39239,yavādicuṇṇe,yavadicunne,1,1,0,0,11
39240,pūpo,pupo,2,1,1,0,4
39241,kārayutte,karayutte,2,2,0,0,9
39242,apūpo,apupo,2,1,1,0,5
39243,lābu,labu,16,10,6,0,4
39244,alābū,alabu,4,4,0,0,5
39245,taṇḍulādīnaṃ,tanduladinam,10,10,0,0,12
39246,piṭṭhānaṃ,pitthanam,2,2,0,0,9
39247,piṭṭhako,pitthako,2,1,1,0,8
39248,para464,para464,62,62,0,0,7
39249,sūde,sude,4,4,0,0,4
39250,sūpañca,supanca,2,2,0,0,7
39251,karissatīti,karissatiti,90,65,25,0,11
39252,bhattakāro,bhattakaro,4,3,1,0,10
39253,sūpakāro,supakaro,6,5,1,0,8
39254,paggharaṇe,paggharane,11,9,2,0,10
39255,paggharāpetīti,paggharapetiti,6,5,1,0,14
39256,sūdo,sudo,57,54,3,0,4
39257,M0.0316,M0.0316,44,44,0,0,7
39258,aḷāro,alaro,2,2,0,0,5
39259,sūpādivikati,supadivikati,1,1,0,0,12
39260,āḷāriko,alariko,10,9,1,0,7
39261,pacatīti,pacatiti,22,21,1,0,8
39262,odaniko,odaniko,3,2,1,0,7
39263,rasako,rasako,10,9,1,0,6
39264,sūpe,supe,4,4,0,0,4
39265,sukhatthāya,sukhatthaya,37,37,0,0,11
39266,pātabbattā,patabbatta,3,3,0,0,10
39267,sūpo,supo,22,16,6,0,4
39268,añjati,anjati,11,11,0,0,6
39269,para465,para465,54,54,0,0,7
39270,bhatte,bhatte,74,70,4,0,6
39271,udi,udi,20,11,9,0,3
39272,savanakledanesu,savanakledanesu,1,1,0,0,15
39273,odana,odana,2,1,1,0,5
39274,kuraṃ,kuram,9,5,4,0,5
39275,bubhukkhanti,bubhukkhanti,4,4,0,0,12
39276,bhajati,bhajati,269,263,6,0,7
39277,bhakkhitabbāti,bhakkhitabbati,2,2,0,0,14
39278,bhikkhā,bhikkha,119,112,7,0,7
39279,bhakkha,bhakkha,5,1,4,0,7
39280,bhidādi,bhidadi,1,0,1,0,7
39281,annā,anna,19,11,8,0,4
39282,bhojane,bhojane,388,358,30,0,7
39283,āharati,aharati,139,136,3,0,7
39284,balāyūnīti,balayuniti,1,1,0,0,10
39285,ghasa,ghasa,14,3,11,0,5
39286,andhopyatra,andhopyatra,1,1,0,0,11
39287,andhā,andha,84,80,4,0,5
39288,yāguyaṃ,yaguyam,10,10,0,0,7
39289,plavati,plavati,10,10,0,0,7
39290,byāpībhavatīti,byapibhavatiti,1,1,0,0,14
39291,taralaṃ,taralam,4,3,1,0,7
39292,taralāpi,taralapi,1,1,0,0,8
39293,ussā,ussa,3,3,0,0,4
39294,uṇhikā,unhika,2,2,0,0,6
39295,sāṇā,sana,2,1,1,0,4
39296,vilepī,vilepi,1,1,0,0,6
39297,yāgunāmāni,yagunamani,1,1,0,0,10
39298,para466,para466,60,60,0,0,7
39299,khajjādayo,khajjadayo,1,1,0,0,10
39300,M0.0317,M0.0317,43,43,0,0,7
39301,asanabhedā,asanabheda,1,1,0,0,10
39302,khāda,khada,97,83,14,0,5
39303,khajjaṃ,khajjam,26,17,9,0,7
39304,maṃsādi,mamsadi,9,9,0,0,7
39305,bhojjaṃ,bhojjam,12,9,3,0,7
39306,liha,liha,5,3,2,0,4
39307,leyyaṃ,leyyam,2,1,1,0,6
39308,madhvādi,madhvadi,2,2,0,0,8
39309,pātabbanti,patabbanti,6,6,0,0,10
39310,āsse,asse,9,8,1,0,4
39311,sūpādi,supadi,2,2,0,0,6
39312,bhattamaṇḍe,bhattamande,1,1,0,0,11
39313,visarujapadādito,visarujapadadito,1,1,0,0,16
39314,māsaropyatra,masaropyatra,1,1,0,0,12
39315,ālope,alope,54,53,1,0,5
39316,lupa,lupa,6,1,5,0,4
39317,kabi,kabi,1,0,1,0,4
39318,balamassāti,balamassati,1,1,0,0,11
39319,kabaḷo,kabalo,9,8,1,0,6
39320,gāsopi,gasopi,1,1,0,0,6
39321,para467,para467,69,69,0,0,7
39322,sabbarasānaṃ,sabbarasanam,5,5,0,0,12
39323,aggamhi,aggamhi,3,3,0,0,7
39324,maṇḍa,manda,9,4,5,0,5
39325,sabbarasagge,sabbarasagge,1,1,0,0,12
39326,maṇḍamanitthiya,mandamanitthiya,1,1,0,0,15
39327,bhuttato,bhuttato,2,2,0,0,8
39328,ghāso,ghaso,8,6,2,0,5
39329,vighāso,vighaso,4,1,3,0,7
39330,seso,seso,439,413,26,0,4
39331,bhuttaseso,bhuttaseso,1,1,0,0,10
39332,bhuttasesako,bhuttasesako,1,0,1,0,12
39333,vighāsāde,vighasade,7,7,0,0,9
39334,vighāsaṃ,vighasam,25,19,6,0,8
39335,pātuṃ,patum,138,133,5,0,5
39336,para468,para468,64,64,0,0,7
39337,M0.0318,M0.0318,43,43,0,0,7
39338,bhuttumicchāyaṃ,bhuttumicchayam,1,1,0,0,15
39339,khuda,khuda,11,3,8,0,5
39340,bubhukkhāyaṃ,bubhukkhayam,2,2,0,0,12
39341,ghasitumicchā,ghasitumiccha,3,3,0,0,13
39342,jighacchā,jighaccha,44,43,1,0,9
39343,paṭicchādanīyamuccate,paticchadaniyamuccate,1,1,0,0,21
39344,paṭicchādetīti,paticchadetiti,15,12,3,0,14
39345,paṭicchādanīyaṃ,paticchadaniyam,7,4,3,0,15
39346,paṭicchādetabbattā,paticchadetabbatta,1,1,0,0,18
39347,uggāre,uggare,1,1,0,0,6
39348,deki,deki,1,0,1,0,4
39349,saddossāhesu,saddossahesu,1,1,0,0,12
39350,dekati,dekati,2,2,0,0,6
39351,gantumussahatīti,gantumussahatiti,1,1,0,0,16
39352,udreko,udreko,2,1,1,0,6
39353,uddekopi,uddekopi,3,3,0,0,8
39354,uggāro,uggaro,7,5,2,0,6
39355,tittiyaṃ,tittiyam,5,2,3,0,8
39356,suhito,suhito,37,37,0,0,6
39357,sohiccaṃ,sohiccam,3,2,1,0,8
39358,issatte,issatte,3,3,0,0,7
39359,para469,para469,61,61,0,0,7
39360,yathicchita,yathicchita,5,4,1,0,11
39361,yathicchite,yathicchite,2,2,0,0,11
39362,kriyāvisesanatāya,kriyavisesanataya,1,1,0,0,17
39363,cete,cete,115,115,0,0,4
39364,kriyābyayānañhi,kriyabyayananhi,1,1,0,0,15
39365,satipyekatte,satipyekatte,1,1,0,0,12
39366,tabbisesanāni,tabbisesanani,1,1,0,0,13
39367,ekattepi,ekattepi,11,11,0,0,8
39368,kriyānamabyayānañca,kriyanamabyayananca,1,1,0,0,19
39369,sattābhūtattā,sattabhutatta,1,1,0,0,13
39370,liṅgasaṅkhyāvisesopādānaṃ,lingasankhyavisesopadanam,1,1,0,0,25
39371,tabbisesanānampi,tabbisesananampi,1,1,0,0,16
39372,sāmaññaliṅgā,samannalinga,1,1,0,0,12
39373,sāmaññasaṅkhyā,samannasankhya,1,1,0,0,14
39374,cekattaṃ,cekattam,2,2,0,0,8
39375,muduṃ,mudum,62,52,10,0,5
39376,sāduṃ,sadum,40,38,2,0,5
39377,bahuvacanantepi,bahuvacanantepi,1,1,0,0,15
39378,kriyāsadde,kriyasadde,2,2,0,0,10
39379,tabbisesanassekattameva,tabbisesanassekattameva,1,1,0,0,23
39380,kriyāvisesanānaṃ,kriyavisesananam,1,1,0,0,16
39381,karotyatthena,karotyatthena,1,1,0,0,13
39382,kubbantītyattho,kubbantityattho,1,1,0,0,15
39383,mudādīnañca,mudadinanca,1,1,0,0,11
39384,tabbisesanānaṃ,tabbisesananam,2,2,0,0,14
39385,kammattaṃ,kammattam,7,7,0,0,9
39386,panāha,panaha,107,106,1,0,6
39387,M0.0319,M0.0319,44,44,0,0,7
39388,dhātvatthā,dhatvattha,3,3,0,0,10
39389,bhavatyatthānugatā,bhavatyatthanugata,1,1,0,0,18
39390,bhavatikriyā,bhavatikriya,1,1,0,0,12
39391,katvatthamanubhavantītyattho,katvatthamanubhavantityattho,1,1,0,0,28
39392,devadattapayutto,devadattapayutto,1,1,0,0,16
39393,bhavatī,bhavati,87,76,11,0,7
39394,tammatena,tammatena,1,1,0,0,9
39395,mudupacanaṃ,mudupacanam,1,1,0,0,11
39396,pacatītyattho,pacatityattho,1,1,0,0,13
39397,ramaṇīyaṃ,ramaniyam,221,212,9,0,9
39398,idamupakumbhaṃ,idamupakumbham,1,1,0,0,14
39399,nikāma,nikama,1,0,1,0,6
39400,sādisantapucche,sadisantapucche,1,1,0,0,15
39401,antena,antena,29,29,0,0,6
39402,āpa,apa,66,4,62,0,3
39403,sattyaṃ,sattyam,1,1,0,0,7
39404,pariyattaṃ,pariyattam,43,41,2,0,10
39405,icchitassa,icchitassa,35,35,0,0,10
39406,anatikkamo,anatikkamo,4,4,0,0,10
39407,yathātthe,yathatthe,3,3,0,0,9
39408,pakāmaṃpyatra,pakamampyatra,1,1,0,0,13
39409,vaṇijake,vanijake,1,1,0,0,8
39410,kayavikkayehi,kayavikkayehi,1,1,0,0,13
39411,vāṇijjopajīvīnaṃ,vanijjopajivinam,1,1,0,0,16
39412,saṅghātaṃ,sanghatam,41,27,14,0,9
39413,desantaraṃ,desantaram,36,35,1,0,10
39414,vaṇijanāyako,vanijanayako,1,1,0,0,12
39415,kayavikkayavohāro,kayavikkayavoharo,1,1,0,0,17
39416,āpaṇiko,apaniko,7,6,1,0,7
39417,vedahako,vedahako,1,1,0,0,8
39418,negamo,negamo,18,16,2,0,6
39419,paṇyājīvo,panyajivo,1,1,0,0,9
39420,vaṇijopyatra,vanijopyatra,1,1,0,0,12
39421,para470,para470,56,56,0,0,7
39422,vikkayo,vikkayo,45,40,5,0,7
39423,pubbameva,pubbameva,11,11,0,0,9
39424,vikkayiko,vikkayiko,6,5,1,0,9
39425,vikkiṇātīti,vikkinatiti,3,3,0,0,11
39426,vikketā,vikketa,2,1,1,0,7
39427,kayo,kayo,15,10,5,0,4
39428,kayena,kayena,8,7,1,0,6
39429,kayiko,kayiko,7,6,1,0,6
39430,M0.0320,M0.0320,43,43,0,0,7
39431,dhanappayottari,dhanappayottari,1,1,0,0,15
39432,iṇe,ine,13,12,1,0,3
39433,uttamaṇṇo,uttamanno,2,1,1,0,9
39434,vuḍḍhatthaṃ,vuddhattham,1,1,0,0,11
39435,payojetīti,payojetiti,25,23,2,0,10
39436,dhaniko,dhaniko,7,6,1,0,7
39437,dhanagāhake,dhanagahake,1,1,0,0,11
39438,adhamo,adhamo,12,8,4,0,6
39439,adhamaṇṇo,adhamanno,1,0,1,0,9
39440,iṇaṃ,inam,176,160,16,0,4
39441,iṇāyiko,inayiko,29,25,4,0,7
39442,āyiko,ayiko,1,1,0,0,5
39443,iṇāyako,inayako,1,1,0,0,7
39444,para471-472,para471-472,4,4,0,0,11
39445,uddharīyate,uddhariyate,1,1,0,0,11
39446,gayhateti,gayhateti,5,5,0,0,9
39447,uddhāro,uddharo,41,23,18,0,7
39448,pariyudañcanampi,pariyudancanampi,1,1,0,0,16
39449,udañjhate,udanjhate,1,1,0,0,9
39450,yattakena,yattakena,57,52,5,0,9
39451,labbhate,labbhate,31,31,0,0,8
39452,mūladhane,muladhane,3,3,0,0,9
39453,mūlādidvayaṃ,muladidvayam,1,1,0,0,12
39454,mūla,mula,30,16,14,0,4
39455,paṭipāde,patipade,1,1,0,0,8
39456,avassamassidaṃ,avassamassidam,1,1,0,0,14
39457,kayitabba,kayitabba,1,1,0,0,9
39458,saccassākhyāpanaṃ,saccassakhyapanam,1,1,0,0,17
39459,saccāpanaṃ,saccapanam,7,5,2,0,10
39460,karañcittabharaṇamiccattho,karancittabharanamiccattho,1,1,0,0,26
39461,dhāturūpā,dhaturupa,3,3,0,0,9
39462,āpuṇanaṃ,apunanam,1,1,0,0,8
39463,saccāpanā,saccapana,1,1,0,0,9
39464,saccākati,saccakati,1,1,0,0,9
39465,thīkaṇḍe,thikande,1,1,0,0,8
39466,saccakāro,saccakaro,4,3,1,0,9
39467,saccaṃkāropi,saccamkaropi,1,1,0,0,12
39468,klive,klive,1,1,0,0,5
39469,saccaṅkāro,saccankaro,1,1,0,0,10
39470,saccākatitthiya,saccakatitthiya,1,1,0,0,15
39471,vikkanīyadabbe,vikkaniyadabbe,1,1,0,0,14
39472,vikkinitabbanti,vikkinitabbanti,1,1,0,0,15
39473,vikkeyyaṃ,vikkeyyam,3,2,1,0,9
39474,M0.0321,M0.0321,43,43,0,0,7
39475,nyāsassappane,nyasassappane,1,1,0,0,13
39476,nyāsampanne,nyasampanne,1,1,0,0,11
39477,nyāsassa,nyasassa,3,3,0,0,8
39478,appanaṃ,appanam,203,186,17,0,7
39479,paṭidānaṃ,patidanam,4,4,0,0,9
39480,nyāsasampannattho,nyasasampannattho,1,1,0,0,17
39481,paridānaṃpyatra,paridanampyatra,1,1,0,0,15
39482,nyāse,nyase,1,1,0,0,5
39483,nyassate,nyassate,1,1,0,0,8
39484,nikkhipīyateti,nikkhipiyateti,1,1,0,0,14
39485,upanidhiyyateti,upanidhiyyateti,1,1,0,0,15
39486,upanidhi,upanidhi,8,4,4,0,8
39487,upanidhinyāso,upanidhinyaso,1,1,0,0,13
39488,para473,para473,68,68,0,0,7
39489,saṅkhyāsaddā,sankhyasadda,6,6,0,0,12
39490,saṅkhyeyye,sankhyeyye,16,14,2,0,10
39491,saṅkhyeyyekatte,sankhyeyyekatte,1,1,0,0,15
39492,samānādhikaraṇaṃ,samanadhikaranam,17,17,0,0,16
39493,bhinnādhikaraṇaṃ,bhinnadhikaranam,3,3,0,0,16
39494,ekādasa,ekadasa,859,823,36,0,7
39495,tīsūtyanena,tisutyanena,1,1,0,0,11
39496,pariyantāpī,pariyantapi,1,1,0,0,11
39497,aliṅgatāvacanaṃ,alingatavacanam,1,1,0,0,15
39498,liṅgavisesābhāvaṃ,lingavisesabhavam,1,1,0,0,17
39499,sāmaññaliṅgābhāvanti,samannalingabhavanti,1,1,0,0,20
39500,atiliṅgaṃ,atilingam,4,4,0,0,9
39501,tadākhyātanti,tadakhyatanti,3,3,0,0,13
39502,taṃtaṃliṅgavisesavacanatā,tamtamlingavisesavacanata,1,1,0,0,25
39503,sāmaññaliṅgavacanatā,samannalingavacanata,1,1,0,0,20
39504,vīsatyā,visatya,1,0,1,0,7
39505,vīsatī,visati,7,6,1,0,6
39506,ekatteti,ekatteti,8,2,6,0,8
39507,panetā,paneta,62,59,3,0,6
39508,ekattavisiṭṭhameva,ekattavisitthameva,1,1,0,0,18
39509,vaggattaṃ,vaggattam,2,2,0,0,9
39510,sabhāvato,sabhavato,473,456,17,0,9
39511,paṭipādayanti,patipadayanti,4,4,0,0,13
39512,bhinnasaṅkhyenāpi,bhinnasankhyenapi,1,1,0,0,17
39513,samānādhikaraṇe,samanadhikarane,11,11,0,0,15
39514,ekavacaneyeva,ekavacaneyeva,1,1,0,0,13
39515,yadyekatte,yadyekatte,1,1,0,0,10
39516,dvevīsatiyo,dvevisatiyo,3,3,0,0,11
39517,vīsatiyo,visatiyo,6,6,0,0,8
39518,pañcasatāniccādayo,pancasataniccadayo,1,1,0,0,18
39519,payogā,payoga,118,115,3,0,6
39520,vaggabhede,vaggabhede,8,8,0,0,10
39521,bahuttepī,bahuttepi,1,1,0,0,9
39522,M0.0322,M0.0322,44,44,0,0,7
39523,vīsatyādīnaṃ,visatyadinam,1,1,0,0,12
39524,vaggānaṃ,vagganam,18,18,0,0,8
39525,vattumicchite,vattumicchite,6,6,0,0,13
39526,bahuttepi,bahuttepi,6,6,0,0,9
39527,bahuvacanepi,bahuvacanepi,3,3,0,0,12
39528,saṅkhyantarassatthe,sankhyantarassatthe,1,1,0,0,19
39529,abhidheyyevīsatyādayo,abhidheyyevisatyadayo,1,1,0,0,21
39530,taṃsamānādhikaraṇato,tamsamanadhikaranato,1,1,0,0,20
39531,bahuvacanānipi,bahuvacananipi,1,1,0,0,14
39532,bhavantī,bhavanti,101,85,16,0,8
39533,saṅkhyantaramiha,sankhyantaramiha,1,1,0,0,16
39534,vaggabhedo,vaggabhedo,1,1,0,0,10
39535,vohāramattanānattaṃ,voharamattananattam,1,1,0,0,19
39536,atthanānattanti,atthananattanti,1,1,0,0,15
39537,ānavuti,anavuti,2,0,2,0,7
39538,navuti,navuti,76,71,5,0,6
39539,saddamabhibyāpetvā,saddamabhibyapetva,1,1,0,0,18
39540,vīsatyādayo,visatyadayo,4,4,0,0,11
39541,bhinnaliṅgenāpi,bhinnalingenapi,1,1,0,0,15
39542,kuṇḍāni,kundani,1,1,0,0,7
39543,vikatasamāhāradvandā,vikatasamaharadvanda,1,1,0,0,20
39544,dvandekattanti,dvandekattanti,1,1,0,0,14
39545,napuṃsakattanti,napumsakattanti,2,2,0,0,15
39546,abyuppannā,abyuppanna,1,1,0,0,10
39547,paramatena,paramatena,1,1,0,0,10
39548,kaccāyana,kaccayana,14,6,8,0,9
39549,byuppannā,byuppanna,1,1,0,0,9
39550,para474-476,para474-476,1,1,0,0,11
39551,satādīni,satadini,1,1,0,0,8
39552,asaṅkhyeyyapariyantāni,asankhyeyyapariyantani,1,1,0,0,22
39553,gaṇanabhedāni,gananabhedani,1,1,0,0,13
39554,dasadasa,dasadasa,1,0,1,0,8
39555,nipphādito,nipphadito,16,13,3,0,10
39556,satadasa,satadasa,1,0,1,0,8
39557,ayuta,ayuta,1,0,1,0,5
39558,satasahassa,satasahassa,5,4,1,0,11
39559,dasaguṇaṃ,dasagunam,3,2,1,0,9
39560,kuṭatīti,kutatiti,1,1,0,0,8
39561,gaṇanaviseso,gananaviseso,6,6,0,0,12
39562,pakoṭīti,pakotiti,2,1,1,0,8
39563,missetvā,missetva,132,131,1,0,8
39564,koṭipakoṭīti,kotipakotiti,1,0,1,0,12
39565,āgamassu,agamassu,2,2,0,0,8
39566,aba,aba,1,0,1,0,3
39567,M0.0323,M0.0323,43,43,0,0,7
39568,sogandhikaṃ,sogandhikam,7,5,2,0,11
39569,kamalavisesanāmena,kamalavisesanamena,1,1,0,0,18
39570,tathoppalādināmehi,tathoppaladinamehi,1,1,0,0,18
39571,ekeko,ekeko,125,120,5,0,5
39572,vākyappabandhe,vakyappabandhe,2,2,0,0,14
39573,saṅkhyātumasakkuṇeyyatāya,sankhyatumasakkuneyyataya,1,1,0,0,25
39574,saṅkhyātumasakkuṇeyyatte,sankhyatumasakkuneyyatte,1,1,0,0,24
39575,kathameko,kathameko,1,1,0,0,9
39576,asaṅkhyeyyāniccādīni,asankhyeyyaniccadini,1,1,0,0,20
39577,bhedāni,bhedani,3,3,0,0,7
39578,vuttānīti,vuttaniti,187,175,12,0,9
39579,kāladesādivasena,kaladesadivasena,1,1,0,0,16
39580,bhinnānampi,bhinnanampi,7,7,0,0,11
39581,etāsu,etasu,123,120,3,0,5
39582,saṅkhyāsu,sankhyasu,5,4,1,0,9
39583,satādilakkhapariyantaṃ,satadilakkhapariyantam,1,1,0,0,22
39584,guṇitaṃ,gunitam,10,10,0,0,7
39585,koṭyādikaṃ,kotyadikam,2,2,0,0,10
39586,asaṅkhyeyyapariyantaṃ,asankhyeyyapariyantam,1,1,0,0,21
39587,satalakkhaguṇaṃ,satalakkhagunam,6,5,1,0,15
39588,satalakkhehi,satalakkhehi,1,1,0,0,12
39589,dvisuññasahitā,dvisunnasahita,1,1,0,0,14
39590,tisuññasahitā,tisunnasahita,1,1,0,0,13
39591,catusuññasahitā,catusunnasahita,1,1,0,0,15
39592,pañcasuññasahitā,pancasunnasahita,1,1,0,0,16
39593,sattasuññasahitā,sattasunnasahita,1,1,0,0,16
39594,cuddasasuññasahitā,cuddasasunnasahita,1,1,0,0,18
39595,pakoṭi,pakoti,23,22,1,0,6
39596,yāvāsaṅkhyeyyaṃ,yavasankhyeyyam,1,1,0,0,15
39597,netabbaṃ,netabbam,50,49,1,0,8
39598,ayamekaccānamācariyānaṃ,ayamekaccanamacariyanam,1,1,0,0,23
39599,satādayo,satadayo,2,2,0,0,8
39600,asaṅkhyeyyapariyantā,asankhyeyyapariyanta,1,1,0,0,20
39601,dasaguṇitā,dasagunita,2,2,0,0,10
39602,kaccāyanassa,kaccayanassa,16,15,1,0,12
39603,dasaguṇitañce,dasagunitance,1,1,0,0,13
39604,suttamāha,suttamaha,5,5,0,0,9
39605,lakkhantā,lakkhanta,1,1,0,0,9
39606,dasadasaguṇitā,dasadasagunita,1,1,0,0,14
39607,dvibindusahitā,dvibindusahita,1,1,0,0,14
39608,catupañcādibindusahitā,catupancadibindusahita,1,1,0,0,22
39609,sahassādikaṃ,sahassadikam,1,1,0,0,12
39610,dvādasabindusahitā,dvadasabindusahita,1,1,0,0,18
39611,ekūnavīsatibindusahitā,ekunavisatibindusahita,1,1,0,0,22
39612,asaṅkhyeyyā,asankhyeyya,17,17,0,0,11
39613,bindūni,binduni,10,10,0,0,7
39614,gaṇanā,ganana,187,181,6,0,6
39615,asaṅkhyeyyagaṇanavisese,asankhyeyyagananavisese,1,1,0,0,23
39616,pañcacattālīsādhikāni,pancacattalisadhikani,2,2,0,0,21
39617,satabindūni,satabinduni,1,1,0,0,11
39618,ayamamhākaṃ,ayamamhakam,11,11,0,0,11
39619,pantyā,pantya,1,1,0,0,6
39620,satasahassādi,satasahassadi,1,1,0,0,13
39621,dasaguṇottara,dasagunottara,1,1,0,0,13
39622,mityuttaṃ,mityuttam,1,1,0,0,9
39623,dasasaṅkhyā,dasasankhya,4,4,0,0,11
39624,pantītyuccate,pantityuccate,1,1,0,0,13
39625,M0.0324,M0.0324,43,43,0,0,7
39626,satasahassādikaṃ,satasahassadikam,1,1,0,0,16
39627,dasasaṅkhyāya,dasasankhyaya,2,2,0,0,13
39628,satā,sata,138,130,8,0,4
39629,sahassā,sahassa,8,6,2,0,7
39630,ayutā,ayuta,1,1,0,0,5
39631,lakkhā,lakkha,3,3,0,0,6
39632,payutaṃ,payutam,7,5,2,0,7
39633,payutā,payuta,1,1,0,0,6
39634,koṭiyā,kotiya,76,75,1,0,6
39635,abbudaṃ,abbudam,54,46,8,0,7
39636,abbudā,abbuda,22,21,1,0,6
39637,khabbo,khabbo,1,1,0,0,6
39638,khabbā,khabba,1,1,0,0,6
39639,mahākatho,mahakatho,1,1,0,0,9
39640,mahāpadumaṃ,mahapadumam,10,10,0,0,11
39641,saṅku,sanku,13,10,3,0,5
39642,saṅkuto,sankuto,1,1,0,0,7
39643,antyaṃ,antyam,1,1,0,0,6
39644,antyā,antya,1,1,0,0,5
39645,majjhā,majjha,9,8,1,0,6
39646,paraddhaṃ,paraddham,2,2,0,0,9
39647,paraddhā,paraddha,1,1,0,0,8
39648,saṅkhyañca,sankhyanca,1,1,0,0,10
39649,vīsatimaṃ,visatimam,19,18,1,0,9
39650,asaṅkhyeyyamito,asankhyeyyamito,1,1,0,0,15
39651,sabbesaṃpyatra,sabbesampyatra,1,1,0,0,14
39652,vādā,vada,83,76,7,0,4
39653,para477-478,para477-478,2,2,0,0,11
39654,sādhikena,sadhikena,1,1,0,0,9
39655,dvepādena,dvepadena,1,1,0,0,9
39656,aḍḍhena,addhena,43,42,1,0,7
39657,catuttho,catuttho,615,603,12,0,8
39658,aḍḍhuḍḍho,addhuddho,8,7,1,0,9
39659,tatiyo,tatiyo,890,875,15,0,6
39660,aḍḍhatiyo,addhatiyo,7,7,0,0,9
39661,aḍḍhateyyo,addhateyyo,12,10,2,0,10
39662,vacanatthaṃ,vacanattham,296,294,2,0,11
39663,aḍḍhūpapadena,addhupapadena,3,3,0,0,13
39664,catutthā,catuttha,125,123,2,0,8
39665,disaddānaṃ,disaddanam,8,8,0,0,10
39666,aḍḍhuḍḍhā,addhuddha,1,0,1,0,9
39667,dyādeso,dyadeso,1,1,0,0,7
39668,sādhikapādena,sadhikapadena,1,1,0,0,13
39669,diyaḍḍho,diyaddho,42,33,9,0,8
39670,divaḍḍho,divaddho,8,7,1,0,8
39671,antaritassāpi,antaritassapi,1,1,0,0,13
39672,idhānuvattanatā,idhanuvattanata,1,1,0,0,15
39673,abhidhānantarābhāvā,abhidhanantarabhava,1,1,0,0,19
39674,para479-480,para479-480,3,3,0,0,11
39675,mīyate,miyate,10,10,0,0,6
39676,paricchindīyate,paricchindiyate,1,1,0,0,15
39677,tulāpatthaṅgulivasā,tulapatthangulivasa,1,1,0,0,19
39678,tidhā,tidha,324,282,42,0,5
39679,māniyadabbassa,maniyadabbassa,1,1,0,0,14
39680,M0.0325,M0.0325,42,42,0,0,7
39681,aṅgulī,anguli,11,10,1,0,6
39682,vīhayo,vihayo,22,21,1,0,6
39683,ekāva,ekava,162,155,7,0,5
39684,guñjā,gunja,13,10,3,0,5
39685,samagarukā,samagaruka,1,1,0,0,10
39686,māsako,masako,21,15,6,0,6
39687,samagarukoti,samagarukoti,1,1,0,0,12
39688,māsakā,masaka,6,6,0,0,6
39689,vibhīṭakoti,vibhitakoti,1,1,0,0,11
39690,akkhaphalasamānagarukattā,akkhaphalasamanagarukatta,1,1,0,0,25
39691,karisopyatra,karisopyatra,1,1,0,0,12
39692,dharaṇaṃ,dharanam,5,2,3,0,8
39693,tidhātuyā,tidhatuya,1,1,0,0,9
39694,akkhānamaṭṭhakaṃ,akkhanamatthakam,1,1,0,0,16
39695,pañcadharaṇaṃ,pancadharanam,4,4,0,0,13
39696,nikkhaṃ,nikkham,31,19,12,0,7
39697,nikkhā,nikkha,6,6,0,0,6
39698,vattatītyekaccānaṃ,vattatityekaccanam,1,1,0,0,18
39699,yathāvuttāyeva,yathavuttayeva,1,1,0,0,14
39700,pañcamāsakā,pancamasaka,1,1,0,0,11
39701,dasamāsakā,dasamasaka,1,1,0,0,10
39702,pañcasuvaṇṇā,pancasuvanna,2,2,0,0,12
39703,nāmātyamhākaṃ,namatyamhakam,1,1,0,0,13
39704,suvaṇṇavikārepi,suvannavikarepi,1,1,0,0,15
39705,dharaṇāni,dharanani,4,4,0,0,9
39706,palaṃ,palam,13,8,5,0,5
39707,para481,para481,63,63,0,0,7
39708,palasataṃ,palasatam,8,7,1,0,9
39709,gehānaṃ,gehanam,11,10,1,0,7
39710,dārubandhāya,darubandhaya,1,1,0,0,12
39711,piṭhikāyaṃ,pithikayam,1,1,0,0,10
39712,mānabhaṇḍe,manabhande,2,2,0,0,10
39713,sādise,sadise,2,2,0,0,6
39714,rāsipalasatesu,rasipalasatesu,1,1,0,0,14
39715,M0.0326,M0.0326,41,41,0,0,7
39716,dhāraṇaposanesu,dharanaposanesu,4,4,0,0,15
39717,dvisahassesu,dvisahassesu,1,1,0,0,12
39718,palānamapi,palanamapi,1,1,0,0,10
39719,vivadhe,vivadhe,1,1,0,0,7
39720,tyajayo,tyajayo,1,0,1,0,7
39721,byākhyāsudhāṭīkāyampi,byakhyasudhatikayampi,1,1,0,0,21
39722,vivadho,vivadho,1,1,0,0,7
39723,bhārabhedo,bharabhedo,1,1,0,0,10
39724,rūpiyassa,rupiyassa,29,25,4,0,9
39725,karisena,karisena,1,1,0,0,8
39726,saṃvohārapadattho,samvoharapadattho,1,1,0,0,17
39727,karisappamāṇena,karisappamanena,1,1,0,0,15
39728,rūpiyena,rupiyena,17,17,0,0,8
39729,paṇo,pano,8,4,4,0,4
39730,paṇiyo,paniyo,2,2,0,0,6
39731,dabbabhedo,dabbabhedo,1,1,0,0,10
39732,risa,risa,5,2,3,0,4
39733,ahā,aha,5,4,1,0,3
39734,karisāpaṇo,karisapano,2,1,1,0,10
39735,aññatrūpacārā,annatrupacara,1,1,0,0,13
39736,tulāmānaṃ,tulamanam,1,1,0,0,9
39737,para482,para482,57,57,0,0,7
39738,patthamānaṃ,patthamanam,2,2,0,0,11
39739,kuḍuvo,kuduvo,12,9,3,0,6
39740,pasato,pasato,9,8,1,0,6
39741,kuḍu,kudu,2,1,1,0,4
39742,kuḍuvā,kuduva,7,7,0,0,6
39743,pattho,pattho,30,24,6,0,6
39744,catupatthā,catupattha,1,1,0,0,10
39745,ḷattādi,lattadi,1,1,0,0,7
39746,dasaṅgulaṃ,dasangulam,1,1,0,0,10
39747,vāsabbato,vasabbato,1,1,0,0,9
39748,mānampi,manampi,1,1,0,0,7
39749,āḷhakā,alhaka,6,6,0,0,6
39750,doṇaṃ,donam,33,27,6,0,5
39751,caturāḷhakaṃ,caturalhakam,4,4,0,0,12
39752,duṇa,duna,3,0,3,0,4
39753,hiṃsāyañca,himsayanca,5,4,1,0,10
39754,doṇo,dono,62,60,2,0,4
39755,para483,para483,57,57,0,0,7
39756,doṇā,dona,7,7,0,0,4
39757,mānikā,manika,17,15,2,0,6
39758,catumānikaṃ,catumanikam,2,2,0,0,11
39759,catassannaṃ,catassannam,38,38,0,0,11
39760,mānikānaṃ,manikanam,1,1,0,0,9
39761,M0.0327,M0.0327,42,42,0,0,7
39762,khārī,khari,26,21,5,0,5
39763,dasambaṇaṃ,dasambanam,3,2,1,0,10
39764,dasādhikasatadoṇamattaṃ,dasadhikasatadonamattam,1,1,0,0,23
39765,kumbhoti,kumbhoti,10,2,8,0,8
39766,ghaṭanāmena,ghatanamena,1,1,0,0,11
39767,patthamānaviseso,patthamanaviseso,1,1,0,0,16
39768,para484,para484,60,60,0,0,7
39769,patthamānavisesānaṃ,patthamanavisesanam,1,1,0,0,19
39770,labbhamānapariyāye,labbhamanapariyaye,2,2,0,0,18
39771,patthe,patthe,10,7,3,0,6
39772,pattha,pattha,4,2,2,0,6
39773,sāmaññabhedamānesu,samannabhedamanesu,1,1,0,0,18
39774,visesamānavācako,visesamanavacako,1,1,0,0,16
39775,vāhe,vahe,3,2,1,0,4
39776,vāho,vaho,24,19,5,0,4
39777,ambaṇamānaṃ,ambanamanam,1,1,0,0,11
39778,pariyāyaṃ,pariyayam,158,134,24,0,9
39779,doṇe,done,5,4,1,0,4
39780,aṅgulamānaṃ,angulamanam,1,1,0,0,11
39781,aṇvādyābhidhānāvasare,anvadyabhidhanavasare,1,1,0,0,21
39782,bhūmivagge,bhumivagge,1,1,0,0,10
39783,abhihitaṃ,abhihitam,8,6,2,0,9
39784,para485,para485,63,63,0,0,7
39785,koṭṭhaṃ,kottham,26,21,5,0,7
39786,koṭṭhāso,kotthaso,210,206,4,0,8
39787,bhajīyate,bhajiyate,1,1,0,0,9
39788,vaṇṭakopyatra,vantakopyatra,1,1,0,0,13
39789,ṇantā,nanta,2,2,0,0,5
39790,vibhava,vibhava,9,3,6,0,7
39791,duiva,duiva,1,1,0,0,5
39792,sāramiccattho,saramiccattho,1,1,0,0,13
39793,ivatthe,ivatthe,5,5,0,0,7
39794,M0.0328,M0.0328,41,41,0,0,7
39795,sapati,sapati,15,13,2,0,6
39796,sāpateyyaṃ,sapateyyam,109,94,15,0,10
39797,vibhavanti,vibhavanti,3,3,0,0,10
39798,kosopyatra,kosopyatra,1,1,0,0,10
39799,para486,para486,58,58,0,0,7
39800,rūpiyañca,rupiyanca,6,6,0,0,9
39801,missitaṃ,missitam,27,24,3,0,8
39802,militaṃ,militam,2,2,0,0,7
39803,paccekañca,paccekanca,13,13,0,0,10
39804,khīrasvādhīṭīkā,khirasvadhitika,1,1,0,0,15
39805,kosādidvayavāccaṃ,kosadidvayavaccam,1,1,0,0,17
39806,piṇḍīkataṃ,pindikatam,4,3,1,0,10
39807,ābharaṇīkataṃ,abharanikatam,1,1,0,0,13
39808,kammībhāvamāpāditaṃ,kammibhavamapaditam,1,1,0,0,19
39809,ākarotthaṃ,akarottham,1,1,0,0,10
39810,ajātakammaṃ,ajatakammam,1,1,0,0,11
39811,cuṇṇādirūpaṃ,cunnadirupam,1,1,0,0,12
39812,kañcanarūpiyehi,kancanarupiyehi,1,1,0,0,15
39813,tejasaṃ,tejasam,1,1,0,0,7
39814,tambaṃ,tambam,4,2,2,0,6
39815,kaṃsarītisīsakādi,kamsaritisisakadi,1,1,0,0,17
39816,yañcātejasaṃ,yancatejasam,1,1,0,0,12
39817,rājapaṭṭadāruvisādika,rajapattadaruvisadika,1,1,0,0,21
39818,masāraṃ,masaram,1,1,0,0,7
39819,kuppaṃ,kuppam,25,22,3,0,6
39820,guppateti,guppateti,1,1,0,0,9
39821,rūpiyañcāhatamuṭṭhāpitahayavarāhapurisādi,rupiyancahatamutthapitahayavarahapurisadi,1,1,0,0,41
39822,nigghātikāya,nigghatikaya,1,1,0,0,12
39823,tāḷitaṃ,talitam,5,5,0,0,7
39824,dīnārādikaṃ,dinaradikam,1,1,0,0,11
39825,rūpiyākhyaṃ,rupiyakhyam,1,1,0,0,11
39826,assādirūpamassāhatamatthīti,assadirupamassahatamatthiti,1,1,0,0,27
39827,rūpiyaṃ,rupiyam,152,134,18,0,7
39828,āhatapasaṃsāsu,ahatapasamsasu,1,1,0,0,14
39829,para487-488,para487-488,2,2,0,0,11
39830,hirañña,hiranna,8,6,2,0,7
39831,jātarūpaṃ,jatarupam,190,160,30,0,9
39832,M0.0329,M0.0329,41,41,0,0,7
39833,pakaṭṭhatthe,pakatthatthe,1,1,0,0,12
39834,rūpapaccayo,rupapaccayo,1,1,0,0,11
39835,subhū,subhu,1,1,0,0,5
39836,rūpamassāti,rupamassati,4,4,0,0,11
39837,dippate,dippate,3,3,0,0,7
39838,dittiyā,dittiya,1,1,0,0,7
39839,soṇṇaṃ,sonnam,5,4,1,0,6
39840,kañca,kanca,6,5,1,0,5
39841,cittamattānaṃ,cittamattanam,1,1,0,0,13
39842,haṭa,hata,2,0,2,0,4
39843,tapanaṃ,tapanam,11,10,1,0,7
39844,dāhamarahatīti,dahamarahatiti,1,1,0,0,14
39845,tapaniyo,tapaniyo,1,0,1,0,8
39846,hirā,hira,1,0,1,0,4
39847,cāmīkarādayo,camikaradayo,1,1,0,0,12
39848,suvaṇṇassa,suvannassa,73,69,4,0,10
39849,cāmī,cami,3,2,1,0,4
39850,pupphajāti,pupphajati,1,1,0,0,10
39851,taṃkarattā,tamkaratta,1,1,0,0,10
39852,cāmīkaro,camikaro,2,0,2,0,8
39853,satakumbhaṃ,satakumbham,1,1,0,0,11
39854,paddhakesaravaṇṇaṃ,paddhakesaravannam,1,1,0,0,18
39855,tabbaṇṇasadisattā,tabbannasadisatta,1,1,0,0,17
39856,sātakumbhaṃ,satakumbham,5,4,1,0,11
39857,devarukkhabhūtāya,devarukkhabhutaya,1,1,0,0,17
39858,mahājambuyā,mahajambuya,1,1,0,0,11
39859,patiṭṭhitaṭṭhāne,patitthitatthane,9,9,0,0,16
39860,jambunadī,jambunadi,1,1,0,0,9
39861,patitehi,patitehi,8,8,0,0,8
39862,mahāgajappamāṇānaṃ,mahagajappamananam,1,1,0,0,18
39863,kumbhappamāṇānaṃ,kumbhappamananam,1,1,0,0,16
39864,bījehi,bijehi,17,16,1,0,6
39865,jambunadaṃ,jambunadam,7,6,1,0,10
39866,analappabhaṃ,analappabham,1,1,0,0,12
39867,devālaṅkāramatulaṃ,devalankaramatulam,1,1,0,0,18
39868,panānalamiti,pananalamiti,1,1,0,0,12
39869,visesatthepi,visesatthepi,1,1,0,0,12
39870,amarasīho,amarasiho,4,0,4,0,9
39871,suvaṇṇasāmaññeva,suvannasamanneva,1,1,0,0,16
39872,macchajāti,macchajati,20,19,1,0,10
39873,khaṇiyaṃ,khaniyam,1,1,0,0,8
39874,taṃsaṇṭhānasilākhaṇḍehi,tamsanthanasilakhandehi,1,1,0,0,23
39875,jātatāya,jatataya,13,13,0,0,8
39876,cāmīkarādīnipi,camikaradinipi,1,1,0,0,14
39877,suvaṇṇasāmaññe,suvannasamanne,1,1,0,0,14
39878,alaṅkārasuvaṇṇaṃ,alankarasuvannam,1,1,0,0,16
39879,siṅgīkanakamiccayaṃ,singikanakamiccayam,1,1,0,0,19
39880,kaṭakakuṇḍalādino,katakakundaladino,1,1,0,0,17
39881,alaṅkārasuvaṇṇassa,alankarasuvannassa,1,1,0,0,18
39882,nāmanti,namanti,93,92,1,0,7
39883,siṅgīmaṇḍanasoṇṇaṃ,singimandanasonnam,1,1,0,0,18
39884,M0.0330,M0.0330,41,41,0,0,7
39885,suvaṇṇatāya,suvannataya,4,4,0,0,11
39886,para489,para489,53,53,0,0,7
39887,rajate,rajate,5,5,0,0,6
39888,rūpayuttatāya,rupayuttataya,2,2,0,0,13
39889,jhu,jhu,1,1,0,0,3
39890,ña,na,64,50,14,0,2
39891,sajjhu,sajjhu,14,11,3,0,6
39892,jho,jho,19,8,11,0,3
39893,rūpiyajjhaṃ,rupiyajjham,1,1,0,0,11
39894,iyajjha,iyajjha,1,0,1,0,7
39895,dubbaṇṇaṃ,dubbannam,42,38,4,0,9
39896,khajjūraṃ,khajjuram,1,1,0,0,9
39897,setampi,setampi,5,5,0,0,7
39898,āhatasoṇṇarajate,ahatasonnarajate,1,1,0,0,16
39899,khaleklivaṃ,khaleklivam,1,1,0,0,11
39900,khajjūro,khajjuro,5,5,0,0,8
39901,pādapantare,padapantare,3,3,0,0,11
39902,bhatikāyaṃ,bhatikayam,1,1,0,0,10
39903,sajjhe,sajjhe,1,1,0,0,6
39904,asmajātiyaṃ,asmajatiyam,1,1,0,0,11
39905,puppharāgādimhi,puppharagadimhi,1,1,0,0,15
39906,muttāvajirādimhi,muttavajiradimhi,1,1,0,0,16
39907,vasvādittayaṃ,vasvadittayam,1,1,0,0,13
39908,ratnaṃ,ratnam,2,2,0,0,6
39909,sajātiseṭṭhepī,sajatisetthepi,1,1,0,0,14
39910,gajaseṭṭho,gajasettho,1,1,0,0,10
39911,gajaratanaṃ,gajaratanam,1,1,0,0,11
39912,itthiseṭṭho,itthisettho,1,1,0,0,11
39913,itthiratananti,itthiratananti,1,1,0,0,14
39914,maṇī,mani,36,34,2,0,4
39915,puppharāgādayo,puppharagadayo,1,1,0,0,14
39916,tabbhidā,tabbhida,5,4,1,0,8
39917,maṇino,manino,21,21,0,0,6
39918,bhāsanto,bhasanto,57,54,3,0,8
39919,puppharāgo,puppharago,1,0,1,0,10
39920,bhāsassa,bhasassa,1,0,1,0,8
39921,puppho,puppho,3,2,1,0,6
39922,para490,para490,50,50,0,0,7
39923,suvaṇṇādayo,suvannadayo,1,1,0,0,11
39924,ratanānyāhu,ratananyahu,1,1,0,0,11
39925,rattamaṇi,rattamani,10,10,0,0,9
39926,para491,para491,46,46,0,0,7
39927,sattaratanānaṃ,sattaratananam,4,3,1,0,14
39928,lohitaṅgo,lohitango,12,9,3,0,9
39929,lohitaṅgā,lohitanga,3,1,2,0,9
39930,rattamaṇiyaṃ,rattamaniyam,1,1,0,0,12
39931,M0.0331,M0.0331,40,40,0,0,7
39932,aṅgīyateti,angiyateti,1,1,0,0,10
39933,padumañcātra,padumancatra,1,1,0,0,12
39934,kokanadaṃ,kokanadam,37,25,12,0,9
39935,tabbaṇṇasadiso,tabbannasadiso,1,1,0,0,14
39936,padumarāgo,padumarago,2,1,1,0,10
39937,soṇaratanaṃ,sonaratanam,1,1,0,0,11
39938,lohitakopyatra,lohitakopyatra,1,1,0,0,14
39939,veḷuriye,veluriye,3,1,2,0,8
39940,tacasāro,tacasaro,5,4,1,0,8
39941,tabbaṇṇo,tabbanno,1,1,0,0,8
39942,vaṃsavaṇṇo,vamsavanno,3,2,1,0,10
39943,veḷu,velu,67,65,2,0,4
39944,veḷuriyo,veluriyo,63,60,3,0,8
39945,pavāḷe,pavale,1,1,0,0,6
39946,pavāḷopi,pavalopi,1,1,0,0,8
39947,para492,para492,50,50,0,0,7
39948,kabaramaṇimhi,kabaramanimhi,1,1,0,0,13
39949,masāragirimhi,masaragirimhi,1,1,0,0,13
39950,kabaro,kabaro,1,1,0,0,6
39951,muttāyaṃ,muttayam,1,1,0,0,8
39952,muttikaṃ,muttikam,6,5,1,0,8
39953,satthikā,satthika,10,10,0,0,8
39954,liṅgavacanānyativattanteti,lingavacananyativattanteti,1,1,0,0,26
39955,ratanapariyāyānaṃ,ratanapariyayanam,1,1,0,0,17
39956,ratanānaṃ,ratananam,134,130,4,0,9
39957,uppattikkamapaṇītakkamādino,uppattikkamapanitakkamadino,1,1,0,0,27
39958,abhāvadīpanatthaṃ,abhavadipanattham,4,4,0,0,17
39959,pittale,pittale,1,1,0,0,7
39960,rī,ri,12,11,1,0,2
39961,rītipi,ritipi,1,1,0,0,6
39962,rīti,riti,7,7,0,0,4
39963,pacāre,pacare,2,2,0,0,6
39964,sande,sande,1,1,0,0,5
39965,lohakiṭṭārakūṭesū,lohakittarakutesu,1,1,0,0,17
39966,ārasseva,arasseva,1,1,0,0,8
39967,kūṭo,kuto,27,21,6,0,4
39968,dabbasaddopyatra,dabbasaddopyatra,1,1,0,0,16
39969,abbhake,abbhake,1,1,0,0,7
39970,taṃsaññakattā,tamsannakatta,1,1,0,0,13
39971,abbhakaṃ,abbhakam,2,1,1,0,8
39972,meghambarābhidhānañca,meghambarabhidhananca,1,1,0,0,21
39973,gori,gori,1,1,0,0,4
39974,bījañca,bijanca,18,18,0,0,7
39975,girijatu,girijatu,1,1,0,0,8
39976,silājatupyatra,silajatupyatra,1,1,0,0,14
39977,para493,para493,58,58,0,0,7
39978,M0.0332,M0.0332,41,41,0,0,7
39979,lohe,lohe,3,2,1,0,4
39980,manogaṇādi,manoganadi,1,1,0,0,10
39981,kāḷañca,kalanca,2,2,0,0,7
39982,ayasañceti,ayasanceti,1,1,0,0,10
39983,kāḷāyasaṃ,kalayasam,6,4,2,0,9
39984,satthakaṃ,satthakam,19,18,1,0,9
39985,tikkhaṇaṃ,tikkhanam,1,1,0,0,9
39986,ayasaṃ,ayasam,63,58,5,0,6
39987,asmasāropyatra,asmasaropyatra,1,1,0,0,14
39988,satthamāyudhalohesū,satthamayudhalohesu,1,1,0,0,19
39989,sāmuddalavaṇetikkhaṃ,samuddalavanetikkham,1,1,0,0,20
39990,visalohājimukkake,visalohajimukkake,1,1,0,0,17
39991,paṇḍa,panda,2,1,1,0,5
39992,asmassa,asmassa,3,3,0,0,7
39993,kāḷāyasa,kalayasa,1,1,0,0,8
39994,mayo,mayo,14,12,2,0,4
39995,lohaṃ,loham,57,43,14,0,5
39996,asmasārañca,asmasaranca,1,1,0,0,11
39997,maramālāyaṃ,maramalayam,2,0,2,0,11
39998,klīvakaṇḍaṃ,klivakandam,1,1,0,0,11
39999,capale,capale,3,3,0,0,6
