0,namo,namo,708,666,42,0,4
1,tassa,tassa,38332,37204,1128,0,5
2,bhagavato,bhagavato,10513,10315,198,0,9
3,arahato,arahato,1548,1521,27,0,7
4,sammāsambuddhassa,sammasambuddhassa,882,874,8,0,17
5,namakkārapāḷi,namakkarapali,2,2,0,0,13
6,para1,para1,781,781,0,0,5
7,sugataṃ,sugatam,143,118,25,0,7
8,M0.0001,M0.0001,85,85,0,0,7
9,seṭṭhaṃ,settham,389,341,48,0,7
10,kusalaṃkusalaṃ,kusalamkusalam,5,4,1,0,14
11,jahaṃ,jaham,19,14,5,0,5
12,amataṃ,amatam,740,673,67,0,6
13,santaṃ,santam,828,696,132,0,6
14,asamaṃ,asamam,44,33,11,0,6
15,dadaṃ,dadam,102,85,17,0,5
16,saraṇaṃ,saranam,1622,1503,119,0,7
17,lokaṃ,lokam,2031,1871,160,0,5
18,araṇaṃ,aranam,211,208,3,0,6
19,karaṃ,karam,105,90,15,0,5
20,abhayaṃ,abhayam,176,164,12,0,7
21,ṭhānaṃ,thanam,3291,3030,261,0,6
22,nāyakaṃ,nayakam,49,47,2,0,7
23,name,name,132,123,9,0,4
24,para2,para2,726,726,0,0,5
25,nayanasubhagakāyaṅgaṃ,nayanasubhagakayangam,5,3,2,0,21
26,madhuravarasaropetaṃ,madhuravarasaropetam,4,3,1,0,20
27,amitaguṇagaṇādhāraṃ,amitagunaganadharam,4,3,1,0,19
28,dasabalamatulaṃ,dasabalamatulam,2,2,0,0,15
29,vande,vande,152,141,11,0,5
30,para3,para3,715,715,0,0,5
31,yo,yo,18681,17256,1425,0,2
32,buddho,buddho,3785,3676,109,0,6
33,dhitimāññadhārako,dhitimannadharako,2,2,0,0,17
34,saṃsāre,samsare,399,396,3,0,7
35,anubhosi,anubhosi,28,27,1,0,8
36,kāyikaṃ,kayikam,559,521,38,0,7
37,dukkhaṃ,dukkham,5949,5526,423,0,7
38,cetasikañca,cetasikanca,64,64,0,0,11
39,lokato,lokato,99,98,1,0,6
40,taṃ,tam,66329,62728,3601,0,3
41,naradevamaṅgalaṃ,naradevamangalam,4,3,1,0,16
42,para4,para4,696,696,0,0,5
43,bāttiṃsatilakkhaṇacitradehaṃ,battimsatilakkhanacitradeham,2,2,0,0,28
44,dehajjutiniggatapajjalantaṃ,dehajjutiniggatapajjalantam,3,2,1,0,27
45,paññādhitisīlaguṇoghavindaṃ,pannadhitisilagunoghavindam,2,2,0,0,27
46,munimantimajātiyuttaṃ,munimantimajatiyuttam,2,2,0,0,21
47,para5,para5,684,684,0,0,5
48,pātodayaṃ,patodayam,6,4,2,0,9
49,bāladivākaraṃva,baladivakaramva,3,3,0,0,15
50,majjhe,majjhe,1781,1681,100,0,6
51,yatīnaṃ,yatinam,14,12,2,0,7
52,lalitaṃ,lalitam,11,9,2,0,7
53,sirīhi,sirihi,8,8,0,0,6
54,puṇṇindusaṅkāsamukhaṃ,punnindusankasamukham,4,3,1,0,21
55,anejaṃ,anejam,54,36,18,0,6
56,vandāmi,vandami,132,128,4,0,7
57,sabbaññumahaṃ,sabbannumaham,2,2,0,0,13
58,munindaṃ,munindam,37,34,3,0,8
59,para6,para6,682,682,0,0,5
60,upetapuñño,upetapunno,7,6,1,0,10
61,M0.0002,M0.0002,82,82,0,0,7
62,varabodhimūle,varabodhimule,4,4,0,0,13
63,sasenamāraṃ,sasenamaram,5,4,1,0,11
64,sugato,sugato,739,670,69,0,6
65,jinitvā,jinitva,48,48,0,0,7
66,abojjhi,abojjhi,4,4,0,0,7
67,bodhiṃ,bodhim,318,286,32,0,6
68,aruṇodayamhi,arunodayamhi,4,4,0,0,12
69,namāmi,namami,79,79,0,0,6
70,mārajinaṃ,marajinam,6,5,1,0,9
71,abhaṅgaṃ,abhangam,12,10,2,0,8
72,para7,para7,674,674,0,0,5
73,rāgādichedāmalañāṇakhaggaṃ,ragadichedamalananakhaggam,1,1,0,0,26
74,satīsamaññāphalakābhigāhaṃ,satisamannaphalakabhigaham,3,3,0,0,26
75,sīloghalaṅkāravibhūsitaṃ,siloghalankaravibhusitam,5,4,1,0,24
76,namāmibhiññāvaramiddhupetaṃ,namamibhinnavaramiddhupetam,3,2,1,0,27
77,para8,para8,673,673,0,0,5
78,dayālayaṃ,dayalayam,5,3,2,0,9
79,sabbadhi,sabbadhi,238,217,21,0,8
80,dukkaraṃ,dukkaram,413,380,33,0,8
81,bhavaṇṇavātikkamamaggataṃ,bhavannavatikkamamaggatam,3,2,1,0,25
82,gataṃ,gatam,649,602,47,0,5
83,tilokanāthaṃ,tilokanatham,6,5,1,0,12
84,susamāhitaṃ,susamahitam,78,62,16,0,11
85,hitaṃ,hitam,301,270,31,0,5
86,samantacakkhuṃ,samantacakkhum,17,12,5,0,14
87,paṇamāmi,panamami,26,24,2,0,8
88,taṃmitaṃ,tammitam,3,2,1,0,8
89,para9,para9,661,661,0,0,5
90,tahiṃ,tahim,718,670,48,0,5
91,pāramisañcayaṃ,paramisancayam,6,5,1,0,14
92,cayaṃ,cayam,31,23,8,0,5
93,sabbhi,sabbhi,129,110,19,0,6
94,sukhappadaṃ,sukhappadam,12,10,2,0,11
95,padaṃ,padam,2147,1978,169,0,5
96,narānarānaṃ,naranaranam,7,6,1,0,11
97,sukhasambhavaṃ,sukhasambhavam,7,6,1,0,14
98,bhavaṃ,bhavam,1862,1738,124,0,6
99,namānamānaṃ,namanamanam,3,2,1,0,11
100,jinapuṅgavaṃ,jinapungavam,4,3,1,0,12
101,gavaṃ,gavam,157,144,13,0,5
102,para10,para10,654,654,0,0,6
103,maggaṅganāvaṃ,magganganavam,7,5,2,0,13
104,munidakkhanāviko,munidakkhanaviko,5,5,0,0,16
105,īhāphiyaṃ,ihaphiyam,6,5,1,0,9
106,ñāṇakarena,nanakarena,4,4,0,0,10
107,gāhako,gahako,9,9,0,0,6
108,āruyha,aruyha,396,395,1,0,6
109,tāya,taya,2754,2660,94,0,4
110,bahū,bahu,1755,1702,53,0,4
111,bhavaṇṇavā,bhavannava,9,9,0,0,10
112,tāresi,taresi,90,89,1,0,6
113,buddhamaghappahaṃ,buddhamaghappaham,2,2,0,0,17
114,para11,para11,647,647,0,0,6
115,samatiṃsatipāramisambharaṇaṃ,samatimsatiparamisambharanam,5,3,2,0,28
116,varabodhidume,varabodhidume,3,3,0,0,13
117,catusaccadasaṃ,catusaccadasam,5,4,1,0,14
118,varamiddhigataṃ,varamiddhigatam,5,4,1,0,15
119,naradevahitaṃ,naradevahitam,5,4,1,0,13
120,tibhavūpasamaṃ,tibhavupasamam,5,4,1,0,14
121,jinaṃ,jinam,197,186,11,0,5
122,para12,para12,630,630,0,0,6
123,satapuññajalakkhaṇikaṃ,satapunnajalakkhanikam,5,3,2,0,22
124,virajaṃ,virajam,275,234,41,0,7
125,gaganūpamadhiṃ,gaganupamadhim,5,4,1,0,14
126,dhitimerusamaṃ,dhitimerusamam,4,3,1,0,14
127,jalajūpamasītalasīlayutaṃ,jalajupamasitalasilayutam,4,3,1,0,25
128,pathavīsahanaṃ,pathavisahanam,5,4,1,0,14
129,para13,para13,633,633,0,0,6
130,M0.0003,M0.0003,82,82,0,0,7
131,sumati,sumati,20,17,3,0,6
132,dive,dive,11,10,1,0,4
133,divākarova,divakarova,3,3,0,0,10
134,sobhanto,sobhanto,10,10,0,0,8
135,ratijanane,ratijanane,4,4,0,0,10
136,silāsanamhi,silasanamhi,4,4,0,0,11
137,āsīno,asino,28,26,2,0,5
138,sivasukhadaṃ,sivasukhadam,5,4,1,0,12
139,adesi,adesi,12,11,1,0,5
140,dhammaṃ,dhammam,19963,19224,739,0,7
141,devānaṃ,devanam,1209,1158,51,0,7
142,tamasadisaṃ,tamasadisam,2,2,0,0,11
143,niccaṃ,niccam,1517,1414,103,0,6
144,para14,para14,627,627,0,0,6
145,pādapaṅkajamuduttalarājikehi,padapankajamuduttalarajikehi,2,2,0,0,28
146,lokehi,lokehi,18,18,0,0,6
147,tīhivikalehi,tihivikalehi,2,2,0,0,12
148,nirākulehi,nirakulehi,5,5,0,0,10
149,sampāpuṇe,sampapune,6,4,2,0,9
150,nirupameyyatameva,nirupameyyatameva,2,2,0,0,17
151,nātho,natho,238,223,15,0,5
152,sabbalokamahitaṃ,sabbalokamahitam,5,4,1,0,16
153,para15,para15,606,606,0,0,6
154,buddhaṃ,buddham,2118,2048,70,0,7
155,narānarasamosaraṇaṃ,naranarasamosaranam,5,3,2,0,19
156,dhitattaṃ,dhitattam,5,4,1,0,9
157,paññāpadīpajutiyā,pannapadipajutiya,8,8,0,0,17
158,vihatandhakāraṃ,vihatandhakaram,6,5,1,0,15
159,atthābhikāmanaradevahitāvahaṃ,atthabhikamanaradevahitavaham,2,2,0,0,29
160,kāruṇikamaggamanantañāṇaṃ,karunikamaggamanantananam,2,2,0,0,25
161,para16,para16,606,606,0,0,6
162,akhilaguṇanidhāno,akhilagunanidhano,5,4,1,0,17
163,munindopagantvā,munindopagantva,2,2,0,0,15
164,vanamisipatanavhaṃ,vanamisipatanavham,3,2,1,0,18
165,saññatānaṃ,sannatanam,24,22,2,0,10
166,niketaṃ,niketam,56,50,6,0,7
167,tahimakusalachedaṃ,tahimakusalachedam,2,2,0,0,18
168,dhammacakkaṃ,dhammacakkam,533,471,62,0,12
169,pavatto,pavatto,666,655,11,0,7
170,tamatulamabhikantaṃ,tamatulamabhikantam,3,2,1,0,19
171,vandaneyyaṃ,vandaneyyam,4,3,1,0,11
172,para17,para17,584,584,0,0,6
173,suciparivāritaṃ,suciparivaritam,5,3,2,0,15
174,surucirappabhāhi,surucirappabhahi,4,4,0,0,16
175,rattaṃ,rattam,147,138,9,0,6
176,sirivisarālayaṃ,sirivisaralayam,5,4,1,0,15
177,gupitamindriyehupetaṃ,gupitamindriyehupetam,3,2,1,0,21
178,ravisasimaṇḍalappabhutilakkhaṇopacittaṃ,ravisasimandalappabhutilakkhanopacittam,4,3,1,0,39
179,suranarapūjitaṃ,suranarapujitam,4,3,1,0,15
180,sugatamādaraṃ,sugatamadaram,2,2,0,0,13
181,para18,para18,565,565,0,0,6
182,maggoḷumpena,maggolumpena,6,5,1,0,12
183,muhapaṭighāsādiullolavīciṃ,muhapatighasadiullolavicim,3,3,0,0,26
184,saṃsāroghaṃ,samsarogham,14,13,1,0,11
185,tari,tari,11,11,0,0,4
186,tamabhayaṃ,tamabhayam,2,2,0,0,10
187,pārapattaṃ,parapattam,6,5,1,0,10
188,pajānaṃ,pajanam,114,81,33,0,7
189,tāṇaṃ,tanam,162,136,26,0,5
190,leṇaṃ,lenam,190,157,33,0,5
191,asamasaraṇaṃ,asamasaranam,6,5,1,0,12
192,ekatitthaṃ,ekatittham,7,6,1,0,10
193,patiṭṭhaṃ,patittham,184,175,9,0,9
194,puññakkhettaṃ,punnakkhettam,230,220,10,0,13
195,paramasukhadaṃ,paramasukhadam,5,4,1,0,14
196,dhammarājaṃ,dhammarajam,21,19,2,0,11
197,para19,para19,562,562,0,0,6
198,kaṇḍambaṃmūle,kandambammule,4,3,1,0,13
199,parahitakaro,parahitakaro,6,6,0,0,12
200,munindo,munindo,81,72,9,0,7
201,nisinno,nisinno,2424,2388,36,0,7
202,accheraṃ,accheram,42,36,6,0,8
203,sīghaṃ,sigham,635,609,26,0,6
204,nayanasubhagaṃ,nayanasubhagam,9,8,1,0,14
205,ākulaṇṇaggijālaṃ,akulannaggijalam,6,5,1,0,16
206,dujjāladdhaṃsaṃ,dujjaladdhamsam,5,4,1,0,15
207,munibhijahitaṃ,munibhijahitam,4,3,1,0,14
208,pāṭiheraṃ,patiheram,36,32,4,0,9
209,akāsi,akasi,1938,1913,25,0,5
210,paramaratijaṃ,paramaratijam,5,4,1,0,13
211,iddhidhammehupetaṃ,iddhidhammehupetam,3,2,1,0,18
212,para20,para20,562,562,0,0,6
213,munindakko,munindakko,16,15,1,0,10
214,M0.0004,M0.0004,82,82,0,0,7
215,yveko,yveko,2,2,0,0,5
216,dayudayaruṇo,dayudayaruno,7,6,1,0,12
217,ñāṇavitthiṇṇabimbo,nanavitthinnabimbo,5,5,0,0,18
218,vineyyappāṇoghaṃ,vineyyappanogham,7,6,1,0,16
219,kamalakathitaṃ,kamalakathitam,5,5,0,0,14
220,dhammaraṃsīvarehi,dhammaramsivarehi,3,3,0,0,17
221,subodhesī,subodhesi,2,2,0,0,9
222,suddhe,suddhe,76,73,3,0,6
223,tibhavakuhare,tibhavakuhare,4,4,0,0,13
224,byāpitakkittinañca,byapitakkittinanca,2,2,0,0,18
225,tilokekaccakkhuṃ,tilokekaccakkhum,5,4,1,0,16
226,dukhamasahanaṃ,dukhamasahanam,6,5,1,0,14
227,mahesiṃ,mahesim,77,68,9,0,7
228,para21,para21,561,561,0,0,6
229,jino,jino,734,692,42,0,4
230,anekajātiyaṃ,anekajatiyam,5,4,1,0,12
231,saputtadāramaṅgajīvitampi,saputtadaramangajivitampi,3,3,0,0,25
232,bodhipemato,bodhipemato,5,5,0,0,11
233,alaggamānaso,alaggamanaso,9,9,0,0,12
234,adāsiyeva,adasiyeva,10,10,0,0,9
235,atthikassa,atthikassa,12,12,0,0,10
236,dānapāramiṃ,danaparamim,76,71,5,0,11
237,tato,tato,18635,17922,713,0,4
238,paraṃ,param,5269,4973,296,0,5
239,apūri,apuri,3,3,0,0,5
240,sīlapāramādikampi,silaparamadikampi,3,3,0,0,17
241,tāsamiddhiyopayātamaggataṃ,tasamiddhiyopayatamaggatam,3,2,1,0,26
242,tamekadīpakaṃ,tamekadipakam,3,2,1,0,13
243,para22,para22,553,553,0,0,6
244,devādevātidevaṃ,devadevatidevam,6,4,2,0,15
245,nidhanavapudharaṃ,nidhanavapudharam,5,4,1,0,17
246,mārabhaṅgaṃ,marabhangam,5,4,1,0,11
247,dīpaṃ,dipam,257,219,38,0,5
248,jayavarasayane,jayavarasayane,3,3,0,0,14
249,bodhipattaṃdhipattaṃ,bodhipattamdhipattam,3,2,1,0,20
250,brahmābrahmāgatānaṃ,brahmabrahmagatanam,3,2,1,0,19
251,varagirakathikaṃ,varagirakathikam,4,3,1,0,16
252,pāpahīnaṃ,papahinam,5,4,1,0,9
253,pahīnaṃ,pahinam,385,360,25,0,7
254,lokālokābhirāmaṃ,lokalokabhiramam,4,3,1,0,16
255,satatamabhiname,satatamabhiname,2,2,0,0,15
256,para23,para23,551,551,0,0,6
257,nigrodhabimbo,nigrodhabimbo,7,6,1,0,13
258,mudukaracaraṇo,mudukaracarano,5,5,0,0,14
259,brahmaghoseṇijaṅgho,brahmaghosenijangho,3,3,0,0,19
260,kosacchādaṅgajāto,kosacchadangajato,5,5,0,0,17
261,punarapi,punarapi,10,10,0,0,8
262,suppatiṭṭhitapādo,suppatitthitapado,24,21,3,0,17
263,mūdodātuṇṇalomo,mudodatunnalomo,2,2,0,0,15
264,athamapi,athamapi,4,4,0,0,8
265,brahmujuggattabhāvo,brahmujuggattabhavo,5,5,0,0,19
266,nīlakkhī,nilakkhi,6,6,0,0,8
267,dīghapaṇhī,dighapanhi,4,4,0,0,10
268,sukhumamalachavī,sukhumamalachavi,5,5,0,0,16
269,thomyarasaggasaggī,thomyarasaggasaggi,4,4,0,0,18
270,para24,para24,549,549,0,0,6
271,cattālīsaggadanto,cattalisaggadanto,5,5,0,0,17
272,samakalapanajo,samakalapanajo,5,5,0,0,14
273,antaraṃsappapīno,antaramsappapino,4,4,0,0,16
274,cakkenaṅkitapādo,cakkenankitapado,4,4,0,0,16
275,aviraḷadasano,aviraladasano,5,5,0,0,13
276,mārajussaṅkhapādo,marajussankhapado,3,3,0,0,17
277,tiṭṭhanto,titthanto,73,71,2,0,9
278,M0.0005,M0.0005,83,83,0,0,7
279,nonamantobhayakaramudunā,nonamantobhayakaramuduna,3,2,1,0,24
280,jaṇṇukānāmasanto,jannukanamasanto,2,2,0,0,16
281,vaṭṭakkhandho,vattakkhandho,5,5,0,0,13
282,gotaruṇapakhumako,gotarunapakhumako,4,4,0,0,17
283,sīhapubbaḍḍhakāyo,sihapubbaddhakayo,7,7,0,0,17
284,para25,para25,542,542,0,0,6
285,sattappīno,sattappino,2,2,0,0,10
286,ca,ca,167250,162121,5129,0,2
287,dīghaṅguli,dighanguli,10,9,1,0,10
288,matha,matha,26,15,11,0,5
289,lomakūpekalomo,lomakupekalomo,5,5,0,0,14
290,sampannodātadāṭho,sampannodatadatho,4,4,0,0,17
291,kanakasamataco,kanakasamataco,3,3,0,0,14
292,nīlamuddhaggalomo,nilamuddhaggalomo,6,6,0,0,17
293,sambuddho,sambuddho,435,424,11,0,9
294,thūlajivho,thulajivho,5,5,0,0,10
295,atha,atha,22309,21723,586,0,4
296,sīhahanuko,sihahanuko,6,6,0,0,10
297,jālikappādahattho,jalikappadahattho,4,4,0,0,17
298,uṇhīsasīso,unhisasiso,23,22,1,0,10
299,itiguṇasahitaṃ,itigunasahitam,3,2,1,0,14
300,para26,para26,541,541,0,0,6
301,buddhobuddhotighoso,buddhobuddhotighoso,5,5,0,0,19
302,atidulabhataro,atidulabhataro,6,6,0,0,14
303,kā,ka,1542,1413,129,0,2
304,kathā,katha,1093,1043,50,0,5
305,buddhabhāvo,buddhabhavo,13,13,0,0,11
306,loke,loke,5194,4952,242,0,4
307,tasmā,tasma,20795,20405,390,0,5
308,vibhāvī,vibhavi,51,45,6,0,7
309,vividhahitasukhaṃ,vividhahitasukham,6,5,1,0,17
310,sādhavo,sadhavo,67,66,1,0,7
311,patthayantā,patthayanta,16,15,1,0,11
312,iṭṭhaṃ,ittham,184,168,16,0,6
313,atthaṃ,attham,3554,3338,216,0,6
314,vahantaṃ,vahantam,17,15,2,0,8
315,suranaramahitaṃ,suranaramahitam,6,5,1,0,15
316,nibbhayaṃ,nibbhayam,42,41,1,0,9
317,dakkhiṇeyyaṃ,dakkhineyyam,69,60,9,0,12
318,lokānaṃ,lokanam,43,41,2,0,7
319,nandivaḍḍhaṃ,nandivaddham,4,3,1,0,12
320,dasabalamasamaṃ,dasabalamasamam,3,3,0,0,15
321,namassantu,namassantu,4,4,0,0,10
322,para27,para27,529,529,0,0,6
323,puññenetena,punnenetena,4,3,1,0,11
324,sohaṃ,soham,636,615,21,0,5
325,nipuṇamati,nipunamati,6,6,0,0,10
326,sato,sato,1569,1404,165,0,4
327,samparāye,samparaye,112,102,10,0,9
328,titto,titto,29,28,1,0,5
329,dakkho,dakkho,149,141,8,0,6
330,diṭṭhujjupañño,ditthujjupanno,4,4,0,0,14
331,avikalavīriyo,avikalaviriyo,3,3,0,0,13
332,bhogavā,bhogava,25,25,0,0,7
333,saṃvibhāgī,samvibhagi,37,35,2,0,10
334,tikkho,tikkho,12,11,1,0,6
335,sūro,suro,150,138,12,0,4
336,dhitatto,dhitatto,5,5,0,0,8
337,saparahitacaro,saparahitacaro,3,3,0,0,14
338,dīghajīvī,dighajivi,6,6,0,0,9
339,arogo,arogo,253,240,13,0,5
340,dhañño,dhanno,16,14,2,0,6
341,vaṇṇo,vanno,1174,1094,80,0,5
342,yasassī,yasassi,113,109,4,0,7
343,atibalavadharo,atibalavadharo,4,4,0,0,14
344,kittimā,kittima,12,12,0,0,7
345,khantupeto,khantupeto,6,6,0,0,10
346,para28,para28,527,527,0,0,6
347,saddho,saddho,478,457,21,0,6
348,M0.0006,M0.0006,82,82,0,0,7
349,dātaṅgupeto,datangupeto,6,5,1,0,11
350,paramasiridharo,paramasiridharo,3,3,0,0,15
351,diṭṭhadhamme,ditthadhamme,66,65,1,0,12
352,viratto,viratto,35,35,0,0,7
353,lajjī,lajji,195,180,15,0,5
354,kalyāṇamitto,kalyanamitto,149,141,8,0,12
355,abhiratakusalo,abhiratakusalo,5,5,0,0,14
356,pañcasīlādirakkho,pancasiladirakkho,4,4,0,0,17
357,appiccho,appiccho,165,154,11,0,8
358,appakodho,appakodho,6,6,0,0,9
359,ativujuhadayo,ativujuhadayo,4,4,0,0,13
360,iddhimā,iddhima,205,198,7,0,7
361,appameyyo,appameyyo,130,124,6,0,9
362,pāsaṃso,pasamso,163,163,0,0,7
363,pemavāco,pemavaco,4,4,0,0,8
364,sujanaguṇavidū,sujanagunavidu,4,4,0,0,14
365,māmako,mamako,30,26,4,0,6
366,so,so,50053,48171,1882,0,2
367,bhaveyyaṃ,bhaveyyam,238,233,5,0,9
368,para29,para29,516,516,0,0,6
369,itthaṃ,ittham,838,811,27,0,6
370,asaṅkhaye,asankhaye,3,3,0,0,9
371,nātha,natha,45,29,16,0,5
372,guṇe,gune,553,519,34,0,4
373,lakkhaṇadīpite,lakkhanadipite,3,3,0,0,14
374,gāthāsu,gathasu,194,194,0,0,7
375,sūcakāsveka,sucakasveka,2,2,0,0,11
376,gāthampi,gathampi,5,5,0,0,8
377,sarate,sarate,2,2,0,0,6
378,budho,budho,89,80,9,0,5
379,para30,para30,521,521,0,0,6
380,caturāpāyamutto,caturapayamutto,3,3,0,0,15
381,sādhakatthadvayassa,sadhakatthadvayassa,3,2,1,0,19
382,hatūpaddavajālo,hatupaddavajalo,4,3,1,0,15
383,lābhī,labhi,575,560,15,0,5
384,hitasukhassa,hitasukhassa,18,17,1,0,12
385,para31,para31,517,517,0,0,6
386,adhipo,adhipo,12,10,2,0,6
387,naradevānaṃ,naradevanam,14,9,5,0,11
388,catudīpissaropi,catudipissaropi,4,3,1,0,15
389,vā,va,119999,115560,4439,0,2
390,bhaveyya,bhaveyya,1537,1511,26,0,8
391,antime,antime,29,24,5,0,6
392,dehe,dehe,26,25,1,0,4
393,tamaññaṃ,tamannam,2,2,0,0,8
394,setachattakaṃ,setachattakam,6,5,1,0,13
395,para32,para32,491,491,0,0,6
396,bhāvanāyānamāruyha,bhavanayanamaruyha,2,2,0,0,18
397,samamessati,samamessati,2,2,0,0,11
398,subbato,subbato,35,32,3,0,7
399,imasmiṃ,imasmim,5938,5755,183,0,7
400,attabhāvepi,attabhavepi,5,5,0,0,11
401,dīghajīviko,dighajiviko,2,2,0,0,11
402,para33,para33,491,491,0,0,6
403,pūjito,pujito,244,232,12,0,6
404,sabbalokehi,sabbalokehi,6,6,0,0,11
405,bhāvanābhiratīmano,bhavanabhiratimano,2,2,0,0,18
406,janappiyo,janappiyo,3,3,0,0,9
407,manāpo,manapo,278,270,8,0,6
408,kathākhiladhāraṇe,kathakhiladharane,2,2,0,0,17
409,niṭṭhitā,nitthita,7889,7882,7,0,8
410,namakkāraṭīkā,namakkaratika,2,2,0,0,13
411,sugatantyādivaṇṇehi,sugatantyadivannehi,1,1,0,0,19
412,M0.0007,M0.0007,83,83,0,0,7
413,pasatthañca,pasatthanca,2,2,0,0,11
414,sukhaddadaṃ,sukhaddadam,1,1,0,0,11
415,vandantānaṃ,vandantanam,5,5,0,0,11
416,natvā,natva,19,17,2,0,5
417,suddhaṃ,suddham,568,523,45,0,7
418,gaṇuttamaṃ,ganuttamam,5,4,1,0,10
419,namakkāraṃ,namakkaram,26,25,1,0,10
420,hitatthīhi,hitatthihi,2,2,0,0,10
421,porāṇācariyehi,poranacariyehi,3,3,0,0,14
422,likhitvā,likhitva,117,114,3,0,8
423,ṭhapitaṃ,thapitam,533,512,21,0,8
424,puñña,punna,25,21,4,0,5
425,buddhiyā,buddhiya,104,103,1,0,8
426,tena,tena,25266,24358,908,0,4
427,vandinaṃ,vandinam,1,1,0,0,8
428,tassatthavaṇṇanaṃ,tassatthavannanam,2,2,0,0,17
429,kassaṃ,kassam,49,45,4,0,6
430,gambhīratthasubodhanaṃ,gambhiratthasubodhanam,1,1,0,0,22
431,movipunāmena,movipunamena,1,1,0,0,12
432,santena,santena,47,47,0,0,7
433,sīlupetena,silupetena,1,1,0,0,10
434,yācito,yacito,423,416,7,0,6
435,vaṇṇantopi,vannantopi,1,1,0,0,10
436,tassatthaṃ,tassattham,22,19,3,0,10
437,aṭṭhakathādisu,atthakathadisu,1,1,0,0,14
438,vuttañāyena,vuttanayena,1,1,0,0,11
439,kassāmi,kassami,20,17,3,0,7
440,saddhā,saddha,1378,1309,69,0,6
441,suṇātha,sunatha,533,523,10,0,7
442,namanaṃ,namanam,13,8,5,0,7
443,namatītī,namatiti,1,1,0,0,8
444,namatī,namati,7,6,1,0,6
445,kāronti,karonti,1,1,0,0,7
446,tāhīti,tahiti,10,1,9,0,6
447,namakkāroti,namakkaroti,1,1,0,0,11
448,vuccati,vuccati,13632,13363,269,0,7
449,tañca,tanca,2456,2313,143,0,5
450,buddhaghosācari,buddhaghosacari,1,1,0,0,15
451,yena,yena,8418,7870,548,0,4
452,pubbasutaṃ,pubbasutam,1,1,0,0,10
453,kataṃ,katam,6998,6711,287,0,5
454,buddhaghosuppattiyañca,buddhaghosuppattiyanca,1,1,0,0,22
455,pana,pana,76652,74550,2102,0,4
456,kathādisu,kathadisu,1,1,0,0,9
457,na,na,150852,141162,9690,0,2
458,diṭṭhaṃ,dittham,1001,894,107,0,7
459,katakāraṇaṃ,katakaranam,17,16,1,0,11
460,hitatthikehi,hitatthikehi,1,1,0,0,12
461,porāṇācariyehī,poranacariyehi,1,1,0,0,14
462,ṭhapitanti,thapitanti,33,33,0,0,10
463,mayā,maya,5639,5517,122,0,4
464,vuttaṃ,vuttam,38990,38223,767,0,6
465,kāraṇaṃ,karanam,3164,2974,190,0,7
466,viññūhī,vinnuhi,80,78,2,0,7
467,vicāretvā,vicaretva,179,177,2,0,9
468,vijānitanti,vijanitanti,1,1,0,0,11
469,ka,ka,12004,11858,146,0,2
470,idāni,idani,7778,7705,73,0,5
471,M0.0008,M0.0008,85,85,0,0,7
472,paṭhamaṃ,pathamam,6052,5796,256,0,8
473,tāva,tava,6572,6372,200,0,4
474,sugatantyādīhi,sugatantyadihi,2,2,0,0,14
475,aṭṭhārasahi,attharasahi,204,198,6,0,11
476,guṇehi,gunehi,389,378,11,0,6
477,thometvā,thometva,50,49,1,0,8
478,buddhassa,buddhassa,2675,2617,58,0,9
479,vanditukāmena,vanditukamena,1,1,0,0,13
480,sugatantiādi,sugatantiadi,1,1,0,0,12
481,gāthādvayaṃ,gathadvayam,62,61,1,0,11
482,āraddhaṃ,araddham,707,677,30,0,8
483,ayaṃ,ayam,27069,25589,1480,0,4
484,sabbapādādiyamakapathyā,sabbapadadiyamakapathya,1,1,0,0,23
485,vattagāthāti,vattagathati,1,1,0,0,12
486,daṭṭhabbaṃ,datthabbam,3901,3839,62,0,10
487,yamakaṃ,yamakam,103,85,18,0,7
488,subodhālaṅkāre,subodhalankare,22,18,4,0,14
489,kiliṭṭhadosanti,kilitthadosanti,1,1,0,0,15
490,vuttañhi,vuttanhi,527,527,0,0,8
491,tattha,tattha,54675,53217,1458,0,6
492,yaṃ,yam,22214,20339,1875,0,3
493,kiliṭṭhapadaṃ,kilitthapadam,8,4,4,0,13
494,mandā,manda,142,137,5,0,5
495,bhidheyyaṃ,bhidheyyam,2,2,0,0,10
496,yamakādikaṃ,yamakadikam,6,3,3,0,11
497,kiliṭṭhapadadoseva,kilitthapadadoseva,2,1,1,0,18
498,tampi,tampi,1818,1774,44,0,5
499,anto,anto,1963,1831,132,0,4
500,karīyatī,kariyati,15,12,3,0,8
501,iti,iti,282298,280859,1439,0,3
502,panettha,panettha,2891,2832,59,0,8
503,patītasaddaracitattāyeva,patitasaddaracitattayeva,3,3,0,0,24
504,pasādaguṇa,pasadaguna,1,1,0,0,10
505,saṅkhātena,sankhatena,23,23,0,0,10
506,saddālaṅkārena,saddalankarena,3,3,0,0,14
507,saṃyuttā,samyutta,55,53,2,0,8
508,hoti,hoti,72390,71366,1024,0,4
509,suvuttanti,suvuttanti,11,11,0,0,10
510,evaṃ,evam,55000,52356,2644,0,4
511,parāsu,parasu,12,11,1,0,6
512,yamakagāthāsu,yamakagathasu,1,1,0,0,13
513,punā,puna,29,28,1,0,4
514,laṅkāre,lankare,4,2,2,0,7
515,patītasaddaracitaṃ,patitasaddaracitam,5,2,3,0,18
516,siliṭṭhapadasandhikaṃ,silitthapadasandhikam,5,2,3,0,21
517,pasādaguṇasaṃyuttaṃ,pasadagunasamyuttam,4,2,2,0,19
518,matamedisaṃ,matamedisam,1,1,0,0,11
519,sobhanagamanattā,sobhanagamanatta,20,14,6,0,16
520,sundaraṃ,sundaram,463,440,23,0,8
521,gatattā,gatatta,191,189,2,0,7
522,sammā,samma,3620,3367,253,0,5
523,hi,hi,40463,38979,1484,0,2
524,sobhanaṃ,sobhanam,155,148,7,0,8
525,ariyamaggena,ariyamaggena,212,209,3,0,12
526,gacchatīti,gacchatiti,1087,904,183,0,10
527,sugatoti,sugatoti,40,24,16,0,8
528,supubbo,supubbo,3,3,0,0,7
529,gamudhātu,gamudhatu,6,6,0,0,9
530,ta,ta,514,232,282,0,2
531,susaddo,susaddo,5,5,0,0,7
532,sobhanattho,sobhanattho,3,3,0,0,11
533,ariyamaggagamanena,ariyamaggagamanena,2,2,0,0,18
534,parisuddhaṃ,parisuddham,507,449,58,0,11
535,anavajjaṃ,anavajjam,163,148,15,0,9
536,khemaṃ,khemam,309,257,52,0,6
537,disaṃ,disam,678,632,46,0,5
538,asajjamāno,asajjamano,88,79,9,0,10
539,gatoti,gatoti,378,284,94,0,6
540,attho,attho,29371,28922,449,0,5
541,gamanaṃ,gamanam,722,674,48,0,7
542,duvidhaṃ,duvidham,599,569,30,0,8
543,kāyagamanaṃ,kayagamanam,15,13,2,0,11
544,ñāṇagamanañcāti,nanagamanancati,1,1,0,0,15
545,veneyyajanupasaṅkamanaṃ,veneyyajanupasankamanam,6,6,0,0,23
546,ekantena,ekantena,526,510,16,0,8
547,tesaṃ,tesam,24144,23060,1084,0,5
548,nipphāda,nipphada,1,1,0,0,8
549,nato,nato,7,7,0,0,4
550,kāyena,kayena,2182,2044,138,0,6
551,nāma,nama,44599,43319,1280,0,4
552,sayambhū,sayambhu,171,161,10,0,8
553,ñāṇena,nanena,1176,1106,70,0,6
554,sakalampi,sakalampi,177,175,2,0,9
555,pariññābhisamayavasena,parinnabhisamayavasena,27,27,0,0,22
556,parijānanato,parijananato,3,3,0,0,12
557,ñāṇagamanaṃ,nanagamanam,14,13,1,0,11
558,idha,idha,14568,13957,611,0,4
559,adhippetaṃ,adhippetam,673,625,48,0,10
560,aṅguttaraṭīkāyaṃ,anguttaratikayam,9,2,7,0,16
561,etassāti,etassati,942,894,48,0,8
562,ārammaṇakaraṇavasena,arammanakaranavasena,146,145,1,0,20
563,nibbānaṃ,nibbanam,3439,3207,232,0,8
564,M0.0009,M0.0009,84,84,0,0,7
565,aviparītaṃ,aviparitam,128,127,1,0,10
566,cesa,cesa,187,183,4,0,4
567,sammāsaddattho,sammasaddattho,2,2,0,0,14
568,maggena,maggena,986,942,44,0,7
569,ye,ye,12650,11822,828,0,2
570,kilesā,kilesa,1593,1555,38,0,6
571,pahīnā,pahina,937,915,22,0,6
572,te,te,38329,36591,1738,0,2
573,kilese,kilese,1106,1077,29,0,6
574,puneti,puneti,42,41,1,0,6
575,pacceti,pacceti,129,113,16,0,7
576,paccāgacchatīti,paccagacchatiti,31,25,6,0,15
577,āgacchatīti,agacchatiti,143,115,28,0,11
578,dīpaṅkarapādamūlato,dipankarapadamulato,17,17,0,0,19
579,pabhuti,pabhuti,467,447,20,0,7
580,yāva,yava,5257,4982,275,0,4
581,bodhimaṇḍā,bodhimanda,6,6,0,0,10
582,samatiṃsapāramipūrikāya,samatimsaparamipurikaya,1,1,0,0,23
583,sammāpaṭipattiyā,sammapatipattiya,121,119,2,0,16
584,sabbalokassa,sabbalokassa,83,79,4,0,12
585,hitasukhameva,hitasukhameva,11,9,2,0,13
586,karonto,karonto,2117,2076,41,0,7
587,sassataṃ,sassatam,234,220,14,0,8
588,ucchedaṃ,ucchedam,132,124,8,0,8
589,kāmasukhaṃ,kamasukham,92,82,10,0,10
590,attakilamathañcāti,attakilamathancati,1,1,0,0,18
591,ime,ime,8914,8592,322,0,3
592,cante,cante,6,4,2,0,5
593,anupagacchanto,anupagacchanto,20,16,4,0,14
594,āgatoti,agatoti,277,233,44,0,7
595,namāmīti,namamiti,39,38,1,0,8
596,sambandho,sambandho,4771,4754,17,0,9
597,puna,puna,9309,9031,278,0,4
598,gadattā,gadatta,12,12,0,0,7
599,gadati,gadati,22,22,0,0,6
600,bhāsatīti,bhasatiti,130,81,49,0,9
601,supubbagadadhātu,supubbagadadhatu,1,1,0,0,16
602,bhāsāyaṃ,bhasayam,15,1,14,0,8
603,viyattiyaṃ,viyattiyam,40,32,8,0,10
604,vācāyaṃ,vacayam,56,45,11,0,7
605,dassa,dassa,49,45,4,0,5
606,to,to,517,458,59,0,2
607,chasu,chasu,890,844,46,0,5
608,vācāsu,vacasu,2,2,0,0,6
609,yuttaṭṭhāne,yuttatthane,53,52,1,0,11
610,yuttameva,yuttameva,82,81,1,0,9
611,dvivācaṃ,dvivacam,5,5,0,0,8
612,majjhimapaṇṇāsapāḷiyaṃ,majjhimapannasapaliyam,1,1,0,0,22
613,abhayarājakumārasutte,abhayarajakumarasutte,1,0,1,0,21
614,rājakumāra,rajakumara,225,223,2,0,10
615,tathāgato,tathagato,3177,2960,217,0,9
616,vācaṃ,vacam,1020,935,85,0,5
617,jānāti,janati,4321,4204,117,0,6
618,abhūtaṃ,abhutam,273,240,33,0,7
619,atacchaṃ,ataccham,58,46,12,0,8
620,anatthasaṃhitaṃ,anatthasamhitam,102,86,16,0,15
621,sā,sa,12405,11817,588,0,2
622,paresaṃ,paresam,1750,1688,62,0,7
623,appiyā,appiya,104,100,4,0,6
624,amanāpā,amanapa,103,97,6,0,7
625,bhāsati,bhasati,945,919,26,0,7
626,yampi,yampi,625,605,20,0,5
627,bhūtaṃ,bhutam,499,436,63,0,6
628,tacchaṃ,taccham,190,177,13,0,7
629,yañca,yanca,1369,1290,79,0,5
630,kho,kho,46219,44641,1578,0,3
631,atthasaṃhitaṃ,atthasamhitam,95,77,18,0,13
632,tatrakālaññū,tatrakalannu,1,1,0,0,12
633,tassā,tassa,5289,5118,171,0,5
634,vācāya,vacaya,2013,1953,60,0,6
635,veyyākaraṇāya,veyyakaranaya,39,39,0,0,13
636,piyā,piya,468,441,27,0,4
637,manāpā,manapa,351,339,12,0,6
638,M0.0010,M0.0010,83,83,0,0,7
639,tatra,tatra,2757,2603,154,0,5
640,kālaññū,kalannu,67,58,9,0,7
641,veyyākaraṇāyā,veyyakaranaya,14,14,0,0,13
642,ettha,ettha,20197,19816,381,0,5
643,pāḷiyaṃ,paliyam,2256,1932,324,0,7
644,panesā,panesa,321,302,19,0,6
645,sukhaggahaṇatthaṃ,sukhaggahanattham,53,53,0,0,17
646,saṅkhepena,sankhepena,181,177,4,0,10
647,veditabbā,veditabba,4216,4122,94,0,9
648,kathaṃ,katham,9132,8654,478,0,6
649,hesā,hesa,130,116,14,0,4
650,abhūtā,abhuta,19,19,0,0,6
651,anatthasaṃhitā,anatthasamhita,20,20,0,0,14
652,vācā,vaca,858,810,48,0,4
653,bhūtā,bhuta,328,302,26,0,5
654,attha,attha,106,80,26,0,5
655,saṃhitā,samhita,10,10,0,0,7
656,atthasaṃhitā,atthasamhita,23,23,0,0,12
657,cāti,cati,5233,3854,1379,0,4
658,chabbidhā,chabbidha,76,73,3,0,9
659,hotīti,hotiti,9348,7652,1696,0,6
660,acoraṃyeva,acoramyeva,4,4,0,0,10
661,coro,coro,378,369,9,0,4
662,ayantiādivasena,ayantiadivasena,3,3,0,0,15
663,vattabbavācā,vattabbavaca,5,5,0,0,12
664,paṭhamavācā,pathamavaca,3,2,1,0,11
665,coraṃyeva,coramyeva,2,2,0,0,9
666,dutiyavācā,dutiyavaca,3,1,2,0,10
667,akatapuññatāya,akatapunnataya,7,7,0,0,14
668,duggato,duggato,67,64,3,0,7
669,dubbaṇṇo,dubbanno,97,94,3,0,8
670,appesakkho,appesakkho,9,9,0,0,10
671,ṭhatvāpi,thatvapi,27,27,0,0,8
672,puññaṃ,punnam,1371,1277,94,0,6
673,karoti,karoti,5838,5686,152,0,6
674,dutiyacittavāre,dutiyacittavare,10,10,0,0,15
675,catūhi,catuhi,2667,2546,121,0,6
676,apāyehi,apayehi,20,18,2,0,7
677,muccissatīti,muccissatiti,10,8,2,0,12
678,mahājanassa,mahajanassa,549,539,10,0,11
679,atthapurekkhārena,atthapurekkharena,2,2,0,0,17
680,dhammapurekkhārena,dhammapurekkharena,2,2,0,0,18
681,anusāsanīpurekkhārena,anusasanipurekkharena,2,2,0,0,21
682,tatiyavācā,tatiyavaca,3,1,2,0,10
683,eko,eko,7370,7054,316,0,3
684,dhutto,dhutto,56,54,2,0,6
685,āhamayhaṃ,ahamayham,1,1,0,0,9
686,bho,bho,4797,4658,139,0,3
687,mātu,matu,515,495,20,0,4
688,mayi,mayi,798,781,17,0,4
689,kucchigate,kucchigate,28,28,0,0,10
690,kapiṭṭhaphaladohaḷo,kapitthaphaladohalo,1,1,0,0,19
691,ahosi,ahosi,8200,8118,82,0,5
692,aññaṃ,annam,5387,5002,385,0,5
693,kapiṭṭhahārakaṃ,kapitthaharakam,2,2,0,0,15
694,alabhamānā,alabhamana,118,118,0,0,10
695,maṃyeva,mamyeva,23,23,0,0,7
696,pesesi,pesesi,695,692,3,0,6
697,ahaṃ,aham,11173,10786,387,0,4
698,gantvā,gantva,8185,8124,61,0,6
699,rukkhaṃ,rukkham,529,517,12,0,7
700,abhiruhituṃ,abhiruhitum,26,26,0,0,11
701,asakkonto,asakkonto,660,649,11,0,9
702,attanāva,attanava,373,355,18,0,8
703,attānaṃ,attanam,3366,3166,200,0,7
704,pāde,pade,1374,1324,50,0,4
705,gahetvā,gahetva,9786,9651,135,0,7
706,muggaraṃ,muggaram,28,25,3,0,8
707,viya,viya,25953,25303,650,0,4
708,rukkhassa,rukkhassa,351,343,8,0,9
709,upari,upari,2747,2662,85,0,5
710,khipiṃ,khipim,15,13,2,0,6
711,sākhato,sakhato,11,11,0,0,7
712,sākhaṃ,sakham,177,171,6,0,6
713,vicaranto,vicaranto,204,203,1,0,9
714,phalāni,phalani,441,425,16,0,7
715,otarituṃ,otaritum,61,60,1,0,8
716,gharaṃ,gharam,583,558,25,0,6
717,nisseṇiṃ,nissenim,86,80,6,0,8
718,āharitvā,aharitva,1615,1604,11,0,8
719,oruyha,oruyha,329,326,3,0,6
720,santike,santike,3711,3641,70,0,7
721,mātuyā,matuya,205,203,2,0,6
722,adāsiṃ,adasim,240,229,11,0,6
723,tāni,tani,4137,3982,155,0,4
724,mahantāni,mahantani,158,157,1,0,9
725,honti,honti,13051,12858,193,0,5
726,cāṭippa,catippa,1,1,0,0,7
727,māṇāni,manani,2,2,0,0,6
728,me,me,21974,20662,1312,0,2
729,mātarā,matara,174,171,3,0,6
730,ekāsane,ekasane,67,64,3,0,7
731,nisinnāya,nisinnaya,29,27,2,0,9
732,samasaṭṭhiphalāni,samasatthiphalani,2,2,0,0,17
733,khāditānīti,khaditaniti,2,1,1,0,11
734,evamādivasena,evamadivasena,4,4,0,0,13
735,catutthavācā,catutthavaca,1,1,0,0,12
736,āmisahetu,amisahetu,36,32,4,0,9
737,cāṭukamyatādivasena,catukamyatadivasena,1,1,0,0,19
738,nānappakārakaṃ,nanappakarakam,89,73,16,0,14
739,thomanā,thomana,62,62,0,0,7
740,ceva,ceva,9712,9421,291,0,4
741,rājakathaṃ,rajakatham,32,30,2,0,10
742,corakathantiādinayappavattā,corakathantiadinayappavatta,1,1,0,0,27
743,tiracchānakathā,tiracchanakatha,46,36,10,0,15
744,pañcamavācā,pancamavaca,1,1,0,0,11
745,ariyasaccasannissitā,ariyasaccasannissita,1,1,0,0,20
746,dhammakathā,dhammakatha,99,95,4,0,11
747,chaṭṭhamavācā,chatthamavaca,1,1,0,0,13
748,vassasatampi,vassasatampi,49,47,2,0,12
749,suṇantā,sunanta,29,26,3,0,7
750,paṇḍitā,pandita,901,867,34,0,7
751,neva,neva,3844,3515,329,0,4
752,tittiṃ,tittim,32,31,1,0,6
753,gacchanti,gacchanti,2070,2035,35,0,9
754,M0.0011,M0.0011,84,84,0,0,7
755,tāsu,tasu,667,636,31,0,4
756,bhagavā,bhagava,19002,18374,628,0,7
757,tatiyachaṭṭhamā,tatiyachatthama,1,1,0,0,15
758,dvivācāeva,dvivacaeva,1,1,0,0,10
759,sappurisehi,sappurisehi,54,50,4,0,11
760,sāyeva,sayeva,157,144,13,0,6
761,dvivācā,dvivaca,1,1,0,0,7
762,vattabbāti,vattabbati,124,104,20,0,10
763,tadaṭṭhakathāyaṃ,tadatthakathayam,20,7,13,0,16
764,āgato,agato,1742,1691,51,0,5
765,saṅkhepanayo,sankhepanayo,3,3,0,0,12
766,visuddhimagga,visuddhimagga,9,7,2,0,13
767,mahāṭīkāyaṃ,mahatikayam,15,14,1,0,11
768,sāratthadīpanīṭīkāyañca,saratthadipanitikayanca,1,1,0,0,23
769,tadaññākārena,tadannakarena,1,1,0,0,13
770,vaṇṇito,vannito,55,55,0,0,7
771,oloketvā,oloketva,832,822,10,0,8
772,gahetabbanti,gahetabbanti,148,148,0,0,12
773,saṅgahagāthā,sangahagatha,12,12,0,0,12
774,bhūtamatthasaṃhītaṃ,bhutamatthasamhitam,1,1,0,0,19
775,paresamappiyā,paresamappiya,1,1,0,0,13
776,bhūtamatthasahītañca,bhutamatthasahitanca,1,1,0,0,20
777,piyavācanti,piyavacanti,1,1,0,0,11
778,yuttaṭṭhāneva,yuttatthaneva,1,1,0,0,13
779,vadatīti,vadatiti,320,271,49,0,8
780,vuccatī,vuccati,609,523,86,0,7
781,dakārassa,dakarassa,67,67,0,0,9
782,katvā,katva,22220,21851,369,0,5
783,takāraviññunā,takaravinnuna,1,1,0,0,13
784,guṇamahantattā,gunamahantatta,1,1,0,0,14
785,pasatthataraṃ,pasatthataram,4,4,0,0,13
786,pasatthānaṃ,pasatthanam,10,10,0,0,11
787,visesena,visesena,605,597,8,0,8
788,pasatthoti,pasatthoti,13,8,5,0,10
789,seṭṭhoti,setthoti,81,54,27,0,8
790,pasatthapadaṃ,pasatthapadam,1,1,0,0,13
791,visesataddhite,visesataddhite,1,1,0,0,14
792,iṭṭhapaccayo,itthapaccayo,1,1,0,0,12
793,pasatthasaddassa,pasatthasaddassa,1,1,0,0,16
794,paccekabuddhāriyasāvakādīnaṃ,paccekabuddhariyasavakadinam,1,1,0,0,28
795,sīlasamādhipaññādi,silasamadhipannadi,2,2,0,0,18
796,sundare,sundare,58,50,8,0,7
797,satipaṭṭhānādibhede,satipatthanadibhede,9,9,0,0,19
798,dhamme,dhamme,4339,4184,155,0,6
799,esati,esati,40,38,2,0,5
800,gavesati,gavesati,88,88,0,0,8
801,esiṃ,esim,2,2,0,0,4
802,gavesinti,gavesinti,3,3,0,0,9
803,seṭṭho,settho,541,505,36,0,6
804,supubboesa,supubboesa,1,1,0,0,10
805,gavesane,gavesane,13,12,1,0,8
806,raṭṭho,rattho,2,2,0,0,6
807,sundarattho,sundarattho,2,2,0,0,11
808,santehi,santehi,29,29,0,0,7
809,esitabbo,esitabbo,2,2,0,0,8
810,gavesitabboti,gavesitabboti,11,10,1,0,13
811,santasaddūpapado,santasaddupapado,2,2,0,0,16
812,isa,isa,22,8,14,0,3
813,santasaddassa,santasaddassa,12,10,2,0,13
814,ikārasse,ikarasse,1,1,0,0,8
815,ṭṭho,ttho,16,8,8,0,4
816,icchiyati,icchiyati,5,5,0,0,9
817,kantiya,kantiya,1,1,0,0,7
818,tīti,titi,9,8,1,0,4
819,isu,isu,21,7,14,0,3
820,icchākantīsu,icchakantisu,8,7,1,0,12
821,santānaṃ,santanam,157,144,13,0,8
822,sappurisānaṃ,sappurisanam,141,130,11,0,12
823,hitasukhaṃ,hitasukham,81,77,4,0,10
824,icchatīti,icchatiti,114,94,20,0,9
825,kattusādhanoyaṃ,kattusadhanoyam,3,3,0,0,15
826,satipaṭṭhānā,satipatthana,487,456,31,0,12
827,dibhede,dibhede,1,1,0,0,7
828,eseti,eseti,3,3,0,0,5
829,buddhetīti,buddhetiti,2,2,0,0,10
830,hetu,hetu,4450,4302,148,0,4
831,supubbaesadhātu,supubbaesadhatu,1,1,0,0,15
832,buddhiyaṃ,buddhiyam,29,24,5,0,9
833,kusalaṃ,kusalam,3398,3197,201,0,7
834,akusalaṃ,akusalam,1826,1761,65,0,8
835,jahanti,jahanti,151,138,13,0,7
836,padavibhāgo,padavibhago,56,51,5,0,11
837,kātabbo,katabbo,953,936,17,0,7
838,kucchitaṃ,kucchitam,144,138,6,0,9
839,pāpadhammaṃ,papadhammam,26,23,3,0,11
840,salayati,salayati,9,9,0,0,8
841,calayati,calayati,10,10,0,0,8
842,M0.0012,M0.0012,85,85,0,0,7
843,kampeti,kampeti,25,25,0,0,7
844,viddhaṃsetīti,viddhamsetiti,30,26,4,0,13
845,catubhūmikakusalaṃ,catubhumikakusalam,2,2,0,0,18
846,labbhati,labbhati,1796,1769,27,0,8
847,kupubbo,kupubbo,1,1,0,0,7
848,saladhātu,saladhatu,2,2,0,0,9
849,a,a,4157,3715,442,0,1
850,kāmāvacarakusalaṃ,kamavacarakusalam,42,39,3,0,17
851,tadaṅgappahānena,tadangappahanena,14,14,0,0,16
852,mahaggata,mahaggata,18,18,0,0,9
853,ksalaṃ,ksalam,1,1,0,0,6
854,vikkhambhanappahānena,vikkhambhanappahanena,22,21,1,0,21
855,lokuttara,lokuttara,37,32,5,0,9
856,samucchedappahānena,samucchedappahanena,23,23,0,0,19
857,apāyadvāraṃ,apayadvaram,3,3,0,0,11
858,salanti,salanti,5,5,0,0,7
859,saṃvaranti,samvaranti,8,8,0,0,10
860,pidahanti,pidahanti,14,14,0,0,9
861,etenāti,etenati,1143,1079,64,0,7
862,karaṇasādhanoyaṃ,karanasadhanoyam,3,3,0,0,16
863,vuttattā,vuttatta,2620,2601,19,0,8
864,tebhūmakakusalamevādhippetaṃ,tebhumakakusalamevadhippetam,1,1,0,0,28
865,anavajjasukhavipākalakkhaṇaṃ,anavajjasukhavipakalakkhanam,4,4,0,0,28
866,akusalaviddhaṃsanarasaṃ,akusalaviddhamsanarasam,6,4,2,0,23
867,vodāna,vodana,4,3,1,0,6
868,paccupaṭṭhānaṃ,paccupatthanam,31,25,6,0,14
869,iṭṭhavipākapaccupaṭṭhānaṃ,itthavipakapaccupatthanam,6,3,3,0,25
870,yonisomanasikāra,yonisomanasikara,1,1,0,0,16
871,padaṭṭhānaṃ,padatthanam,790,653,137,0,11
872,mittapaṭipakkho,mittapatipakkho,4,4,0,0,15
873,amitto,amitto,50,48,2,0,6
874,pahāyakapahātabbabhāvena,pahayakapahatabbabhavena,3,3,0,0,24
875,kusalapaṭipakkhanti,kusalapatipakkhanti,4,4,0,0,19
876,sāvajjadukkhavipākalakkhaṇaṃ,savajjadukkhavipakalakkhanam,2,2,0,0,28
877,sāvajjāniṭṭhavipāka,savajjanitthavipaka,1,1,0,0,19
878,lakkhaṇaṃ,lakkhanam,839,707,132,0,9
879,anatthajananarasaṃ,anatthajananarasam,3,3,0,0,18
880,aniṭṭhavipākapaccupaṭṭhānaṃ,anitthavipakapaccupatthanam,3,3,0,0,27
881,ayonisomanasikārapadaṭṭhānaṃ,ayonisomanasikarapadatthanam,14,14,0,0,28
882,puññābhisaṅkhāraāneñjā,punnabhisankharaanenja,1,1,0,0,22
883,bhisaṅkhārasaṅkhātaṃ,bhisankharasankhatam,1,1,0,0,20
884,apuññābhisaṅkhārasaṅkhātaṃ,apunnabhisankharasankhatam,1,1,0,0,26
885,akusalañca,akusalanca,213,208,5,0,10
886,jahantipade,jahantipade,1,1,0,0,11
887,kammaṃ,kammam,6444,5998,446,0,6
888,maggakkhaṇe,maggakkhane,289,271,18,0,11
889,phalakkhaṇe,phalakkhane,131,117,14,0,11
890,paṭippassambhanappahānena,patippassambhanappahanena,1,1,0,0,25
891,pajahantaṃ,pajahantam,5,4,1,0,10
892,viddhaṃsentanti,viddhamsentanti,1,1,0,0,15
893,tañhi,tanhi,1161,1141,20,0,5
894,arahattamaggañāṇena,arahattamaggananena,38,38,0,0,19
895,jahati,jahati,169,164,5,0,6
896,pajahati,pajahati,1230,1206,24,0,8
897,phalañāṇena,phalananena,8,7,1,0,11
898,jahiṃ,jahim,1,1,0,0,5
899,pajahiṃ,pajahim,63,56,7,0,7
900,paṭippassambhinti,patippassambhinti,1,1,0,0,17
901,jaho,jaho,6,6,0,0,4
902,hādhātu,hadhatu,4,4,0,0,7
903,cāge,cage,40,32,8,0,4
904,kiñcāpi,kincapi,1776,1728,48,0,7
905,pahātabbadhamme,pahatabbadhamme,3,3,0,0,15
906,vaṭṭamūlabhūte,vattamulabhute,2,2,0,0,14
907,avijjātaṇhādikilese,avijjatanhadikilese,1,1,0,0,19
908,arahattamagga,arahattamagga,4,4,0,0,13
909,jahite,jahite,9,7,2,0,6
910,lokiyakusaluppattiyā,lokiyakusaluppattiya,2,2,0,0,20
911,mūlabhūtāya,mulabhutaya,4,4,0,0,11
912,avijjātaṇhāya,avijjatanhaya,1,1,0,0,13
913,abhāvā,abhava,555,532,23,0,6
914,puññābhisaṅkhāro,punnabhisankharo,100,90,10,0,16
915,paṭisandhiyā,patisandhiya,223,215,8,0,12
916,nibbattetuṃ,nibbattetum,135,130,5,0,11
917,sakkoti,sakkoti,1853,1781,72,0,7
918,phalūpacārena,phalupacarena,70,70,0,0,13
919,kusalampi,kusalampi,51,50,1,0,9
920,jahitaṃ,jahitam,11,11,0,0,7
921,rūpaṃ,rupam,9276,8711,565,0,5
922,bhikkhave,bhikkhave,35596,34938,658,0,9
923,tumhākaṃ,tumhakam,2424,2382,42,0,8
924,pajahathātiādīsu,pajahathatiadisu,1,1,0,0,16
925,M0.0013,M0.0013,85,85,0,0,7
926,arahantena,arahantena,8,8,0,0,10
927,abhisamācārikavattaṃ,abhisamacarikavattam,2,2,0,0,20
928,katampi,katampi,89,88,1,0,7
929,kusalanti,kusalanti,77,72,5,0,9
930,kriyāti,kriyati,13,8,5,0,7
931,vuttanti,vuttanti,2538,2533,5,0,8
932,veditabbaṃ,veditabbam,5243,5148,95,0,10
933,nidānavaggasaṃyuttaṭṭhakathāyaṃ,nidanavaggasamyuttatthakathayam,1,0,1,0,31
934,khīṇāsavena,khinasavena,20,19,1,0,11
935,nākusalaṃ,nakusalam,27,27,0,0,9
936,avipākaṃ,avipakam,103,99,4,0,8
937,hutvā,hutva,10762,10510,252,0,5
938,kriyamatte,kriyamatte,1,1,0,0,10
939,tiṭṭhatī,titthati,188,150,38,0,8
940,aṅguttaraṭṭhakathāyañca,anguttaratthakathayanca,6,5,1,0,23
941,arahattamaggo,arahattamaggo,166,159,7,0,13
942,kusalākusala,kusalakusala,15,15,0,0,12
943,kammakkhayāya,kammakkhayaya,39,39,0,0,13
944,saṃvattatīti,samvattatiti,114,94,20,0,12
945,bhijjatī,bhijjati,41,36,5,0,8
946,cūḷaniddesapāḷiyaṃ,culaniddesapaliyam,1,0,1,0,18
947,abhisaṅkhāraviññāṇassa,abhisankharavinnanassa,37,35,2,0,22
948,nirodhena,nirodhena,85,76,9,0,9
949,uppajjeyyuṃ,uppajjeyyum,274,267,7,0,11
950,nāmañca,namanca,219,196,23,0,7
951,rūpañca,rupanca,346,322,24,0,7
952,etthete,etthete,58,55,3,0,7
953,nirujjhanti,nirujjhanti,618,609,9,0,11
954,vūpasamanti,vupasamanti,25,25,0,0,11
955,paṭippassambhantī,patippassambhanti,10,10,0,0,17
956,maraṇavirahitaṃ,maranavirahitam,7,6,1,0,15
957,mato,mato,529,503,26,0,4
958,amato,amato,7,7,0,0,5
959,maraṇadhammassa,maranadhammassa,10,10,0,0,15
960,nibbattakānaṃ,nibbattakanam,2,2,0,0,13
961,kilesānaṃ,kilesanam,827,801,26,0,9
962,arahatta,arahatta,20,16,4,0,8
963,samucchinditattā,samucchinditatta,4,4,0,0,16
964,maraṇato,maranato,83,81,2,0,8
965,virahitoti,virahitoti,12,9,3,0,10
966,nibbāne,nibbane,411,391,20,0,7
967,adhigate,adhigate,55,55,0,0,8
968,natthi,natthi,14245,13577,668,0,6
969,mataṃ,matam,558,500,58,0,5
970,maraṇaṃ,maranam,1114,1034,80,0,7
971,yassa,yassa,11000,10560,440,0,5
972,jinassāti,jinassati,1,1,0,0,9
973,amatoti,amatoti,2,2,0,0,7
974,jinena,jinena,47,46,1,0,6
975,khandhamaccumāraṃ,khandhamaccumaram,1,1,0,0,17
976,ajitopi,ajitopi,3,2,1,0,7
977,kilesamāraṃ,kilesamaram,14,13,1,0,11
978,jayitvā,jayitva,2,2,0,0,7
979,avassaṃ,avassam,393,376,17,0,7
980,jiyamānattā,jiyamanatta,2,2,0,0,11
981,vuccatīti,vuccatiti,869,664,205,0,9
982,amatanibbānasamannāgataṃ,amatanibbanasamannagatam,1,1,0,0,24
983,etthāti,etthati,1745,1053,692,0,7
984,santilakkhaṇaṃ,santilakkhanam,12,11,1,0,14
985,accutarasaṃ,accutarasam,1,1,0,0,11
986,animittapaccupaṭṭhānaṃ,animittapaccupatthanam,11,8,3,0,22
987,nissaraṇapaccupaṭṭhānaṃ,nissaranapaccupatthanam,3,2,1,0,23
988,nibbānassa,nibbanassa,508,481,27,0,10
989,milindapañhe,milindapanhe,16,10,6,0,12
990,nāgasenattherena,nagasenattherena,16,15,1,0,16
991,kenaci,kenaci,2559,2415,144,0,6
992,kāraṇena,karanena,1654,1633,21,0,8
993,uppajjatī,uppajjati,424,378,46,0,9
994,assa,assa,2943,2710,233,0,4
995,atthīti,atthiti,2467,2310,157,0,7
996,saddhādito,saddhadito,5,4,1,0,10
997,ṇāti,nati,1,1,0,0,4
998,suttena,suttena,349,339,10,0,7
999,assathyatthe,assathyatthe,14,14,0,0,12
1000,ṇapaccayo,napaccayo,11,11,0,0,9
1001,paññotiādīsu,pannotiadisu,1,1,0,0,12
1002,M0.0014,M0.0014,84,84,0,0,7
1003,jinassa,jinassa,101,97,4,0,7
1004,catumaggañāṇena,catumaggananena,5,3,2,0,15
1005,sacchikataṃ,sacchikatam,203,196,7,0,11
1006,sabbakilesadarathehi,sabbakilesadarathehi,1,1,0,0,20
1007,vaṭṭadukkhehi,vattadukkhehi,1,1,0,0,13
1008,suvūpasantaṃ,suvupasantam,20,20,0,0,12
1009,sabbakilesadarathavaṭṭadukkhehi,sabbakilesadarathavattadukkhehi,1,1,0,0,31
1010,samittha,samittha,1,1,0,0,8
1011,vūpasamitthāti,vupasamitthati,1,1,0,0,14
1012,santoti,santoti,109,29,80,0,7
1013,samudhātu,samudhatu,3,3,0,0,9
1014,upasame,upasame,33,31,2,0,7
1015,dhātvantassa,dhatvantassa,93,91,2,0,12
1016,lopaṃ,lopam,148,134,14,0,5
1017,tapaccayassantoādesaṃ,tapaccayassantoadesam,1,1,0,0,21
1018,padasiddhi,padasiddhi,83,82,1,0,10
1019,saṃsāravaṭṭe,samsaravatte,47,47,0,0,12
1020,darathakārakānaṃ,darathakarakanam,1,1,0,0,16
1021,bodhimaṇḍe,bodhimande,109,109,0,0,10
1022,sītibhūto,sitibhuto,50,44,6,0,9
1023,santakāyacittoti,santakayacittoti,2,2,0,0,16
1024,sīlādiguṇehi,siladigunehi,74,74,0,0,12
1025,puggalena,puggalena,231,229,2,0,9
1026,asadisaṃ,asadisam,71,64,7,0,8
1027,samo,samo,256,213,43,0,4
1028,sadiso,sadiso,405,394,11,0,6
1029,asamoti,asamoti,8,2,6,0,7
1030,sattaloke,sattaloke,75,72,3,0,9
1031,sīla,sila,51,36,15,0,4
1032,samādhipaññādiguṇehi,samadhipannadigunehi,1,1,0,0,20
1033,buddhena,buddhena,279,252,27,0,8
1034,koci,koci,3555,3389,166,0,4
1035,manusso,manusso,334,323,11,0,7
1036,devo,devo,875,826,49,0,4
1037,brahmā,brahma,709,676,33,0,6
1038,natthīti,natthiti,2504,2174,330,0,8
1039,asīti,asiti,244,226,18,0,5
1040,anubyañjanapaṭimaṇḍita,anubyanjanapatimandita,1,1,0,0,22
1041,bāttiṃsa,battimsa,66,62,4,0,8
1042,mahāpurisalakkhaṇehi,mahapurisalakkhanehi,11,11,0,0,20
1043,vicitrarūpakāyo,vicitrarupakayo,3,3,0,0,15
1044,sabbākārehi,sabbakarehi,7,7,0,0,11
1045,parisuddhasīlakkhandhādiguṇa,parisuddhasilakkhandhadiguna,1,1,0,0,28
1046,ratanasamiddho,ratanasamiddho,1,1,0,0,14
1047,dhammakāyo,dhammakayo,25,23,2,0,10
1048,puññamahattathāmamahatta,punnamahattathamamahatta,1,1,0,0,24
1049,iddhimahattayasamahattapaññāmahattādiguṇehi,iddhimahattayasamahattapannamahattadigunehi,1,1,0,0,43
1050,paramukkaṃsagato,paramukkamsagato,10,10,0,0,16
1051,atthi,atthi,13643,13237,406,0,5
1052,asamo,asamo,137,126,11,0,5
1053,asadisoti,asadisoti,13,11,2,0,9
1054,lokiyadhammena,lokiyadhammena,4,4,0,0,14
1055,maggaphalanibbāna,maggaphalanibbana,3,2,1,0,17
1056,veneyyānaṃ,veneyyanam,154,147,7,0,10
1057,sattānaṃ,sattanam,2564,2493,71,0,8
1058,desanāñāṇena,desanananena,16,16,0,0,12
1059,dāyakaṃ,dayakam,57,55,2,0,7
1060,asamanti,asamanti,2,2,0,0,8
1061,etesaṃ,etesam,1471,1351,120,0,6
1062,lokiyadhammoti,lokiyadhammoti,1,1,0,0,14
1063,maggaphalanibbānaṃ,maggaphalanibbanam,5,5,0,0,18
1064,aññesaṃ,annesam,1128,1051,77,0,7
1065,dhammānaṃ,dhammanam,3402,3199,203,0,9
1066,aggabhāvato,aggabhavato,6,6,0,0,11
1067,catubbidhena,catubbidhena,60,56,4,0,12
1068,ariya,ariya,21,17,4,0,5
1069,sacchikātabbaṃ,sacchikatabbam,167,157,10,0,14
1070,vuttañhetaṃ,vuttanhetam,1448,1392,56,0,11
1071,bhagavatā,bhagavata,6624,6541,83,0,9
1072,yāvatā,yavata,808,735,73,0,6
1073,dhammā,dhamma,19436,19023,413,0,6
1074,saṅkhatā,sankhata,217,198,19,0,8
1075,asaṅkhatā,asankhata,276,264,12,0,9
1076,virāgo,virago,340,290,50,0,6
1077,aggamakkhāyatī,aggamakkhayati,65,64,1,0,14
1078,padassa,padassa,753,744,9,0,7
1079,dadantipadena,dadantipadena,1,1,0,0,13
1080,M0.0015,M0.0015,84,84,0,0,7
1081,kammabhāvena,kammabhavena,22,22,0,0,12
1082,dadātīti,dadatiti,75,68,7,0,8
1083,dado,dado,12,11,1,0,4
1084,dādhātu,dadhatu,7,7,0,0,7
1085,maggaphalanibbānasaṅkhātaṃ,maggaphalanibbanasankhatam,3,3,0,0,26
1086,lokuttaradhammaṃ,lokuttaradhammam,103,99,4,0,16
1087,mahākaruṇāppadhānena,mahakarunappadhanena,1,1,0,0,20
1088,amatādhigamapaṭipattidassanena,amatadhigamapatipattidassanena,1,1,0,0,30
1089,dātāti,datati,7,3,4,0,6
1090,kha,kha,4481,4445,36,0,3
1091,dutiyagāthāyaṃ,dutiyagathayam,10,10,0,0,14
1092,sabbasattalokassa,sabbasattalokassa,2,2,0,0,17
1093,paṭisaraṇabhūto,patisaranabhuto,4,4,0,0,15
1094,parāyaṇo,parayano,17,15,2,0,8
1095,leṇo,leno,9,8,1,0,4
1096,tāṇoti,tanoti,2,2,0,0,6
1097,saranti,saranti,80,76,4,0,7
1098,paṭisaranti,patisaranti,12,12,0,0,11
1099,sattalokāti,sattalokati,2,2,0,0,11
1100,saraṇoti,saranoti,9,5,4,0,8
1101,saradhātu,saradhatu,9,9,0,0,9
1102,yu,yu,346,296,50,0,2
1103,osaranti,osaranti,58,56,2,0,8
1104,samosaranti,samosaranti,36,35,1,0,11
1105,cintenti,cintenti,40,39,1,0,8
1106,pasannā,pasanna,342,336,6,0,7
1107,devamanussā,devamanussa,165,161,4,0,11
1108,saraṇamidanti,saranamidanti,1,1,0,0,13
1109,paṭivijjhanti,pativijjhanti,70,69,1,0,13
1110,etthupagatā,etthupagata,1,1,0,0,11
1111,saddhammanti,saddhammanti,2,2,0,0,12
1112,sara,sara,100,49,51,0,4
1113,cintāyaṃ,cintayam,29,26,3,0,8
1114,saraṇagamanaṭṭhāne,saranagamanatthane,2,2,0,0,18
1115,sarati,sarati,315,304,11,0,6
1116,hiṃsati,himsati,122,119,3,0,7
1117,bhayaṃ,bhayam,1367,1201,166,0,6
1118,santāpaṃ,santapam,18,17,1,0,8
1119,kilesañcāti,kilesancati,1,1,0,0,11
1120,ratanatta,ratanatta,1,1,0,0,9
1121,yanti,yanti,238,211,27,0,5
1122,aṭṭhakathāsu,atthakathasu,369,293,76,0,12
1123,sattasaṅkhārokāsasaṅkhataṃ,sattasankharokasasankhatam,1,1,0,0,26
1124,sarantaṃ,sarantam,1,1,0,0,8
1125,jānantaṃ,janantam,20,20,0,0,8
1126,lokayati,lokayati,5,5,0,0,8
1127,patiṭṭhayati,patitthayati,1,1,0,0,12
1128,puññāpuññañca,punnapunnanca,1,1,0,0,13
1129,tabbipāko,tabbipako,23,23,0,0,9
1130,loko,loko,2409,2264,145,0,4
1131,satta,satta,6262,6034,228,0,5
1132,lokadhātu,lokadhatu,109,108,1,0,9
1133,patiṭṭhāyaṃ,patitthayam,27,24,3,0,11
1134,ṇa,na,290,133,157,0,2
1135,lujjati,lujjati,50,50,0,0,7
1136,palujjatīti,palujjatiti,21,13,8,0,11
1137,saṅkhāraloko,sankharaloko,45,39,6,0,12
1138,lujadhātuṇa,lujadhatuna,1,1,0,0,11
1139,lokiyati,lokiyati,9,9,0,0,8
1140,vicittākārena,vicittakarena,5,5,0,0,13
1141,dissatīti,dissatiti,210,178,32,0,9
1142,lokiyanti,lokiyanti,30,28,2,0,9
1143,patiṭṭhiyanti,patitthiyanti,1,1,0,0,13
1144,jaṅgamā,jangama,7,6,1,0,7
1145,thāvarā,thavara,41,34,7,0,7
1146,cakkavāḷasaṅkhato,cakkavalasankhato,1,1,0,0,17
1147,okāsaloko,okasaloko,39,34,5,0,9
1148,lokadhātuṇa,lokadhatuna,1,1,0,0,11
1149,sassato,sassato,488,457,31,0,7
1150,lokoti,lokoti,381,240,141,0,6
1151,asassato,asassato,181,177,4,0,8
1152,vāti,vati,3424,1545,1879,0,4
1153,āgataṭṭhāne,agatatthane,168,161,7,0,11
1154,indriyabaddhānaṃ,indriyabaddhanam,10,10,0,0,16
1155,rūpādīnaṃ,rupadinam,143,134,9,0,9
1156,khandhānaṃ,khandhanam,3342,3285,57,0,10
1157,samūho,samuho,224,218,6,0,6
1158,santāno,santano,24,20,4,0,7
1159,sattoyeva,sattoyeva,9,9,0,0,9
1160,sattalokoti,sattalokoti,4,4,0,0,11
1161,vacanatthena,vacanatthena,61,61,0,0,12
1162,veditabbo,veditabbo,5749,5625,124,0,9
1163,sabbe,sabbe,5616,5303,313,0,5
1164,sattā,satta,3556,3457,99,0,5
1165,āhā,aha,128,83,45,0,3
1166,raṭṭhitikāti,ratthitikati,1,1,0,0,12
1167,M0.0016,M0.0016,86,86,0,0,7
1168,anindriyabaddhānaṃ,anindriyabaddhanam,6,6,0,0,18
1169,paccayehi,paccayehi,576,569,7,0,9
1170,saṅkhariyantīti,sankhariyantiti,2,2,0,0,15
1171,saṅkhārā,sankhara,2311,2226,85,0,8
1172,saṅkhārāeva,sankharaeva,1,1,0,0,11
1173,saṅkhāralokoti,sankharalokoti,5,5,0,0,14
1174,candimasūriyā,candimasuriya,176,167,9,0,13
1175,pariharanti,pariharanti,53,52,1,0,11
1176,disā,disa,1133,1031,102,0,4
1177,bhanti,bhanti,43,35,8,0,6
1178,virocamānā,virocamana,35,34,1,0,10
1179,sahassadhā,sahassadha,60,51,9,0,10
1180,vattati,vattati,980,963,17,0,7
1181,vaso,vaso,115,105,10,0,4
1182,avakasanti,avakasanti,3,3,0,0,10
1183,patiṭṭhahanti,patitthahanti,56,54,2,0,13
1184,okāso,okaso,384,366,18,0,5
1185,soyeva,soyeva,320,304,16,0,6
1186,okāsalokoti,okasalokoti,11,11,0,0,11
1187,okāsa,okasa,10,9,1,0,5
1188,ajānīti,ajaniti,1,1,0,0,7
1189,saraṇo,sarano,227,223,4,0,6
1190,saraṇanti,sarananti,45,44,1,0,9
1191,sattalokaṃ,sattalokam,35,35,0,0,10
1192,saṅkhāralokaṃ,sankharalokam,11,11,0,0,13
1193,okāsalokaṃ,okasalokam,11,11,0,0,10
1194,kilesalokaṃ,kilesalokam,1,1,0,0,11
1195,bhavalokaṃ,bhavalokam,1,1,0,0,10
1196,indriya,indriya,46,37,9,0,7
1197,khandhalokaṃ,khandhalokam,10,10,0,0,12
1198,āyatanalokaṃ,ayatanalokam,3,3,0,0,12
1199,dhātulokañcātiādimanekalokaṃ,dhatulokancatiadimanekalokam,1,1,0,0,28
1200,anāvaraṇañāṇena,anavaranananena,10,10,0,0,15
1201,paṭivijjhatīti,pativijjhatiti,113,98,15,0,14
1202,nikkilesaṃ,nikkilesam,10,9,1,0,10
1203,kilesasaṅkhātaraṇavirahitaṃ,kilesasankhataranavirahitam,2,2,0,0,27
1204,raṇasaddo,ranasaddo,2,2,0,0,9
1205,kilesesu,kilesesu,60,58,2,0,8
1206,yuddhe,yuddhe,78,72,6,0,6
1207,cuṇṇavicuṇṇakaraṇe,cunnavicunnakarane,3,3,0,0,18
1208,dissati,dissati,1993,1969,24,0,7
1209,tathā,tatha,19085,18337,748,0,5
1210,saraṇā,sarana,62,57,5,0,6
1211,araṇā,arana,47,43,4,0,5
1212,dhammātiādīsu,dhammatiadisu,7,3,4,0,13
1213,raṇanti,rananti,13,13,0,0,7
1214,kandanti,kandanti,62,61,1,0,8
1215,etehīti,etehiti,153,134,19,0,7
1216,raṇāti,ranati,7,5,2,0,6
1217,vuccanti,vuccanti,1910,1871,39,0,8
1218,dhanuggaho,dhanuggaho,39,36,3,0,10
1219,asadiso,asadiso,43,39,4,0,7
1220,rājaputto,rajaputto,122,121,1,0,9
1221,mahabbalo,mahabbalo,259,256,3,0,9
1222,sabbāmitte,sabbamitte,12,12,0,0,10
1223,raṇaṃ,ranam,35,28,7,0,5
1224,saṃyamaṃ,samyamam,20,16,4,0,8
1225,ajjhupāgamī,ajjhupagami,7,7,0,0,11
1226,asadisajātake,asadisajatake,1,1,0,0,13
1227,katvāti,katvati,791,313,478,0,7
1228,yuddhaṃ,yuddham,151,147,4,0,7
1229,saṃyamanti,samyamanti,2,2,0,0,10
1230,saṃyataṃ,samyatam,4,4,0,0,8
1231,isipabbajjaṃ,isipabbajjam,213,211,2,0,12
1232,ajjhupāgamīti,ajjhupagamiti,5,3,2,0,13
1233,tiṇañca,tinanca,49,48,1,0,7
1234,kaṭṭhañca,katthanca,42,40,2,0,9
1235,dhāviṃsu,dhavimsu,17,17,0,0,8
1236,aṭṭhadisā,atthadisa,5,5,0,0,9
1237,M0.0017,M0.0017,84,84,0,0,7
1238,samantatoti,samantatoti,24,8,16,0,11
1239,chaddantajātake,chaddantajatake,1,1,0,0,15
1240,karontoti,karontoti,73,36,37,0,9
1241,cuṇṇaṃ,cunnam,100,92,8,0,6
1242,vicuṇṇaṃ,vicunnam,2,2,0,0,8
1243,teti,teti,553,86,467,0,4
1244,aṭṭhasahassanāgāti,atthasahassanagati,1,1,0,0,18
1245,daṭṭhabbo,datthabbo,2489,2445,44,0,9
1246,vacanattho,vacanattho,310,306,4,0,10
1247,satte,satte,1064,1039,25,0,5
1248,rāgādayo,ragadayo,219,213,6,0,8
1249,cuṇṇenti,cunnenti,6,6,0,0,8
1250,pīḷentīti,pilentiti,2,2,0,0,9
1251,raṇā,rana,19,17,2,0,4
1252,etehi,etehi,740,708,32,0,5
1253,paridevantīti,paridevantiti,4,2,2,0,13
1254,raṇadhātu,ranadhatu,1,1,0,0,9
1255,sadde,sadde,532,486,46,0,5
1256,araṇoti,aranoti,3,2,1,0,7
1257,kilesamārassa,kilesamarassa,23,20,3,0,13
1258,bodhimūle,bodhimule,81,81,0,0,9
1259,santīti,santiti,221,183,38,0,7
1260,veneyyasantāne,veneyyasantane,24,24,0,0,14
1261,raṇasaṅkhatakilesassa,ranasankhatakilesassa,1,1,0,0,21
1262,abhāvakaraṇaṃ,abhavakaranam,3,3,0,0,13
1263,etaṃ,etam,6635,5907,728,0,4
1264,yehi,yehi,989,943,46,0,4
1265,abhibhūtā,abhibhuta,74,73,1,0,9
1266,paridavanti,paridavanti,1,1,0,0,11
1267,rāgādīnaṃ,ragadinam,221,210,11,0,9
1268,adhivacanaṃ,adhivacanam,1474,1362,112,0,11
1269,abhāvaṃ,abhavam,286,272,14,0,7
1270,karotīti,karotiti,1302,1079,223,0,8
1271,karo,karo,68,58,10,0,4
1272,jātibhayādīnaṃ,jatibhayadinam,1,1,0,0,14
1273,abhāvato,abhavato,1450,1423,27,0,8
1274,cittutrāsabhayaṃ,cittutrasabhayam,11,9,2,0,16
1275,ñāṇabhayaṃ,nanabhayam,12,11,1,0,10
1276,ārammaṇabhayaṃ,arammanabhayam,5,5,0,0,14
1277,ottappa,ottappa,1,1,0,0,7
1278,bhayañcāti,bhayancati,5,5,0,0,10
1279,catubbidhaṃ,catubbidham,482,456,26,0,11
1280,bhāyati,bhayati,170,164,6,0,7
1281,cittenāti,cittenati,49,11,38,0,9
1282,tīretvā,tiretva,34,34,0,0,7
1283,bhāyatīti,bhayatiti,29,22,7,0,9
1284,ñāṇaṃ,nanam,4712,4299,413,0,5
1285,etasmāti,etasmati,123,123,0,0,8
1286,etena,etena,2900,2813,87,0,5
1287,pāpatoti,papatoti,7,7,0,0,8
1288,ottappabhayaṃ,ottappabhayam,2,2,0,0,13
1289,bhīdhātu,bhidhatu,1,1,0,0,8
1290,bhaye,bhaye,112,95,17,0,5
1291,mahāniddesapāḷiyaṃ,mahaniddesapaliyam,3,0,3,0,18
1292,āgatāni,agatani,217,203,14,0,7
1293,jātibhayaṃ,jatibhayam,21,15,6,0,10
1294,jarābhayaṃ,jarabhayam,16,15,1,0,10
1295,byādhibhayaṃ,byadhibhayam,13,13,0,0,12
1296,maraṇabhayaṃ,maranabhayam,50,48,2,0,12
1297,rājabhayaṃ,rajabhayam,19,17,2,0,10
1298,corabhayaṃ,corabhayam,24,24,0,0,10
1299,aggibhayaṃ,aggibhayam,10,9,1,0,10
1300,udakabhayaṃ,udakabhayam,7,7,0,0,11
1301,attānuvādabhayaṃ,attanuvadabhayam,22,18,4,0,16
1302,parānuvādabhayaṃ,paranuvadabhayam,23,20,3,0,16
1303,daṇḍabhayaṃ,dandabhayam,21,18,3,0,11
1304,duggatibhayaṃ,duggatibhayam,27,22,5,0,13
1305,ūmibhayaṃ,umibhayam,25,19,6,0,9
1306,kumbhīḷabhayaṃ,kumbhilabhayam,2,2,0,0,14
1307,āvaṭṭabhayaṃ,avattabhayam,17,15,2,0,12
1308,susukabhayaṃ,susukabhayam,1,1,0,0,12
1309,ājīvikabhayaṃ,ajivikabhayam,6,5,1,0,13
1310,asilokabhayaṃ,asilokabhayam,10,7,3,0,13
1311,parisayasārajjabhayaṃ,parisayasarajjabhayam,1,1,0,0,21
1312,madana,madana,1,1,0,0,6
1313,duggatibhayantiādīni,duggatibhayantiadini,1,1,0,0,20
1314,gahitāni,gahitani,241,237,4,0,8
1315,bhayāni,bhayani,156,145,11,0,7
1316,abhayo,abhayo,83,78,5,0,6
1317,bhayānaṃ,bhayanam,29,25,4,0,8
1318,kāraṇa,karana,16,16,0,0,6
1319,bhūtānaṃ,bhutanam,212,199,13,0,8
1320,M0.0018,M0.0018,86,86,0,0,7
1321,sabbakilesānaṃ,sabbakilesanam,78,72,6,0,14
1322,arahattamaggena,arahattamaggena,310,294,16,0,15
1323,sabbabhayaṃ,sabbabhayam,4,4,0,0,11
1324,abhayantipadaṃ,abhayantipadam,1,1,0,0,14
1325,ṭhānantipade,thanantipade,1,1,0,0,12
1326,visesanaṃ,visesanam,307,295,12,0,9
1327,ṭhānantipadaṃ,thanantipadam,1,1,0,0,13
1328,nāyakantipade,nayakantipade,1,1,0,0,13
1329,bhayasaddassa,bhayasaddassa,2,2,0,0,13
1330,heṭṭhā,hettha,3843,3718,125,0,6
1331,vuttoyeva,vuttoyeva,231,221,10,0,9
1332,nibbāneti,nibbaneti,7,6,1,0,9
1333,buddhapaccekabuddha,buddhapaccekabuddha,1,1,0,0,19
1334,arahantā,arahanta,30,29,1,0,8
1335,ṭhanti,thanti,13,13,0,0,6
1336,uppajjanti,uppajjanti,3639,3612,27,0,10
1337,veneyyasatte,veneyyasatte,25,25,0,0,12
1338,netīti,netiti,99,88,11,0,6
1339,nāyako,nayako,233,228,5,0,6
1340,nīdhātu,nidhatu,5,5,0,0,7
1341,nayane,nayane,24,20,4,0,6
1342,ṇvu,nvu,210,194,16,0,3
1343,bhabbe,bhabbe,25,20,5,0,6
1344,kulaputte,kulaputte,46,46,0,0,9
1345,maggādhi,maggadhi,1,1,0,0,8
1346,gamappattiyā,gamappattiya,1,1,0,0,12
1347,dhammadesanāya,dhammadesanaya,301,297,4,0,14
1348,maggaphalañāṇaṃ,maggaphalananam,10,10,0,0,15
1349,adhigamento,adhigamento,1,1,0,0,11
1350,nibbānaṭṭhānaṃ,nibbanatthanam,2,2,0,0,14
1351,nameti,nameti,4,3,1,0,6
1352,nāyakanti,nayakanti,4,4,0,0,9
1353,saṃsāraṇṇavato,samsarannavato,3,3,0,0,14
1354,nibbānapāraṃ,nibbanaparam,31,30,1,0,12
1355,yathā,yatha,20411,19235,1176,0,5
1356,nāviko,naviko,47,44,3,0,6
1357,jane,jane,350,324,26,0,4
1358,nāvāya,navaya,326,313,13,0,6
1359,orimatīrato,orimatirato,13,13,0,0,11
1360,pārimatīraṃ,parimatiram,20,20,0,0,11
1361,neti,neti,218,202,16,0,4
1362,maggaṅganāvāya,magganganavaya,1,1,0,0,14
1363,nibbāna,nibbana,57,52,5,0,7
1364,pāraṃ,param,536,454,82,0,5
1365,pāpuṇetīti,papunetiti,1,1,0,0,10
1366,tiṇṇaṃ,tinnam,2228,2050,178,0,6
1367,jeṭṭhabhāvagamanattā,jetthabhavagamanatta,1,1,0,0,20
1368,jeṭṭha,jettha,5,5,0,0,6
1369,seṭṭhavuḍḍhataro,setthavuddhataro,1,1,0,0,16
1370,jeṭṭhabhāvaṃ,jetthabhavam,10,10,0,0,12
1371,gacchati,gacchati,5245,5106,139,0,8
1372,pāpuṇātīti,papunatiti,197,164,33,0,10
1373,nāyakoti,nayakoti,7,5,2,0,8
1374,gatimhi,gatimhi,72,71,1,0,7
1375,avijjaṇḍagatānaṃ,avijjandagatanam,1,1,0,0,16
1376,sabbapajānaṃ,sabbapajanam,2,2,0,0,12
1377,paṭhamataraṃ,pathamataram,309,298,11,0,12
1378,avijjaṇḍakosaṃ,avijjandakosam,42,38,4,0,14
1379,padāletvā,padaletva,93,91,2,0,9
1380,ariyāya,ariyaya,216,208,8,0,7
1381,jātiyā,jatiya,1120,1066,54,0,6
1382,jātattā,jatatta,187,185,2,0,7
1383,sabbasattānaṃ,sabbasattanam,282,272,10,0,13
1384,seṭṭhajeṭṭhavuḍḍhatarabhāvaṃ,setthajetthavuddhatarabhavam,1,1,0,0,28
1385,tīhi,tihi,2315,2172,143,0,4
1386,dvārehi,dvarehi,109,107,2,0,7
1387,sakkaccaṃ,sakkaccam,698,654,44,0,9
1388,vattamānamivibhattiyā,vattamanamivibhattiya,1,1,0,0,21
1389,kvacidhātutyādisuttena,kvacidhatutyadisuttena,1,1,0,0,22
1390,eādeso,eadeso,1,1,0,0,6
1391,vāccatthādinayo,vaccatthadinayo,1,1,0,0,15
1392,nametipadassa,nametipadassa,2,2,0,0,13
1393,ākhyātapadattā,akhyatapadatta,1,1,0,0,14
1394,saddavidūhi,saddaviduhi,3,1,2,0,11
1395,ruḷhīkhyātaṃ,rulhikhyatam,3,3,0,0,12
1396,nipātañcu,nipatancu,2,2,0,0,9
1397,pasaggālapanaṃ,pasaggalapanam,2,2,0,0,14
1398,sabbanāmantimetesu,sabbanamantimetesu,1,1,0,0,18
1399,kato,kato,1507,1463,44,0,4
1400,viggaho,viggaho,566,542,24,0,7
1401,chasū,chasu,6,4,2,0,5
1402,M0.0019,M0.0019,86,86,0,0,7
1403,namudhātuvattamānaamhayogaparassapadamivibhatyantaṃ,namudhatuvattamanaamhayogaparassapadamivibhatyantam,1,1,0,0,51
1404,ākhyātapadaṃ,akhyatapadam,20,18,2,0,12
1405,namudhātuyā,namudhatuya,2,2,0,0,11
1406,vāccattho,vaccattho,18,16,2,0,9
1407,namanakriyā,namanakriya,1,1,0,0,11
1408,saṅkhāto,sankhato,25,25,0,0,8
1409,kusalacittuppādo,kusalacittuppado,8,8,0,0,16
1410,padhānavasena,padhanavasena,23,23,0,0,13
1411,mivibhattiyā,mivibhattiya,4,4,0,0,12
1412,cittuppādena,cittuppadena,23,23,0,0,12
1413,upalakkhito,upalakkhito,20,20,0,0,11
1414,uppāda,uppada,7,6,1,0,6
1415,vanto,vanto,32,31,1,0,5
1416,tadākāro,tadakaro,8,7,1,0,8
1417,puggalo,puggalo,5772,5621,151,0,7
1418,appadhānavasena,appadhanavasena,2,2,0,0,15
1419,padasamudāyassa,padasamudayassa,3,3,0,0,15
1420,kattukammabhāvesu,kattukammabhavesu,1,1,0,0,17
1421,kattubhūto,kattubhuto,10,9,1,0,10
1422,atītādikālesu,atitadikalesu,2,2,0,0,13
1423,paccuppannakālabhūto,paccuppannakalabhuto,1,1,0,0,20
1424,dhātvattha,dhatvattha,3,3,0,0,10
1425,kiriyāvisesova,kiriyavisesova,1,1,0,0,14
1426,ayamettha,ayamettha,1150,1116,34,0,9
1427,saṅkhepo,sankhepo,393,371,22,0,8
1428,vitthāro,vittharo,684,661,23,0,8
1429,panevaṃ,panevam,113,106,7,0,7
1430,vaccaṃ,vaccam,119,113,6,0,6
1431,sugatādi,sugatadi,1,1,0,0,8
1432,buddhaguṇaṃ,buddhagunam,20,19,1,0,11
1433,ārammaṇaṃ,arammanam,2121,1994,127,0,9
1434,vandanākārappavatto,vandanakarappavatto,2,2,0,0,19
1435,kāyavacī,kayavaci,8,8,0,0,8
1436,viññattisamuṭṭhāpako,vinnattisamutthapako,1,1,0,0,20
1437,saddhācetanāpaññāpadhāno,saddhacetanapannapadhano,1,1,0,0,24
1438,kusala,kusala,80,62,18,0,6
1439,cittuppādo,cittuppado,169,160,9,0,10
1440,dve,dve,16710,16002,708,0,3
1441,viññattiyo,vinnattiyo,17,16,1,0,10
1442,asamuṭṭhāpetvā,asamutthapetva,8,8,0,0,14
1443,manodvāre,manodvare,309,300,9,0,9
1444,mukhyena,mukhyena,7,7,0,0,8
1445,buddhaguṇānussaraṇavasena,buddhagunanussaranavasena,2,2,0,0,25
1446,yonisomanasikā,yonisomanasika,1,1,0,0,14
1447,rādipurecarānucarakusalacittuppādo,radipurecaranucarakusalacittuppado,1,1,0,0,34
1448,diṭṭhadhammi,ditthadhammi,1,1,0,0,12
1449,kasamparāyikasaṅkhātaṃ,kasamparayikasankhatam,1,1,0,0,22
1450,pacchimapacchimaphalaṃ,pacchimapacchimaphalam,1,1,0,0,22
1451,rogādiantarāyānaṃ,rogadiantarayanam,1,1,0,0,17
1452,abhāvañca,abhavanca,3,3,0,0,9
1453,saggamokkhasampattisukhañca,saggamokkhasampattisukhanca,1,1,0,0,27
1454,kāraṇūpacārena,karanupacarena,49,48,1,0,14
1455,pure,pure,1306,1197,109,0,4
1456,vandanā,vandana,85,77,8,0,7
1457,sadisyūpacārena,sadisyupacarena,1,1,0,0,15
1458,vandanassa,vandanassa,1,1,0,0,10
1459,nāmapaññatti,namapannatti,34,32,2,0,12
1460,ṭhānūpacārena,thanupacarena,10,10,0,0,13
1461,vatthudvārārammaṇaṃ,vatthudvararammanam,1,1,0,0,19
1462,vandana,vandana,3,2,1,0,7
1463,guṇena,gunena,127,123,4,0,6
1464,lakkhitaṃ,lakkhitam,12,12,0,0,9
1465,puggaladabbaṃ,puggaladabbam,1,1,0,0,13
1466,guṇūpacārena,gunupacarena,1,1,0,0,12
1467,ukkaṭṭhamajjha,ukkatthamajjha,1,1,0,0,14
1468,muduttamattabhāvo,muduttamattabhavo,1,1,0,0,17
1469,guṇyūpacārena,gunyupacarena,1,1,0,0,13
1470,avayavabhūtā,avayavabhuta,4,4,0,0,12
1471,ekadesūpacārena,ekadesupacarena,2,2,0,0,15
1472,samūhabhūtā,samuhabhuta,1,1,0,0,11
1473,ekadesyūpacārena,ekadesyupacarena,1,1,0,0,16
1474,pubbapubbakusalacittuppādo,pubbapubbakusalacittuppado,1,1,0,0,26
1475,samīpūpacārena,samipupacarena,2,2,0,0,14
1476,pacchimapacchima,pacchimapacchima,1,1,0,0,16
1477,samīpyūpacārena,samipyupacarena,1,1,0,0,15
1478,paṇāmakusalacittuppādabhūtānaṃ,panamakusalacittuppadabhutanam,1,1,0,0,30
1479,paramatthadhammānaṃ,paramatthadhammanam,13,13,0,0,19
1480,nibyāpārabhāvo,nibyaparabhavo,1,1,0,0,14
1481,taddhammūpacārena,taddhammupacarena,1,1,0,0,17
1482,dhammatābhāvo,dhammatabhavo,1,1,0,0,13
1483,ataddhammūpacārena,ataddhammupacarena,1,1,0,0,18
1484,vandanākāro,vandanakaro,2,2,0,0,11
1485,abhedabhedūpacārena,abhedabhedupacarena,1,1,0,0,19
1486,vandanasatti,vandanasatti,1,1,0,0,12
1487,bhedaabhedūpacārena,bhedaabhedupacarena,1,1,0,0,19
1488,vāccaṃ,vaccam,10,10,0,0,6
1489,taṃmukhyādīhi,tammukhyadihi,1,1,0,0,13
1490,lakkhito,lakkhito,29,29,0,0,8
1491,kattu,kattu,88,77,11,0,5
1492,kriyāvisesena,kriyavisesena,1,1,0,0,13
1493,vattamānavibhattisaṅkhātena,vattamanavibhattisankhatena,1,1,0,0,27
1494,vibhattivise,vibhattivise,1,1,0,0,12
1495,sena,sena,55,47,8,0,4
1496,M0.0020,M0.0020,83,83,0,0,7
1497,parassapadasaṅkhātena,parassapadasankhatena,1,1,0,0,21
1498,padavisesena,padavisesena,1,1,0,0,12
1499,uttamapurisa,uttamapurisa,1,1,0,0,12
1500,amhayogavisesena,amhayogavisesena,1,1,0,0,16
1501,sabbadhātuvisesena,sabbadhatuvisesena,1,1,0,0,18
1502,ekavacanavisesena,ekavacanavisesena,1,1,0,0,17
1503,paccuppannakālavisesena,paccuppannakalavisesena,1,1,0,0,23
1504,dhātvatthakriyāvisesena,dhatvatthakriyavisesena,1,1,0,0,23
1505,aliṅga,alinga,2,2,0,0,6
1506,bhūvādigaṇa,bhuvadigana,4,4,0,0,11
1507,novikaraṇavisesena,novikaranavisesena,1,1,0,0,18
1508,bhāvakammakattūsukattuvisesena,bhavakammakattusukattuvisesena,1,1,0,0,30
1509,ahaṃsaṅkhāto,ahamsankhato,1,1,0,0,12
1510,khandhasaṅkhato,khandhasankhato,1,1,0,0,15
1511,appadhānena,appadhanena,3,3,0,0,11
1512,kriyāpadassa,kriyapadassa,8,8,0,0,12
1513,kriyāya,kriyaya,53,52,1,0,7
1514,padhānena,padhanena,58,58,0,0,9
1515,vācakattā,vacakatta,12,12,0,0,9
1516,dhātvatthova,dhatvatthova,1,1,0,0,12
1517,apaccayassa,apaccayassa,2,2,0,0,11
1518,bhūvādigaṇajotakā,bhuvadiganajotaka,1,1,0,0,17
1519,rūpasiddhimattā,rupasiddhimatta,1,1,0,0,15
1520,pada,pada,82,41,41,0,4
1521,siliṭṭhatā,silitthata,2,2,0,0,10
1522,sāmaññattha,samannattha,1,1,0,0,11
1523,viggahoyaṃ,viggahoyam,1,1,0,0,10
1524,vuttanayena,vuttanayena,1628,1601,27,0,11
1525,namanañcettha,namanancettha,1,1,0,0,13
1526,sīlādianantaguṇesu,siladianantagunesu,1,1,0,0,18
1527,ninnapabbhāratāvasena,ninnapabbharatavasena,1,1,0,0,21
1528,paṇāmakriyābhinipphādikā,panamakriyabhinipphadika,2,2,0,0,24
1529,kusalacetanā,kusalacetana,25,25,0,0,12
1530,vandaneyya,vandaneyya,1,1,0,0,10
1531,vandanakānaṃ,vandanakanam,1,1,0,0,12
1532,khettajjhāsayasampadāhi,khettajjhasayasampadahi,4,4,0,0,23
1533,diṭṭhadhammavedanīyabhūtā,ditthadhammavedaniyabhuta,8,8,0,0,25
1534,yathāladdhasampattinimittakassa,yathaladdhasampattinimittakassa,10,10,0,0,31
1535,purimakammassa,purimakammassa,8,8,0,0,14
1536,anubalappadāna,anubalappadana,1,1,0,0,14
1537,vasena,vasena,5124,5048,76,0,6
1538,tannibbattitavipākasantatiyā,tannibbattitavipakasantatiya,4,4,0,0,28
1539,antarāyakarāni,antarayakarani,8,8,0,0,14
1540,upapīḷakaupacchedakakammāni,upapilakaupacchedakakammani,4,4,0,0,27
1541,paṭibāhitvā,patibahitva,129,116,13,0,11
1542,pavattikāle,pavattikale,62,62,0,0,11
1543,rogādiantarāyānamappavattiṃ,rogadiantarayanamappavattim,3,3,0,0,27
1544,sādheti,sadheti,318,303,15,0,7
1545,upapajjavedanīyabhūtā,upapajjavedaniyabhuta,2,2,0,0,21
1546,saggamokkhasampattisukhaṃ,saggamokkhasampattisukham,1,1,0,0,25
1547,nibbattetīti,nibbattetiti,55,52,3,0,12
1548,dassanatthanayo,dassanatthanayo,1,0,1,0,15
1549,nametiiminā,nametiimina,1,1,0,0,11
1550,sugatādiguṇaṃ,sugatadigunam,1,1,0,0,13
1551,ārabbha,arabbha,4860,4829,31,0,7
1552,pavattā,pavatta,1322,1291,31,0,7
1553,tividhā,tividha,361,344,17,0,7
1554,paṇāmakusala,panamakusala,1,1,0,0,12
1555,cetanā,cetana,1956,1886,70,0,6
1556,dasseti,dasseti,7104,7059,45,0,7
1557,dassanena,dassanena,1747,1734,13,0,9
1558,kāraṇabhūtā,karanabhuta,41,41,0,0,11
1559,yonisomanasikārādayo,yonisomanasikaradayo,2,2,0,0,20
1560,catucakkasampattiñca,catucakkasampattinca,1,1,0,0,20
1561,buddhuppādanavamakhettañca,buddhuppadanavamakhettanca,1,1,0,0,26
1562,pubbabhāge,pubbabhage,502,490,12,0,10
1563,pavattaṃ,pavattam,1038,984,54,0,8
1564,saddhāpaññāpadhānaṃ,saddhapannapadhanam,1,1,0,0,19
1565,kusalacittuppādañca,kusalacittuppadanca,1,1,0,0,19
1566,dīpeti,dipeti,1707,1683,24,0,6
1567,taddīpanena,taddipanena,1,1,0,0,11
1568,phalabhūtaṃ,phalabhutam,23,23,0,0,11
1569,diṭṭhadhammarogādiantarāyavisosanañca,ditthadhammarogadiantarayavisosananca,1,1,0,0,37
1570,saggamokkha,saggamokkha,1,1,0,0,11
1571,sukhañca,sukhanca,255,239,16,0,8
1572,paṭhamakāraṇūpacārena,pathamakaranupacarena,2,2,0,0,21
1573,pakāseti,pakaseti,248,247,1,0,8
1574,tappakāsanena,tappakasanena,3,3,0,0,13
1575,paṇāmārahabhāvaṃ,panamarahabhavam,1,1,0,0,16
1576,dutiyakāraṇūpacārena,dutiyakaranupacarena,2,2,0,0,20
1577,vibhāveti,vibhaveti,318,313,5,0,9
1578,M0.0021,M0.0021,86,86,0,0,7
1579,taṃvibhāvanena,tamvibhavanena,1,1,0,0,14
1580,vandakassa,vandakassa,1,1,0,0,10
1581,khettaṅgatabhāvañca,khettangatabhavanca,2,2,0,0,19
1582,paṇāme,paname,4,3,1,0,6
1583,tabbabhāvañca,tabbabhavanca,1,1,0,0,13
1584,tatiyakāraṇūpacārena,tatiyakaranupacarena,1,1,0,0,20
1585,anubhāveti,anubhaveti,3,3,0,0,10
1586,alaṅkāranayo,alankaranayo,1,0,1,0,12
1587,nametivācakapadassa,nametivacakapadassa,1,1,0,0,19
1588,vāccabhūtā,vaccabhuta,1,1,0,0,10
1589,buddhapaṇāmakusalacetanā,buddhapanamakusalacetana,1,1,0,0,24
1590,samaṭṭhāyī,samatthayi,1,1,0,0,10
1591,bhāvo,bhavo,1443,1414,29,0,5
1592,kasmā,kasma,5528,5355,173,0,5
1593,sarīrattā,sariratta,1,1,0,0,9
1594,tividhāya,tividhaya,46,46,0,0,9
1595,buddhapaṇā,buddhapana,1,1,0,0,10
1596,makusalacetanāya,makusalacetanaya,1,1,0,0,16
1597,sampayutto,sampayutto,786,782,4,0,10
1598,samādhippadhāno,samadhippadhano,1,1,0,0,15
1599,mahā,maha,729,687,42,0,4
1600,samaṭṭhāyībhāvo,samatthayibhavo,1,1,0,0,15
1601,sugatādiguṇārammaṇe,sugatadigunarammane,1,1,0,0,19
1602,ekaggattā,ekaggatta,1,1,0,0,9
1603,samāhitacittattā,samahitacittatta,1,1,0,0,16
1604,santaraso,santaraso,3,3,0,0,9
1605,buddhapaṇāmacetanā,buddhapanamacetana,1,1,0,0,18
1606,kusalaṅgena,kusalangena,8,8,0,0,11
1607,akusalaṅgassa,akusalangassa,5,5,0,0,13
1608,pahīnattā,pahinatta,407,399,8,0,9
1609,buddhantipāṭhasesa,buddhantipathasesa,1,1,0,0,18
1610,vāccabhūto,vaccabhuto,4,4,0,0,10
1611,buddhadabbo,buddhadabbo,2,2,0,0,11
1612,ārammaṇavibhāvo,arammanavibhavo,2,2,0,0,15
1613,paṇāmakusalacittuppādassa,panamakusalacittuppadassa,1,1,0,0,25
1614,ārammaṇapaccayena,arammanapaccayena,1994,1992,2,0,17
1615,upakārattā,upakaratta,9,9,0,0,10
1616,sugatantyādiguṇo,sugatantyadiguno,1,1,0,0,16
1617,uddīpanavibhāvo,uddipanavibhavo,8,8,0,0,15
1618,paṇāmassa,panamassa,6,6,0,0,9
1619,kāraṇattā,karanatta,62,61,1,0,9
1620,kāraṇabhūtaṃ,karanabhutam,66,63,3,0,12
1621,samaṭṭhāyībhāvaṃ,samatthayibhavam,1,1,0,0,16
1622,upādāya,upadaya,1820,1776,44,0,7
1623,jānitabbo,janitabbo,172,170,2,0,9
1624,diṭṭhadhammarogā,ditthadhammaroga,1,1,0,0,16
1625,diantarāyābhāvo,diantarayabhavo,1,1,0,0,15
1626,saggamokkhasukhasampatti,saggamokkhasukhasampatti,1,1,0,0,24
1627,ānubhāvo,anubhavo,155,142,13,0,8
1628,ānisaṃsaphalattā,anisamsaphalatta,1,1,0,0,16
1629,ānubhāvadīpakaṃ,anubhavadipakam,5,5,0,0,15
1630,kāraṇassa,karanassa,133,130,3,0,9
1631,phalena,phalena,254,242,12,0,7
1632,vinābhāvato,vinabhavato,2,2,0,0,11
1633,phalaṃ,phalam,3923,3721,202,0,6
1634,viññeyyanti,vinneyyanti,12,12,0,0,11
1635,sāmatthiyato,samatthiyato,76,74,2,0,12
1636,dassitoyevāti,dassitoyevati,11,11,0,0,13
1637,āvibhūto,avibhuto,18,13,5,0,8
1638,ussuko,ussuko,18,16,2,0,6
1639,buddhapaṇāmassa,buddhapanamassa,1,1,0,0,15
1640,ānisaṃsapajānanā,anisamsapajanana,1,1,0,0,16
1641,mati,mati,126,116,10,0,4
1642,alasābhāvo,alasabhavo,1,1,0,0,10
1643,cittappasādo,cittappasado,5,5,0,0,12
1644,samādhityādi,samadhityadi,1,1,0,0,12
1645,byabhicārībhāvo,byabhicaribhavo,4,4,0,0,15
1646,lomahaṃsādibhāvo,lomahamsadibhavo,1,1,0,0,16
1647,satvaṃkābhāvo,satvamkabhavo,1,1,0,0,13
1648,nāmāti,namati,1677,1351,326,0,6
1649,alaṅkāra,alankara,13,2,11,0,8
1650,nayo,nayo,5681,5495,186,0,4
1651,pacchimapacchimagāthāsūti,pacchimapacchimagathasuti,1,1,0,0,25
1652,saṅkhepayojanā,sankhepayojana,24,0,24,0,14
1653,sobhanagataṃ,sobhanagatam,1,1,0,0,12
1654,sundaranibbānaṭṭhānaṃ,sundaranibbanatthanam,1,1,0,0,21
1655,vacanaṃ,vacanam,4803,4675,128,0,7
1656,gadaṃ,gadam,3,3,0,0,5
1657,bhāsanaṃ,bhasanam,23,19,4,0,8
1658,M0.0022,M0.0022,84,84,0,0,7
1659,gavesantaṃ,gavesantam,3,2,1,0,10
1660,gavesitabbaṃ,gavesitabbam,44,42,2,0,12
1661,icchitaṃ,icchitam,154,151,3,0,8
1662,kusalaṃakusalaṃ,kusalamakusalam,1,1,0,0,15
1663,amatanibbānasamannā,amatanibbanasamanna,1,1,0,0,19
1664,kilesadarathavūpasamaṃ,kilesadarathavupasamam,3,3,0,0,22
1665,maggaphalanibbānadhammaṃ,maggaphalanibbanadhammam,2,2,0,0,24
1666,dātaṃ,datam,3,3,0,0,5
1667,paṭisaraṇabhūtaṃ,patisaranabhutam,5,5,0,0,16
1668,sattasaṅkha,sattasankha,1,1,0,0,11
1669,rokāsasaṅkhataṃ,rokasasankhatam,1,1,0,0,15
1670,tilokaṃ,tilokam,22,22,0,0,7
1671,sattesu,sattesu,478,469,9,0,7
1672,kilesarajassābhāvaṃ,kilesarajassabhavam,1,1,0,0,19
1673,nibbhayaṭṭhānaṃ,nibbhayatthanam,3,3,0,0,15
1674,nibbānadisaṃ,nibbanadisam,7,7,0,0,12
1675,nentaṃ,nentam,1,1,0,0,6
1676,tilokānaṃ,tilokanam,6,6,0,0,9
1677,jeṭṭhaṃ,jettham,24,20,4,0,7
1678,pāmokkhaṃ,pamokkham,49,40,9,0,9
1679,paṭhamavandanagāthādvayavaṇṇanā,pathamavandanagathadvayavannana,1,1,0,0,31
1680,samattā,samatta,866,856,10,0,7
1681,gāthādvayena,gathadvayena,6,6,0,0,12
1682,namassitvā,namassitva,53,47,6,0,10
1683,nayanasubhagakāyaṅgantyādīhi,nayanasubhagakayangantyadihi,1,1,0,0,28
1684,pañcahi,pancahi,2403,2335,68,0,7
1685,thomitvā,thomitva,20,20,0,0,8
1686,vandituṃ,vanditum,91,90,1,0,8
1687,itiādigāthamāha,itiadigathamaha,10,10,0,0,15
1688,magaṇayuttattā,maganayuttatta,1,1,0,0,14
1689,navakkharehi,navakkharehi,1,1,0,0,12
1690,lakkhitā,lakkhita,25,25,0,0,8
1691,bhujagasu,bhujagasu,1,1,0,0,9
1692,sugāthāti,sugathati,1,1,0,0,9
1693,daṭṭhabbā,datthabba,1033,1009,24,0,9
1694,vuttodaye,vuttodaye,25,6,19,0,9
1695,bhujagasusumatā,bhujagasusumata,1,1,0,0,15
1696,nāmo,namo,45,39,6,0,4
1697,yojanā,yojana,4953,4937,16,0,6
1698,yassaṃ,yassam,178,175,3,0,6
1699,paṭipādaṃ,patipadam,18,18,0,0,9
1700,nā,na,355,247,108,0,2
1701,nagaṇāmo,naganamo,1,1,0,0,8
1702,magaṇo,magano,1,1,0,0,6
1703,yadi,yadi,5614,5387,227,0,4
1704,siyā,siya,9055,8766,289,0,4
1705,bhujagasusu,bhujagasusu,1,1,0,0,11
1706,gāthāti,gathati,32,20,12,0,7
1707,matā,mata,491,461,30,0,4
1708,ñātabbāti,natabbati,20,19,1,0,9
1709,cakkhussa,cakkhussa,280,265,15,0,9
1710,gatena,gatena,73,72,1,0,6
1711,kāyaṅgenasamannāgataṃ,kayangenasamannagatam,1,1,0,0,21
1712,M0.0023,M0.0023,86,86,0,0,7
1713,nayananti,nayananti,2,2,0,0,9
1714,samavisamaṃ,samavisamam,49,47,2,0,11
1715,dassentaṃ,dassentam,18,18,0,0,9
1716,attabhāvaṃ,attabhavam,365,354,11,0,10
1717,nayanaṃ,nayanam,65,56,9,0,7
1718,cakkhu,cakkhu,1453,1368,85,0,6
1719,subhaṃ,subham,317,268,49,0,6
1720,subhagaṃ,subhagam,13,5,8,0,8
1721,kāyaṅgaṃ,kayangam,29,25,4,0,8
1722,subhasaddūpapado,subhasaddupapado,1,1,0,0,16
1723,kvi,kvi,93,74,19,0,3
1724,kāyassa,kayassa,2494,2438,56,0,7
1725,aṅgaṃ,angam,671,607,64,0,5
1726,avayavaṃ,avayavam,17,17,0,0,8
1727,chaṭṭhītappurisasamāsoyaṃ,chatthitappurisasamasoyam,2,2,0,0,25
1728,nayanassa,nayanassa,2,2,0,0,9
1729,buddhassāti,buddhassati,10,3,7,0,11
1730,nayanasubhaga,nayanasubhaga,1,1,0,0,13
1731,kāyaṅgo,kayango,1,1,0,0,7
1732,rūpakāyassa,rupakayassa,106,103,3,0,11
1733,dassanā,dassana,86,64,22,0,7
1734,nuttariyaguṇayogato,nuttariyagunayogato,1,1,0,0,19
1735,pasādacakkhussa,pasadacakkhussa,5,5,0,0,15
1736,dvattiṃsamahāpurisalakkhaṇehi,dvattimsamahapurisalakkhanehi,35,35,0,0,29
1737,asītyā,asitya,1,1,0,0,6
1738,nubyañjanalakkhaṇehi,nubyanjanalakkhanehi,1,1,0,0,20
1739,lakkhitena,lakkhitena,3,3,0,0,10
1740,kāyaṅgena,kayangena,6,6,0,0,9
1741,samannāgatoti,samannagatoti,316,258,58,0,13
1742,piyapemanīyauttamasaddena,piyapemaniyauttamasaddena,1,1,0,0,25
1743,samannāgataṃ,samannagatam,456,439,17,0,12
1744,madhiyati,madhiyati,2,2,0,0,9
1745,piyati,piyati,1,1,0,0,6
1746,pemiyati,pemiyati,1,1,0,0,8
1747,madhuro,madhuro,66,61,5,0,7
1748,madhadhātu,madhadhatu,2,2,0,0,10
1749,uro,uro,44,43,1,0,3
1750,majjhimapaṇṇāsaṭīkāyaṃ,majjhimapannasatikayam,1,0,1,0,22
1751,madhuroti,madhuroti,12,8,4,0,9
1752,piyo,piyo,602,557,45,0,4
1753,pemanīyo,pemaniyo,11,11,0,0,8
1754,apalibuddho,apalibuddho,8,7,1,0,11
1755,assādiyatīti,assadiyatiti,3,3,0,0,12
1756,madhati,madhati,2,2,0,0,7
1757,pītiṃ,pitim,255,239,16,0,5
1758,undeti,undeti,1,1,0,0,6
1759,vaḍḍhetīti,vaddhetiti,57,51,6,0,10
1760,unde,unde,4,3,1,0,4
1761,saddanītiyaṃ,saddanitiyam,15,11,4,0,12
1762,madha,madha,2,1,1,0,5
1763,varitabbo,varitabbo,7,7,0,0,9
1764,icchitabbo,icchitabbo,133,131,2,0,10
1765,patthitabbo,patthitabbo,2,2,0,0,11
1766,varo,varo,213,197,16,0,4
1767,saro,saro,336,313,23,0,4
1768,varadhātu,varadhatu,7,7,0,0,9
1769,icchāyaṃ,icchayam,68,59,9,0,8
1770,sotaviññāṇārammaṇabhāvanti,sotavinnanarammanabhavanti,1,1,0,0,26
1771,saddo,saddo,4014,3976,38,0,5
1772,gatiyaṃ,gatiyam,269,204,65,0,7
1773,suyyamānatanti,suyyamanatanti,1,1,0,0,14
1774,sariyati,sariyati,1,1,0,0,8
1775,suṇiyatīti,suniyatiti,1,1,0,0,10
1776,aṭṭhaṅgasamannāgato,atthangasamannagato,39,39,0,0,19
1777,upasampajjatīti,upasampajjatiti,2,2,0,0,15
1778,upeto,upeto,225,217,8,0,5
1779,upapubbaidhātu,upapubbaidhatu,3,3,0,0,14
1780,madhuravarasaro,madhuravarasaro,1,1,0,0,15
1781,sampanno,sampanno,229,217,12,0,8
1782,madhuravarasaropetoti,madhuravarasaropetoti,1,1,0,0,21
1783,hadaya,hadaya,17,13,4,0,6
1784,vatthuno,vatthuno,177,164,13,0,8
1785,suvisuddhattā,suvisuddhatta,2,2,0,0,13
1786,pittasemhādīhi,pittasemhadihi,11,11,0,0,14
1787,apalibuddhattā,apalibuddhatta,7,7,0,0,14
1788,deva,deva,1646,1622,24,0,4
1789,manussehi,manussehi,277,277,0,0,9
1790,madhurena,madhurena,62,60,2,0,9
1791,piyena,piyena,27,26,1,0,6
1792,manāpiyena,manapiyena,3,3,0,0,10
1793,varena,varena,15,15,0,0,6
1794,icchitapatthi,icchitapatthi,1,1,0,0,13
1795,aṭṭhaṅgasamannāgatena,atthangasamannagatena,10,10,0,0,21
1796,sarena,sarena,194,186,8,0,6
1797,saddena,saddena,2387,2380,7,0,7
1798,M0.0024,M0.0024,87,87,0,0,7
1799,saropetanti,saropetanti,1,1,0,0,11
1800,sāmaññavasena,samannavasena,34,34,0,0,13
1801,visaṭṭho,visattho,10,9,1,0,8
1802,viññeyyo,vinneyyo,186,179,7,0,8
1803,mañju,manju,15,11,4,0,5
1804,savanīyo,savaniyo,15,11,4,0,8
1805,bindu,bindu,75,68,7,0,5
1806,avisārī,avisari,12,8,4,0,7
1807,gambhīro,gambhiro,270,240,30,0,8
1808,ninnādi,ninnadi,5,4,1,0,7
1809,aṭṭhaṅgasamannāgatoti,atthangasamannagatoti,4,2,2,0,21
1810,majjhima,majjhima,11,9,2,0,8
1811,paṇṇāse,pannase,3,3,0,0,7
1812,brahmāyusutte,brahmayusutte,20,6,14,0,13
1813,panassa,panassa,1869,1830,39,0,7
1814,gotamassa,gotamassa,708,700,8,0,9
1815,mukhato,mukhato,296,275,21,0,7
1816,ghoso,ghoso,112,105,7,0,5
1817,niccharati,niccharati,55,54,1,0,10
1818,yathāparisaṃ,yathaparisam,11,7,4,0,12
1819,gotamo,gotamo,1831,1792,39,0,6
1820,viññāpeti,vinnapeti,294,292,2,0,9
1821,cassa,cassa,1622,1547,75,0,5
1822,bahiddhā,bahiddha,1942,1805,137,0,8
1823,parisāya,parisaya,693,676,17,0,8
1824,niccharatī,niccharati,4,3,1,0,10
1825,tassāṭṭhakathāyaṃ,tassatthakathayam,1,1,0,0,17
1826,visaṭṭhoti,visatthoti,2,1,1,0,10
1827,siniddho,siniddho,15,13,2,0,8
1828,viññeyyoti,vinneyyoti,6,3,3,0,10
1829,viññāpanīyo,vinnapaniyo,2,2,0,0,11
1830,pākaṭo,pakato,730,694,36,0,6
1831,visaṭṭhattāyeva,visatthattayeva,1,1,0,0,15
1832,mañjūti,manjuti,4,1,3,0,7
1833,savanīyoti,savaniyoti,5,3,2,0,10
1834,sotasukho,sotasukho,2,2,0,0,9
1835,madhurattāyeva,madhurattayeva,2,2,0,0,14
1836,bindūti,binduti,4,1,3,0,7
1837,sampiṇḍito,sampindito,6,5,1,0,10
1838,avisārīti,avisariti,3,1,2,0,9
1839,avisaṭo,avisato,3,3,0,0,7
1840,binduttāyeva,binduttayeva,2,2,0,0,12
1841,gambhīroti,gambhiroti,38,18,20,0,10
1842,gambhīrasamuṭṭhito,gambhirasamutthito,4,3,1,0,18
1843,ninnādīti,ninnaditi,3,1,2,0,9
1844,ninnadavā,ninnadava,1,1,0,0,9
1845,gambhīrattāyeva,gambhirattayeva,4,3,1,0,15
1846,yathāparisanti,yathaparisanti,1,1,0,0,14
1847,cakkavāḷapariyantāpi,cakkavalapariyantapi,1,1,0,0,20
1848,ekabaddhaṃ,ekabaddham,4,4,0,0,10
1849,parisaṃ,parisam,424,406,18,0,7
1850,bahiddhāti,bahiddhati,70,25,45,0,10
1851,aṅgulimattampi,angulimattampi,9,9,0,0,14
1852,parisato,parisato,36,32,4,0,8
1853,evarūpo,evarupo,863,851,12,0,7
1854,madhurasaro,madhurasaro,2,2,0,0,11
1855,akāraṇā,akarana,16,15,1,0,7
1856,mā,ma,6531,6017,514,0,2
1857,nassīti,nassiti,5,4,1,0,7
1858,mattakeneva,mattakeneva,1,1,0,0,11
1859,caratīti,caratiti,222,186,36,0,8
1860,vaṇṇitoti,vannitoti,6,3,3,0,9
1861,abhidhānappadīpikāyañca,abhidhanappadipikayanca,3,2,1,0,23
1862,vuttā,vutta,5739,5567,172,0,5
1863,visaṭṭhamañjuviññeyyā,visatthamanjuvinneyya,1,1,0,0,21
1864,savanīyāvisārino,savaniyavisarino,2,2,0,0,16
1865,bindugambhīraninnādi,bindugambhiraninnadi,1,1,0,0,20
1866,tyevamaṭṭhaṅgiko,tyevamatthangiko,1,1,0,0,16
1867,brahmuno,brahmuno,313,303,10,0,8
1868,pittasemhehi,pittasemhehi,7,7,0,0,12
1869,visuddho,visuddho,55,54,1,0,8
1870,sīhabyagghādīhi,sihabyagghadihi,5,5,0,0,15
1871,vāḷamigehi,valamigehi,10,10,0,0,10
1872,anubandhā,anubandha,23,19,4,0,9
1873,dhāvantā,dhavanta,6,6,0,0,8
1874,khuddakamigā,khuddakamiga,1,1,0,0,12
1875,karavīkasakuṇassa,karavikasakunassa,3,3,0,0,17
1876,vikūjamānaṃ,vikujamanam,1,1,0,0,11
1877,saddaṃ,saddam,1268,1207,61,0,6
1878,sutvā,sutva,6844,6779,65,0,5
1879,sarassa,sarassa,91,90,1,0,7
1880,madhurattā,madhuratta,2,2,0,0,10
1881,hitvā,hitva,612,547,65,0,5
1882,adhāvitvā,adhavitva,1,1,0,0,9
1883,ukkhittapādaṃ,ukkhittapadam,2,2,0,0,13
1884,M0.0025,M0.0025,85,85,0,0,7
1885,anikkhipitvā,anikkhipitva,21,21,0,0,12
1886,tiṭṭhantā,titthanta,10,10,0,0,9
1887,suṇanti,sunanti,227,224,3,0,7
1888,karavīkassa,karavikassa,6,6,0,0,11
1889,dhammatābhāvena,dhammatabhavena,2,2,0,0,15
1890,vatthuṃ,vatthum,2379,2250,129,0,7
1891,sodheti,sodheti,104,98,6,0,7
1892,vatthussa,vatthussa,272,268,4,0,9
1893,suddhattā,suddhatta,19,19,0,0,9
1894,nābhito,nabhito,44,44,0,0,7
1895,samuṭṭhahanto,samutthahanto,5,5,0,0,13
1896,saropi,saropi,7,6,1,0,6
1897,suvisuddho,suvisuddho,8,8,0,0,10
1898,atimadhuro,atimadhuro,8,8,0,0,10
1899,atipiyo,atipiyo,3,3,0,0,7
1900,atimanāpo,atimanapo,3,3,0,0,9
1901,hīnūpamā,hinupama,4,4,0,0,8
1902,tehi,tehi,4048,3931,117,0,4
1903,saddehi,saddehi,105,102,3,0,7
1904,satabhāgena,satabhagena,7,6,1,0,11
1905,sahassabhāgena,sahassabhagena,11,10,1,0,14
1906,dhammāso,dhammaso,1,1,0,0,8
1907,karañño,karanno,1,1,0,0,7
1908,asandhimittā,asandhimitta,5,5,0,0,12
1909,devī,devi,473,472,1,0,4
1910,madhurasaddaṃ,madhurasaddam,4,4,0,0,13
1911,cintesi,cintesi,1739,1730,9,0,7
1912,imassa,imassa,4004,3882,122,0,6
1913,tiracchānassa,tiracchanassa,2,2,0,0,13
1914,ko,ko,5111,4648,463,0,2
1915,sabbaññutañāṇasiriṃ,sabbannutananasirim,1,1,0,0,19
1916,pattassa,pattassa,321,313,8,0,8
1917,uppādetvā,uppadetva,576,564,12,0,9
1918,avijahitvā,avijahitva,95,94,1,0,10
1919,sattahi,sattahi,639,614,25,0,7
1920,jaṅghasatehi,janghasatehi,4,3,1,0,12
1921,saddhiṃ,saddhim,9929,9633,296,0,7
1922,sotāpattiphale,sotapattiphale,484,473,11,0,14
1923,patiṭṭhāti,patitthati,300,283,17,0,10
1924,madhuravarasaropetanti,madhuravarasaropetanti,1,1,0,0,22
1925,thometīti,thometiti,22,20,2,0,9
1926,aparimiṇitabbasīlādiguṇasamūhānaṃ,apariminitabbasiladigunasamuhanam,2,2,0,0,33
1927,patiṭṭhānabhūtaṃ,patitthanabhutam,19,17,2,0,16
1928,samitoti,samitoti,1,1,0,0,8
1929,parimiṇitabboti,pariminitabboti,1,1,0,0,15
1930,mito,mito,18,18,0,0,4
1931,mādhātu,madhatu,3,3,0,0,7
1932,parimāṇe,parimane,25,21,4,0,8
1933,amito,amito,9,9,0,0,5
1934,guṇoti,gunoti,27,24,3,0,6
1935,sīlādayo,siladayo,88,87,1,0,8
1936,guṇenti,gunenti,1,1,0,0,7
1937,taṃsamaṅgīpuggalaṃ,tamsamangipuggalam,11,11,0,0,18
1938,pakāsentīti,pakasentiti,20,14,6,0,11
1939,guṇāti,gunati,17,10,7,0,6
1940,guṇadhātu,gunadhatu,2,2,0,0,9
1941,pakāsane,pakasane,20,19,1,0,8
1942,maṇisāramañjūsāṭīkāyaṃ,manisaramanjusatikayam,1,0,1,0,22
1943,guṇanti,gunanti,5,5,0,0,7
1944,attano,attano,17817,17346,471,0,6
1945,ādhāraṃ,adharam,15,15,0,0,7
1946,pākaṭaṃ,pakatam,889,841,48,0,7
1947,karontīti,karontiti,368,284,84,0,9
1948,guṇā,guna,354,328,26,0,4
1949,saddanītidhātumālāyañca,saddanitidhatumalayanca,1,0,1,0,23
1950,guṇa,guna,40,29,11,0,4
1951,āmantane,amantane,20,15,5,0,8
1952,kenaṭṭhena,kenatthena,311,282,29,0,10
1953,goṇāpiyati,gonapiyati,2,2,0,0,10
1954,āmantāpiyati,amantapiyati,2,2,0,0,12
1955,attani,attani,982,941,41,0,6
1956,patiṭṭhito,patitthito,355,347,8,0,10
1957,daṭṭhuṃ,datthum,322,312,10,0,7
1958,sotuṃ,sotum,252,244,8,0,5
1959,pūjituñca,pujitunca,3,3,0,0,9
1960,icchantehi,icchantehi,15,15,0,0,10
1961,janehīti,janehiti,17,13,4,0,8
1962,guṇo,guno,256,236,20,0,4
1963,sīlādi,siladi,18,18,0,0,6
1964,āmantāpanaṃ,amantapanam,2,2,0,0,11
1965,tathāpi,tathapi,987,976,11,0,7
1966,taṃhetu,tamhetu,36,36,0,0,7
1967,āmantanaṃ,amantanam,32,27,5,0,9
1968,nimantanañca,nimantananca,2,2,0,0,12
1969,teyeva,teyeva,298,289,9,0,6
1970,karonti,karonti,2625,2587,38,0,7
1971,aññe,anne,1704,1632,72,0,4
1972,guñjante,gunjante,2,2,0,0,8
1973,abyayante,abyayante,2,2,0,0,9
1974,vadanti,vadanti,5412,5280,132,0,7
1975,tadanurūpaṃ,tadanurupam,110,103,7,0,11
1976,dhātusaddaṃna,dhatusaddamna,1,1,0,0,13
1977,passāma,passama,121,114,7,0,7
1978,M0.0026,M0.0026,88,88,0,0,7
1979,icceva,icceva,401,382,19,0,6
1980,gahetabbaṃ,gahetabbam,1875,1836,39,0,10
1981,amitaguṇo,amitaguno,8,8,0,0,9
1982,gaṇo,gano,247,229,18,0,4
1983,amitaguṇagaṇo,amitagunagano,1,1,0,0,13
1984,ādhārati,adharati,1,1,0,0,8
1985,tiṭṭhati,titthati,2444,2391,53,0,8
1986,amitaguṇagaṇādhāro,amitagunaganadharo,1,1,0,0,18
1987,samuddodakaṃ,samuddodakam,7,6,1,0,12
1988,nāḷipattena,nalipattena,1,1,0,0,11
1989,aparimitaṃ,aparimitam,30,27,3,0,10
1990,aparimitānaṃ,aparimitanam,4,4,0,0,12
1991,sīlādiguṇasamūhānaṃ,siladigunasamuhanam,1,1,0,0,19
1992,ādhāro,adharo,83,74,9,0,6
1993,patiṭṭhānabhūtoti,patitthanabhutoti,2,2,0,0,17
1994,dasabalaṃ,dasabalam,252,244,8,0,9
1995,aññehi,annehi,790,763,27,0,6
1996,asādhāraṇaṃ,asadharanam,162,144,18,0,11
1997,tathāgatadasabalasampannaṃ,tathagatadasabalasampannam,1,1,0,0,26
1998,balanti,balanti,51,51,0,0,7
1999,kehici,kehici,717,701,16,0,6
2000,viruddhehi,viruddhehi,7,7,0,0,10
2001,kāraṇe,karane,245,233,12,0,6
2002,kampenti,kampenti,13,13,0,0,8
2003,thirantīti,thirantiti,1,1,0,0,10
2004,balaṃ,balam,889,802,87,0,5
2005,dasa,dasa,3010,2789,221,0,4
2006,balāni,balani,396,377,19,0,6
2007,soti,soti,687,141,546,0,4
2008,dasabalo,dasabalo,82,80,2,0,8
2009,gatassa,gatassa,157,155,2,0,7
2010,kāyadasabalañca,kayadasabalanca,1,1,0,0,15
2011,ñāṇadasabalañcāti,nanadasabalancati,1,1,0,0,17
2012,tesu,tesu,4997,4869,128,0,4
2013,kāyabalaṃ,kayabalam,75,65,10,0,9
2014,hatthikulānusārena,hatthikulanusarena,9,9,0,0,18
2015,porāṇehi,poranehi,70,67,3,0,8
2016,kāḷā,kala,34,24,10,0,4
2017,vakañca,vakanca,1,1,0,0,7
2018,gaṅgeyyaṃ,gangeyyam,15,15,0,0,9
2019,paṇḍaraṃ,pandaram,146,134,12,0,8
2020,tambapiṅgalaṃ,tambapingalam,13,13,0,0,13
2021,gandha,gandha,30,19,11,0,6
2022,maṅgalahemañca,mangalahemanca,1,1,0,0,14
2023,uposathaṃ,uposatham,822,791,31,0,9
2024,chaddantime,chaddantime,3,3,0,0,11
2025,dasā,dasa,127,113,14,0,4
2026,imāni,imani,2967,2869,98,0,5
2027,hatthikulāni,hatthikulani,10,10,0,0,12
2028,kāḷāvakanti,kalavakanti,1,1,0,0,11
2029,pakatihatthikulaṃ,pakatihatthikulam,14,11,3,0,17
2030,dasannaṃ,dasannam,511,473,38,0,8
2031,purisānaṃ,purisanam,395,386,9,0,9
2032,ekassa,ekassa,1574,1544,30,0,6
2033,kāḷāvakahatthino,kalavakahatthino,3,3,0,0,16
2034,kāḷāvakānaṃ,kalavakanam,8,8,0,0,11
2035,gaṅgeyyassa,gangeyyassa,8,8,0,0,11
2036,gaṅgeyyānaṃ,gangeyyanam,8,8,0,0,11
2037,paṇḍarassa,pandarassa,11,11,0,0,10
2038,paṇḍarānaṃ,pandaranam,8,8,0,0,10
2039,tambassa,tambassa,9,9,0,0,8
2040,tambānaṃ,tambanam,8,8,0,0,8
2041,piṅgalassa,pingalassa,10,10,0,0,10
2042,piṅgalānaṃ,pingalanam,8,8,0,0,10
2043,gandhahatthino,gandhahatthino,14,13,1,0,14
2044,gandhahatthīnaṃ,gandhahatthinam,8,8,0,0,15
2045,maṅgalassa,mangalassa,48,41,7,0,10
2046,maṅgalānaṃ,mangalanam,10,10,0,0,10
2047,hemavatassa,hemavatassa,8,8,0,0,11
2048,hemavatānaṃ,hemavatanam,7,7,0,0,11
2049,uposathassa,uposathassa,82,82,0,0,11
2050,uposathānaṃ,uposathanam,9,9,0,0,11
2051,chaddantassa,chaddantassa,9,9,0,0,12
2052,chaddantānaṃ,chaddantanam,13,13,0,0,12
2053,tathāgatassa,tathagatassa,1737,1693,44,0,12
2054,nārāyanasaṅghātabalantipi,narayanasanghatabalantipi,6,6,0,0,25
2055,idameva,idameva,840,814,26,0,7
2056,tadetaṃ,tadetam,206,191,15,0,7
2057,pakatihatthīnaṃ,pakatihatthinam,8,8,0,0,15
2058,gaṇanāya,gananaya,159,150,9,0,8
2059,hatthikoṭisahassānaṃ,hatthikotisahassanam,3,3,0,0,20
2060,M0.0027,M0.0027,84,84,0,0,7
2061,purisagaṇanāya,purisagananaya,18,18,0,0,14
2062,purisakoṭisahassānaṃ,purisakotisahassanam,12,12,0,0,20
2063,idaṃ,idam,20914,19655,1259,0,4
2064,pāḷīsu,palisu,4,4,0,0,6
2065,āgataṃ,agatam,1119,1079,40,0,6
2066,aṭṭhakathāsuyeva,atthakathasuyeva,4,4,0,0,16
2067,dasaka,dasaka,2,2,0,0,6
2068,nipāta,nipata,8,6,2,0,6
2069,balañāṇaṃ,balananam,3,3,0,0,9
2070,āgatameva,agatameva,127,121,6,0,9
2071,aṭṭha,attha,8457,8233,224,0,5
2072,kathārūḷhamevāti,katharulhamevati,1,1,0,0,16
2073,adhippāyo,adhippayo,4290,4231,59,0,9
2074,nārāyana,narayana,1,1,0,0,8
2075,saṅghāta,sanghata,3,3,0,0,8
2076,nārā,nara,7,7,0,0,4
2077,rasmiyo,rasmiyo,108,105,3,0,7
2078,tā,ta,3095,2956,139,0,2
2079,nānāvidhā,nanavidha,36,33,3,0,9
2080,ito,ito,4978,4714,264,0,3
2081,uppajjantīti,uppajjantiti,407,359,48,0,12
2082,nārāyanaṃ,narayanam,6,3,3,0,9
2083,vajiraṃ,vajiram,54,51,3,0,7
2084,nārāyanasaṅghāta,narayanasanghata,1,1,0,0,16
2085,vajirasaṅghātabalanti,vajirasanghatabalanti,5,5,0,0,21
2086,atthoti,atthoti,468,341,127,0,7
2087,ñāṇadasabalaṃ,nanadasabalam,1,1,0,0,13
2088,vibhaṅgapāḷiyañca,vibhangapaliyanca,1,1,0,0,17
2089,mūlapaṇṇāse,mulapannase,3,3,0,0,11
2090,sīhanādasutte,sihanadasutte,1,1,0,0,13
2091,dasakanipātaaṅguttarapāḷiyañca,dasakanipataanguttarapaliyanca,1,1,0,0,30
2092,vitthārena,vittharena,872,862,10,0,10
2093,dassayissāmi,dassayissami,15,15,0,0,12
2094,seyyathidaṃ,seyyathidam,1136,1070,66,0,11
2095,ṭhānāṭṭhānañāṇañca,thanatthananananca,1,1,0,0,18
2096,kammasamādānānaṃ,kammasamadananam,46,36,10,0,16
2097,vipākañāṇaṃ,vipakananam,2,2,0,0,11
2098,sabbatthagāminipaṭipadāñāṇaṃ,sabbatthagaminipatipadananam,6,5,1,0,28
2099,anekadhātu,anekadhatu,12,9,3,0,10
2100,nānādhātu,nanadhatu,8,4,4,0,9
2101,loka,loka,38,27,11,0,4
2102,nānādhimuttikataṃ,nanadhimuttikatam,30,23,7,0,17
2103,parasattānaṃ,parasattanam,109,95,14,0,12
2104,parapuggalānaṃ,parapuggalanam,84,73,11,0,14
2105,indriyaparopariyattiñāṇaṃ,indriyaparopariyattinanam,4,4,0,0,25
2106,jhānavimokkhasamādhisamāpattīnaṃ,jhanavimokkhasamadhisamapattinam,39,31,8,0,32
2107,saṃkilesaṃ,samkilesam,121,101,20,0,10
2108,vodānaṃ,vodanam,287,237,50,0,7
2109,vuṭṭhānaṃ,vutthanam,362,309,53,0,9
2110,pubbenivāsānussatiñāṇaṃ,pubbenivasanussatinanam,69,62,7,0,23
2111,cutūpapātaṃ,cutupapatam,28,23,5,0,11
2112,āsavānaṃ,asavanam,1084,991,93,0,8
2113,khayañāṇañcāti,khayananancati,1,1,0,0,14
2114,kamo,kamo,106,101,5,0,4
2115,abhidhammavibhaṅgapāḷiyaṃ,abhidhammavibhangapaliyam,1,1,0,0,25
2116,āgatakkamo,agatakkamo,1,1,0,0,10
2117,cutūpapātañāṇaṭṭhāne,cutupapatananatthane,2,2,0,0,20
2118,mūlapaṇṇāsapāḷiyaṃ,mulapannasapaliyam,1,1,0,0,18
2119,mahāsīhanādasutte,mahasihanadasutte,10,8,2,0,17
2120,dasakanipātaaṅguttarapāḷiyaṃ,dasakanipataanguttarapaliyam,1,1,0,0,28
2121,dibbacakkhuñāṇaṃ,dibbacakkhunanam,67,61,6,0,16
2122,atthato,atthato,2139,2012,127,0,7
2123,dibbacakkhuñāṇena,dibbacakkhunanena,14,14,0,0,17
2124,cutūpapātassa,cutupapatassa,1,1,0,0,13
2125,passitattā,passitatta,1,1,0,0,10
2126,sadisamevāti,sadisamevati,7,7,0,0,12
2127,ṭhānāṭṭhānañāṇanti,thanatthananananti,1,1,0,0,18
2128,kāraṇākāraṇaṃ,karanakaranam,34,31,3,0,13
2129,yathābhūtaṃ,yathabhutam,2666,2556,110,0,11
2130,jānanañāṇaṃ,jananananam,17,16,1,0,11
2131,kāraṇañhi,karananhi,39,39,0,0,9
2132,yasmā,yasma,7303,7089,214,0,5
2133,tadāyattavuttitāya,tadayattavuttitaya,26,26,0,0,18
2134,uppajjati,uppajjati,18166,18042,124,0,9
2135,pavattati,pavattati,1711,1696,15,0,9
2136,ṭhānanti,thananti,110,107,3,0,8
2137,vipākañāṇanti,vipakanananti,1,1,0,0,13
2138,samādiyitvā,samadiyitva,275,263,12,0,11
2139,katānaṃ,katanam,80,74,6,0,7
2140,atītānāgata,atitanagata,9,6,3,0,11
2141,paccuppannānaṃ,paccuppannanam,59,56,3,0,14
2142,kusalākusalakammānaṃ,kusalakusalakammanam,10,10,0,0,20
2143,sugatiduggatipaṭisandhisaṅkhātaṃ,sugatiduggatipatisandhisankhatam,1,1,0,0,32
2144,vipākaṃ,vipakam,1164,1117,47,0,7
2145,nibbānaphalañca,nibbanaphalanca,1,1,0,0,15
2146,pajānanañāṇaṃ,pajananananam,7,7,0,0,13
2147,sabbattha,sabbattha,4139,4027,112,0,9
2148,gāminipaṭipadaṃ,gaminipatipadam,1,1,0,0,15
2149,M0.0028,M0.0028,86,86,0,0,7
2150,ñāṇanti,nananti,167,163,4,0,7
2151,sabbagatigāminiñca,sabbagatigamininca,6,6,0,0,18
2152,paṭipadaṃ,patipadam,548,510,38,0,9
2153,maggaṃ,maggam,2982,2823,159,0,6
2154,paṭipadanti,patipadanti,7,7,0,0,11
2155,paṭipajjati,patipajjati,320,311,9,0,11
2156,pāpuṇāti,papunati,1267,1254,13,0,8
2157,gatigāmininti,gatigamininti,1,1,0,0,13
2158,nirayādipañcagatigāminiṃ,nirayadipancagatigaminim,1,1,0,0,24
2159,agatigāmininti,agatigamininti,1,1,0,0,14
2160,nibbānagāminiṃ,nibbanagaminim,12,12,0,0,14
2161,nibbānañcāhaṃ,nibbanancaham,7,6,1,0,13
2162,sāriputta,sariputta,1402,1371,31,0,9
2163,pajānāmi,pajanami,251,243,8,0,8
2164,nibbānagāminiñca,nibbanagamininca,21,20,1,0,16
2165,anekadhātunānādhātulokaṃ,anekadhatunanadhatulokam,15,15,0,0,24
2166,aneka,aneka,29,27,2,0,5
2167,dhātūti,dhatuti,105,79,26,0,7
2168,cakkhudhātuādīhi,cakkhudhatuadihi,8,8,0,0,16
2169,kāmadhātūhi,kamadhatuhi,1,1,0,0,11
2170,bahudhātuṃ,bahudhatum,7,7,0,0,10
2171,nānādhātūti,nanadhatuti,1,1,0,0,11
2172,tāsaṃyeva,tasamyeva,54,50,4,0,9
2173,dhātūnaṃ,dhatunam,424,407,17,0,8
2174,vilakkhaṇattā,vilakkhanatta,4,4,0,0,13
2175,visadisa,visadisa,2,2,0,0,8
2176,sabhāvattā,sabhavatta,21,20,1,0,10
2177,nānāppakāradhātuṃ,nanappakaradhatum,1,1,0,0,17
2178,lokanti,lokanti,38,38,0,0,7
2179,khandhāyatana,khandhayatana,6,5,1,0,13
2180,dhātulokaṃ,dhatulokam,3,3,0,0,10
2181,adhimuttikataṃ,adhimuttikatam,1,1,0,0,14
2182,hīnādīhi,hinadihi,11,9,2,0,8
2183,adhimuttīhi,adhimuttihi,9,7,2,0,11
2184,nānādhimuttikabhāvaṃ,nanadhimuttikabhavam,9,7,2,0,20
2185,indriyaparopariyattiñāṇanti,indriyaparopariyattinananti,2,2,0,0,27
2186,parasattānanti,parasattananti,1,1,0,0,14
2187,padhānasattānaṃ,padhanasattanam,8,8,0,0,15
2188,parapuggalānanti,parapuggalananti,1,1,0,0,16
2189,hīnasattānaṃ,hinasattanam,7,7,0,0,12
2190,ekatthameva,ekatthameva,12,12,0,0,11
2191,padadvayaṃ,padadvayam,105,104,1,0,10
2192,veneyyavasena,veneyyavasena,33,33,0,0,13
2193,dvedhā,dvedha,181,165,16,0,6
2194,saddhādīnaṃ,saddhadinam,112,112,0,0,11
2195,indriyānaṃ,indriyanam,638,604,34,0,10
2196,parabhāvaṃ,parabhavam,5,5,0,0,10
2197,vaḍḍhañca,vaddhanca,1,1,0,0,9
2198,aparabhāvaṃ,aparabhavam,1,1,0,0,11
2199,hāniñca,haninca,4,4,0,0,7
2200,jhānavimokkhasamādhisamāpattīnanti,jhanavimokkhasamadhisamapattinanti,1,1,0,0,34
2201,paṭhamādīnaṃ,pathamadinam,16,14,2,0,12
2202,catunnaṃ,catunnam,2600,2481,119,0,8
2203,jhānānaṃ,jhananam,237,220,17,0,8
2204,rūpī,rupi,309,279,30,0,4
2205,rūpāni,rupani,1046,1001,45,0,6
2206,passatītiādīnaṃ,passatitiadinam,2,2,0,0,15
2207,aṭṭhannaṃ,atthannam,376,346,30,0,9
2208,vimokkhānaṃ,vimokkhanam,44,39,5,0,11
2209,savitakkasavicārādīnaṃ,savitakkasavicaradinam,9,9,0,0,22
2210,samādhīnaṃ,samadhinam,27,24,3,0,10
2211,paṭhamajjhāna,pathamajjhana,1,1,0,0,13
2212,samāpattiādīnañca,samapattiadinanca,1,1,0,0,17
2213,navannaṃ,navannam,162,150,12,0,8
2214,anupubbasamāpattīnaṃ,anupubbasamapattinam,10,9,1,0,20
2215,saṃkilesanti,samkilesanti,3,3,0,0,12
2216,hānabhāgiyadhammaṃ,hanabhagiyadhammam,11,7,4,0,18
2217,vodānanti,vodananti,10,10,0,0,9
2218,visesabhāgiyadhammaṃ,visesabhagiyadhammam,8,6,2,0,20
2219,vuṭṭhānanti,vutthananti,22,21,1,0,11
2220,jhānādīhi,jhanadihi,24,24,0,0,9
2221,vuṭṭhahanti,vutthahanti,47,46,1,0,11
2222,pubbenivāsānussatiñāṇanti,pubbenivasanussatinananti,2,2,0,0,25
2223,pubbe,pubbe,5730,5475,255,0,5
2224,nivutthakkhandhānussaraṇasaṅkhātaṃ,nivutthakkhandhanussaranasankhatam,1,1,0,0,34
2225,cutiñca,cutinca,9,9,0,0,7
2226,upapātañca,upapatanca,3,3,0,0,10
2227,pajānanaṃ,pajananam,41,38,3,0,9
2228,khayañāṇanti,khayanananti,1,1,0,0,12
2229,kāmāsavādīnaṃ,kamasavadinam,15,14,1,0,13
2230,khayasaṅkhātaṃ,khayasankhatam,16,16,0,0,14
2231,āsavanirodhaṃ,asavanirodham,5,5,0,0,13
2232,pajānana,pajanana,1,1,0,0,8
2233,M0.0029,M0.0029,85,85,0,0,7
2234,ñāṇāni,nanani,338,324,14,0,6
2235,asādhāraṇāni,asadharanani,61,57,4,0,12
2236,dasabalañāṇānīti,dasabalanananiti,1,1,0,0,16
2237,daṭṭhabbāni,datthabbani,131,122,9,0,11
2238,cettha,cettha,2502,2456,46,0,6
2239,ṭhānāṭṭhānaṃ,thanatthanam,5,4,1,0,12
2240,vipākañca,vipakanca,56,56,0,0,9
2241,anekadhātulokañca,anekadhatulokanca,1,1,0,0,17
2242,adhimuttikaṃ,adhimuttikam,1,1,0,0,12
2243,setavavipulāgāthāti,setavavipulagathati,1,1,0,0,19
2244,indriyaparāparañca,indriyaparaparanca,1,1,0,0,18
2245,jhānādinaṃ,jhanadinam,1,1,0,0,10
2246,pubbenivāsānussatiṃ,pubbenivasanussatim,14,13,1,0,19
2247,āsavakkhayaṃ,asavakkhayam,83,77,6,0,12
2248,dasimāni,dasimani,1,1,0,0,8
2249,cā,ca,2624,1987,637,0,2
2250,sādhāraṇāni,sadharanani,53,50,3,0,11
2251,ñāṇānī,nanani,12,5,7,0,6
2252,sāmaññagāthāti,samannagathati,1,1,0,0,14
2253,nanu,nanu,2979,2859,120,0,4
2254,dasabalañāṇaṃ,dasabalananam,49,46,3,0,13
2255,pāṭiyekkaṃ,patiyekkam,166,148,18,0,10
2256,sabbaññutañāṇameva,sabbannutananameva,2,2,0,0,18
2257,dasabhedena,dasabhedena,1,1,0,0,11
2258,vuccate,vuccate,674,670,4,0,7
2259,aññameva,annameva,49,49,0,0,8
2260,sabbaññutañāṇaṃ,sabbannutananam,70,70,0,0,15
2261,dasabalañhi,dasabalanhi,1,1,0,0,11
2262,sakasakakiccameva,sakasakakiccameva,9,7,2,0,17
2263,avasesampi,avasesampi,13,13,0,0,10
2264,pajānāti,pajanati,2931,2901,30,0,8
2265,dasabalañāṇesu,dasabalananesu,8,8,0,0,14
2266,kāraṇākāraṇameva,karanakaranameva,9,9,0,0,16
2267,dutiyaṃ,dutiyam,2458,2374,84,0,7
2268,kammantara,kammantara,1,1,0,0,10
2269,vipākantarameva,vipakantarameva,2,2,0,0,15
2270,tatiyaṃ,tatiyam,1935,1889,46,0,7
2271,kammaparicchedameva,kammaparicchedameva,9,9,0,0,19
2272,catutthaṃ,catuttham,1881,1835,46,0,9
2273,dhātu,dhatu,876,842,34,0,5
2274,nānattakāraṇameva,nanattakaranameva,2,2,0,0,17
2275,pañcamaṃ,pancamam,1144,1126,18,0,8
2276,ajjhāsayādhimuttimeva,ajjhasayadhimuttimeva,8,8,0,0,21
2277,chaṭṭhaṃ,chattham,850,839,11,0,8
2278,tikkhamudubhāvameva,tikkhamudubhavameva,9,9,0,0,19
2279,sattamaṃ,sattamam,865,847,18,0,8
2280,saṃkilesādimeva,samkilesadimeva,9,9,0,0,15
2281,aṭṭhamaṃ,atthamam,807,793,14,0,8
2282,nivutthakhandhasantatimeva,nivutthakhandhasantatimeva,1,1,0,0,26
2283,navamaṃ,navamam,705,693,12,0,7
2284,cutipaṭisandhimeva,cutipatisandhimeva,8,8,0,0,18
2285,dasamaṃ,dasamam,739,728,11,0,7
2286,saccaparicchedameva,saccaparicchedameva,9,9,0,0,19
2287,jānitabbañca,janitabbanca,9,9,0,0,12
2288,uttariñca,uttarinca,23,21,2,0,9
2289,kiccaṃ,kiccam,943,866,77,0,6
2290,sabbaṃ,sabbam,7306,6788,518,0,6
2291,jhānaṃ,jhanam,3907,3794,113,0,6
2292,appetuṃ,appetum,58,43,15,0,7
2293,iddhi,iddhi,535,463,72,0,5
2294,vikubbituṃ,vikubbitum,14,11,3,0,10
2295,maggo,maggo,3176,3004,172,0,5
2296,khepetuṃ,khepetum,16,15,1,0,8
2297,ñāṇadvayānaṃ,nanadvayanam,1,1,0,0,12
2298,visesoti,visesoti,200,159,41,0,8
2299,ñāṇadvayaṃ,nanadvayam,14,14,0,0,10
2300,adhippetanti,adhippetanti,138,138,0,0,12
2301,atulanti,atulanti,4,3,1,0,8
2302,M0.0030,M0.0030,86,86,0,0,7
2303,sīlādīhi,siladihi,97,97,0,0,8
2304,tulanaṃ,tulanam,5,4,1,0,7
2305,ummānaṃ,ummanam,4,4,0,0,7
2306,tulā,tula,86,73,13,0,4
2307,tula,tula,16,6,10,0,4
2308,sadisyaṃ,sadisyam,1,1,0,0,8
2309,saddanītiya,saddanitiya,1,0,1,0,11
2310,ñhi,nhi,33,33,0,0,3
2311,ummāne,ummane,6,5,1,0,6
2312,tuliyati,tuliyati,1,1,0,0,8
2313,pamiyati,pamiyati,2,2,0,0,8
2314,etāyāti,etayati,442,424,18,0,7
2315,pakatitulā,pakatitula,1,1,0,0,10
2316,viyāti,viyati,1144,780,364,0,6
2317,sammito,sammito,7,7,0,0,7
2318,tulo,tulo,11,11,0,0,4
2319,sammita,sammita,1,1,0,0,7
2320,taddhite,taddhite,7,6,1,0,8
2321,apaccayo,apaccayo,20,19,1,0,8
2322,tulasadisañāṇena,tulasadisananena,1,1,0,0,16
2323,atulo,atulo,66,61,5,0,5
2324,kammadhārayamissakatappurisa,kammadharayamissakatappurisa,1,1,0,0,28
2325,samāsoyaṃ,samasoyam,5,5,0,0,9
2326,atagguṇasaṃviññāṇoyaṃ,ataggunasamvinnanoyam,1,1,0,0,21
2327,bahubbīhi,bahubbihi,44,38,6,0,9
2328,aggapuggaloti,aggapuggaloti,2,2,0,0,13
2329,sadevake,sadevake,397,385,12,0,8
2330,aggapuggalabhāvato,aggapuggalabhavato,2,2,0,0,18
2331,yathāha,yathaha,1732,1718,14,0,7
2332,apadā,apada,48,46,2,0,5
2333,dvipadā,dvipada,37,36,1,0,7
2334,catuppadā,catuppada,44,43,1,0,9
2335,aggamakkhāyati,aggamakkhayati,189,189,0,0,14
2336,dvipadānañca,dvipadananca,19,17,2,0,12
2337,cakkhumā,cakkhuma,481,458,23,0,8
2338,atulaṃ,atulam,98,74,24,0,6
2339,buddhanti,buddhanti,3,2,1,0,9
2340,vandeti,vandeti,26,6,20,0,7
2341,nayanasubhagakāyaṅgādiguṇaṃ,nayanasubhagakayangadigunam,1,1,0,0,27
2342,anussaritvā,anussaritva,157,154,3,0,11
2343,vandāmīti,vandamiti,33,31,2,0,9
2344,mahāvisayasuttena,mahavisayasuttena,1,1,0,0,17
2345,ekārā,ekara,2,2,0,0,5
2346,desoti,desoti,13,5,8,0,6
2347,kāyavacīmanovandanāvasenāti,kayavacimanovandanavasenati,1,1,0,0,27
2348,tisso,tisso,2567,2403,164,0,5
2349,imā,ima,2655,2601,54,0,3
2350,katamā,katama,1920,1876,44,0,6
2351,vandati,vandati,172,168,4,0,7
2352,manasā,manasa,1192,1134,58,0,6
2353,vandatī,vandati,52,50,2,0,7
2354,yoniso,yoniso,855,779,76,0,6
2355,manasikāracittaṃ,manasikaracittam,1,1,0,0,16
2356,paccupaṭṭhāpetvā,paccupatthapetva,41,41,0,0,16
2357,jāṇudvayakapparadvayanalāṭasaṅkhātāni,janudvayakapparadvayanalatasankhatani,1,1,0,0,37
2358,pañca,panca,9343,8933,410,0,5
2359,aṅgāni,angani,978,961,17,0,6
2360,bhūmiyaṃ,bhumiyam,862,829,33,0,8
2361,patiṭṭhāpetvā,patitthapetva,283,282,1,0,13
2362,vandaneyyānaṃ,vandaneyyanam,9,9,0,0,13
2363,abhimukhaṃ,abhimukham,196,188,8,0,10
2364,nipatanto,nipatanto,3,3,0,0,9
2365,sandhāya,sandhaya,5933,5817,116,0,8
2366,pañcapatiṭṭhitena,pancapatitthitena,151,149,2,0,17
2367,vanditvā,vanditva,2140,2125,15,0,8
2368,kathādīsu,kathadisu,5,5,0,0,9
2369,buddhaguṇapadāni,buddhagunapadani,1,1,0,0,16
2370,pavattento,pavattento,60,60,0,0,10
2371,vipassissa,vipassissa,376,367,9,0,10
2372,namatthu,namatthu,69,65,4,0,8
2373,sikhissāpi,sikhissapi,8,7,1,0,10
2374,vessa,vessa,1,1,0,0,5
2375,bhussa,bhussa,7,7,0,0,6
2376,kakusandhassa,kakusandhassa,77,74,3,0,13
2377,koṇāgamanassa,konagamanassa,52,52,0,0,13
2378,M0.0031,M0.0031,86,86,0,0,7
2379,kassapassa,kassapassa,305,299,6,0,10
2380,aṅgīrassassa,angirassassa,1,1,0,0,12
2381,tyādīsupi,tyadisupi,4,4,0,0,9
2382,vācāvandanāyeva,vacavandanayeva,1,1,0,0,15
2383,buddhādi,buddhadi,1,1,0,0,8
2384,guṇāni,gunani,10,9,1,0,6
2385,anussaranto,anussaranto,99,95,4,0,11
2386,piyapemanīyena,piyapemaniyena,1,1,0,0,14
2387,assādi,assadi,1,1,0,0,6
2388,uttamasaddena,uttamasaddena,1,1,0,0,13
2389,anaññasādhāraṇena,anannasadharanena,18,18,0,0,17
2390,kāyañāṇadasa,kayananadasa,1,1,0,0,12
2391,balena,balena,221,217,4,0,6
2392,dutiyavandanagāthāvaṇṇanā,dutiyavandanagathavannana,1,1,0,0,25
2393,naradeva,naradeva,6,6,0,0,8
2394,maṅgalaṃ,mangalam,307,287,20,0,8
2395,tatiyagāthāya,tatiyagathaya,37,37,0,0,13
2396,samādhi,samadhi,1321,1236,85,0,7
2397,ādīhi,adihi,23,22,1,0,5
2398,vanditukāmo,vanditukamo,19,19,0,0,11
2399,dhitimāññadhārakotiādigāthamāha,dhitimannadharakotiadigathamaha,1,0,1,0,31
2400,masajagaṇa,masajagana,1,1,0,0,10
2401,garuyuttattā,garuyuttatta,1,1,0,0,12
2402,dasakkharehi,dasakkharehi,1,1,0,0,12
2403,suddhavirā,suddhavira,2,2,0,0,10
2404,jitagāthāti,jitagathati,1,1,0,0,11
2405,msājgā,msajga,2,2,0,0,6
2406,jitaṃ,jitam,130,117,13,0,5
2407,matanti,matanti,27,27,0,0,7
2408,tassattho,tassattho,925,923,2,0,9
2409,msā,msa,1,1,0,0,3
2410,masagaṇā,masagana,1,1,0,0,8
2411,jgā,jga,3,3,0,0,3
2412,jagaṇagarukā,jaganagaruka,2,2,0,0,12
2413,ce,ce,6555,6183,372,0,2
2414,siyyuṃ,siyyum,4,4,0,0,6
2415,suddhavirājitanti,suddhavirajitanti,1,1,0,0,17
2416,ñātabbanti,natabbanti,26,26,0,0,10
2417,dhitimā,dhitima,58,56,2,0,7
2418,aññadhārako,annadharako,4,4,0,0,11
2419,dukkhañca,dukkhanca,147,139,8,0,9
2420,cetasikaṃ,cetasikam,462,427,35,0,9
2421,M0.0032,M0.0032,84,84,0,0,7
2422,yoti,yoti,143,15,128,0,4
2423,aniyamaniddeso,aniyamaniddeso,11,11,0,0,14
2424,yādisoti,yadisoti,6,1,5,0,8
2425,aniyamavācaka,aniyamavacaka,2,2,0,0,13
2426,sabbanāmapadattā,sabbanamapadatta,1,1,0,0,16
2427,ya,ya,400,145,255,0,2
2428,oti,oti,3,2,1,0,3
2429,yasaddassa,yasaddassa,4,4,0,0,10
2430,aniyamo,aniyamo,9,9,0,0,7
2431,yādisayuttajaccanāmagottasīlavihārī,yadisayuttajaccanamagottasilavihari,1,1,0,0,35
2432,gocarasaṅkhātaṃ,gocarasankhatam,1,1,0,0,15
2433,aniyamasāmaññākārattaguṇameva,aniyamasamannakarattagunameva,1,1,0,0,29
2434,paṭhamāsivibhattiyā,pathamasivibhattiya,1,1,0,0,19
2435,kāriyabhūtassa,kariyabhutassa,3,3,0,0,14
2436,okārassa,okarassa,30,30,0,0,8
2437,pakatūpanissayasaṅkhātaṃ,pakatupanissayasankhatam,1,1,0,0,24
2438,kattukārakekavacanasaṅkhyaṃ,kattukarakekavacanasankhyam,1,1,0,0,27
2439,sabbanāmabhāvaṃ,sabbanamabhavam,2,2,0,0,15
2440,yāti,yati,348,296,52,0,4
2441,aniyamavācakabhāvaṃ,aniyamavacakabhavam,1,1,0,0,19
2442,sabbanāma,sabbanama,8,6,2,0,9
2443,bhāvena,bhavena,283,283,0,0,7
2444,pavattatīti,pavattatiti,902,869,33,0,11
2445,sabbanāmabhāvena,sabbanamabhavena,3,3,0,0,16
2446,yātabbo,yatabbo,4,4,0,0,7
2447,ñātabboti,natabboti,40,40,0,0,9
2448,ñātabbo,natabbo,82,81,1,0,7
2449,aniyamatthoti,aniyamatthoti,3,3,0,0,13
2450,tenāhu,tenahu,157,157,0,0,6
2451,porāṇā,porana,282,272,10,0,6
2452,nānākāraṇaṃ,nanakaranam,9,9,0,0,11
2453,paṭicca,paticca,15885,15766,119,0,7
2454,dhātupaccayaviggahaṃ,dhatupaccayaviggaham,1,1,0,0,20
2455,cintakānaṃ,cintakanam,1,1,0,0,10
2456,pabhāvova,pabhavova,1,1,0,0,9
2457,padhānaṃ,padhanam,469,408,61,0,8
2458,cintane,cintane,2,2,0,0,7
2459,buddhoti,buddhoti,397,285,112,0,8
2460,paṭividdhacatusaccadhammo,patividdhacatusaccadhammo,3,3,0,0,25
2461,bujjhati,bujjhati,124,122,2,0,8
2462,cattāri,cattari,5137,4903,234,0,7
2463,saccānīti,saccaniti,69,47,22,0,9
2464,suddhakattusādhanoyaṃ,suddhakattusadhanoyam,2,2,0,0,21
2465,budhadhātu,budhadhatu,4,4,0,0,10
2466,bodhetā,bodheta,40,34,6,0,7
2467,pajāyāti,pajayati,48,29,19,0,8
2468,saccāni,saccani,1001,955,46,0,7
2469,bodhetīti,bodhetiti,29,28,1,0,9
2470,anaññabodhito,anannabodhito,3,3,0,0,13
2471,savāsanāya,savasanaya,12,12,0,0,10
2472,sammohaniddāya,sammohaniddaya,3,3,0,0,14
2473,jāgarotīti,jagarotiti,2,2,0,0,10
2474,dinakarakiraṇa,dinakarakirana,1,1,0,0,14
2475,samāgamena,samagamena,9,9,0,0,10
2476,paramarucirasirīsobhaggappattiyā,paramarucirasirisobhaggappattiya,2,2,0,0,32
2477,vikasitamiva,vikasitamiva,9,9,0,0,12
2478,padumaṃ,padumam,346,314,32,0,7
2479,aggamaggañāṇasamāgamena,aggamaggananasamagamena,3,3,0,0,23
2480,aparimitaguṇagaṇālaṅkata,aparimitagunaganalankata,1,1,0,0,24
2481,sabbaññutañāṇappattiyā,sabbannutananappattiya,1,1,0,0,22
2482,vikasatīti,vikasatiti,7,6,1,0,10
2483,saṅkhātaṃ,sankhatam,63,63,0,0,9
2484,ekāyanamaggaṃ,ekayanamaggam,31,26,5,0,13
2485,budhasaddo,budhasaddo,2,2,0,0,10
2486,ñāṇādīsu,nanadisu,1,1,0,0,8
2487,catūsvatthesu,catusvatthesu,8,8,0,0,13
2488,M0.0033,M0.0033,85,85,0,0,7
2489,ñāṇe,nane,190,182,8,0,4
2490,vikasane,vikasane,15,13,2,0,8
2491,gamane,gamane,394,376,18,0,6
2492,cāpi,capi,944,881,63,0,4
2493,jāgare,jagare,4,4,0,0,6
2494,catūsvetesu,catusvetesu,4,4,0,0,11
2495,atthesu,atthesu,260,245,15,0,7
2496,pavattatī,pavattati,107,87,20,0,9
2497,sabbañeyyadhamme,sabbaneyyadhamme,3,3,0,0,16
2498,jānātīti,janatiti,617,440,177,0,8
2499,pārami,parami,12,11,1,0,6
2500,bhāvitāya,bhavitaya,67,67,0,0,9
2501,paññāya,pannaya,2535,2389,146,0,7
2502,saṅkhatāsaṅkhatadhamme,sankhatasankhatadhamme,3,3,0,0,22
2503,abujjhi,abujjhi,20,20,0,0,7
2504,bujjhissatīti,bujjhissatiti,14,14,0,0,13
2505,sammāsambuddho,sammasambuddho,1097,1060,37,0,14
2506,vata,vata,3454,3276,178,0,4
2507,bhagavāti,bhagavati,605,354,251,0,9
2508,adhigatañāṇaguṇavisesehi,adhigatananagunavisesehi,1,1,0,0,24
2509,bujjhitabboti,bujjhitabboti,4,4,0,0,13
2510,bujjhitabbaṃ,bujjhitabbam,23,23,0,0,12
2511,kiṃ,kim,14068,13281,787,0,3
2512,sabbaññuta,sabbannuta,11,11,0,0,10
2513,tadassatthīti,tadassatthiti,10,8,2,0,13
2514,pāramitā,paramita,16,13,3,0,8
2515,bhāvito,bhavito,333,305,28,0,7
2516,sayambhūñāṇena,sayambhunanena,41,41,0,0,14
2517,saha,saha,4185,3959,226,0,4
2518,vāsanāya,vasanaya,42,42,0,0,8
2519,vihataviddhasta,vihataviddhasta,1,1,0,0,15
2520,niravasesakleso,niravasesakleso,1,1,0,0,15
2521,mahākaruṇāsabbaññutañāṇādiapari,mahakarunasabbannutananadiapari,1,1,0,0,31
2522,meyyaguṇagaṇādhāro,meyyagunaganadharo,1,1,0,0,18
2523,khandhasantāno,khandhasantano,27,27,0,0,14
2524,anācariyako,anacariyako,39,39,0,0,11
2525,ananussutesu,ananussutesu,182,180,2,0,12
2526,dhammesu,dhammesu,2632,2502,130,0,8
2527,sāmaṃ,samam,695,619,76,0,5
2528,abhisambujjhi,abhisambujjhi,31,31,0,0,13
2529,sabbaññutaṃ,sabbannutam,275,265,10,0,11
2530,patto,patto,2175,2076,99,0,5
2531,balesu,balesu,76,71,5,0,6
2532,vasībhāvaṃ,vasibhavam,67,62,5,0,10
2533,sabbaññubuddha,sabbannubuddha,2,2,0,0,14
2534,paccekabuddha,paccekabuddha,6,6,0,0,13
2535,catusaccabuddha,catusaccabuddha,1,1,0,0,15
2536,suta,suta,20,9,11,0,4
2537,buddhavasena,buddhavasena,1,1,0,0,12
2538,catubbidho,catubbidho,234,217,17,0,10
2539,kappasatasahassādhikāni,kappasatasahassadhikani,47,46,1,0,23
2540,asaṅkhyeyyāni,asankhyeyyani,190,188,2,0,13
2541,samatiṃsapāramiyo,samatimsaparamiyo,15,15,0,0,17
2542,pūretvā,puretva,1119,1085,34,0,7
2543,sambodhippatto,sambodhippatto,3,3,0,0,14
2544,sabbaññubuddho,sabbannubuddho,28,26,2,0,14
2545,pāramiyo,paramiyo,411,404,7,0,8
2546,sayambhūpatto,sayambhupatto,1,1,0,0,13
2547,paccekabuddho,paccekabuddho,256,246,10,0,13
2548,avasesā,avasesa,1459,1423,36,0,7
2549,khīṇāsavā,khinasava,288,275,13,0,9
2550,catusaccabuddho,catusaccabuddho,7,4,3,0,15
2551,bahussuto,bahussuto,473,455,18,0,9
2552,sutabuddho,sutabuddho,8,5,3,0,10
2553,adhippeto,adhippeto,851,823,28,0,9
2554,dhitimāññadhārakoti,dhitimannadharakoti,1,0,1,0,19
2555,aññadhārakoti,annadharakoti,2,1,1,0,13
2556,padacchedo,padacchedo,240,238,2,0,10
2557,dhitimāti,dhitimati,7,2,5,0,9
2558,samādhivanto,samadhivanto,2,2,0,0,12
2559,sampayutta,sampayutta,38,32,6,0,10
2560,ekārammaṇe,ekarammane,57,56,1,0,10
2561,dhāretīti,dharetiti,202,189,13,0,9
2562,dhiti,dhiti,93,80,13,0,5
2563,dhādhātuti,dhadhatuti,1,1,0,0,10
2564,ākārassa,akarassa,67,67,0,0,8
2565,ikārādeso,ikaradeso,3,3,0,0,9
2566,dhiyati,dhiyati,5,5,0,0,7
2567,ṭhapeti,thapeti,465,452,13,0,7
2568,sampayuttadhammeti,sampayuttadhammeti,3,3,0,0,18
2569,cittena,cittena,1755,1694,61,0,7
2570,yogeneveso,yogeneveso,1,1,0,0,10
2571,ekā,eka,2068,1981,87,0,3
2572,rammaṇe,rammane,10,10,0,0,7
2573,M0.0034,M0.0034,86,86,0,0,7
2574,patiṭṭhāpanavasena,patitthapanavasena,11,11,0,0,18
2575,cittassa,cittassa,3916,3754,162,0,8
2576,ārammaṇe,arammane,2614,2577,37,0,8
2577,niccalabhāvena,niccalabhavena,24,24,0,0,14
2578,patiṭṭhāpetīti,patitthapetiti,30,21,9,0,14
2579,mahāmeru,mahameru,2,2,0,0,8
2580,disāhi,disahi,66,65,1,0,6
2581,bhusaṃ,bhusam,308,289,19,0,6
2582,āgatehi,agatehi,74,72,2,0,7
2583,vātehi,vatehi,37,35,2,0,6
2584,samiñjati,saminjati,3,3,0,0,9
2585,paṭipakkhehi,patipakkhehi,54,54,0,0,12
2586,micchāvāda,micchavada,2,2,0,0,10
2587,iṭṭhāniṭṭhārammaṇehi,itthanittharammanehi,1,1,0,0,20
2588,lābhālābha,labhalabha,2,2,0,0,10
2589,yasāyasa,yasayasa,2,2,0,0,8
2590,nindā,ninda,60,57,3,0,5
2591,pasaṃsa,pasamsa,2,2,0,0,7
2592,sukhadukkhasaṅkhātehi,sukhadukkhasankhatehi,1,1,0,0,21
2593,lokadhammehi,lokadhammehi,63,61,2,0,12
2594,samādhivantoyeva,samadhivantoyeva,1,1,0,0,16
2595,arahattaphalahārako,arahattaphalaharako,1,1,0,0,19
2596,vimuttisaṅkhātaṃ,vimuttisankhatam,3,3,0,0,16
2597,arahattaphalasetacchattaṃ,arahattaphalasetacchattam,1,1,0,0,25
2598,dhārento,dharento,102,99,3,0,8
2599,paṭhama,pathama,53,50,3,0,7
2600,diṭṭhasaccassa,ditthasaccassa,2,2,0,0,14
2601,āmariyādaṃ,amariyadam,1,1,0,0,10
2602,anatikkamitvā,anatikkamitva,125,120,5,0,13
2603,arahattaphalaṃ,arahattaphalam,207,194,13,0,14
2604,āpubbañādhātu,apubbanadhatu,2,2,0,0,13
2605,āsaddo,asaddo,8,8,0,0,6
2606,mariyādattho,mariyadattho,18,18,0,0,12
2607,saṃyogaparattā,samyogaparatta,5,5,0,0,14
2608,rasso,rasso,352,337,15,0,5
2609,aññasaddūpapadadharadhātu,annasaddupapadadharadhatu,1,1,0,0,25
2610,saṃsāreti,samsareti,7,3,4,0,9
2611,khandhadhātuāyatanānaṃ,khandhadhatuayatananam,9,8,1,0,22
2612,abbocchinnaṃ,abbocchinnam,57,53,4,0,12
2613,pavattamāne,pavattamane,80,79,1,0,11
2614,aṭṭhakathāyaṃ,atthakathayam,1924,1172,752,0,13
2615,khandhānañca,khandhananca,40,38,2,0,12
2616,paṭipāṭi,patipati,53,52,1,0,8
2617,dhātuāyatanāna,dhatuayatanana,24,24,0,0,14
2618,vattamānā,vattamana,157,145,12,0,9
2619,saṃsāroti,samsaroti,31,25,6,0,9
2620,pavuccatī,pavuccati,97,95,2,0,9
2621,aññamaññasambandhena,annamannasambandhena,3,3,0,0,20
2622,saṃpunappunaṃ,sampunappunam,2,2,0,0,13
2623,saṃsāro,samsaro,185,170,15,0,7
2624,saṃpubbasaradhātu,sampubbasaradhatu,2,2,0,0,17
2625,khandhāyatanadhātuyo,khandhayatanadhatuyo,23,22,1,0,20
2626,saṃ,sam,3631,3480,151,0,3
2627,pavattanti,pavattanti,615,610,5,0,10
2628,tasmiṃ,tasmim,12887,12428,459,0,6
2629,anubhosīti,anubhositi,3,1,2,0,10
2630,anupunappunaṃ,anupunappunam,3,3,0,0,13
2631,abhuñji,abhunji,5,5,0,0,7
2632,avedayīti,avedayiti,1,1,0,0,9
2633,kāye,kaye,1384,1306,78,0,4
2634,sarīre,sarire,760,745,15,0,6
2635,cetasi,cetasi,51,50,1,0,6
2636,dukkhantipade,dukkhantipade,1,1,0,0,13
2637,vaṭṭadukkhaṃ,vattadukkham,86,76,10,0,12
2638,dukkhanaṃ,dukkhanam,3,3,0,0,9
2639,dukkhayatīti,dukkhayatiti,25,25,0,0,12
2640,dukkhadhātu,dukkhadhatu,8,8,0,0,11
2641,nibbacanaṃ,nibbacanam,150,147,3,0,10
2642,kāritavasena,karitavasena,10,10,0,0,12
2643,dukkhitaṃ,dukkhitam,96,82,14,0,9
2644,lokatoti,lokatoti,6,2,4,0,8
2645,sattalokahetu,sattalokahetu,2,2,0,0,13
2646,M0.0035,M0.0035,85,85,0,0,7
2647,puññāpuññāni,punnapunnani,16,15,1,0,12
2648,kusalādīni,kusaladini,18,15,3,0,10
2649,lāti,lati,38,38,0,0,4
2650,gaṇhātīti,ganhatiti,237,182,55,0,9
2651,lādhātu,ladhatu,3,3,0,0,7
2652,okapaccayo,okapaccayo,1,1,0,0,10
2653,lokova,lokova,5,5,0,0,6
2654,nimuggānaṃ,nimugganam,5,5,0,0,10
2655,sattānamanudayāya,sattanamanudayaya,1,1,0,0,17
2656,saṃsāravaṭṭadukkhato,samsaravattadukkhato,3,3,0,0,20
2657,pamocetukāmo,pamocetukamo,1,1,0,0,12
2658,atidukkarāni,atidukkarani,11,10,1,0,12
2659,pariccāge,pariccage,8,8,0,0,9
2660,saṃsāravaṭṭadukkhaṃ,samsaravattadukkham,1,1,0,0,19
2661,anubhavasīti,anubhavasiti,1,1,0,0,12
2662,tādisaṃ,tadisam,784,733,51,0,7
2663,maṅgalabhūtaṃ,mangalabhutam,3,3,0,0,13
2664,vacanatto,vacanatto,1,1,0,0,9
2665,nirayaṃ,nirayam,821,782,39,0,7
2666,naro,naro,643,599,44,0,4
2667,nidhātu,nidhatu,2,2,0,0,7
2668,pāpunane,papunane,1,1,0,0,8
2669,aro,aro,59,58,1,0,3
2670,ariyamanusso,ariyamanusso,1,1,0,0,12
2671,bhūtapubbagatika,bhutapubbagatika,1,1,0,0,16
2672,nayena,nayena,3147,3123,24,0,6
2673,seṭṭhabhāvaṃ,setthabhavam,31,31,0,0,12
2674,uttamaṃ,uttamam,483,424,59,0,7
2675,pabbajjaṃ,pabbajjam,702,676,26,0,9
2676,vimānavatthuaṭṭhakathāyaṃ,vimanavatthuatthakathayam,6,2,4,0,25
2677,puttabhātubhūtopi,puttabhatubhutopi,5,5,0,0,17
2678,mātujeṭṭhabhaginīnaṃ,matujetthabhagininam,6,6,0,0,20
2679,pituṭṭhāne,pitutthane,16,16,0,0,10
2680,pageva,pageva,847,836,11,0,6
2681,bhattubhūto,bhattubhuto,3,3,0,0,11
2682,itarāsanti,itarasanti,3,3,0,0,10
2683,visuddhimaggamahāṭīkāyaṃ,visuddhimaggamahatikayam,3,0,3,0,24
2684,naratīti,naratiti,2,2,0,0,8
2685,puriso,puriso,3640,3567,73,0,6
2686,paṭhamapakatibhūto,pathamapakatibhuto,5,5,0,0,18
2687,satto,satto,1047,990,57,0,5
2688,itarāya,itaraya,50,49,1,0,7
2689,pakatiyā,pakatiya,529,503,26,0,8
2690,seṭṭhaṭṭhena,setthatthena,53,53,0,0,12
2691,puriucce,puriucce,1,1,0,0,8
2692,ṭhāne,thane,2421,2340,81,0,5
2693,seti,seti,308,287,21,0,4
2694,purisoti,purisoti,119,73,46,0,8
2695,nayanaṭṭhena,nayanatthena,9,9,0,0,12
2696,naroti,naroti,46,11,35,0,6
2697,puttabhātu,puttabhatu,1,1,0,0,10
2698,bhūtopi,bhutopi,1,1,0,0,7
2699,pituṭhāne,pituthane,1,1,0,0,9
2700,itarā,itara,449,414,35,0,5
2701,naranti,naranti,7,7,0,0,7
2702,sāmaññena,samannena,189,184,5,0,9
2703,vuttampi,vuttampi,513,482,31,0,8
2704,purisanaranti,purisanaranti,1,1,0,0,13
2705,viññāyati,vinnayati,640,632,8,0,9
2706,padhānanayena,padhananayena,2,2,0,0,13
2707,gahaṇassa,gahanassa,67,66,1,0,9
2708,yuttattā,yuttatta,74,71,3,0,8
2709,dibbanti,dibbanti,55,54,1,0,8
2710,kāmaguṇa,kamaguna,2,2,0,0,8
2711,jhānābhiññācittissariyādīhi,jhanabhinnacittissariyadihi,1,1,0,0,27
2712,kīḷantīti,kilantiti,24,15,9,0,9
2713,devā,deva,2099,2012,87,0,4
2714,divudhātu,divudhatu,4,4,0,0,9
2715,sarīrālaṅkārajutiyā,sariralankarajutiya,1,1,0,0,19
2716,dibbantīti,dibbantiti,27,26,1,0,10
2717,sammutidevā,sammutideva,40,32,8,0,11
2718,upapattidevā,upapattideva,59,53,6,0,12
2719,visuddhidevā,visuddhideva,33,28,5,0,12
2720,mahāsammatakālato,mahasammatakalato,3,3,0,0,17
2721,paṭṭhāya,patthaya,4927,4862,65,0,8
2722,lokena,lokena,173,164,9,0,6
2723,M0.0036,M0.0036,85,85,0,0,7
2724,devāti,devati,200,133,67,0,6
2725,sammatattā,sammatatta,18,17,1,0,10
2726,rājāno,rajano,701,684,17,0,6
2727,deviyo,deviyo,37,37,0,0,6
2728,rājakumārā,rajakumara,61,57,4,0,10
2729,devaloke,devaloke,711,696,15,0,8
2730,upapannā,upapanna,242,239,3,0,8
2731,buddhapaccekabuddhakhīṇāsavā,buddhapaccekabuddhakhinasava,10,9,1,0,28
2732,adhippetā,adhippeta,733,697,36,0,9
2733,tantipade,tantipade,1,1,0,0,9
2734,maṅganti,manganti,2,2,0,0,8
2735,vaḍḍhenti,vaddhenti,58,55,3,0,9
2736,sabbasampattīhi,sabbasampattihi,12,12,0,0,15
2737,maṅgalo,mangalo,53,46,7,0,7
2738,maṅgala,mangala,20,18,2,0,7
2739,vaḍḍhane,vaddhane,24,22,2,0,8
2740,alo,alo,71,71,0,0,3
2741,maṅgaṃ,mangam,1,1,0,0,6
2742,pāpaṃ,papam,1103,1003,100,0,5
2743,desanāya,desanaya,751,726,25,0,8
2744,lunāti,lunati,53,53,0,0,6
2745,chindatīti,chindatiti,73,56,17,0,10
2746,maṅgasaddūpapadaludhātu,mangasaddupapadaludhatu,1,1,0,0,23
2747,narā,nara,254,242,12,0,4
2748,naradevā,naradeva,3,3,0,0,8
2749,naradevamaṅgalo,naradevamangalo,1,1,0,0,15
2750,manussadevabrahmānaṃ,manussadevabrahmanam,2,2,0,0,20
2751,pūjanīyattā,pujaniyatta,6,6,0,0,11
2752,saṅkhe,sankhe,14,14,0,0,6
2753,cakkaṃ,cakkam,531,493,38,0,6
2754,puṇṇakumbho,punnakumbho,6,6,0,0,11
2755,garā,gara,1,1,0,0,4
2756,sirī,siri,126,113,13,0,4
2757,setacchattaṃ,setacchattam,140,130,10,0,12
2758,aṅkuso,ankuso,35,22,13,0,6
2759,dhajaṃ,dhajam,105,95,10,0,6
2760,sovattikañcāti,sovattikancati,1,1,0,0,14
2761,aṭṭhahi,atthahi,591,562,29,0,7
2762,lokiyamaṅgalehi,lokiyamangalehi,1,1,0,0,15
2763,seṭṭhattā,setthatta,22,22,0,0,9
2764,uttamattā,uttamatta,17,17,0,0,9
2765,naradevamaṅgalanti,naradevamangalanti,1,1,0,0,18
2766,adhippāyoti,adhippayoti,89,54,35,0,11
2767,arahattaphaladhārako,arahattaphaladharako,1,1,0,0,20
2768,arahattaphalase,arahattaphalase,1,1,0,0,15
2769,tacchattaṃ,tacchattam,1,1,0,0,10
2770,yādiso,yadiso,237,230,7,0,6
2771,vaṭṭadukkhañca,vattadukkhanca,9,9,0,0,14
2772,lokahetu,lokahetu,2,2,0,0,8
2773,punappunaṃ,punappunam,1994,1871,123,0,10
2774,abhavasi,abhavasi,4,4,0,0,8
2775,avedayi,avedayi,1,1,0,0,7
2776,tatiyavandanagāthāvaṇṇanā,tatiyavandanagathavannana,1,1,0,0,25
2777,M0.0037,M0.0037,85,85,0,0,7
2778,bāttiṃsatilakkhaṇacitradehantyādīhi,battimsatilakkhanacitradehantyadihi,1,1,0,0,35
2779,chahi,chahi,787,758,29,0,5
2780,munino,munino,197,166,31,0,6
2781,bāttiṃsati,battimsati,4,2,2,0,10
2782,lakkhaṇa,lakkhana,37,32,5,0,8
2783,citra,citra,3,1,2,0,5
2784,dehaṃ,deham,291,272,19,0,5
2785,ityādigāthamāha,ityadigathamaha,9,9,0,0,15
2786,ja,ja,144,100,44,0,2
2787,gaṇa,gana,62,52,10,0,4
2788,garudvaya,garudvaya,1,1,0,0,9
2789,ekādasakkharehi,ekadasakkharehi,4,4,0,0,15
2790,upaṭṭhitā,upatthita,214,196,18,0,9
2791,tjā,tja,2,2,0,0,3
2792,garunāyamupaṭṭhitā,garunayamupatthita,1,1,0,0,18
2793,tajagaṇā,tajagana,1,1,0,0,8
2794,jgājagaṇagarū,jgajaganagaru,1,1,0,0,13
2795,garunā,garuna,31,27,4,0,6
2796,pādantagarunā,padantagaruna,2,2,0,0,13
2797,yuttā,yutta,439,408,31,0,5
2798,gāthā,gatha,2226,2204,22,0,5
2799,eka,eka,119,75,44,0,3
2800,garuke,garuke,45,41,4,0,6
2801,satipi,satipi,748,738,10,0,6
2802,dvigarukepi,dvigarukepi,1,1,0,0,11
2803,lakkhaṇasamānattā,lakkhanasamanatta,1,1,0,0,17
2804,vicitraṃ,vicitram,22,21,1,0,8
2805,sarīravantaṃ,sariravantam,1,1,0,0,12
2806,dvīhi,dvihi,1882,1781,101,0,5
2807,adhikaṃ,adhikam,280,264,16,0,7
2808,tiṃsaṃ,timsam,37,36,1,0,6
2809,dvisaddassa,dvisaddassa,4,4,0,0,11
2810,bādeso,badeso,1,1,0,0,6
2811,lakkhiyati,lakkhiyati,10,10,0,0,10
2812,lakkhitabbaṃ,lakkhitabbam,9,9,0,0,12
2813,buddhasarīraṃ,buddhasariram,2,2,0,0,13
2814,dihati,dihati,4,4,0,0,6
2815,upacayati,upacayati,3,3,0,0,9
2816,vaḍḍhati,vaddhati,425,419,6,0,8
2817,kusalā,kusala,3084,2960,124,0,6
2818,sarīraṃ,sariram,1421,1339,82,0,7
2819,dihadhātu,dihadhatu,2,2,0,0,9
2820,upacaye,upacaye,8,7,1,0,7
2821,citraṃ,citram,14,12,2,0,6
2822,bāttiṃsatilakkhaṇacitradeho,battimsatilakkhanacitradeho,1,1,0,0,27
2823,muni,muni,729,644,85,0,4
2824,dvattiṃsamahāpurisalakkhaṇasarūpassa,dvattimsamahapurisalakkhanasarupassa,1,1,0,0,36
2825,saṅkhepa,sankhepa,8,5,3,0,8
2826,dassanaṃ,dassanam,1045,941,104,0,8
2827,āyatapaṇhi,ayatapanhi,9,8,1,0,10
2828,muduta,muduta,1,1,0,0,6
2829,luṇahatthapādo,lunahatthapado,1,1,0,0,14
2830,jālahatthapādo,jalahatthapado,10,10,0,0,14
2831,ussaṅkhapādo,ussankhapado,13,11,2,0,12
2832,eṇijaṅgho,enijangho,13,12,1,0,9
2833,ṭhitakova,thitakova,115,111,4,0,9
2834,anonamanto,anonamanto,11,11,0,0,10
2835,ubhohi,ubhohi,230,221,9,0,6
2836,pāṇitalehi,panitalehi,12,12,0,0,10
2837,jāṇu,janu,9,9,0,0,4
2838,kāni,kani,80,71,9,0,4
2839,parimasati,parimasati,14,14,0,0,10
2840,parimajjati,parimajjati,38,38,0,0,11
2841,kosohitavatthaguyho,kosohitavatthaguyho,10,9,1,0,19
2842,suvaṇṇa,suvanna,41,37,4,0,7
2843,kañcanasannibhattaco,kancanasannibhattaco,25,25,0,0,20
2844,sukhumacchavī,sukhumacchavi,6,6,0,0,13
2845,ekekalomo,ekekalomo,9,9,0,0,9
2846,uddhaggalomo,uddhaggalomo,10,10,0,0,12
2847,brahmujugatto,brahmujugatto,16,15,1,0,13
2848,sattussado,sattussado,13,11,2,0,10
2849,sīhapubbaddha,sihapubbaddha,2,2,0,0,13
2850,kāyo,kayo,1804,1695,109,0,4
2851,citantaraṃso,citantaramso,13,13,0,0,12
2852,nigrodhaparimaṇḍalo,nigrodhaparimandalo,22,20,2,0,19
2853,samavaṭṭakkhandho,samavattakkhandho,14,14,0,0,17
2854,rasaggarasī,rasaggarasi,1,1,0,0,11
2855,sīhahanu,sihahanu,19,15,4,0,8
2856,cattālīsadanto,cattalisadanto,9,8,1,0,14
2857,samadanto,samadanto,9,9,0,0,9
2858,aviraḷadanto,aviraladanto,7,7,0,0,12
2859,susukkadāṭho,susukkadatho,12,12,0,0,12
2860,pahūtajivho,pahutajivho,14,13,1,0,11
2861,brahmassaro,brahmassaro,28,27,1,0,11
2862,karavīkabhāṇi,karavikabhani,2,2,0,0,13
2863,atinīlanetto,atinilanetto,2,2,0,0,12
2864,gopakhumo,gopakhumo,10,10,0,0,9
2865,uṇṇā,unna,35,28,7,0,4
2866,bhamu,bhamu,17,9,8,0,5
2867,kantare,kantare,1,1,0,0,7
2868,M0.0038,M0.0038,84,84,0,0,7
2869,jāto,jato,1722,1663,59,0,4
2870,dvattiṃsavidhāni,dvattimsavidhani,1,1,0,0,16
2871,mahāpurisalakkhaṇāni,mahapurisalakkhanani,40,39,1,0,20
2872,pātheyyavagge,patheyyavagge,3,3,0,0,13
2873,lakkhaṇasutte,lakkhanasutte,4,2,2,0,13
2874,katamāni,katamani,835,819,16,0,8
2875,dvattiṃsamahāpurisassa,dvattimsamahapurisassa,2,2,0,0,22
2876,samannāgatassa,samannagatassa,465,463,2,0,14
2877,mahāpurisassa,mahapurisassa,192,190,2,0,13
2878,gatiyo,gatiyo,159,148,11,0,6
2879,bhavanti,bhavanti,1735,1673,62,0,8
2880,anaññā,ananna,32,31,1,0,6
2881,sace,sace,10603,10198,405,0,4
2882,agāraṃ,agaram,412,382,30,0,6
2883,ajjhāvasati,ajjhavasati,162,162,0,0,11
2884,rājā,raja,8963,8837,126,0,4
2885,cakkavatti,cakkavatti,57,56,1,0,10
2886,pe,pe,49244,45274,3970,0,2
2887,khopana,khopana,2,2,0,0,7
2888,agārasmā,agarasma,688,679,9,0,8
2889,anagāriyaṃ,anagariyam,843,812,31,0,10
2890,pabbajati,pabbajati,115,108,7,0,9
2891,arahaṃ,araham,959,834,125,0,6
2892,vivaṭacchado,vivatacchado,24,21,3,0,12
2893,idampi,idampi,1038,982,56,0,6
2894,purisassa,purisassa,1269,1228,41,0,9
2895,mahāpurisalakkhaṇaṃ,mahapurisalakkhanam,44,37,7,0,19
2896,bhavati,bhavati,1486,1464,22,0,7
2897,caparaṃ,caparam,1636,1601,35,0,7
2898,heṭṭhāpādatalesu,hetthapadatalesu,6,6,0,0,16
2899,cakkāni,cakkani,85,84,1,0,7
2900,jātāni,jatani,166,166,0,0,6
2901,sahassārāni,sahassarani,15,14,1,0,11
2902,sanemikāni,sanemikani,10,10,0,0,10
2903,sanābhikāni,sanabhikani,10,10,0,0,11
2904,sabbā,sabba,1303,1176,127,0,5
2905,kāraparipūrāni,karaparipurani,1,1,0,0,14
2906,mahāpurisa,mahapurisa,19,19,0,0,10
2907,mahāpuriso,mahapuriso,301,296,5,0,10
2908,āyatapaṇhī,ayatapanhi,3,2,1,0,10
2909,dīghaṅgulī,dighanguli,11,11,0,0,10
2910,mudutaluṇa,mudutaluna,1,1,0,0,10
2911,hatthapādo,hatthapado,2,2,0,0,10
2912,jāṇukāni,janukani,5,5,0,0,8
2913,suvaṇṇavaṇṇo,suvannavanno,153,148,5,0,12
2914,sukhumattā,sukhumatta,40,39,1,0,10
2915,chaviyā,chaviya,57,53,4,0,7
2916,rajojallaṃ,rajojallam,78,67,11,0,10
2917,upalimpati,upalimpati,49,46,3,0,10
2918,ekekāni,ekekani,12,12,0,0,7
2919,lomāni,lomani,114,109,5,0,6
2920,lomakūpesu,lomakupesu,9,9,0,0,10
2921,uddhaggāni,uddhaggani,11,11,0,0,10
2922,nīlāni,nilani,36,34,2,0,6
2923,añjanavaṇṇāni,anjanavannani,7,7,0,0,13
2924,kuṇḍalā,kundala,13,12,1,0,7
2925,vattāni,vattani,68,65,3,0,7
2926,padakkhiṇāvattakajātāni,padakkhinavattakajatani,1,1,0,0,23
2927,yāvatakvassa,yavatakvassa,15,11,4,0,12
2928,byāmo,byamo,22,20,2,0,5
2929,takvassa,takvassa,1,1,0,0,8
2930,M0.0039,M0.0039,85,85,0,0,7
2931,rasagga,rasagga,1,1,0,0,7
2932,saggī,saggi,1,1,0,0,5
2933,bhamukantare,bhamukantare,20,20,0,0,12
2934,jātā,jata,1353,1314,39,0,4
2935,odātā,odata,40,39,1,0,5
2936,mudutūla,mudutula,2,2,0,0,8
2937,sannibhā,sannibha,10,6,4,0,8
2938,mudutūlasannibhā,mudutulasannibha,8,8,0,0,16
2939,lakkhaṇānī,lakkhanani,11,9,2,0,10
2940,dvattiṃsamahāpurisalakkhaṇānaṃ,dvattimsamahapurisalakkhananam,4,4,0,0,30
2941,pacchā,paccha,3344,3205,139,0,6
2942,āvibhavissatīti,avibhavissatiti,13,13,0,0,15
2943,rūpakāyato,rupakayato,42,41,1,0,10
2944,nikkhantehi,nikkhantehi,7,7,0,0,11
2945,chabbaṇṇaraṃsīsaṅkhātehi,chabbannaramsisankhatehi,1,1,0,0,24
2946,obhāsehi,obhasehi,1,1,0,0,8
2947,parisamantato,parisamantato,41,41,0,0,13
2948,vijjotavantaṃ,vijjotavantam,2,2,0,0,13
2949,javati,javati,71,71,0,0,6
2950,dibbatīti,dibbatiti,46,46,0,0,9
2951,juti,juti,22,19,3,0,4
2952,judhātuti,judhatuti,1,1,0,0,9
2953,nigacchati,nigacchati,103,102,1,0,10
2954,niccharatīti,niccharatiti,7,3,4,0,12
2955,niggatā,niggata,32,32,0,0,7
2956,rasmi,rasmi,36,35,1,0,5
2957,nipubbagamudhātu,nipubbagamudhatu,1,1,0,0,16
2958,pakārena,pakarena,548,543,5,0,8
2959,jalate,jalate,8,8,0,0,6
2960,dibbate,dibbate,4,4,0,0,7
2961,pajjalantaṃ,pajjalantam,24,24,0,0,11
2962,dehaniggatajutīti,dehaniggatajutiti,1,1,0,0,17
2963,vattabbe,vattabbe,4222,4208,14,0,8
2964,chandānurakkhaṇatthaṃ,chandanurakkhanattham,20,20,0,0,21
2965,padavipariyāyena,padavipariyayena,2,2,0,0,16
2966,dehajjutiniggatanti,dehajjutiniggatanti,1,1,0,0,19
2967,dehato,dehato,5,5,0,0,6
2968,jutīti,jutiti,7,1,6,0,6
2969,samāso,samaso,329,320,9,0,6
2970,niggatehi,niggatehi,4,4,0,0,9
2971,niccharehi,niccharehi,1,1,0,0,10
2972,jutīhi,jutihi,3,3,0,0,6
2973,raṃsīhi,ramsihi,17,16,1,0,7
2974,dehajjuti,dehajjuti,1,1,0,0,9
2975,niggatapajjalanto,niggatapajjalanto,1,1,0,0,17
2976,puratthimakāyato,puratthimakayato,21,21,0,0,16
2977,chabbaṇṇarasmiyo,chabbannarasmiyo,43,40,3,0,16
2978,uṭṭhahitvā,utthahitva,410,404,6,0,10
2979,asītihatthaṭṭhānaṃ,asitihatthatthanam,22,20,2,0,18
2980,agga,agga,24,4,20,0,4
2981,hesi,hesi,4,4,0,0,4
2982,pacchimakāyato,pacchimakayato,22,22,0,0,14
2983,dakkhiṇahatthato,dakkhinahatthato,19,19,0,0,16
2984,vāmahatthato,vamahatthato,19,19,0,0,12
2985,chabbaṇṇā,chabbanna,35,30,5,0,9
2986,aggahesi,aggahesi,310,305,5,0,8
2987,kesantato,kesantato,5,5,0,0,9
2988,sabbakesavattehi,sabbakesavattehi,1,1,0,0,16
2989,moragīvavaṇṇā,moragivavanna,6,6,0,0,13
2990,M0.0040,M0.0040,85,85,0,0,7
2991,gaganatale,gaganatale,45,45,0,0,10
2992,heṭṭhāpādatalehi,hetthapadatalehi,3,3,0,0,16
2993,pavāḷavaṇṇā,pavalavanna,11,10,1,0,11
2994,ghanapathaviyaṃ,ghanapathaviyam,7,7,0,0,15
2995,samantā,samanta,889,836,53,0,7
2996,asītihatthamattaṃ,asitihatthamattam,6,6,0,0,17
2997,buddharasmiyo,buddharasmiyo,25,23,2,0,13
2998,vijjotamānā,vijjotamana,19,19,0,0,11
2999,vipphandamānā,vipphandamana,13,13,0,0,13
3000,kañcanadaṇḍadīpikāhi,kancanadandadipikahi,4,4,0,0,20
3001,niccharitvā,niccharitva,16,16,0,0,11
3002,ākāsaṃ,akasam,349,328,21,0,6
3003,pakkhandajālā,pakkhandajala,3,3,0,0,13
3004,catuddīpika,catuddipika,1,1,0,0,11
3005,mahāmeghato,mahameghato,2,2,0,0,11
3006,nikkhantavijjulatā,nikkhantavijjulata,4,4,0,0,18
3007,vidhāviṃsūti,vidhavimsuti,1,1,0,0,12
3008,dehajjutiniggatapajjalantanti,dehajjutiniggatapajjalantanti,1,1,0,0,29
3009,paññādhiti,pannadhiti,1,0,1,0,10
3010,guṇoghavindaṃ,gunoghavindam,1,0,1,0,13
3011,paññāti,pannati,173,72,101,0,7
3012,dhitīti,dhititi,6,1,5,0,7
3013,jhānamaggaphalasampayuttasamādhi,jhanamaggaphalasampayuttasamadhi,1,1,0,0,32
3014,sīlanti,silanti,101,97,4,0,7
3015,pacceka,pacceka,13,13,0,0,7
3016,buddhāriyasāvakehi,buddhariyasavakehi,1,1,0,0,18
3017,suvisuddhaṃ,suvisuddham,98,92,6,0,11
3018,catupārisuddhisīlaṃ,catuparisuddhisilam,93,84,9,0,19
3019,oghanti,oghanti,5,5,0,0,7
3020,samūhaṃ,samuham,62,55,7,0,7
3021,vindanti,vindanti,56,51,5,0,8
3022,laddhaṃ,laddham,829,796,33,0,7
3023,yathāsabhāvaṃ,yathasabhavam,58,57,1,0,13
3024,sabbañeyyadhammaṃ,sabbaneyyadhammam,13,11,2,0,17
3025,paññā,panna,3718,3517,201,0,5
3026,papubbañādhātu,papubbanadhatu,2,2,0,0,14
3027,pajānanalakkhaṇā,pajananalakkhana,8,8,0,0,16
3028,paṭivedhalakkhaṇā,pativedhalakkhana,2,2,0,0,17
3029,obhāsanalakkhaṇā,obhasanalakkhana,10,10,0,0,16
3030,visayobhāsa,visayobhasa,1,1,0,0,11
3031,rasā,rasa,310,298,12,0,4
3032,asammohapaccupaṭṭhānā,asammohapaccupatthana,16,12,4,0,21
3033,samādhipadaṭṭhānā,samadhipadatthana,10,9,1,0,17
3034,dhitisaddassa,dhitisaddassa,1,1,0,0,13
3035,sīlatīti,silatiti,7,7,0,0,8
3036,sīlaṃ,silam,2889,2610,279,0,5
3037,kāyavacīkammāni,kayavacikammani,10,10,0,0,15
3038,dahati,dahati,193,191,2,0,6
3039,ṭhapetīti,thapetiti,63,43,20,0,9
3040,sīlati,silati,8,8,0,0,6
3041,samādhiyati,samadhiyati,261,254,7,0,11
3042,kāyakammādīnaṃ,kayakammadinam,28,27,1,0,14
3043,susilya,susilya,1,1,0,0,7
3044,vippakiratīti,vippakiratiti,7,4,3,0,13
3045,samādahanti,samadahanti,12,12,0,0,11
3046,cittaṃ,cittam,13930,13151,779,0,6
3047,sīladhātu,siladhatu,4,4,0,0,9
3048,patiṭṭhāpanalakkhaṇaṃ,patitthapanalakkhanam,1,1,0,0,21
3049,dussilyaviddhaṃsanarasaṃ,dussilyaviddhamsanarasam,1,1,0,0,24
3050,anavajjarasaṃ,anavajjarasam,4,3,1,0,13
3051,soceyyapaccupaṭṭhānaṃ,soceyyapaccupatthanam,8,6,2,0,21
3052,hiriottappapadaṭṭhānaṃ,hiriottappapadatthanam,1,1,0,0,22
3053,guṇasaddassa,gunasaddassa,7,7,0,0,12
3054,uhanati,uhanati,1,1,0,0,7
3055,avayavanti,avayavanti,4,4,0,0,10
3056,ogho,ogho,98,91,7,0,4
3057,upubbahanadhātu,upubbahanadhatu,1,1,0,0,15
3058,ussa,ussa,53,51,2,0,4
3059,o,o,362,165,197,0,1
3060,hanassa,hanassa,34,30,4,0,7
3061,gho,gho,75,50,25,0,3
3062,abhidhānappadīpikāṭīkāyaṃ,abhidhanappadipikatikayam,7,4,3,0,25
3063,byapiyati,byapiyati,2,2,0,0,9
3064,vindanaṃlabhanaṃ,vindanamlabhanam,1,1,0,0,16
3065,vindaṃ,vindam,5,5,0,0,6
3066,vindiyittha,vindiyittha,1,1,0,0,11
3067,labbhitthāti,labbhitthati,2,2,0,0,12
3068,sīlañca,silanca,174,169,5,0,7
3069,guṇañcāti,gunancati,1,1,0,0,9
3070,paññādhitisīlaguṇā,pannadhitisilaguna,1,1,0,0,18
3071,samūhoti,samuhoti,36,36,0,0,8
3072,labhanaṃ,labhanam,11,11,0,0,8
3073,yassāti,yassati,376,271,105,0,7
3074,paññādhitisīlaguṇoghavindo,pannadhitisilagunoghavindo,2,2,0,0,26
3075,M0.0041,M0.0041,87,87,0,0,7
3076,labhitabbaṃ,labhitabbam,32,29,3,0,11
3077,paññādhitisīlaguṇoghaṃ,pannadhitisilagunogham,1,1,0,0,22
3078,yenāti,yenati,186,92,94,0,6
3079,tatiyābahubbīhi,tatiyabahubbihi,5,5,0,0,15
3080,vindānaṃ,vindanam,1,1,0,0,8
3081,labhitabbānaṃ,labhitabbanam,5,5,0,0,13
3082,paññādhitisīla,pannadhitisila,1,1,0,0,14
3083,saṅkhātānaṃ,sankhatanam,14,14,0,0,11
3084,guṇānaṃ,gunanam,164,154,10,0,7
3085,muniṃ,munim,162,128,34,0,5
3086,munāti,munati,48,46,2,0,6
3087,paricchindati,paricchindati,45,44,1,0,13
3088,hitāhitanti,hitahitanti,3,3,0,0,11
3089,munadhātu,munadhatu,4,4,0,0,9
3090,i,i,512,217,295,0,1
3091,ubho,ubho,1176,1091,85,0,4
3092,attheti,attheti,45,11,34,0,7
3093,khandhādi,khandhadi,4,4,0,0,9
3094,tulaṃ,tulam,118,90,28,0,5
3095,āropetvā,aropetva,739,721,18,0,8
3096,minanto,minanto,15,15,0,0,7
3097,ajjhattikā,ajjhattika,218,207,11,0,10
3098,khandhā,khandha,6842,6772,70,0,7
3099,bāhirātiādinā,bahiratiadina,1,1,0,0,13
3100,idhalokatthañca,idhalokatthanca,2,2,0,0,15
3101,paralokatthañca,paralokatthanca,5,5,0,0,15
3102,panesa,panesa,413,402,11,0,6
3103,agāriyamuni,agariyamuni,7,7,0,0,11
3104,anāgāriyamuni,anagariyamuni,2,2,0,0,13
3105,sekhamuni,sekhamuni,2,2,0,0,9
3106,asekhamuni,asekhamuni,2,2,0,0,10
3107,paccekamuni,paccekamuni,6,6,0,0,11
3108,munimuni,munimuni,5,5,0,0,8
3109,anekavidho,anekavidho,49,48,1,0,10
3110,agāriyamunīti,agariyamuniti,4,2,2,0,13
3111,gihipi,gihipi,2,2,0,0,6
3112,āgataphalo,agataphalo,14,13,1,0,10
3113,viññātasāsano,vinnatasasano,20,18,2,0,13
3114,anāgāriyamunīti,anagariyamuniti,1,1,0,0,15
3115,tathārūpova,tatharupova,5,5,0,0,11
3116,pabbajito,pabbajito,1113,1090,23,0,9
3117,sekhamunīti,sekhamuniti,1,1,0,0,11
3118,sekkhā,sekkha,330,309,21,0,6
3119,asekhamunīti,asekhamuniti,1,1,0,0,12
3120,khīṇāsavo,khinasavo,559,538,21,0,9
3121,paccekamunīti,paccekamuniti,3,2,1,0,13
3122,munimunīti,munimuniti,10,7,3,0,10
3123,antimajātiyuttaṃ,antimajatiyuttam,2,1,1,0,16
3124,antimena,antimena,8,6,2,0,8
3125,carimabhavena,carimabhavena,2,2,0,0,13
3126,yuttaṃ,yuttam,1167,1115,52,0,6
3127,avasānaṃ,avasanam,45,43,2,0,8
3128,amati,amati,26,26,0,0,5
3129,antaṃ,antam,431,374,57,0,5
3130,amadhātu,amadhatu,2,2,0,0,8
3131,massa,massa,91,90,1,0,5
3132,no,no,17111,16239,872,0,2
3133,ante,ante,529,497,32,0,4
3134,bhavo,bhavo,864,806,58,0,5
3135,antimo,antimo,20,17,3,0,6
3136,carimabhavo,carimabhavo,1,1,0,0,11
3137,jānanaṃ,jananam,192,183,9,0,7
3138,nibbattanaṃ,nibbattanam,42,39,3,0,11
3139,jāti,jati,1266,1167,99,0,4
3140,pavatti,pavatti,750,729,21,0,7
3141,kammena,kammena,957,927,30,0,7
3142,janiyati,janiyati,2,2,0,0,8
3143,nibbattiyatīti,nibbattiyatiti,2,2,0,0,14
3144,upapattibhavo,upapattibhavo,91,84,7,0,13
3145,jānidhātuti,janidhatuti,1,1,0,0,11
3146,dhātvanta,dhatvanta,2,2,0,0,9
3147,lopo,lopo,706,675,31,0,4
3148,antimajātiyā,antimajatiya,1,1,0,0,12
3149,yuttoti,yuttoti,156,130,26,0,7
3150,antimajātiyutto,antimajatiyutto,2,2,0,0,15
3151,āyatiñhi,ayatinhi,1,1,0,0,8
3152,tīsu,tisu,2346,2229,117,0,4
3153,bhavesu,bhavesu,402,373,29,0,7
3154,paṭisandhijanakānaṃ,patisandhijanakanam,4,4,0,0,19
3155,sabba,sabba,166,114,52,0,5
3156,bodhipallaṅkeyeva,bodhipallankeyeva,8,8,0,0,17
3157,aggamaggena,aggamaggena,94,92,2,0,11
3158,anāgate,anagate,919,888,31,0,7
3159,punabbhavo,punabbhavo,249,236,13,0,10
3160,ariyajāti,ariyajati,6,6,0,0,9
3161,pacchimattabhāvayuttoti,pacchimattabhavayuttoti,1,1,0,0,23
3162,dhammacakkapavattanasutte,dhammacakkapavattanasutte,2,1,1,0,25
3163,ñāṇañca,nananca,140,126,14,0,7
3164,medassanaṃ,medassanam,1,1,0,0,10
3165,udapādi,udapadi,1393,1386,7,0,7
3166,akuppāme,akuppame,1,1,0,0,8
3167,vimutti,vimutti,332,294,38,0,7
3168,ayamantimā,ayamantima,65,53,12,0,10
3169,natthidāni,natthidani,18,16,2,0,10
3170,M0.0042,M0.0042,85,85,0,0,7
3171,bāttiṃsatilakkhaṇacitraṃ,battimsatilakkhanacitram,1,1,0,0,24
3172,rūpakāyavantaṃ,rupakayavantam,1,1,0,0,14
3173,dehajjutiniggata,dehajjutiniggata,1,1,0,0,16
3174,chabbaṇṇaraṃ,chabbannaram,1,1,0,0,12
3175,sīhi,sihi,6,6,0,0,4
3176,paññādhitisīlaguṇo,pannadhitisilaguno,1,1,0,0,18
3177,ghavindaṃ,ghavindam,1,1,0,0,9
3178,paññādhitisīlasaṅkhatānaṃ,pannadhitisilasankhatanam,1,1,0,0,25
3179,labhanavantaṃ,labhanavantam,1,1,0,0,13
3180,vinditabbānaṃ,vinditabbanam,1,1,0,0,13
3181,paññādhitisīlasaṅkhātānaṃ,pannadhitisilasankhatanam,1,1,0,0,25
3182,samūhavantaṃ,samuhavantam,1,1,0,0,12
3183,carimattabhāvena,carimattabhavena,1,1,0,0,16
3184,catutthavandanagāthāvaṇṇanā,catutthavandanagathavannana,1,1,0,0,27
3185,catutthagāthāya,catutthagathaya,26,26,0,0,15
3186,lalitantyādīhi,lalitantyadihi,1,1,0,0,14
3187,gaṇadvigarūhi,ganadvigaruhi,1,1,0,0,13
3188,indavajirā,indavajira,2,2,0,0,10
3189,indādikā,indadika,1,1,0,0,8
3190,vajirā,vajira,11,10,1,0,6
3191,jagāgo,jagago,1,1,0,0,6
3192,dveta,dveta,1,1,0,0,5
3193,gaṇā,gana,55,53,2,0,4
3194,jagā,jaga,5,5,0,0,4
3195,jagaṇa,jagana,5,5,0,0,6
3196,garu,garu,295,271,24,0,4
3197,go,go,343,195,148,0,2
3198,indā,inda,6,5,1,0,4
3199,dikā,dika,9,9,0,0,4
3200,indasaddaādikā,indasaddaadika,1,1,0,0,14
3201,vajirāgāthā,vajiragatha,1,1,0,0,11
3202,pāto,pato,272,256,16,0,4
3203,udayanti,udayanti,6,6,0,0,8
3204,page,page,6,6,0,0,4
3205,pubbaṇhasamaye,pubbanhasamaye,40,40,0,0,14
3206,pācīnalokadhātuto,pacinalokadhatuto,11,11,0,0,17
3207,uggatanti,uggatanti,6,6,0,0,9
3208,udeti,udeti,57,54,3,0,5
3209,uggacchatīti,uggacchatiti,13,8,5,0,12
3210,pātodayo,patodayo,1,1,0,0,8
3211,sūriyo,suriyo,429,415,14,0,6
3212,pātopubba,patopubba,1,1,0,0,9
3213,udadhātu,udadhatu,1,1,0,0,8
3214,uggamane,uggamane,3,3,0,0,8
3215,ayo,ayo,96,89,7,0,3
3216,bāladivā,baladiva,1,0,1,0,8
3217,M0.0043,M0.0043,85,85,0,0,7
3218,bāladivākaraṃ,baladivakaram,2,2,0,0,13
3219,ivātipadacchedo,ivatipadacchedo,1,1,0,0,15
3220,niggatābhinavasūriyaṃ,niggatabhinavasuriyam,1,1,0,0,21
3221,bāloti,baloti,80,52,28,0,6
3222,sampati,sampati,149,142,7,0,7
3223,taruṇadārako,tarunadarako,16,15,1,0,12
3224,potako,potako,8,7,1,0,6
3225,balati,balati,7,7,0,0,6
3226,assasitapassasitamattena,assasitapassasitamattena,6,6,0,0,24
3227,jīvati,jivati,336,322,14,0,6
3228,seṭṭhena,setthena,13,10,3,0,8
3229,paññājīvitenāti,pannajivitenati,7,7,0,0,15
3230,bālo,balo,912,848,64,0,4
3231,baladhātu,baladhatu,3,3,0,0,9
3232,pāṇane,panane,17,14,3,0,6
3233,jīvāyaṃ,jivayam,3,3,0,0,7
3234,sūriyaraṃsinā,suriyaramsina,1,1,0,0,13
3235,divati,divati,2,2,0,0,6
3236,divā,diva,925,835,90,0,4
3237,dīyati,diyati,126,126,0,0,6
3238,khīyati,khiyati,190,184,6,0,7
3239,andhakāro,andhakaro,127,116,11,0,9
3240,dīdhātu,didhatu,1,1,0,0,7
3241,khaye,khaye,213,175,38,0,5
3242,vāgamo,vagamo,14,11,3,0,6
3243,divākaro,divakaro,44,39,5,0,8
3244,divase,divase,1514,1494,20,0,6
3245,ābhā,abha,110,97,13,0,4
3246,bālasadiso,balasadiso,1,1,0,0,10
3247,bāladivākaro,baladivakaro,2,2,0,0,12
3248,iva,iva,322,274,48,0,3
3249,divākaroti,divakaroti,1,1,0,0,10
3250,navuggatasūriyo,navuggatasuriyo,1,1,0,0,15
3251,ākāse,akase,1175,1147,28,0,5
3252,nakkhattatārānaṃ,nakkhattataranam,3,3,0,0,16
3253,sahassaraṃsīhi,sahassaramsihi,3,3,0,0,14
3254,lalati,lalati,5,5,0,0,6
3255,vilāsati,vilasati,2,2,0,0,8
3256,bhikkhūnaṃ,bhikkhunam,4303,4181,122,0,10
3257,yatanti,yatanti,2,2,0,0,7
3258,uṭṭhahanti,utthahanti,81,81,0,0,10
3259,ghaṭanti,ghatanti,9,9,0,0,8
3260,vāyamanti,vayamanti,27,27,0,0,9
3261,kusale,kusale,298,278,20,0,6
3262,dhammeti,dhammeti,192,26,166,0,8
3263,yatīti,yatiti,8,7,1,0,6
3264,yata,yata,24,5,19,0,4
3265,patiyatane,patiyatane,6,3,3,0,10
3266,vāyāme,vayame,8,7,1,0,6
3267,yamanti,yamanti,2,2,0,0,7
3268,uparamanti,uparamanti,3,2,1,0,10
3269,akusale,akusale,269,253,16,0,7
3270,yamudhātu,yamudhatu,2,2,0,0,9
3271,uparame,uparame,24,23,1,0,7
3272,dhātvantalopo,dhatvantalopo,40,40,0,0,13
3273,vilāsitaṃ,vilasitam,2,2,0,0,9
3274,vilāsetīti,vilasetiti,1,1,0,0,10
3275,lalito,lalito,1,1,0,0,6
3276,laladhātu,laladhatu,1,1,0,0,9
3277,vilāse,vilase,7,6,1,0,6
3278,sirīhīti,sirihiti,1,0,1,0,8
3279,kāyaṅgasobhaggapattehi,kayangasobhaggapattehi,1,1,0,0,22
3280,bāttiṃsalakkhaṇāsītyā,battimsalakkhanasitya,1,1,0,0,21
3281,nubyañjanachabbaṇṇaraṃsīsaṅkhatehi,nubyanjanachabbannaramsisankhatehi,1,1,0,0,34
3282,sampattisirīhi,sampattisirihi,2,2,0,0,14
3283,katapuññe,katapunne,6,6,0,0,9
3284,nissayatīti,nissayatiti,7,7,0,0,11
3285,sidhātu,sidhatu,12,12,0,0,7
3286,sevāyaṃ,sevayam,38,35,3,0,7
3287,rapaccayo,rapaccayo,6,6,0,0,9
3288,itthi,itthi,73,64,9,0,5
3289,liṅgajotakaīpaccayo,lingajotakaipaccayo,1,1,0,0,19
3290,katapuññehi,katapunnehi,16,16,0,0,11
3291,seviyatīti,seviyatiti,7,7,0,0,10
3292,sampatti,sampatti,303,290,13,0,8
3293,mūlaṭīkāyaṃ,mulatikayam,24,23,1,0,11
3294,sirīti,siriti,25,15,10,0,6
3295,paññāpuññāna,pannapunnana,1,1,0,0,12
3296,metaṃ,metam,403,340,63,0,5
3297,vilāsitanti,vilasitanti,1,1,0,0,11
3298,udito,udito,23,17,6,0,5
3299,uggato,uggato,116,112,4,0,6
3300,M0.0044,M0.0044,86,86,0,0,7
3301,bāttiṃsalakkhaṇā,battimsalakkhana,3,3,0,0,16
3302,sītyānubyañjanachabbaṇṇaraṃsīhi,sityanubyanjanachabbannaramsihi,1,1,0,0,31
3303,alaṅkatehi,alankatehi,1,1,0,0,10
3304,sarīrasobhagga,sarirasobhagga,2,2,0,0,14
3305,pattīhi,pattihi,4,4,0,0,7
3306,vilāsatīti,vilasatiti,1,1,0,0,10
3307,puṇṇacandena,punnacandena,2,2,0,0,12
3308,sadisaṃ,sadisam,328,316,12,0,7
3309,ānanasampannaṃ,ananasampannam,1,1,0,0,14
3310,cando,cando,430,403,27,0,5
3311,kāḷapakkhe,kalapakkhe,57,56,1,0,10
3312,pāṭipadadivasato,patipadadivasato,13,12,1,0,16
3313,dine,dine,87,85,2,0,4
3314,ūno,uno,57,54,3,0,3
3315,mukhaṃ,mukham,1058,986,72,0,6
3316,ānanaṃ,ananam,12,10,2,0,6
3317,ūnaṃ,unam,107,98,9,0,4
3318,paripuṇṇacandamaṇḍalaṃ,paripunnacandamandalam,2,2,0,0,22
3319,anūnaṃ,anunam,61,51,10,0,6
3320,sobhati,sobhati,315,307,8,0,7
3321,puṇṇasaddena,punnasaddena,1,1,0,0,12
3322,visesetvā,visesetva,306,301,5,0,9
3323,puṇṇindusaṅkāsamukhanti,punnindusankasamukhanti,2,2,0,0,23
3324,thometi,thometi,125,125,0,0,7
3325,soḷasakalehi,solasakalehi,1,1,0,0,12
3326,pūretīti,puretiti,55,51,4,0,8
3327,puṇṇaṃ,punnam,133,128,5,0,6
3328,pūradhātu,puradhatu,4,4,0,0,9
3329,ṇṇo,nno,1,1,0,0,3
3330,idati,idati,1,1,0,0,5
3331,issariyaṃ,issariyam,245,222,23,0,9
3332,indu,indu,24,17,7,0,4
3333,ididhātu,ididhatu,2,2,0,0,8
3334,u,u,422,223,199,0,1
3335,paripuṇṇaṃ,paripunnam,476,446,30,0,10
3336,puṇṇindu,punnindu,7,7,0,0,8
3337,saṅkāsanti,sankasanti,1,1,0,0,10
3338,saṅkāsasaddo,sankasasaddo,1,1,0,0,12
3339,upamāvācako,upamavacako,1,1,0,0,11
3340,nipāto,nipato,759,728,31,0,6
3341,ivādi,ivadi,3,2,1,0,5
3342,tulya,tulya,8,7,1,0,5
3343,samānanibhasannibhā,samananibhasannibha,1,1,0,0,19
3344,saṅkāsa,sankasa,3,3,0,0,7
3345,tulita,tulita,2,2,0,0,6
3346,ppakāsa,ppakasa,2,2,0,0,7
3347,patirūpakā,patirupaka,3,2,1,0,10
3348,tyādi,tyadi,144,143,1,0,5
3349,puṇṇacandaṃ,punnacandam,29,29,0,0,11
3350,mukhati,mukhati,1,1,0,0,7
3351,sobhatīti,sobhatiti,43,33,10,0,9
3352,mukhadhātu,mukhadhatu,1,1,0,0,10
3353,puṇṇindunā,punninduna,2,2,0,0,10
3354,saṅkāsaṃ,sankasam,2,2,0,0,8
3355,puṇṇindusaṅkāsamukho,punnindusankasamukho,1,1,0,0,20
3356,munindassa,munindassa,47,43,4,0,10
3357,puṇṇa,punna,108,106,2,0,5
3358,candassa,candassa,103,102,1,0,8
3359,sassiriko,sassiriko,9,8,1,0,9
3360,lakkhaṇāsītyānubyañjana,lakkhanasityanubyanjana,1,1,0,0,23
3361,paṭimaṇḍitehi,patimanditehi,1,1,0,0,13
3362,byāmappabhāparikkhittehi,byamappabhaparikkhittehi,3,3,0,0,24
3363,āveḷāveḷā,avelavela,4,4,0,0,9
3364,yamakāyamakā,yamakayamaka,1,1,0,0,12
3365,gumbāgumbā,gumbagumba,1,1,0,0,10
3366,viniccharantīhi,viniccharantihi,1,1,0,0,15
3367,ghanabuddharasmisaṅkhātehi,ghanabuddharasmisankhatehi,1,1,0,0,26
3368,alaṅkito,alankito,1,1,0,0,8
3369,sassirikamukho,sassirikamukho,1,1,0,0,14
3370,nittaṇhaṃ,nittanham,14,12,2,0,9
3371,lābhālābhādiṃ,labhalabhadim,1,1,0,0,13
3372,ejati,ejati,4,4,0,0,5
3373,kampatīti,kampatiti,137,120,17,0,9
3374,ejā,eja,55,46,9,0,3
3375,taṇhā,tanha,2150,2021,129,0,5
3376,ejadhātu,ejadhatu,1,1,0,0,8
3377,kampane,kampane,42,35,7,0,7
3378,M0.0045,M0.0045,86,86,0,0,7
3379,anejo,anejo,84,70,14,0,5
3380,nindāninda,nindaninda,1,1,0,0,10
3381,sukhadukkhehi,sukhadukkhehi,16,16,0,0,13
3382,iñjatīti,injatiti,55,52,3,0,8
3383,labbhatī,labbhati,139,110,29,0,8
3384,sabbaññuṃ,sabbannum,25,24,1,0,9
3385,paṭividdha,patividdha,1,1,0,0,10
3386,saṅkharavikāralakkhaṇanibbāna,sankharavikaralakkhananibbana,1,1,0,0,29
3387,paññattivasena,pannattivasena,14,14,0,0,14
3388,pañcavidhaṃ,pancavidham,177,159,18,0,11
3389,ñeyyadhammaṃ,neyyadhammam,23,21,2,0,12
3390,paṭivijjhati,pativijjhati,228,225,3,0,12
3391,sīlenāti,silenati,146,130,16,0,8
3392,sabbaññū,sabbannu,228,219,9,0,8
3393,sabbasaddūpapada,sabbasaddupapada,1,1,0,0,16
3394,ñādhātu,nadhatu,5,5,0,0,7
3395,rū,ru,734,726,8,0,2
3396,saṅkhatadhammā,sankhatadhamma,29,29,0,0,14
3397,saṅkharā,sankhara,2,2,0,0,8
3398,sakasakapaccayehi,sakasakapaccayehi,1,1,0,0,17
3399,viññattidvayaṃ,vinnattidvayam,26,23,3,0,14
3400,lahutādittayañca,lahutadittayanca,4,4,0,0,16
3401,vikāro,vikaro,108,102,6,0,6
3402,mahābhūtehi,mahabhutehi,37,36,1,0,11
3403,virūpaṃ,virupam,107,104,3,0,7
3404,kariyatīti,kariyatiti,12,11,1,0,10
3405,viññattidvayassa,vinnattidvayassa,6,6,0,0,16
3406,yathākkamaṃ,yathakkamam,839,825,14,0,11
3407,cittajavāyodhātu,cittajavayodhatu,1,1,0,0,16
3408,cittajapathavī,cittajapathavi,2,2,0,0,14
3409,visesaguṇattā,visesagunatta,2,2,0,0,13
3410,lahutādittayassa,lahutadittayassa,4,4,0,0,16
3411,citto,citto,315,307,8,0,5
3412,tvāhārajanipphannarūpānaṃ,tvaharajanipphannarupanam,1,1,0,0,25
3413,phassādidhammānaṃ,phassadidhammanam,16,16,0,0,17
3414,phusanādilakkhaṇañca,phusanadilakkhananca,1,1,0,0,20
3415,pathavīdhātvādīnaṃ,pathavidhatvadinam,1,1,0,0,18
3416,kakkhaḷādilakkhaṇañca,kakkhaladilakkhananca,1,1,0,0,21
3417,ārammaṇavijānanalakkhaṇañca,arammanavijananalakkhananca,1,1,0,0,27
3418,santilakkhaṇañca,santilakkhananca,1,1,0,0,16
3419,rūpassa,rupassa,1110,1050,60,0,7
3420,ruppanalakkhaṇañca,ruppanalakkhananca,2,2,0,0,18
3421,nāmassa,namassa,192,188,4,0,7
3422,namanalakkhaṇañca,namanalakkhananca,1,1,0,0,17
3423,aniccatādittayāni,aniccatadittayani,1,1,0,0,17
3424,upacayādicattāri,upacayadicattari,1,1,0,0,16
3425,lakkhaṇarūpāni,lakkhanarupani,9,8,1,0,14
3426,lakkhaṇāni,lakkhanani,321,303,18,0,10
3427,lakkhiyanti,lakkhiyanti,1,1,0,0,11
3428,lakkhitabbā,lakkhitabba,4,4,0,0,11
3429,dhammāti,dhammati,553,290,263,0,8
3430,asaṅkhatadhātunibbānaṃ,asankhatadhatunibbanam,1,1,0,0,22
3431,vānaṃ,vanam,31,23,8,0,5
3432,nikkhantanti,nikkhantanti,13,13,0,0,12
3433,paricchedarūpaṃ,paricchedarupam,8,3,5,0,15
3434,itthipurisādighaṭapaṭādayo,itthipurisadighatapatadayo,1,1,0,0,26
3435,vohāratthā,voharattha,1,1,0,0,10
3436,paññatti,pannatti,1010,964,46,0,8
3437,paññāpiyati,pannapiyati,12,12,0,0,11
3438,ñāpiyatīti,napiyatiti,1,1,0,0,10
3439,saṅkhāranibbānāni,sankharanibbanani,1,1,0,0,17
3440,paramatthadhammā,paramatthadhamma,3,3,0,0,16
3441,vikārādīsu,vikaradisu,1,1,0,0,10
3442,vikāralakkhaṇāni,vikaralakkhanani,1,1,0,0,16
3443,paññattivisesattā,pannattivisesatta,1,1,0,0,17
3444,visuṃ,visum,2780,2693,87,0,5
3445,vuttāni,vuttani,1138,1117,21,0,7
3446,imehi,imehi,2735,2660,75,0,5
3447,vinimuttā,vinimutta,11,11,0,0,9
3448,paricchedarūpā,paricchedarupa,1,1,0,0,14
3449,sabbavohāratthā,sabbavoharattha,1,1,0,0,15
3450,paññattīti,pannattiti,138,101,37,0,10
3451,vuttāti,vuttati,950,871,79,0,7
3452,apadāna,apadana,4,2,2,0,7
3453,atītādibhedaṃ,atitadibhedam,15,15,0,0,13
3454,hatthāmalakaṃ,hatthamalakam,11,11,0,0,13
3455,sabbaññūti,sabbannuti,21,15,6,0,10
3456,kamasabbaññū,kamasabbannu,4,4,0,0,12
3457,sakiṃ,sakim,588,527,61,0,5
3458,satatasabbaññū,satatasabbannu,4,4,0,0,14
3459,satti,satti,56,51,5,0,5
3460,ñātasabbaññū,natasabbannu,2,2,0,0,12
3461,pañcavidhā,pancavidha,140,135,5,0,10
3462,jānanadhammo,jananadhammo,4,4,0,0,12
3463,ekāvajjanena,ekavajjanena,19,18,1,0,12
3464,javanavārena,javanavarena,5,4,1,0,12
3465,M0.0046,M0.0046,86,86,0,0,7
3466,jānitabbaṃ,janitabbam,307,274,33,0,10
3467,catusaccadhammaṃ,catusaccadhammam,102,99,3,0,16
3468,sakiṃsabbaññū,sakimsabbannu,4,4,0,0,13
3469,cakkhuviññāṇādīnaṃ,cakkhuvinnanadinam,105,100,5,0,18
3470,niyatārammaṇattaṃ,niyatarammanattam,1,1,0,0,17
3471,ekappahārena,ekappaharena,60,57,3,0,12
3472,sabbadhammaṃ,sabbadhammam,19,17,2,0,12
3473,jānanasamattho,jananasamattho,3,3,0,0,14
3474,dhammo,dhammo,18207,17892,315,0,6
3475,sattisabbaññū,sattisabbannu,3,3,0,0,13
3476,āvajjanābhedena,avajjanabhedena,1,1,0,0,15
3477,sattisabbaññūvasena,sattisabbannuvasena,1,1,0,0,19
3478,maggañāṇāniyeva,magganananiyeva,1,1,0,0,15
3479,tadavasesā,tadavasesa,20,20,0,0,10
3480,sabbaññutañāṇāni,sabbannutananani,1,1,0,0,16
3481,munisaddassa,munisaddassa,1,1,0,0,12
3482,munīnaṃ,muninam,28,28,0,0,7
3483,indo,indo,102,97,5,0,4
3484,issaro,issaro,347,332,15,0,6
3485,sambandhoti,sambandhoti,44,40,4,0,11
3486,udayaṃ,udayam,145,135,10,0,6
3487,uggataṃ,uggatam,60,54,6,0,7
3488,navuggatasūriyamāṇavoiva,navuggatasuriyamanavoiva,1,1,0,0,24
3489,bāttiṃsamahāpurisalakkhaṇā,battimsamahapurisalakkhana,1,1,0,0,26
3490,sītyānubyañjanasampattisaṅkhātehi,sityanubyanjanasampattisankhatehi,1,1,0,0,33
3491,ānanavantaṃ,ananavantam,1,1,0,0,11
3492,aniñjanaṃ,aninjanam,4,2,2,0,9
3493,sabbadhamma,sabbadhamma,2,2,0,0,11
3494,vijānantaṃ,vijanantam,10,8,2,0,10
3495,pañcamavandanagāthāvaṇṇanā,pancamavandanagathavannana,1,1,0,0,26
3496,pañcamagāthāya,pancamagathaya,15,15,0,0,14
3497,mārajinaguṇena,marajinagunena,1,1,0,0,14
3498,tyādigāthamāha,tyadigathamaha,8,8,0,0,14
3499,dvigaruyuttattā,dvigaruyuttatta,1,1,0,0,15
3500,upendavajirāgāthāti,upendavajiragathati,1,1,0,0,19
3501,upādikā,upadika,4,4,0,0,7
3502,M0.0047,M0.0047,86,86,0,0,7
3503,sāva,sava,147,133,14,0,4
3504,jatā,jata,5,5,0,0,4
3505,tagaṇā,tagana,1,1,0,0,6
3506,jagaṇagarū,jaganagaru,1,1,0,0,10
3507,sāgāthāeva,sagathaeva,1,1,0,0,10
3508,upasaddādikā,upasaddadika,1,1,0,0,12
3509,indavajirāgāthā,indavajiragatha,2,2,0,0,15
3510,sasena,sasena,3,3,0,0,6
3511,māraṃ,maram,192,180,12,0,5
3512,upetapuññoti,upetapunnoti,1,0,1,0,12
3513,sampannadānasīlādipāramīpuññavā,sampannadanasiladiparamipunnava,1,1,0,0,31
3514,dānasīlādi,danasiladi,5,5,0,0,10
3515,pāramīpuññena,paramipunnena,1,1,0,0,13
3516,samannāgato,samannagato,4136,4068,68,0,11
3517,dānasīlādipāramīpuññena,danasiladiparamipunnena,1,1,0,0,23
3518,samupeto,samupeto,90,89,1,0,8
3519,upagato,upagato,301,292,9,0,7
3520,samupagato,samupagato,23,23,0,0,10
3521,upanno,upanno,1,1,0,0,6
3522,eti,eti,283,277,6,0,3
3523,upetaṃ,upetam,136,116,20,0,6
3524,punāti,punati,45,36,9,0,6
3525,kārakanti,karakanti,6,6,0,0,9
3526,pāramīpuññaṃ,paramipunnam,2,2,0,0,12
3527,pudhātu,pudhatu,5,5,0,0,7
3528,pīṇane,pinane,10,7,3,0,6
3529,sodhane,sodhane,15,13,2,0,7
3530,ṇyo,nyo,77,74,3,0,3
3531,ño,no,30,25,5,0,2
3532,pavattiyā,pavattiya,437,434,3,0,9
3533,sacittasantatiñca,sacittasantatinca,1,1,0,0,17
3534,saṃjanitapaṇītarūpavisaṭena,samjanitapanitarupavisatena,1,1,0,0,27
3535,sanissaya,sanissaya,1,1,0,0,9
3536,rūpasantatiñca,rupasantatinca,1,1,0,0,14
3537,pīṇeti,pineti,99,97,2,0,6
3538,paṭisambhidāmaggagaṇṭhipade,patisambhidamaggaganthipade,2,0,2,0,27
3539,vutto,vutto,5126,5006,120,0,5
3540,pūreti,pureti,169,164,5,0,6
3541,ajjhāsayanti,ajjhasayanti,5,5,0,0,12
3542,ṇya,nya,52,24,28,0,3
3543,ajjhāsayaṃ,ajjhasayam,256,239,17,0,10
3544,pujjañca,pujjanca,5,5,0,0,8
3545,nibbattitaddhitāyaṃ,nibbattitaddhitayam,1,1,0,0,19
3546,pūja,puja,13,5,8,0,4
3547,ṇyapaccayo,nyapaccayo,7,7,0,0,10
3548,pūjitabbaṃ,pujitabbam,4,4,0,0,10
3549,pavattetīti,pavattetiti,215,199,16,0,11
3550,sammohavinodanī,sammohavinodani,6,3,3,0,15
3551,kārakaṃ,karakam,115,105,10,0,7
3552,puñño,punno,15,12,3,0,5
3553,mūlaṭīkāyañca,mulatikayanca,4,3,1,0,13
3554,punātīti,punatiti,26,25,1,0,8
3555,apuññaphalato,apunnaphalato,7,5,2,0,13
3556,dukkhasaṃkilesato,dukkhasamkilesato,6,5,1,0,17
3557,hitajjhāsayena,hitajjhasayena,19,19,0,0,14
3558,nipphādanena,nipphadanena,3,3,0,0,12
3559,kārakassajjhāsayaṃ,karakassajjhasayam,2,2,0,0,18
3560,pūrako,purako,16,16,0,0,6
3561,pujjanibbattako,pujjanibbattako,5,4,1,0,15
3562,niruttilakkhaṇena,niruttilakkhanena,8,8,0,0,17
3563,puññoti,punnoti,2,2,0,0,7
3564,M0.0048,M0.0048,87,87,0,0,7
3565,visuddhimaggamahāṭīkāyañca,visuddhimaggamahatikayanca,1,0,1,0,26
3566,visodhetīti,visodhetiti,13,12,1,0,11
3567,hitasukhajjhāsayena,hitasukhajjhasayena,3,3,0,0,19
3568,taṃnipphādanena,tamnipphadanena,2,2,0,0,15
3569,kārakassa,karakassa,15,15,0,0,9
3570,pujjabhavaṃ,pujjabhavam,3,3,0,0,11
3571,niruttinayena,niruttinayena,161,161,0,0,13
3572,puññanti,punnanti,33,33,0,0,8
3573,sampannaṃ,sampannam,183,161,22,0,9
3574,varabodhimūleti,varabodhimuleti,1,0,1,0,15
3575,uttamassa,uttamassa,21,21,0,0,9
3576,bodhirukkhassa,bodhirukkhassa,18,18,0,0,14
3577,samīpe,samipe,511,496,15,0,6
3578,varoti,varoti,17,10,7,0,6
3579,icchitabboti,icchitabboti,40,40,0,0,12
3580,bodhimūleti,bodhimuleti,2,0,2,0,11
3581,bodhīti,bodhiti,70,52,18,0,7
3582,rukkhopi,rukkhopi,26,25,1,0,8
3583,maggopi,maggopi,47,46,1,0,7
3584,sabbaññutañāṇampi,sabbannutananampi,3,3,0,0,17
3585,nibbānampi,nibbanampi,57,55,2,0,10
3586,bodhirukkhamūle,bodhirukkhamule,58,53,5,0,15
3587,paṭhamābhi,pathamabhi,1,1,0,0,10
3588,sambuddhoti,sambuddhoti,25,16,9,0,11
3589,antarā,antara,1215,1140,75,0,6
3590,gayanti,gayanti,1,1,0,0,7
3591,rukkho,rukkho,519,499,20,0,6
3592,catūsu,catusu,2468,2352,116,0,6
3593,maggesu,maggesu,165,161,4,0,7
3594,pappoti,pappoti,157,151,6,0,7
3595,varabhūri,varabhuri,2,2,0,0,9
3596,medhasoti,medhasoti,1,1,0,0,9
3597,patvāna,patvana,55,54,1,0,7
3598,asaṅkhatanti,asankhatanti,48,48,0,0,12
3599,bodhirukkhoti,bodhirukkhoti,5,5,0,0,13
3600,bujjhissati,bujjhissati,16,16,0,0,11
3601,ariyasaccāni,ariyasaccani,298,283,15,0,12
3602,ñeyyadhammampi,neyyadhammampi,1,1,0,0,14
3603,bodhi,bodhi,439,386,53,0,5
3604,bodhirukkho,bodhirukkho,16,16,0,0,11
3605,ṇi,ni,73,65,8,0,2
3606,sabbañeyyadhammanti,sabbaneyyadhammanti,1,1,0,0,19
3607,ariyena,ariyena,178,170,8,0,7
3608,bujjhitabbanti,bujjhitabbanti,6,6,0,0,14
3609,uttamo,uttamo,321,304,17,0,6
3610,varabodhi,varabodhi,5,5,0,0,9
3611,mūlaṃ,mulam,1224,1123,101,0,5
3612,samīpaṃ,samipam,167,164,3,0,7
3613,varabodhimūlaṃ,varabodhimulam,1,1,0,0,14
3614,senāya,senaya,303,293,10,0,6
3615,mārarājaṃ,mararajam,2,2,0,0,9
3616,siyati,siyati,17,17,0,0,6
3617,bandhiyatīti,bandhiyatiti,5,5,0,0,12
3618,senā,sena,216,204,12,0,4
3619,bandhaneyu,bandhaneyu,1,1,0,0,10
3620,saseno,saseno,12,12,0,0,6
3621,mārarājā,mararaja,2,2,0,0,8
3622,anatthe,anatthe,39,35,4,0,7
3623,niyojento,niyojento,61,58,3,0,9
3624,guṇamāraṇena,gunamaranena,4,4,0,0,12
3625,māretīti,maretiti,36,30,6,0,8
3626,māro,maro,768,707,61,0,4
3627,maradhātu,maradhatu,1,1,0,0,9
3628,māreti,mareti,141,137,4,0,6
3629,vināsetīti,vinasetiti,71,66,5,0,10
3630,sasenamāro,sasenamaro,2,2,0,0,10
3631,M0.0049,M0.0049,84,84,0,0,7
3632,jinitvāti,jinitvati,3,1,2,0,9
3633,pade,pade,550,525,25,0,4
3634,sugatasaddassa,sugatasaddassa,5,5,0,0,14
3635,visākhapuṇṇamiyaṃ,visakhapunnamiyam,3,3,0,0,17
3636,buddhadine,buddhadine,2,2,0,0,10
3637,anatthaṅgateyeva,anatthangateyeva,11,11,0,0,16
3638,sūriye,suriye,231,225,6,0,6
3639,pāramīpuññatejena,paramipunnatejena,5,5,0,0,17
3640,vijayitvāti,vijayitvati,1,1,0,0,11
3641,abojjhīti,abojjhiti,2,1,1,0,9
3642,paṭivijjhi,pativijjhi,92,88,4,0,10
3643,adhigami,adhigami,3,3,0,0,8
3644,anuttaraṃ,anuttaram,952,849,103,0,9
3645,sambodhiṃ,sambodhim,142,129,13,0,9
3646,arahattamaggasabbaññutañāṇanti,arahattamaggasabbannutanananti,1,1,0,0,30
3647,ñāṇapadaṭṭhānañhi,nanapadatthananhi,1,1,0,0,17
3648,maggañāṇaṃ,maggananam,127,124,3,0,10
3649,maggañāṇapadaṭṭhānañca,maggananapadatthananca,15,15,0,0,22
3650,aruṇodayamhīti,arunodayamhiti,1,0,1,0,14
3651,aruṇaudayamhīti,arunaudayamhiti,1,1,0,0,15
3652,aruṇuggamanavelāyanti,arunuggamanavelayanti,1,1,0,0,21
3653,āsamantato,asamantato,8,8,0,0,10
3654,ālokaṃ,alokam,234,224,10,0,6
3655,unati,unati,1,1,0,0,5
3656,aruṇo,aruno,129,114,15,0,5
3657,āpubbaunadhātu,apubbaunadhatu,1,1,0,0,14
3658,rakārāgamo,rakaragamo,3,3,0,0,10
3659,nassa,nassa,137,132,5,0,5
3660,ṇo,no,545,514,31,0,2
3661,sūriyassa,suriyassa,146,144,2,0,9
3662,udayato,udayato,38,37,1,0,7
3663,uggataraṃsi,uggataramsi,2,2,0,0,11
3664,dasakanipāta,dasakanipata,1,1,0,0,12
3665,aṅguttarapāḷiyaṃ,anguttarapaliyam,7,2,5,0,16
3666,pubbaṅgamaṃ,pubbangamam,143,139,4,0,11
3667,pubbanimittaṃ,pubbanimittam,225,183,42,0,13
3668,yadidaṃ,yadidam,1979,1806,173,0,7
3669,aruṇuggaṃ,arunuggam,27,24,3,0,9
3670,evameva,evameva,3900,3751,149,0,7
3671,kusalānaṃ,kusalanam,725,682,43,0,9
3672,sammādiṭṭhī,sammaditthi,54,49,5,0,11
3673,abhidhānappadīpikāyaṃ,abhidhanappadipikayam,26,20,6,0,21
3674,sūrassodayato,surassodayato,4,4,0,0,13
3675,pubbu,pubbu,3,3,0,0,5
3676,ṭṭhitaraṃsi,tthitaramsi,2,2,0,0,11
3677,siyāruṇo,siyaruno,2,2,0,0,8
3678,aruṇavaṇṇatāya,arunavannataya,3,3,0,0,14
3679,arati,arati,187,168,19,0,5
3680,udayo,udayo,105,95,10,0,5
3681,udidhātu,udidhatu,2,2,0,0,8
3682,udayassa,udayassa,10,10,0,0,8
3683,uggataraṃsīti,uggataramsiti,1,1,0,0,13
3684,aruṇodayo,arunodayo,2,2,0,0,9
3685,tassaṃ,tassam,310,305,5,0,6
3686,aruṇuggamanavelāyaṃ,arunuggamanavelayam,7,7,0,0,19
3687,mārabalaṃ,marabalam,84,81,3,0,9
3688,vidhametvā,vidhametva,42,42,0,0,10
3689,cīvarūpari,civarupari,4,4,0,0,10
3690,patamānehi,patamanehi,4,4,0,0,10
3691,bodhirukkhaṅkarehi,bodhirukkhankarehi,1,1,0,0,18
3692,rattapavāḷapallavehi,rattapavalapallavehi,3,3,0,0,20
3693,pūjayamāno,pujayamano,13,13,0,0,10
3694,rattiyā,rattiya,819,808,11,0,7
3695,paṭhamayāme,pathamayame,69,69,0,0,11
3696,pubbenivāsaṃ,pubbenivasam,437,401,36,0,12
3697,majjhimayāme,majjhimayame,91,91,0,0,12
3698,dibbacakkhuṃ,dibbacakkhum,104,99,5,0,12
3699,visodhetvā,visodhetva,73,71,2,0,10
3700,pacchimayāme,pacchimayame,71,70,1,0,12
3701,paṭiccasamuppādaṃ,paticcasamuppadam,92,82,10,0,17
3702,anulomapaṭilomaṃ,anulomapatilomam,44,39,5,0,16
3703,manasikaritvā,manasikaritva,44,44,0,0,13
3704,ānāpānacatutthajjhānaṃ,anapanacatutthajjhanam,21,19,2,0,22
3705,nibbattetvā,nibbattetva,389,384,5,0,11
3706,tadeva,tadeva,1566,1502,64,0,6
3707,pādakaṃ,padakam,221,212,9,0,7
3708,mahāvajirañāṇasaṅkhātaṃ,mahavajirananasankhatam,1,1,0,0,23
3709,M0.0050,M0.0050,82,82,0,0,7
3710,vipassanaṃ,vipassanam,1150,1126,24,0,10
3711,vaḍḍhetvā,vaddhetva,653,646,7,0,9
3712,maggapaṭipāṭiyā,maggapatipatiya,83,83,0,0,15
3713,adhigatena,adhigatena,25,24,1,0,10
3714,catutthamaggañāṇena,catutthamaggananena,2,2,0,0,19
3715,sabbakilese,sabbakilese,101,99,2,0,11
3716,khepetvā,khepetva,198,196,2,0,8
3717,yadā,yada,2768,2604,164,0,4
3718,uggamissati,uggamissati,3,3,0,0,11
3719,tadā,tada,7148,7036,112,0,4
3720,sabbaññutañāṇādisabba,sabbannutananadisabba,1,1,0,0,21
3721,buddhaguṇe,buddhagune,101,99,2,0,10
3722,adhigamīti,adhigamiti,1,1,0,0,10
3723,pañcamārānaṃ,pancamaranam,4,4,0,0,12
3724,vijitāviṃ,vijitavim,3,3,0,0,9
3725,devaputta,devaputta,18,18,0,0,9
3726,kilesābhi,kilesabhi,1,1,0,0,9
3727,saṅkhārakhandhamaccusaṅkhāte,sankharakhandhamaccusankhate,1,1,0,0,28
3728,pañcamāre,pancamare,12,12,0,0,9
3729,jināti,jinati,121,113,8,0,6
3730,ajini,ajini,42,42,0,0,5
3731,jinissatīti,jinissatiti,6,6,0,0,11
3732,mārajino,marajino,1,1,0,0,8
3733,devaputtakilesābhisaṅkharasaṅkhataṃ,devaputtakilesabhisankharasankhatam,1,1,0,0,35
3734,mārattayaṃ,marattayam,1,1,0,0,10
3735,khandhamaccusaṅkhataṃ,khandhamaccusankhatam,1,1,0,0,21
3736,māradvayaṃ,maradvayam,1,1,0,0,10
3737,vijitāvinti,vijitavinti,1,1,0,0,11
3738,aviraddhaṃ,aviraddham,6,6,0,0,10
3739,jiyamānattāti,jiyamanattati,1,1,0,0,13
3740,sasenamārassa,sasenamarassa,1,1,0,0,13
3741,bhañjituṃ,bhanjitum,20,20,0,0,9
3742,viddhaṃsituṃ,viddhamsitum,4,4,0,0,12
3743,asamatthaṃ,asamattham,43,43,0,0,10
3744,kassaci,kassaci,2090,2016,74,0,7
3745,tatrāyaṃ,tatrayam,781,748,33,0,8
3746,mārena,marena,166,157,9,0,6
3747,sakkotīti,sakkotiti,204,176,28,0,9
3748,abhaṅgo,abhango,6,6,0,0,7
3749,bhañjiyati,bhanjiyati,1,1,0,0,10
3750,viddhaṃsiyatīti,viddhamsiyatiti,1,1,0,0,15
3751,napubba,napubba,4,4,0,0,7
3752,bhanjadhātu,bhanjadhatu,2,2,0,0,11
3753,dhātvantena,dhatvantena,12,12,0,0,11
3754,gakārādeso,gakaradeso,1,1,0,0,10
3755,bhanjati,bhanjati,1,1,0,0,8
3756,viddhaṃsatīti,viddhamsatiti,5,4,1,0,13
3757,bhaṅgo,bhango,87,77,10,0,6
3758,imissaṃ,imissam,82,81,1,0,7
3759,gāthāyaṃ,gathayam,178,175,3,0,8
3760,ekanipātajātakaṭṭhakathāyaṃ,ekanipatajatakatthakathayam,1,0,1,0,27
3761,apadānaṭṭhakathāyañca,apadanatthakathayanca,1,0,1,0,21
3762,āgatanayena,agatanayena,175,174,1,0,11
3763,māravijayādiṃ,maravijayadim,1,1,0,0,13
3764,sotujanānaṃ,sotujananam,3,3,0,0,11
3765,bahussutatthaṃ,bahussutattham,1,1,0,0,14
3766,mahāsampattiṃ,mahasampattim,53,53,0,0,13
3767,anubhavitvā,anubhavitva,296,295,1,0,11
3768,hatthagataṃ,hatthagatam,139,132,7,0,11
3769,cakkavattirajjaṃ,cakkavattirajjam,40,40,0,0,16
3770,kheḷapiṇḍaṃ,khelapindam,40,40,0,0,11
3771,anapekkho,anapekkho,144,139,5,0,9
3772,chaṭṭetvā,chattetva,11,11,0,0,9
3773,ekūnatiṃsavasse,ekunatimsavasse,1,1,0,0,15
3774,āsaḷhipuṇṇamāya,asalhipunnamaya,1,1,0,0,15
3775,uttarasaḷhanakkhattena,uttarasalhanakkhattena,1,1,0,0,22
3776,yutte,yutte,73,67,6,0,5
3777,mahābhinikkhamaṃ,mahabhinikkhamam,1,1,0,0,16
3778,nikkhamitvā,nikkhamitva,1622,1608,14,0,11
3779,anomanadītīre,anomanaditire,4,4,0,0,13
3780,ghaṭīkārabrahmunā,ghatikarabrahmuna,1,1,0,0,17
3781,dinnaṃ,dinnam,1888,1776,112,0,6
3782,dhajabhūtaṃ,dhajabhutam,5,5,0,0,11
3783,aṭṭhaparikkhāraṃ,atthaparikkharam,1,1,0,0,16
3784,paṭiggahetvā,patiggahetva,652,614,38,0,12
3785,nivāsetvā,nivasetva,779,772,7,0,9
3786,samaṇapabbajjaṃ,samanapabbajjam,8,8,0,0,15
3787,chabbassāni,chabbassani,112,103,9,0,11
3788,dukkarakārikaṃ,dukkarakarikam,63,60,3,0,14
3789,caritvā,caritva,804,800,4,0,7
3790,nigrodharukkhamūle,nigrodharukkhamule,19,19,0,0,18
3791,senanigame,senanigame,3,3,0,0,10
3792,senakuṭumbikassa,senakutumbikassa,1,1,0,0,16
3793,dhītarāya,dhitaraya,1,1,0,0,9
3794,sujātāya,sujataya,55,54,1,0,8
3795,satasahassagghiyā,satasahassagghiya,1,1,0,0,17
3796,M0.0051,M0.0051,86,86,0,0,7
3797,suvaṇṇapātiyā,suvannapatiya,25,25,0,0,13
3798,appodakaṃ,appodakam,9,8,1,0,9
3799,madhupāyāsaṃ,madhupayasam,36,33,3,0,12
3800,ekaṭṭhitālapakkappamāṇaṃ,ekatthitalapakkappamanam,1,1,0,0,24
3801,ekūnapaññāsālopaṃ,ekunapannasalopam,1,1,0,0,17
3802,paribhuñjitvā,paribhunjitva,254,251,3,0,13
3803,sāyanhasamaye,sayanhasamaye,242,240,2,0,13
3804,devatāhi,devatahi,239,237,2,0,8
3805,alaṅkatena,alankatena,12,12,0,0,10
3806,bodhirukkhābhimukho,bodhirukkhabhimukho,4,4,0,0,19
3807,gacchante,gacchante,425,420,5,0,9
3808,antaramagge,antaramagge,3,3,0,0,11
3809,sotthiyena,sotthiyena,8,7,1,0,10
3810,tiṇahārakena,tinaharakena,3,3,0,0,12
3811,aṭṭhamuṭṭhikatiṇaṃ,atthamutthikatinam,1,1,0,0,18
3812,bodhimaṇḍaṃ,bodhimandam,56,55,1,0,11
3813,sabbabuddhānaṃ,sabbabuddhanam,94,87,7,0,14
3814,avijahitaṃ,avijahitam,16,15,1,0,10
3815,acalaṭṭhānaṃ,acalatthanam,15,13,2,0,12
3816,kilesabhañjanaṭṭhānanti,kilesabhanjanatthananti,1,1,0,0,23
3817,ñatvā,natva,3315,3212,103,0,5
3818,tiṇāni,tinani,199,194,5,0,6
3819,agge,agge,236,220,16,0,4
3820,cālesi,calesi,25,25,0,0,6
3821,tāvadeva,tavadeva,505,494,11,0,8
3822,cuddasahattho,cuddasahattho,9,8,1,0,13
3823,pallaṅko,pallanko,92,82,10,0,8
3824,tānipi,tanipi,156,155,1,0,6
3825,tathārūpena,tatharupena,37,37,0,0,11
3826,saṇṭhānena,santhanena,26,26,0,0,10
3827,santhariṃsu,santharimsu,1,1,0,0,11
3828,saṇṭhahiṃsu,santhahimsu,15,15,0,0,11
3829,yathārūpaṃ,yatharupam,36,32,4,0,10
3830,sukusalopi,sukusalopi,3,3,0,0,10
3831,vicittakāro,vicittakaro,1,1,0,0,11
3832,potthatāro,potthataro,1,1,0,0,10
3833,ālikhitumpi,alikhitumpi,3,3,0,0,11
3834,samattho,samattho,575,562,13,0,8
3835,bodhikhandhaṃ,bodhikhandham,1,1,0,0,13
3836,piṭṭhito,pitthito,338,321,17,0,8
3837,puratthābhimukho,puratthabhimukho,47,47,0,0,16
3838,daḷhamānaso,dalhamanaso,6,6,0,0,11
3839,kāmaṃ,kamam,853,770,83,0,5
3840,taco,taco,150,130,20,0,4
3841,nhāru,nharu,109,104,5,0,5
3842,aṭṭhi,atthi,153,134,19,0,5
3843,avasussatu,avasussatu,8,8,0,0,10
3844,upasussatu,upasussatu,27,26,1,0,10
3845,nisesaṃ,nisesam,1,1,0,0,7
3846,maṃsalohitaṃ,mamsalohitam,41,40,1,0,12
3847,tveva,tveva,910,887,23,0,5
3848,sammāsambodhiṃ,sammasambodhim,318,291,27,0,14
3849,apatvā,apatva,47,47,0,0,6
3850,imaṃ,imam,9896,9460,436,0,4
3851,pallaṅkaṃ,pallankam,378,349,29,0,9
3852,bhindissāmīti,bhindissamiti,9,6,3,0,13
3853,asanisatasannipātenapi,asanisatasannipatenapi,3,3,0,0,22
3854,abhejjarūpaṃ,abhejjarupam,3,3,0,0,12
3855,abhañjitvā,abhanjitva,2,2,0,0,10
3856,nisīdi,nisidi,2390,2380,10,0,6
3857,samaye,samaye,4645,4534,111,0,6
3858,devaputto,devaputto,573,562,11,0,9
3859,siddhatthakumāro,siddhatthakumaro,27,27,0,0,16
3860,mayhaṃ,mayham,6032,5869,163,0,6
3861,vasaṃ,vasam,619,559,60,0,5
3862,atikkamitukāmo,atikkamitukamo,5,5,0,0,14
3863,dāni,dani,1583,1498,85,0,4
3864,atikkamituṃ,atikkamitum,51,50,1,0,11
3865,dassāmī,dassami,555,546,9,0,7
3866,mārabalassa,marabalassa,7,7,0,0,11
3867,santikaṃ,santikam,2430,2408,22,0,8
3868,etamatthaṃ,etamattham,2346,2231,115,0,10
3869,ārocetvā,arocetva,378,368,10,0,8
3870,māraghosanaṃ,maraghosanam,3,3,0,0,12
3871,ghosāpetvā,ghosapetva,19,19,0,0,10
3872,ādāya,adaya,2296,2270,26,0,5
3873,nikkhami,nikkhami,406,406,0,0,8
3874,mārasenā,marasena,55,53,2,0,8
3875,mārassa,marassa,330,304,26,0,7
3876,purato,purato,1614,1557,57,0,6
3877,dvādasa,dvadasa,880,828,52,0,7
3878,dakkhiṇato,dakkhinato,106,105,1,0,10
3879,vāmato,vamato,51,49,2,0,6
3880,pacchato,pacchato,664,649,15,0,8
3881,cakkavāḷapariyantaṃ,cakkavalapariyantam,22,21,1,0,19
3882,ṭhitā,thita,1469,1427,42,0,5
3883,uddhaṃ,uddham,1574,1383,191,0,6
3884,navayojanubbedhā,navayojanubbedha,4,4,0,0,16
3885,yassā,yassa,496,450,46,0,5
3886,unnādantiyā,unnadantiya,1,1,0,0,11
3887,unnādasaddo,unnadasaddo,5,5,0,0,11
3888,yojanasahassato,yojanasahassato,3,3,0,0,15
3889,pathavīundriyasaddo,pathaviundriyasaddo,2,2,0,0,19
3890,suyyati,suyyati,106,103,3,0,7
3891,diyaḍḍhayojanasatikaṃ,diyaddhayojanasatikam,10,10,0,0,21
3892,girimekhalaṃ,girimekhalam,10,8,2,0,12
3893,hatthiṃ,hatthim,237,230,7,0,7
3894,abhirūhitvā,abhiruhitva,23,22,1,0,11
3895,bāhusahassaṃ,bahusahassam,8,8,0,0,12
3896,māpetvā,mapetva,303,303,0,0,7
3897,nānāvudhāni,nanavudhani,12,12,0,0,11
3898,avasesāyapi,avasesayapi,3,3,0,0,11
3899,māraparisāya,maraparisaya,9,9,0,0,12
3900,janā,jana,1130,1082,48,0,4
3901,ekasadisaṃ,ekasadisam,44,42,2,0,10
3902,M0.0052,M0.0052,85,85,0,0,7
3903,āvudhaṃ,avudham,98,80,18,0,7
3904,gaṇhiṃsu,ganhimsu,164,158,6,0,8
3905,nānappakāravaṇṇā,nanappakaravanna,3,3,0,0,16
3906,nānappakāra,nanappakara,3,3,0,0,11
3907,mukhā,mukha,15,15,0,0,5
3908,mahāsattaṃ,mahasattam,232,230,2,0,10
3909,ajjhottharamānā,ajjhottharamana,6,6,0,0,15
3910,āgamaṃsu,agamamsu,64,63,1,0,8
3911,dasasahassacakkavāḷadevatā,dasasahassacakkavaladevata,15,15,0,0,26
3912,mahāsattassa,mahasattassa,335,335,0,0,12
3913,thuti,thuti,36,30,6,0,5
3914,vadamānā,vadamana,80,78,2,0,8
3915,aṭṭhaṃsu,atthamsu,397,396,1,0,8
3916,sakko,sakko,1514,1479,35,0,5
3917,devarājā,devaraja,349,341,8,0,8
3918,vijayuttarasaṅkhaṃ,vijayuttarasankham,9,9,0,0,18
3919,dhamamāno,dhamamano,7,7,0,0,9
3920,aṭṭhāsi,atthasi,1545,1535,10,0,7
3921,kira,kira,6315,6191,124,0,4
3922,saṅkho,sankho,113,105,8,0,6
3923,vīsahatthasatiko,visahatthasatiko,4,4,0,0,16
3924,vātaṃ,vatam,108,103,5,0,5
3925,gāhāpetvā,gahapetva,415,409,6,0,9
3926,dhamanto,dhamanto,14,13,1,0,8
3927,cattāro,cattaro,6384,6044,340,0,7
3928,māse,mase,669,652,17,0,4
3929,karitvā,karitva,1112,1092,20,0,7
3930,nissaddo,nissaddo,13,12,1,0,8
3931,mahākāḷanāga,mahakalanaga,1,1,0,0,12
3932,atirekapadasatena,atirekapadasatena,5,5,0,0,17
3933,vaṇṇaṃ,vannam,1044,973,71,0,6
3934,vadanto,vadanto,565,558,7,0,7
3935,mahābrahmā,mahabrahma,190,182,8,0,10
3936,dhārayamāno,dharayamano,20,20,0,0,11
3937,māra,mara,70,65,5,0,4
3938,bale,bale,37,36,1,0,4
3939,bodhimaṇḍalaṃ,bodhimandalam,3,3,0,0,13
3940,upasaṅkamante,upasankamante,33,33,0,0,13
3941,ekopi,ekopi,428,412,16,0,5
3942,ṭhātuṃ,thatum,177,165,12,0,6
3943,nāsakkhi,nasakkhi,418,407,11,0,8
3944,sammukha,sammukha,2,2,0,0,8
3945,sammukhaṭṭhāneneva,sammukhatthaneneva,2,2,0,0,18
3946,palāyiṃsu,palayimsu,103,100,3,0,9
3947,kāḷo,kalo,87,82,5,0,4
3948,nāgarājā,nagaraja,391,389,2,0,8
3949,pathaviṃ,pathavim,802,745,57,0,8
3950,nimujjitvā,nimujjitva,83,83,0,0,10
3951,pañcayojanasatikaṃ,pancayojanasatikam,10,10,0,0,18
3952,mantirakanāgabhavanaṃ,mantirakanagabhavanam,1,1,0,0,21
3953,hatthehi,hatthehi,321,308,13,0,8
3954,pidahitvā,pidahitva,158,156,2,0,9
3955,nipanno,nipanno,307,307,0,0,7
3956,piṭṭhiyaṃ,pitthiyam,150,150,0,0,9
3957,cakkavāḷamukha,cakkavalamukha,1,1,0,0,14
3958,vaṭṭiyaṃ,vattiyam,1,1,0,0,8
3959,koṭiyaṃ,kotiyam,62,56,6,0,7
3960,brahmalokameva,brahmalokameva,17,17,0,0,14
3961,agamāsi,agamasi,1648,1644,4,0,7
3962,ekadevatāpi,ekadevatapi,4,4,0,0,11
3963,nāhosi,nahosi,337,327,10,0,6
3964,ekakova,ekakova,249,246,3,0,7
3965,māropi,maropi,17,17,0,0,6
3966,āha,aha,20985,20928,57,0,3
3967,tāta,tata,1794,1776,18,0,4
3968,suddhodanaputtena,suddhodanaputtena,3,3,0,0,17
3969,siddhatthena,siddhatthena,6,6,0,0,12
3970,añño,anno,2333,2230,103,0,4
3971,mayaṃ,mayam,4287,4147,140,0,5
3972,sammukhā,sammukha,830,790,40,0,8
3973,dātuṃ,datum,1213,1164,49,0,5
3974,sakkhissāma,sakkhissama,33,31,2,0,11
3975,bhāgena,bhagena,31,31,0,0,7
3976,dassāmā,dassama,147,147,0,0,7
3977,mahāpurisopi,mahapurisopi,20,20,0,0,12
3978,tīṇi,tini,12314,12086,228,0,4
3979,passāni,passani,21,21,0,0,7
3980,sabbadevatānaṃ,sabbadevatanam,4,4,0,0,14
3981,palāyitattā,palayitatta,2,2,0,0,11
3982,suññāni,sunnani,16,16,0,0,7
3983,addasa,addasa,688,676,12,0,6
3984,uttarapassena,uttarapassena,4,4,0,0,13
3985,ajjhottharamānaṃ,ajjhottharamanam,6,5,1,0,16
3986,disvā,disva,10034,9880,154,0,5
3987,ettako,ettako,152,136,16,0,6
3988,jano,jano,596,552,44,0,4
3989,maṃ,mam,7600,7131,469,0,3
3990,ekakaṃ,ekakam,76,67,9,0,6
3991,mahantaṃ,mahantam,1782,1708,74,0,8
3992,vāyāmaṃ,vayamam,91,80,11,0,7
3993,mātā,mata,1577,1501,76,0,4
3994,pitā,pita,1455,1408,47,0,4
3995,bhātā,bhata,292,284,8,0,5
3996,ñātako,natako,67,65,2,0,6
3997,pāramiyova,paramiyova,6,6,0,0,10
3998,dīgharattaṃ,digharattam,813,777,36,0,11
3999,puttaparijanasadisā,puttaparijanasadisa,1,1,0,0,19
4000,phalakaṃ,phalakam,78,69,9,0,8
4001,pāramisattheneva,paramisattheneva,3,3,0,0,16
4002,paharitvā,paharitva,513,507,6,0,9
4003,balakāyo,balakayo,35,35,0,0,8
4004,viddhaṃsetuṃ,viddhamsetum,13,13,0,0,12
4005,vaṭṭatī,vattati,1749,1592,157,0,7
4006,āvajjamāno,avajjamano,27,27,0,0,10
4007,M0.0053,M0.0053,85,85,0,0,7
4008,eteneva,eteneva,550,524,26,0,7
4009,siddhatthaṃ,siddhattham,49,49,0,0,11
4010,palāpessāmīti,palapessamiti,2,2,0,0,13
4011,vātamaṇḍalaṃ,vatamandalam,8,3,5,0,12
4012,samuṭṭhāpesi,samutthapesi,83,83,0,0,12
4013,taṅkhaṇaññeyeva,tankhananneyeva,1,1,0,0,15
4014,puratthimā,puratthima,78,71,7,0,10
4015,dibhedā,dibheda,1,1,0,0,7
4016,vātā,vata,313,307,6,0,4
4017,samuṭṭhahitvā,samutthahitva,29,29,0,0,13
4018,aḍḍhayojanaekayojana,addhayojanaekayojana,1,1,0,0,20
4019,dviyojanatiyojanappamāṇāni,dviyojanatiyojanappamanani,1,1,0,0,26
4020,pabbatakūṭāni,pabbatakutani,17,17,0,0,13
4021,vanagaccharukkhādīni,vanagaccharukkhadini,6,6,0,0,20
4022,mūlāni,mulani,252,239,13,0,6
4023,sāmantā,samanta,138,123,15,0,7
4024,gāmanigame,gamanigame,11,11,0,0,10
4025,cuṇṇavicuṇṇaṃ,cunnavicunnam,52,51,1,0,13
4026,kātuṃ,katum,3533,3386,147,0,5
4027,samatthāpi,samatthapi,11,11,0,0,10
4028,puññatejena,punnatejena,31,31,0,0,11
4029,mahānubhāvena,mahanubhavena,8,8,0,0,13
4030,bodhisattaṃ,bodhisattam,430,430,0,0,11
4031,patvā,patva,2480,2448,32,0,5
4032,cīvarakaṇṇamattampi,civarakannamattampi,6,6,0,0,19
4033,cāletuṃ,caletum,102,98,4,0,7
4034,nāsakkhiṃsu,nasakkhimsu,149,145,4,0,11
4035,udakena,udakena,565,552,13,0,7
4036,ajjhottharitvā,ajjhottharitva,146,140,6,0,14
4037,māressāmāti,maressamati,1,1,0,0,11
4038,mahāvassaṃ,mahavassam,18,13,5,0,10
4039,tassānubhāvena,tassanubhavena,64,64,0,0,14
4040,uparūpari,uparupari,303,293,10,0,9
4041,satapaṭalasahassapaṭalādibhedā,satapatalasahassapataladibheda,6,6,0,0,30
4042,vaḷāhakā,valahaka,2,2,0,0,8
4043,vassiṃsu,vassimsu,12,12,0,0,8
4044,vuṭṭhidhārāvegena,vutthidharavegena,6,6,0,0,17
4045,pathavī,pathavi,751,698,53,0,7
4046,bhinnā,bhinna,194,184,10,0,6
4047,vanarukkhādīnaṃ,vanarukkhadinam,6,6,0,0,15
4048,uparibhāgena,uparibhagena,29,29,0,0,12
4049,mahāmegho,mahamegho,93,93,0,0,9
4050,āgantvā,agantva,2741,2724,17,0,7
4051,sattassa,sattassa,379,370,9,0,8
4052,cīvare,civare,430,403,27,0,6
4053,ussāvabinduggahaṇamattampi,ussavabinduggahanamattampi,1,1,0,0,26
4054,temetuṃ,temetum,8,8,0,0,7
4055,pāsāṇavassaṃ,pasanavassam,8,3,5,0,12
4056,dhūmāyantāni,dhumayantani,6,6,0,0,12
4057,pajjalantāni,pajjalantani,7,7,0,0,12
4058,ākāsenāgantvā,akasenagantva,97,97,0,0,13
4059,bodhisattassa,bodhisattassa,837,833,4,0,13
4060,pādamūle,padamule,382,376,6,0,8
4061,dibbamālāguḷabhāvaṃ,dibbamalagulabhavam,3,3,0,0,19
4062,āpajjiṃsu,apajjimsu,51,49,2,0,9
4063,paharavassaṃ,paharavassam,1,1,0,0,12
4064,ekatodhārā,ekatodhara,3,3,0,0,10
4065,ubhatodhārā,ubhatodhara,3,3,0,0,11
4066,asisattikhurappādayo,asisattikhurappadayo,4,4,0,0,20
4067,dhūmāyantā,dhumayanta,13,13,0,0,10
4068,pajjalantā,pajjalanta,14,14,0,0,10
4069,dibbapupphāni,dibbapupphani,27,27,0,0,13
4070,ahesuṃ,ahesum,2266,2222,44,0,6
4071,aṅgāravassaṃ,angaravassam,7,2,5,0,12
4072,kiṃsukavaṇṇā,kimsukavanna,5,5,0,0,12
4073,aṅgārā,angara,12,11,1,0,6
4074,dibba,dibba,10,10,0,0,5
4075,pupphāni,pupphani,518,510,8,0,8
4076,vikiriṃsu,vikirimsu,30,30,0,0,9
4077,kukkuḷavassaṃ,kukkulavassam,5,2,3,0,13
4078,accuṇho,accunho,5,5,0,0,7
4079,aggivaṇṇo,aggivanno,9,9,0,0,9
4080,kukkuḷo,kukkulo,7,5,2,0,7
4081,dibbacandanacuṇṇaṃ,dibbacandanacunnam,2,2,0,0,18
4082,nipatati,nipatati,64,63,1,0,8
4083,vāḷukavassaṃ,valukavassam,1,1,0,0,12
4084,atisukhumavāḷikā,atisukhumavalika,1,1,0,0,16
4085,nipatiṃsu,nipatimsu,20,19,1,0,9
4086,kalalavassaṃ,kalalavassam,11,5,6,0,12
4087,dhūmāyantaṃ,dhumayantam,10,10,0,0,11
4088,nāgantvā,nagantva,1,1,0,0,8
4089,dibbavilepanaṃ,dibbavilepanam,3,3,0,0,14
4090,patati,patati,342,335,7,0,6
4091,iminā,imina,10676,10387,289,0,5
4092,bhiṃsetvā,bhimsetva,6,6,0,0,9
4093,andhakāraṃ,andhakaram,215,195,20,0,10
4094,M0.0054,M0.0054,81,81,0,0,7
4095,caturaṅgasamannāgataṃ,caturangasamannagatam,59,52,7,0,21
4096,mahātamaṃ,mahatamam,13,12,1,0,9
4097,sūriyappabhā,suriyappabha,6,6,0,0,12
4098,vihataṃ,vihatam,22,20,2,0,7
4099,antaradhāyati,antaradhayati,221,214,7,0,13
4100,imāhi,imahi,307,297,10,0,5
4101,navahi,navahi,313,286,27,0,6
4102,vātavassapāsāṇapaharaaṅgāra,vatavassapasanapaharaangara,1,1,0,0,27
4103,kukkuḷavāḷuka,kukkulavaluka,1,1,0,0,13
4104,kalalaandhakāravuṭṭhīhi,kalalaandhakaravutthihi,1,1,0,0,23
4105,palāpetuṃ,palapetum,19,19,0,0,9
4106,bhaṇe,bhane,354,351,3,0,5
4107,tiṭṭhatha,titthatha,75,75,0,0,9
4108,siddhatthakumāraṃ,siddhatthakumaram,3,3,0,0,17
4109,gaṇhatha,ganhatha,326,323,3,0,8
4110,hanatha,hanatha,19,19,0,0,7
4111,palāpethā,palapetha,7,7,0,0,9
4112,āṇāpetvā,anapetva,140,138,2,0,8
4113,sayampi,sayampi,393,378,15,0,7
4114,girimekhalassa,girimekhalassa,4,4,0,0,14
4115,hatthino,hatthino,106,106,0,0,8
4116,khandhe,khandhe,4236,4189,47,0,7
4117,cakkāvudhaṃ,cakkavudham,9,9,0,0,11
4118,upasaṅkamitvā,upasankamitva,4282,4266,16,0,13
4119,siddhattha,siddhattha,24,24,0,0,10
4120,uṭṭhāhi,utthahi,3,3,0,0,7
4121,etasmā,etasma,163,159,4,0,6
4122,pallaṅkā,pallanka,26,26,0,0,8
4123,nāyaṃ,nayam,614,581,33,0,5
4124,mayhaṃeva,mayhameva,1,1,0,0,9
4125,pāpuṇātī,papunati,187,169,18,0,8
4126,mahāsatto,mahasatto,997,993,4,0,9
4127,avoca,avoca,699,693,6,0,5
4128,tayā,taya,1777,1725,52,0,4
4129,dasapāramiyo,dasaparamiyo,10,10,0,0,12
4130,pūritā,purita,76,76,0,0,6
4131,upapāramiyo,upaparamiyo,49,47,2,0,11
4132,paramattha,paramattha,36,34,2,0,10
4133,nāpi,napi,812,777,35,0,4
4134,pañcamahāpariccāgā,pancamahapariccaga,1,1,0,0,18
4135,pariccattā,pariccatta,45,44,1,0,10
4136,ñātatthacariyā,natatthacariya,17,11,6,0,14
4137,lokatthacariyā,lokatthacariya,24,21,3,0,14
4138,buddhatthacariyā,buddhatthacariya,4,4,0,0,16
4139,mayāyeva,mayayeva,4,4,0,0,8
4140,tuyhaṃ,tuyham,1255,1201,54,0,6
4141,mayhameva,mayhameva,120,120,0,0,9
4142,kuddho,kuddho,216,213,3,0,6
4143,kodhavegaṃ,kodhavegam,3,3,0,0,10
4144,asahanto,asahanto,39,39,0,0,8
4145,vissajjesi,vissajjesi,263,262,1,0,10
4146,āvajjantassa,avajjantassa,41,41,0,0,12
4147,uparibhāge,uparibhage,59,59,0,0,10
4148,mālāvitānaṃ,malavitanam,9,9,0,0,11
4149,khuracakkāvudhaṃ,khuracakkavudham,1,1,0,0,16
4150,aññadā,annada,36,35,1,0,6
4151,kuddhena,kuddhena,13,13,0,0,8
4152,vissaṭṭhaṃ,vissattham,33,32,1,0,10
4153,ekaghanapāsāṇa,ekaghanapasana,1,1,0,0,14
4154,thambhe,thambhe,80,79,1,0,7
4155,vaṃsakaḷīre,vamsakalire,4,4,0,0,11
4156,chindantaṃ,chindantam,13,12,1,0,10
4157,ṭhite,thite,554,526,28,0,5
4158,māraparisā,maraparisa,15,15,0,0,10
4159,pallaṅkato,pallankato,18,18,0,0,10
4160,vuṭṭhāya,vutthaya,761,758,3,0,8
4161,palāyissatīti,palayissatiti,2,2,0,0,13
4162,mahantamahantāni,mahantamahantani,11,11,0,0,16
4163,selakūṭāni,selakutani,3,3,0,0,10
4164,vissajjesuṃ,vissajjesum,31,31,0,0,11
4165,mālāguḷabhāvaṃ,malagulabhavam,3,3,0,0,14
4166,āpajjitvā,apajjitva,308,301,7,0,9
4167,patiṃsu,patimsu,53,52,1,0,7
4168,devatā,devata,1936,1876,60,0,6
4169,cakkavāḷamukhavaṭṭiyaṃ,cakkavalamukhavattiyam,16,16,0,0,22
4170,gīvaṃ,givam,204,194,10,0,5
4171,pasāretvā,pasaretva,268,265,3,0,9
4172,sīsaṃ,sisam,1152,1095,57,0,5
4173,ukkhipitvā,ukkhipitva,655,648,7,0,10
4174,naṭṭho,nattho,75,74,1,0,6
4175,siddhatthakumārassa,siddhatthakumarassa,10,10,0,0,19
4176,rūpaggappatto,rupaggappatto,3,3,0,0,13
4177,attabhāvo,attabhavo,336,318,18,0,9
4178,nu,nu,7829,7392,437,0,2
4179,karissatī,karissati,239,232,7,0,9
4180,olokenti,olokenti,63,62,1,0,8
4181,M0.0055,M0.0055,84,84,0,0,7
4182,pūritapāramīnaṃ,puritaparaminam,15,15,0,0,15
4183,bodhisattānaṃ,bodhisattanam,122,122,0,0,13
4184,abhi,abhi,135,88,47,0,4
4185,sambujjhanadivase,sambujjhanadivase,2,2,0,0,17
4186,pattapallaṅko,pattapallanko,3,3,0,0,13
4187,mayhaṃva,mayhamva,6,6,0,0,8
4188,vatvā,vatva,7178,7146,32,0,5
4189,ṭhitaṃ,thitam,1539,1437,102,0,6
4190,dānassa,danassa,179,176,3,0,7
4191,dinnabhāve,dinnabhave,17,17,0,0,10
4192,sakkhī,sakkhi,70,66,4,0,6
4193,ettakā,ettaka,399,392,7,0,6
4194,sakkhino,sakkhino,12,12,0,0,8
4195,balābhimukhaṃ,balabhimukham,1,1,0,0,13
4196,hatthaṃ,hattham,637,597,40,0,7
4197,pasāreti,pasareti,58,56,2,0,8
4198,khaṇe,khane,1368,1350,18,0,5
4199,pavattasaddo,pavattasaddo,3,3,0,0,12
4200,pathavīundriyasaddasadiso,pathaviundriyasaddasadiso,1,1,0,0,25
4201,mahāpurisaṃ,mahapurisam,62,62,0,0,11
4202,sacetanā,sacetana,15,15,0,0,8
4203,sacetano,sacetano,25,24,1,0,8
4204,tiṭṭhatu,titthatu,277,269,8,0,8
4205,avasesattabhāvesu,avasesattabhavesu,2,2,0,0,17
4206,dinnadānaṃ,dinnadanam,74,73,1,0,10
4207,vessantarattabhāve,vessantarattabhave,22,22,0,0,18
4208,ṭhatvā,thatva,2547,2492,55,0,6
4209,sattasattaka,sattasattaka,1,1,0,0,12
4210,mahādānassa,mahadanassa,3,3,0,0,11
4211,acetanāpi,acetanapi,10,10,0,0,9
4212,ghanamahāpathavī,ghanamahapathavi,3,3,0,0,16
4213,cīvaragabbhantarato,civaragabbhantarato,3,3,0,0,19
4214,dakkhiṇahatthaṃ,dakkhinahattham,38,38,0,0,15
4215,nīharitvā,niharitva,782,765,17,0,9
4216,sattasattakamahādānassa,sattasattakamahadanassa,1,1,0,0,23
4217,tvaṃ,tvam,9005,8625,380,0,4
4218,sakkhi,sakkhi,91,87,4,0,6
4219,sakkhīti,sakkhiti,11,9,2,0,8
4220,mahāpathaviyābhimukhaṃ,mahapathaviyabhimukham,2,2,0,0,22
4221,pasāresi,pasaresi,85,85,0,0,8
4222,viravasahassena,viravasahassena,3,3,0,0,15
4223,viravasatasahassena,viravasatasahassena,3,3,0,0,19
4224,avattharamānā,avattharamana,4,4,0,0,13
4225,unnadi,unnadi,8,8,0,0,6
4226,mahāpurise,mahapurise,16,16,0,0,10
4227,mahādānaṃ,mahadanam,551,545,6,0,9
4228,uttama,uttama,15,13,2,0,6
4229,dānanti,dananti,27,27,0,0,7
4230,vessantaradānaṃ,vessantaradanam,3,3,0,0,15
4231,sammasante,sammasante,3,3,0,0,10
4232,diyaḍḍhayojanasatiko,diyaddhayojanasatiko,14,14,0,0,20
4233,girimekhalo,girimekhalo,7,6,1,0,11
4234,hatthī,hatthi,421,410,11,0,6
4235,jāṇukehi,janukehi,3,3,0,0,8
4236,patiṭṭhāsi,patitthasi,257,256,1,0,10
4237,disāvidisā,disavidisa,12,12,0,0,10
4238,ekamaggena,ekamaggena,18,18,0,0,10
4239,gatā,gata,1342,1306,36,0,4
4240,sīsābharaṇāni,sisabharanani,3,3,0,0,13
4241,vatthābharaṇāni,vatthabharanani,25,25,0,0,15
4242,pahāya,pahaya,2680,2598,82,0,6
4243,sammukhaṭṭhāne,sammukhatthane,30,30,0,0,14
4244,disāvidisāhiyeva,disavidisahiyeva,1,1,0,0,16
4245,devasaṅgho,devasangho,13,13,0,0,10
4246,palāyamānaṃ,palayamanam,9,9,0,0,11
4247,parājayo,parajayo,157,146,11,0,8
4248,jayo,jayo,147,139,8,0,4
4249,jayapūjaṃ,jayapujam,3,3,0,0,9
4250,karissāmāti,karissamati,54,51,3,0,11
4251,nāgā,naga,310,295,15,0,4
4252,nāgānaṃ,naganam,101,100,1,0,7
4253,supaṇṇā,supanna,54,52,2,0,7
4254,supaṇṇānaṃ,supannanam,32,32,0,0,10
4255,devatānaṃ,devatanam,472,441,31,0,9
4256,brahmāno,brahmano,132,130,2,0,8
4257,brahmānaṃ,brahmanam,211,205,6,0,9
4258,pesetvā,pesetva,460,448,12,0,7
4259,gandhamālādi,gandhamaladi,3,3,0,0,12
4260,hatthā,hattha,121,114,7,0,6
4261,bodhipallaṅkaṃ,bodhipallankam,7,7,0,0,14
4262,gatesu,gatesu,125,120,5,0,6
4263,panetesu,panetesu,33,33,0,0,8
4264,M0.0056,M0.0056,84,84,0,0,7
4265,sirīmato,sirimato,57,56,1,0,8
4266,pāpimato,papimato,122,121,1,0,8
4267,ugghosisuṃ,ugghosisum,4,4,0,0,10
4268,pamoditā,pamodita,50,48,2,0,8
4269,jayaṃ,jayam,110,93,17,0,5
4270,nāgagaṇā,nagagana,3,3,0,0,8
4271,mahesino,mahesino,388,380,8,0,8
4272,supaṇṇasaṅghā,supannasangha,1,1,0,0,13
4273,devagaṇā,devagana,13,12,1,0,8
4274,brahmagaṇāpi,brahmaganapi,2,2,0,0,12
4275,tādino,tadino,290,279,11,0,6
4276,avasesesu,avasesesu,87,83,4,0,9
4277,dasasu,dasasu,366,353,13,0,6
4278,cakkavāḷasahassesu,cakkavalasahassesu,36,35,1,0,18
4279,mālāgandhavilepanehi,malagandhavilepanehi,7,7,0,0,20
4280,pūjayamānā,pujayamana,24,24,0,0,10
4281,thutiyo,thutiyo,9,9,0,0,7
4282,pata,pata,23,6,17,0,4
4283,mānehi,manehi,11,10,1,0,6
4284,bodhirukkhaṅkurehi,bodhirukkhankurehi,4,4,0,0,18
4285,pubbenivāsañāṇaṃ,pubbenivasananam,37,34,3,0,16
4286,samuppāde,samuppade,3,3,0,0,9
4287,otāresi,otaresi,19,19,0,0,7
4288,athassa,athassa,1856,1840,16,0,7
4289,dvādasapadikaṃ,dvadasapadikam,7,7,0,0,14
4290,paccayā,paccaya,4583,4525,58,0,7
4291,kāraṃ,karam,146,132,14,0,5
4292,vaṭṭavivaṭṭavasena,vattavivattavasena,13,13,0,0,18
4293,anulomato,anulomato,167,158,9,0,9
4294,paṭilomato,patilomato,85,83,2,0,10
4295,sammasantassa,sammasantassa,56,55,1,0,13
4296,dasasahassilokadhātu,dasasahassilokadhatu,50,47,3,0,20
4297,udakapariyantaṃ,udakapariyantam,59,57,2,0,15
4298,dvādasakkhattuṃ,dvadasakkhattum,12,12,0,0,15
4299,sampakampi,sampakampi,27,26,1,0,10
4300,mahāpurisena,mahapurisena,6,6,0,0,12
4301,dasasahassi,dasasahassi,17,16,1,0,11
4302,lokadhātuṃ,lokadhatum,50,47,3,0,10
4303,unnādetvā,unnadetva,21,21,0,0,9
4304,M0.0057,M0.0057,82,82,0,0,7
4305,paṭivijjhīti,pativijjhiti,13,12,1,0,12
4306,vuttāvasesaṃ,vuttavasesam,34,30,4,0,12
4307,sampanna,sampanna,16,14,2,0,8
4308,dānādipāramīpuññavā,danadiparamipunnava,1,1,0,0,19
4309,dānādipāramīpuññena,danadiparamipunnena,1,1,0,0,19
4310,vijayitvā,vijayitva,3,3,0,0,9
4311,arahattamaggañāṇa,arahattamagganana,2,2,0,0,17
4312,sabbaññutañāṇasaṅkhātaṃ,sabbannutananasankhatam,2,2,0,0,23
4313,bhindituṃ,bhinditum,62,60,2,0,9
4314,chaṭṭhamavandanagāthāvaṇṇanā,chatthamavandanagathavannana,1,1,0,0,28
4315,rāgādi,ragadi,13,12,1,0,6
4316,chedāmalañāṇakhaggaṃ,chedamalananakhaggam,1,1,0,0,20
4317,chaṭṭhamagāthāya,chatthamagathaya,2,2,0,0,16
4318,maggañāṇādīhi,maggananadihi,2,2,0,0,13
4319,indavajira,indavajira,5,5,0,0,10
4320,upendavajira,upendavajira,5,5,0,0,12
4321,gāthādvayassa,gathadvayassa,3,3,0,0,13
4322,lakkhaṇassa,lakkhanassa,57,56,1,0,11
4323,missakattā,missakatta,19,19,0,0,10
4324,upajātigāthāti,upajatigathati,1,1,0,0,14
4325,anantarodīritalakkhaṇā,anantarodiritalakkhana,1,1,0,0,22
4326,pādāvimissā,padavimissa,1,1,0,0,11
4327,upajātiyo,upajatiyo,3,2,1,0,9
4328,vuttiyā,vuttiya,30,30,0,0,7
4329,anantaro,anantaro,23,22,1,0,8
4330,dīritalakkhaṇā,diritalakkhana,1,1,0,0,14
4331,anantare,anantare,760,750,10,0,8
4332,udīritaṃ,udiritam,24,18,6,0,8
4333,indavajiropenda,indavajiropenda,1,1,0,0,15
4334,vajiragāthānaṃ,vajiragathanam,1,1,0,0,14
4335,lakkhaṇavantā,lakkhanavanta,1,1,0,0,13
4336,pādā,pada,299,271,28,0,4
4337,vimissā,vimissa,2,2,0,0,7
4338,saṃsaṭṭhā,samsattha,353,342,11,0,9
4339,vuttiyo,vuttiyo,4,2,2,0,7
4340,M0.0058,M0.0058,81,81,0,0,7
4341,rāgādichedāmala,ragadichedamala,1,0,1,0,15
4342,ñāṇakhaggaṃ,nanakhaggam,2,1,1,0,11
4343,rāgaādicheda,ragaadicheda,1,1,0,0,12
4344,amalañāṇakhaggantipadacchedo,amalananakhaggantipadacchedo,1,1,0,0,28
4345,rāgādikilesaṃ,ragadikilesam,3,3,0,0,13
4346,malavira,malavira,2,2,0,0,8
4347,arahattamaggañāṇasaṅkhātaṃ,arahattamaggananasankhatam,5,5,0,0,26
4348,asivantanti,asivantanti,1,1,0,0,11
4349,rūpādīsu,rupadisu,340,332,8,0,8
4350,rañjatīti,ranjatiti,6,5,1,0,9
4351,rāgo,rago,1807,1709,98,0,4
4352,ranjadhātu,ranjadhatu,4,4,0,0,10
4353,rāge,rage,77,71,6,0,4
4354,ādi,adi,1981,603,1378,0,3
4355,yesanteti,yesanteti,3,3,0,0,9
4356,rāgādichedaṃ,ragadichedam,1,1,0,0,12
4357,arahattamaggañāṇaṃ,arahattamaggananam,37,36,1,0,18
4358,apāyaṃ,apayam,412,392,20,0,6
4359,malati,malati,5,5,0,0,6
4360,malaṃ,malam,242,209,33,0,5
4361,saṃkilissati,samkilissati,32,31,1,0,12
4362,maladhātu,maladhatu,2,2,0,0,9
4363,saṃkilesane,samkilesane,2,1,1,0,11
4364,malato,malato,2,2,0,0,6
4365,virahitaṃ,virahitam,21,20,1,0,9
4366,amalaṃ,amalam,18,16,2,0,6
4367,rāgādichedañca,ragadichedanca,1,1,0,0,14
4368,amalañca,amalanca,1,1,0,0,8
4369,ñāṇañcāti,nanancati,9,9,0,0,9
4370,rāgādichedāmalañāṇaṃ,ragadichedamalananam,1,1,0,0,20
4371,rukkhādiṃ,rukkhadim,2,2,0,0,9
4372,khaggati,khaggati,1,1,0,0,8
4373,chindati,chindati,268,265,3,0,8
4374,khaggaṃ,khaggam,118,117,1,0,7
4375,pakatiasi,pakatiasi,1,1,0,0,9
4376,rāgādichedāmalañāṇasaṅkhataṃ,ragadichedamalananasankhatam,1,1,0,0,28
4377,rāgādichedāmalañāṇakhaggo,ragadichedamalananakhaggo,1,1,0,0,25
4378,chindantena,chindantena,6,6,0,0,11
4379,hitena,hitena,40,40,0,0,6
4380,aggamaggañāṇasaṅkhatena,aggamaggananasankhatena,1,1,0,0,23
4381,asinā,asina,121,118,3,0,5
4382,satīsamaññā,satisamanna,1,0,1,0,11
4383,phalakābhigāhaṃ,phalakabhigaham,1,0,1,0,15
4384,satisamaññāphalaka,satisamannaphalaka,1,1,0,0,18
4385,abhigāhantipadacchedo,abhigahantipadacchedo,1,1,0,0,21
4386,sammāsatināmikaṃ,sammasatinamikam,1,1,0,0,16
4387,daḷhagāha,dalhagaha,1,1,0,0,9
4388,kanti,kanti,40,27,13,0,5
4389,sati,sati,7173,6927,246,0,4
4390,sampayuttadhammā,sampayuttadhamma,53,51,2,0,16
4391,saratīti,saratiti,57,44,13,0,8
4392,saradhātuti,saradhatuti,1,1,0,0,11
4393,pamādaṃ,pamadam,237,214,23,0,7
4394,hiṃsatīti,himsatiti,116,101,15,0,9
4395,sammāsati,sammasati,348,324,24,0,9
4396,hiṃsāyaṃti,himsayamti,1,1,0,0,10
4397,ājānāti,ajanati,18,17,1,0,7
4398,samaññā,samanna,259,243,16,0,7
4399,satiiti,satiiti,1,1,0,0,7
4400,satisamaññā,satisamanna,1,1,0,0,11
4401,asiādisatthaṃ,asiadisattham,3,3,0,0,13
4402,phalati,phalati,54,52,2,0,7
4403,nivāretīti,nivaretiti,22,17,5,0,10
4404,kheṭakaṃ,khetakam,4,4,0,0,8
4405,phaladhātu,phaladhatu,1,1,0,0,10
4406,nivāraṇe,nivarane,14,13,1,0,8
4407,satisamaññaṃ,satisamannam,1,1,0,0,12
4408,abhidaḷhaṃ,abhidalham,1,1,0,0,10
4409,gaṇhatīti,ganhatiti,19,14,5,0,9
4410,satisamaññāphala,satisamannaphala,1,1,0,0,16
4411,kābhigāho,kabhigaho,1,1,0,0,9
4412,rakkhati,rakkhati,655,625,30,0,8
4413,satisaṃvaro,satisamvaro,59,45,14,0,11
4414,cakkhādi,cakkhadi,26,25,1,0,8
4415,dvāresu,dvaresu,334,330,4,0,7
4416,rūpādiārammaṇaṃ,rupadiarammanam,39,38,1,0,15
4417,pavisituṃ,pavisitum,157,155,2,0,9
4418,adatvā,adatva,452,445,7,0,6
4419,satidhammo,satidhammo,1,1,0,0,10
4420,sabbākusalānaṃ,sabbakusalanam,16,16,0,0,14
4421,rakkhakattā,rakkhakatta,1,1,0,0,11
4422,sabbakusala,sabbakusala,2,2,0,0,11
4423,sabbatthānaṃ,sabbatthanam,2,2,0,0,12
4424,sādhakattā,sadhakatta,8,8,0,0,10
4425,satiphalakaṃ,satiphalakam,4,3,1,0,12
4426,daḷhaṃ,dalham,653,605,48,0,6
4427,M0.0059,M0.0059,84,84,0,0,7
4428,keci,keci,4354,4249,105,0,4
4429,appamādamūlakā,appamadamulaka,19,19,0,0,14
4430,appamādasamosaraṇā,appamadasamosarana,18,17,1,0,18
4431,appamādo,appamado,191,170,21,0,8
4432,satiṃ,satim,556,501,55,0,5
4433,khvāhaṃ,khvaham,402,376,26,0,7
4434,sabbatthikaṃ,sabbatthikam,25,18,7,0,12
4435,vadāmī,vadami,270,254,16,0,6
4436,sīlaoghaalaṅkāra,silaoghaalankara,1,1,0,0,16
4437,vibhū,vibhu,27,26,1,0,5
4438,sitanti,sitanti,2,2,0,0,7
4439,visuddhasīlānaṃ,visuddhasilanam,1,1,0,0,15
4440,samūhasaṅkhātena,samuhasankhatena,3,3,0,0,16
4441,alaṅkārena,alankarena,37,34,3,0,10
4442,vibhūsitanti,vibhusitanti,1,1,0,0,12
4443,saṃvaro,samvaro,412,379,33,0,7
4444,avītikkamo,avitikkamo,123,113,10,0,10
4445,sīlañcāti,silancati,5,2,3,0,9
4446,pāṇātipātā,panatipata,632,601,31,0,10
4447,dīhi,dihi,40,40,0,0,4
4448,viramantassa,viramantassa,91,89,2,0,12
4449,vattapaṭipattiṃ,vattapatipattim,42,40,2,0,15
4450,pūrentassa,purentassa,34,31,3,0,10
4451,cetasikasīlaṃ,cetasikasilam,2,2,0,0,13
4452,pāṇātipātādīhi,panatipatadihi,64,63,1,0,14
4453,virati,virati,240,230,10,0,6
4454,pātimokkhasaṃvaro,patimokkhasamvaro,66,56,10,0,17
4455,ñāṇasaṃvaro,nanasamvaro,47,32,15,0,11
4456,khantisaṃvaro,khantisamvaro,41,26,15,0,13
4457,vīriyasaṃvaro,viriyasamvaro,21,4,17,0,13
4458,pañcavidho,pancavidho,135,130,5,0,10
4459,sabbametaṃ,sabbametam,311,289,22,0,10
4460,samādinnasīlassa,samadinnasilassa,4,4,0,0,16
4461,kāyikavācasiko,kayikavacasiko,44,42,2,0,14
4462,anatikkamoti,anatikkamoti,1,1,0,0,12
4463,paṭisambhidāyaṃ,patisambhidayam,95,54,41,0,15
4464,kiṃsīlanticetanā,kimsilanticetana,1,1,0,0,16
4465,nādhippetaṃ,nadhippetam,24,24,0,0,11
4466,samādinnasikkhāpadassa,samadinnasikkhapadassa,1,1,0,0,22
4467,buddhānañhi,buddhananhi,83,83,0,0,11
4468,sikkhāpadaṃ,sikkhapadam,1250,1199,51,0,11
4469,oghoti,oghoti,10,9,1,0,6
4470,oghasaddo,oghasaddo,1,1,0,0,9
4471,samūhavācako,samuhavacako,1,1,0,0,12
4472,gaṇasaṅghātā,ganasanghata,2,2,0,0,12
4473,samudāyo,samudayo,121,120,1,0,8
4474,sañcayo,sancayo,56,54,2,0,7
4475,sandoho,sandoho,5,3,2,0,7
4476,nivaho,nivaho,5,4,1,0,6
4477,visaro,visaro,9,7,2,0,6
4478,nikaro,nikaro,8,7,1,0,6
4479,cayo,cayo,47,45,2,0,4
4480,avahanati,avahanati,1,1,0,0,9
4481,avapubbahanadhātu,avapubbahanadhatu,1,1,0,0,17
4482,avassa,avassa,10,8,2,0,6
4483,M0.0060,M0.0060,84,84,0,0,7
4484,byāpiyati,byapiyati,1,1,0,0,9
4485,sīlānaṃ,silanam,48,43,5,0,7
4486,sīlogho,silogho,2,2,0,0,7
4487,alaṅkāroti,alankaroti,4,3,1,0,10
4488,piḷandhano,pilandhano,1,1,0,0,10
4489,alaṃ,alam,1284,1131,153,0,4
4490,vibhusaṃ,vibhusam,1,1,0,0,8
4491,samaṅgīpuggalaṃ,samangipuggalam,3,3,0,0,15
4492,anenāti,anenati,211,201,10,0,7
4493,alaṅkāro,alankaro,81,68,13,0,8
4494,alaṃsaddūpapadakaradhātu,alamsaddupapadakaradhatu,1,1,0,0,24
4495,eva,eva,13062,12713,349,0,3
4496,sīloghālaṅkāro,siloghalankaro,1,1,0,0,14
4497,siyatīti,siyatiti,2,1,1,0,8
4498,sīloghalaṅkāravibhūsito,siloghalankaravibhusito,1,1,0,0,23
4499,asādhāraṇena,asadharanena,23,22,1,0,12
4500,lokuttarasīlālaṅkārena,lokuttarasilalankarena,1,1,0,0,22
4501,vibhūsito,vibhusito,15,15,0,0,9
4502,cīvarādinālaṅkārenāti,civaradinalankarenati,1,1,0,0,21
4503,sīlālaṅkārena,silalankarena,9,6,3,0,13
4504,abhiññāvaraṃ,abhinnavaram,1,1,0,0,12
4505,upetanti,upetanti,8,8,0,0,8
4506,abhiññāvaramiddhupetanti,abhinnavaramiddhupetanti,1,1,0,0,24
4507,abhiññāsaṅkhātāya,abhinnasankhataya,3,3,0,0,17
4508,uttamāya,uttamaya,26,26,0,0,8
4509,iddhiyā,iddhiya,517,482,35,0,7
4510,samannāgatanti,samannagatanti,8,8,0,0,14
4511,abhivisesena,abhivisesena,7,7,0,0,12
4512,abhiññā,abhinna,1132,1066,66,0,7
4513,chabbidhaṃ,chabbidham,70,60,10,0,10
4514,iddhividhadibbasota,iddhividhadibbasota,1,1,0,0,19
4515,paracitta,paracitta,3,3,0,0,9
4516,vijānana,vijanana,10,9,1,0,8
4517,pubbenivāsānussati,pubbenivasanussati,27,23,4,0,18
4518,cutūpapāta,cutupapata,1,1,0,0,10
4519,āsavakkhaya,asavakkhaya,1,1,0,0,11
4520,ñāṇavasena,nanavasena,14,14,0,0,10
4521,iddhividhañāṇanti,iddhividhanananti,1,1,0,0,17
4522,bahudhā,bahudha,252,240,12,0,7
4523,hotītiādinayappavatte,hotitiadinayappavatte,1,1,0,0,21
4524,iddhividhe,iddhividhe,15,13,2,0,10
4525,jānana,janana,9,9,0,0,6
4526,dibbasotañāṇanti,dibbasotanananti,1,1,0,0,16
4527,dūrasantikādibhedasaddārammaṇāya,durasantikadibhedasaddarammanaya,2,2,0,0,32
4528,dibbasotadhātuyā,dibbasotadhatuya,8,8,0,0,16
4529,paracittavijānanañāṇanti,paracittavijanananananti,1,1,0,0,24
4530,cittaparicchedassa,cittaparicchedassa,2,2,0,0,18
4531,vijānanañāṇaṃ,vijananananam,1,1,0,0,13
4532,pubbenivāsā,pubbenivasa,4,3,1,0,11
4533,nussatiñāṇanti,nussatinananti,1,1,0,0,14
4534,attasantāne,attasantane,7,7,0,0,11
4535,vutthavasena,vutthavasena,1,1,0,0,12
4536,gocara,gocara,7,6,1,0,6
4537,nivāsavasena,nivasavasena,3,3,0,0,12
4538,atītabhavesu,atitabhavesu,14,14,0,0,12
4539,khandhādīnaṃ,khandhadinam,53,51,2,0,12
4540,anussaraṇa,anussarana,1,1,0,0,10
4541,satiyā,satiya,886,831,55,0,6
4542,sampayuttaṃ,sampayuttam,635,621,14,0,11
4543,cutūpapātañāṇanti,cutupapatanananti,2,2,0,0,17
4544,cutiyañca,cutiyanca,3,3,0,0,9
4545,upapāte,upapate,8,7,1,0,7
4546,dibbacakkhuñāṇanti,dibbacakkhunananti,2,2,0,0,18
4547,āsavakkhayañāṇanti,asavakkhayanananti,13,13,0,0,18
4548,saccaparicchedassa,saccaparicchedassa,1,1,0,0,18
4549,maggañāṇanti,magganananti,7,7,0,0,12
4550,varanti,varanti,21,21,0,0,7
4551,iddhīti,iddhiti,73,46,27,0,7
4552,ijjhanaṃ,ijjhanam,16,14,2,0,8
4553,samijjhanaṃ,samijjhanam,7,7,0,0,11
4554,ijjhati,ijjhati,240,234,6,0,7
4555,samijjhatīti,samijjhatiti,46,34,12,0,12
4556,idhadhātuti,idhadhatuti,1,1,0,0,11
4557,varāya,varaya,4,4,0,0,6
4558,M0.0061,M0.0061,82,82,0,0,7
4559,abhiññāvaramiddhupeto,abhinnavaramiddhupeto,1,1,0,0,21
4560,abhiññāvaramiddhupetaṃ,abhinnavaramiddhupetam,1,1,0,0,22
4561,rāgādichedāmalañāṇa,ragadichedamalanana,1,1,0,0,19
4562,malavirahitaṃ,malavirahitam,1,1,0,0,13
4563,asivantaṃ,asivantam,1,1,0,0,9
4564,satināmikaṃ,satinamikam,1,1,0,0,11
4565,daḷhagahaṇaṃ,dalhagahanam,3,3,0,0,12
4566,vibhūsitaṃ,vibhusitam,9,9,0,0,10
4567,varamiddhupetaṃ,varamiddhupetam,1,1,0,0,15
4568,samupetaṃ,samupetam,12,12,0,0,9
4569,sattamavandanagāthāvaṇṇanā,sattamavandanagathavannana,1,1,0,0,26
4570,sattamagāthāya,sattamagathaya,6,6,0,0,14
4571,mahākaruṇā,mahakaruna,81,78,3,0,10
4572,ragaṇehi,raganehi,2,2,0,0,8
4573,dvādasakkharehi,dvadasakkharehi,5,5,0,0,15
4574,catupādantayamakā,catupadantayamaka,1,1,0,0,17
4575,vaṃsaṭṭhagāthāti,vamsatthagathati,2,2,0,0,16
4576,vaṃsaṭṭhamidaṃ,vamsatthamidam,2,2,0,0,14
4577,jarā,jara,440,401,39,0,4
4578,jatagaṇā,jatagana,1,1,0,0,8
4579,jaragaṇā,jaragana,1,1,0,0,8
4580,vaṃsaṭṭhaṃ,vamsattham,1,1,0,0,10
4581,vaṃsaṭṭhagāthā,vamsatthagatha,2,2,0,0,14
4582,munayo,munayo,78,73,5,0,6
4583,isayo,isayo,237,228,9,0,5
4584,vadantīti,vadantiti,211,141,70,0,9
4585,mahākaruṇāya,mahakarunaya,84,83,1,0,12
4586,mettāya,mettaya,390,363,27,0,7
4587,dayāsaddo,dayasaddo,13,12,1,0,9
4588,karuṇāya,karunaya,278,271,7,0,8
4589,adayāpannoti,adayapannoti,2,1,1,0,12
4590,nikkaruṇikataṃ,nikkarunikatam,1,1,0,0,14
4591,M0.0062,M0.0062,83,83,0,0,7
4592,āpannoti,apannoti,56,41,15,0,8
4593,dayāpannoti,dayapannoti,5,2,3,0,11
4594,mettacittataṃ,mettacittatam,15,13,2,0,13
4595,tadubhayampi,tadubhayampi,234,231,3,0,12
4596,vaṭṭati,vattati,6574,6489,85,0,7
4597,dayā,daya,88,64,24,0,4
4598,dayāti,dayati,4,1,3,0,6
4599,saddasarūpekaseso,saddasarupekaseso,1,1,0,0,17
4600,dayati,dayati,23,23,0,0,6
4601,kāruṇikanti,karunikanti,2,2,0,0,11
4602,dayadhātu,dayadhatu,6,6,0,0,9
4603,hiṃsāyaṃ,himsayam,124,88,36,0,8
4604,yā,ya,7096,6471,625,0,2
4605,karuṇā,karuna,398,336,62,0,6
4606,yathādhippetaṃ,yathadhippetam,30,29,1,0,14
4607,parassa,parassa,1766,1685,81,0,7
4608,hitanipphattiṃ,hitanipphattim,2,2,0,0,14
4609,kāruṇikaṃ,karunikam,30,28,2,0,9
4610,apaneti,apaneti,54,53,1,0,7
4611,paradukkhanti,paradukkhanti,2,2,0,0,13
4612,sukhampi,sukhampi,33,30,3,0,8
4613,khedaṃ,khedam,24,19,5,0,6
4614,gaṇhāti,ganhati,1799,1767,32,0,7
4615,sajjano,sajjano,10,8,2,0,7
4616,anuggaṇhāti,anugganhati,18,17,1,0,11
4617,pāpajanampi,papajanampi,3,3,0,0,11
4618,dayanti,dayanti,15,15,0,0,7
4619,gaṇhanti,ganhanti,639,626,13,0,8
4620,bodhisattā,bodhisatta,99,98,1,0,10
4621,buddhabhāvāya,buddhabhavaya,36,36,0,0,13
4622,abhinīhārakaraṇa,abhiniharakarana,1,1,0,0,16
4623,kāle,kale,2971,2890,81,0,4
4624,hatthagatampi,hatthagatampi,4,4,0,0,13
4625,aggaphalaṃ,aggaphalam,86,84,2,0,10
4626,saṃsārasāgarato,samsarasagarato,4,4,0,0,15
4627,samuddharitukāmā,samuddharitukama,3,3,0,0,16
4628,anassāsa,anassasa,1,1,0,0,8
4629,saṃsāradukkhañca,samsaradukkhanca,2,2,0,0,16
4630,pacchimabhave,pacchimabhave,23,22,1,0,13
4631,amata,amata,4,3,1,0,5
4632,dhātupaṭilābhena,dhatupatilabhena,1,1,0,0,16
4633,anekaguṇasamalaṅkataṃ,anekagunasamalankatam,3,3,0,0,21
4634,sabbaññutañāṇañca,sabbannutanananca,2,2,0,0,17
4635,gaṇhantīti,ganhantiti,94,73,21,0,10
4636,dadāti,dadati,206,197,9,0,6
4637,mettā,metta,401,360,41,0,5
4638,dāne,dane,316,294,22,0,4
4639,vibhāgaṃ,vibhagam,178,171,7,0,8
4640,akatvā,akatva,1178,1159,19,0,6
4641,samaṃ,samam,1172,1027,145,0,5
4642,udakaṃ,udakam,2637,2542,95,0,6
4643,sabbasattesu,sabbasattesu,108,107,1,0,12
4644,sītena,sitena,128,124,4,0,6
4645,pharati,pharati,238,230,8,0,7
4646,rajomalañca,rajomalanca,2,2,0,0,11
4647,pavāheti,pavaheti,10,10,0,0,8
4648,pāpakalyāṇajanesu,papakalyanajanesu,2,2,0,0,17
4649,aparo,aparo,646,618,28,0,5
4650,anurakkhanti,anurakkhanti,3,3,0,0,12
4651,etāya,etaya,310,300,10,0,5
4652,sayaṃ,sayam,3249,3040,209,0,5
4653,anuddayati,anuddayati,2,2,0,0,10
4654,anuddayamattameva,anuddayamattameva,1,1,0,0,17
4655,etanti,etanti,72,69,3,0,6
4656,karuṇāmettā,karunametta,1,1,0,0,11
4657,labbhanti,labbhanti,639,614,25,0,9
4658,ālayati,alayati,1,1,0,0,7
4659,patiṭṭhati,patitthati,14,14,0,0,10
4660,dayālayo,dayalayo,4,4,0,0,8
4661,devadattādīsu,devadattadisu,4,4,0,0,13
4662,virodhi,virodhi,17,8,9,0,7
4663,avirodhisattesu,avirodhisattesu,1,1,0,0,15
4664,orase,orase,6,6,0,0,5
4665,rāhule,rahule,14,14,0,0,6
4666,hitajjhāsayatāya,hitajjhasayataya,5,5,0,0,16
4667,ṭhito,thito,2861,2760,101,0,5
4668,M0.0063,M0.0063,84,84,0,0,7
4669,dayālayanti,dayalayanti,1,1,0,0,11
4670,apadānapāḷiyaṃ,apadanapaliyam,5,1,4,0,14
4671,vadhake,vadhake,22,22,0,0,7
4672,devadatte,devadatte,34,33,1,0,9
4673,core,core,138,137,1,0,4
4674,aṅgulimālake,angulimalake,7,7,0,0,12
4675,dhanapāle,dhanapale,8,8,0,0,9
4676,samacitto,samacitto,10,10,0,0,9
4677,mahāmunī,mahamuni,23,22,1,0,8
4678,sabbadhīti,sabbadhiti,28,0,28,0,10
4679,sabbasmiṃ,sabbasmim,215,206,9,0,9
4680,attabhāve,attabhave,571,548,23,0,9
4681,abhinīhārato,abhiniharato,42,40,2,0,12
4682,sabbattabhāvesūti,sabbattabhavesuti,1,1,0,0,17
4683,dukkhena,dukkhena,641,613,28,0,8
4684,karitabbaṃ,karitabbam,4,4,0,0,10
4685,pañcamahāpariccāgādikammaṃ,pancamahapariccagadikammam,3,3,0,0,26
4686,karitabbanti,karitabbanti,2,2,0,0,12
4687,pañcamahā,pancamaha,2,2,0,0,9
4688,pariccāgoti,pariccagoti,6,5,1,0,11
4689,dhanapariccāgo,dhanapariccago,7,6,1,0,14
4690,aṅgapariccāgo,angapariccago,15,15,0,0,13
4691,puttapariccāgo,puttapariccago,2,2,0,0,14
4692,bhariyapariccāgo,bhariyapariccago,2,2,0,0,16
4693,jīvitapariccāgo,jivitapariccago,12,12,0,0,15
4694,hatthiassa,hatthiassa,1,1,0,0,10
4695,dāsidāsādi,dasidasadi,1,1,0,0,10
4696,saviññāṇakassa,savinnanakassa,7,7,0,0,14
4697,dhanassa,dhanassa,92,87,5,0,8
4698,muttāmaṇirajatādi,muttamanirajatadi,1,1,0,0,17
4699,aviññāṇakassa,avinnanakassa,4,4,0,0,13
4700,pariccāgo,pariccago,49,48,1,0,9
4701,hatthapādacakkhukaṇṇanāsādisarīrāva,hatthapadacakkhukannanasadisarirava,1,1,0,0,35
4702,yavassa,yavassa,5,5,0,0,7
4703,puttassa,puttassa,591,588,3,0,8
4704,dhītuyā,dhituya,40,40,0,0,7
4705,bhariyāya,bhariyaya,200,199,1,0,9
4706,jīvitindriyapaṭibaddhassa,jivitindriyapatibaddhassa,1,1,0,0,25
4707,sarīrassa,sarirassa,235,232,3,0,9
4708,dhanapariccāgā,dhanapariccaga,1,1,0,0,14
4709,dayo,dayo,263,262,1,0,4
4710,dānapāramiyaṃyeva,danaparamiyamyeva,1,1,0,0,17
4711,antogadhā,antogadha,58,53,5,0,9
4712,pariccāga,pariccaga,1,1,0,0,9
4713,visesabhāvadassanatthañceva,visesabhavadassanatthanceva,1,1,0,0,27
4714,sudukkarabhāvadassanatthañca,sudukkarabhavadassanatthanca,9,9,0,0,28
4715,mahāpariccāgavasena,mahapariccagavasena,1,1,0,0,19
4716,katanti,katanti,474,471,3,0,7
4717,mahāpadānasuttaṭīkāyaṃ,mahapadanasuttatikayam,1,0,1,0,22
4718,nayanapariccāgo,nayanapariccago,3,3,0,0,15
4719,attapariccāgo,attapariccago,8,8,0,0,13
4720,rajjapariccāgo,rajjapariccago,3,3,0,0,14
4721,puttadārapariccāgoti,puttadarapariccagoti,3,3,0,0,20
4722,mahāpariccāgā,mahapariccaga,8,7,1,0,13
4723,tatthapi,tatthapi,219,219,0,0,8
4724,aṅgapariccāgādayopi,angapariccagadayopi,2,2,0,0,19
4725,dānapāramīyeva,danaparamiyeva,2,2,0,0,14
4726,pariccāgavisesabhāvadassanatthañceva,pariccagavisesabhavadassanatthanceva,6,6,0,0,36
4727,mahāpariccāgānaṃ,mahapariccaganam,8,8,0,0,16
4728,gahaṇaṃ,gahanam,1258,1214,44,0,7
4729,tatoyeva,tatoyeva,188,188,0,0,8
4730,aṅgapariccāgatopi,angapariccagatopi,2,2,0,0,17
4731,nayanapariccāgaggahaṇaṃ,nayanapariccagaggahanam,5,5,0,0,23
4732,pariccāgabhāvasāmaññepi,pariccagabhavasamannepi,5,5,0,0,23
4733,rajjapariccāga,rajjapariccaga,1,1,0,0,14
4734,puttadārapariccāgaggahaṇaṃ,puttadarapariccagaggahanam,1,1,0,0,26
4735,karanti,karanti,1,1,0,0,7
4736,etassa,etassa,1994,1924,70,0,6
4737,kammapadaṃ,kammapadam,24,24,0,0,10
4738,karontaṃ,karontam,109,107,2,0,8
4739,M0.0064,M0.0064,83,83,0,0,7
4740,bhavaaṇṇavaatikkamaṃ,bhavaannavaatikkamam,1,1,0,0,20
4741,aggatanti,aggatanti,3,3,0,0,9
4742,bhavaṇṇavātikkamanti,bhavannavatikkamanti,2,2,0,0,20
4743,kāmarūpaarūpabhavasaṅkhatā,kamarupaarupabhavasankhata,1,1,0,0,26
4744,aṇṇavā,annava,3,3,0,0,6
4745,samuddato,samuddato,35,34,1,0,9
4746,atikkantaṃ,atikkantam,66,62,4,0,10
4747,aṇṇo,anno,5,5,0,0,4
4748,etasmiṃ,etasmim,1295,1244,51,0,7
4749,samuddo,samuddo,267,250,17,0,7
4750,bhavasaṅkhāto,bhavasankhato,1,1,0,0,13
4751,aṇṇavoti,annavoti,4,4,0,0,8
4752,mahāsamuddo,mahasamuddo,239,236,3,0,11
4753,bahūhi,bahuhi,269,250,19,0,6
4754,ūmivegādīhi,umivegadihi,1,1,0,0,11
4755,bhayehi,bhayehi,7,6,1,0,7
4756,okiṇṇo,okinno,5,5,0,0,6
4757,tividhopi,tividhopi,54,52,2,0,9
4758,jātijarāmaraṇādīhi,jatijaramaranadihi,6,6,0,0,18
4759,dukkhabhayehi,dukkhabhayehi,1,1,0,0,13
4760,bhavaṇṇavāti,bhavannavati,2,1,1,0,12
4761,atikkamittha,atikkamittha,2,2,0,0,12
4762,uttaritthāti,uttaritthati,1,1,0,0,12
4763,bhavaṇṇavātikkamo,bhavannavatikkamo,1,1,0,0,17
4764,gambhīre,gambhire,116,106,10,0,8
4765,mahāudakakkhandhe,mahaudakakkhandhe,5,5,0,0,17
4766,mahāsamudde,mahasamudde,300,290,10,0,11
4767,sandatiiva,sandatiiva,1,1,0,0,10
4768,tibhavasaṅkhate,tibhavasankhate,1,1,0,0,15
4769,paṭisandhicutiyo,patisandhicutiyo,1,1,0,0,16
4770,diyaḍḍhasahassakilesānaṃ,diyaddhasahassakilesanam,1,1,0,0,24
4771,asesaṃ,asesam,158,129,29,0,6
4772,viddhaṃsitattā,viddhamsitatta,16,14,2,0,14
4773,abhitthavituṃ,abhitthavitum,3,3,0,0,13
4774,arahatīti,arahatiti,232,221,11,0,9
4775,bhavaṇṇavātikkamaṃ,bhavannavatikkamam,2,2,0,0,18
4776,aggataṃ,aggatam,23,21,2,0,7
4777,aggasaddo,aggasaddo,11,11,0,0,9
4778,ādikoṭikoṭṭhāsaseṭṭhesu,adikotikotthasasetthesu,7,7,0,0,23
4779,hesa,hesa,251,248,3,0,4
4780,ajjatagge,ajjatagge,230,226,4,0,9
4781,pāṇupetaṃ,panupetam,158,148,10,0,9
4782,gatantiādīsu,gatantiadisu,1,1,0,0,12
4783,ādimhi,adimhi,330,317,13,0,6
4784,teneva,teneva,2794,2721,73,0,6
4785,aṅgulaggena,angulaggena,13,13,0,0,11
4786,aṅgulaggaṃ,angulaggam,10,10,0,0,10
4787,parāmaseyyātiādīsu,paramaseyyatiadisu,1,1,0,0,18
4788,anujānāmi,anujanami,1789,1742,47,0,9
4789,vihāraggena,viharaggena,13,13,0,0,11
4790,pariveṇaggena,parivenaggena,16,16,0,0,13
4791,bhājetuntiādīsu,bhajetuntiadisu,1,1,0,0,15
4792,koṭṭhāse,kotthase,334,323,11,0,8
4793,aggo,aggo,490,470,20,0,4
4794,hamasmi,hamasmi,16,15,1,0,7
4795,lokassātiādīsu,lokassatiadisu,1,1,0,0,14
4796,seṭṭhe,setthe,61,58,3,0,6
4797,svāyamidhapi,svayamidhapi,1,1,0,0,12
4798,devamanussānaṃ,devamanussanam,642,615,27,0,14
4799,ajati,ajati,12,12,0,0,5
4800,asadisaṭṭhena,asadisatthena,12,10,2,0,13
4801,guṇavisiṭṭhaṭṭhena,gunavisitthatthena,7,6,1,0,18
4802,asamasamaṭṭhena,asamasamatthena,6,5,1,0,15
4803,dullabhapātu,dullabhapatu,1,1,0,0,12
4804,bhāvato,bhavato,115,108,7,0,7
4805,acchariyamanussabhāvato,acchariyamanussabhavato,3,3,0,0,23
4806,bahujanahitasukhāvahato,bahujanahitasukhavahato,3,3,0,0,23
4807,adutiyaasahāyādibhāvato,adutiyaasahayadibhavato,3,3,0,0,23
4808,M0.0065,M0.0065,84,84,0,0,7
4809,bahuppadā,bahuppada,21,20,1,0,9
4810,aggassa,aggassa,27,24,3,0,7
4811,gatantietassa,gatantietassa,1,1,0,0,13
4812,pattaṃ,pattam,2013,1910,103,0,6
4813,pāpuṇantanti,papunantanti,1,1,0,0,12
4814,kāmarūpaarūpasaṅkhatānaṃ,kamarupaarupasankhatanam,1,1,0,0,24
4815,paṭisaraṇaṃ,patisaranam,190,174,16,0,11
4816,lokasaddassa,lokasaddassa,6,6,0,0,12
4817,tayo,tayo,6850,6541,309,0,4
4818,lokā,loka,432,419,13,0,4
4819,tilokā,tiloka,3,3,0,0,6
4820,nāthasaddo,nathasaddo,2,2,0,0,10
4821,nipphannānipphannavasena,nipphannanipphannavasena,2,2,0,0,24
4822,duvidho,duvidho,491,473,18,0,7
4823,anipphannanāthasaddo,anipphannanathasaddo,1,1,0,0,20
4824,paṭisaraṇattho,patisaranattho,2,2,0,0,14
4825,saṅketavasena,sanketavasena,7,7,0,0,13
4826,saṅketavacanaṃ,sanketavacanam,19,16,3,0,14
4827,saccaṃ,saccam,2938,2801,137,0,6
4828,lokasammutikāraṇaṃ,lokasammutikaranam,13,9,4,0,18
4829,paṭisaraṇoti,patisaranoti,2,2,0,0,12
4830,tilokanātho,tilokanatho,6,6,0,0,11
4831,sabbānatthaparihāra,sabbanatthaparihara,1,1,0,0,19
4832,pubbaṅgamāya,pubbangamaya,2,2,0,0,12
4833,niravasesahitasukhavidhānatapparāyaniratisayāya,niravasesahitasukhavidhanatapparayaniratisayaya,1,1,0,0,47
4834,payogasampattiyā,payogasampattiya,31,31,0,0,16
4835,sadevamanussāya,sadevamanussaya,177,176,1,0,15
4836,pajāya,pajaya,248,239,9,0,6
4837,accantupakāritāya,accantupakaritaya,10,10,0,0,17
4838,aparimitanirupamappabhāvaguṇavisesasamaṅgitāya,aparimitanirupamappabhavagunavisesasamangitaya,6,6,0,0,46
4839,sabbasattuttamo,sabbasattuttamo,25,24,1,0,15
4840,aparimāṇāsu,aparimanasu,69,65,4,0,11
4841,lokadhātūsu,lokadhatusu,86,85,1,0,11
4842,aparimāṇānaṃ,aparimananam,61,57,4,0,12
4843,ekapaṭisaraṇo,ekapatisarano,2,2,0,0,13
4844,nipphannanāthasaddo,nipphannanathasaddo,1,1,0,0,19
4845,yācane,yacane,40,33,7,0,6
4846,upatāpe,upatape,10,7,3,0,7
4847,issariye,issariye,48,46,2,0,8
4848,āsīse,asise,2,2,0,0,5
4849,nāthati,nathati,25,24,1,0,7
4850,yācatīti,yacatiti,39,27,12,0,8
4851,nāthadhātu,nathadhatu,2,2,0,0,10
4852,hitakaraṇe,hitakarane,2,2,0,0,10
4853,yācitvāpi,yacitvapi,22,21,1,0,9
4854,niyojetīti,niyojetiti,17,17,0,0,10
4855,sādhu,sadhu,3060,2899,161,0,5
4856,bhikkhu,bhikkhu,15785,15257,528,0,7
4857,kālena,kalena,1263,1189,74,0,6
4858,kālaṃ,kalam,2482,2353,129,0,5
4859,attasampattiṃ,attasampattim,12,12,0,0,13
4860,paccavekkheyyātiādinā,paccavekkheyyatiadina,1,1,0,0,21
4861,hitapaṭipattiṃ,hitapatipattim,12,12,0,0,14
4862,samussāhito,samussahito,14,14,0,0,11
4863,niyojeti,niyojeti,84,82,2,0,8
4864,veneyyagate,veneyyagate,4,4,0,0,11
4865,upatāpetīti,upatapetiti,7,7,0,0,11
4866,viddhaṃsāpetīti,viddhamsapetiti,1,1,0,0,15
4867,issariyati,issariyati,1,1,0,0,10
4868,satteti,satteti,23,18,5,0,7
4869,paramena,paramena,109,103,6,0,8
4870,M0.0066,M0.0066,82,82,0,0,7
4871,cittissariyena,cittissariyena,12,12,0,0,14
4872,sabbasatte,sabbasatte,83,82,1,0,10
4873,dhammena,dhammena,1504,1429,75,0,8
4874,isati,isati,5,5,0,0,5
4875,abhibhavatīti,abhibhavatiti,63,56,7,0,13
4876,āsīsatīti,asisatiti,4,4,0,0,9
4877,navasena,navasena,1,1,0,0,8
4878,patthetīti,patthetiti,29,20,9,0,10
4879,lābhālābhādilokadhammehi,labhalabhadilokadhammehi,2,2,0,0,24
4880,acala,acala,3,3,0,0,5
4881,mānattā,manatta,9,9,0,0,7
4882,sundarasamādhivantaṃ,sundarasamadhivantam,1,1,0,0,20
4883,saṃsamaṃ,samsamam,1,1,0,0,8
4884,ādhiyati,adhiyati,20,20,0,0,8
4885,sampayuttadhamme,sampayuttadhamme,119,116,3,0,16
4886,saṃpubba,sampubba,3,3,0,0,8
4887,dhā,dha,99,45,54,0,3
4888,sundaro,sundaro,166,156,10,0,7
4889,pasattho,pasattho,71,69,2,0,8
4890,susamādhi,susamadhi,1,1,0,0,9
4891,susamāhito,susamahito,68,64,4,0,10
4892,pabbatotiādīsu,pabbatotiadisu,1,1,0,0,14
4893,dhassa,dhassa,25,22,3,0,6
4894,ho,ho,62,50,12,0,2
4895,acalamāno,acalamano,2,2,0,0,9
4896,mahāmerupabbato,mahamerupabbato,1,1,0,0,15
4897,acalamānena,acalamanena,1,1,0,0,11
4898,samādhinā,samadhina,228,212,16,0,9
4899,manussadevabrahmasaṅkhātānaṃ,manussadevabrahmasankhatanam,1,1,0,0,28
4900,payojana,payojana,10,8,2,0,8
4901,dhārentaṃ,dharentam,14,14,0,0,9
4902,kāraṇānurūpaṃ,karananurupam,7,7,0,0,13
4903,hinoti,hinoti,65,65,0,0,6
4904,payojanaṃ,payojanam,491,471,20,0,9
4905,hidhātu,hidhatu,3,3,0,0,7
4906,hito,hito,68,64,4,0,4
4907,kitanta,kitanta,1,1,0,0,7
4908,hitadharanti,hitadharanti,1,1,0,0,12
4909,chandānurakkhaṇatthāya,chandanurakkhanatthaya,1,1,0,0,22
4910,uttara,uttara,55,47,8,0,6
4911,padalopena,padalopena,1,1,0,0,10
4912,hitanti,hitanti,25,25,0,0,7
4913,vattabbaṃ,vattabbam,3311,3178,133,0,9
4914,samajjanī,samajjani,1,1,0,0,9
4915,padīpoti,padipoti,6,3,3,0,8
4916,hiṃsadhātu,himsadhatu,2,2,0,0,10
4917,tapaccayo,tapaccayo,15,15,0,0,9
4918,byādhiyā,byadhiya,1,1,0,0,8
4919,osamaṃ,osamam,1,1,0,0,6
4920,rogīnaṃ,roginam,2,2,0,0,7
4921,dukkhahananato,dukkhahananato,1,1,0,0,14
4922,sukhaṃ,sukham,4258,3869,389,0,6
4923,vidadhātīti,vidadhatiti,2,2,0,0,11
4924,dhādhātu,dhadhatu,5,5,0,0,8
4925,dhāraṇe,dharane,88,78,10,0,7
4926,rudhiramaṃsādi,rudhiramamsadi,1,1,0,0,14
4927,vaḍḍhanaṃ,vaddhanam,70,68,2,0,9
4928,rasāyatanaṃ,rasayatanam,202,202,0,0,11
4929,kissānaṃ,kissanam,1,1,0,0,8
4930,sukhavahanato,sukhavahanato,1,1,0,0,13
4931,veneyyajanānaṃ,veneyyajananam,2,2,0,0,14
4932,dukkhāpanayanampi,dukkhapanayanampi,1,1,0,0,17
4933,ñāṇaparipācanampi,nanaparipacanampi,1,1,0,0,17
4934,lokiyalokuttarahitasukhaṃ,lokiyalokuttarahitasukham,2,2,0,0,25
4935,M0.0067,M0.0067,84,84,0,0,7
4936,buddhacakkhu,buddhacakkhu,33,24,9,0,12
4937,dhammacakkhu,dhammacakkhu,39,28,11,0,12
4938,ñāṇa,nana,40,35,5,0,4
4939,samantacakkhu,samantacakkhu,121,102,19,0,13
4940,dibbacakkhūti,dibbacakkhuti,16,10,6,0,13
4941,addasaṃ,addasam,424,408,16,0,7
4942,buddhacakkhunā,buddhacakkhuna,110,106,4,0,14
4943,volokentoti,volokentoti,1,1,0,0,11
4944,vītamalaṃ,vitamalam,96,76,20,0,9
4945,dhammacakkhunti,dhammacakkhunti,8,5,3,0,15
4946,heṭṭhimamaggatta,hetthimamaggatta,1,1,0,0,16
4947,yasaṅkhātaṃ,yasankhatam,1,1,0,0,11
4948,cakkhuṃ,cakkhum,1159,1087,72,0,7
4949,udapādīti,udapaditi,156,80,76,0,9
4950,ñāṇacakkhu,nanacakkhu,35,28,7,0,10
4951,sabbaññutañāṇanti,sabbannutanananti,3,3,0,0,17
4952,dibbena,dibbena,683,658,25,0,7
4953,cakkhunā,cakkhuna,1083,1021,62,0,8
4954,visuddhenāti,visuddhenati,5,1,4,0,12
4955,dibbacakkhu,dibbacakkhu,220,204,16,0,11
4956,passantaṃ,passantam,30,27,3,0,9
4957,sabbaññutañāṇavantanti,sabbannutananavantanti,1,1,0,0,22
4958,samantato,samantato,1062,1017,45,0,9
4959,cakkhati,cakkhati,22,21,1,0,8
4960,passatīti,passatiti,499,304,195,0,9
4961,cakkhadhātu,cakkhadhatu,1,1,0,0,11
4962,paṭisambhidāmagge,patisambhidamagge,86,45,41,0,17
4963,addiṭṭhamidhatthi,additthamidhatthi,14,10,4,0,17
4964,kiñci,kinci,5408,5113,295,0,5
4965,atho,atho,595,558,37,0,4
4966,aviññātamajānitabbaṃ,avinnatamajanitabbam,16,16,0,0,20
4967,abhiññāsi,abhinnasi,33,31,2,0,9
4968,yadatthi,yadatthi,66,53,13,0,8
4969,neyyaṃ,neyyam,192,175,17,0,6
4970,samantacakkhū,samantacakkhu,23,21,2,0,13
4971,addiṭṭhaṃ,addittham,2,2,0,0,9
4972,apassantaṃ,apassantam,9,8,1,0,10
4973,dhammajātaṃ,dhammajatam,115,111,4,0,11
4974,idhaloke,idhaloke,88,78,10,0,8
4975,aviññātaṃ,avinnatam,43,34,9,0,9
4976,aviditaṃ,aviditam,72,64,8,0,8
4977,apākaṭaṃ,apakatam,67,65,2,0,8
4978,ajānitabbaṃ,ajanitabbam,9,6,3,0,11
4979,ñātabbaṃ,natabbam,153,151,2,0,8
4980,amitanti,amitanti,3,3,0,0,8
4981,amitaṃ,amitam,25,22,3,0,6
4982,paṇamāmīti,panamamiti,2,1,1,0,10
4983,aparimeyyaṃ,aparimeyyam,3,3,0,0,11
4984,aparicchinnaṃ,aparicchinnam,10,9,1,0,13
4985,sīlasamādhi,silasamadhi,3,3,0,0,11
4986,paññādiguṇavantaṃ,pannadigunavantam,1,1,0,0,17
4987,amitabbaṃ,amitabbam,1,1,0,0,9
4988,aparicchinditabbanti,aparicchinditabbanti,1,1,0,0,20
4989,sīlādiguṇaṃ,siladigunam,6,6,0,0,11
4990,M0.0068,M0.0068,86,86,0,0,7
4991,sukaraṃ,sukaram,226,206,20,0,7
4992,udakassa,udakassa,322,319,3,0,8
4993,pamāṇaṃ,pamanam,1056,960,96,0,7
4994,gaṇetuṃ,ganetum,49,49,0,0,7
4995,ettakāni,ettakani,244,244,0,0,8
4996,udakāḷhakānīti,udakalhakaniti,5,5,0,0,14
4997,udakāḷhakasatānīti,udakalhakasataniti,5,5,0,0,18
4998,udakāḷhakasahassānīti,udakalhakasahassaniti,5,5,0,0,21
4999,udakāḷhakasatasahassānīti,udakalhakasatasahassaniti,4,4,0,0,25
5000,asaṅkhyeyyo,asankhyeyyo,25,25,0,0,11
5001,mahāudakakkhandhotveva,mahaudakakkhandhotveva,12,12,0,0,22
5002,saṅkhyaṃ,sankhyam,365,346,19,0,8
5003,sīlādiguṇassa,siladigunassa,1,1,0,0,13
5004,ettakaṃ,ettakam,1133,1077,56,0,7
5005,sīlaguṇaṃ,silagunam,7,6,1,0,9
5006,samādhiguṇo,samadhiguno,1,1,0,0,11
5007,paññāguṇātiādināti,pannagunatiadinati,1,1,0,0,18
5008,mahāguṇakkhandhotveva,mahagunakkhandhotveva,1,1,0,0,21
5009,tenavuttaṃ,tenavuttam,2,2,0,0,10
5010,buddhopi,buddhopi,56,55,1,0,8
5011,bhaṇeyya,bhaneyya,112,110,2,0,8
5012,kappampi,kappampi,29,28,1,0,8
5013,aññamabhāsamāno,annamabhasamano,24,23,1,0,15
5014,khīyetha,khiyetha,65,65,0,0,8
5015,kappo,kappo,267,248,19,0,5
5016,ciradīghamantare,ciradighamantare,24,23,1,0,16
5017,tathāgatānaṃ,tathagatanam,147,135,12,0,12
5018,nāmāni,namani,446,423,23,0,6
5019,saguṇena,sagunena,29,27,2,0,8
5020,nāmamuddheyyaṃ,namamuddheyyam,14,14,0,0,14
5021,api,api,2448,2162,286,0,3
5022,nāmasahassato,namasahassato,11,11,0,0,13
5023,tibhavasaṅkhātasamuddato,tibhavasankhatasamuddato,1,1,0,0,24
5024,kāmarūpa,kamarupa,4,4,0,0,8
5025,arūpasaṅkhātassa,arupasankhatassa,1,1,0,0,16
5026,tilokassa,tilokassa,12,11,1,0,9
5027,sundara,sundara,5,5,0,0,7
5028,samādhivantaṃ,samadhivantam,1,1,0,0,13
5029,lokiyalokuttarasaṅkhātaṃ,lokiyalokuttarasankhatam,3,3,0,0,24
5030,atthadhāraṇaṃ,atthadharanam,1,1,0,0,13
5031,sabbaññutañāṇavantaṃ,sabbannutananavantam,3,3,0,0,20
5032,sīlādiguṇavantaṃ,siladigunavantam,1,1,0,0,16
5033,aṭṭhamavandanagāthāvaṇṇanā,atthamavandanagathavannana,1,1,0,0,26
5034,M0.0069,M0.0069,85,85,0,0,7
5035,aṭṭhamagāthāya,atthamagathaya,5,5,0,0,14
5036,cayantyādīhi,cayantyadihi,1,1,0,0,12
5037,pāramisañcayaṃcayaṃ,paramisancayamcayam,1,0,1,0,19
5038,jatajara,jatajara,1,1,0,0,8
5039,gaṇehi,ganehi,12,12,0,0,6
5040,sabbapādādyantayamakā,sabbapadadyantayamaka,1,1,0,0,21
5041,bhave,bhave,2205,2109,96,0,5
5042,buddhavaraṃ,buddhavaram,7,7,0,0,11
5043,paṇidhānato,panidhanato,10,10,0,0,11
5044,attabhāvesu,attabhavesu,42,41,1,0,11
5045,dānādipā,danadipa,1,1,0,0,8
5046,ramīnaṃ,raminam,1,1,0,0,7
5047,pāramī,parami,102,89,13,0,6
5048,dānasīlanekkhammapaññā,danasilanekkhammapanna,1,1,0,0,22
5049,vīriya,viriya,22,22,0,0,6
5050,khantisaccaadhiṭṭhānamettāupekkhāvasena,khantisaccaadhitthanamettaupekkhavasena,1,1,0,0,39
5051,dasavidhā,dasavidha,64,59,5,0,9
5052,vuttañca,vuttanca,147,147,0,0,8
5053,buddhavaṃse,buddhavamse,19,12,7,0,11
5054,dānaṃ,danam,3618,3413,205,0,5
5055,nekkhammaṃ,nekkhammam,264,201,63,0,10
5056,vīriyena,viriyena,197,190,7,0,8
5057,khantisaccamadhiṭṭhānaṃ,khantisaccamadhitthanam,5,5,0,0,23
5058,mettupekkhāti,mettupekkhati,5,5,0,0,13
5059,pāramīsaddassa,paramisaddassa,4,4,0,0,14
5060,dānasīlādiguṇa,danasiladiguna,1,1,0,0,14
5061,visesayogena,visesayogena,1,1,0,0,12
5062,sattuttamatāya,sattuttamataya,5,5,0,0,14
5063,mahābodhisatto,mahabodhisatto,13,13,0,0,14
5064,paramo,paramo,141,132,9,0,6
5065,kammanti,kammanti,162,153,9,0,8
5066,dānādi,danadi,10,10,0,0,6
5067,kriyāva,kriyava,2,2,0,0,7
5068,santakabhāvakammataddhite,santakabhavakammataddhite,1,1,0,0,25
5069,itthiliṅgajotaka,itthilingajotaka,1,1,0,0,16
5070,īpaccayo,ipaccayo,17,17,0,0,8
5071,dānādīni,danadini,199,199,0,0,8
5072,dānādiguṇānaṃ,danadigunanam,4,4,0,0,13
5073,pālako,palako,14,14,0,0,6
5074,bodhisatto,bodhisatto,2152,2136,16,0,10
5075,amapaccayo,amapaccayo,1,1,0,0,10
5076,pare,pare,1224,1184,40,0,4
5077,mavati,mavati,14,14,0,0,6
5078,bandhati,bandhati,210,206,4,0,8
5079,guṇavisesayogenāti,gunavisesayogenati,2,2,0,0,18
5080,parasaddūpapada,parasaddupapada,4,4,0,0,15
5081,mudhātu,mudhatu,1,1,0,0,7
5082,bandhane,bandhane,145,119,26,0,8
5083,atirekaṃ,atirekam,199,185,14,0,8
5084,majjati,majjati,79,78,1,0,7
5085,kilesamalatoti,kilesamalatoti,2,2,0,0,14
5086,parasaddūpa,parasaddupa,2,2,0,0,11
5087,M0.0070,M0.0070,83,83,0,0,7
5088,majjadhātu,majjadhatu,1,1,0,0,10
5089,saṃsuddhiyaṃ,samsuddhiyam,6,4,2,0,12
5090,parasaddo,parasaddo,7,7,0,0,9
5091,atirekattho,atirekattho,12,12,0,0,11
5092,mayati,mayati,16,16,0,0,6
5093,mayadhātu,mayadhatu,1,1,0,0,9
5094,para,para,68,32,36,0,4
5095,seṭṭhattho,setthattho,1,1,0,0,10
5096,pamāṇabhūtena,pamanabhutena,5,5,0,0,13
5097,idhalokamiva,idhalokamiva,2,2,0,0,12
5098,paricchindatīti,paricchindatiti,21,20,1,0,15
5099,paricchindane,paricchindane,2,2,0,0,13
5100,ati,ati,97,77,20,0,3
5101,sīlādiguṇagaṇaṃ,siladigunaganam,5,5,0,0,15
5102,santāne,santane,534,521,13,0,7
5103,minoti,minoti,21,21,0,0,6
5104,pakkhipatīti,pakkhipatiti,13,8,5,0,12
5105,midhātu,midhatu,3,3,0,0,7
5106,pakkhipane,pakkhipane,4,4,0,0,10
5107,atirekavācako,atirekavacako,1,1,0,0,13
5108,attabhūtadhammakāyato,attabhutadhammakayato,1,1,0,0,21
5109,paṭipakkhaṃ,patipakkham,70,67,3,0,11
5110,tadanatthakaraṃ,tadanatthakaram,5,5,0,0,15
5111,kilesacoragaṇaṃ,kilesacoraganam,5,5,0,0,15
5112,mināti,minati,27,27,0,0,6
5113,aññavācako,annavacako,1,1,0,0,10
5114,paṭipakkhavācako,patipakkhavacako,1,1,0,0,16
5115,paramassa,paramassa,25,25,0,0,9
5116,ayantiādinā,ayantiadina,2,2,0,0,11
5117,pāramīti,paramiti,9,6,3,0,8
5118,pāre,pare,23,22,1,0,4
5119,sujjhatīti,sujjhatiti,21,14,7,0,10
5120,mahābodhi,mahabodhi,70,70,0,0,9
5121,pārasaddūpapada,parasaddupapada,3,3,0,0,15
5122,majadhātu,majadhatu,1,1,0,0,9
5123,ī,i,311,177,134,0,1
5124,sodhetīti,sodhetiti,29,21,8,0,9
5125,hetukattusādhanoyaṃ,hetukattusadhanoyam,1,1,0,0,19
5126,pārenibbāne,parenibbane,1,1,0,0,11
5127,yojetīti,yojetiti,20,20,0,0,8
5128,māyeti,mayeti,4,4,0,0,6
5129,gameti,gameti,165,160,5,0,6
5130,yāthāvato,yathavato,497,487,10,0,9
5131,dānādikriyā,danadikriya,6,6,0,0,11
5132,sotūnaṃ,sotunam,86,83,3,0,7
5133,niruttinayakosallatthaṃ,niruttinayakosallattham,1,1,0,0,23
5134,dasapāramī,dasaparami,9,9,0,0,10
5135,dasaupapāramī,dasaupaparami,1,1,0,0,13
5136,dasaparamatthapāramī,dasaparamatthaparami,1,1,0,0,20
5137,saviññāṇāviññāṇakaṃ,savinnanavinnanakam,1,1,0,0,19
5138,dhanaṃ,dhanam,1491,1429,62,0,6
5139,pariccāgaṃ,pariccagam,22,22,0,0,10
5140,M0.0071,M0.0071,83,83,0,0,7
5141,bodhisambhārā,bodhisambhara,15,15,0,0,13
5142,hattha,hattha,26,19,7,0,6
5143,pāda,pada,15,8,7,0,4
5144,kaṇṇa,kanna,9,7,2,0,5
5145,nāsādiaṅgapaccaṅgapariccāgaṃ,nasadiangapaccangapariccagam,1,1,0,0,28
5146,dasaupapāramiyo,dasaupaparamiyo,1,1,0,0,15
5147,jīvitindriyapariccāgaṃ,jivitindriyapariccagam,1,1,0,0,22
5148,paramatthapāramiyo,paramatthaparamiyo,21,19,2,0,18
5149,dānādipāramīnaṃ,danadiparaminam,14,14,0,0,15
5150,cariyapiṭakaaṭṭhakathādīsu,cariyapitakaatthakathadisu,1,1,0,0,26
5151,gahetabbo,gahetabbo,868,856,12,0,9
5152,saṅgahavasena,sangahavasena,18,18,0,0,13
5153,cayati,cayati,7,7,0,0,6
5154,cidhātu,cidhatu,4,4,0,0,7
5155,sañcinoti,sancinoti,2,2,0,0,9
5156,pāramīnaṃ,paraminam,81,77,4,0,9
5157,pāramisañcayo,paramisancayo,1,1,0,0,13
5158,cayanti,cayanti,2,2,0,0,7
5159,upacitaṃ,upacitam,76,66,10,0,8
5160,parisambhūtanti,parisambhutanti,1,1,0,0,15
5161,upacinātīti,upacinatiti,1,1,0,0,11
5162,ciyittha,ciyittha,1,1,0,0,8
5163,upaciyitthāti,upaciyitthati,1,1,0,0,13
5164,sabbhigatanti,sabbhigatanti,1,1,0,0,13
5165,sabbhīti,sabbhiti,15,10,5,0,8
5166,rāgādikilese,ragadikilese,6,6,0,0,12
5167,samenti,samenti,282,279,3,0,7
5168,upasamentīti,upasamentiti,1,1,0,0,12
5169,santā,santa,289,261,28,0,5
5170,sappurisā,sappurisa,156,148,8,0,9
5171,upasameta,upasameta,1,1,0,0,9
5172,antapaccayo,antapaccayo,6,6,0,0,11
5173,santehīti,santehiti,1,1,0,0,9
5174,smāhismiṃnaṃ,smahismimnam,7,5,2,0,12
5175,mhā,mha,49,39,10,0,3
5176,bhimhivāti,bhimhivati,1,1,0,0,10
5177,hivibhattiyā,hivibhattiya,1,1,0,0,12
5178,bhikāraṃ,bhikaram,1,1,0,0,8
5179,bhe,bhe,17,12,5,0,3
5180,bo,bo,54,39,15,0,2
5181,canteti,canteti,2,1,1,0,7
5182,bhakāre,bhakare,6,6,0,0,7
5183,sakāraṃ,sakaram,4,4,0,0,7
5184,bakārāgamaṃ,bakaragamam,1,1,0,0,11
5185,gatanti,gatanti,58,56,2,0,7
5186,avuttakattā,avuttakatta,2,2,0,0,11
5187,upagamitabbaṃ,upagamitabbam,2,2,0,0,13
5188,devamanussehi,devamanussehi,91,84,7,0,13
5189,gamiyati,gamiyati,3,3,0,0,8
5190,upagamiyati,upagamiyati,1,1,0,0,11
5191,upasaṅkamiyatīti,upasankamiyatiti,1,1,0,0,16
5192,atthakāmehi,atthakamehi,8,8,0,0,11
5193,sīlādianantaguṇikattā,siladianantagunikatta,1,1,0,0,21
5194,abhimānā,abhimana,2,2,0,0,8
5195,payirupāsitabboti,payirupasitabboti,3,1,2,0,17
5196,accantasukhassa,accantasukhassa,2,2,0,0,15
5197,sukhanaṃ,sukhanam,12,10,2,0,8
5198,pajjati,pajjati,59,58,1,0,7
5199,buddhādīhi,buddhadihi,126,121,5,0,10
5200,ariyehi,ariyehi,126,124,2,0,7
5201,pajjiyati,pajjiyati,1,1,0,0,9
5202,gamiyatīti,gamiyatiti,3,3,0,0,10
5203,padanti,padanti,71,70,1,0,7
5204,agaminti,agaminti,4,4,0,0,8
5205,gato,gato,2734,2677,57,0,4
5206,dukkhādiasammissassa,dukkhadiasammissassa,1,1,0,0,20
5207,ekantasukhassa,ekantasukhassa,24,24,0,0,14
5208,apāpuṇinti,apapuninti,1,1,0,0,10
5209,M0.0072,M0.0072,84,84,0,0,7
5210,naraanarānanti,naraanarananti,1,1,0,0,14
5211,manussadevānanti,manussadevananti,1,1,0,0,16
5212,pabbajjādiseṭṭhabhāvaṃ,pabbajjadisetthabhavam,1,1,0,0,22
5213,narati,narati,12,12,0,0,6
5214,narīyati,nariyati,1,1,0,0,8
5215,sakena,sakena,183,170,13,0,6
5216,niyatīti,niyatiti,6,2,4,0,8
5217,naradhātu,naradhatu,4,4,0,0,9
5218,anaro,anaro,2,2,0,0,5
5219,narānaro,naranaro,1,1,0,0,8
5220,sukhasambhavanti,sukhasambhavanti,1,1,0,0,16
5221,lokiyalokuttarasukhassa,lokiyalokuttarasukhassa,4,4,0,0,23
5222,tividhasukhassa,tividhasukhassa,1,1,0,0,15
5223,labhanakāraṇabhūtaṃ,labhanakaranabhutam,3,3,0,0,19
5224,sukhayatīti,sukhayatiti,36,36,0,0,11
5225,tividhasukhaṃ,tividhasukham,1,1,0,0,13
5226,sukhitaṃ,sukhitam,54,46,8,0,8
5227,suṭṭhu,sutthu,2136,2026,110,0,6
5228,khanatīti,khanatiti,22,19,3,0,9
5229,supubbakhanudhātu,supubbakhanudhatu,1,1,0,0,17
5230,avadhāraṇe,avadharane,111,102,9,0,10
5231,sambhavati,sambhavati,644,635,9,0,10
5232,sukhasaṅkhātaṃ,sukhasankhatam,1,1,0,0,14
5233,anena,anena,225,218,7,0,5
5234,puññenāti,punnenati,7,2,5,0,9
5235,sambhavaṃ,sambhavam,191,163,28,0,9
5236,puññakaraṇaṃ,punnakaranam,2,2,0,0,12
5237,saṃpubbabhūdhātu,sampubbabhudhatu,1,1,0,0,16
5238,sattāyaṃṇa,sattayamna,1,1,0,0,10
5239,sukhassa,sukhassa,529,506,23,0,8
5240,bhavantipade,bhavantipade,1,1,0,0,12
5241,nibbattentaṃ,nibbattentam,9,9,0,0,12
5242,bhāveti,bhaveti,1944,1906,38,0,7
5243,mahākaruṇāpubbaṅgamāya,mahakarunapubbangamaya,1,1,0,0,22
5244,dānasīlabhāvanāsaṅkhātaṃ,danasilabhavanasankhatam,1,1,0,0,24
5245,kāreti,kareti,315,310,5,0,6
5246,anamānanti,anamananti,2,2,0,0,10
5247,ekārādesoti,ekaradesoti,1,1,0,0,11
5248,anamentānaṃ,anamentanam,1,1,0,0,11
5249,avandantānaṃ,avandantanam,3,3,0,0,12
5250,anādarānanti,anadarananti,1,1,0,0,12
5251,gavantietassa,gavantietassa,1,1,0,0,13
5252,goṇasadisānaṃ,gonasadisanam,2,2,0,0,13
5253,bālānaṃ,balanam,144,130,14,0,7
5254,gavanti,gavanti,1,1,0,0,7
5255,chaṭṭhībahuvacanantanāmapadaṃ,chatthibahuvacanantanamapadam,1,1,0,0,29
5256,namaṃ,namam,7,5,2,0,5
5257,patimhālutte,patimhalutte,3,2,1,0,12
5258,samāseti,samaseti,9,9,0,0,8
5259,sutte,sutte,1289,1208,81,0,5
5260,samabhiniviṭṭhena,samabhinivitthena,2,2,0,0,17
5261,caggahaṇena,caggahanena,38,8,30,0,11
5262,naṃvacanassa,namvacanassa,27,27,0,0,12
5263,aṃ,am,191,113,78,0,2
5264,ādesañca,adesanca,1,1,0,0,8
5265,goiccetassa,goiccetassa,1,1,0,0,11
5266,avādesaṃ,avadesam,1,1,0,0,8
5267,rūpasiddhi,rupasiddhi,14,14,0,0,10
5268,gacchantīti,gacchantiti,356,284,72,0,11
5269,gāvo,gavo,414,399,15,0,4
5270,goṇā,gona,90,84,6,0,4
5271,jinapuṅgavantipade,jinapungavantipade,1,1,0,0,18
5272,chaṭṭhīkammaṃ,chatthikammam,2,2,0,0,13
5273,jayantapurisuttamaṃ,jayantapurisuttamam,2,2,0,0,19
5274,puṅgava,pungava,3,2,1,0,7
5275,M0.0073,M0.0073,83,83,0,0,7
5276,kammadhārayasamāse,kammadharayasamase,8,8,0,0,18
5277,seṭṭhatthavācako,setthatthavacako,1,1,0,0,16
5278,munipuṅgavotiādīsu,munipungavotiadisu,1,1,0,0,18
5279,amarakose,amarakose,37,5,32,0,9
5280,uttarasmiṃ,uttarasmim,7,7,0,0,10
5281,byaggha,byaggha,9,8,1,0,7
5282,puṅgavosabhakuñjarā,pungavosabhakunjara,1,1,0,0,19
5283,sīhasaddūlanāgādyā,sihasaddulanagadya,4,4,0,0,18
5284,pume,pume,215,204,11,0,4
5285,seṭṭhatthagocarā,setthatthagocara,4,4,0,0,16
5286,uttarapade,uttarapade,81,80,1,0,10
5287,byagghapuṅgavosabhakuñjarā,byagghapungavosabhakunjara,2,2,0,0,26
5288,byagghapuṅgavausabhakuñjarasaddā,byagghapungavausabhakunjarasadda,1,1,0,0,32
5289,sīha,siha,138,130,8,0,4
5290,saddūlanāgādyā,saddulanagadya,1,1,0,0,14
5291,saddūla,saddula,1,1,0,0,7
5292,nāgāsaddā,nagasadda,1,1,0,0,9
5293,seṭṭhattha,setthattha,1,1,0,0,10
5294,vācakāti,vacakati,3,3,0,0,8
5295,ajānante,ajanante,11,11,0,0,8
5296,anamante,anamante,1,1,0,0,8
5297,aññadiṭṭhike,annaditthike,1,1,0,0,12
5298,bāle,bale,116,106,10,0,4
5299,ajinīti,ajiniti,10,8,2,0,7
5300,pakaṭṭhabhāvaṃ,pakatthabhavam,3,3,0,0,14
5301,padhānabhāvaṃ,padhanabhavam,47,47,0,0,13
5302,puṅgavo,pungavo,38,35,3,0,7
5303,paupubba,paupubba,1,1,0,0,8
5304,avapaccayo,avapaccayo,1,1,0,0,10
5305,niggahitā,niggahita,13,13,0,0,9
5306,gamo,gamo,58,58,0,0,4
5307,kavaggantaṃ,kavaggantam,1,1,0,0,11
5308,dhātvantalopañca,dhatvantalopanca,1,1,0,0,16
5309,yadādinā,yadadina,27,27,0,0,8
5310,jinapuṅgavo,jinapungavo,1,1,0,0,11
5311,gunnaṃ,gunnam,237,232,5,0,6
5312,buddhānaṃ,buddhanam,1306,1243,63,0,9
5313,sīlādike,siladike,8,8,0,0,8
5314,appameyyaguṇe,appameyyagune,1,1,0,0,13
5315,ajānantānaṃ,ajanantanam,79,75,4,0,11
5316,anamantānaṃ,anamantanam,2,2,0,0,11
5317,agāravantānaṃ,agaravantanam,1,1,0,0,13
5318,añña,anna,43,24,19,0,4
5319,diṭṭhigatikānaṃ,ditthigatikanam,43,43,0,0,15
5320,asatthena,asatthena,42,41,1,0,9
5321,jinapuṅgavanti,jinapungavanti,1,1,0,0,14
5322,parisambhūtaṃ,parisambhutam,1,1,0,0,13
5323,payirupāsitabbaṃ,payirupasitabbam,1,1,0,0,16
5324,patiṭṭhāna,patitthana,3,3,0,0,10
5325,agamiṃ,agamim,13,13,0,0,6
5326,manussadevānaṃ,manussadevanam,9,9,0,0,14
5327,tividha,tividha,16,13,3,0,7
5328,anamānaṃ,anamanam,1,1,0,0,8
5329,anādarānaṃ,anadaranam,1,1,0,0,10
5330,navamavandanagāthāvaṇṇanā,navamavandanagathavannana,1,1,0,0,25
5331,M0.0074,M0.0074,82,82,0,0,7
5332,navamagāthāya,navamagathaya,4,4,0,0,13
5333,tibhavasaṅkhātā,tibhavasankhata,2,2,0,0,15
5334,saṃsārasamuddato,samsarasamuddato,4,4,0,0,16
5335,tārentena,tarentena,1,1,0,0,9
5336,dukkhappahānena,dukkhappahanena,1,1,0,0,15
5337,vanditu,vanditu,4,4,0,0,7
5338,kāmo,kamo,304,280,24,0,4
5339,tata,tata,6,6,0,0,4
5340,jara,jara,41,20,21,0,4
5341,racitattā,racitatta,16,16,0,0,9
5342,indavaṃsa,indavamsa,1,1,0,0,9
5343,sāyindavaṃsā,sayindavamsa,1,1,0,0,12
5344,khalu,khalu,320,302,18,0,5
5345,yattha,yattha,7536,7191,345,0,6
5346,tagaṇadvayañca,taganadvayanca,1,1,0,0,14
5347,ragaṇā,ragana,3,3,0,0,6
5348,siyuṃ,siyum,632,591,41,0,5
5349,ekantaṃ,ekantam,120,116,4,0,7
5350,indavaṃsagāthā,indavamsagatha,1,1,0,0,14
5351,munidakkhanāvikoti,munidakkhanavikoti,1,1,0,0,18
5352,buddha,buddha,71,61,10,0,6
5353,cheko,cheko,226,222,4,0,5
5354,nāvājeṭṭhakoti,navajetthakoti,1,1,0,0,14
5355,munīti,muniti,107,26,81,0,6
5356,monaṃ,monam,60,48,12,0,5
5357,ipaccayo,ipaccayo,5,5,0,0,8
5358,ekanipāte,ekanipate,4,4,0,0,9
5359,vaṇṇapathajātakaṭṭhakathāyaṃ,vannapathajatakatthakathayam,1,0,1,0,28
5360,kāya,kaya,384,359,25,0,4
5361,moneyyādīsu,moneyyadisu,1,1,0,0,11
5362,aññatarena,annatarena,334,323,11,0,10
5363,samannāgatattā,samannagatatta,321,318,3,0,14
5364,anagāriyamuni,anagariyamuni,8,8,0,0,13
5365,sekkhamuni,sekkhamuni,11,11,0,0,10
5366,asekkhamuni,asekkhamuni,9,9,0,0,11
5367,gihi,gihi,39,38,1,0,4
5368,anagāriyamunīti,anagariyamuniti,3,1,2,0,15
5369,sekkhamunīti,sekkhamuniti,3,1,2,0,12
5370,sattasekkhā,sattasekkha,2,2,0,0,11
5371,asekkhamunīti,asekkhamuniti,3,1,2,0,13
5372,paccekasambuddho,paccekasambuddho,196,195,1,0,16
5373,dakkhoti,dakkhoti,20,2,18,0,8
5374,M0.0075,M0.0075,83,83,0,0,7
5375,samuddataraṇe,samuddatarane,2,2,0,0,13
5376,dakkhati,dakkhati,90,86,4,0,8
5377,kusalattaṃ,kusalattam,2,2,0,0,10
5378,dakkhadhātu,dakkhadhatu,4,4,0,0,11
5379,kusalakamme,kusalakamme,12,11,1,0,11
5380,aññasmiñca,annasminca,11,11,0,0,10
5381,kiccākicce,kiccakicce,6,5,1,0,10
5382,adandhatāya,adandhataya,3,3,0,0,11
5383,yokoci,yokoci,22,21,1,0,6
5384,kusalo,kusalo,1961,1873,88,0,6
5385,sīghatthe,sighatthe,7,7,0,0,9
5386,nītatthena,nitatthena,5,5,0,0,10
5387,uddhāraṇassa,uddharanassa,1,1,0,0,12
5388,ñāṇenāti,nanenati,28,3,25,0,8
5389,nāvikoti,navikoti,2,1,1,0,8
5390,samuddatīraṃ,samuddatiram,15,15,0,0,12
5391,taratīti,taratiti,30,24,6,0,8
5392,nāvājeṭṭhako,navajetthako,2,2,0,0,12
5393,taratitaddhite,taratitaddhite,1,1,0,0,14
5394,ṇiko,niko,86,82,4,0,4
5395,aṭṭhamaggaṅganāvāya,atthamagganganavaya,4,4,0,0,19
5396,dakkhanāviko,dakkhanaviko,2,2,0,0,12
5397,dakkhanāvikocāti,dakkhanavikocati,1,1,0,0,16
5398,kammadhārayasamāsoyaṃ,kammadharayasamasoyam,2,2,0,0,21
5399,upamākammadhārayasamāsoyaṃ,upamakammadharayasamasoyam,1,1,0,0,26
5400,manusse,manusse,505,495,10,0,7
5401,samuddapāraṃ,samuddaparam,3,3,0,0,12
5402,āruyhāti,aruyhati,5,3,2,0,8
5403,aṭṭhamaggaṅga,atthamagganga,2,2,0,0,13
5404,nāvaṃ,navam,373,352,21,0,5
5405,ārohitvāti,arohitvati,1,1,0,0,10
5406,mārento,marento,68,67,1,0,7
5407,mārasaddūpapada,marasaddupapada,2,2,0,0,15
5408,mārenta,marenta,2,2,0,0,7
5409,goti,goti,16,11,5,0,4
5410,maggoti,maggoti,232,155,77,0,7
5411,maggati,maggati,28,28,0,0,7
5412,gavesatīti,gavesatiti,27,23,4,0,10
5413,maggadhātu,maggadhatu,4,4,0,0,10
5414,nibbānatthikehi,nibbanatthikehi,42,41,1,0,15
5415,maggiyati,maggiyati,6,6,0,0,9
5416,gavesiyatīti,gavesiyatiti,3,3,0,0,12
5417,ekantato,ekantato,219,216,3,0,8
5418,jarābyādhimaraṇadukkhādīhi,jarabyadhimaranadukkhadihi,1,1,0,0,26
5419,pīḷitehi,pilitehi,3,3,0,0,8
5420,sattehi,sattehi,98,98,0,0,7
5421,dukkhakkhayaṃ,dukkhakkhayam,7,6,1,0,13
5422,pāpuṇatthāya,papunatthaya,2,2,0,0,12
5423,maggitabbo,maggitabbo,14,13,1,0,10
5424,catumaggo,catumaggo,1,1,0,0,9
5425,magganaṭṭhena,magganatthena,6,6,0,0,13
5426,magganīyaṭṭhena,magganiyatthena,7,7,0,0,15
5427,aṅgati,angati,26,23,3,0,6
5428,phalanibbānaṃ,phalanibbanam,2,2,0,0,13
5429,agidhātu,agidhatu,3,3,0,0,8
5430,maggassa,maggassa,1212,1176,36,0,8
5431,kāraṇanti,karananti,263,259,4,0,9
5432,maggaṅgaṃ,maggangam,177,168,9,0,9
5433,sammādiṭṭhi,sammaditthi,1069,1018,51,0,11
5434,sammāsaṅkappa,sammasankappa,2,1,1,0,13
5435,sammāvācā,sammavaca,299,278,21,0,9
5436,sammākammanta,sammakammanta,4,2,2,0,13
5437,sammāājīva,sammaajiva,2,1,1,0,10
5438,sammāvāyāma,sammavayama,2,1,1,0,11
5439,M0.0076,M0.0076,81,81,0,0,7
5440,sammāsamādhivasena,sammasamadhivasena,2,2,0,0,18
5441,aṭṭhamaggaṅgaṃ,atthamaggangam,1,1,0,0,14
5442,nuyati,nuyati,1,1,0,0,6
5443,thavīyatīti,thaviyatiti,6,6,0,0,11
5444,nāvā,nava,308,285,23,0,4
5445,nudhātu,nudhatu,1,1,0,0,7
5446,thaviyaṃ,thaviyam,1,1,0,0,8
5447,avo,avo,28,27,1,0,3
5448,orato,orato,176,167,9,0,5
5449,bhāraṃ,bharam,231,205,26,0,6
5450,nayanti,nayanti,84,76,8,0,7
5451,maggaṅgasaṅkhātā,maggangasankhata,1,1,0,0,16
5452,maggaṅganāvā,magganganava,1,1,0,0,12
5453,maggaṅganti,magganganti,5,5,0,0,11
5454,maggaṅga,magganga,7,7,0,0,8
5455,āruḷhe,arulhe,27,27,0,0,6
5456,samudda,samudda,8,7,1,0,7
5457,nadīpāraṃ,nadiparam,31,20,11,0,9
5458,aṭṭhamaggaṅgadhammā,atthamaggangadhamma,1,1,0,0,19
5459,paṭipajjante,patipajjante,6,6,0,0,12
5460,nentīti,nentiti,12,10,2,0,7
5461,vīriyasaṅkhātaṃ,viriyasankhatam,3,3,0,0,15
5462,dabbisārakaṃ,dabbisarakam,3,3,0,0,12
5463,suttani,suttani,1,0,1,0,7
5464,pātaaṭṭhakathāyaṃ,pataatthakathayam,1,0,1,0,17
5465,phiyenāti,phiyenati,3,1,2,0,9
5466,dabbisārakenā,dabbisarakena,1,1,0,0,13
5467,īhati,ihati,17,16,1,0,5
5468,ārabbhatīti,arabbhatiti,1,1,0,0,11
5469,īhā,iha,24,20,4,0,3
5470,vāyamati,vayamati,346,339,7,0,8
5471,cetayati,cetayati,12,11,1,0,8
5472,vīriyaṃ,viriyam,1574,1447,127,0,7
5473,īha,iha,4,2,2,0,3
5474,cetāyaṃ,cetayam,6,3,3,0,7
5475,phāti,phati,11,9,2,0,5
5476,vaḍḍheti,vaddheti,124,122,2,0,8
5477,phiyaṃ,phiyam,5,5,0,0,6
5478,phādhātu,phadhatu,2,2,0,0,8
5479,vaḍḍhiyaṃ,vaddhiyam,8,8,0,0,9
5480,iyo,iyo,36,35,1,0,3
5481,ghaṭṭeti,ghatteti,81,81,0,0,8
5482,udakanti,udakanti,18,17,1,0,8
5483,phāyati,phayati,4,4,0,0,7
5484,phāyi,phayi,2,1,1,0,5
5485,īhāsaṅkhātaṃ,ihasankhatam,1,1,0,0,12
5486,phiyanti,phiyanti,1,1,0,0,8
5487,īhāti,ihati,1,1,0,0,5
5488,phiyena,phiyena,5,5,0,0,7
5489,icchitaṭṭhānaṃ,icchitatthanam,42,42,0,0,14
5490,īhāsaṅkhātena,ihasankhatena,1,1,0,0,13
5491,gāhakoti,gahakoti,2,1,1,0,8
5492,ñāṇakarenāti,nanakarenati,1,0,1,0,12
5493,sabbaññutañāṇasaṅkhātena,sabbannutananasankhatena,2,2,0,0,24
5494,hatthena,hatthena,931,914,17,0,8
5495,hattho,hattho,152,135,17,0,6
5496,ñāṇasaṅkhāto,nanasankhato,2,2,0,0,12
5497,ñāṇakaro,nanakaro,1,1,0,0,8
5498,daḷhagaṇhamāno,dalhaganhamano,1,1,0,0,14
5499,tāyāti,tayati,28,10,18,0,6
5500,saṅkhātāya,sankhataya,13,13,0,0,10
5501,bahūti,bahuti,39,20,19,0,6
5502,aneke,aneke,257,248,9,0,5
5503,saṃsāravaṭṭasaṅkhātā,samsaravattasankhata,1,1,0,0,20
5504,mahāsamuddato,mahasamuddato,13,12,1,0,13
5505,tāresīti,taresiti,4,1,3,0,8
5506,otiṇṇesi,otinnesi,1,1,0,0,8
5507,atikkamesīti,atikkamesiti,1,1,0,0,12
5508,paṭividdhacatusaccadhammaṃ,patividdhacatusaccadhammam,3,3,0,0,26
5509,aghappahaṃ,aghappaham,3,1,2,0,10
5510,dukkhappaja,dukkhappaja,1,1,0,0,11
5511,hantaṃ,hantam,1,1,0,0,6
5512,M0.0077,M0.0077,83,83,0,0,7
5513,dukkhaviddhaṃsentanti,dukkhaviddhamsentanti,1,1,0,0,21
5514,aghappahanti,aghappahanti,1,1,0,0,12
5515,kilesappajahantaṃ,kilesappajahantam,1,1,0,0,17
5516,kilesaviddhaṃsentanti,kilesaviddhamsentanti,1,1,0,0,21
5517,aghasaddo,aghasaddo,1,1,0,0,9
5518,dukkhe,dukkhe,477,430,47,0,6
5519,aghayati,aghayati,3,3,0,0,8
5520,aghanti,aghanti,7,7,0,0,7
5521,dukkhākārena,dukkhakarena,6,5,1,0,12
5522,kileso,kileso,461,453,8,0,6
5523,aghayanti,aghayanti,3,3,0,0,9
5524,aghoti,aghoti,3,1,2,0,6
5525,aghadhātu,aghadhatu,1,1,0,0,9
5526,pāpakaraṇe,papakarane,45,40,5,0,10
5527,aghaṃ,agham,75,52,23,0,5
5528,aghappaho,aghappaho,1,1,0,0,9
5529,aghasaddūpapadapapubbahādhātu,aghasaddupapadapapubbahadhatu,1,1,0,0,29
5530,veneyyasattānaṃ,veneyyasattanam,16,16,0,0,15
5531,kilesañca,kilesanca,34,32,2,0,9
5532,apanetīti,apanetiti,34,34,0,0,9
5533,paṭhamavikappe,pathamavikappe,23,23,0,0,14
5534,dukkhassa,dukkhassa,1268,1171,97,0,9
5535,appahātabbadhammattā,appahatabbadhammatta,1,1,0,0,20
5536,appahātabbampi,appahatabbampi,3,3,0,0,14
5537,dukkhappajahantanti,dukkhappajahantanti,1,1,0,0,19
5538,munidakkhanāvikaṃ,munidakkhanavikam,2,2,0,0,17
5539,buddhasaṅkhāto,buddhasankhato,1,1,0,0,14
5540,aṭṭhamaggaṅgasaṅkhātaṃ,atthamaggangasankhatam,1,1,0,0,22
5541,ārohitvā,arohitva,37,36,1,0,8
5542,gaṇhamāno,ganhamano,9,9,0,0,9
5543,tibhavasaṅkhātamahāsamuddato,tibhavasankhatamahasamuddato,1,1,0,0,28
5544,dukkhaviddhaṃsentaṃ,dukkhaviddhamsentam,1,1,0,0,19
5545,kilesa,kilesa,39,37,2,0,6
5546,viddhaṃsentaṃ,viddhamsentam,4,4,0,0,13
5547,dasamavandanagāthāvaṇṇanā,dasamavandanagathavannana,1,1,0,0,25
5548,M0.0078,M0.0078,78,78,0,0,7
5549,dasamagāthāya,dasamagathaya,2,2,0,0,13
5550,samatiṃ,samatim,3,3,0,0,7
5551,satipāramisambharaṇādīhi,satiparamisambharanadihi,1,1,0,0,24
5552,sagaṇehi,saganehi,2,2,0,0,8
5553,toṭakagāthāti,totakagathati,2,2,0,0,13
5554,iha,iha,189,166,23,0,3
5555,toṭaka,totaka,3,2,1,0,6
5556,mambudhisehi,mambudhisehi,1,1,0,0,12
5557,mitaṃ,mitam,63,55,8,0,5
5558,ambudhisehi,ambudhisehi,1,1,0,0,11
5559,pamitaṃ,pamitam,2,2,0,0,7
5560,racitaṃ,racitam,25,24,1,0,7
5561,jagatichande,jagatichande,1,1,0,0,12
5562,toṭakaṃ,totakam,1,1,0,0,7
5563,sambhūtaṃ,sambhutam,71,67,4,0,9
5564,paripūritanti,paripuritanti,1,1,0,0,13
5565,tāsaṃ,tasam,1909,1849,60,0,5
5566,viseso,viseso,1708,1656,52,0,6
5567,pāramisaddassa,paramisaddassa,1,1,0,0,14
5568,sambharittha,sambharittha,1,1,0,0,12
5569,paripūrayitthāti,paripurayitthati,1,1,0,0,16
5570,sambharaṇo,sambharano,1,1,0,0,10
5571,saṃpubbabharadhātu,sampubbabharadhatu,1,1,0,0,18
5572,pūraṇe,purane,43,36,7,0,6
5573,sambharaṇoti,sambharanoti,1,1,0,0,12
5574,samatiṃsatipāramisambharaṇo,samatimsatiparamisambharano,1,1,0,0,27
5575,dīpaṅkarabuddhassa,dipankarabuddhassa,3,3,0,0,18
5576,laddhabyākaraṇato,laddhabyakaranato,3,3,0,0,17
5577,pūrayitthāti,purayitthati,1,1,0,0,12
5578,varabodhidumeti,varabodhidumeti,1,0,1,0,15
5579,uttamabodhirukkhamūle,uttamabodhirukkhamule,2,2,0,0,21
5580,varabodhisaddassa,varabodhisaddassa,1,1,0,0,17
5581,davati,davati,13,13,0,0,6
5582,mūlakhandhatacasākha,mulakhandhatacasakha,1,1,0,0,20
5583,viṭapa,vitapa,3,3,0,0,6
5584,pallava,pallava,5,3,2,0,7
5585,phalehi,phalehi,64,62,2,0,7
5586,vuḍḍhiṃ,vuddhim,99,93,6,0,7
5587,virūḷiṃ,virulim,5,5,0,0,7
5588,vepullaṃ,vepullam,289,260,29,0,8
5589,rajata,rajata,10,7,3,0,6
5590,suvaṇṇamaṇi,suvannamani,2,2,0,0,11
5591,rucīhi,rucihi,1,1,0,0,6
5592,atisobhanaṃ,atisobhanam,1,1,0,0,11
5593,dumo,dumo,33,29,4,0,4
5594,vijātadivaseyeva,vijatadivaseyeva,1,1,0,0,16
5595,bodhisattena,bodhisattena,137,134,3,0,12
5596,satahatthubbedho,satahatthubbedho,1,1,0,0,16
5597,asatthadumarājā,asatthadumaraja,1,1,0,0,15
5598,dudhātu,dudhatu,1,1,0,0,7
5599,amo,amo,6,6,0,0,3
5600,apadānaṭṭhakathāyaṃ,apadanatthakathayam,4,1,3,0,19
5601,dunāti,dunati,3,3,0,0,6
5602,dumati,dumati,1,1,0,0,6
5603,ākāsatalanti,akasatalanti,2,2,0,0,12
5604,varabodhidumo,varabodhidumo,1,1,0,0,13
5605,maggañāṇena,maggananena,67,67,0,0,11
5606,paṭivijjhitaṃ,pativijjhitam,3,3,0,0,13
5607,saccasaddo,saccasaddo,8,7,1,0,10
5608,anekesvatthesu,anekesvatthesu,2,2,0,0,14
5609,M0.0079,M0.0079,83,83,0,0,7
5610,kujjheyyātiādīsu,kujjheyyatiadisu,1,1,0,0,16
5611,vācāsacce,vacasacce,9,8,1,0,9
5612,sacce,sacce,145,125,20,0,5
5613,samaṇabrāhmaṇātiādīsu,samanabrahmanatiadisu,2,2,0,0,21
5614,viratisacce,viratisacce,10,9,1,0,11
5615,nānā,nana,396,364,32,0,4
5616,pavādiyāse,pavadiyase,13,11,2,0,10
5617,kusalāvadānātiādīsu,kusalavadanatiadisu,1,1,0,0,19
5618,diṭṭhisacce,ditthisacce,8,7,1,0,11
5619,ekañhi,ekanhi,27,23,4,0,6
5620,dutiyamatthītiādīsu,dutiyamatthitiadisu,1,1,0,0,19
5621,paramatthasacce,paramatthasacce,10,10,0,0,15
5622,magge,magge,1017,979,38,0,5
5623,saccānaṃ,saccanam,247,225,22,0,8
5624,kati,kati,1513,1421,92,0,4
5625,kusalātiādīsu,kusalatiadisu,2,1,1,0,13
5626,ariyasacce,ariyasacce,31,31,0,0,10
5627,svāyamidhāpi,svayamidhapi,13,13,0,0,12
5628,vattatīti,vattatiti,351,305,46,0,9
5629,sathanaṃ,sathanam,1,1,0,0,8
5630,avitathaṃ,avitatham,68,59,9,0,9
5631,sathadhātu,sathadhatu,1,1,0,0,10
5632,avitathe,avitathe,2,2,0,0,8
5633,aggīnaṃ,agginam,15,15,0,0,7
5634,sabhāvo,sabhavo,393,370,23,0,7
5635,uṇhoyeva,unhoyeva,1,1,0,0,8
5636,sītalo,sitalo,31,30,1,0,6
5637,dukkhādīnaṃ,dukkhadinam,49,47,2,0,11
5638,pīḷanādi,pilanadi,1,1,0,0,8
5639,sabhāvaṃ,sabhavam,215,197,18,0,8
5640,tathaṃ,tatham,142,123,19,0,6
5641,anaññathaṃ,anannatham,14,10,4,0,10
5642,dukkhasaccaṃ,dukkhasaccam,846,803,43,0,12
5643,samudayasaccaṃ,samudayasaccam,741,722,19,0,14
5644,nirodhasaccaṃ,nirodhasaccam,273,262,11,0,13
5645,maggasaccañcāti,maggasaccancati,1,1,0,0,15
5646,dukkhasaccanti,dukkhasaccanti,47,46,1,0,14
5647,dukkhacchitaṃ,dukkhacchitam,1,1,0,0,13
5648,khaṃ,kham,61,39,22,0,4
5649,tucchanti,tucchanti,3,3,0,0,9
5650,saccavibhaṅgaṭṭhakathāyaṃ,saccavibhangatthakathayam,1,0,1,0,25
5651,duiti,duiti,5,5,0,0,5
5652,ayaṃsaddo,ayamsaddo,11,11,0,0,9
5653,kucchite,kucchite,38,35,3,0,8
5654,kucchitañhi,kucchitanhi,4,4,0,0,11
5655,puttaṃ,puttam,1243,1212,31,0,6
5656,duputtoti,duputtoti,3,3,0,0,9
5657,khaṃsaddo,khamsaddo,1,1,0,0,9
5658,tucche,tucche,8,8,0,0,6
5659,tucchañhi,tucchanhi,4,4,0,0,9
5660,khanti,khanti,252,220,32,0,6
5661,idañca,idanca,937,900,37,0,6
5662,paṭhamasaccaṃ,pathamasaccam,12,12,0,0,13
5663,anekaupaddavādhiṭṭhānato,anekaupaddavadhitthanato,4,4,0,0,24
5664,tucchaṃbālajanaparikappitadhuvasubhasukhattabhāvavirahitato,tucchambalajanaparikappitadhuvasubhasukhattabhavavirahitato,1,1,0,0,59
5665,kucchitattā,kucchitatta,11,11,0,0,11
5666,tucchattā,tucchatta,13,13,0,0,9
5667,dukkhanti,dukkhanti,376,348,28,0,9
5668,saccañcāti,saccancati,7,7,0,0,10
5669,tebhūmikavaṭṭaṃ,tebhumikavattam,2,2,0,0,15
5670,samudayasaccanti,samudayasaccanti,33,33,0,0,16
5671,ayati,ayati,39,39,0,0,5
5672,dukkhaphalaṃ,dukkhaphalam,2,2,0,0,12
5673,lobho,lobho,849,796,53,0,5
5674,ayadhātu,ayadhatu,4,4,0,0,8
5675,avasesa,avasesa,7,7,0,0,7
5676,paccayasaṃyoge,paccayasamyoge,3,3,0,0,14
5677,dukkhuppattiyā,dukkhuppattiya,16,16,0,0,14
5678,kāraṇoti,karanoti,1,1,0,0,8
5679,samudayo,samudayo,927,882,45,0,8
5680,vutteñhetaṃ,vuttenhetam,2,2,0,0,11
5681,sacca,sacca,37,25,12,0,5
5682,vibhaṅgaṭṭhakathāyaṃ,vibhangatthakathayam,14,5,9,0,20
5683,saṃiti,samiti,3,3,0,0,6
5684,samāgamo,samagamo,279,272,7,0,8
5685,sametantiādīsu,sametantiadisu,1,1,0,0,14
5686,saṃyogaṃ,samyogam,25,22,3,0,8
5687,uiti,uiti,4,4,0,0,4
5688,uppannaṃ,uppannam,2341,2252,89,0,8
5689,uditantiādīsu,uditantiadisu,1,1,0,0,13
5690,uppattiṃ,uppattim,104,97,7,0,8
5691,ayasaddo,ayasaddo,3,2,1,0,8
5692,idañcāpi,idancapi,16,16,0,0,8
5693,dutiyasaccaṃ,dutiyasaccam,13,13,0,0,12
5694,avasesapaccayasamāyoge,avasesapaccayasamayoge,8,8,0,0,22
5695,dukkhassuppattikāraṇaṃ,dukkhassuppattikaranam,3,3,0,0,22
5696,saṃyoge,samyoge,38,36,2,0,7
5697,uppattikāraṇattā,uppattikaranatta,7,7,0,0,16
5698,dukkhasamudayanti,dukkhasamudayanti,1,1,0,0,17
5699,lobhasaṅkhātā,lobhasankhata,3,3,0,0,13
5700,M0.0080,M0.0080,83,83,0,0,7
5701,nirodhasaccanti,nirodhasaccanti,28,28,0,0,15
5702,rodhati,rodhati,1,1,0,0,7
5703,carati,carati,1066,1050,16,0,6
5704,rodho,rodho,9,9,0,0,5
5705,tebhūmikavaṭṭadhammo,tebhumikavattadhammo,1,1,0,0,20
5706,rodhadhātu,rodhadhatu,1,1,0,0,10
5707,caraṇe,carane,15,14,1,0,6
5708,tebhūmikavaṭṭadhammassa,tebhumikavattadhammassa,1,1,0,0,23
5709,caraṇaṃ,caranam,195,172,23,0,7
5710,nirodho,nirodho,926,860,66,0,7
5711,nirujjhati,nirujjhati,1926,1911,15,0,10
5712,saṃsāradukkhaṃ,samsaradukkham,74,74,0,0,14
5713,rudhidhātu,rudhidhatu,2,2,0,0,10
5714,āvaraṇe,avarane,36,31,5,0,7
5715,saccavibhaṅgaṭṭha,saccavibhangattha,1,0,1,0,17
5716,kathāyaṃ,kathayam,41,29,12,0,8
5717,tatiyasaccaṃ,tatiyasaccam,4,4,0,0,12
5718,nisaddo,nisaddo,3,3,0,0,7
5719,rodha,rodha,6,1,5,0,5
5720,cārakaṃ,carakam,7,7,0,0,7
5721,abhāvo,abhavo,350,334,16,0,6
5722,saṃsāra,samsara,20,18,2,0,7
5723,cārakasaṅkhātassa,carakasankhatassa,1,1,0,0,17
5724,dukkharodhassa,dukkharodhassa,11,11,0,0,14
5725,sabbagatisuññattā,sabbagatisunnatta,7,7,0,0,17
5726,samadhi,samadhi,1,1,0,0,7
5727,gate,gate,519,505,14,0,4
5728,saṃsāracārakasaṅkhātassa,samsaracarakasankhatassa,10,10,0,0,24
5729,tappaṭipakkhattātipi,tappatipakkhattatipi,5,5,0,0,20
5730,dukkhanirodhanti,dukkhanirodhanti,7,7,0,0,16
5731,anuppādanirodhapaccayattā,anuppadanirodhapaccayatta,8,8,0,0,25
5732,maggasaccanti,maggasaccanti,39,39,0,0,13
5733,dukkhanirodhaṃ,dukkhanirodham,126,120,6,0,14
5734,aṭṭhaṅgiko,atthangiko,601,562,39,0,10
5735,catutthasaccaṃ,catutthasaccam,3,3,0,0,14
5736,ārammaṇavasena,arammanavasena,182,178,4,0,14
5737,tadabhimukhabhūtattā,tadabhimukhabhutatta,3,3,0,0,20
5738,paṭipadā,patipada,1563,1490,73,0,8
5739,dukkhanirodhappattiyā,dukkhanirodhappattiya,14,12,2,0,21
5740,dukkhanirodhagāminipaṭipadāti,dukkhanirodhagaminipatipadati,4,3,1,0,29
5741,maggasaccaṃ,maggasaccam,591,579,12,0,11
5742,panetāni,panetani,117,117,0,0,8
5743,buddhādayo,buddhadayo,91,86,5,0,10
5744,ariyā,ariya,966,909,57,0,5
5745,ariyasaccānītipi,ariyasaccanitipi,2,2,0,0,16
5746,paṭivijjhiyanti,pativijjhiyanti,1,1,0,0,15
5747,lakkhaṇādīni,lakkhanadini,38,37,1,0,12
5748,veditabbāni,veditabbani,628,624,4,0,11
5749,bādhanalakkhaṇaṃ,badhanalakkhanam,7,5,2,0,16
5750,santāpanarasaṃ,santapanarasam,5,4,1,0,14
5751,pavattipaccupaṭṭhānaṃ,pavattipaccupatthanam,6,4,2,0,21
5752,pabhavalakkhaṇaṃ,pabhavalakkhanam,5,5,0,0,16
5753,anupacchedakaraṇarasaṃ,anupacchedakaranarasam,4,4,0,0,22
5754,palibodhapaccupaṭṭhānaṃ,palibodhapaccupatthanam,4,4,0,0,23
5755,accutirasaṃ,accutirasam,13,9,4,0,11
5756,niyyānalakkhaṇaṃ,niyyanalakkhanam,10,10,0,0,16
5757,kilesappahāna,kilesappahana,4,4,0,0,13
5758,karaṇarasaṃ,karanarasam,3,3,0,0,11
5759,vuṭṭhānapaccupaṭṭhānanti,vutthanapaccupatthananti,1,1,0,0,24
5760,etesu,etesu,886,832,54,0,5
5761,saccesu,saccesu,195,183,12,0,7
5762,paṭhamatatiyasaccāni,pathamatatiyasaccani,1,1,0,0,20
5763,dutiya,dutiya,48,45,3,0,6
5764,catutthasaccāni,catutthasaccani,1,1,0,0,15
5765,hetūni,hetuni,1,1,0,0,6
5766,purimāni,purimani,220,205,15,0,8
5767,dvesaccāni,dvesaccani,2,2,0,0,10
5768,dudda,dudda,1,1,0,0,5
5769,gambhīrāni,gambhirani,15,13,2,0,10
5770,pacchimāni,pacchimani,58,52,6,0,10
5771,gambhīrattā,gambhiratta,52,49,3,0,11
5772,duddasāni,duddasani,13,12,1,0,9
5773,M0.0081,M0.0081,83,83,0,0,7
5774,ariyasaccaṃ,ariyasaccam,493,475,18,0,11
5775,gambhīrañceva,gambhiranceva,8,7,1,0,13
5776,duddasañcāti,duddasancati,1,1,0,0,12
5777,ekekassa,ekekassa,280,271,9,0,8
5778,saccassa,saccassa,24,24,0,0,8
5779,atthānaṃ,atthanam,168,159,9,0,8
5780,soḷasa,solasa,821,778,43,0,6
5781,saccaṭṭhā,saccattha,2,2,0,0,9
5782,paṭisambhidā,patisambhida,930,918,12,0,12
5783,maggapāḷiyaṃ,maggapaliyam,2,1,1,0,12
5784,pīḷanaṭṭho,pilanattho,51,46,5,0,10
5785,saṅkhataṭṭho,sankhatattho,42,32,10,0,12
5786,santāpaṭṭho,santapattho,38,29,9,0,11
5787,vipariṇāmaṭṭho,viparinamattho,35,25,10,0,14
5788,dukkhaṭṭhā,dukkhattha,6,6,0,0,10
5789,avitathā,avitatha,53,51,2,0,8
5790,anaññathā,anannatha,101,100,1,0,9
5791,tathaṭṭhena,tathatthena,53,50,3,0,11
5792,samudayassa,samudayassa,109,101,8,0,11
5793,āyūhanaṭṭho,ayuhanattho,17,13,4,0,11
5794,nidānaṭṭho,nidanattho,22,14,8,0,10
5795,saṃyogaṭṭho,samyogattho,19,13,6,0,11
5796,palibodhaṭṭho,palibodhattho,19,13,6,0,13
5797,samudayaṭṭhā,samudayattha,3,3,0,0,12
5798,nirodhassa,nirodhassa,211,204,7,0,10
5799,nissaraṇaṭṭho,nissaranattho,21,16,5,0,13
5800,vivekaṭṭho,vivekattho,28,20,8,0,10
5801,asaṅkhataṭṭho,asankhatattho,24,18,6,0,13
5802,amataṭṭho,amatattho,19,14,5,0,9
5803,nirodhaṭṭhā,nirodhattha,3,3,0,0,11
5804,niyyānaṭṭho,niyyanattho,49,37,12,0,11
5805,hetvaṭṭho,hetvattho,9,7,2,0,9
5806,dassanaṭṭho,dassanattho,59,49,10,0,11
5807,adhipateyyaṭṭho,adhipateyyattho,8,5,3,0,15
5808,maggaṭṭhā,maggattha,33,32,1,0,9
5809,dasaṃ,dasam,8,8,0,0,5
5810,disati,disati,4,4,0,0,6
5811,catumaggañāṇaṃ,catumaggananam,20,17,3,0,14
5812,disadhātu,disadhatu,2,2,0,0,9
5813,apekkhane,apekkhane,1,1,0,0,9
5814,assāti,assati,1485,901,584,0,6
5815,catusaccadaso,catusaccadaso,12,12,0,0,13
5816,adassi,adassi,3,3,0,0,6
5817,apassīti,apassiti,2,2,0,0,8
5818,appaṭivijjhīti,appativijjhiti,1,1,0,0,14
5819,catusaccañāṇaṃ,catusaccananam,11,11,0,0,14
5820,anubodhañāṇañca,anubodhanananca,2,2,0,0,15
5821,paṭivedha,pativedha,1,1,0,0,9
5822,anubodhañāṇaṃ,anubodhananam,11,8,3,0,13
5823,lokiyaṃ,lokiyam,314,284,30,0,7
5824,anussavādivasena,anussavadivasena,23,23,0,0,16
5825,nirodhe,nirodhe,135,120,15,0,7
5826,paṭivedhañāṇaṃ,pativedhananam,51,40,11,0,14
5827,lokuttaraṃ,lokuttaram,627,585,42,0,10
5828,nirodhamārammaṇaṃ,nirodhamarammanam,4,4,0,0,17
5829,kiccato,kiccato,189,174,15,0,7
5830,cattāripi,cattaripi,107,100,7,0,9
5831,passati,passati,3434,3349,85,0,7
5832,dukkhasamudayampi,dukkhasamudayampi,24,21,3,0,17
5833,dukkhanirodhampi,dukkhanirodhampi,14,14,0,0,16
5834,dukkhanirodhagāminipaṭi,dukkhanirodhagaminipati,1,1,0,0,23
5835,padampi,padampi,23,22,1,0,7
5836,catusaccapaṭivedhañāṇaṃ,catusaccapativedhananam,1,1,0,0,23
5837,anubodhañāṇena,anubodhananena,2,2,0,0,14
5838,vinā,vina,2648,2542,106,0,4
5839,anubodha,anubodha,1,1,0,0,8
5840,ñāṇatthāya,nanatthaya,2,2,0,0,10
5841,catusaccakammaṭṭhānaṃ,catusaccakammatthanam,30,28,2,0,21
5842,paṇḍitena,panditena,137,132,5,0,9
5843,samārambhi,samarambhi,1,1,0,0,10
5844,tabbanti,tabbanti,6,5,1,0,8
5845,M0.0082,M0.0082,80,80,0,0,7
5846,ariyasāvakā,ariyasavaka,53,52,1,0,11
5847,jinoyeva,jinoyeva,1,1,0,0,8
5848,catusaccadasanti,catusaccadasanti,2,2,0,0,16
5849,thomitoti,thomitoti,10,7,3,0,9
5850,ariyasāvakehi,ariyasavakehi,4,4,0,0,13
5851,visiṭṭhena,visitthena,17,17,0,0,10
5852,anaññopadesena,anannopadesena,1,1,0,0,14
5853,bhagavāyeva,bhagavayeva,12,11,1,0,11
5854,abhitthavitoti,abhitthavitoti,2,2,0,0,14
5855,ṭhapetvā,thapetva,5623,5440,183,0,8
5856,taṇhañca,tanhanca,22,19,3,0,8
5857,nibbānañca,nibbananca,310,304,6,0,10
5858,avasesadhammā,avasesadhamma,1,1,0,0,13
5859,aṭṭhasatataṇhāvicaritā,atthasatatanhavicarita,1,1,0,0,22
5860,nirodha,nirodha,16,12,4,0,7
5861,abhidhammatthasaṅgahe,abhidhammatthasangahe,14,13,1,0,21
5862,tebhūmakaṃ,tebhumakam,41,37,4,0,10
5863,vaṭṭaṃ,vattam,354,304,50,0,6
5864,lokuttaro,lokuttaro,232,221,11,0,9
5865,varaṃ,varam,815,760,55,0,5
5866,iddhigataṃ,iddhigatam,1,1,0,0,10
5867,atītabuddhānaṃ,atitabuddhanam,9,7,2,0,14
5868,iddhiṃ,iddhim,115,107,8,0,6
5869,pattanti,pattanti,39,39,0,0,8
5870,uttamānaṃ,uttamanam,23,22,1,0,9
5871,iddhīnaṃ,iddhinam,7,7,0,0,8
5872,patiṭṭhānabhūtanti,patitthanabhutanti,1,1,0,0,18
5873,samijjhati,samijjhati,154,153,1,0,10
5874,nippajjatīti,nippajjatiti,6,6,0,0,12
5875,iddhividhañāṇañca,iddhividhanananca,1,1,0,0,17
5876,visuddhimagge,visuddhimagge,541,335,206,0,13
5877,ijjhatīti,ijjhatiti,113,102,11,0,9
5878,iddhī,iddhi,62,58,4,0,5
5879,ijjhanti,ijjhanti,104,102,2,0,8
5880,iddhā,iddha,65,63,2,0,5
5881,vuddhā,vuddha,75,74,1,0,6
5882,ukkaṃsagatā,ukkamsagata,36,36,0,0,11
5883,hontīti,hontiti,2021,1730,291,0,7
5884,aṭṭhasamāpattiyo,atthasamapattiyo,6,6,0,0,16
5885,maggā,magga,678,645,33,0,5
5886,idhadhātu,idhadhatu,2,2,0,0,9
5887,vuḍḍhiyanti,vuddhiyanti,1,1,0,0,11
5888,paccayo,paccayo,17782,17629,153,0,7
5889,itthiliṅgajotako,itthilingajotako,4,4,0,0,16
5890,iddhigato,iddhigato,1,1,0,0,9
5891,patiṭṭhahati,patitthahati,47,47,0,0,12
5892,varānaṃ,varanam,22,21,1,0,7
5893,varamiddhigato,varamiddhigato,1,1,0,0,14
5894,iddhippattā,iddhippatta,5,5,0,0,11
5895,buddhā,buddha,928,893,35,0,6
5896,visesato,visesato,908,885,23,0,8
5897,abhiññāya,abhinnaya,577,558,19,0,9
5898,samiddhā,samiddha,33,33,0,0,8
5899,atiukkaṃsagatā,atiukkamsagata,1,1,0,0,14
5900,buddhoyeva,buddhoyeva,14,12,2,0,10
5901,varamiddhigatanti,varamiddhigatanti,1,1,0,0,17
5902,lokiyalokuttara,lokiyalokuttara,4,4,0,0,15
5903,dhāraṇaṃ,dharanam,62,49,13,0,8
5904,M0.0083,M0.0083,82,82,0,0,7
5905,tibhavaupasamaṃ,tibhavaupasamam,1,1,0,0,15
5906,punabbhavābhinibbattiyā,punabbhavabhinibbattiya,16,16,0,0,23
5907,kāmarūpaarūpasaṅkhātehi,kamarupaarupasankhatehi,2,2,0,0,23
5908,bhavehi,bhavehi,31,31,0,0,7
5909,punabbhavābhinibbattito,punabbhavabhinibbattito,1,1,0,0,23
5910,upasamitaṃ,upasamitam,3,3,0,0,10
5911,nibbutaṃ,nibbutam,47,43,4,0,8
5912,niruddhanti,niruddhanti,8,8,0,0,11
5913,bhavā,bhava,468,435,33,0,5
5914,tibhavā,tibhava,7,6,1,0,7
5915,upasamitthāti,upasamitthati,1,1,0,0,13
5916,tibhavūpasamo,tibhavupasamo,1,1,0,0,13
5917,bodhipallaṅkeva,bodhipallankeva,1,1,0,0,15
5918,kāmarūpārūpasaṅkhātesu,kamaruparupasankhatesu,3,3,0,0,22
5919,avijjātaṇhāmūlakānaṃ,avijjatanhamulakanam,1,1,0,0,20
5920,puññādisaṅkhārānaṃ,punnadisankharanam,1,1,0,0,18
5921,niravasesaṃ,niravasesam,54,52,2,0,11
5922,punabbhavābhinibbatti,punabbhavabhinibbatti,73,67,6,0,21
5923,bhagavantaṃyeva,bhagavantamyeva,97,88,9,0,15
5924,tibhavūpasamanti,tibhavupasamanti,1,1,0,0,16
5925,pañcamārajayantaṃ,pancamarajayantam,2,2,0,0,17
5926,ñāṇasampayuttacittena,nanasampayuttacittena,22,22,0,0,21
5927,ādaraṃ,adaram,84,80,4,0,6
5928,samatiṃsati,samatimsati,2,2,0,0,11
5929,sambharaṇaṃ,sambharanam,4,4,0,0,11
5930,paripūritaṃ,paripuritam,10,9,1,0,11
5931,paṭivijjhantaṃ,pativijjhantam,24,21,3,0,14
5932,atīta,atita,22,21,1,0,5
5933,iddhipattaṃ,iddhipattam,1,1,0,0,11
5934,punabbhavā,punabbhava,7,7,0,0,10
5935,bhinibbattito,bhinibbattito,1,1,0,0,13
5936,ekādasamavandanagāthāvaṇṇanā,ekadasamavandanagathavannana,1,1,0,0,28
5937,M0.0084,M0.0084,80,80,0,0,7
5938,ekādasamagāthāya,ekadasamagathaya,2,2,0,0,16
5939,satapuññajalakkhaṇikantyādīhi,satapunnajalakkhanikantyadihi,1,1,0,0,29
5940,sa,sa,2773,2406,367,0,2
5941,sādhakaṃ,sadhakam,155,147,8,0,8
5942,anantaragāthāvaṇṇanāyaṃ,anantaragathavannanayam,1,1,0,0,23
5943,vuttameva,vuttameva,590,576,14,0,9
5944,anekapāramīpuññatejena,anekaparamipunnatejena,2,2,0,0,22
5945,jātena,jatena,55,53,2,0,6
5946,dvattiṃsamahāpurisalakkhaṇena,dvattimsamahapurisalakkhanena,2,2,0,0,29
5947,satasaddo,satasaddo,4,4,0,0,9
5948,anekasaṅkhyāvācako,anekasankhyavacako,1,1,0,0,18
5949,satatejo,satatejo,3,3,0,0,8
5950,sahassaraṃ,sahassaram,1,1,0,0,10
5951,sītiādīsu,sitiadisu,1,1,0,0,9
5952,satena,satena,68,63,5,0,6
5953,anekena,anekena,4,4,0,0,7
5954,jātanti,jatanti,129,129,0,0,7
5955,satapuññajaṃ,satapunnajam,1,1,0,0,12
5956,buddhadabbaṃ,buddhadabbam,1,1,0,0,12
5957,dvattiṃsamahāpurisalakkhaṇādi,dvattimsamahapurisalakkhanadi,1,1,0,0,29
5958,lakkhadhātu,lakkhadhatu,1,1,0,0,11
5959,dassanaṅkesuyu,dassanankesuyu,1,1,0,0,14
5960,satapuññajañca,satapunnajanca,1,1,0,0,14
5961,lakkhaṇañcāti,lakkhanancati,5,5,0,0,13
5962,satapuññaja,satapunnaja,1,1,0,0,11
5963,satapuññajalakkhaṇiko,satapunnajalakkhaniko,1,1,0,0,21
5964,anantesu,anantesu,12,11,1,0,8
5965,cakkavāḷesu,cakkavalesu,52,52,0,0,11
5966,ekekaṃ,ekekam,502,465,37,0,6
5967,puññakammaṃ,punnakammam,97,95,2,0,11
5968,satakkhattuṃ,satakkhattum,40,38,2,0,12
5969,kareyyuṃ,kareyyum,180,170,10,0,8
5970,ettakehi,ettakehi,53,48,5,0,8
5971,janehi,janehi,96,94,2,0,6
5972,ekova,ekova,376,353,23,0,5
5973,sataguṇaṃ,satagunam,14,13,1,0,9
5974,nibbattena,nibbattena,21,19,2,0,10
5975,jātehi,jatehi,14,14,0,0,6
5976,dvattiṃsa,dvattimsa,218,206,12,0,9
5977,asītianubyañjana,asitianubyanjana,1,1,0,0,16
5978,lakkhaṇe,lakkhane,174,160,14,0,8
5979,sampannoti,sampannoti,23,12,11,0,10
5980,satapuññajalakkhaṇikanti,satapunnajalakkhanikanti,1,1,0,0,24
5981,buddhavaṃsaṭṭhakathāyaṃ,buddhavamsatthakathayam,2,0,2,0,23
5982,satapuñña,satapunna,1,1,0,0,9
5983,lakkhaṇoti,lakkhanoti,9,6,3,0,10
5984,katakammaṃ,katakammam,188,184,4,0,10
5985,sayameva,sayameva,1200,1168,32,0,8
5986,nibbatto,nibbatto,1017,1004,13,0,8
5987,satapuññalakkhaṇoti,satapunnalakkhanoti,6,2,4,0,19
5988,puññakammena,punnakammena,325,323,2,0,12
5989,nibbattaṃ,nibbattam,311,297,14,0,9
5990,ekekalakkhaṇoti,ekekalakkhanoti,1,1,0,0,15
5991,sante,sante,799,773,26,0,5
5992,bhaveyyāti,bhaveyyati,311,286,25,0,10
5993,paṭikkhittaṃ,patikkhittam,282,266,16,0,12
5994,pātheyyaṭṭhakathāyaṃ,patheyyatthakathayam,2,0,2,0,20
5995,sata,sata,35,12,23,0,4
5996,puññalakkhaṇanti,punnalakkhananti,1,1,0,0,16
5997,M0.0085,M0.0085,80,80,0,0,7
5998,rocayiṃsu,rocayimsu,8,8,0,0,9
5999,imamatthaṃ,imamattham,770,754,16,0,10
6000,rocayiṃsū,rocayimsu,2,1,1,0,9
6001,dvattiṃsamahāpurisalakkhaṇaṃ,dvattimsamahapurisalakkhanam,3,2,1,0,28
6002,rāgarajādīnaṃ,ragarajadinam,18,18,0,0,13
6003,vigatarajaṃ,vigatarajam,14,13,1,0,11
6004,rañjati,ranjati,10,10,0,0,7
6005,sañjati,sanjati,2,2,0,0,7
6006,rūpādiārammaṇesūti,rupadiarammanesuti,1,1,0,0,18
6007,rajo,rajo,187,171,16,0,4
6008,rāgādirajo,ragadirajo,12,12,0,0,10
6009,vigato,vigato,106,103,3,0,6
6010,virajo,virajo,25,24,1,0,6
6011,sabbakilesamāra,sabbakilesamara,1,1,0,0,15
6012,rajassa,rajassa,22,22,0,0,7
6013,jayitattā,jayitatta,1,1,0,0,9
6014,vigatarajoti,vigatarajoti,4,4,0,0,12
6015,dhī,dhi,84,67,17,0,3
6016,ākāsūpamasabbaññuta,akasupamasabbannuta,1,1,0,0,19
6017,ñāṇavantanti,nanavantanti,1,1,0,0,12
6018,vihaṅgamādayoti,vihangamadayoti,1,1,0,0,15
6019,gaganaṃ,gaganam,27,26,1,0,7
6020,ākāso,akaso,322,300,22,0,5
6021,makārassa,makarassa,15,15,0,0,9
6022,upamiyate,upamiyate,1,1,0,0,9
6023,upamā,upama,370,342,28,0,5
6024,bhāvasādhanoyaṃ,bhavasadhanoyam,7,7,0,0,15
6025,upapubbamādhātu,upapubbamadhatu,1,1,0,0,15
6026,parimāne,parimane,2,2,0,0,8
6027,dharati,dharati,31,30,1,0,7
6028,dharadhātu,dharadhatu,5,5,0,0,10
6029,itthiliṅgajotakaīpaccayo,itthilingajotakaipaccayo,2,2,0,0,24
6030,gaganena,gaganena,1,1,0,0,8
6031,ākāsena,akasena,370,366,4,0,7
6032,gaganūpamā,gaganupama,1,1,0,0,10
6033,gaganūpamadhi,gaganupamadhi,1,1,0,0,13
6034,anantādiguṇahīnattā,anantadigunahinatta,1,1,0,0,19
6035,dhammahīnopamā,dhammahinopama,2,2,0,0,14
6036,dhammahīnāmukhambhoja,dhammahinamukhambhoja,1,1,0,0,21
6037,itī,iti,79,60,19,0,3
6038,anantoti,anantoti,7,6,1,0,8
6039,ananto,ananto,171,163,8,0,6
6040,vittharati,vittharati,4,4,0,0,10
6041,anantaṃ,anantam,276,253,23,0,7
6042,buddhañāṇanti,buddhanananti,1,1,0,0,13
6043,sabbaññutañāṇassa,sabbannutananassa,13,13,0,0,17
6044,anantārammaṇattā,anantarammanatta,3,3,0,0,16
6045,gaganūpamadhinti,gaganupamadhinti,1,1,0,0,16
6046,sinerupabbata,sinerupabbata,2,2,0,0,13
6047,acalasamādhivantanti,acalasamadhivantanti,1,1,0,0,20
6048,ṭhapiyati,thapiyati,9,9,0,0,9
6049,M0.0086,M0.0086,80,80,0,0,7
6050,lokiyalokuttarajhānasamādhi,lokiyalokuttarajhanasamadhi,1,1,0,0,27
6051,dhidhātu,dhidhatu,1,1,0,0,8
6052,dhāraṇeti,dharaneti,1,1,0,0,9
6053,raṃsiyā,ramsiya,6,6,0,0,7
6054,meru,meru,13,12,1,0,4
6055,pabbatarājā,pabbataraja,45,44,1,0,11
6056,mīdhātu,midhatu,1,1,0,0,7
6057,rupaccayo,rupaccayo,1,1,0,0,9
6058,vacanatthañhi,vacanatthanhi,2,2,0,0,13
6059,sinerussa,sinerussa,69,66,3,0,9
6060,pācīnapassaṃ,pacinapassam,7,7,0,0,12
6061,rajatamayaṃ,rajatamayam,37,36,1,0,11
6062,dakkhiṇapassaṃ,dakkhinapassam,27,27,0,0,14
6063,maṇimayaṃ,manimayam,31,29,2,0,9
6064,pacchimapassaṃ,pacchimapassam,5,5,0,0,14
6065,phallikamayaṃ,phallikamayam,1,1,0,0,13
6066,uttarapassaṃ,uttarapassam,5,5,0,0,12
6067,suvaṇṇamayaṃ,suvannamayam,43,43,0,0,12
6068,vuttavacanaṃ,vuttavacanam,140,136,4,0,12
6069,pabbate,pabbate,404,386,18,0,7
6070,uccataraṭṭhenāti,uccataratthenati,2,2,0,0,16
6071,merunā,meruna,2,2,0,0,6
6072,dhitimerusamo,dhitimerusamo,1,1,0,0,13
6073,dhitimeru,dhitimeru,1,1,0,0,9
6074,merurājā,meruraja,2,2,0,0,8
6075,kampati,kampati,182,175,7,0,7
6076,calati,calati,152,149,3,0,6
6077,kāmacchandādinīvaraṇe,kamacchandadinivarane,1,1,0,0,21
6078,pajahitvā,pajahitva,150,146,4,0,9
6079,lokuttarajjhānasamādhinā,lokuttarajjhanasamadhina,1,1,0,0,24
6080,micchādiṭṭhivātehi,micchaditthivatehi,1,1,0,0,18
6081,calatīti,calatiti,50,38,12,0,8
6082,dhitimerusamanti,dhitimerusamanti,1,1,0,0,16
6083,udakajātappadumasadisena,udakajatappadumasadisena,2,2,0,0,24
6084,atisītalena,atisitalena,1,1,0,0,11
6085,asaṅkhyeyyasīlena,asankhyeyyasilena,3,3,0,0,17
6086,saṃyuttaṃ,samyuttam,52,47,5,0,9
6087,asaṅkhyeyyaṃ,asankhyeyyam,109,105,4,0,12
6088,tadaṭṭhakathāyañca,tadatthakathayanca,11,6,5,0,18
6089,asaṅkhyeyyamevā,asankhyeyyameva,1,1,0,0,15
6090,jalati,jalati,75,75,0,0,6
6091,jalaṃ,jalam,223,201,22,0,5
6092,jaladhātu,jaladhatu,5,5,0,0,9
6093,dittiyaṃ,dittiyam,76,58,18,0,8
6094,jale,jale,72,69,3,0,4
6095,udake,udake,996,955,41,0,5
6096,jātaṃ,jatam,1268,1206,62,0,5
6097,jalajaṃ,jalajam,18,18,0,0,7
6098,jalajena,jalajena,2,2,0,0,8
6099,padumena,padumena,5,5,0,0,8
6100,upamaṃ,upamam,268,258,10,0,6
6101,sadisanti,sadisanti,18,18,0,0,9
6102,jalajūpamaṃ,jalajupamam,1,1,0,0,11
6103,sukhatthikehi,sukhatthikehi,2,2,0,0,13
6104,sītalaṃ,sitalam,106,101,5,0,7
6105,talapaccayo,talapaccayo,1,1,0,0,11
6106,sītaguṇaṃ,sitagunam,1,1,0,0,9
6107,sītasaddūpapada,sitasaddupapada,1,1,0,0,15
6108,gahaṇe,gahane,312,303,9,0,6
6109,uṇhassa,unhassa,60,58,2,0,7
6110,samitattā,samitatta,49,47,2,0,9
6111,kilesatā,kilesata,3,3,0,0,8
6112,sametattā,sametatta,1,1,0,0,9
6113,accantasītalaṃ,accantasitalam,6,6,0,0,14
6114,surakkhitañhi,surakkhitanhi,1,1,0,0,13
6115,visuddhaṃ,visuddham,188,156,32,0,9
6116,kilesappahānena,kilesappahanena,9,8,1,0,15
6117,kilesapariḷāhaṃ,kilesaparilaham,2,2,0,0,15
6118,upasameti,upasameti,11,10,1,0,9
6119,haritacandanaṃ,haritacandanam,1,1,0,0,14
6120,muttāhāro,muttaharo,4,4,0,0,9
6121,maṇi,mani,259,247,12,0,4
6122,vāto,vato,303,287,16,0,4
6123,candakiraṇo,candakirano,1,1,0,0,11
6124,sīlameva,silameva,100,88,12,0,8
6125,sītalanti,sitalanti,2,2,0,0,9
6126,accantasītalanti,accantasitalanti,1,1,0,0,16
6127,M0.0087,M0.0087,80,80,0,0,7
6128,sajaladā,sajalada,4,4,0,0,8
6129,haricandanaṃ,haricandanam,20,16,4,0,12
6130,hārā,hara,114,95,19,0,4
6131,maṇayo,manayo,27,27,0,0,6
6132,candakiraṇaṅkurā,candakiranankura,4,4,0,0,16
6133,samayantīdha,samayantidha,3,3,0,0,12
6134,pariḷāhaṃ,parilaham,42,38,4,0,9
6135,surakkhitaṃ,surakkhitam,46,42,4,0,11
6136,sametidaṃ,sametidam,1,1,0,0,9
6137,ariyaṃ,ariyam,609,575,34,0,6
6138,gāthādvayassattho,gathadvayassattho,1,1,0,0,17
6139,suṭṭhurakkhitaṃ,sutthurakkhitam,1,1,0,0,15
6140,sameti,sameti,628,606,22,0,6
6141,udakadadena,udakadadena,1,1,0,0,11
6142,meghena,meghena,9,9,0,0,7
6143,sītavātā,sitavata,1,1,0,0,8
6144,samayanti,samayanti,30,29,1,0,9
6145,haritacandanañcāpi,haritacandanancapi,1,1,0,0,18
6146,samayati,samayati,3,3,0,0,8
6147,muttāhārā,muttahara,2,2,0,0,9
6148,veḷuriyādimaṇiyo,veluriyadimaniyo,1,1,0,0,16
6149,raṃsiaṅkurā,ramsiankura,1,1,0,0,11
6150,samayantīti,samayantiti,1,1,0,0,11
6151,susīlyavasena,susilyavasena,13,12,1,0,13
6152,samādhimhi,samadhimhi,91,87,4,0,10
6153,sīlenti,silenti,3,3,0,0,7
6154,upadhārenti,upadharenti,6,5,1,0,11
6155,ābhuso,abhuso,28,28,0,0,6
6156,dhārenti,dharenti,263,263,0,0,8
6157,sādhavoti,sadhavoti,21,20,1,0,9
6158,cetanādhammo,cetanadhammo,3,3,0,0,12
6159,upadhāraṇe,upadharane,8,6,2,0,10
6160,visuddhimaggaṭṭhakathāyaṃ,visuddhimaggatthakathayam,1,0,1,0,25
6161,sīlanaṭṭhena,silanatthena,26,26,0,0,12
6162,kimidaṃ,kimidam,130,124,6,0,7
6163,samādhānaṃ,samadhanam,52,46,6,0,10
6164,avippakiṇṇatāti,avippakinnatati,10,9,1,0,15
6165,upadhāraṇaṃ,upadharanam,36,32,4,0,11
6166,patiṭṭhānavasena,patitthanavasena,19,19,0,0,16
6167,ādhārabhāvoti,adharabhavoti,8,8,0,0,13
6168,jalajūpamena,jalajupamena,1,1,0,0,12
6169,padumasadisena,padumasadisena,1,1,0,0,14
6170,sītalena,sitalena,4,4,0,0,8
6171,accantasītalena,accantasitalena,1,1,0,0,15
6172,sīlena,silena,542,515,27,0,6
6173,jalajūpamasītalasīlayuto,jalajupamasitalasilayuto,1,1,0,0,24
6174,jalena,jalena,27,22,5,0,6
6175,maggasīlena,maggasilena,6,6,0,0,11
6176,kilesupatāpanassa,kilesupatapanassa,1,1,0,0,17
6177,sampayuttoti,sampayuttoti,20,17,3,0,12
6178,jalajūpamasītalasīla,jalajupamasitalasila,1,1,0,0,20
6179,yutanti,yutanti,1,1,0,0,7
6180,khantisampannaṃ,khantisampannam,2,2,0,0,15
6181,khantivantaṃ,khantivantam,2,2,0,0,12
6182,pathanti,pathanti,4,4,0,0,8
6183,tarupabbatādayoti,tarupabbatadayoti,1,1,0,0,17
6184,bhūmi,bhumi,431,375,56,0,5
6185,pathadhātu,pathadhatu,1,1,0,0,10
6186,M0.0088,M0.0088,78,78,0,0,7
6187,vīpaccayo,vipaccayo,4,4,0,0,9
6188,puthu,puthu,343,285,58,0,5
6189,jātataddhitatthe,jatataddhitatthe,1,1,0,0,16
6190,sahayate,sahayate,1,1,0,0,8
6191,khamiyate,khamiyate,1,1,0,0,9
6192,sahanaṃ,sahanam,19,19,0,0,7
6193,sahati,sahati,176,169,7,0,6
6194,khamatīti,khamatiti,56,36,20,0,9
6195,adhivāsanakhanti,adhivasanakhanti,28,24,4,0,16
6196,sahadhātu,sahadhatu,5,5,0,0,9
6197,khantiyaṃ,khantiyam,20,18,2,0,9
6198,khamanaṃ,khamanam,40,38,2,0,8
6199,pathavīsahano,pathavisahano,1,1,0,0,13
6200,pakkhittaṃ,pakkhittam,118,116,2,0,10
6201,sucimpi,sucimpi,29,29,0,0,7
6202,asucimpi,asucimpi,31,31,0,0,8
6203,paṭighānunayaṃ,patighanunayam,8,8,0,0,14
6204,iṭṭhārammaṇampi,ittharammanampi,3,3,0,0,15
6205,aniṭṭhārammaṇampi,anittharammanampi,2,2,0,0,17
6206,pathavīsahananti,pathavisahananti,1,1,0,0,16
6207,lābhālābhe,labhalabhe,11,11,0,0,10
6208,sajjanti,sajjanti,19,17,2,0,8
6209,sammānanavimānane,sammananavimanane,3,3,0,0,17
6210,pathavīsadisā,pathavisadisa,4,4,0,0,13
6211,virādhiyā,viradhiya,3,3,0,0,9
6212,ākāsūpamasabbaññutañāṇavantaṃ,akasupamasabbannutananavantam,1,1,0,0,29
6213,sinerupabbatasadisaṃ,sinerupabbatasadisam,2,2,0,0,20
6214,acalasamādhivantaṃ,acalasamadhivantam,1,1,0,0,18
6215,jalajūpamasītala,jalajupamasitala,1,1,0,0,16
6216,sīlayutaṃ,silayutam,1,1,0,0,9
6217,accantaatisītalena,accantaatisitalena,1,1,0,0,18
6218,pañcamāravijayaṃ,pancamaravijayam,1,1,0,0,16
6219,dvādasamavandanagāthāvaṇṇanā,dvadasamavandanagathavannana,1,1,0,0,28
6220,M0.0089,M0.0089,80,80,0,0,7
6221,dvādasamagāthāya,dvadasamagathaya,2,2,0,0,16
6222,tāvatiṃsapure,tavatimsapure,2,2,0,0,13
6223,mātudevaputtappamukhānaṃ,matudevaputtappamukhanam,4,4,0,0,24
6224,upapattidevānaṃ,upapattidevanam,13,12,1,0,15
6225,abhidhammaṃ,abhidhammam,91,88,3,0,11
6226,desaka,desaka,2,2,0,0,6
6227,abhitthavitvā,abhitthavitva,30,30,0,0,13
6228,ma,ma,4892,4746,146,0,2
6229,ra,ra,188,80,108,0,2
6230,ekagarunā,ekagaruna,3,3,0,0,9
6231,yatīhi,yatihi,5,5,0,0,6
6232,dasahi,dasahi,629,593,36,0,6
6233,terasakkhara,terasakkhara,1,1,0,0,12
6234,pahassiṇīgāthāti,pahassinigathati,1,1,0,0,16
6235,mnā,mna,5,5,0,0,3
6236,tidasayatippahassiṇī,tidasayatippahassini,1,1,0,0,20
6237,magaṇa,magana,2,2,0,0,6
6238,nagaṇā,nagana,1,1,0,0,6
6239,tidasayati,tidasayati,2,2,0,0,10
6240,tiyati,tiyati,3,3,0,0,6
6241,dasayati,dasayati,1,1,0,0,8
6242,pahassiṇīgāthā,pahassinigatha,1,1,0,0,14
6243,adesīti,adesiti,4,2,2,0,7
6244,aniyamavācakasabbanāmapadaṃ,aniyamavacakasabbanamapadam,1,1,0,0,27
6245,sabbanāmanti,sabbanamanti,1,1,0,0,12
6246,yātīti,yatiti,44,36,8,0,6
6247,bhāvaṃ,bhavam,126,118,8,0,6
6248,aniyamavācakabhāvena,aniyamavacakabhavena,1,1,0,0,20
6249,sabbanāmasaṅkhātaṃ,sabbanamasankhatam,1,1,0,0,18
6250,yaitipadaṃ,yaitipadam,1,1,0,0,10
6251,yādi,yadi,2,2,0,0,4
6252,paṭividdhasabbañeyyadhammo,patividdhasabbaneyyadhammo,1,1,0,0,26
6253,sumatīti,sumatiti,3,2,1,0,8
6254,sundarasabbaññutañāṇavāto,sundarasabbannutananavato,1,1,0,0,25
6255,desanāñāṇavāto,desanananavato,2,2,0,0,14
6256,devānanti,devananti,6,5,1,0,9
6257,vuccamānattā,vuccamanatta,57,57,0,0,12
6258,manati,manati,20,20,0,0,6
6259,desetabbadhammaṃ,desetabbadhammam,1,1,0,0,16
6260,manadhātu,manadhatu,4,4,0,0,9
6261,ñāṇeti,naneti,5,3,2,0,6
6262,sundarā,sundara,102,100,2,0,7
6263,sabbañeyyadhammānaṃ,sabbaneyyadhammanam,8,8,0,0,19
6264,yathāsabhāvajānanasamatthaṃ,yathasabhavajananasamattham,1,1,0,0,27
6265,dese,dese,247,240,7,0,4
6266,tabbappakārajānanasamatthaṃ,tabbappakarajananasamattham,1,1,0,0,27
6267,M0.0090,M0.0090,81,81,0,0,7
6268,bodhetabbapuggalānaṃ,bodhetabbapuggalanam,2,2,0,0,20
6269,āsayādhi,asayadhi,1,1,0,0,8
6270,muttiyādivibhāvanasamatthañcāti,muttiyadivibhavanasamatthancati,1,1,0,0,31
6271,tisamatthasampannaṃ,tisamatthasampannam,1,1,0,0,19
6272,abhidhammakathāya,abhidhammakathaya,7,7,0,0,17
6273,samuṭṭhānabhāve,samutthanabhave,3,3,0,0,15
6274,samatthaṃ,samattham,134,126,8,0,9
6275,nāññanti,nannanti,12,12,0,0,8
6276,dīpento,dipento,249,247,2,0,7
6277,anaññasādhāraṇabhāvaṃ,anannasadharanabhavam,2,2,0,0,21
6278,asmiṃ,asmim,354,338,16,0,5
6279,samāsanta,samasanta,7,5,2,0,9
6280,taddhitāyaṃ,taddhitayam,1,1,0,0,11
6281,tadassatthītivī,tadassatthitivi,1,1,0,0,15
6282,casaddena,casaddena,72,71,1,0,9
6283,pītisukhanti,pitisukhanti,11,11,0,0,12
6284,pārājikaṇḍaṭṭhakathāyaṃ,parajikandatthakathayam,2,0,2,0,23
6285,ayañca,ayanca,859,830,29,0,6
6286,pīti,piti,1029,936,93,0,4
6287,jhānassa,jhanassa,789,770,19,0,8
6288,jhāne,jhane,653,640,13,0,5
6289,diveti,diveti,2,1,1,0,6
6290,sūriyobhāsena,suriyobhasena,2,2,0,0,13
6291,dibbati,dibbati,67,66,1,0,7
6292,divo,divo,6,4,2,0,4
6293,jutiyaṃ,jutiyam,2,2,0,0,7
6294,karovāti,karovati,1,0,1,0,8
6295,divādinaṃ,divadinam,1,1,0,0,9
6296,divāsaddūpa,divasaddupa,1,1,0,0,11
6297,karadhātu,karadhatu,8,8,0,0,9
6298,karaṇe,karane,300,286,14,0,6
6299,raṃsi,ramsi,37,31,6,0,5
6300,karasaddo,karasaddo,1,1,0,0,9
6301,raṃsivācako,ramsivacako,1,1,0,0,11
6302,sobhantoti,sobhantoti,1,0,1,0,10
6303,virocamāno,virocamano,29,29,0,0,10
6304,subhati,subhati,1,1,0,0,7
6305,virocati,virocati,203,197,6,0,8
6306,chabbaṇṇaraṃsiādīhīti,chabbannaramsiadihiti,1,1,0,0,21
6307,subhadhātu,subhadhatu,13,13,0,0,10
6308,sobhe,sobhe,3,2,1,0,5
6309,chabbaṇṇaraṃsīhi,chabbannaramsihi,10,10,0,0,16
6310,asītyānubyañjanalakkhaṇehi,asityanubyanjanalakkhanehi,1,1,0,0,26
6311,virocatīti,virocatiti,34,19,15,0,10
6312,ratijananeti,ratijananeti,1,0,1,0,12
6313,atappakapītisomanassuppādane,atappakapitisomanassuppadane,1,1,0,0,28
6314,pemuppādane,pemuppadane,2,2,0,0,11
6315,ramanaṃ,ramanam,9,9,0,0,7
6316,rati,rati,136,121,15,0,4
6317,ramudhātu,ramudhatu,2,2,0,0,9
6318,kīḷāyanti,kilayanti,3,3,0,0,9
6319,janeti,janeti,787,776,11,0,6
6320,uppādetīti,uppadetiti,101,93,8,0,10
6321,ratijananaṃ,ratijananam,2,2,0,0,11
6322,silāsanaṃ,silasanam,12,10,2,0,9
6323,ratisaddūpapada,ratisaddupapada,1,1,0,0,15
6324,janadhātu,janadhatu,6,6,0,0,9
6325,janane,janane,43,42,1,0,6
6326,silāsanamhīti,silasanamhiti,1,0,1,0,13
6327,tidasālaye,tidasalaye,9,9,0,0,10
6328,pāricchattakamūle,paricchattakamule,24,24,0,0,17
6329,jāte,jate,293,279,14,0,4
6330,nikkhitte,nikkhitte,18,18,0,0,9
6331,dīghato,dighato,158,156,2,0,7
6332,saṭṭhiyojane,satthiyojane,3,3,0,0,12
6333,vitthārato,vittharato,972,944,28,0,10
6334,paṇṇāsa,pannasa,41,40,1,0,7
6335,yojane,yojane,102,102,0,0,6
6336,puthulato,puthulato,45,45,0,0,9
6337,pannarasayojane,pannarasayojane,1,1,0,0,15
6338,vaṇṇato,vannato,175,162,13,0,7
6339,jayasumanapupphasadise,jayasumanapupphasadise,1,1,0,0,22
6340,rattakampalavaṇṇe,rattakampalavanne,1,1,0,0,17
6341,saṇhasukhume,sanhasukhume,3,3,0,0,12
6342,paṇḍukampa,pandukampa,1,1,0,0,10
6343,lanāmake,lanamake,1,1,0,0,8
6344,silāsane,silasane,10,10,0,0,8
6345,sakkena,sakkena,139,135,4,0,7
6346,silaṃ,silam,61,59,2,0,5
6347,pāsāṇo,pasano,129,123,6,0,6
6348,M0.0091,M0.0091,81,81,0,0,7
6349,alapaccayo,alapaccayo,3,3,0,0,10
6350,āsiyati,asiyati,2,2,0,0,7
6351,āsanaṃ,asanam,664,613,51,0,6
6352,seviyati,seviyati,3,3,0,0,8
6353,āpubbasidhātu,apubbasidhatu,1,1,0,0,13
6354,silaṃeva,silameva,1,1,0,0,8
6355,paṇḍukampalasilāsanaṃ,pandukampalasilasanam,1,1,0,0,21
6356,āsīnoti,asinoti,4,2,2,0,7
6357,cakkavāḷasahassehi,cakkavalasahassehi,19,19,0,0,18
6358,āgamma,agamma,896,866,30,0,6
6359,sannisinnānaṃ,sannisinnanam,65,61,4,0,13
6360,gaṇena,ganena,97,92,5,0,6
6361,parivārito,parivarito,169,164,5,0,10
6362,nisīdanto,nisidanto,60,55,5,0,9
6363,āsīdanaṃ,asidanam,2,2,0,0,8
6364,nisajjanaṃ,nisajjanam,12,12,0,0,10
6365,sīdati,sidati,47,43,4,0,6
6366,vasatīti,vasatiti,77,68,9,0,8
6367,abhidhammakathābhimukhaṃ,abhidhammakathabhimukham,1,1,0,0,24
6368,nisajjatīti,nisajjatiti,1,1,0,0,11
6369,āpubbasīdadhātu,apubbasidadhatu,1,1,0,0,15
6370,nisajjāyaṃ,nisajjayam,9,9,0,0,10
6371,visaraṇa,visarana,2,2,0,0,8
6372,gatyāvasānesu,gatyavasanesu,1,1,0,0,13
6373,īṇādeso,inadeso,1,1,0,0,7
6374,ṇassanattaṃ,nassanattam,1,1,0,0,11
6375,nibbānasukhadāyakaṃ,nibbanasukhadayakam,2,2,0,0,19
6376,sivaṃ,sivam,120,93,27,0,5
6377,rāgaggiādīhi,ragaggiadihi,11,11,0,0,12
6378,samati,samati,11,10,1,0,6
6379,upasamati,upasamati,2,2,0,0,9
6380,rivo,rivo,4,4,0,0,4
6381,abhidhānappadīpikaṭīkāyaṃ,abhidhanappadipikatikayam,1,0,1,0,25
6382,khemabhāvaṃ,khemabhavam,10,10,0,0,11
6383,saṃsārabhīrukehi,samsarabhirukehi,2,2,0,0,16
6384,sevitabbattā,sevitabbatta,8,8,0,0,12
6385,vapaccayo,vapaccayo,1,1,0,0,9
6386,yassuppajjati,yassuppajjati,19,19,0,0,13
6387,supubba,supubba,4,4,0,0,7
6388,khanudhātu,khanudhatu,2,2,0,0,10
6389,avadāraṇe,avadarane,14,13,1,0,9
6390,sivassa,sivassa,3,3,0,0,7
6391,sivasukhaṃ,sivasukham,1,1,0,0,10
6392,abhidhammadhammo,abhidhammadhammo,1,1,0,0,16
6393,sivasukhasaddūpapadadādhātu,sivasukhasaddupapadadadhatu,1,1,0,0,27
6394,abhidhammadhammaṃ,abhidhammadhammam,2,2,0,0,17
6395,suṇāti,sunati,720,710,10,0,6
6396,nibbānasukhaṃ,nibbanasukham,24,24,0,0,13
6397,nānānayavicittaṃ,nananayavicittam,10,10,0,0,16
6398,gambhīraṃ,gambhiram,192,168,24,0,9
6399,saṇhasukhumaṃ,sanhasukhumam,16,15,1,0,13
6400,duddasaṃ,duddasam,110,95,15,0,8
6401,abhidhamma,abhidhamma,10,9,1,0,10
6402,paṇḍitehi,panditehi,216,212,4,0,9
6403,dhāriyati,dhariyati,7,7,0,0,9
6404,bālehīti,balehiti,3,3,0,0,8
6405,abhidhammapiṭakaṃ,abhidhammapitakam,88,77,11,0,17
6406,rammapaccayo,rammapaccayo,3,3,0,0,12
6407,manussaloke,manussaloke,370,360,10,0,11
6408,mātubhūtadevaputtappamukhānaṃ,matubhutadevaputtappamukhanam,1,1,0,0,29
6409,aṭṭhasālinīaṭṭhakathāyaṃ,atthasaliniatthakathayam,1,0,1,0,24
6410,mātaraṃ,mataram,692,650,42,0,7
6411,M0.0092,M0.0092,80,80,0,0,7
6412,pamukhaṃ,pamukham,84,74,10,0,8
6413,tejasā,tejasa,123,111,12,0,6
6414,abhidhammakathāmaggaṃ,abhidhammakathamaggam,9,9,0,0,21
6415,sampavattayī,sampavattayi,2,2,0,0,12
6416,mātarantipadassa,matarantipadassa,2,2,0,0,16
6417,mātubhūtaṃ,matubhutam,6,6,0,0,10
6418,devaputtanti,devaputtanti,3,3,0,0,12
6419,jinālaṅkārapāḷiyaṃ,jinalankarapaliyam,1,0,1,0,18
6420,gahetvāna,gahetvana,379,370,9,0,9
6421,sakaṃ,sakam,804,711,93,0,5
6422,sattamiyaṃ,sattamiyam,30,25,5,0,10
6423,cutā,cuta,360,350,10,0,4
6424,devaputtattamāgamī,devaputtattamagami,1,1,0,0,18
6425,taṭṭīkāyañca,tattikayanca,7,4,3,0,12
6426,bodhisattamātā,bodhisattamata,52,49,3,0,14
6427,gabbhavuṭṭhānato,gabbhavutthanato,1,1,0,0,16
6428,sattame,sattame,861,849,12,0,7
6429,kālaṅkatvā,kalankatva,26,26,0,0,10
6430,tusitapure,tusitapure,68,67,1,0,10
6431,nibbattī,nibbatti,22,15,7,0,8
6432,devaputtasaddena,devaputtasaddena,2,2,0,0,16
6433,kāḷudāyī,kaludayi,29,25,4,0,8
6434,theragāthāaṭṭhakathāyañca,theragathaatthakathayanca,1,0,1,0,25
6435,parivāritāti,parivaritati,4,3,1,0,12
6436,itthiliṅganiddeso,itthilinganiddeso,11,11,0,0,17
6437,purimattabhāvasiddhaṃ,purimattabhavasiddham,2,2,0,0,21
6438,itthibhāvaṃ,itthibhavam,33,33,0,0,11
6439,devatābhāvaṃ,devatabhavam,5,5,0,0,12
6440,devūpapatti,devupapatti,7,7,0,0,11
6441,purisabhāvena,purisabhavena,8,8,0,0,13
6442,jātakaṭīkāyañca,jatakatikayanca,1,0,1,0,15
6443,devorohaneti,devorohaneti,1,1,0,0,12
6444,mātudevaputtassa,matudevaputtassa,1,1,0,0,16
6445,temāsaṃ,temasam,272,264,8,0,7
6446,desetvā,desetva,326,322,4,0,7
6447,devorohanakāle,devorohanakale,3,3,0,0,14
6448,mātudevaputtasaddena,matudevaputtasaddena,1,1,0,0,20
6449,abhidhammāvatāraṭīkāyañca,abhidhammavataratikayanca,1,0,1,0,25
6450,dhammapaṭiggāhakānaṃ,dhammapatiggahakanam,10,10,0,0,20
6451,dasasahassacakkavāḷādhivāsīnaṃ,dasasahassacakkavaladhivasinam,2,2,0,0,30
6452,mātudevaputta,matudevaputta,1,1,0,0,13
6453,sirīmahāmāyāsatthe,sirimahamayasatthe,1,0,1,0,18
6454,sirīmahāmāyā,sirimahamaya,2,2,0,0,12
6455,devīpi,devipi,39,39,0,0,6
6456,sattadivaseyeva,sattadivaseyeva,1,1,0,0,15
6457,vasitvā,vasitva,629,620,9,0,7
6458,puññānubhāvena,punnanubhavena,62,62,0,0,14
6459,tusitabhavane,tusitabhavane,48,48,0,0,13
6460,maṇidīpaṭīkāyañca,manidipatikayanca,1,0,1,0,17
6461,mātaranti,mataranti,4,4,0,0,9
6462,vijāyitvā,vijayitva,46,46,0,0,9
6463,sattāhamattaṃ,sattahamattam,25,23,2,0,13
6464,cavitvā,cavitva,441,432,9,0,7
6465,purisabhāveneva,purisabhaveneva,3,3,0,0,15
6466,itthibhāvenā,itthibhavena,1,1,0,0,12
6467,madhusārattha,madhusarattha,1,0,1,0,13
6468,dīpanīṭīkāyaṃ,dipanitikayam,1,0,1,0,13
6469,suddhodano,suddhodano,63,59,4,0,10
6470,māyā,maya,216,180,36,0,4
6471,M0.0093,M0.0093,79,79,0,0,7
6472,parihariya,parihariya,5,5,0,0,10
6473,kucchinā,kucchina,41,41,0,0,8
6474,bhedā,bheda,1408,1384,24,0,5
6475,tidivasmiṃ,tidivasmim,3,3,0,0,10
6476,modati,modati,83,81,2,0,6
6477,gotamī,gotami,152,148,4,0,6
6478,kālaṃkatā,kalamkata,2,2,0,0,9
6479,dibbehi,dibbehi,216,214,2,0,7
6480,kāmehi,kamehi,816,794,22,0,6
6481,samaṅgibhūtā,samangibhuta,18,18,0,0,12
6482,āmodati,amodati,3,2,1,0,7
6483,kāmaguṇehi,kamagunehi,169,169,0,0,10
6484,parivāritā,parivarita,48,46,2,0,10
6485,devagaṇehi,devaganehi,7,7,0,0,10
6486,tehī,tehi,20,17,3,0,4
6487,therāpāḷi,therapali,1,0,1,0,9
6488,purimatta,purimatta,1,1,0,0,9
6489,bhāvasiddhaṃ,bhavasiddham,1,1,0,0,12
6490,jātāti,jatati,188,167,21,0,6
6491,manussattabhāvavasena,manussattabhavavasena,1,1,0,0,21
6492,theraṭṭhakathā,theratthakatha,1,1,0,0,14
6493,nasaṅgahāruḷhā,nasangaharulha,1,1,0,0,14
6494,aññaṭṭhakathāṭīkāsu,annatthakathatikasu,1,1,0,0,19
6495,patthanākāle,patthanakale,2,2,0,0,12
6496,buddhamātā,buddhamata,21,21,0,0,10
6497,homīti,homiti,54,43,11,0,6
6498,patthanā,patthana,375,360,15,0,8
6499,tiṃsadhammatāyañca,timsadhammatayanca,1,1,0,0,18
6500,buddhamātuyā,buddhamatuya,1,1,0,0,12
6501,purisabhāvo,purisabhavo,16,16,0,0,11
6502,vīmaṃsitabbantipi,vimamsitabbantipi,1,1,0,0,17
6503,vidū,vidu,174,165,9,0,4
6504,saṃsayavacanena,samsayavacanena,1,1,0,0,15
6505,vīmaṃsitabbanti,vimamsitabbanti,10,10,0,0,15
6506,vidūvadantīti,viduvadantiti,1,1,0,0,13
6507,yathāvuttaṭṭhakathāṭīkāvacanehi,yathavuttatthakathatikavacanehi,1,1,0,0,31
6508,ujukaṃ,ujukam,222,211,11,0,6
6509,viruddhattā,viruddhatta,31,31,0,0,11
6510,devatāsaddo,devatasaddo,1,1,0,0,11
6511,devaputte,devaputte,30,28,2,0,9
6512,brahme,brahme,227,217,10,0,6
6513,devadhītāya,devadhitaya,17,17,0,0,11
6514,tathāhesa,tathahesa,12,12,0,0,9
6515,aññatarā,annatara,282,272,10,0,8
6516,abhikkantāya,abhikkantaya,126,112,14,0,12
6517,abhikkantavaṇṇā,abhikkantavanna,60,60,0,0,15
6518,itiādīsu,itiadisu,4187,4186,1,0,8
6519,khuddakapāṭhaaṭṭhakathāyaṃ,khuddakapathaatthakathayam,1,0,1,0,26
6520,aññatarāti,annatarati,9,5,4,0,10
6521,aniyamita,aniyamita,1,1,0,0,9
6522,niddeso,niddeso,476,456,20,0,7
6523,nāmagottato,namagottato,8,8,0,0,11
6524,apākaṭā,apakata,36,32,4,0,7
6525,devoyeva,devoyeva,7,7,0,0,8
6526,itthipurisasādhāraṇamevetaṃ,itthipurisasadharanamevetam,1,1,0,0,27
6527,purisoeva,purisoeva,2,2,0,0,9
6528,kintusādhāraṇanāmavasena,kintusadharananamavasena,1,1,0,0,24
6529,devatāti,devatati,79,37,42,0,8
6530,sunītattheraapadāna,sunitattheraapadana,1,0,1,0,19
6531,āgatāsu,agatasu,14,14,0,0,7
6532,sattasatā,sattasata,73,71,2,0,9
6533,uḷārā,ulara,111,107,4,0,5
6534,vimānā,vimana,24,22,2,0,6
6535,abhinikkhamitvā,abhinikkhamitva,26,24,2,0,15
6536,padīpavimānavatthupāḷiyaṃ,padipavimanavatthupaliyam,1,0,1,0,25
6537,vuttāsu,vuttasu,33,32,1,0,7
6538,abhikkantena,abhikkantena,122,103,19,0,12
6539,vaṇṇena,vannena,391,378,13,0,7
6540,devate,devate,187,186,1,0,6
6541,obhāsentī,obhasenti,45,43,2,0,9
6542,osadhī,osadhi,74,70,4,0,6
6543,tārakā,taraka,95,90,5,0,6
6544,ādīsu,adisu,257,251,6,0,5
6545,M0.0094,M0.0094,80,80,0,0,7
6546,parivāritāsaddopi,parivaritasaddopi,1,1,0,0,17
6547,ācariyadhammapālattherena,acariyadhammapalattherena,74,17,57,0,25
6548,katāya,kataya,176,174,2,0,6
6549,theraṭṭhakathāya,theratthakathaya,1,1,0,0,16
6550,jātakaṭīkāya,jatakatikaya,1,1,0,0,12
6551,vuttavacanañca,vuttavacananca,5,5,0,0,14
6552,ācariyasumaṅgalattherena,acariyasumangalattherena,1,1,0,0,24
6553,abhidhammāvatāraṭīkāya,abhidhammavataratikaya,25,25,0,0,22
6554,mātudevaputtoti,matudevaputtoti,1,1,0,0,15
6555,atthoyeva,atthoyeva,29,29,0,0,9
6556,etarahi,etarahi,1430,1402,28,0,7
6557,ācariyā,acariya,497,488,9,0,7
6558,therāpāḷiyaṃ,therapaliyam,1,1,0,0,12
6559,parivāritāsaddañca,parivaritasaddanca,1,1,0,0,18
6560,madhusāratthadīpanīṭīkāvacanañca,madhusaratthadipanitikavacananca,1,1,0,0,32
6561,mātudevadhītāti,matudevadhitati,1,1,0,0,15
6562,matimattanti,matimattanti,7,7,0,0,12
6563,mahākaruṇāpubbaṅgamena,mahakarunapubbangamena,1,1,0,0,22
6564,sabbaññutañāṇena,sabbannutananena,16,16,0,0,16
6565,kathesi,kathesi,2185,2161,24,0,7
6566,tanti,tanti,286,272,14,0,5
6567,appaṭipuggalaṃ,appatipuggalam,17,12,5,0,14
6568,paṭipuggaloti,patipuggaloti,14,6,8,0,13
6569,sīlādiguṇena,siladigunena,9,9,0,0,12
6570,tenāha,tenaha,6527,6505,22,0,6
6571,vinayamahāvaggapāḷiyaṃ,vinayamahavaggapaliyam,1,0,1,0,22
6572,ācariyo,acariyo,945,903,42,0,7
6573,vijjati,vijjati,1532,1507,25,0,7
6574,sadevakasmiṃ,sadevakasmim,27,27,0,0,12
6575,lokasmiṃ,lokasmim,854,790,64,0,8
6576,paṭipuggalo,patipuggalo,33,33,0,0,11
6577,itisatataṃ,itisatatam,1,1,0,0,10
6578,samitaṃ,samitam,130,113,17,0,7
6579,sabbakālaṃ,sabbakalam,366,358,8,0,10
6580,nirantaranti,nirantaranti,3,3,0,0,12
6581,sundarasabbaññuta,sundarasabbannuta,1,1,0,0,17
6582,ñāṇavāto,nanavato,1,1,0,0,8
6583,sūriyoiva,suriyoiva,1,1,0,0,9
6584,atappakapīti,atappakapiti,1,1,0,0,12
6585,somanassuppādane,somanassuppadane,1,1,0,0,16
6586,paṇḍu,pandu,39,29,10,0,5
6587,kampalanāmake,kampalanamake,1,1,0,0,13
6588,pubbadevaputtappamukhānaṃ,pubbadevaputtappamukhanam,1,1,0,0,25
6589,satataṃ,satatam,308,267,41,0,7
6590,terasamavandanagāthāvaṇṇanā,terasamavandanagathavannana,1,1,0,0,27
6591,M0.0095,M0.0095,82,82,0,0,7
6592,terasamagāthāya,terasamagathaya,2,2,0,0,15
6593,pādatale,padatale,18,18,0,0,8
6594,vicittappavattehi,vicittappavattehi,1,1,0,0,17
6595,aṭṭhasatacakkalakkhaṇehi,atthasatacakkalakkhanehi,1,1,0,0,24
6596,pādapaṅkaja,padapankaja,3,2,1,0,11
6597,bha,bha,84,52,32,0,3
6598,garudvayena,garudvayena,3,3,0,0,11
6599,cuddasakkharehi,cuddasakkharehi,2,2,0,0,15
6600,vasantatilakāgāthāti,vasantatilakagathati,3,3,0,0,20
6601,vasantatilakā,vasantatilaka,3,2,1,0,13
6602,jā,ja,1717,1702,15,0,2
6603,tassāyamattho,tassayamattho,13,13,0,0,13
6604,chandācariyehi,chandacariyehi,1,1,0,0,14
6605,avikalehi,avikalehi,4,4,0,0,9
6606,pādapaṅkajamuduttalehitīhi,padapankajamuduttalehitihi,1,1,0,0,26
6607,nirupameyyataṃ,nirupameyyatam,7,6,1,0,14
6608,sampāpuṇeeva,sampapuneeva,2,2,0,0,12
6609,nāthaṃ,natham,44,32,12,0,6
6610,saddakkamena,saddakkamena,6,6,0,0,12
6611,adassetvā,adassetva,79,79,0,0,9
6612,atthakkamena,atthakkamena,6,6,0,0,12
6613,vaṇṇanaṃ,vannanam,51,50,1,0,8
6614,dassayissāma,dassayissama,47,47,0,0,12
6615,nāthoti,nathoti,16,7,9,0,7
6616,paṭisaraṇo,patisarano,9,9,0,0,10
6617,sampāpuṇeevātipade,sampapuneevatipade,1,1,0,0,18
6618,kattubhāvena,kattubhavena,22,21,1,0,12
6619,sambandhitabbaṃ,sambandhitabbam,267,267,0,0,15
6620,nāthassa,nathassa,19,19,0,0,8
6621,avikalehīti,avikalehiti,1,0,1,0,11
6622,avekallehi,avekallehi,2,2,0,0,10
6623,sabbapādacakkalakkhaṇehi,sabbapadacakkalakkhanehi,1,1,0,0,24
6624,sampuṇṇehīti,sampunnehiti,1,1,0,0,12
6625,kalati,kalati,7,7,0,0,6
6626,vikalo,vikalo,7,7,0,0,6
6627,vipubbakaladhātu,vipubbakaladhatu,1,1,0,0,16
6628,vikalaṃ,vikalam,12,10,2,0,7
6629,etissā,etissa,284,279,5,0,6
6630,rājiyāti,rajiyati,1,1,0,0,8
6631,avikalā,avikala,1,1,0,0,7
6632,pādarāji,padaraji,3,3,0,0,8
6633,pādadvaye,padadvaye,1,1,0,0,9
6634,paribyattaṃ,paribyattam,19,18,1,0,11
6635,saṇṭhānarūpaṃ,santhanarupam,1,1,0,0,13
6636,nirākulehīti,nirakulehiti,1,0,1,0,12
6637,M0.0096,M0.0096,80,80,0,0,7
6638,ākulavirahitehi,akulavirahitehi,2,2,0,0,15
6639,pādacakkalakkhaṇānaṃ,padacakkalakkhananam,1,1,0,0,20
6640,aññamaññaṃ,annamannam,2052,1971,81,0,10
6641,asaṃmissehi,asammissehi,1,1,0,0,11
6642,asaṃsaṭṭhehīti,asamsatthehiti,1,1,0,0,14
6643,kulati,kulati,12,12,0,0,6
6644,bandhatīti,bandhatiti,66,52,14,0,10
6645,ākulaṃ,akulam,35,35,0,0,6
6646,āpubba,apubba,8,8,0,0,6
6647,kuladhātu,kuladhatu,1,1,0,0,9
6648,āvarati,avarati,4,4,0,0,7
6649,sobhananti,sobhananti,1,1,0,0,10
6650,aññamaññamissaṃ,annamannamissam,1,1,0,0,15
6651,nirākulā,nirakula,9,9,0,0,8
6652,pādapaṅkajamuduttalarājikehītipade,padapankajamuduttalarajikehitipade,1,1,0,0,34
6653,pādapaṅkajamuduttalarājikehīti,padapankajamuduttalarajikehiti,1,0,1,0,30
6654,pādasaṅkhātapadumassa,padasankhatapadumassa,2,2,0,0,21
6655,saṇha,sanha,2,2,0,0,5
6656,tale,tale,35,35,0,0,4
6657,aṭṭhasatacakkalakkhaṇarājikehi,atthasatacakkalakkhanarajikehi,2,2,0,0,30
6658,padati,padati,5,5,0,0,6
6659,pādo,pado,224,197,27,0,4
6660,padadhātu,padadhatu,4,4,0,0,9
6661,gatimhiṇa,gatimhina,1,1,0,0,9
6662,paṅke,panke,49,42,7,0,5
6663,kaddame,kaddame,36,36,0,0,7
6664,paṅkajaṃ,pankajam,17,17,0,0,8
6665,pādasaṅkhātaṃ,padasankhatam,1,1,0,0,13
6666,pādapaṅkajaṃ,padapankajam,3,3,0,0,12
6667,paṅkajaṃiva,pankajamiva,1,1,0,0,11
6668,saṇhabhāvena,sanhabhavena,4,4,0,0,12
6669,mudati,mudati,2,2,0,0,6
6670,mudu,mudu,152,137,15,0,4
6671,mudadhātu,mudadhatu,3,3,0,0,9
6672,talati,talati,4,4,0,0,6
6673,talaṃ,talam,35,25,10,0,5
6674,taladhātu,taladhatu,1,1,0,0,9
6675,talañcāti,talancati,1,1,0,0,9
6676,muduttalaṃ,muduttalam,2,2,0,0,10
6677,pādapaṅkajassa,padapankajassa,1,1,0,0,14
6678,pādapaṅkajamuduttalaṃ,padapankajamuduttalam,1,1,0,0,21
6679,rājati,rajati,15,14,1,0,6
6680,rājikā,rajika,3,3,0,0,6
6681,rājadhātu,rajadhatu,1,1,0,0,9
6682,sobhane,sobhane,38,37,1,0,7
6683,muduttale,muduttale,1,1,0,0,9
6684,aṭṭhasatacakkalakkhaṇasaṅkhātaṃ,atthasatacakkalakkhanasankhatam,1,1,0,0,31
6685,rājikanti,rajikanti,1,1,0,0,9
6686,pādapaṅkajamuduttalarājikaṃ,padapankajamuduttalarajikam,1,1,0,0,27
6687,aṭṭhasatapādacakkalakkhaṇaṃ,atthasatapadacakkalakkhanam,1,1,0,0,27
6688,nāmevaṃ,namevam,3,3,0,0,7
6689,pādapaṅkajamudutalassa,padapankajamudutalassa,1,1,0,0,22
6690,nābhi,nabhi,54,43,11,0,5
6691,nābhipaṭicchinnā,nabhipaticchinna,1,1,0,0,16
6692,vaṭṭalekhā,vattalekha,12,12,0,0,10
6693,nābhimukhaparikkhepapaṭṭo,nabhimukhaparikkhepapatto,3,3,0,0,25
6694,panāḷimukhaṃ,panalimukham,3,3,0,0,12
6695,arā,ara,35,32,3,0,3
6696,dissanti,dissanti,616,604,12,0,8
6697,aresu,aresu,5,5,0,0,5
6698,nemi,nemi,35,31,4,0,4
6699,nemimaṇikā,nemimanika,3,3,0,0,10
6700,pāḷiāgatameva,paliagatameva,4,4,0,0,13
6701,sampahulavāro,sampahulavaro,1,1,0,0,13
6702,anāgato,anagato,150,139,11,0,7
6703,sirīvaccho,sirivaccho,5,5,0,0,10
6704,nandiyāvaṭṭaṃ,nandiyavattam,7,5,2,0,13
6705,sovattiko,sovattiko,5,5,0,0,9
6706,vaṭaṃsako,vatamsako,11,8,3,0,9
6707,vaḍḍhamānakaṃ,vaddhamanakam,8,6,2,0,13
6708,macchayugalaṃ,macchayugalam,2,2,0,0,13
6709,bhaddapīṭhaṃ,bhaddapitham,21,17,4,0,12
6710,aṅkusaṃ,ankusam,28,26,2,0,7
6711,tomaro,tomaro,8,6,2,0,6
6712,pāsādo,pasado,235,220,15,0,6
6713,toraṇaṃ,toranam,15,14,1,0,7
6714,khaggo,khaggo,22,19,3,0,6
6715,tālavaṇḍaṃ,talavandam,2,2,0,0,10
6716,morahatthako,morahatthako,4,4,0,0,12
6717,vāḷabījani,valabijani,2,2,0,0,10
6718,uṇhīsaṃ,unhisam,31,25,6,0,7
6719,M0.0097,M0.0097,76,76,0,0,7
6720,maṇikusumadāmaṃ,manikusumadamam,1,1,0,0,15
6721,nīluppalaṃ,niluppalam,25,24,1,0,10
6722,rattuppalaṃ,rattuppalam,5,5,0,0,11
6723,setuppalaṃ,setuppalam,3,3,0,0,10
6724,puṇḍarikaṃ,pundarikam,5,5,0,0,10
6725,puṇṇaghaṭo,punnaghato,4,4,0,0,10
6726,puṇṇapāti,punnapati,5,5,0,0,9
6727,cakkavāḷaṃ,cakkavalam,98,88,10,0,10
6728,himavā,himava,95,87,8,0,6
6729,sineru,sineru,61,57,4,0,6
6730,nakkhattāni,nakkhattani,48,44,4,0,11
6731,mahādīpā,mahadipa,9,7,2,0,8
6732,dveparittadīpasahassāni,dveparittadipasahassani,2,2,0,0,23
6733,antamaso,antamaso,1020,958,62,0,8
6734,rañño,ranno,4786,4715,71,0,5
6735,sabbo,sabbo,887,808,79,0,5
6736,cakkalakkhaṇasseva,cakkalakkhanasseva,5,4,1,0,18
6737,parivāroti,parivaroti,10,6,4,0,10
6738,ettakameva,ettakameva,343,333,10,0,10
6739,majjhimapaṇṇāsaṭṭhakathāyaṃ,majjhimapannasatthakathayam,1,0,1,0,27
6740,jinālaṅkāraṭīkāyaṃ,jinalankaratikayam,2,0,2,0,18
6741,jātānīti,jataniti,14,14,0,0,8
6742,cakkalakkhaṇaṃ,cakkalakkhanam,11,8,3,0,14
6743,dvīsu,dvisu,1945,1870,75,0,5
6744,pādatalesu,padatalesu,35,34,1,0,10
6745,ekekasmiṃ,ekekasmim,387,375,12,0,9
6746,sahassamattā,sahassamatta,37,37,0,0,12
6747,nemivalayaṃ,nemivalayam,1,1,0,0,11
6748,suvaṇṇavaṇṇaṃ,suvannavannam,173,155,18,0,13
6749,indanīlamaṇivaṇṇā,indanilamanivanna,1,1,0,0,17
6750,nābhipariyante,nabhipariyante,1,1,0,0,14
6751,nābhimukhe,nabhimukhe,3,3,0,0,10
6752,chiddaṃ,chiddam,220,196,24,0,7
6753,cakkapariyante,cakkapariyante,1,1,0,0,14
6754,nemito,nemito,1,1,0,0,6
6755,vaṭṭe,vatte,92,83,9,0,5
6756,vaṭaṃsakaṃ,vatamsakam,28,25,3,0,10
6757,pāsādaṃ,pasadam,369,356,13,0,7
6758,mayūrahatthaṃ,mayurahattham,1,1,0,0,13
6759,cāmaraṃ,camaram,7,6,1,0,7
6760,sumanadāmaṃ,sumanadamam,4,4,0,0,11
6761,rattapadumaṃ,rattapadumam,3,3,0,0,12
6762,setapadumaṃ,setapadumam,6,6,0,0,11
6763,puṇṇakalasaṃ,punnakalasam,1,1,0,0,12
6764,puṇṇapattaṃ,punnapattam,24,17,7,0,11
6765,cakkavāḷapabbato,cakkavalapabbato,7,7,0,0,16
6766,himavantapabbato,himavantapabbato,14,14,0,0,16
6767,merupabbato,merupabbato,1,1,0,0,11
6768,sūriyamaṇḍalaṃ,suriyamandalam,50,47,3,0,14
6769,candamaṇḍalaṃ,candamandalam,86,82,4,0,13
6770,nakkhattaṃ,nakkhattam,221,204,17,0,10
6771,saparivārā,saparivara,41,41,0,0,10
6772,catumahādīpā,catumahadipa,1,1,0,0,12
6773,saparivāro,saparivaro,94,92,2,0,10
6774,sattaratanasamaṅgī,sattaratanasamangi,1,1,0,0,18
6775,dakkhiṇāvaṭṭa,dakkhinavatta,1,1,0,0,13
6776,setasaṅkhaṃ,setasankham,1,1,0,0,11
6777,suvaṇṇamacchayugaḷaṃ,suvannamacchayugalam,1,1,0,0,20
6778,sattamahāgaṅgā,sattamahaganga,1,1,0,0,14
6779,sattakulapabbatā,sattakulapabbata,1,1,0,0,16
6780,sattasīdantasāgarā,sattasidantasagara,1,1,0,0,18
6781,haṃsarājā,hamsaraja,44,43,1,0,9
6782,saṃsumāro,samsumaro,8,8,0,0,9
6783,dhajapaṭāko,dhajapatako,1,1,0,0,11
6784,suvaṇṇasivikā,suvannasivika,2,2,0,0,13
6785,suvaṇṇavāḷabījani,suvannavalabijani,1,1,0,0,17
6786,kelāsapabbato,kelasapabbato,2,2,0,0,13
6787,sīharājā,siharaja,8,8,0,0,8
6788,byaggharājā,byaggharaja,6,6,0,0,11
6789,valāhakaassarājā,valahakaassaraja,2,2,0,0,16
6790,uposathachaddantahatthirājā,uposathachaddantahatthiraja,1,1,0,0,27
6791,vāsukīnāgarājā,vasukinagaraja,1,1,0,0,14
6792,usabharājā,usabharaja,2,2,0,0,10
6793,erāvaṇa,eravana,2,2,0,0,7
6794,hatthirājā,hatthiraja,9,9,0,0,10
6795,suvaṇṇamakaraṃ,suvannamakaram,1,1,0,0,14
6796,catumukhasuvaṇṇanāvā,catumukhasuvannanava,1,1,0,0,20
6797,savacchakā,savacchaka,1,1,0,0,10
6798,dhenu,dhenu,41,37,4,0,5
6799,kiṃpuriso,kimpuriso,3,3,0,0,9
6800,kinnarī,kinnari,19,19,0,0,7
6801,karavīko,karaviko,24,21,3,0,8
6802,mayūrarājā,mayuraraja,2,2,0,0,10
6803,koñcarājā,koncaraja,1,1,0,0,9
6804,cakkavākarājā,cakkavakaraja,1,1,0,0,13
6805,jīvañjīvakarājā,jivanjivakaraja,1,1,0,0,15
6806,cha,cha,4471,4185,286,0,3
6807,devalokā,devaloka,115,111,4,0,8
6808,M0.0098,M0.0098,81,81,0,0,7
6809,brahmalokāti,brahmalokati,6,1,5,0,12
6810,aggamaṅgalalakkhaṇā,aggamangalalakkhana,1,1,0,0,19
6811,paññāyantī,pannayanti,20,14,6,0,10
6812,vacanena,vacanena,1024,1015,9,0,8
6813,aṭṭhasata,atthasata,2,2,0,0,9
6814,pādacakkalakkhaṇaṃ,padacakkalakkhanam,4,4,0,0,18
6815,veditabbanti,veditabbanti,247,247,0,0,12
6816,lokehīti,lokehiti,2,2,0,0,8
6817,kāmarūpārūpa,kamaruparupa,2,2,0,0,12
6818,panetaṃ,panetam,1417,1326,91,0,7
6819,katvatthe,katvatthe,9,9,0,0,9
6820,karaṇavacanaṃ,karanavacanam,318,310,8,0,13
6821,nirupameyyāti,nirupameyyati,1,1,0,0,13
6822,padena,padena,536,526,10,0,6
6823,appameyyabhāvaṃ,appameyyabhavam,3,3,0,0,15
6824,upamitabbanti,upamitabbanti,1,1,0,0,13
6825,upameyyaṃ,upameyyam,17,17,0,0,9
6826,upapubba,upapubba,2,2,0,0,8
6827,pamāne,pamane,1,1,0,0,6
6828,upameyyassa,upameyyassa,5,5,0,0,11
6829,upameyyataṃ,upameyyatam,2,2,0,0,11
6830,rājikassāti,rajikassati,2,2,0,0,11
6831,nirupameyyo,nirupameyyo,1,1,0,0,11
6832,pādacakkalakkhaṇarājiko,padacakkalakkhanarajiko,1,1,0,0,23
6833,evātipade,evatipade,1,1,0,0,9
6834,sampāpuṇeevāti,sampapuneevati,1,1,0,0,14
6835,gacchatievāti,gacchatievati,1,1,0,0,13
6836,pādapaṅkajamudutalehi,padapankajamudutalehi,1,1,0,0,21
6837,buddhato,buddhato,31,27,4,0,8
6838,aññassa,annassa,1384,1303,81,0,7
6839,devamanussassa,devamanussassa,2,2,0,0,14
6840,pādatalamajjhe,padatalamajjhe,1,1,0,0,14
6841,pādacakkalakkhaṇassa,padacakkalakkhanassa,1,1,0,0,20
6842,pādapaṅkajamudutale,padapankajamudutale,1,1,0,0,19
6843,pāramipuññānubhāvena,paramipunnanubhavena,1,1,0,0,20
6844,nibbattāni,nibbattani,58,58,0,0,10
6845,aṭṭhasatapādacakkalakkhaṇāni,atthasatapadacakkalakkhanani,1,1,0,0,28
6846,sampāpuṇanti,sampapunanti,7,7,0,0,12
6847,sabbalokena,sabbalokena,17,16,1,0,11
6848,pūjitaṃ,pujitam,55,53,2,0,7
6849,sabbena,sabbena,547,507,40,0,7
6850,devamanussalokena,devamanussalokena,1,1,0,0,17
6851,mahitabbo,mahitabbo,3,3,0,0,9
6852,pūjitabboti,pujitabboti,2,2,0,0,11
6853,sabbaloka,sabbaloka,7,4,3,0,9
6854,mahito,mahito,18,17,1,0,6
6855,uppanne,uppanne,634,609,25,0,7
6856,tathāgate,tathagate,332,320,12,0,9
6857,mahesakkhā,mahesakkha,68,65,3,0,10
6858,pūjenti,pujenti,101,100,1,0,7
6859,aññā,anna,767,698,69,0,4
6860,sahampati,sahampati,117,112,5,0,9
6861,sinerumattena,sinerumattena,8,8,0,0,13
6862,ratana,ratana,20,20,0,0,6
6863,dāmena,damena,12,11,1,0,6
6864,tathāgataṃ,tathagatam,655,611,44,0,10
6865,pūjeti,pujeti,56,56,0,0,6
6866,yathābalañca,yathabalanca,8,8,0,0,12
6867,aññepi,annepi,709,684,25,0,6
6868,manussā,manussa,2669,2616,53,0,7
6869,bimbisārakosalarājādayo,bimbisarakosalarajadayo,6,6,0,0,23
6870,nibbutampi,nibbutampi,3,3,0,0,10
6871,bhagavantaṃ,bhagavantam,5142,5059,83,0,11
6872,uddissa,uddissa,927,898,29,0,7
6873,channavutikoṭidhanaṃ,channavutikotidhanam,11,11,0,0,20
6874,vissajjetvā,vissajjetva,488,483,5,0,11
6875,asoka,asoka,6,5,1,0,5
6876,mahārājā,maharaja,667,652,15,0,8
6877,M0.0099,M0.0099,78,78,0,0,7
6878,sakalajambudīpe,sakalajambudipe,220,218,2,0,15
6879,caturāsītivihārasahassāni,caturasitiviharasahassani,12,12,0,0,25
6880,patiṭṭhāpeti,patitthapeti,138,137,1,0,12
6881,pūjāti,pujati,10,4,6,0,6
6882,sabbamanussadevabrahmehi,sabbamanussadevabrahmehi,2,2,0,0,24
6883,appaṭipuggalanti,appatipuggalanti,1,1,0,0,16
6884,asītianubyañjanapaṭimaṇḍita,asitianubyanjanapatimandita,1,1,0,0,27
6885,mahāpurisalakkhaṇa,mahapurisalakkhana,2,2,0,0,18
6886,sabbākāra,sabbakara,4,2,2,0,9
6887,parisuddha,parisuddha,2,2,0,0,10
6888,sīlakkhandhādiguṇaratanasamiddhadhammakāyo,silakkhandhadigunaratanasamiddhadhammakayo,1,1,0,0,42
6889,puññamahatta,punnamahatta,1,1,0,0,12
6890,thāmamahattaiddhimahatta,thamamahattaiddhimahatta,1,1,0,0,24
6891,yasamahatta,yasamahatta,1,1,0,0,11
6892,paññāmahattānaṃ,pannamahattanam,1,1,0,0,15
6893,paramukkaṃsa,paramukkamsa,1,1,0,0,12
6894,tathāgatena,tathagatena,515,505,10,0,11
6895,muduttalarājikehi,muduttalarajikehi,1,1,0,0,17
6896,saṇhatale,sanhatale,1,1,0,0,9
6897,kattubhūtehi,kattubhutehi,7,7,0,0,12
6898,appamitabba,appamitabba,1,1,0,0,11
6899,gacchatieva,gacchatieva,1,1,0,0,11
6900,cuddasamavandanagāthāvaṇṇanā,cuddasamavandanagathavannana,1,1,0,0,28
6901,M0.0100,M0.0100,78,78,0,0,7
6902,cuddasamagāthāya,cuddasamagathaya,2,2,0,0,16
6903,narānarasa,naranarasa,1,1,0,0,10
6904,mosaraṇantyādīhi,mosaranantyadihi,1,1,0,0,16
6905,tabhajajagaṇehi,tabhajajaganehi,1,1,0,0,15
6906,naraanarasamaṃ,naraanarasamam,1,1,0,0,14
6907,osaraṇanti,osarananti,1,1,0,0,10
6908,osaraṇaṃ,osaranam,6,5,1,0,8
6909,sannipatitaṭṭhānanti,sannipatitatthananti,1,1,0,0,20
6910,narānarasaddassa,naranarasaddassa,1,1,0,0,16
6911,avasaranti,avasaranti,3,3,0,0,10
6912,sannipatanti,sannipatanti,181,180,1,0,12
6913,samosaraṇo,samosarano,3,3,0,0,10
6914,samaavapubba,samaavapubba,1,1,0,0,12
6915,narānarasamosaraṇo,naranarasamosarano,1,1,0,0,18
6916,mahānigrodho,mahanigrodho,8,8,0,0,12
6917,phalakāmānaṃ,phalakamanam,1,1,0,0,12
6918,sakuṇa,sakuna,10,9,1,0,6
6919,samūhānaṃ,samuhanam,2,2,0,0,9
6920,samosaraṇaṃ,samosaranam,40,30,10,0,11
6921,lokiya,lokiya,28,25,3,0,6
6922,lokuttarasampattikāmānaṃ,lokuttarasampattikamanam,1,1,0,0,24
6923,sannipatito,sannipatito,44,43,1,0,11
6924,narānarasamosaraṇanti,naranarasamosarananti,1,1,0,0,21
6925,samāhitacittaṃ,samahitacittam,2,2,0,0,14
6926,attasaddo,attasaddo,7,7,0,0,9
6927,attasammā,attasamma,1,1,0,0,9
6928,paṇidhi,panidhi,113,101,12,0,7
6929,cātiādīsu,catiadisu,18,4,14,0,9
6930,cittavācako,cittavacako,3,3,0,0,11
6931,dhito,dhito,4,4,0,0,5
6932,adati,adati,13,13,0,0,5
6933,ādadātīti,adadatiti,17,17,0,0,9
6934,attaṃ,attam,126,114,12,0,5
6935,adadhātu,adadhatu,2,2,0,0,8
6936,ādāne,adane,48,42,6,0,5
6937,dhitaṃ,dhitam,1,1,0,0,6
6938,samāhitaṃ,samahitam,212,176,36,0,9
6939,paññāpadīpajutiyāti,pannapadipajutiyati,1,0,1,0,19
6940,arahattamaggañāṇasaṅkhātapadīpobhāsena,arahattamaggananasankhatapadipobhasena,1,1,0,0,38
6941,karaṇabhūtena,karanabhutena,94,94,0,0,13
6942,pajānātīti,pajanatiti,205,112,93,0,10
6943,sabbappakārehi,sabbappakarehi,3,3,0,0,14
6944,paññāva,pannava,59,55,4,0,7
6945,ñeyyāvaraṇappahānato,neyyavaranappahanato,6,6,0,0,20
6946,sabbapakārehi,sabbapakarehi,1,1,0,0,13
6947,M0.0101,M0.0101,78,78,0,0,7
6948,dhammasabhāvaṃ,dhammasabhavam,45,43,2,0,14
6949,dīpetīti,dipetiti,114,89,25,0,8
6950,paññāpadīpo,pannapadipo,1,1,0,0,11
6951,jotetīti,jotetiti,17,16,1,0,8
6952,paññāpadīpobhāso,pannapadipobhaso,1,1,0,0,16
6953,judhātu,judhatu,1,1,0,0,7
6954,dittiyanti,dittiyanti,1,1,0,0,10
6955,padīpoeva,padipoeva,1,1,0,0,9
6956,paññāpadīpajuti,pannapadipajuti,2,2,0,0,15
6957,paññāpadīpassa,pannapadipassa,1,1,0,0,14
6958,abhedabhedū,abhedabhedu,1,1,0,0,11
6959,pacārena,pacarena,1,1,0,0,8
6960,hanitabbaavijjāsaṅkhātamohatamaṃ,hanitabbaavijjasankhatamohatamam,1,1,0,0,32
6961,savāsanakilesappahānato,savasanakilesappahanato,1,1,0,0,23
6962,hanitabboti,hanitabboti,1,1,0,0,11
6963,vihato,vihato,65,64,1,0,6
6964,vipubbahanadhātu,vipubbahanadhatu,1,1,0,0,16
6965,andhaṃ,andham,46,39,7,0,6
6966,tamaṃ,tamam,139,116,23,0,5
6967,avijjāsaṅkhātamoho,avijjasankhatamoho,1,1,0,0,18
6968,visayasabhāvapaṭicchādanato,visayasabhavapaticchadanato,4,4,0,0,27
6969,andhakārasarikkhakatāya,andhakarasarikkhakataya,1,1,0,0,23
6970,moho,moho,1532,1473,59,0,4
6971,andhakāroti,andhakaroti,5,4,1,0,11
6972,paññācakkhuandhaṃ,pannacakkhuandham,1,1,0,0,17
6973,andhasaddūpapada,andhasaddupapada,1,1,0,0,16
6974,vihatandhakāro,vihatandhakaro,2,2,0,0,14
6975,padīpo,padipo,164,157,7,0,6
6976,jutiyā,jutiya,14,14,0,0,6
6977,hanati,hanati,254,248,6,0,6
6978,arahattamaggapaññāpi,arahattamaggapannapi,1,1,0,0,20
6979,avijjandhakāraṃ,avijjandhakaram,25,23,2,0,15
6980,hanatīti,hanatiti,41,36,5,0,8
6981,hīnūpamāti,hinupamati,4,4,0,0,10
6982,paññāvato,pannavato,3,3,0,0,9
6983,ekapallaṅkenapi,ekapallankenapi,2,2,0,0,15
6984,nisinnassa,nisinnassa,501,495,6,0,10
6985,ekapajjotā,ekapajjota,6,5,1,0,10
6986,cattārome,cattarome,338,320,18,0,9
6987,pajjotā,pajjota,15,15,0,0,7
6988,katame,katame,2953,2853,100,0,6
6989,candapajjoto,candapajjoto,3,3,0,0,12
6990,sūriyapajjoto,suriyapajjoto,3,3,0,0,13
6991,aggipajjoto,aggipajjoto,3,3,0,0,11
6992,pajjoto,pajjoto,34,32,2,0,7
6993,etadaggaṃ,etadaggam,307,285,22,0,9
6994,imesaṃ,imesam,2309,2222,87,0,6
6995,pajjotānaṃ,pajjotanam,8,7,1,0,10
6996,vihatandhakāranti,vihatandhakaranti,2,2,0,0,17
6997,paññāpadīpa,pannapadipa,1,1,0,0,11
6998,jutiyātiiminā,jutiyatiimina,1,1,0,0,13
6999,pāramīñāṇañca,paraminananca,3,3,0,0,13
7000,vipassanāñāṇañca,vipassananananca,11,11,0,0,16
7001,heṭṭhimamaggaphala,hetthimamaggaphala,1,1,0,0,18
7002,taddīpakena,taddipakena,1,1,0,0,11
7003,avijjandhakārappahānaṃ,avijjandhakarappahanam,1,1,0,0,22
7004,phalañāṇalabhanaṃ,phalananalabhanam,1,1,0,0,17
7005,vibhāvanena,vibhavanena,6,6,0,0,11
7006,M0.0102,M0.0102,77,77,0,0,7
7007,sabbaññutañāṇādisabbabuddhaguṇalabhanaṃ,sabbannutananadisabbabuddhagunalabhanam,1,1,0,0,39
7008,tatiya,tatiya,31,29,2,0,6
7009,ānubhāveti,anubhaveti,1,1,0,0,10
7010,sabbesampi,sabbesampi,476,467,9,0,10
7011,khīṇāsavānaṃ,khinasavanam,224,215,9,0,12
7012,vihatandhakāratā,vihatandhakarata,1,1,0,0,16
7013,aññasādhāraṇāvisesa,annasadharanavisesa,1,1,0,0,19
7014,katāti,katati,229,188,41,0,6
7015,savāsanappahānena,savasanappahanena,8,8,0,0,17
7016,anaññasādhāraṇavisesatāya,anannasadharanavisesataya,1,1,0,0,25
7017,sambhavato,sambhavato,256,252,4,0,10
7018,vihatandhakāratte,vihatandhakaratte,1,1,0,0,17
7019,ariyasāvakapaccekabuddhānaṃ,ariyasavakapaccekabuddhanam,1,1,0,0,27
7020,kilesappahānaṃ,kilesappahanam,67,64,3,0,14
7021,sammāsambuddhānaṃyeva,sammasambuddhanamyeva,2,2,0,0,21
7022,kilesappahānassa,kilesappahanassa,11,11,0,0,16
7023,vijjatīti,vijjatiti,247,160,87,0,9
7024,sātisayavasena,satisayavasena,1,1,0,0,14
7025,avijjandhakārappahānena,avijjandhakarappahanena,1,1,0,0,23
7026,atthābhikāmaṃ,atthabhikamam,3,2,1,0,13
7027,sattalokassa,sattalokassa,53,53,0,0,12
7028,ativiya,ativiya,1222,1198,24,0,7
7029,icchantaṃ,icchantam,9,9,0,0,9
7030,asati,asati,1429,1399,30,0,5
7031,bhavatīti,bhavatiti,347,323,24,0,9
7032,asadhātu,asadhatu,4,4,0,0,8
7033,bhuvimhi,bhuvimhi,2,2,0,0,8
7034,tha,tha,370,326,44,0,3
7035,abhiatirekaṃ,abhiatirekam,3,3,0,0,12
7036,kāmeti,kameti,68,30,38,0,6
7037,atthābhikāmo,atthabhikamo,1,1,0,0,12
7038,atthasaddūpapada,atthasaddupapada,1,1,0,0,16
7039,abhipubbakamudhātu,abhipubbakamudhatu,2,2,0,0,18
7040,naradevahitāvahaṃ,naradevahitavaham,3,2,1,0,17
7041,dhārakaṃ,dharakam,5,5,0,0,8
7042,nariyati,nariyati,2,2,0,0,8
7043,niyyatīti,niyyatiti,3,2,1,0,9
7044,niyyati,niyyati,23,22,1,0,7
7045,jhānābhiññacittissariyādīhi,jhanabhinnacittissariyadihi,1,1,0,0,27
7046,viharantīti,viharantiti,50,31,19,0,11
7047,kīḷādīsu,kiladisu,2,2,0,0,8
7048,vaḍḍhatīti,vaddhatiti,92,77,15,0,10
7049,āvahatīti,avahatiti,51,50,1,0,9
7050,naradevahitāvaho,naradevahitavaho,1,1,0,0,16
7051,naradevahitasaddūpapadaāpubba,naradevahitasaddupapadaapubba,1,1,0,0,29
7052,vahadhātu,vahadhatu,3,3,0,0,9
7053,haraṇe,harane,44,43,1,0,6
7054,sabbadevamanussānaṃ,sabbadevamanussanam,14,14,0,0,19
7055,lokiyalokuttarasampattiatthaṃ,lokiyalokuttarasampattiattham,1,1,0,0,29
7056,kāruṇikamaggamananta,karunikamaggamananta,1,0,1,0,20
7057,M0.0103,M0.0103,77,77,0,0,7
7058,aggaṃ,aggam,449,383,66,0,5
7059,anantañāṇantipadacchedo,anantananantipadacchedo,1,1,0,0,23
7060,mahākaruṇavantaṃ,mahakarunavantam,2,2,0,0,16
7061,kiratīti,kiratiti,19,18,1,0,8
7062,kiradhātu,kiradhatu,1,1,0,0,9
7063,apanayane,apanayane,11,7,4,0,9
7064,uṇapaccayo,unapaccayo,2,2,0,0,10
7065,paradukkhaṃ,paradukkham,28,28,0,0,11
7066,vikkhipati,vikkhipati,73,69,4,0,10
7067,kinātīti,kinatiti,2,2,0,0,8
7068,kidhātu,kidhatu,1,1,0,0,7
7069,ruṇapaccayo,runapaccayo,1,1,0,0,11
7070,paradukkhe,paradukkhe,33,31,2,0,10
7071,vibādhatīti,vibadhatiti,22,21,1,0,11
7072,sādhūnaṃ,sadhunam,88,84,4,0,8
7073,hadayakampanaṃ,hadayakampanam,11,9,2,0,14
7074,kaṃ,kam,3364,3306,58,0,3
7075,rundhatīti,rundhatiti,22,22,0,0,10
7076,kaṃsaddūpapada,kamsaddupapada,2,2,0,0,14
7077,yupaccayo,yupaccayo,6,6,0,0,9
7078,esā,esa,1420,1342,78,0,3
7079,paradukkhāpanayanakāmatā,paradukkhapanayanakamata,1,1,0,0,24
7080,lakkhaṇā,lakkhana,56,53,3,0,8
7081,attasukhanirapekkhatāya,attasukhanirapekkhataya,9,9,0,0,23
7082,kāruṇikānaṃ,karunikanam,10,10,0,0,11
7083,rundhati,rundhati,38,37,1,0,8
7084,yutto,yutto,692,664,28,0,5
7085,kāruṇiko,karuniko,97,90,7,0,8
7086,kāruṇitaṃ,karunitam,1,1,0,0,9
7087,jātipuñña,jatipunna,1,1,0,0,9
7088,guṇamahattabhāvena,gunamahattabhavena,1,1,0,0,18
7089,sabbasattuttamaṃ,sabbasattuttamam,6,3,3,0,16
7090,ajadhātu,ajadhatu,3,3,0,0,8
7091,jassa,jassa,20,18,2,0,5
7092,asambhinnakhattiyavaṃse,asambhinnakhattiyavamse,2,2,0,0,23
7093,jātivasena,jativasena,104,99,5,0,10
7094,pūritapāramīpuññattā,puritaparamipunnatta,1,1,0,0,20
7095,puññavasena,punnavasena,7,7,0,0,11
7096,aparimitanirupamasīlādi,aparimitanirupamasiladi,1,1,0,0,23
7097,guṇavisesena,gunavisesena,4,4,0,0,12
7098,guṇavasena,gunavasena,42,42,0,0,10
7099,anantalokadhātūsu,anantalokadhatusu,3,3,0,0,17
7100,sabbasattuttamabhāvaṃ,sabbasattuttamabhavam,1,1,0,0,21
7101,ajeti,ajeti,1,1,0,0,5
7102,khepeti,khepeti,50,50,0,0,7
7103,kileseti,kileseti,22,13,9,0,8
7104,khepane,khepane,33,30,3,0,7
7105,anantañāṇaṃ,anantananam,9,8,1,0,11
7106,gaṇanavasena,gananavasena,50,49,1,0,12
7107,sabhāvavasena,sabhavavasena,30,25,5,0,13
7108,visayavasena,visayavasena,27,27,0,0,12
7109,antavirahitañāṇaṃ,antavirahitananam,2,2,0,0,17
7110,anantañāṇo,anantanano,19,18,1,0,10
7111,ettakanti,ettakanti,16,13,3,0,9
7112,paricchindituṃ,paricchinditum,37,37,0,0,14
7113,aparimāṇaṃ,aparimanam,50,45,5,0,10
7114,M0.0104,M0.0104,77,77,0,0,7
7115,sāriputtattheraapadāne,sariputtattheraapadane,1,0,1,0,22
7116,sakkā,sakka,4082,3935,147,0,5
7117,samudde,samudde,173,163,10,0,7
7118,pametuṃ,pametum,29,24,5,0,7
7119,aḷhakena,alhakena,1,1,0,0,8
7120,natveva,natveva,52,48,4,0,7
7121,tava,tava,2796,2680,116,0,4
7122,sabbaññu,sabbannu,70,69,1,0,8
7123,pametave,pametave,15,12,3,0,8
7124,kāruṇikamaggamanantañāṇanti,karunikamaggamanantanananti,1,1,0,0,27
7125,karuṇaggahaṇena,karunaggahanena,1,1,0,0,15
7126,sammāsambodhiyā,sammasambodhiya,68,68,0,0,15
7127,mahākaruṇāsañcoditamānaso,mahakarunasancoditamanaso,11,11,0,0,25
7128,saṃsārapaṅkato,samsarapankato,14,14,0,0,14
7129,samuddharaṇatthaṃ,samuddharanattham,11,11,0,0,17
7130,dīpaṅkarapādamūle,dipankarapadamule,28,26,2,0,17
7131,katābhinīhāro,katabhiniharo,33,33,0,0,13
7132,anupubbena,anupubbena,760,732,28,0,10
7133,adhigatoti,adhigatoti,83,75,8,0,10
7134,mūlanti,mulanti,60,59,1,0,7
7135,agganti,agganti,28,26,2,0,7
7136,aparimitanirupamasīlādiguṇasamaṅgītāya,aparimitanirupamasiladigunasamangitaya,1,1,0,0,38
7137,uttamabhāvaṃ,uttamabhavam,15,14,1,0,12
7138,anantañāṇantietena,anantananantietena,1,1,0,0,18
7139,sabbaññutañāṇapadaṭṭhānañhi,sabbannutananapadatthananhi,2,2,0,0,27
7140,aggamaggañāṇaṃ,aggamaggananam,12,12,0,0,14
7141,aggamaggañāṇapadaṭṭhānañca,aggamaggananapadatthananca,4,4,0,0,26
7142,sammāsambodhīti,sammasambodhiti,6,5,1,0,15
7143,sāmatthiyena,samatthiyena,23,23,0,0,12
7144,catupaṭisambhidāñāṇaṃ,catupatisambhidananam,7,7,0,0,21
7145,catuvesārajjañāṇaṃ,catuvesarajjananam,15,15,0,0,18
7146,chaasādhāraṇañāṇāni,chaasadharanananani,4,4,0,0,19
7147,chaabhiññā,chaabhinna,4,4,0,0,10
7148,aṭṭhasu,atthasu,499,474,25,0,7
7149,parisāsu,parisasu,209,203,6,0,8
7150,akampana,akampana,2,2,0,0,8
7151,dasabalañāṇāni,dasabalananani,12,12,0,0,14
7152,soḷasañāṇacariyā,solasananacariya,1,1,0,0,16
7153,catucattārīsañāṇavatthūni,catucattarisananavatthuni,1,1,0,0,25
7154,sattasattatiñāṇavatthūni,sattasattatinanavatthuni,2,2,0,0,24
7155,evamādīnaṃ,evamadinam,91,89,2,0,10
7156,anekesaṃ,anekesam,150,138,12,0,8
7157,paññāpabhedānaṃ,pannapabhedanam,5,5,0,0,15
7158,ñāṇācāraṃ,nanacaram,3,3,0,0,9
7159,dassetīti,dassetiti,231,206,25,0,9
7160,vippasannena,vippasannena,154,144,10,0,12
7161,cetasā,cetasa,1502,1446,56,0,6
7162,sannipatitaṭṭhānaṃ,sannipatitatthanam,4,4,0,0,18
7163,arahattamaggañāṇasaṅkhāta,arahattamaggananasankhata,1,1,0,0,25
7164,padīpobhāsena,padipobhasena,1,1,0,0,13
7165,hanitabba,hanitabba,1,1,0,0,9
7166,avijjāsaṅkhātamohatamaṃ,avijjasankhatamohatamam,1,1,0,0,23
7167,lokiyalokuttarasaṅkhātapayojanaṃ,lokiyalokuttarasankhatapayojanam,1,1,0,0,32
7168,M0.0105,M0.0105,79,79,0,0,7
7169,jātipuññaguṇamahattabhāvena,jatipunnagunamahattabhavena,1,1,0,0,27
7170,ananta,ananta,15,14,1,0,6
7171,gaṇavasena,ganavasena,12,12,0,0,10
7172,pannarasamavandanagāthāvaṇṇanā,pannarasamavandanagathavannana,1,1,0,0,30
7173,pannarasamagāthāya,pannarasamagathaya,2,2,0,0,18
7174,isipatana,isipatana,1,1,0,0,9
7175,migadāye,migadaye,180,179,1,0,8
7176,dhammacakkapavattanādiguṇehi,dhammacakkapavattanadigunehi,1,1,0,0,28
7177,nanamayayagaṇehi,nanamayayaganehi,1,1,0,0,16
7178,pannarasakkharehi,pannarasakkharehi,1,1,0,0,17
7179,mālinī,malini,28,25,3,0,6
7180,nanamayayayutāyaṃ,nanamayayayutayam,1,1,0,0,17
7181,mālinībhogisīhī,malinibhogisihi,1,1,0,0,15
7182,bhogisīhi,bhogisihi,1,1,0,0,9
7183,aṭṭhasattayatīhi,atthasattayatihi,1,1,0,0,16
7184,nanamayayayutā,nanamayayayuta,1,1,0,0,14
7185,nanagaṇamagaṇa,nanaganamagana,1,1,0,0,14
7186,yayagaṇehi,yayaganehi,1,1,0,0,10
7187,mālinīgāthā,malinigatha,2,2,0,0,11
7188,bhogisīhīti,bhogisihiti,1,1,0,0,11
7189,bhogaisīhīti,bhogaisihiti,1,1,0,0,12
7190,bhogasaddo,bhogasaddo,1,1,0,0,10
7191,aṭṭhasaṅkhyā,atthasankhya,1,1,0,0,12
7192,vācako,vacako,56,56,0,0,6
7193,isisaddo,isisaddo,2,2,0,0,8
7194,sattasaṅkhyāvācakoti,sattasankhyavacakoti,5,5,0,0,20
7195,akhilaguṇanidhānoti,akhilagunanidhanoti,1,0,1,0,19
7196,sabbalokiyalokuttara,sabbalokiyalokuttara,1,1,0,0,20
7197,sīlasamādhipaññādiguṇasamūhānaṃ,silasamadhipannadigunasamuhanam,1,1,0,0,31
7198,patiṭṭhāno,patitthano,3,3,0,0,10
7199,akhilasaddo,akhilasaddo,2,2,0,0,11
7200,anavasesavācako,anavasesavacako,6,6,0,0,15
7201,sabboti,sabboti,17,7,10,0,7
7202,madhuṭīkāyaṃ,madhutikayam,1,0,1,0,12
7203,khilasaddo,khilasaddo,1,1,0,0,10
7204,hettha,hettha,474,457,17,0,6
7205,avasesavācako,avasesavacako,1,1,0,0,13
7206,khilaṃ,khilam,35,29,6,0,6
7207,akhilaṃ,akhilam,23,13,10,0,7
7208,khīyatīti,khiyatiti,25,12,13,0,9
7209,M0.0106,M0.0106,76,76,0,0,7
7210,napubbakhidhātu,napubbakhidhatu,1,1,0,0,15
7211,lo,lo,119,86,33,0,2
7212,akhilāni,akhilani,1,1,0,0,8
7213,sabbāni,sabbani,834,788,46,0,7
7214,akhilaguṇāni,akhilagunani,1,1,0,0,12
7215,nidhāti,nidhati,2,1,1,0,7
7216,munindopagantvāti,munindopagantvati,1,0,1,0,17
7217,upagantvāti,upagantvati,19,13,6,0,11
7218,munindoti,munindoti,4,2,2,0,9
7219,munivasena,munivasena,1,1,0,0,10
7220,pañcannaṃ,pancannam,1775,1699,76,0,9
7221,issaroti,issaroti,53,38,15,0,8
7222,isipatanaavhaṃ,isipatanaavham,1,1,0,0,14
7223,vanaṃ,vanam,544,483,61,0,5
7224,upagantvā,upagantva,508,502,6,0,9
7225,akusalachedaṃ,akusalachedam,3,2,1,0,13
7226,pavattoti,pavattoti,81,76,5,0,9
7227,isipatanaavhanti,isipatanaavhanti,1,1,0,0,16
7228,vananti,vananti,16,16,0,0,7
7229,migadāyavanaṃ,migadayavanam,2,2,0,0,13
7230,vivekakāmehi,vivekakamehi,3,3,0,0,12
7231,vanitabbaṃ,vanitabbam,1,1,0,0,10
7232,sambhajitabbaṃ,sambhajitabbam,1,1,0,0,14
7233,vanadhātu,vanadhatu,1,1,0,0,9
7234,sambhattiyaṃ,sambhattiyam,11,10,1,0,12
7235,isipatanavhanti,isipatanavhanti,1,1,0,0,15
7236,isipatananāmikaṃ,isipatananamikam,2,2,0,0,16
7237,isīnaṃ,isinam,142,131,11,0,6
7238,patanaṭṭhānattā,patanatthanatta,1,1,0,0,15
7239,isipatananti,isipatananti,3,3,0,0,12
7240,voharitabbaṃ,voharitabbam,52,50,2,0,12
7241,sīlakkhandhādike,silakkhandhadike,11,11,0,0,16
7242,esanti,esanti,29,27,2,0,6
7243,gavesantīti,gavesantiti,13,10,3,0,11
7244,isi,isi,252,241,11,0,3
7245,paccekabuddhādayo,paccekabuddhadayo,5,5,0,0,17
7246,isadhātu,isadhatu,1,1,0,0,8
7247,patanti,patanti,227,223,4,0,7
7248,isipatanaṃ,isipatanam,50,46,4,0,10
7249,isisaddūpapadapatadhātu,isisaddupapadapatadhatu,1,1,0,0,23
7250,patanaṃ,patanam,50,46,4,0,7
7251,avhetabbaṃ,avhetabbam,1,1,0,0,10
7252,voharitabbanti,voharitabbanti,3,3,0,0,14
7253,avhaṃ,avham,1,1,0,0,5
7254,āpubbavhedhātu,apubbavhedhatu,1,1,0,0,14
7255,avhayane,avhayane,1,1,0,0,8
7256,rassādeso,rassadeso,5,5,0,0,9
7257,avhetabbanti,avhetabbanti,1,1,0,0,12
7258,isipatanavhaṃ,isipatanavham,2,2,0,0,13
7259,kāyavacīmanosaṃyamantānaṃ,kayavacimanosamyamantanam,1,1,0,0,25
7260,saṃyamantīti,samyamantiti,1,1,0,0,12
7261,saññatā,sannata,41,39,2,0,7
7262,sādhū,sadhu,741,714,27,0,5
7263,saṃpubbayamudhātu,sampubbayamudhatu,1,1,0,0,17
7264,vasanaṭṭhānaṃ,vasanatthanam,497,491,6,0,13
7265,rammaṇaṭṭhānaṃ,rammanatthanam,2,2,0,0,14
7266,nikitati,nikitati,1,1,0,0,8
7267,nivasati,nivasati,17,15,2,0,8
7268,rammati,rammati,1,1,0,0,7
7269,nipubba,nipubba,5,5,0,0,7
7270,kitadhātu,kitadhatu,1,1,0,0,9
7271,nivāse,nivase,61,53,8,0,6
7272,gamitvā,gamitva,11,11,0,0,7
7273,isipatananāmake,isipatananamake,2,2,0,0,15
7274,migadāyavane,migadayavane,1,1,0,0,12
7275,akusalassa,akusalassa,478,473,5,0,10
7276,samucchedaṃ,samucchedam,6,6,0,0,11
7277,samucchindati,samucchindati,64,63,1,0,13
7278,M0.0107,M0.0107,79,79,0,0,7
7279,suttenāti,suttenati,8,4,4,0,9
7280,dhammacakka,dhammacakka,3,3,0,0,11
7281,pavattanasuttaṃ,pavattanasuttam,1,1,0,0,15
7282,akusalasaddūpapadachididhātu,akusalasaddupapadachididhatu,1,1,0,0,28
7283,dvidhākaraṇe,dvidhakarane,14,13,1,0,12
7284,dhammacakkapavattanasuttaṃ,dhammacakkapavattanasuttam,3,3,0,0,26
7285,cakkasaddo,cakkasaddo,8,8,0,0,10
7286,sampattiyaṃ,sampattiyam,32,29,3,0,11
7287,rathaṅge,rathange,22,20,2,0,8
7288,iriyāpathe,iriyapathe,100,96,4,0,10
7289,dhammakhuracakkādīsu,dhammakhuracakkadisu,1,1,0,0,20
7290,cattārimāni,cattarimani,204,199,5,0,11
7291,samannāgatānaṃ,samannagatanam,58,57,1,0,14
7292,devamanussānantiādīsu,devamanussanantiadisu,1,1,0,0,21
7293,cakkaṃva,cakkamva,27,22,5,0,8
7294,vahato,vahato,25,21,4,0,6
7295,catucakkaṃ,catucakkam,52,47,5,0,10
7296,navadvāranti,navadvaranti,3,3,0,0,12
7297,bhuñja,bhunja,167,158,9,0,6
7298,pamādo,pamado,281,255,26,0,6
7299,vattaya,vattaya,10,9,1,0,7
7300,sabbapāṇīnanti,sabbapaninanti,1,1,0,0,14
7301,dibbacakkaratanaṃ,dibbacakkaratanam,1,1,0,0,17
7302,pāturahosīti,paturahositi,25,2,23,0,12
7303,ratanacakke,ratanacakke,12,12,0,0,11
7304,pavattitaṃ,pavattitam,268,249,19,0,10
7305,cakkanti,cakkanti,41,41,0,0,8
7306,dhammacakke,dhammacakke,37,35,2,0,11
7307,icchāhatassa,icchahatassa,24,23,1,0,12
7308,posassa,posassa,80,78,2,0,7
7309,bhamati,bhamati,35,34,1,0,7
7310,matthaketi,matthaketi,14,6,8,0,10
7311,khuracakke,khuracakke,6,6,0,0,10
7312,khurapariyantena,khurapariyantena,22,22,0,0,16
7313,cakkenāti,cakkenati,2,1,1,0,9
7314,paharaṇacakke,paharanacakke,8,8,0,0,13
7315,asanivicakkanti,asanivicakkanti,3,3,0,0,15
7316,asanimaṇḍale,asanimandale,7,7,0,0,12
7317,panāyaṃ,panayam,693,665,28,0,7
7318,satipaṭṭhānādidhammaṃ,satipatthanadidhammam,1,1,0,0,21
7319,cakketi,cakketi,4,4,0,0,7
7320,dhammacakkanti,dhammacakkanti,13,13,0,0,14
7321,ariyasaccādidhammaṃ,ariyasaccadidhammam,1,1,0,0,19
7322,dhammato,dhammato,337,315,22,0,8
7323,anapetattā,anapetatta,27,27,0,0,10
7324,dhammañca,dhammanca,489,467,22,0,9
7325,āṇācakkañcāti,anacakkancati,1,1,0,0,13
7326,ñāyena,nayena,108,106,2,0,6
7327,pavatteti,pavatteti,336,324,12,0,9
7328,cakkañcāti,cakkancati,22,21,1,0,10
7329,cakkañca,cakkanca,22,21,1,0,8
7330,dhammañcāti,dhammancati,23,14,9,0,11
7331,dhammacariyāya,dhammacariyaya,28,27,1,0,14
7332,itiādi,itiadi,11620,11614,6,0,6
7333,paṭivedhañāṇampi,pativedhananampi,10,7,3,0,16
7334,desanāñāṇampi,desanananampi,13,12,1,0,13
7335,bodhipallaṅke,bodhipallanke,55,53,2,0,13
7336,soḷasahākārehi,solasahakarehi,16,16,0,0,14
7337,saṭṭhinayasahassehi,satthinayasahassehi,3,2,1,0,19
7338,desanāñāṇaṃ,desanananam,39,35,4,0,11
7339,tiparivaṭṭaṃ,tiparivattam,33,25,8,0,12
7340,dvādasākāraṃ,dvadasakaram,28,21,7,0,12
7341,pavattesi,pavattesi,170,170,0,0,9
7342,ubhayampetaṃ,ubhayampetam,100,93,7,0,12
7343,dasabalassa,dasabalassa,476,473,3,0,11
7344,ure,ure,146,142,4,0,3
7345,jātañāṇameva,jatananameva,3,3,0,0,12
7346,dhammadesanāñāṇaṃ,dhammadesanananam,2,2,0,0,17
7347,suttaṃ,suttam,2154,1962,192,0,6
7348,pañcavaggiyānaṃ,pancavaggiyanam,34,34,0,0,15
7349,M0.0108,M0.0108,77,77,0,0,7
7350,dveme,dveme,190,183,7,0,5
7351,antā,anta,84,73,11,0,4
7352,pabbajitena,pabbajitena,168,167,1,0,11
7353,sevitabbātiādinā,sevitabbatiadina,1,1,0,0,16
7354,adesayi,adesayi,32,29,3,0,7
7355,abhikantanti,abhikantanti,4,4,0,0,12
7356,dhātūsu,dhatusu,108,107,1,0,7
7357,asadisehi,asadisehi,2,2,0,0,9
7358,buddhehi,buddhehi,83,78,5,0,8
7359,samoti,samoti,34,21,13,0,6
7360,abhikantaṃ,abhikantam,8,7,1,0,10
7361,sabbadevamanussehi,sabbadevamanussehi,8,8,0,0,18
7362,kantaṃ,kantam,73,62,11,0,6
7363,kamanīyaṃ,kamaniyam,9,9,0,0,9
7364,sarīravaṇṇavantaṃ,sariravannavantam,2,2,0,0,17
7365,tusitabbasarīravaṇṇasampannaṃ,tusitabbasariravannasampannam,1,1,0,0,29
7366,abhikkantavaṇṇanti,abhikkantavannanti,1,1,0,0,18
7367,kakāralopañca,kakaralopanca,1,1,0,0,13
7368,vaṇṇapadalopaṃ,vannapadalopam,1,1,0,0,14
7369,vuttasandhivasena,vuttasandhivasena,1,1,0,0,17
7370,uttarapadalopa,uttarapadalopa,1,1,0,0,14
7371,sarīravaṇṇaṃ,sariravannam,21,21,0,0,12
7372,kamiyati,kamiyati,3,3,0,0,8
7373,tosiyatīti,tosiyatiti,1,1,0,0,10
7374,abhikanto,abhikanto,1,1,0,0,9
7375,asītyānubyañjana,asityanubyanjana,1,1,0,0,16
7376,lakkhaṇehi,lakkhanehi,78,78,0,0,10
7377,suvaṇṇavaṇṇena,suvannavannena,8,5,3,0,14
7378,samannā,samanna,3,3,0,0,7
7379,sarīrasobhaggappattito,sarirasobhaggappattito,1,1,0,0,22
7380,kamanīyo,kamaniyo,18,17,1,0,8
7381,tuṭṭho,tuttho,274,271,3,0,6
7382,sarīravaṇṇo,sariravanno,25,25,0,0,11
7383,vandanārahaṃ,vandanaraham,5,5,0,0,12
7384,vanditabbaṃ,vanditabbam,22,21,1,0,11
7385,vandiyate,vandiyate,1,1,0,0,9
7386,thomiyate,thomiyate,1,1,0,0,9
7387,vandanaṃ,vandanam,105,91,14,0,8
7388,vandadhātu,vandadhatu,1,1,0,0,10
7389,vadidhātu,vadidhatu,1,1,0,0,9
7390,abhivādanathutīsu,abhivadanathutisu,7,5,2,0,17
7391,vandaneyyo,vandaneyyo,4,4,0,0,10
7392,vandapadaṃ,vandapadam,1,1,0,0,10
7393,arahatitaddhite,arahatitaddhite,3,3,0,0,15
7394,ṇeyyo,neyyo,32,29,3,0,5
7395,thomitabbanti,thomitabbanti,1,1,0,0,13
7396,ādimajjhapariyosāna,adimajjhapariyosana,1,1,0,0,19
7397,vandanāraho,vandanaraho,2,2,0,0,11
7398,vanditabbo,vanditabbo,16,15,1,0,10
7399,ādiguṇaṃ,adigunam,1,1,0,0,8
7400,karuṇānidānaṃ,karunanidanam,2,1,1,0,13
7401,M0.0109,M0.0109,77,77,0,0,7
7402,pāṇātipātādiviratippavattito,panatipatadiviratippavattito,9,8,1,0,28
7403,majjha,majjha,11,11,0,0,6
7404,guṇaṃ,gunam,528,519,9,0,5
7405,jhānattayayogato,jhanattayayogato,1,1,0,0,16
7406,pariyosānaguṇaṃ,pariyosanagunam,1,1,0,0,15
7407,uttari,uttari,738,655,83,0,6
7408,karaṇīyābhāvatoti,karaniyabhavatoti,1,1,0,0,17
7409,vandaneyyanti,vandaneyyanti,1,1,0,0,13
7410,akhilanidhāno,akhilanidhano,1,1,0,0,13
7411,lokiyalokuttarasaṅkhātānaṃ,lokiyalokuttarasankhatanam,1,1,0,0,26
7412,sīlasamādhipaññādiguṇa,silasamadhipannadiguna,1,1,0,0,22
7413,kāyavacīmanosaṃya,kayavacimanosamya,1,1,0,0,17
7414,mantānaṃ,mantanam,60,56,4,0,8
7415,migadāya,migadaya,2,2,0,0,8
7416,vane,vane,581,546,35,0,4
7417,dhammacakkappavattanasuttaṃ,dhammacakkappavattanasuttam,6,5,1,0,27
7418,tuṭṭhi,tutthi,62,57,5,0,6
7419,manussānaṃ,manussanam,1275,1220,55,0,10
7420,soḷasamavandanagāthāvaṇṇanā,solasamavandanagathavannana,1,1,0,0,27
7421,soḷasamagāthāya,solasamagathaya,1,1,0,0,15
7422,suciparivāritantyādīhi,suciparivaritantyadihi,1,1,0,0,22
7423,jabhajaragaṇehi,jabhajaraganehi,1,1,0,0,15
7424,soḷasakkharehi,solasakkharehi,1,1,0,0,14
7425,yuttāvāṇinīgāthāti,yuttavaninigathati,1,1,0,0,18
7426,M0.0110,M0.0110,77,77,0,0,7
7427,najabhajarā,najabhajara,2,2,0,0,11
7428,vāṇinī,vanini,3,2,1,0,6
7429,gayuttā,gayutta,4,4,0,0,7
7430,nagaṇa,nagana,3,3,0,0,6
7431,bhagaṇa,bhagana,2,2,0,0,7
7432,saṃyogā,samyoga,16,15,1,0,7
7433,vāṇinīgāthā,vaninigatha,2,2,0,0,11
7434,rāgādimalavisuddhāhi,ragadimalavisuddhahi,1,1,0,0,20
7435,ariyasāvakādiparisāhi,ariyasavakadiparisahi,2,2,0,0,21
7436,parikkhāritaṃ,parikkharitam,2,2,0,0,13
7437,kilesamalavisuddhaṃ,kilesamalavisuddham,2,2,0,0,19
7438,parikkhāravantaṃ,parikkharavantam,2,2,0,0,16
7439,rāgādimalehi,ragadimalehi,10,10,0,0,12
7440,sucati,sucati,3,3,0,0,6
7441,suci,suci,91,81,10,0,4
7442,parisā,parisa,612,591,21,0,6
7443,sucadhātu,sucadhatu,1,1,0,0,9
7444,soceyye,soceyye,12,9,3,0,7
7445,ariyabhikkhuādīhi,ariyabhikkhuadihi,2,2,0,0,17
7446,vāriyati,variyati,1,1,0,0,8
7447,parikkhariyatīti,parikkhariyatiti,1,1,0,0,16
7448,parivāro,parivaro,101,98,3,0,8
7449,paripubbavaradhātu,paripubbavaradhatu,1,1,0,0,18
7450,parikkhāre,parikkhare,75,72,3,0,10
7451,sucīhi,sucihi,5,5,0,0,6
7452,parisāhi,parisahi,14,14,0,0,8
7453,suciparivārito,suciparivarito,2,2,0,0,14
7454,tappurisasamāsoyaṃ,tappurisasamasoyam,2,2,0,0,18
7455,sadā,sada,1209,1112,97,0,4
7456,rāgādimala,ragadimala,2,2,0,0,10
7457,visuddhehi,visuddhehi,2,2,0,0,10
7458,suciparisuddhaṃ,suciparisuddham,1,1,0,0,15
7459,parivāritaṃ,parivaritam,37,36,1,0,11
7460,surucirappabhāhīti,surucirappabhahiti,1,0,1,0,18
7461,kantitasarīranikkhanta,kantitasariranikkhanta,1,1,0,0,22
7462,byāmamattaraṃsīhi,byamamattaramsihi,2,2,0,0,17
7463,karaṇabhūtehi,karanabhutehi,33,33,0,0,13
7464,ruciyati,ruciyati,1,1,0,0,8
7465,tusiyatīti,tusiyatiti,2,2,0,0,10
7466,surucirā,surucira,5,5,0,0,8
7467,rucadhātu,rucadhatu,1,1,0,0,9
7468,rocane,rocane,7,5,2,0,6
7469,iro,iro,22,22,0,0,3
7470,bhāti,bhati,67,59,8,0,5
7471,pabhā,pabha,183,172,11,0,5
7472,papubba,papubba,7,7,0,0,7
7473,bhādhātu,bhadhatu,2,2,0,0,8
7474,dibbane,dibbane,2,2,0,0,7
7475,surucirappabhā,surucirappabha,1,1,0,0,14
7476,tāhi,tahi,470,455,15,0,4
7477,rañjitabbakāyaṃ,ranjitabbakayam,2,2,0,0,15
7478,rañjiyatīti,ranjiyatiti,1,1,0,0,11
7479,ratto,ratto,269,250,19,0,5
7480,uttarapadalopasamā,uttarapadalopasama,1,1,0,0,18
7481,soyaṃ,soyam,127,117,10,0,5
7482,sarīrato,sarirato,182,177,5,0,8
7483,rañjitabbo,ranjitabbo,1,1,0,0,10
7484,rūpakāyo,rupakayo,82,75,7,0,8
7485,paññāpuññasaṅkhātalakkhisamūhānaṃ,pannapunnasankhatalakkhisamuhanam,1,1,0,0,33
7486,patiṭṭhānaṃ,patitthanam,135,116,19,0,11
7487,paññāpuññānametaṃ,pannapunnanametam,1,1,0,0,17
7488,puññanibbattā,punnanibbatta,3,3,0,0,13
7489,M0.0111,M0.0111,78,78,0,0,7
7490,sarīrasobhaggādisampatti,sarirasobhaggadisampatti,4,4,0,0,24
7491,nissayati,nissayati,9,8,1,0,9
7492,nissiyatīti,nissiyatiti,1,1,0,0,11
7493,paññāpuññaṃ,pannapunnam,1,1,0,0,11
7494,sarīrasobhaggādi,sarirasobhaggadi,1,1,0,0,16
7495,vimānavatthuaṭṭhakathādīsu,vimanavatthuatthakathadisu,1,0,1,0,26
7496,buddhipuññānaṃ,buddhipunnanam,2,2,0,0,14
7497,adhivacananti,adhivacananti,40,40,0,0,13
7498,issariyanti,issariyanti,7,7,0,0,11
7499,rūpakāyasampattī,rupakayasampatti,1,1,0,0,16
7500,dīghavasena,dighavasena,20,20,0,0,11
7501,gāthābandhattā,gathabandhatta,3,3,0,0,14
7502,rassavasena,rassavasena,21,21,0,0,11
7503,visarālayanti,visaralayanti,1,1,0,0,13
7504,visaraālayanti,visaraalayanti,1,1,0,0,14
7505,visaroti,visaroti,1,1,0,0,8
7506,visanti,visanti,14,13,1,0,7
7507,pavisanti,pavisanti,220,219,1,0,9
7508,avayavā,avayava,51,47,4,0,7
7509,yasmiṃ,yasmim,2890,2764,126,0,6
7510,samūheti,samuheti,2,2,0,0,8
7511,visadhātu,visadhatu,1,1,0,0,9
7512,pavesane,pavesane,28,27,1,0,8
7513,arapaccayo,arapaccayo,1,1,0,0,10
7514,visaranti,visaranti,2,2,0,0,9
7515,yasminti,yasminti,29,29,0,0,8
7516,vipubba,vipubba,3,3,0,0,7
7517,samosaraṇe,samosarane,6,6,0,0,10
7518,potthakesu,potthakesu,290,289,1,0,10
7519,visayāla,visayala,1,1,0,0,8
7520,yakārena,yakarena,7,6,1,0,8
7521,pāṭho,patho,2068,2060,8,0,5
7522,yujjati,yujjati,1170,1146,24,0,7
7523,visarasaddasseva,visarasaddasseva,1,1,0,0,16
7524,samūhavācakattā,samuhavacakatta,2,2,0,0,15
7525,abhidhānappa,abhidhanappa,1,0,1,0,12
7526,dīpikāyaṃ,dipikayam,1,0,1,0,9
7527,ālayanti,alayanti,9,9,0,0,8
7528,patiṭṭhanti,patitthanti,4,4,0,0,11
7529,ālayo,alayo,102,87,15,0,5
7530,lidhātu,lidhatu,1,1,0,0,7
7531,alliyane,alliyane,2,2,0,0,8
7532,sirīnaṃ,sirinam,1,1,0,0,7
7533,paññāsaṅkhātalakkhīnaṃ,pannasankhatalakkhinam,1,1,0,0,22
7534,sirīvisaro,sirivisaro,1,1,0,0,10
7535,sirīvisarālayo,sirivisaralayo,1,1,0,0,14
7536,gopitabbehi,gopitabbehi,1,1,0,0,11
7537,saṃvaritabbehi,samvaritabbehi,2,2,0,0,14
7538,cakkhādīhi,cakkhadihi,18,17,1,0,10
7539,indriyehi,indriyehi,138,134,4,0,9
7540,gupiyanti,gupiyanti,1,1,0,0,9
7541,rakkhiyantīti,rakkhiyantiti,1,1,0,0,13
7542,gupitāni,gupitani,2,2,0,0,8
7543,gupadhātu,gupadhatu,1,1,0,0,9
7544,rakkhane,rakkhane,9,9,0,0,8
7545,idanti,idanti,117,114,3,0,6
7546,sahajātadhamme,sahajatadhamme,26,26,0,0,14
7547,indriyāni,indriyani,715,666,49,0,9
7548,paramissariye,paramissariye,5,4,1,0,13
7549,gupitamindriyāni,gupitamindriyani,1,1,0,0,16
7550,M0.0112,M0.0112,78,78,0,0,7
7551,cakkhādiindriyāni,cakkhadiindriyani,3,3,0,0,17
7552,upeti,upeti,535,497,38,0,5
7553,sampajjatīti,sampajjatiti,74,61,13,0,12
7554,idhātu,idhatu,5,5,0,0,6
7555,ariyasāvakādīhi,ariyasavakadihi,1,1,0,0,15
7556,puggalehi,puggalehi,70,67,3,0,9
7557,rakkhitāni,rakkhitani,6,6,0,0,10
7558,indriyaṃ,indriyam,740,710,30,0,8
7559,rakkhito,rakkhito,73,68,5,0,8
7560,gupitamindriyehupetanti,gupitamindriyehupetanti,1,1,0,0,23
7561,sūriyamaṇḍala,suriyamandala,2,2,0,0,13
7562,candamaṇḍalādīhi,candamandaladihi,1,1,0,0,16
7563,pādacakkalakkhaṇehi,padacakkalakkhanehi,2,2,0,0,19
7564,abhivicitrapādaṃ,abhivicitrapadam,2,2,0,0,16
7565,upasaddo,upasaddo,24,23,1,0,8
7566,bhusaṭṭhavācako,bhusatthavacako,1,1,0,0,15
7567,abhivicitraṃ,abhivicitram,2,2,0,0,12
7568,candamaṇḍalādiṃ,candamandaladim,1,1,0,0,15
7569,pādacakkalakkhaṇavantaṃ,padacakkalakkhanavantam,2,2,0,0,23
7570,ravīti,raviti,4,3,1,0,6
7571,ravati,ravati,24,24,0,0,6
7572,rudhātu,rudhatu,1,1,0,0,7
7573,saṇikaṃ,sanikam,236,215,21,0,7
7574,ṇvādi,nvadi,13,13,0,0,5
7575,moggallāne,moggallane,30,29,1,0,10
7576,rusadde,rusadde,7,7,0,0,7
7577,avādeso,avadeso,10,10,0,0,7
7578,gajjatīti,gajjatiti,5,4,1,0,9
7579,ravi,ravi,69,68,1,0,4
7580,ādicco,adicco,95,89,6,0,6
7581,abhidhāna,abhidhana,47,45,2,0,9
7582,ṭīkāyañca,tikayanca,6,4,2,0,9
7583,ravanti,ravanti,17,17,0,0,7
7584,pabhāvitattāti,pabhavitattati,1,1,0,0,14
7585,ravī,ravi,8,3,5,0,4
7586,sasīti,sasiti,5,4,1,0,6
7587,sasati,sasati,20,20,0,0,6
7588,tiṇena,tinena,62,62,0,0,6
7589,pāṇati,panati,1,1,0,0,6
7590,jīvatīti,jivatiti,72,56,16,0,8
7591,saso,saso,46,44,2,0,4
7592,sasapaṇḍito,sasapandito,7,7,0,0,11
7593,sasadhātu,sasadhatu,1,1,0,0,9
7594,pāṇe,pane,153,146,7,0,4
7595,sasarūpalakkhaṇamettha,sasarupalakkhanamettha,1,1,0,0,22
7596,atīte,atite,1159,1120,39,0,5
7597,sasarājā,sasaraja,1,1,0,0,8
7598,brāhmaṇavesena,brahmanavesena,9,9,0,0,14
7599,yācakassa,yacakassa,26,26,0,0,9
7600,sakkarañño,sakkaranno,1,1,0,0,10
7601,aṅgārarāsimhi,angararasimhi,8,7,1,0,13
7602,laṅghitvā,langhitva,45,45,0,0,9
7603,jīvitaṃ,jivitam,1615,1511,104,0,7
7604,pariccajitvā,pariccajitva,186,184,2,0,12
7605,kāyaṃ,kayam,1492,1354,138,0,5
7606,adāsi,adasi,2359,2345,14,0,5
7607,sasapaṇḍitassa,sasapanditassa,3,3,0,0,14
7608,jīvitapariccajitassa,jivitapariccajitassa,1,1,0,0,20
7609,jīvitadānaguṇo,jivitadanaguno,1,1,0,0,14
7610,sakalakappaṃ,sakalakappam,11,11,0,0,12
7611,hotūti,hotuti,241,214,27,0,6
7612,pabbataṃ,pabbatam,337,322,15,0,8
7613,pīḷetvā,piletva,116,115,1,0,7
7614,pabbatarasaṃ,pabbatarasam,6,6,0,0,12
7615,candamaṇḍale,candamandale,13,13,0,0,12
7616,sasarūpalakkhaṇaṃ,sasarupalakkhanam,1,1,0,0,17
7617,ṭhapesi,thapesi,783,773,10,0,7
7618,vohariyati,vohariyati,13,12,1,0,10
7619,sasapaṇḍitajātake,sasapanditajatake,4,3,1,0,17
7620,passitvā,passitva,590,586,4,0,8
7621,M0.0113,M0.0113,75,75,0,0,7
7622,uṇhaguṇanti,unhagunanti,2,2,0,0,11
7623,sasudhātu,sasudhatu,1,1,0,0,9
7624,maṇḍiyati,mandiyati,1,1,0,0,9
7625,vibhūsiyati,vibhusiyati,1,1,0,0,11
7626,paricchedakaraṇavasenāti,paricchedakaranavasenati,1,1,0,0,24
7627,maṇḍalaṃ,mandalam,95,75,20,0,8
7628,maṇḍadhātu,mandadhatu,1,1,0,0,10
7629,maḍidhātu,madidhatu,1,1,0,0,9
7630,vibhūsane,vibhusane,8,8,0,0,9
7631,maṇḍaṃ,mandam,19,18,1,0,6
7632,vibhūsanaṃ,vibhusanam,25,18,7,0,10
7633,maṇḍasaddūpapada,mandasaddupapada,1,1,0,0,16
7634,ravino,ravino,1,1,0,0,6
7635,ravimaṇḍalaṃ,ravimandalam,2,2,0,0,12
7636,sasino,sasino,2,2,0,0,6
7637,sasimaṇḍalaṃ,sasimandalam,3,3,0,0,12
7638,ravimaṇḍalañca,ravimandalanca,1,1,0,0,14
7639,sasimaṇḍalañca,sasimandalanca,1,1,0,0,14
7640,ravisasimaṇḍalaṃ,ravisasimandalam,2,2,0,0,16
7641,maṇḍalasaddo,mandalasaddo,1,1,0,0,12
7642,ravisaddepi,ravisaddepi,1,1,0,0,11
7643,yojetabbo,yojetabbo,377,371,6,0,9
7644,maṇḍalasaddassa,mandalasaddassa,1,1,0,0,15
7645,dvandapadato,dvandapadato,3,3,0,0,12
7646,suyyamānattā,suyyamanatta,7,7,0,0,12
7647,pabhutītiādi,pabhutitiadi,1,0,1,0,12
7648,ādyatthavācako,adyatthavacako,1,1,0,0,14
7649,abyayanipāto,abyayanipato,1,1,0,0,12
7650,pabhutiādi,pabhutiadi,1,1,0,0,10
7651,ravisasimaṇḍalappabhuti,ravisasimandalappabhuti,2,2,0,0,23
7652,pādappa,padappa,1,1,0,0,7
7653,vattacakkalakkhaṇaṃ,vattacakkalakkhanam,1,1,0,0,19
7654,ravisasimaṇḍalappabhutilakkhaṇaṃ,ravisasimandalappabhutilakkhanam,1,1,0,0,32
7655,upacittaṃ,upacittam,2,2,0,0,9
7656,ativicitraṃ,ativicitram,2,2,0,0,11
7657,pādaṃ,padam,427,395,32,0,5
7658,ravisasimaṇḍalappabhutilakkhaṇopa,ravisasimandalappabhutilakkhanopa,1,1,0,0,33
7659,ravisasi,ravisasi,1,1,0,0,8
7660,maṇḍalappabhutilakkhaṇaṃ,mandalappabhutilakkhanam,1,1,0,0,24
7661,suranti,suranti,13,13,0,0,7
7662,issariya,issariya,2,2,0,0,8
7663,kīḷādīhi,kiladihi,1,1,0,0,8
7664,surā,sura,142,126,16,0,4
7665,suradhātu,suradhatu,3,3,0,0,9
7666,surati,surati,6,6,0,0,6
7667,devissariyaṃ,devissariyam,13,13,0,0,12
7668,issariyadittīsu,issariyadittisu,2,1,1,0,15
7669,rāvācā,ravaca,1,1,0,0,6
7670,etesanti,etesanti,708,696,12,0,8
7671,khandhasantānaṃ,khandhasantanam,33,31,2,0,15
7672,sakakammaṃ,sakakammam,27,20,7,0,10
7673,niyantīti,niyantiti,1,1,0,0,9
7674,suranarā,suranara,2,2,0,0,8
7675,suranara,suranara,2,2,0,0,8
7676,veneyyajanūpasaṅkamanaṃ,veneyyajanupasankamanam,2,2,0,0,23
7677,hitasukhanipphādanato,hitasukhanipphadanato,10,10,0,0,21
7678,lakkhaṇānubyañjanappaṭi,lakkhananubyanjanappati,1,1,0,0,23
7679,maṇḍitarūpakāyatāya,manditarupakayataya,1,1,0,0,19
7680,M0.0114,M0.0114,76,76,0,0,7
7681,dutavilambitakhalitānukaḍḍhananippiḷinukkuṭika,dutavilambitakhalitanukaddhananippilinukkutika,1,1,0,0,46
7682,kuṭilākuṭilatādi,kutilakutilatadi,1,1,0,0,16
7683,dosarahita,dosarahita,1,1,0,0,10
7684,mavahasita,mavahasita,1,1,0,0,10
7685,rājahaṃsausabha,rajahamsausabha,1,1,0,0,15
7686,vāraṇa,varana,2,2,0,0,6
7687,migarājagamanaṃ,migarajagamanam,1,1,0,0,15
7688,ñāṇagamanañca,nanagamananca,10,10,0,0,13
7689,vipula,vipula,6,5,1,0,6
7690,nimmala,nimmala,1,1,0,0,7
7691,vīriyādi,viriyadi,1,1,0,0,8
7692,guṇavisesa,gunavisesa,2,2,0,0,10
7693,sahita,sahita,8,7,1,0,6
7694,anavajjatāya,anavajjataya,16,15,1,0,12
7695,sobhanamevāti,sobhanamevati,7,7,0,0,13
7696,pariññābhi,parinnabhi,1,1,0,0,10
7697,samayavasena,samayavasena,16,12,4,0,12
7698,parijānanto,parijananto,69,68,1,0,11
7699,avagatoti,avagatoti,23,23,0,0,9
7700,lokasamudayaṃ,lokasamudayam,28,24,4,0,13
7701,pahānātisamayavasena,pahanatisamayavasena,1,1,0,0,20
7702,pajahanto,pajahanto,201,194,7,0,9
7703,anuppattidhammataṃ,anuppattidhammatam,41,40,1,0,18
7704,āpādento,apadento,13,13,0,0,8
7705,lokanirodhaṃ,lokanirodham,31,23,8,0,12
7706,sacchikiriyābhisamayavasena,sacchikiriyabhisamayavasena,33,32,1,0,27
7707,lokanirodhagāminippaṭipadaṃ,lokanirodhagaminippatipadam,1,1,0,0,27
7708,bhāvanābhi,bhavanabhi,2,2,0,0,10
7709,paṭipannoti,patipannoti,89,63,26,0,11
7710,sotāpattimaggena,sotapattimaggena,126,121,5,0,16
7711,sugatotiādinā,sugatotiadina,3,1,2,0,13
7712,ayamattho,ayamattho,772,763,9,0,9
7713,vibhāvetabbo,vibhavetabbo,69,67,2,0,12
7714,nibbānameva,nibbanameva,166,156,10,0,11
7715,yathārahaṃ,yatharaham,1090,1044,46,0,10
7716,gadatīti,gadatiti,16,16,0,0,8
7717,takāraṃ,takaram,51,51,0,0,7
7718,sobhana,sobhana,3,3,0,0,7
7719,gamanatādīhi,gamanatadihi,1,1,0,0,12
7720,ādaranaṃ,adaranam,2,2,0,0,8
7721,ādaro,adaro,25,24,1,0,5
7722,daradhātu,daradhatu,1,1,0,0,9
7723,ādare,adare,3,3,0,0,5
7724,visuddhāhi,visuddhahi,1,1,0,0,10
7725,kantita,kantita,1,1,0,0,7
7726,sarīranikkhantabyāmamattaraṃsīhi,sariranikkhantabyamamattaramsihi,1,1,0,0,32
7727,paññāpuññasaṅkhātalakkhisa,pannapunnasankhatalakkhisa,1,1,0,0,26
7728,mūhānaṃ,muhanam,1,1,0,0,7
7729,M0.0115,M0.0115,75,75,0,0,7
7730,gupitamindriyehi,gupitamindriyehi,1,1,0,0,16
7731,gupitabbehi,gupitabbehi,1,1,0,0,11
7732,cakkhādiindriyehi,cakkhadiindriyehi,1,1,0,0,17
7733,sūriyamaṇḍalacandamaṇḍalādīhi,suriyamandalacandamandaladihi,1,1,0,0,29
7734,sūriya,suriya,2,2,0,0,6
7735,maṇḍalacandamaṇḍalādiṃ,mandalacandamandaladim,1,1,0,0,22
7736,sattarasamavandanagāthāvaṇṇanā,sattarasamavandanagathavannana,1,1,0,0,30
7737,sattarasamagāthāya,sattarasamagathaya,1,1,0,0,18
7738,taritādīhi,taritadihi,1,1,0,0,10
7739,sattarasakkharehi,sattarasakkharehi,1,1,0,0,17
7740,mandakkantāgāthāti,mandakkantagathati,1,1,0,0,18
7741,mandakkantā,mandakkanta,2,1,1,0,11
7742,gā,ga,67,56,11,0,2
7743,yugutvassa,yugutvassa,1,1,0,0,10
7744,kehī,kehi,1,1,0,0,4
7745,panāyamattho,panayamattho,8,8,0,0,12
7746,yugutvassakehi,yugutvassakehi,1,1,0,0,14
7747,catu,catu,48,33,15,0,4
7748,sattayatīhi,sattayatihi,3,3,0,0,11
7749,tagaṇa,tagana,2,2,0,0,6
7750,garū,garu,76,69,7,0,4
7751,mandakkantāgāthānāmāti,mandakkantagathanamati,1,1,0,0,22
7752,yugutvassakehīti,yugutvassakehiti,1,1,0,0,16
7753,yugasaddassa,yugasaddassa,1,1,0,0,12
7754,maggaphalacatubbidhapurisayugaḷavācakattā,maggaphalacatubbidhapurisayugalavacakatta,1,1,0,0,41
7755,yugasaddo,yugasaddo,5,5,0,0,9
7756,catusaṅkhyāvācako,catusankhyavacako,1,1,0,0,17
7757,utūnaṃ,utunam,49,47,2,0,6
7758,hemantasisira,hemantasisira,1,1,0,0,13
7759,vassanta,vassanta,1,1,0,0,8
7760,gimha,gimha,2,1,1,0,5
7761,vassāna,vassana,3,3,0,0,7
7762,sarada,sarada,3,3,0,0,6
7763,utuvasena,utuvasena,10,10,0,0,9
7764,chabbidhattā,chabbidhatta,4,4,0,0,12
7765,utusaddo,utusaddo,3,3,0,0,8
7766,chasaṅkhyāvācako,chasankhyavacako,1,1,0,0,16
7767,assasaddo,assasaddo,4,4,0,0,9
7768,M0.0116,M0.0116,74,74,0,0,7
7769,chappaccayaṭīkādīsu,chappaccayatikadisu,1,0,1,0,19
7770,assasaddassa,assasaddassa,3,3,0,0,12
7771,sattasaṅkhyāvācakabhāvo,sattasankhyavacakabhavo,2,2,0,0,23
7772,dhammarājā,dhammaraja,256,217,39,0,10
7773,etissaṃ,etissam,44,44,0,0,7
7774,vaṇṇayissāmi,vannayissami,11,11,0,0,12
7775,muhapaṭighāsādi,muhapatighasadi,3,2,1,0,15
7776,ullolavīciṃ,ullolavicim,1,0,1,0,11
7777,mohadosataṇhādisaṅkhātaṃ,mohadosatanhadisankhatam,2,2,0,0,24
7778,mahātaraṅga,mahataranga,2,2,0,0,11
7779,khuddaūmikaṃ,khuddaumikam,1,1,0,0,12
7780,muyhanti,muyhanti,48,46,2,0,8
7781,muyhati,muyhati,44,44,0,0,7
7782,muyhanamattamevetanti,muyhanamattamevetanti,1,1,0,0,21
7783,muho,muho,2,2,0,0,4
7784,muhadhātu,muhadhatu,1,1,0,0,9
7785,vekhitte,vekhitte,1,1,0,0,8
7786,paṭihaññanti,patihannanti,12,12,0,0,12
7787,paṭihaññati,patihannati,125,121,4,0,11
7788,paṭihaññanamattamevetanti,patihannanamattamevetanti,1,1,0,0,25
7789,paṭigho,patigho,95,87,8,0,7
7790,doso,doso,1897,1814,83,0,4
7791,paṭipubba,patipubba,2,2,0,0,9
7792,hanadhātu,hanadhatu,8,8,0,0,9
7793,hiṃsāgatīsu,himsagatisu,12,10,2,0,11
7794,asanaṃ,asanam,93,75,18,0,6
7795,icchanaṃ,icchanam,13,13,0,0,8
7796,āsā,asa,169,138,31,0,3
7797,isudhātu,isudhatu,3,3,0,0,8
7798,issa,issa,41,37,4,0,4
7799,ā,a,662,349,313,0,1
7800,muhapaṭighāsā,muhapatighasa,1,1,0,0,13
7801,lobhādikilesā,lobhadikilesa,1,1,0,0,13
7802,ādisaddena,adisaddena,240,239,1,0,10
7803,māna,mana,93,59,34,0,4
7804,diṭṭhi,ditthi,1896,1819,77,0,6
7805,vicikicchā,vicikiccha,707,663,44,0,10
7806,thina,thina,5,5,0,0,5
7807,uddhacca,uddhacca,14,11,3,0,8
7808,ahirika,ahirika,5,5,0,0,7
7809,anottappakilese,anottappakilese,1,1,0,0,15
7810,akusalacittuppāde,akusalacittuppade,1,1,0,0,17
7811,saṅgaṇhāti,sanganhati,987,985,2,0,10
7812,lolati,lolati,1,1,0,0,6
7813,ākuletīti,akuletiti,1,1,0,0,9
7814,ullolo,ullolo,7,5,2,0,6
7815,mahātaraṅgo,mahatarango,1,1,0,0,11
7816,upubbalola,upubbalola,1,1,0,0,10
7817,ummādane,ummadane,6,6,0,0,8
7818,tīraṃ,tiram,338,322,16,0,5
7819,ulati,ulati,24,24,0,0,5
7820,uladhātu,uladhatu,1,1,0,0,8
7821,olapaccayo,olapaccayo,1,1,0,0,10
7822,vimhayaṃ,vimhayam,12,12,0,0,8
7823,vicittaṃ,vicittam,90,82,8,0,8
7824,cinotīti,cinotiti,8,8,0,0,8
7825,vīci,vici,38,35,3,0,4
7826,khuddakaūmi,khuddakaumi,1,1,0,0,11
7827,caye,caye,55,47,8,0,4
7828,ullolavīci,ullolavici,4,4,0,0,10
7829,kesuci,kesuci,131,131,0,0,6
7830,kullolavīcintipāṭho,kullolavicintipatho,1,1,0,0,19
7831,kullasaddassa,kullasaddassa,1,1,0,0,13
7832,uḷumpatthavācakattā,ulumpatthavacakatta,1,1,0,0,19
7833,ullolasaddoyeva,ullolasaddoyeva,1,1,0,0,15
7834,mahātaraṅgattha,mahatarangattha,1,1,0,0,15
7835,tu,tu,2928,2671,257,0,2
7836,kallolo,kallolo,5,3,2,0,7
7837,mahāvīcisu,mahavicisu,1,1,0,0,10
7838,kathyate,kathyate,16,16,0,0,8
7839,mūlapaṇṇāsaṭṭhakathāyañca,mulapannasatthakathayanca,1,0,1,0,25
7840,kullo,kullo,31,24,7,0,5
7841,taraṇatthāya,taranatthaya,6,6,0,0,12
7842,kalāpaṃ,kalapam,19,15,4,0,7
7843,bandho,bandho,107,88,19,0,6
7844,pattharitvā,pattharitva,135,129,6,0,11
7845,baddhā,baddha,234,207,27,0,6
7846,padaracāṭi,padaracati,1,1,0,0,10
7847,ādayo,adayo,1346,1341,5,0,5
7848,M0.0117,M0.0117,76,76,0,0,7
7849,uḷumpo,ulumpo,15,12,3,0,6
7850,muhapaṭighāsādieva,muhapatighasadieva,1,1,0,0,18
7851,saṃsāroghe,samsaroghe,1,1,0,0,10
7852,muhapaṭighāsādiullolavīci,muhapatighasadiullolavici,1,1,0,0,25
7853,samāsantataddhitāyaṃ,samasantataddhitayam,1,1,0,0,20
7854,pītisukhaṃ,pitisukham,308,289,19,0,10
7855,mahāsannaṃ,mahasannam,2,2,0,0,10
7856,rattidivantyādīsu,rattidivantyadisu,1,1,0,0,17
7857,mahāsanaṃ,mahasanam,7,6,1,0,9
7858,ratti,ratti,368,343,25,0,5
7859,rattidivaṃ,rattidivam,13,13,0,0,10
7860,rattidivanti,rattidivanti,1,1,0,0,12
7861,bahubbīhisamāsoyaṃ,bahubbihisamasoyam,2,2,0,0,18
7862,bhāyitabbā,bhayitabba,2,2,0,0,10
7863,mahātaraṅgaūmivegādayo,mahatarangaumivegadayo,1,1,0,0,22
7864,saṃsumāra,samsumara,3,3,0,0,9
7865,timi,timi,29,26,3,0,4
7866,tipiṅgalādi,tipingaladi,1,1,0,0,11
7867,macchamakārādayo,macchamakaradayo,1,1,0,0,16
7868,okiṇṇā,okinna,29,27,2,0,6
7869,mohādikilesā,mohadikilesa,1,1,0,0,12
7870,akusalacittuppādā,akusalacittuppada,24,20,4,0,17
7871,nibbattā,nibbatta,445,440,5,0,8
7872,bhayānakā,bhayanaka,13,13,0,0,9
7873,jātijarābyādhimaraṇadukkhādayo,jatijarabyadhimaranadukkhadayo,1,1,0,0,30
7874,khandhādayo,khandhadayo,43,41,2,0,11
7875,saṃsārasaṅkhātaṃ,samsarasankhatam,3,3,0,0,16
7876,oghaṃ,ogham,170,132,38,0,5
7877,samuddajalappavāhaṃ,samuddajalappavaham,2,2,0,0,19
7878,khandhadhātuāyata,khandhadhatuayata,1,1,0,0,17
7879,nānaṃ,nanam,199,183,16,0,5
7880,ottharitvā,ottharitva,67,62,5,0,10
7881,haratīti,haratiti,115,87,28,0,8
7882,jalappavāho,jalappavaho,6,6,0,0,11
7883,avapubba,avapubba,7,7,0,0,8
7884,avasaddo,avasaddo,5,5,0,0,8
7885,ottharaṇattho,ottharanattho,1,1,0,0,13
7886,patite,patite,54,54,0,0,6
7887,haneti,haneti,3,1,2,0,6
7888,osīdāpetīti,osidapetiti,3,3,0,0,11
7889,osīdāpane,osidapane,1,1,0,0,9
7890,heṭṭhābhāgattho,hetthabhagattho,1,1,0,0,15
7891,M0.0118,M0.0118,74,74,0,0,7
7892,sattasaṅkhāre,sattasankhare,2,2,0,0,13
7893,abhibhavitvā,abhibhavitva,406,384,22,0,12
7894,vaṭṭasmiṃ,vattasmim,68,67,1,0,9
7895,ohaneti,ohaneti,1,1,0,0,7
7896,osīdāpeti,osidapeti,4,4,0,0,9
7897,sattasaṅkhāreti,sattasankhareti,1,1,0,0,15
7898,saṃsāroeva,samsaroeva,1,1,0,0,10
7899,saṃsārogho,samsarogho,2,2,0,0,10
7900,maggoḷumpenāti,maggolumpenati,1,0,1,0,14
7901,maggaoḷumpenāti,maggaolumpenati,1,1,0,0,15
7902,aṭṭhamaggaṅgasaṅkhātena,atthamaggangasankhatena,2,2,0,0,23
7903,kullenāti,kullenati,3,1,2,0,9
7904,aṭṭhaṅgikamaggo,atthangikamaggo,3,3,0,0,15
7905,magganti,magganti,26,25,1,0,8
7906,agataṃ,agatam,38,30,8,0,6
7907,nibbānanti,nibbananti,232,229,3,0,10
7908,sāvakā,savaka,711,697,14,0,6
7909,dassiyatīti,dassiyatiti,1,1,0,0,11
7910,mahāvaggasaṃyuttaṭṭhakathāyaṃ,mahavaggasamyuttatthakathayam,1,0,1,0,29
7911,magganiyaṭṭhena,magganiyatthena,3,3,0,0,15
7912,paṭipajjiyatīti,patipajjiyatiti,3,3,0,0,15
7913,uḷu,ulu,7,4,3,0,3
7914,pāti,pati,129,119,10,0,4
7915,rakkhatīti,rakkhatiti,169,132,37,0,10
7916,uḷupo,ulupo,3,3,0,0,5
7917,niggahitāgamavasena,niggahitagamavasena,3,3,0,0,19
7918,uḷusaddūpapadapādhātu,ulusaddupapadapadhatu,1,1,0,0,21
7919,maggoeva,maggoeva,1,1,0,0,8
7920,maggoḷumpo,maggolumpo,3,3,0,0,10
7921,maggasaṅkhāto,maggasankhato,7,7,0,0,13
7922,maggasadiso,maggasadiso,1,1,0,0,11
7923,uḷumpoeva,ulumpoeva,1,1,0,0,9
7924,uḷumpasaṅkhāto,ulumpasankhato,1,1,0,0,14
7925,uḷumpa,ulumpa,1,1,0,0,6
7926,maggoḷumpoti,maggolumpoti,1,1,0,0,12
7927,rūpakasadisaupamā,rupakasadisaupama,1,1,0,0,17
7928,samupekkhatthavasena,samupekkhatthavasena,1,1,0,0,20
7929,parapakkha,parapakkha,1,1,0,0,10
7930,sakapakkhatthavasena,sakapakkhatthavasena,1,1,0,0,20
7931,tarīti,tariti,1,0,1,0,6
7932,atari,atari,32,31,1,0,5
7933,M0.0119,M0.0119,76,76,0,0,7
7934,taritvā,taritva,73,69,4,0,7
7935,nibbānatīraṃ,nibbanatiram,4,4,0,0,12
7936,atītā,atita,365,346,19,0,5
7937,pāpuṇiṃsu,papunimsu,222,222,0,0,9
7938,anāgatā,anagata,336,327,9,0,7
7939,pāpuṇissantīti,papunissantiti,10,10,0,0,14
7940,mahāvaggasaṃyutte,mahavaggasamyutte,4,3,1,0,17
7941,ekāyanaṃ,ekayanam,25,19,6,0,8
7942,jātikhayantadassī,jatikhayantadassi,26,22,4,0,17
7943,hitānukampī,hitanukampi,54,50,4,0,11
7944,tariṃsu,tarimsu,25,23,2,0,7
7945,tarissantiyeva,tarissantiyeva,2,2,0,0,14
7946,taranti,taranti,126,111,15,0,7
7947,saṃsārasotaṃ,samsarasotam,24,20,4,0,12
7948,chinditvā,chinditva,869,852,17,0,9
7949,viddhaṃsetvā,viddhamsetva,60,59,1,0,12
7950,dhammanāvaṃ,dhammanavam,19,17,2,0,11
7951,samāruyha,samaruyha,21,21,0,0,9
7952,tāremi,taremi,11,11,0,0,6
7953,janataṃ,janatam,205,187,18,0,7
7954,bahuṃ,bahum,1428,1362,66,0,5
7955,jātijarābyādhimaraṇabhayādīnaṃ,jatijarabyadhimaranabhayadinam,1,1,0,0,30
7956,abhayoti,abhayoti,6,2,4,0,8
7957,abhayanti,abhayanti,3,3,0,0,9
7958,jātiādibhayaṃ,jatiadibhayam,2,2,0,0,13
7959,dutiyavikappe,dutiyavikappe,57,57,0,0,13
7960,pārantipade,parantipade,1,1,0,0,11
7961,pāranti,paranti,8,8,0,0,7
7962,saṃsāravaṭṭassa,samsaravattassa,13,11,2,0,15
7963,paratīraṭṭhena,paratiratthena,1,1,0,0,14
7964,pādhātu,padhatu,1,1,0,0,7
7965,pāreti,pareti,8,8,0,0,6
7966,samattheti,samattheti,78,78,0,0,10
7967,taraṅgādayo,tarangadayo,2,2,0,0,11
7968,vāretunti,varetunti,5,5,0,0,9
7969,pāradhātu,paradhatu,1,1,0,0,9
7970,samatthiyaṃ,samatthiyam,1,1,0,0,11
7971,bhayādiṃ,bhayadim,1,1,0,0,8
7972,jātibhayādayo,jatibhayadayo,1,1,0,0,13
7973,pajjittha,pajjittha,3,3,0,0,9
7974,adhigamitthāti,adhigamitthati,1,1,0,0,14
7975,pārapatto,parapatto,2,2,0,0,9
7976,mutto,mutto,407,388,19,0,5
7977,moceyyantiādinā,moceyyantiadina,1,1,0,0,15
7978,pavattassa,pavattassa,149,148,1,0,10
7979,mahābhinīhārassa,mahabhiniharassa,3,3,0,0,16
7980,sakalassa,sakalassa,127,123,4,0,9
7981,saṃsāradukkhassa,samsaradukkhassa,19,19,0,0,16
7982,sabbaññutañāṇādiguṇānaṃ,sabbannutananadigunanam,1,1,0,0,23
7983,pariyantaṃ,pariyantam,184,172,12,0,10
7984,pārasaddo,parasaddo,1,1,0,0,9
7985,pariyanta,pariyanta,7,6,1,0,9
7986,kammakilesehi,kammakilesehi,36,36,0,0,13
7987,pajāti,pajati,48,13,35,0,6
7988,M0.0120,M0.0120,75,75,0,0,7
7989,tāyanaṭṭhena,tayanatthena,5,5,0,0,12
7990,bhayato,bhayato,206,187,19,0,7
7991,tāyati,tayati,79,78,1,0,6
7992,tāṇo,tano,7,6,1,0,4
7993,tādhātu,tadhatu,2,2,0,0,7
7994,tāṇanti,tananti,6,5,1,0,7
7995,paripālanaṭṭhena,paripalanatthena,5,5,0,0,16
7996,magga,magga,52,40,12,0,5
7997,phalanibbānasukhaṃ,phalanibbanasukham,1,1,0,0,18
7998,dadanto,dadanto,144,141,3,0,7
7999,pāletīti,paletiti,28,24,4,0,8
8000,nilīyanaṭṭhena,niliyanatthena,4,4,0,0,14
8001,jātibhayādīhi,jatibhayadihi,1,1,0,0,13
8002,līyanti,liyanti,4,4,0,0,7
8003,nilīyanti,niliyanti,13,13,0,0,9
8004,līdhātu,lidhatu,1,1,0,0,7
8005,nilīyane,niliyane,1,1,0,0,8
8006,leṇanti,lenanti,6,6,0,0,7
8007,saṃsārabhayaṃ,samsarabhayam,3,3,0,0,13
8008,passantehi,passantehi,8,8,0,0,10
8009,saṃsāranissaraṇatthikehi,samsaranissaranatthikehi,4,4,0,0,24
8010,leṇoti,lenoti,1,1,0,0,6
8011,saṃsārabhayehi,samsarabhayehi,1,1,0,0,14
8012,pīḷitānaṃ,pilitanam,3,2,1,0,9
8013,parāyanaṃ,parayanam,29,28,1,0,9
8014,asadisaavassayanaṃ,asadisaavassayanam,2,2,0,0,18
8015,sīlādiguṇenāti,siladigunenati,1,1,0,0,14
8016,avassayati,avassayati,12,12,0,0,10
8017,asamasaraṇo,asamasarano,1,1,0,0,11
8018,sambhāva,sambhava,1,1,0,0,8
8019,nākammadhārayasamāsoyaṃ,nakammadharayasamasoyam,1,1,0,0,23
8020,sabbasampattisukhānaṃ,sabbasampattisukhanam,1,1,0,0,21
8021,dāyakattā,dayakatta,3,3,0,0,9
8022,anaññasādhāraṇaṃ,anannasadharanam,55,54,1,0,16
8023,avassayanaṃ,avassayanam,4,4,0,0,11
8024,nibbānapāragamanānaṃ,nibbanaparagamananam,2,2,0,0,20
8025,ekatitthabhūtaṃ,ekatitthabhutam,1,1,0,0,15
8026,uttaranti,uttaranti,42,42,0,0,9
8027,najjasamuddādinti,najjasamuddadinti,1,1,0,0,17
8028,titthaṃ,tittham,149,117,32,0,7
8029,najjasamuddādīnaṃ,najjasamuddadinam,1,1,0,0,17
8030,pārimatīragamanatthaṃ,parimatiragamanattham,1,1,0,0,21
8031,otaraṇaṭṭhānaṃ,otaranatthanam,5,5,0,0,14
8032,taradhātu,taradhatu,1,1,0,0,9
8033,otaraṇe,otarane,3,3,0,0,7
8034,rassa,rassa,42,41,1,0,5
8035,ikārāgamo,ikaragamo,18,16,2,0,9
8036,ekaṃ,ekam,17068,16630,438,0,4
8037,ekatittho,ekatittho,1,1,0,0,9
8038,titthena,titthena,25,25,0,0,8
8039,najjādiṃ,najjadim,2,2,0,0,8
8040,tarantā,taranta,17,17,0,0,7
8041,pāpuṇanti,papunanti,335,324,11,0,9
8042,atitthena,atitthena,23,22,1,0,9
8043,seṭṭhabhūtena,setthabhutena,5,5,0,0,13
8044,buddhatitthena,buddhatitthena,1,1,0,0,14
8045,M0.0121,M0.0121,75,75,0,0,7
8046,veneyyasattā,veneyyasatta,11,9,2,0,12
8047,aññatitthiyena,annatitthiyena,1,1,0,0,14
8048,ekatitthoti,ekatitthoti,1,1,0,0,11
8049,tittho,tittho,2,2,0,0,6
8050,taritukāmā,taritukama,2,2,0,0,10
8051,buddhatitthe,buddhatitthe,1,1,0,0,12
8052,desitadhammaṃ,desitadhammam,3,3,0,0,13
8053,desitadhammānurūpaṃ,desitadhammanurupam,1,1,0,0,19
8054,paṭipajjitvā,patipajjitva,98,96,2,0,12
8055,ititasmā,ititasma,1,1,0,0,8
8056,etthātipadena,etthatipadena,1,1,0,0,13
8057,niddiṭṭho,niddittho,244,233,11,0,9
8058,aññatitthiyā,annatitthiya,247,239,8,0,12
8059,ekatitthā,ekatittha,1,1,0,0,9
8060,mahādīpaṃ,mahadipam,6,6,0,0,9
8061,ādhārabhūtaṃ,adharabhutam,6,6,0,0,12
8062,parāyananti,parayananti,4,4,0,0,11
8063,patiṭṭho,patittho,9,7,2,0,8
8064,patipubbaṭṭhādhātu,patipubbatthadhatu,1,1,0,0,18
8065,gatinivattimhi,gatinivattimhi,9,9,0,0,14
8066,sabbasukhatthikānaṃ,sabbasukhatthikanam,1,1,0,0,19
8067,mahādīpo,mahadipo,6,6,0,0,8
8068,parāyano,parayano,10,10,0,0,8
8069,nibbānasukhatthikānaṃ,nibbanasukhatthikanam,2,2,0,0,21
8070,puññabījassa,punnabijassa,4,4,0,0,12
8071,khettabhūtaṃ,khettabhutam,4,4,0,0,12
8072,puññatthikānaṃ,punnatthikanam,13,12,1,0,14
8073,vapanaṭhānaṃ,vapanathanam,1,1,0,0,12
8074,pavati,pavati,11,11,0,0,6
8075,pujjabhāvaṃ,pujjabhavam,1,1,0,0,11
8076,janetīti,janetiti,196,166,30,0,8
8077,pūjasaddūpapada,pujasaddupapada,1,1,0,0,15
8078,saddasiddhi,saddasiddhi,27,27,0,0,11
8079,avasesaṃ,avasesam,430,386,44,0,8
8080,apuññaṃ,apunnam,178,169,9,0,7
8081,khittaṃ,khittam,79,73,6,0,7
8082,bījaṃ,bijam,381,343,38,0,5
8083,khettaṃ,khettam,540,470,70,0,7
8084,kedārādi,kedaradi,4,4,0,0,8
8085,khipasaddūpapada,khipasaddupapada,1,1,0,0,16
8086,bījāni,bijani,147,140,7,0,6
8087,vapantānaṃ,vapantanam,2,2,0,0,10
8088,mahapphalabhāvakaraṇena,mahapphalabhavakaranena,18,17,1,0,23
8089,khipanti,khipanti,87,84,3,0,8
8090,vapanti,vapanti,48,46,2,0,7
8091,bījānīti,bijaniti,9,4,5,0,8
8092,khipadhātu,khipadhatu,1,1,0,0,10
8093,peraṇe,perane,23,15,8,0,6
8094,khepe,khepe,14,8,6,0,5
8095,khetto,khetto,3,3,0,0,6
8096,puññabījāni,punnabijani,2,2,0,0,11
8097,mahapphala,mahapphala,5,5,0,0,10
8098,bhāvakaraṇena,bhavakaranena,1,1,0,0,13
8099,M0.0122,M0.0122,77,77,0,0,7
8100,puññabījaṃ,punnabijam,1,1,0,0,10
8101,khipiyanti,khipiyanti,1,1,0,0,10
8102,vapiyanti,vapiyanti,1,1,0,0,9
8103,dhammarājāti,dhammarajati,14,8,6,0,12
8104,puññānaṃ,punnanam,105,95,10,0,8
8105,puññakkhetto,punnakkhetto,6,6,0,0,12
8106,amaccādīnaṃ,amaccadinam,9,9,0,0,11
8107,sālīnaṃ,salinam,57,49,8,0,7
8108,yavānaṃ,yavanam,8,8,0,0,7
8109,virūhanaṭṭhānaṃ,viruhanatthanam,4,4,0,0,15
8110,sālikhettaṃ,salikhettam,8,8,0,0,11
8111,yavakhettanti,yavakhettanti,2,2,0,0,13
8112,puññamahabbalabhāvakaraṇena,punnamahabbalabhavakaranena,1,1,0,0,27
8113,virūha,viruha,1,1,0,0,6
8114,naṭṭhānaṃ,natthanam,3,3,0,0,9
8115,nissāya,nissaya,3872,3780,92,0,7
8116,nānāppakārahita,nanappakarahita,1,1,0,0,15
8117,sukhasaṃvattanikāni,sukhasamvattanikani,1,1,0,0,19
8118,puññāni,punnani,1047,1032,15,0,7
8119,virūhanti,viruhanti,16,16,0,0,9
8120,puññakkhettanti,punnakkhettanti,2,2,0,0,15
8121,dadamānaṃ,dadamanam,22,21,1,0,9
8122,paramaṃ,paramam,432,350,82,0,7
8123,paramasaddo,paramasaddo,2,2,0,0,11
8124,uttamatthavācako,uttamatthavacako,2,2,0,0,16
8125,anipphannapāṭi,anipphannapati,2,2,0,0,14
8126,padiko,padiko,4,3,1,0,6
8127,mānitabbanti,manitabbanti,1,1,0,0,12
8128,parapubbamādhātu,parapubbamadhatu,1,1,0,0,16
8129,māne,mane,62,54,8,0,4
8130,ramiyati,ramiyati,2,2,0,0,8
8131,papubbaramudhātu,papubbaramudhatu,1,1,0,0,16
8132,ramane,ramane,3,3,0,0,6
8133,abhidhānaṭīkāyaṃ,abhidhanatikayam,4,0,4,0,16
8134,paccanīkaṃ,paccanikam,123,116,7,0,10
8135,pakaṭṭhabhāve,pakatthabhave,2,2,0,0,13
8136,ramatīti,ramatiti,59,49,10,0,8
8137,paramasukhaṃ,paramasukham,13,12,1,0,12
8138,paramasukhado,paramasukhado,1,1,0,0,13
8139,paramasukhasaddūpapada,paramasukhasaddupapada,1,1,0,0,22
8140,catupaccayappaṭiggahaṇena,catupaccayappatiggahanena,1,1,0,0,25
8141,detīti,detiti,323,195,128,0,6
8142,lokuttaradhammehi,lokuttaradhammehi,9,9,0,0,17
8143,rañjeti,ranjeti,14,11,3,0,7
8144,tosetīti,tosetiti,19,17,2,0,8
8145,pāramīdhammeneva,paramidhammeneva,3,3,0,0,16
8146,buddhattaṃ,buddhattam,71,70,1,0,10
8147,jātoti,jatoti,265,229,36,0,6
8148,rājāti,rajati,103,57,46,0,6
8149,muha,muha,19,10,9,0,4
8150,paṭighāsādiullolavīciṃ,patighasadiullolavicim,1,1,0,0,22
8151,khuddakaūmikaṃ,khuddakaumikam,1,1,0,0,14
8152,M0.0123,M0.0123,73,73,0,0,7
8153,kullena,kullena,9,8,1,0,7
8154,atariṃ,atarim,6,5,1,0,6
8155,jātiādīnaṃ,jatiadinam,58,55,3,0,10
8156,adhigataṃ,adhigatam,258,238,20,0,9
8157,rakkhaṇaṃ,rakkhanam,44,42,2,0,9
8158,nilīyanaṃ,niliyanam,12,11,1,0,9
8159,ekatittha,ekatittha,1,1,0,0,9
8160,vapanaṭṭhānaṃ,vapanatthanam,1,1,0,0,13
8161,dhammehi,dhammehi,2593,2574,19,0,8
8162,rañjāpanaṃ,ranjapanam,1,1,0,0,10
8163,buddhabhāvaṃ,buddhabhavam,75,65,10,0,12
8164,aṭṭhārasamavandanagāthāvaṇṇanā,attharasamavandanagathavannana,1,1,0,0,30
8165,aṭṭhārasamagāthāya,attharasamagathaya,1,1,0,0,18
8166,sāvatthiyaṃ,savatthiyam,2402,2377,25,0,11
8167,kaṇḍambamūle,kandambamule,13,13,0,0,12
8168,iddhipāṭiherādīhi,iddhipatiheradihi,1,1,0,0,17
8169,gāthamāha,gathamaha,2177,2176,1,0,9
8170,matanayayayagaṇehi,matanayayayaganehi,1,1,0,0,18
8171,yati,yati,92,80,12,0,4
8172,chayati,chayati,2,2,0,0,7
8173,sattaya,sattaya,1,1,0,0,7
8174,aṭṭhārasakkharehi,attharasakkharehi,1,1,0,0,17
8175,kusumitalatā,kusumitalata,5,4,1,0,12
8176,vellitāgāthāti,vellitagathati,1,1,0,0,14
8177,mo,mo,120,89,31,0,2
8178,vellitākkhutvisīhī,vellitakkhutvisihi,1,1,0,0,18
8179,akkhutvisīhi,akkhutvisihi,1,1,0,0,12
8180,pañcayati,pancayati,2,2,0,0,9
8181,mogaṇo,mogano,1,1,0,0,6
8182,togaṇo,togano,1,1,0,0,6
8183,nogaṇo,nogano,1,1,0,0,6
8184,yogaṇo,yogano,3,3,0,0,6
8185,yagaṇadvayañca,yaganadvayanca,1,1,0,0,14
8186,M0.0124,M0.0124,74,74,0,0,7
8187,vellitā,vellita,5,4,1,0,7
8188,akkhasaddassa,akkhasaddassa,1,1,0,0,13
8189,pañcindriyavācakattā,pancindriyavacakatta,1,1,0,0,20
8190,akkhasaddo,akkhasaddo,3,3,0,0,10
8191,pañcasaṅkhyāvācakoti,pancasankhyavacakoti,1,1,0,0,20
8192,hemantasisīravassantagimhavassānasaradavasena,hemantasisiravassantagimhavassanasaradavasena,1,1,0,0,45
8193,chasaṅkhyāvācakoti,chasankhyavacakoti,3,3,0,0,18
8194,vipassīādīnaṃ,vipassiadinam,12,12,0,0,13
8195,sattavidhattā,sattavidhatta,1,1,0,0,13
8196,veditabboti,veditabboti,434,405,29,0,11
8197,parahitakaroti,parahitakaroti,2,1,1,0,14
8198,attanā,attana,3510,3412,98,0,6
8199,taṃsamaṅgino,tamsamangino,88,83,5,0,12
8200,lokiyalokuttarasukhaṃ,lokiyalokuttarasukham,2,2,0,0,21
8201,parahitaṃ,parahitam,16,16,0,0,9
8202,dīpaṅkarassa,dipankarassa,69,65,4,0,12
8203,hitasukhatthāya,hitasukhatthaya,6,6,0,0,15
8204,kappasata,kappasata,2,2,0,0,9
8205,sahassādhikāni,sahassadhikani,1,1,0,0,14
8206,pañcamahāpariccāge,pancamahapariccage,3,3,0,0,18
8207,sabbaññubuddhabhāvaṃ,sabbannubuddhabhavam,1,1,0,0,20
8208,pattakāle,pattakale,60,59,1,0,9
8209,pañcacattālīsavassāni,pancacattalisavassani,8,8,0,0,21
8210,dhamma,dhamma,184,125,59,0,6
8211,lokiyalokuttarahita,lokiyalokuttarahita,1,1,0,0,19
8212,agāriya,agariya,1,1,0,0,7
8213,paccekamunivasena,paccekamunivasena,1,1,0,0,17
8214,indoti,indoti,19,14,5,0,6
8215,kaṇḍambamūleti,kandambamuleti,1,0,1,0,14
8216,kaṇḍaambamūleti,kandaambamuleti,1,1,0,0,15
8217,bindāgamo,bindagamo,22,22,0,0,9
8218,kaṇḍanāmikena,kandanamikena,3,3,0,0,13
8219,pasenadīkosalarañño,pasenadikosalaranno,1,1,0,0,19
8220,uyyānapālena,uyyanapalena,17,17,0,0,12
8221,ropitassa,ropitassa,8,7,1,0,9
8222,setambarukkhassa,setambarukkhassa,2,2,0,0,16
8223,samīpeti,samipeti,21,16,5,0,8
8224,kaṇḍanti,kandanti,2,2,0,0,8
8225,tasseva,tasseva,2226,2141,85,0,7
8226,nāmaṃ,namam,3559,3321,238,0,5
8227,ḍeti,deti,36,36,0,0,4
8228,M0.0125,M0.0125,74,74,0,0,7
8229,kaṇḍo,kando,91,89,2,0,5
8230,uyyānapālo,uyyanapalo,44,44,0,0,10
8231,kaṃsaddūpapadaḍi,kamsaddupapadadi,1,1,0,0,16
8232,rukkhesu,rukkhesu,43,42,1,0,8
8233,siñcanaṃ,sincanam,8,7,1,0,8
8234,ṭināti,tinati,1,1,0,0,6
8235,uyyāna,uyyana,7,5,2,0,6
8236,phalakāmehi,phalakamehi,4,4,0,0,11
8237,amiyati,amiyati,1,1,0,0,7
8238,ambo,ambo,54,53,1,0,4
8239,setambarukkho,setambarukkho,4,4,0,0,13
8240,ropito,ropito,5,5,0,0,6
8241,kaṇḍambo,kandambo,3,3,0,0,8
8242,samīpanti,samipanti,4,4,0,0,9
8243,kaṇḍambamūlaṃ,kandambamulam,1,1,0,0,13
8244,nisinnoti,nisinnoti,44,36,8,0,9
8245,vasamāno,vasamano,57,56,1,0,8
8246,vimhāpaniyaṭṭhena,vimhapaniyatthena,1,1,0,0,17
8247,ayañhi,ayanhi,791,768,23,0,6
8248,accherasaddo,accherasaddo,1,1,0,0,12
8249,vimhayatthavācako,vimhayatthavacako,1,1,0,0,17
8250,vimhayo,vimhayo,11,7,4,0,7
8251,caradhātu,caradhatu,4,4,0,0,9
8252,caradhātussaccherādeso,caradhatussaccheradeso,1,1,0,0,22
8253,andhassa,andhassa,39,35,4,0,8
8254,pabbatārohanaṃ,pabbatarohanam,6,6,0,0,14
8255,pabbātārohanaṃ,pabbatarohanam,1,1,0,0,14
8256,kadāciyeva,kadaciyeva,9,9,0,0,10
8257,pāṭihāriyaṃ,patihariyam,361,306,55,0,11
8258,accheranti,accheranti,2,2,0,0,10
8259,nettiaṭṭhakathāyaṃ,nettiatthakathayam,4,1,3,0,18
8260,abhiṇhaṃ,abhinham,317,295,22,0,8
8261,acchariyaṃ,acchariyam,547,502,45,0,10
8262,accharaṃ,accharam,73,68,5,0,8
8263,paharituṃ,paharitum,44,42,2,0,9
8264,yogganti,yogganti,3,3,0,0,8
8265,yoggataddhite,yoggataddhite,1,1,0,0,13
8266,ṇiyapaccayo,niyapaccayo,2,2,0,0,11
8267,acchariyanti,acchariyanti,11,11,0,0,12
8268,iyasaddalopena,iyasaddalopena,1,1,0,0,14
8269,sīlakkhandhavaggaṭṭhakathāyaṃ,silakkhandhavaggatthakathayam,1,0,1,0,29
8270,saddanayo,saddanayo,12,9,3,0,9
8271,aṭṭhakathānayo,atthakathanayo,29,27,2,0,14
8272,accharāyogganti,accharayogganti,5,4,1,0,15
8273,yuttanti,yuttanti,176,175,1,0,8
8274,sobhanapattaṃ,sobhanapattam,2,2,0,0,13
8275,pasādacakkhu,pasadacakkhu,29,24,5,0,12
8276,naye,naye,215,208,7,0,4
8277,nayanasubha,nayanasubha,1,1,0,0,11
8278,saddūpapadagamudhātu,saddupapadagamudhatu,1,1,0,0,20
8279,M0.0126,M0.0126,74,74,0,0,7
8280,ākulaaṇṇaaggijālanti,akulaannaaggijalanti,1,1,0,0,20
8281,parikiṇṇa,parikinna,2,2,0,0,9
8282,udakadhāra,udakadhara,1,1,0,0,10
8283,aggisikhāvantaṃ,aggisikhavantam,1,1,0,0,15
8284,kulaṃ,kulam,535,485,50,0,5
8285,pakiṇṇaṃ,pakinnam,3,2,1,0,8
8286,aññamaññamissakaṃ,annamannamissakam,2,2,0,0,17
8287,udakajālaaggijālavantanti,udakajalaaggijalavantanti,1,1,0,0,25
8288,udakaggijālaṃ,udakaggijalam,5,5,0,0,13
8289,āpubbakuladhātu,apubbakuladhatu,1,1,0,0,15
8290,ābhusaṃ,abhusam,2,2,0,0,7
8291,aññamaññanti,annamannanti,9,8,1,0,12
8292,udakajālaṃ,udakajalam,1,1,0,0,10
8293,aggijālena,aggijalena,4,4,0,0,10
8294,aggijālañca,aggijalanca,2,2,0,0,11
8295,udakajālena,udakajalena,1,1,0,0,11
8296,sammisso,sammisso,3,3,0,0,8
8297,ananti,ananti,5,5,0,0,6
8298,jīvanti,jivanti,143,132,11,0,7
8299,sattāti,sattati,225,121,104,0,7
8300,aṇṇaṃ,annam,4,4,0,0,5
8301,anadhātu,anadhatu,2,2,0,0,8
8302,dvittaṃ,dvittam,186,186,0,0,7
8303,dvibhāvo,dvibhavo,28,28,0,0,8
8304,aradhātu,aradhatu,6,6,0,0,8
8305,gatimhito,gatimhito,1,1,0,0,9
8306,annādeso,annadeso,1,1,0,0,8
8307,nnassa,nnassa,3,3,0,0,6
8308,ṇṇattaṃ,nnattam,1,1,0,0,7
8309,aṇṇassa,annassa,1,1,0,0,7
8310,dhāraṃ,dharam,48,40,8,0,6
8311,uttarapadalopena,uttarapadalopena,143,143,0,0,16
8312,kuṭilabhāvena,kutilabhavena,1,1,0,0,13
8313,aggi,aggi,644,601,43,0,4
8314,ggo,ggo,7,2,5,0,3
8315,jālaṃ,jalam,162,136,26,0,5
8316,sikhaṃ,sikham,39,36,3,0,6
8317,aggino,aggino,40,40,0,0,6
8318,aggijālaṃ,aggijalam,8,8,0,0,9
8319,aṇṇañca,annanca,1,1,0,0,7
8320,aṇṇaggijālaṃ,annaggijalam,2,2,0,0,12
8321,parikiṇṇaṃ,parikinnam,15,14,1,0,10
8322,yamaka,yamaka,31,28,3,0,6
8323,duṭṭhu,dutthu,129,123,6,0,6
8324,diṭṭhivādasaṅkhātajālaṃ,ditthivadasankhatajalam,1,1,0,0,23
8325,viddhaṃsitaṃ,viddhamsitam,10,10,0,0,12
8326,saṃsāravaṭṭeti,samsaravatteti,1,1,0,0,14
8327,dujjālaṃ,dujjalam,1,1,0,0,8
8328,diṭṭhivādajālaṃ,ditthivadajalam,1,1,0,0,15
8329,titthiya,titthiya,2,1,1,0,8
8330,vādo,vado,539,485,54,0,4
8331,dinnantiādinayapavatto,dinnantiadinayapavatto,1,1,0,0,22
8332,saṃsārato,samsarato,78,78,0,0,9
8333,nissaritumappadānavasena,nissaritumappadanavasena,2,2,0,0,24
8334,jālasadisattā,jalasadisatta,3,3,0,0,13
8335,dujjālanti,dujjalanti,1,1,0,0,10
8336,dupubba,dupubba,1,1,0,0,7
8337,dhaṃsati,dhamsati,30,30,0,0,8
8338,yamakapāṭihāriyaṃ,yamakapatihariyam,101,98,3,0,17
8339,munibhi,munibhi,1,1,0,0,7
8340,ajahitanti,ajahitanti,2,2,0,0,10
8341,munibhīti,munibhiti,1,1,0,0,9
8342,sabbasammāsambuddhehi,sabbasammasambuddhehi,3,3,0,0,21
8343,kāyamoneyya,kayamoneyya,1,1,0,0,11
8344,vacīmoneyya,vacimoneyya,1,1,0,0,11
8345,manomoneyyaṃ,manomoneyyam,50,48,2,0,12
8346,M0.0127,M0.0127,77,77,0,0,7
8347,assatthitaddhite,assatthitaddhite,2,2,0,0,16
8348,ṇīpaccayo,nipaccayo,1,1,0,0,9
8349,idhaloka,idhaloka,1,1,0,0,8
8350,paralokaṃ,paralokam,189,175,14,0,9
8351,attahita,attahita,4,4,0,0,8
8352,hitāhitañca,hitahitanca,1,1,0,0,11
8353,munanti,munanti,3,3,0,0,7
8354,jānantīti,janantiti,121,86,35,0,9
8355,munībhi,munibhi,4,4,0,0,7
8356,ajahitaṃ,ajahitam,3,2,1,0,8
8357,apariccattaṃ,apariccattam,17,14,3,0,12
8358,hātabbaṃ,hatabbam,5,5,0,0,8
8359,cajitabbanti,cajitabbanti,1,1,0,0,12
8360,sāvatthinagarassa,savatthinagarassa,5,5,0,0,17
8361,dakkhiṇadvāre,dakkhinadvare,33,33,0,0,13
8362,kaṇḍambarukkhamūle,kandambarukkhamule,22,22,0,0,18
8363,pāṭihāriyañca,patihariyanca,4,4,0,0,13
8364,pāṭihāriyāvasāne,patihariyavasane,1,1,0,0,16
8365,tāvatiṃsapuraṃ,tavatimsapuram,2,1,1,0,14
8366,pārichattakamūlamhi,parichattakamulamhi,1,1,0,0,19
8367,paṇḍukambalanāmake,pandukambalanamake,4,4,0,0,18
8368,sannisinno,sannisinno,16,16,0,0,10
8369,desanā,desana,1171,1077,94,0,6
8370,avijahitā,avijahita,11,9,2,0,9
8371,dhammatāyeva,dhammatayeva,3,3,0,0,12
8372,buddhavaṃsaṭṭhakathāya,buddhavamsatthakathaya,5,4,1,0,22
8373,samatiṃsadhammatāpakāsane,samatimsadhammatapakasane,1,1,0,0,25
8374,sāvatthi,savatthi,101,95,6,0,8
8375,nagaradvāre,nagaradvare,88,85,3,0,11
8376,yamakapāṭihāriyakaraṇaṃ,yamakapatihariyakaranam,3,3,0,0,23
8377,tāvatiṃse,tavatimse,82,81,1,0,9
8378,bhavane,bhavane,88,81,7,0,7
8379,abhidhammadesanāti,abhidhammadesanati,1,1,0,0,18
8380,munībhijahitanti,munibhijahitanti,1,1,0,0,16
8381,paccanīkapaṭiharaṇavasena,paccanikapatiharanavasena,3,3,0,0,25
8382,paṭipakkhe,patipakkhe,59,55,4,0,10
8383,titthiye,titthiye,80,76,4,0,8
8384,madditvā,madditva,232,231,1,0,8
8385,paṭipubbahidhātu,patipubbahidhatu,1,1,0,0,16
8386,hissa,hissa,560,539,21,0,5
8387,heraṇideso,heranideso,1,1,0,0,10
8388,sāsanassa,sasanassa,417,391,26,0,9
8389,harati,harati,262,234,28,0,6
8390,iddhividhañāṇaṃ,iddhividhananam,64,58,6,0,15
8391,paṭipubbaharadhātu,patipubbaharadhatu,1,1,0,0,18
8392,paṭiharati,patiharati,6,6,0,0,10
8393,diṭṭhimānopagatāni,ditthimanopagatani,2,2,0,0,18
8394,cittānīti,cittaniti,25,9,16,0,9
8395,appasannānaṃ,appasannanam,378,375,3,0,12
8396,pasādaṃ,pasadam,230,208,22,0,7
8397,āharatīti,aharatiti,52,48,4,0,9
8398,samāhite,samahite,229,205,24,0,8
8399,citte,citte,1371,1304,67,0,5
8400,vigatūpakkilese,vigatupakkilese,131,125,6,0,15
8401,katakiccena,katakiccena,28,28,0,0,11
8402,paṭipacchā,patipaccha,1,1,0,0,10
8403,haritabbaṃ,haritabbam,34,32,2,0,10
8404,pavattetabbanti,pavattetabbanti,37,37,0,0,15
8405,paṭīti,patiti,12,4,8,0,6
8406,pacchāti,pacchati,74,26,48,0,8
8407,bodheti,bodheti,61,60,1,0,7
8408,paṭipaviṭṭhamhi,patipavitthamhi,15,14,1,0,15
8409,āgacchi,agacchi,86,84,2,0,7
8410,brāhmaṇotiādīsu,brahmanotiadisu,1,1,0,0,15
8411,paṭipunappunaṃ,patipunappunam,1,1,0,0,14
8412,iddhipāṭihāriya,iddhipatihariya,1,1,0,0,15
8413,ādesanāpāṭihāriya,adesanapatihariya,1,1,0,0,17
8414,anusā,anusa,1,1,0,0,5
8415,sanī,sani,2,2,0,0,4
8416,M0.0128,M0.0128,73,73,0,0,7
8417,pāṭihāriyavasena,patihariyavasena,3,3,0,0,16
8418,tividhaṃ,tividham,533,487,46,0,8
8419,iddhipāṭihāriyaṃ,iddhipatihariyam,121,106,15,0,16
8420,khippaṃ,khippam,651,603,48,0,7
8421,āsuṃ,asum,239,230,9,0,4
8422,lahuṃ,lahum,244,223,21,0,5
8423,akāsītipade,akasitipade,1,1,0,0,11
8424,kriyāvisesanaṃ,kriyavisesanam,10,10,0,0,14
8425,lahu,lahu,78,67,11,0,4
8426,ghapaccayo,ghapaccayo,1,1,0,0,10
8427,dīgho,digho,397,381,16,0,5
8428,akāsīti,akasiti,156,132,24,0,7
8429,akari,akari,35,35,0,0,5
8430,pāṭihāriyamevaṃ,patihariyamevam,1,1,0,0,15
8431,abhisambodhito,abhisambodhito,25,25,0,0,14
8432,saṃvacchare,samvacchare,134,133,1,0,11
8433,devānamindena,devanamindena,45,44,1,0,13
8434,āṇāpitena,anapitena,2,2,0,0,9
8435,visukammadevaputtena,visukammadevaputtena,1,1,0,0,20
8436,nimmite,nimmite,20,20,0,0,7
8437,dvādasayojane,dvadasayojane,7,7,0,0,13
8438,maṇḍape,mandape,103,99,4,0,7
8439,yojanappamāṇe,yojanappamane,28,28,0,0,13
8440,ratanapallaṅke,ratanapallanke,10,10,0,0,14
8441,ratanacaṅkame,ratanacankame,21,21,0,0,13
8442,nisīditvā,nisiditva,1650,1631,19,0,9
8443,tiyojanike,tiyojanike,9,9,0,0,10
8444,dibbasetacchatte,dibbasetacchatte,9,8,1,0,16
8445,dhārayamāne,dharayamane,1,1,0,0,11
8446,dvādasayojanāya,dvadasayojanaya,15,14,1,0,15
8447,atthādānaparidīpanaṃ,atthadanaparidipanam,2,2,0,0,20
8448,titthiyamaddanaṃ,titthiyamaddanam,10,8,2,0,16
8449,uparimakāyato,uparimakayato,29,28,1,0,13
8450,aggikkhandho,aggikkhandho,135,131,4,0,12
8451,heṭṭhimakāyato,hetthimakayato,26,26,0,0,14
8452,udakadhārā,udakadhara,129,125,4,0,10
8453,dakkhiṇaakkhito,dakkhinaakkhito,13,12,1,0,15
8454,vāmaakkhito,vamaakkhito,12,12,0,0,11
8455,dakkhiṇakaṇṇasotato,dakkhinakannasotato,12,12,0,0,19
8456,vāmakaṇṇasotato,vamakannasotato,12,12,0,0,15
8457,dakkhiṇa,dakkhina,17,16,1,0,8
8458,nāsikāsotato,nasikasotato,1,1,0,0,12
8459,vāmanāsikāso,vamanasikaso,1,1,0,0,12
8460,vāmanāsikāsotato,vamanasikasotato,11,11,0,0,16
8461,dakkhiṇanāsikāsotato,dakkhinanasikasotato,12,12,0,0,20
8462,dakkhiṇaaṃsakūṭato,dakkhinaamsakutato,13,13,0,0,18
8463,vāmaaṃsakūṭato,vamaamsakutato,12,12,0,0,14
8464,dakkhiṇapassato,dakkhinapassato,20,20,0,0,15
8465,M0.0129,M0.0129,76,76,0,0,7
8466,vāmapassato,vamapassato,21,21,0,0,11
8467,dakkhiṇapādato,dakkhinapadato,12,12,0,0,14
8468,vāmapādato,vamapadato,12,12,0,0,10
8469,aṅgulaṅgulehi,angulangulehi,12,12,0,0,13
8470,aṅgulantarikāhi,angulantarikahi,15,15,0,0,15
8471,ekekalomato,ekekalomato,16,14,2,0,11
8472,lomakūpato,lomakupato,28,24,4,0,10
8473,channaṃ,channam,1270,1187,83,0,7
8474,vaṇṇānaṃ,vannanam,108,100,8,0,8
8475,nīlānaṃ,nilanam,7,6,1,0,7
8476,pītānaṃ,pitanam,2,2,0,0,7
8477,lohitakānaṃ,lohitakanam,11,10,1,0,11
8478,odātānaṃ,odatanam,44,37,7,0,8
8479,mañjaṭṭhānaṃ,manjatthanam,1,1,0,0,12
8480,pabhassarānaṃ,pabhassaranam,5,4,1,0,13
8481,ubbahanabhūtānaṃ,ubbahanabhutanam,1,1,0,0,16
8482,yamakā,yamaka,20,18,2,0,6
8483,vaṇṇā,vanna,204,195,9,0,5
8484,caṅkamati,cankamati,142,138,4,0,9
8485,nimmito,nimmito,95,95,0,0,7
8486,nisīdati,nisidati,569,566,3,0,8
8487,seyyaṃ,seyyam,444,396,48,0,6
8488,kappeti,kappeti,393,369,24,0,7
8489,vividhaṃ,vividham,163,144,19,0,8
8490,titthiyānaṃ,titthiyanam,174,169,5,0,11
8491,maddanatthāya,maddanatthaya,4,4,0,0,13
8492,evarūpaṃ,evarupam,1833,1771,62,0,8
8493,āgacchatūti,agacchatuti,16,15,1,0,11
8494,codanāsadisattā,codanasadisatta,3,3,0,0,15
8495,atthādānaparidīpananti,atthadanaparidipananti,1,1,0,0,22
8496,atthādānañhi,atthadananhi,1,1,0,0,12
8497,anuyogo,anuyogo,145,123,22,0,7
8498,paṭipakkhassa,patipakkhassa,38,37,1,0,13
8499,atthassa,atthassa,1090,1052,38,0,8
8500,ādānaṃ,adanam,131,107,24,0,6
8501,gahaṇanti,gahananti,68,68,0,0,9
8502,paridīpanaṃ,paridipanam,7,5,2,0,11
8503,titthiyamaddananti,titthiyamaddananti,1,1,0,0,18
8504,kuhāyanavasena,kuhayanavasena,2,2,0,0,14
8505,uṭṭhitānaṃ,utthitanam,14,14,0,0,10
8506,maddanaṃ,maddanam,10,9,1,0,8
8507,asamatthatā,asamatthata,34,32,2,0,11
8508,sampādanameva,sampadanameva,1,1,0,0,13
8509,yamakapāṭihāriyanti,yamakapatihariyanti,2,2,0,0,19
8510,sambandhitabbanti,sambandhitabbanti,13,13,0,0,17
8511,M0.0130,M0.0130,76,76,0,0,7
8512,uttamaratiṃ,uttamaratim,3,3,0,0,11
8513,janakaṃ,janakam,96,75,21,0,7
8514,paramānaṃ,paramanam,4,4,0,0,9
8515,uttamasādhūnaṃ,uttamasadhunam,1,1,0,0,14
8516,cittaramanaṃ,cittaramanam,2,2,0,0,12
8517,janāpetaṃ,janapetam,2,2,0,0,9
8518,uttamavācako,uttamavacako,3,3,0,0,12
8519,anipphannapāṭipadiko,anipphannapatipadiko,11,11,0,0,20
8520,sādhuvācako,sadhuvacako,1,1,0,0,11
8521,nipphannapāṭipadiko,nipphannapatipadiko,2,2,0,0,19
8522,ratiṃ,ratim,163,140,23,0,5
8523,paramaratijo,paramaratijo,2,2,0,0,12
8524,paramaratisaddūpapada,paramaratisaddupapada,1,1,0,0,21
8525,saddhamme,saddhamme,138,133,5,0,9
8526,ramantīti,ramantiti,28,25,3,0,9
8527,paramā,parama,124,112,12,0,6
8528,kīḷāyaṃ,kilayam,20,18,2,0,7
8529,pāṭihāriyena,patihariyena,17,17,0,0,12
8530,sampattiādīhi,sampattiadihi,1,1,0,0,13
8531,abhiratiṃ,abhiratim,28,28,0,0,9
8532,abhikkantaṃ,abhikkantam,411,373,38,0,11
8533,paramaratijanti,paramaratijanti,1,1,0,0,15
8534,iddhidhammehi,iddhidhammehi,2,2,0,0,13
8535,dhammehīti,dhammehiti,41,7,34,0,10
8536,acinteyyaappameyyehi,acinteyyaappameyyehi,2,2,0,0,20
8537,buddhaiddhisaṅkhātaguṇehi,buddhaiddhisankhatagunehi,1,1,0,0,25
8538,dhammasaddo,dhammasaddo,47,46,1,0,11
8539,buddhadhammātiādīsu,buddhadhammatiadisu,1,1,0,0,19
8540,yathicchitattho,yathicchitattho,2,2,0,0,15
8541,vuddhiyaṃ,vuddhiyam,21,15,6,0,9
8542,tipaccayo,tipaccayo,6,6,0,0,9
8543,iddho,iddho,32,31,1,0,5
8544,vuddho,vuddho,66,61,5,0,6
8545,ukkaṃsagato,ukkamsagato,6,6,0,0,11
8546,dhāreti,dhareti,480,471,9,0,7
8547,dabbanti,dabbanti,8,8,0,0,8
8548,iddhieva,iddhieva,1,1,0,0,8
8549,iddhidhammo,iddhidhammo,1,1,0,0,11
8550,upagacchati,upagacchati,226,213,13,0,11
8551,adhiṭṭhānā,adhitthana,44,34,10,0,10
8552,vikuppanā,vikuppana,2,2,0,0,9
8553,manomayā,manomaya,72,59,13,0,8
8554,ñāṇavipphārā,nanavipphara,33,27,6,0,12
8555,samādhivipphārā,samadhivipphara,44,39,5,0,15
8556,kammavipākajā,kammavipakaja,45,38,7,0,13
8557,puññavato,punnavato,72,59,13,0,9
8558,vijjāmayā,vijjamaya,17,12,5,0,9
8559,sammāpayogapaccayā,sammapayogapaccaya,13,9,4,0,18
8560,ijjhanaṭṭhena,ijjhanatthena,57,51,6,0,13
8561,bahukaṃ,bahukam,90,78,12,0,7
8562,āpajjati,apajjati,2780,2653,127,0,8
8563,sataṃ,satam,1096,963,133,0,5
8564,M0.0131,M0.0131,72,72,0,0,7
8565,sahassaṃ,sahassam,642,611,31,0,8
8566,āvajjitvā,avajjitva,128,121,7,0,9
8567,adhiṭṭhāti,adhitthati,215,207,8,0,10
8568,bahuko,bahuko,35,35,0,0,6
8569,vibhajitvā,vibhajitva,791,786,5,0,10
8570,dassitā,dassita,817,784,33,0,7
8571,adhiṭṭhāna,adhitthana,18,16,2,0,10
8572,nipphannattā,nipphannatta,29,29,0,0,12
8573,pakativaṇṇaṃ,pakativannam,34,30,4,0,12
8574,vijahitvā,vijahitva,182,176,6,0,9
8575,kumāravaṇṇaṃ,kumaravannam,3,3,0,0,12
8576,nāgavaṇṇaṃ,nagavannam,15,13,2,0,10
8577,supaṇṇavaṇṇaṃ,supannavannam,11,10,1,0,13
8578,yakkhavaṇṇaṃ,yakkhavannam,2,2,0,0,12
8579,vividhampi,vividhampi,31,29,2,0,10
8580,senābyūhaṃ,senabyuham,38,29,9,0,10
8581,āgatā,agata,1260,1231,29,0,5
8582,pakativaṇṇavijahanavikāravasena,pakativannavijahanavikaravasena,8,8,0,0,31
8583,pavattattā,pavattatta,335,324,11,0,10
8584,imamhā,imamha,211,198,13,0,6
8585,kāyā,kaya,220,209,11,0,4
8586,abhinimmināti,abhinimminati,17,17,0,0,13
8587,manomayanti,manomayanti,2,2,0,0,11
8588,sarīrabbhantare,sarirabbhantare,42,42,0,0,15
8589,aññasseva,annasseva,16,15,1,0,9
8590,manomayassa,manomayassa,9,9,0,0,11
8591,nipphattivasena,nipphattivasena,8,8,0,0,15
8592,ñāṇuppattito,nanuppattito,4,3,1,0,12
8593,taṅkhaṇe,tankhane,78,75,3,0,8
8594,ñāṇānubhāvanibbattā,nananubhavanibbatta,1,1,0,0,19
8595,visesā,visesa,71,69,2,0,6
8596,āyasmato,ayasmato,1804,1766,38,0,8
8597,bākulattherassa,bakulattherassa,3,3,0,0,15
8598,saṃkiccattherassa,samkiccattherassa,5,4,1,0,17
8599,bhūtapālattherassa,bhutapalattherassa,1,1,0,0,18
8600,samādhito,samadhito,21,21,0,0,9
8601,samathānubhāvena,samathanubhavena,3,3,0,0,16
8602,sāriputtattherassa,sariputtattherassa,121,119,2,0,18
8603,sañjīvattherassa,sanjivattherassa,5,5,0,0,16
8604,khāṇukoṇḍaññattherassa,khanukondannattherassa,1,1,0,0,22
8605,uttarāya,uttaraya,159,158,1,0,8
8606,upāsikāya,upasikaya,133,132,1,0,9
8607,sāmāvatiyā,samavatiya,39,39,0,0,10
8608,paṭikūlādīsu,patikuladisu,3,3,0,0,12
8609,appaṭikūlasaññī,appatikulasanni,86,80,6,0,15
8610,vihārādikā,viharadika,1,1,0,0,10
8611,pakkhidevādīnaṃ,pakkhidevadinam,1,1,0,0,15
8612,vehāsagamanādikā,vehasagamanadika,8,8,0,0,16
8613,kamma,kamma,150,132,18,0,5
8614,vipākajā,vipakaja,4,4,0,0,8
8615,sabbesaṃ,sabbesam,2581,2450,131,0,8
8616,pakkhīnaṃ,pakkhinam,41,36,5,0,9
8617,ekaccānaṃ,ekaccanam,226,207,19,0,9
8618,ekaccā,ekacca,165,160,5,0,6
8619,nañca,nanca,10,10,0,0,5
8620,vinipātikānaṃ,vinipatikanam,21,19,2,0,13
8621,cakkavattiādīnaṃ,cakkavattiadinam,7,7,0,0,16
8622,vehāsaṃ,vehasam,233,225,8,0,7
8623,caturaṅginiyā,caturanginiya,96,94,2,0,13
8624,assabandhagobandhapurise,assabandhagobandhapurise,2,2,0,0,24
8625,M0.0132,M0.0132,75,75,0,0,7
8626,jotikassa,jotikassa,14,11,3,0,9
8627,gahapatissa,gahapatissa,162,155,7,0,11
8628,jaṭilassa,jatilassa,84,82,2,0,9
8629,ghosakassa,ghosakassa,3,3,0,0,10
8630,meṇḍakassa,mendakassa,17,15,2,0,10
8631,mahāpuññānaṃ,mahapunnanam,15,14,1,0,12
8632,vijjādharādīnaṃ,vijjadharadinam,3,3,0,0,15
8633,antalikkhe,antalikkhe,182,172,10,0,10
8634,hatthimpi,hatthimpi,21,17,4,0,9
8635,assampi,assampi,11,11,0,0,7
8636,tyādiṃ,tyadim,1,1,0,0,6
8637,sammāpayogena,sammapayogena,5,5,0,0,13
8638,kammassa,kammassa,1406,1373,33,0,8
8639,payogapaccayā,payogapaccaya,10,9,1,0,13
8640,iddhikathāya,iddhikathaya,5,5,0,0,12
8641,visuddhimaggaṭṭhakathāya,visuddhimaggatthakathaya,1,0,1,0,24
8642,iddhīsu,iddhisu,46,46,0,0,7
8643,vijjāmayiddhiṃ,vijjamayiddhim,3,3,0,0,14
8644,vijjāhi,vijjahi,56,54,2,0,7
8645,buddhaiddhiyo,buddhaiddhiyo,1,1,0,0,13
8646,vijjāmayiddhipi,vijjamayiddhipi,1,1,0,0,15
8647,labbhatīti,labbhatiti,559,502,57,0,10
8648,saṅkhepatthayojanā,sankhepatthayojana,3,1,2,0,18
8649,pasenadikosalarañño,pasenadikosalaranno,2,2,0,0,19
8650,vimhāpanīyaṃ,vimhapaniyam,1,1,0,0,12
8651,pasāda,pasada,23,15,8,0,6
8652,parikiṇṇaudaka,parikinnaudaka,1,1,0,0,14
8653,dhāraaggisikhavantaṃ,dharaaggisikhavantam,1,1,0,0,20
8654,aññamañña,annamanna,21,16,5,0,9
8655,missakaṃ,missakam,66,57,9,0,8
8656,udakajālaaggijālavantaṃ,udakajalaaggijalavantam,1,1,0,0,23
8657,duṭṭhuṃ,dutthum,9,9,0,0,7
8658,micchādiṭṭhivādasaṅkhātaṃ,micchaditthivadasankhatam,1,1,0,0,25
8659,paccanīka,paccanika,3,3,0,0,9
8660,paṭihārakaṃ,patiharakam,4,2,2,0,11
8661,udakaggiyamakaṃyamakaṃ,udakaggiyamakamyamakam,1,1,0,0,22
8662,M0.0133,M0.0133,73,73,0,0,7
8663,buddhaiddhi,buddhaiddhi,1,1,0,0,11
8664,sirasā,sirasa,424,404,20,0,6
8665,ekūnavīsatimavandanagāthāvaṇṇanā,ekunavisatimavandanagathavannana,1,1,0,0,32
8666,ekūnavīsatimāya,ekunavisatimaya,2,2,0,0,15
8667,gāthāya,gathaya,987,972,15,0,7
8668,bodhaneyyādīhi,bodhaneyyadihi,1,1,0,0,14
8669,munindakkaṃ,munindakkam,5,5,0,0,11
8670,chayatīhi,chayatihi,1,1,0,0,9
8671,ekūnavīsatakkharā,ekunavisatakkhara,1,1,0,0,17
8672,meghavipphujjitāgāthāti,meghavipphujjitagathati,1,1,0,0,23
8673,rasutvassehi,rasutvassehi,2,2,0,0,12
8674,ymā,yma,3,3,0,0,3
8675,meghavipphujjitā,meghavipphujjita,3,2,1,0,16
8676,yagaṇamagaṇā,yaganamagana,1,1,0,0,12
8677,rara,rara,1,1,0,0,4
8678,sagaṇa,sagana,1,1,0,0,6
8679,ragaṇa,ragana,2,2,0,0,6
8680,ekagaru,ekagaru,1,1,0,0,7
8681,megha,megha,5,5,0,0,5
8682,vipphujjitā,vipphujjita,1,1,0,0,11
8683,rasānaṃ,rasanam,111,103,8,0,7
8684,kasāva,kasava,5,4,1,0,6
8685,titta,titta,2,2,0,0,5
8686,madhuralavaṇa,madhuralavana,1,1,0,0,13
8687,ambila,ambila,2,2,0,0,6
8688,kaṭukavasena,katukavasena,1,1,0,0,12
8689,rasasaddo,rasasaddo,1,1,0,0,9
8690,hemanta,hemanta,3,2,1,0,7
8691,sisīra,sisira,1,1,0,0,6
8692,vasanta,vasanta,3,2,1,0,7
8693,gimhavassānasaradavasena,gimhavassanasaradavasena,1,1,0,0,24
8694,chandaṭīkāsu,chandatikasu,1,0,1,0,12
8695,vuttoti,vuttoti,826,767,59,0,7
8696,M0.0134,M0.0134,71,71,0,0,7
8697,subodhesi,subodhesi,2,2,0,0,9
8698,byāpitakkitti,byapitakkitti,1,1,0,0,13
8699,imissā,imissa,864,839,25,0,6
8700,atthakkameneva,atthakkameneva,1,1,0,0,14
8701,sukhajānanatthaṃ,sukhajananattham,1,1,0,0,16
8702,vaṇṇayissāma,vannayissama,108,107,1,0,12
8703,tipadassa,tipadassa,45,45,0,0,9
8704,dayāudayaaruṇoti,dayaudayaarunoti,1,1,0,0,16
8705,mahākaruṇāsaṅkhātaudayapabbatuggatasūriyāruṇo,mahakarunasankhataudayapabbatuggatasuriyaruno,2,2,0,0,45
8706,udayapabbatato,udayapabbatato,4,4,0,0,14
8707,uggatasūriyāruṇo,uggatasuriyaruno,3,3,0,0,16
8708,karuṇāmettāsu,karunamettasu,1,1,0,0,13
8709,adayāti,adayati,1,1,0,0,7
8710,nikkaruṇatanti,nikkarunatanti,1,1,0,0,14
8711,karuṇāyaṃ,karunayam,6,4,2,0,9
8712,mettāyaṃ,mettayam,7,7,0,0,8
8713,mettācittataṃ,mettacittatam,1,1,0,0,13
8714,hitanibbattiṃ,hitanibbattim,1,1,0,0,13
8715,tāvāti,tavati,47,17,30,0,6
8716,anuggahaṇe,anuggahane,1,1,0,0,10
8717,sabbaññutañāṇañcāti,sabbannutananancati,1,1,0,0,19
8718,mahābodhisattā,mahabodhisatta,28,27,1,0,14
8719,abhinīhārakaraṇakāle,abhiniharakaranakale,2,2,0,0,20
8720,anassāsakaraṃ,anassasakaram,2,2,0,0,13
8721,atibhayānakaṃ,atibhayanakam,9,9,0,0,13
8722,amatadhātupaṭilābhena,amatadhatupatilabhena,2,2,0,0,21
8723,karuṇāmūlakā,karunamulaka,2,2,0,0,12
8724,buddhaguṇā,buddhaguna,126,123,3,0,10
8725,sabbesañca,sabbesanca,52,51,1,0,10
8726,buddhaguṇānaṃ,buddhagunanam,46,45,1,0,13
8727,tannidānabhāvato,tannidanabhavato,9,8,1,0,16
8728,M0.0135,M0.0135,75,75,0,0,7
8729,anudayamattameva,anudayamattameva,2,2,0,0,16
8730,anurakkhaṇe,anurakkhane,1,1,0,0,11
8731,pabbato,pabbato,391,374,17,0,7
8732,pasavane,pasavane,8,6,2,0,8
8733,uṇati,unati,3,3,0,0,5
8734,sūriyaraṃsī,suriyaramsi,1,1,0,0,11
8735,āpubbauṇadhātu,apubbaunadhatu,1,1,0,0,14
8736,dayāsaṅkhātato,dayasankhatato,1,1,0,0,14
8737,uggatasūriyassa,uggatasuriyassa,2,2,0,0,15
8738,ālokassa,alokassa,35,35,0,0,8
8739,karopayātaṃ,karopayatam,2,1,1,0,11
8740,nibbānasukhamosajja,nibbanasukhamosajja,1,1,0,0,19
8741,samuddharitukāmo,samuddharitukamo,1,1,0,0,16
8742,sudukkarā,sudukkara,7,7,0,0,9
8743,dānādayo,danadayo,19,17,2,0,8
8744,mahāpariccāge,mahapariccage,35,32,3,0,13
8745,buddhasseva,buddhasseva,6,6,0,0,11
8746,dayudayaruṇoti,dayudayarunoti,1,1,0,0,14
8747,ñāṇavitthiṇṇabimboti,nanavitthinnabimboti,2,1,1,0,20
8748,sabbaññutañāṇasaṅkhāto,sabbannutananasankhato,2,2,0,0,22
8749,vitthāra,vitthara,6,5,1,0,8
8750,parimaṇḍalo,parimandalo,33,31,2,0,11
8751,vitthāracakkavāḷamaṇḍalaṃ,vittharacakkavalamandalam,2,2,0,0,25
8752,vipulārammaṇa,vipularammana,1,1,0,0,13
8753,sabbaññutañāṇavā,sabbannutananava,1,1,0,0,16
8754,saṅkhatāsaṅkhatabhedaṃ,sankhatasankhatabhedam,3,3,0,0,22
8755,sabbeñeyyadhammaṃ,sabbeneyyadhammam,1,1,0,0,17
8756,avabodhaneyu,avabodhaneyu,1,1,0,0,12
8757,tanoti,tanoti,38,38,0,0,6
8758,vitthāretīti,vittharetiti,11,10,1,0,12
8759,vitthiṇṇaṃ,vitthinnam,19,18,1,0,10
8760,vipubbatanudhātu,vipubbatanudhatu,1,1,0,0,16
8761,vitthāre,vitthare,53,49,4,0,8
8762,iṇṇādeso,innadeso,1,1,0,0,8
8763,asarūpadvittaṃ,asarupadvittam,14,14,0,0,14
8764,pattharatīti,pattharatiti,14,12,2,0,12
8765,tharadhātumevettha,tharadhatumevettha,1,1,0,0,18
8766,vamati,vamati,23,22,1,0,6
8767,parimaṇḍalākārena,parimandalakarena,8,8,0,0,17
8768,bimbaṃ,bimbam,54,45,9,0,6
8769,ñāṇamaṇḍalaṃ,nanamandalam,1,1,0,0,12
8770,vamadhātu,vamadhatu,1,1,0,0,9
8771,assi,assi,33,33,0,0,4
8772,vassa,vassa,73,60,13,0,5
8773,ṇvādimoggallāne,nvadimoggallane,3,1,2,0,15
8774,vama,vama,2,2,0,0,4
8775,uggiraṇe,uggirane,9,8,1,0,8
8776,ba,ba,52,21,31,0,2
8777,vamissa,vamissa,3,3,0,0,7
8778,bittaṃ,bittam,3,3,0,0,6
8779,uggiratīti,uggiratiti,4,3,1,0,10
8780,bimbasaddassa,bimbasaddassa,3,3,0,0,13
8781,sarīravācake,sariravacake,1,1,0,0,12
8782,M0.0136,M0.0136,74,74,0,0,7
8783,parimaṇḍalavācake,parimandalavacake,1,1,0,0,17
8784,parimaṇḍalavācakattā,parimandalavacakatta,1,1,0,0,20
8785,cakkamaṇḍalanti,cakkamandalanti,1,1,0,0,15
8786,vicāretabbaṃ,vicaretabbam,106,100,6,0,12
8787,paṭibimbe,patibimbe,6,5,1,0,9
8788,maṇḍale,mandale,32,30,2,0,7
8789,bimbikāphale,bimbikaphale,2,2,0,0,12
8790,paṭimaṇḍale,patimandale,1,1,0,0,11
8791,vitthāraṃ,vittharam,41,39,2,0,9
8792,parimaṇḍalaṃ,parimandalam,119,99,20,0,12
8793,cakkavāḷaparimaṇḍalaṃ,cakkavalaparimandalam,1,1,0,0,21
8794,vipulārammaṇaṃ,vipularammanam,1,1,0,0,14
8795,cakkavāḷassa,cakkavalassa,15,15,0,0,12
8796,anantattā,anantatta,12,12,0,0,9
8797,cakkavāḷamaṇḍalaṃ,cakkavalamandalam,1,1,0,0,17
8798,vipulaṃ,vipulam,374,341,33,0,7
8799,meva,meva,88,88,0,0,4
8800,yvekoti,yvekoti,2,1,1,0,7
8801,ekoti,ekoti,119,62,57,0,5
8802,yekotipi,yekotipi,1,1,0,0,8
8803,katthaci,katthaci,1949,1881,68,0,8
8804,pāṭhadvayaṃ,pathadvayam,1,1,0,0,11
8805,pāṭhe,pathe,164,160,4,0,5
8806,ādesasandhi,adesasandhi,3,3,0,0,11
8807,yekoti,yekoti,1,1,0,0,6
8808,lopasandhīti,lopasandhiti,1,1,0,0,12
8809,ayametesaṃ,ayametesam,154,152,2,0,10
8810,munindakkoti,munindakkoti,3,2,1,0,12
8811,asahāyo,asahayo,50,48,2,0,7
8812,adutiyako,adutiyako,4,4,0,0,9
8813,buddhabhūtoti,buddhabhutoti,1,1,0,0,13
8814,ekasaddo,ekasaddo,27,27,0,0,8
8815,aññaseṭṭhāsahāya,annasetthasahaya,1,1,0,0,16
8816,saṅkhyādīsu,sankhyadisu,1,1,0,0,11
8817,attā,atta,2496,2392,104,0,4
8818,moghamaññanti,moghamannanti,64,64,0,0,13
8819,ittheke,ittheke,82,80,2,0,7
8820,abhivadantītiādīsu,abhivadantitiadisu,1,1,0,0,18
8821,aññatthe,annatthe,44,43,1,0,8
8822,cetaso,cetaso,1047,956,91,0,6
8823,ekodibhāvantiādīsu,ekodibhavantiadisu,1,1,0,0,18
8824,vūpakaṭṭhotiādīsu,vupakatthotiadisu,3,1,2,0,17
8825,asahāye,asahaye,12,12,0,0,7
8826,khaṇo,khano,200,178,22,0,5
8827,samayo,samayo,583,450,133,0,6
8828,brahmacariyāyātiādīsu,brahmacariyayatiadisu,1,1,0,0,21
8829,saṅkhyāyaṃ,sankhyayam,6,5,1,0,10
8830,edhātu,edhatu,2,2,0,0,6
8831,ñāṇagatīsu,nanagatisu,1,1,0,0,10
8832,pabbajjasaṅkhātena,pabbajjasankhatena,4,4,0,0,18
8833,adutiyaṭṭhena,adutiyatthena,20,17,3,0,13
8834,taṇhāya,tanhaya,1040,976,64,0,7
8835,pahānaṭṭhena,pahanatthena,20,19,1,0,12
8836,M0.0137,M0.0137,77,77,0,0,7
8837,ekantavītarāgoti,ekantavitaragoti,22,22,0,0,16
8838,ekantavītadosoti,ekantavitadosoti,16,16,0,0,16
8839,ekantavītamohoti,ekantavitamohoti,16,16,0,0,16
8840,ekantanikkilesoti,ekantanikkilesoti,19,16,3,0,17
8841,ekāya,ekaya,756,730,26,0,5
8842,abhisambuddhoti,abhisambuddhoti,117,86,31,0,15
8843,ekotiādinā,ekotiadina,3,3,0,0,10
8844,āgatena,agatena,99,98,1,0,7
8845,mahāniddesanayenapettha,mahaniddesanayenapettha,1,1,0,0,23
8846,anantacakkavāḷesuyeva,anantacakkavalesuyeva,1,1,0,0,21
8847,vikasati,vikasati,9,8,1,0,8
8848,ekanipāta,ekanipata,3,2,1,0,9
8849,aṅguttara,anguttara,5,3,2,0,9
8850,aṭṭhānametaṃ,atthanametam,232,226,6,0,12
8851,anavakāso,anavakaso,219,217,2,0,9
8852,ekissā,ekissa,632,611,21,0,6
8853,lokadhātuyā,lokadhatuya,94,91,3,0,11
8854,arahanto,arahanto,520,507,13,0,8
8855,sammāsambuddhā,sammasambuddha,230,229,1,0,14
8856,apubbaṃ,apubbam,260,229,31,0,7
8857,acarimaṃ,acarimam,158,135,23,0,8
8858,netaṃ,netam,1281,1223,58,0,5
8859,ṭhānañca,thananca,143,129,14,0,8
8860,uppajjeyya,uppajjeyya,441,433,8,0,10
8861,ṭhānametaṃ,thanametam,257,252,5,0,10
8862,vijjatī,vijjati,317,297,20,0,7
8863,lokadhātuyāti,lokadhatuyati,15,4,11,0,13
8864,dasasahassilokadhātuyā,dasasahassilokadhatuya,22,22,0,0,22
8865,khettāni,khettani,70,68,2,0,8
8866,jātikkhettaṃ,jatikkhettam,33,26,7,0,12
8867,āṇakkhettaṃ,anakkhettam,2,2,0,0,11
8868,visayakkhettanti,visayakkhettanti,3,3,0,0,16
8869,mātukucchiṃ,matukucchim,88,82,6,0,11
8870,okkamanakāle,okkamanakale,5,5,0,0,12
8871,nikkhamanakāle,nikkhamanakale,31,31,0,0,14
8872,sambodhikāle,sambodhikale,5,5,0,0,12
8873,dhammacakkappavattane,dhammacakkappavattane,35,33,2,0,21
8874,āyu,ayu,406,367,39,0,3
8875,saṅkhāravossajjane,sankharavossajjane,1,1,0,0,18
8876,parinibbāne,parinibbane,39,38,1,0,11
8877,koṭisatasahassa,kotisatasahassa,6,6,0,0,15
8878,āṭānāṭiyaparitta,atanatiyaparitta,2,2,0,0,16
8879,moraparittadhajaggaparitta,moraparittadhajaggaparitta,1,1,0,0,26
8880,ratanaparittādīnañhi,ratanaparittadinanhi,1,1,0,0,20
8881,āṇā,ana,130,120,10,0,3
8882,visayakkhettassa,visayakkhettassa,4,4,0,0,16
8883,parimāṇaṃ,parimanam,140,138,2,0,9
8884,yāvatakaṃ,yavatakam,132,126,6,0,9
8885,tāvatakaṃ,tavatakam,102,99,3,0,9
8886,ñeyyaṃ,neyyam,251,223,28,0,6
8887,ñāṇapariyantikaṃ,nanapariyantikam,26,26,0,0,16
8888,ñeyyapariyantikaṃ,neyyapariyantikam,10,10,0,0,17
8889,vacanato,vacanato,2000,1979,21,0,8
8890,avisayo,avisayo,65,64,1,0,7
8891,imesu,imesu,1038,988,50,0,5
8892,khettesu,khettesu,33,33,0,0,8
8893,aññasmiṃ,annasmim,586,538,48,0,8
8894,cakkavāḷe,cakkavale,98,93,5,0,9
8895,piṭakāni,pitakani,134,125,9,0,8
8896,vinayapiṭakaṃ,vinayapitakam,152,139,13,0,13
8897,suttantapiṭakaṃ,suttantapitakam,66,58,8,0,15
8898,saṃgītiyo,samgitiyo,3,3,0,0,9
8899,mahākassapattherassa,mahakassapattherassa,47,46,1,0,20
8900,saṃgīti,samgiti,10,10,0,0,7
8901,yasattherassa,yasattherassa,11,11,0,0,13
8902,moggaliputtattherassa,moggaliputtattherassa,2,2,0,0,21
8903,M0.0138,M0.0138,77,77,0,0,7
8904,tepiṭake,tepitake,55,53,2,0,8
8905,buddhavacane,buddhavacane,101,99,2,0,12
8906,muñcitvā,muncitva,458,440,18,0,8
8907,aññattha,annattha,935,900,35,0,8
8908,atthī,atthi,732,662,70,0,5
8909,parivāretvā,parivaretva,473,469,4,0,11
8910,tattakānaṃyeva,tattakanamyeva,4,4,0,0,14
8911,jātikkhettabhāvo,jatikkhettabhavo,3,3,0,0,16
8912,dhammatā,dhammata,227,209,18,0,8
8913,khettesūti,khettesuti,4,4,0,0,10
8914,dasasahassilokadhātusaṅkhāte,dasasahassilokadhatusankhate,1,1,0,0,28
8915,jātikkhette,jatikkhette,4,4,0,0,11
8916,koṭisatasahassacakkavāḷasaṅkhāte,kotisatasahassacakkavalasankhate,1,1,0,0,32
8917,āṇakkhette,anakkhette,2,2,0,0,10
8918,anantacakkavāḷa,anantacakkavala,2,2,0,0,15
8919,saṅkhāte,sankhate,14,14,0,0,8
8920,visayakkhette,visayakkhette,3,3,0,0,13
8921,buddhakkhettesu,buddhakkhettesu,6,6,0,0,15
8922,cakkavāḷato,cakkavalato,10,10,0,0,11
8923,aññesu,annesu,381,367,14,0,6
8924,anantacakkavāḷesu,anantacakkavalesu,10,10,0,0,17
8925,nuppajjantīti,nuppajjantiti,35,30,5,0,13
8926,tividhañhi,tividhanhi,14,14,0,0,10
8927,buddhakkhettaṃ,buddhakkhettam,14,10,4,0,14
8928,dassetvā,dassetva,2724,2680,44,0,8
8929,ādhārabhāvena,adharabhavena,33,33,0,0,13
8930,niddhāraṇabhāvena,niddharanabhavena,2,2,0,0,17
8931,niddhāraṇīyapadassa,niddharaniyapadassa,1,1,0,0,19
8932,aṭṭhakathācariyo,atthakathacariyo,22,18,4,0,16
8933,niddhāraṇatthe,niddharanatthe,11,11,0,0,14
8934,adhippete,adhippete,32,29,3,0,9
8935,cakkavāḷantiādi,cakkavalantiadi,1,1,0,0,15
8936,vucceyya,vucceyya,98,98,0,0,8
8937,ādhāratthoyeva,adharatthoyeva,1,1,0,0,14
8938,pubbanissayā,pubbanissaya,1,1,0,0,12
8939,cariyehi,cariyehi,3,3,0,0,8
8940,atthayojanā,atthayojana,117,116,1,0,11
8941,tatheva,tatheva,2497,2384,113,0,7
8942,abhidhammañāṇavibhaṅgapāḷiyañca,abhidhammananavibhangapaliyanca,1,0,1,0,31
8943,uparipaṇṇāse,uparipannase,2,2,0,0,12
8944,bahudhātusuttapāḷiyañca,bahudhatusuttapaliyanca,1,0,1,0,23
8945,nettipāḷiyañca,nettipaliyanca,1,0,1,0,14
8946,āgatamevāti,agatamevati,16,13,3,0,11
8947,navijjatītiādi,navijjatitiadi,1,1,0,0,14
8948,vadantena,vadantena,149,147,2,0,9
8949,kiṃpanāvuso,kimpanavuso,1,1,0,0,11
8950,atthetarahi,atthetarahi,10,10,0,0,11
8951,samaṇo,samano,1953,1885,68,0,6
8952,brāhmaṇo,brahmano,3090,2988,102,0,8
8953,samasamo,samasamo,46,41,5,0,8
8954,sambodhiyanti,sambodhiyanti,7,6,1,0,13
8955,puṭṭhohaṃ,putthoham,27,27,0,0,9
8956,bhante,bhante,19024,18807,217,0,6
8957,noti,noti,251,102,149,0,4
8958,vadeyyanti,vadeyyanti,7,7,0,0,10
8959,M0.0139,M0.0139,74,74,0,0,7
8960,dassetuṃ,dassetum,5525,5451,74,0,8
8961,uppajjeyyunti,uppajjeyyunti,8,8,0,0,13
8962,āharantena,aharantena,3,3,0,0,10
8963,senāpatinā,senapatina,13,13,0,0,10
8964,buddhakkhettabhūtaṃ,buddhakkhettabhutam,2,2,0,0,19
8965,anuppatti,anuppatti,29,29,0,0,9
8966,ñāṇavibhaṅgamūlaṭīkāyaṃ,nanavibhangamulatikayam,1,0,1,0,23
8967,uparipaṇṇāsabahudhātu,uparipannasabahudhatu,1,0,1,0,21
8968,suttaṭīkāyañca,suttatikayanca,1,0,1,0,14
8969,buddhakkhettabhūtato,buddhakkhettabhutato,1,1,0,0,20
8970,aññatthāti,annatthati,40,13,27,0,10
8971,vuttepi,vuttepi,461,457,4,0,7
8972,vuttena,vuttena,275,273,2,0,7
8973,saddantarasannidhānena,saddantarasannidhanena,14,14,0,0,22
8974,anantacakkavāḷabhūto,anantacakkavalabhuto,1,1,0,0,20
8975,visesattho,visesattho,18,18,0,0,10
8976,sāmaññavacanopi,samannavacanopi,3,3,0,0,15
8977,visesavisayoti,visesavisayoti,2,2,0,0,14
8978,vutte,vutte,4460,4404,56,0,5
8979,uppajjamānā,uppajjamana,351,340,11,0,11
8980,imasmiṃyeva,imasmimyeva,399,383,16,0,11
8981,uppajjanaṭṭhāne,uppajjanatthane,13,13,0,0,15
8982,vārite,varite,5,5,0,0,6
8983,vāritameva,varitameva,4,4,0,0,10
8984,hotītiettha,hotitiettha,1,1,0,0,11
8985,vākye,vakye,96,92,4,0,5
8986,yevātipade,yevatipade,1,1,0,0,10
8987,samabhiniviṭṭho,samabhinivittho,3,3,0,0,15
8988,evasaddo,evasaddo,38,36,2,0,8
8989,nivattāpanāvadhāraṇattho,nivattapanavadharanattho,1,1,0,0,24
8990,nivatteti,nivatteti,238,237,1,0,9
8991,yadipi,yadipi,619,606,13,0,6
8992,santesu,santesu,92,89,3,0,7
8993,jānanto,jananto,423,409,14,0,7
8994,passanto,passanto,661,643,18,0,8
8995,amhākaṃ,amhakam,3840,3776,64,0,7
8996,aññacakkavāḷesu,annacakkavalesu,3,3,0,0,15
8997,taṇhaṅkarādayo,tanhankaradayo,1,1,0,0,14
8998,aṭṭhavīsati,atthavisati,70,67,3,0,11
8999,sambuddhā,sambuddha,47,47,0,0,9
9000,uppajjantītivacanaṃ,uppajjantitivacanam,1,1,0,0,19
9001,aṭṭhakathā,atthakatha,374,249,125,0,10
9002,ṭīkāsu,tikasu,39,28,11,0,6
9003,suttantamahāvaggaṭṭhakathāyaṃ,suttantamahavaggatthakathayam,1,1,0,0,29
9004,mahāsamayasuttavaṇṇanāyaṃ,mahasamayasuttavannanayam,1,0,1,0,25
9005,M0.0140,M0.0140,74,74,0,0,7
9006,etadahosi,etadahosi,1417,1409,8,0,9
9007,mādiso,madiso,104,99,5,0,6
9008,sakkuṇeyya,sakkuneyya,107,105,2,0,10
9009,anantāsu,anantasu,20,20,0,0,8
9010,olokento,olokento,833,830,3,0,8
9011,anacchariyañcetaṃ,anacchariyancetam,20,18,2,0,17
9012,passeyya,passeyya,334,329,5,0,8
9013,jātadivasepi,jatadivasepi,3,3,0,0,12
9014,brahmajālasuttavaṇṇanāyaṃ,brahmajalasuttavannanayam,7,5,2,0,25
9015,apassanto,apassanto,343,339,4,0,9
9016,aggohamasmi,aggohamasmi,27,27,0,0,11
9017,lokassāti,lokassati,53,26,27,0,9
9018,appaṭivattiyaṃ,appativattiyam,71,56,15,0,14
9019,sīhanādaṃ,sihanadam,373,337,36,0,9
9020,nadi,nadi,68,66,2,0,4
9021,apassitvā,apassitva,36,36,0,0,9
9022,cintesī,cintesi,22,21,1,0,7
9023,tathevetaṃ,tathevetam,9,9,0,0,10
9024,purābhedasutta,purabhedasutta,1,1,0,0,14
9025,mahāniddesaṭṭhakathāyañca,mahaniddesatthakathayanca,1,0,1,0,25
9026,mahāsamayasuttaṭīkāyañca,mahasamayasuttatikayanca,1,0,1,0,24
9027,sabbattheva,sabbattheva,70,70,0,0,11
9028,honteva,honteva,30,30,0,0,7
9029,tenevāha,tenevaha,1072,1071,1,0,8
9030,addasā,addasa,389,368,21,0,6
9031,saṃvaṇṇeti,samvanneti,28,21,7,0,10
9032,apaṇṇakajātakaṭṭhakathāyañca,apannakajatakatthakathayanca,1,0,1,0,28
9033,satthā,sattha,7160,7065,95,0,6
9034,upāsakā,upasaka,429,421,8,0,7
9035,avīciṃ,avicim,39,37,2,0,6
9036,bhavaggaṃ,bhavaggam,61,55,6,0,9
9037,paricchedaṃ,paricchedam,159,146,13,0,11
9038,kuto,kuto,1364,1277,87,0,4
9039,adhikataro,adhikataro,44,44,0,0,10
9040,imāsu,imasu,125,120,5,0,5
9041,lokadhātūsūti,lokadhatusuti,4,2,2,0,13
9042,anantaaparimāṇa,anantaaparimana,1,1,0,0,15
9043,ṭīkāvacanena,tikavacanena,2,2,0,0,12
9044,anuppattiṃ,anuppattim,12,12,0,0,10
9045,sammohavinodanīaṭṭhakathāya,sammohavinodaniatthakathaya,1,1,0,0,27
9046,yojanāyaṃ,yojanayam,7,7,0,0,9
9047,panātiādinā,panatiadina,17,2,15,0,11
9048,ñāpeti,napeti,76,75,1,0,6
9049,vitakkayāma,vitakkayama,1,1,0,0,11
9050,cakkavāḷeti,cakkavaleti,6,5,1,0,11
9051,sabbesupi,sabbesupi,106,104,2,0,9
9052,buddhakkhettesūti,buddhakkhettesuti,1,1,0,0,17
9053,atthe,atthe,1794,1737,57,0,5
9054,gayhamāne,gayhamane,105,104,1,0,9
9055,koṭisatasahassacakkavāḷato,kotisatasahassacakkavalato,6,6,0,0,26
9056,jātiāṇākhettabhūte,jatianakhettabhute,1,1,0,0,18
9057,M0.0141,M0.0141,70,70,0,0,7
9058,gahite,gahite,338,326,12,0,6
9059,uppatti,uppatti,957,943,14,0,7
9060,itiādipāḷiyā,itiadipaliya,16,16,0,0,12
9061,cakkavattī,cakkavatti,811,781,30,0,10
9062,kathanato,kathanato,31,31,0,0,9
9063,aññissā,annissa,103,95,8,0,7
9064,cakkavattirañño,cakkavattiranno,44,43,1,0,15
9065,kathāvatthuppakaraṇe,kathavatthuppakarane,14,11,3,0,20
9066,paṭisedhitā,patisedhita,13,12,1,0,11
9067,āṇakkhettabhūtato,anakkhettabhutato,2,2,0,0,17
9068,vīmaṃsetvā,vimamsetva,2,2,0,0,10
9069,paṭisedhitāti,patisedhitati,2,2,0,0,13
9070,kathāvatthupāḷiyaṃ,kathavatthupaliyam,2,1,1,0,18
9071,nattheva,nattheva,98,96,2,0,8
9072,sabbadisākathāyaṃ,sabbadisakathayam,1,1,0,0,17
9073,paravādīnaṃ,paravadinam,9,9,0,0,11
9074,parikappavacanamattameva,parikappavacanamattameva,2,2,0,0,24
9075,sabbadisā,sabbadisa,284,281,3,0,9
9076,tiṭṭhantīti,titthantiti,108,71,37,0,11
9077,āmantā,amanta,6358,6347,11,0,6
9078,puratthimāya,puratthimaya,212,203,9,0,12
9079,disāya,disaya,639,630,9,0,6
9080,tiṭṭhatīti,titthatiti,412,306,106,0,10
9081,nahevaṃ,nahevam,10,9,1,0,7
9082,kinnāmo,kinnamo,20,17,3,0,7
9083,kiṃjacco,kimjacco,6,5,1,0,8
9084,kiṃgotto,kimgotto,2,2,0,0,8
9085,kinnāmā,kinnama,5,5,0,0,7
9086,mātāpitaro,matapitaro,1021,1010,11,0,10
9087,kinnāmaṃ,kinnamam,5,5,0,0,8
9088,sāvakayugaṃ,savakayugam,46,46,0,0,11
9089,upaṭṭhako,upatthako,2,2,0,0,9
9090,kiṃdisaṃ,kimdisam,2,2,0,0,8
9091,cīvaraṃ,civaram,3331,3161,170,0,7
9092,katarasmiṃ,katarasmim,74,71,3,0,10
9093,gāme,game,807,762,45,0,4
9094,nigame,nigame,130,129,1,0,6
9095,nagare,nagare,893,860,33,0,6
9096,raṭṭhe,ratthe,177,172,5,0,6
9097,janapade,janapade,306,295,11,0,8
9098,sabbadisākathā,sabbadisakatha,5,4,1,0,14
9099,disāsu,disasu,406,390,16,0,6
9100,uparīti,upariti,60,26,34,0,7
9101,lokadhātusannivesaṃ,lokadhatusannivesam,2,2,0,0,19
9102,sabbalokadhātūsu,sabbalokadhatusu,4,4,0,0,16
9103,vikappasippaṃ,vikappasippam,2,2,0,0,13
9104,sabbadisāsu,sabbadisasu,99,96,3,0,11
9105,yesaṃ,yesam,2040,1892,148,0,5
9106,M0.0142,M0.0142,74,74,0,0,7
9107,seyyathāpi,seyyathapi,3141,3055,86,0,10
9108,mahāsaṅghikānaṃ,mahasanghikanam,11,10,1,0,15
9109,pucchā,puccha,2295,853,1442,0,6
9110,sakavādissa,sakavadissa,325,324,1,0,11
9111,paṭiññā,patinna,382,372,10,0,7
9112,itarassa,itarassa,557,544,13,0,8
9113,puratthimāyāti,puratthimayati,3,2,1,0,14
9114,puṭṭho,puttho,1182,1148,34,0,6
9115,sakyamuniṃ,sakyamunim,5,5,0,0,10
9116,paṭikkhipati,patikkhipati,653,646,7,0,12
9117,laddhivasena,laddhivasena,43,42,1,0,12
9118,aññalokadhātuyaṃ,annalokadhatuyam,4,4,0,0,16
9119,paṭijānāti,patijanati,781,772,9,0,10
9120,bhagavātiādi,bhagavatiadi,11,2,9,0,12
9121,jānāsi,janasi,393,383,10,0,6
9122,nāmādivasena,namadivasena,5,5,0,0,12
9123,naṃ,nam,7157,6701,456,0,3
9124,kathehīti,kathehiti,73,72,1,0,9
9125,codanatthaṃ,codanattham,41,39,2,0,11
9126,upāyena,upayena,622,615,7,0,7
9127,mahāsaṅghikānanti,mahasanghikananti,2,2,0,0,17
9128,laddhiṃ,laddhim,211,188,23,0,7
9129,laddhi,laddhi,404,392,12,0,6
9130,kesaṃ,kesam,92,83,9,0,5
9131,seyyathāpīti,seyyathapiti,23,1,22,0,12
9132,sandhāyāti,sandhayati,151,69,82,0,10
9133,paravādīpuggale,paravadipuggale,1,1,0,0,15
9134,dhāretvā,dharetva,60,59,1,0,8
9135,sallakkhetvāti,sallakkhetvati,31,7,24,0,14
9136,sakavādissāti,sakavadissati,10,8,2,0,13
9137,itarassāti,itarassati,45,28,17,0,10
9138,paravādissa,paravadissa,126,126,0,0,11
9139,paṭijānanā,patijanana,5,5,0,0,10
9140,puṭṭhoti,putthoti,20,6,14,0,8
9141,sakavādinā,sakavadina,49,47,2,0,10
9142,puratthi,puratthi,3,3,0,0,8
9143,māyātiādinā,mayatiadina,1,1,0,0,11
9144,pucchite,pucchite,127,123,4,0,8
9145,sakyamuninti,sakyamuninti,1,1,0,0,12
9146,sakyavaṃsa,sakyavamsa,1,1,0,0,10
9147,khattiyajātibhūtaṃ,khattiyajatibhutam,1,1,0,0,18
9148,gotamabuddhaṃ,gotamabuddham,1,1,0,0,13
9149,paṭikkhipatīti,patikkhipatiti,46,42,4,0,14
9150,paravādīpuggalo,paravadipuggalo,2,2,0,0,15
9151,laddhivasenāti,laddhivasenati,1,1,0,0,14
9152,micchāladdhivasena,micchaladdhivasena,1,1,0,0,18
9153,paṭijānātīti,patijanatiti,51,36,15,0,12
9154,paravādī,paravadi,101,96,5,0,8
9155,nāmagottādiṃ,namagottadim,3,3,0,0,12
9156,codanāvacanaṃ,codanavacanam,1,1,0,0,13
9157,bhagavātiādimāha,bhagavatiadimaha,16,1,15,0,16
9158,janapadevāti,janapadevati,1,1,0,0,12
9159,M0.0143,M0.0143,70,70,0,0,7
9160,kinnāmotyādinā,kinnamotyadina,1,1,0,0,14
9161,laddhiyā,laddhiya,149,141,8,0,8
9162,uppajjamānānaṃ,uppajjamananam,76,75,1,0,14
9163,nāmādiṃ,namadim,1,1,0,0,7
9164,ajānanto,ajananto,386,377,9,0,8
9165,hevaṃ,hevam,2799,2742,57,0,5
9166,vattabbeti,vattabbeti,10,3,7,0,10
9167,sakavādī,sakavadi,110,105,5,0,8
9168,puggalassa,puggalassa,1801,1755,46,0,10
9169,uppajjanābhāvo,uppajjanabhavo,1,1,0,0,14
9170,aññānantacakkavāḷesu,annanantacakkavalesu,6,6,0,0,20
9171,aññabuddhā,annabuddha,1,1,0,0,10
9172,matiṃ,matim,73,66,7,0,5
9173,yathābhūtato,yathabhutato,10,10,0,0,12
9174,mahāpañño,mahapanno,175,167,8,0,9
9175,dibbacakkhuādīhi,dibbacakkhuadihi,1,1,0,0,16
9176,chaḷabhiññehi,chalabhinnehi,16,15,1,0,13
9177,satthārā,satthara,602,594,8,0,8
9178,dinnamātikānayena,dinnamatikanayena,1,1,0,0,17
9179,kathāvatthupāḷiṃ,kathavatthupalim,1,1,0,0,16
9180,desento,desento,450,438,12,0,7
9181,āyasmā,ayasma,4627,4518,109,0,6
9182,mahāmoggaliputtatthero,mahamoggaliputtatthero,1,1,0,0,22
9183,aññabuddhānaṃ,annabuddhanam,3,3,0,0,13
9184,katheyya,katheyya,92,89,3,0,8
9185,nāti,nati,37,18,19,0,4
9186,kathāvatthupāḷi,kathavatthupali,2,2,0,0,15
9187,tadaṭṭhakathāvacanañca,tadatthakathavacananca,1,1,0,0,22
9188,abhāvadīpane,abhavadipane,1,1,0,0,12
9189,sabbaṭṭhakathāṭīkāsu,sabbatthakathatikasu,1,1,0,0,20
9190,vuttavacanehi,vuttavacanehi,2,2,0,0,13
9191,daḷhataraṃ,dalhataram,51,49,2,0,10
9192,padhānavacanameva,padhanavacanameva,1,1,0,0,17
9193,buddhāeva,buddhaeva,1,1,0,0,9
9194,laddhabyākaraṇā,laddhabyakarana,4,4,0,0,15
9195,paccekabodhi,paccekabodhi,10,9,1,0,12
9196,aggasāvakamahāsāvakabodhisattā,aggasavakamahasavakabodhisatta,1,1,0,0,30
9197,paripākindriyā,paripakindriya,1,1,0,0,14
9198,sāvakabodhisattā,savakabodhisatta,2,2,0,0,16
9199,buddhakkhettabhūte,buddhakkhettabhute,4,4,0,0,18
9200,anuppannattā,anuppannatta,22,22,0,0,12
9201,abhinīhāro,abhiniharo,113,104,9,0,10
9202,pāramīsambharaṇaṃ,paramisambharanam,2,2,0,0,17
9203,ñāṇaparipācanañca,nanaparipacananca,1,1,0,0,17
9204,tasmiṃeva,tasmimeva,1,1,0,0,9
9205,mahāpadāna,mahapadana,3,1,2,0,10
9206,suttaṭīkāyaṃ,suttatikayam,1,0,1,0,12
9207,purimabuddhānaṃ,purimabuddhanam,21,21,0,0,15
9208,mahābodhisattānaṃ,mahabodhisattanam,50,50,0,0,17
9209,paccekabuddhānañca,paccekabuddhananca,13,13,0,0,18
9210,nibbattiyā,nibbattiya,44,43,1,0,10
9211,sāvakabodhisattānaṃ,savakabodhisattanam,6,6,0,0,19
9212,sāvakabodhiyā,savakabodhiya,19,19,0,0,13
9213,sāvakapāramiyā,savakaparamiya,11,11,0,0,14
9214,paripācanañca,paripacananca,6,6,0,0,13
9215,jambudīpeeva,jambudipeeva,1,1,0,0,12
9216,aññatthā,annattha,4,3,1,0,8
9217,ekanipātaaṅguttaraṭīkāyañcāti,ekanipataanguttaratikayancati,1,0,1,0,29
9218,M0.0144,M0.0144,73,73,0,0,7
9219,apare,apare,777,760,17,0,5
9220,uppajjantī,uppajjanti,108,99,9,0,10
9221,ayuttameva,ayuttameva,16,16,0,0,10
9222,aññasaddassa,annasaddassa,6,6,0,0,12
9223,cakkavāḷantipadato,cakkavalantipadato,1,1,0,0,18
9224,apādānassa,apadanassa,1,1,0,0,10
9225,asambhavato,asambhavato,303,298,5,0,11
9226,bahūsu,bahusu,506,498,8,0,6
9227,buddhesu,buddhesu,53,52,1,0,8
9228,uppannesu,uppannesu,200,194,6,0,9
9229,anacchariyattā,anacchariyatta,11,10,1,0,14
9230,acchariyamanusso,acchariyamanusso,23,22,1,0,16
9231,ekapuggalo,ekapuggalo,125,123,2,0,10
9232,uppajjamāno,uppajjamano,266,253,13,0,11
9233,katamo,katamo,2573,2431,142,0,6
9234,vuttanayenapi,vuttanayenapi,6,6,0,0,13
9235,viññūhi,vinnuhi,212,195,17,0,7
9236,viññātabbanti,vinnatabbanti,13,13,0,0,13
9237,buddhaapadānapāḷiyaṃ,buddhaapadanapaliyam,1,0,1,0,20
9238,yāyato,yayato,19,18,1,0,6
9239,antakaṃ,antakam,9,7,2,0,7
9240,tasmiñca,tasminca,283,273,10,0,8
9241,disābhāgamhi,disabhagamhi,4,4,0,0,12
9242,buddhakkhette,buddhakkhette,6,6,0,0,13
9243,asaṅkhayā,asankhaya,6,6,0,0,9
9244,pakittitā,pakittita,29,29,0,0,9
9245,raṃsivāhanā,ramsivahana,5,4,1,0,11
9246,etthantare,etthantare,220,211,9,0,10
9247,raṃsijālaṃ,ramsijalam,9,8,1,0,10
9248,āloko,aloko,456,423,33,0,5
9249,vipulo,vipulo,94,88,6,0,6
9250,paṭhamagāthāya,pathamagathaya,101,98,3,0,14
9251,anādhippāyena,anadhippayena,1,1,0,0,13
9252,micchāñāṇena,micchananena,12,11,1,0,12
9253,asaṅkhayāti,asankhayati,1,1,0,0,11
9254,asundarameva,asundarameva,1,1,0,0,12
9255,pāḷiyā,paliya,629,580,49,0,6
9256,aṭṭhakathāṭīkāvacanehi,atthakathatikavacanehi,1,1,0,0,22
9257,atthaggahaṇassa,atthaggahanassa,2,2,0,0,15
9258,micchattā,micchatta,39,28,11,0,9
9259,imāya,imaya,1376,1345,31,0,5
9260,vuttavacanena,vuttavacanena,25,25,0,0,13
9261,M0.0145,M0.0145,70,70,0,0,7
9262,virujjhati,virujjhati,259,254,5,0,10
9263,bhaddantamahā,bhaddantamaha,1,1,0,0,13
9264,buddhaghosādayo,buddhaghosadayo,2,2,0,0,15
9265,aṭṭhakathācariyā,atthakathacariya,119,102,17,0,16
9266,pāḷiṃ,palim,220,206,14,0,5
9267,passantīti,passantiti,56,42,14,0,10
9268,duggahitena,duggahitena,41,39,2,0,11
9269,aṭṭhakathācariyānaṃ,atthakathacariyanam,29,27,2,0,19
9270,abbhakkhānaṃ,abbhakkhanam,65,58,7,0,12
9271,panete,panete,194,190,4,0,6
9272,tipiṭakadharā,tipitakadhara,12,12,0,0,13
9273,tikkhavisadajavana,tikkhavisadajavana,1,1,0,0,18
9274,gambhīrādiñāṇikā,gambhiradinanika,1,1,0,0,16
9275,passeyyuṃ,passeyyum,21,21,0,0,9
9276,natthītiādivacanameva,natthitiadivacanameva,1,1,0,0,21
9277,yuttataraṃ,yuttataram,57,54,3,0,10
9278,buddhakkhettetipadaṃ,buddhakkhettetipadam,1,1,0,0,20
9279,disābhāgamhītipade,disabhagamhitipade,1,1,0,0,18
9280,asaṅkhayātipadaṃ,asankhayatipadam,2,2,0,0,16
9281,dutiyagāthāya,dutiyagathaya,67,67,0,0,13
9282,pabhātipadassa,pabhatipadassa,2,2,0,0,14
9283,visesananti,visesananti,21,21,0,0,11
9284,cakkavāḷaloke,cakkavalaloke,4,4,0,0,13
9285,koṭṭhāsā,kotthasa,173,163,10,0,8
9286,yāyantassa,yayantassa,4,4,0,0,10
9287,gacchantassa,gacchantassa,345,339,6,0,12
9288,pariyosānaṃ,pariyosanam,417,376,41,0,11
9289,dasasahassisaṅkhātajātikkhettabhūte,dasasahassisankhatajatikkhettabhute,1,1,0,0,35
9290,saṅkhārahitā,sankharahita,6,6,0,0,12
9291,yugaḷā,yugala,10,10,0,0,6
9292,raṃsivahantā,ramsivahanta,1,1,0,0,12
9293,raṃsimuñcamānā,ramsimuncamana,2,2,0,0,14
9294,cakkaratanamaṇiratanādīnaṃ,cakkaratanamaniratanadinam,3,3,0,0,26
9295,ālokā,aloka,17,15,2,0,5
9296,pākaṭā,pakata,517,483,34,0,6
9297,pattharitā,pattharita,1,1,0,0,10
9298,dasasahassacakkavāḷantare,dasasahassacakkavalantare,2,2,0,0,25
9299,raṃsisamūhena,ramsisamuhena,1,1,0,0,13
9300,bahutaro,bahutaro,20,20,0,0,8
9301,ahosinti,ahosinti,162,162,0,0,8
9302,cakkindābhisirīsaddhamma,cakkindabhisirisaddhamma,1,1,0,0,24
9303,dhajamahādhammarājādhirājagurūtiladdhalañchitena,dhajamahadhammarajadhirajagurutiladdhalanchitena,1,1,0,0,48
9304,ācariyabudhena,acariyabudhena,1,1,0,0,14
9305,likhitoti,likhitoti,3,3,0,0,9
9306,gāthāhi,gathahi,450,445,5,0,7
9307,cakkavattirājakāle,cakkavattirajakale,2,2,0,0,18
9308,mayhaṃcakkaratanamaṇīratanādīnaṃ,mayhamcakkaratanamaniratanadinam,1,1,0,0,32
9309,dasasahassicakkavāḷe,dasasahassicakkavale,3,3,0,0,20
9310,pattharitāti,pattharitati,1,1,0,0,12
9311,uppajjanabuddhānaṃ,uppajjanabuddhanam,1,1,0,0,18
9312,asaṅkhayabhāvanti,asankhayabhavanti,1,1,0,0,17
9313,M0.0146,M0.0146,72,72,0,0,7
9314,buddhaapadānaṭṭhakathāyaṃ,buddhaapadanatthakathayam,1,0,1,0,25
9315,loketi,loketi,168,19,149,0,6
9316,dasakoṭṭhāsā,dasakotthasa,2,2,0,0,12
9317,cakkavattikāle,cakkavattikale,19,16,3,0,14
9318,gataṭṭhāne,gatatthane,109,105,4,0,10
9319,disābhāge,disabhage,53,51,2,0,9
9320,buddhavisayā,buddhavisaya,4,4,0,0,12
9321,pakittitāti,pakittitati,5,4,1,0,11
9322,rājakāle,rajakale,7,7,0,0,8
9323,raṃsisamūhaṃ,ramsisamuham,2,2,0,0,12
9324,pubbaḍḍhassa,pubbaddhassa,1,1,0,0,12
9325,ekavākyabhāvato,ekavakyabhavato,1,1,0,0,15
9326,aparaḍḍhassa,aparaddhassa,1,1,0,0,12
9327,antogadhattā,antogadhatta,70,66,4,0,12
9328,evamassa,evamassa,794,774,20,0,8
9329,sabbadhammesu,sabbadhammesu,128,115,13,0,13
9330,appaṭihata,appatihata,2,2,0,0,10
9331,tādisassa,tadisassa,275,269,6,0,9
9332,dassento,dassento,4794,4747,47,0,8
9333,anantasattesu,anantasattesu,4,4,0,0,13
9334,lokadhātusu,lokadhatusu,9,9,0,0,11
9335,sabbepi,sabbepi,1727,1681,46,0,7
9336,samā,sama,322,282,40,0,4
9337,tenā,tena,115,77,38,0,4
9338,ekekissaṃ,ekekissam,2,2,0,0,9
9339,ekajjhaṃ,ekajjham,466,451,15,0,8
9340,bhaveyyunti,bhaveyyunti,37,37,0,0,11
9341,hutvāpi,hutvapi,86,85,1,0,7
9342,ekakena,ekakena,33,33,0,0,7
9343,M0.0147,M0.0147,73,73,0,0,7
9344,anantalokadhātusūtiādinā,anantalokadhatusutiadina,1,1,0,0,24
9345,pathavojaṃ,pathavojam,17,15,2,0,10
9346,uddharitvā,uddharitva,494,479,15,0,10
9347,dassito,dassito,901,879,22,0,7
9348,dassitehi,dassitehi,10,10,0,0,9
9349,atidaḷhatarehi,atidalhatarehi,1,1,0,0,14
9350,sādhakavacanehi,sadhakavacanehi,1,1,0,0,15
9351,micchāvādo,micchavado,3,3,0,0,10
9352,paṭihanati,patihanati,20,20,0,0,10
9353,paṭihaniyati,patihaniyati,1,1,0,0,12
9354,apaniyatīti,apaniyatiti,1,1,0,0,11
9355,saddhahakaṃ,saddhahakam,1,1,0,0,11
9356,daṭṭhabboti,datthabboti,116,101,15,0,11
9357,muninda,muninda,55,28,27,0,7
9358,akkoti,akkoti,2,1,1,0,6
9359,buddhādiccoti,buddhadiccoti,1,1,0,0,13
9360,sabbadhamme,sabbadhamme,80,78,2,0,11
9361,makāre,makare,5,5,0,0,6
9362,assuttaṃ,assuttam,10,10,0,0,8
9363,saka,saka,64,42,22,0,4
9364,sāmaññalakkhaṇādinā,samannalakkhanadina,1,1,0,0,19
9365,munati,munati,4,4,0,0,6
9366,hitāhitaṃ,hitahitam,35,33,2,0,9
9367,paṭivijjhane,pativijjhane,4,4,0,0,12
9368,catusaccadhamme,catusaccadhamme,40,37,3,0,15
9369,saṃyuttaṭṭhakathāyaṃ,samyuttatthakathayam,15,11,4,0,20
9370,monanti,monanti,4,3,1,0,7
9371,munātīti,munatiti,18,15,3,0,8
9372,indati,indati,11,11,0,0,6
9373,abhibhavati,abhibhavati,135,129,6,0,11
9374,pañcamunīnaṃ,pancamuninam,1,1,0,0,12
9375,kamati,kamati,96,93,3,0,6
9376,pādena,padena,278,271,7,0,6
9377,puññajavimānena,punnajavimanena,1,1,0,0,15
9378,akko,akko,20,16,4,0,4
9379,kamudhātu,kamudhatu,4,4,0,0,9
9380,kassa,kassa,1117,1046,71,0,5
9381,yugandharubbedhappamāṇe,yugandharubbedhappamane,1,1,0,0,23
9382,kapaccayo,kapaccayo,16,16,0,0,9
9383,rāsito,rasito,30,27,3,0,6
9384,rāsiṃ,rasim,124,114,10,0,5
9385,mahantajutatāya,mahantajutataya,1,1,0,0,15
9386,akkiyati,akkiyati,2,2,0,0,8
9387,abhitthaviyati,abhitthaviyati,3,3,0,0,14
9388,tappasannehi,tappasannehi,2,2,0,0,12
9389,akkadhātu,akkadhatu,1,1,0,0,9
9390,thavane,thavane,3,1,2,0,7
9391,M0.0148,M0.0148,70,70,0,0,7
9392,sahassaraṃsiyā,sahassaramsiya,1,1,0,0,14
9393,ekacakkavāḷe,ekacakkavale,34,32,2,0,12
9394,timirandhakāraṃ,timirandhakaram,1,1,0,0,15
9395,navayojanasatasahassappadesaṃ,navayojanasatasahassappadesam,1,1,0,0,29
9396,koṭisahassappadesaṃ,kotisahassappadesam,1,1,0,0,19
9397,dasadisaṃ,dasadisam,2,2,0,0,9
9398,obhāsetvā,obhasetva,123,122,1,0,9
9399,bhagavāpi,bhagavapi,217,210,7,0,9
9400,saddhammaraṃ,saddhammaram,1,1,0,0,12
9401,buddhakkhettabhūtesu,buddhakkhettabhutesu,1,1,0,0,20
9402,dasasahassacakkavāḷesu,dasasahassacakkavalesu,20,20,0,0,22
9403,vineyyānaṃ,vineyyanam,46,45,1,0,10
9404,veneyyasattasamūhaṃ,veneyyasattasamuham,1,1,0,0,19
9405,catusaccadhammobhāsena,catusaccadhammobhasena,1,1,0,0,22
9406,jotayamāno,jotayamano,3,3,0,0,10
9407,virocanaṃ,virocanam,5,5,0,0,9
9408,ṭhānānurūpaṃ,thananurupam,1,1,0,0,12
9409,samāsopamā,samasopama,1,1,0,0,10
9410,suddheti,suddheti,2,0,2,0,8
9411,visuddhe,visuddhe,13,13,0,0,8
9412,sujjhati,sujjhati,82,75,7,0,8
9413,visujjhatīti,visujjhatiti,34,11,23,0,12
9414,suddho,suddho,190,175,15,0,6
9415,tibhavo,tibhavo,6,6,0,0,7
9416,sudhadhātu,sudhadhatu,1,1,0,0,10
9417,soceyyeti,soceyyeti,1,1,0,0,9
9418,tibhava,tibhava,5,4,1,0,7
9419,kuhareti,kuhareti,1,0,1,0,8
9420,tibhavasaṅkhātakamalasare,tibhavasankhatakamalasare,2,2,0,0,25
9421,kamalasaraṃ,kamalasaram,1,1,0,0,11
9422,tibhavasmiṃ,tibhavasmim,1,1,0,0,11
9423,bhūdhātu,bhudhatu,7,7,0,0,8
9424,sattāyaṃ,sattayam,39,32,7,0,8
9425,kāmarūpārūpabhūmi,kamaruparupabhumi,1,1,0,0,17
9426,kuṃ,kum,39,37,2,0,3
9427,kuharo,kuharo,3,3,0,0,6
9428,kupubbaharadhātu,kupubbaharadhatu,1,1,0,0,16
9429,tibhavakuharo,tibhavakuharo,1,1,0,0,13
9430,bhavāti,bhavati,100,73,27,0,7
9431,kamala,kamala,5,1,4,0,6
9432,kathitaṃ,kathitam,973,867,106,0,8
9433,uppalanti,uppalanti,4,4,0,0,9
9434,kathetabbaṃ,kathetabbam,246,232,14,0,11
9435,alayati,alayati,2,2,0,0,7
9436,vibhūsayatīti,vibhusayatiti,2,2,0,0,13
9437,kamalaṃ,kamalam,28,22,6,0,7
9438,uppalaṃ,uppalam,70,58,12,0,7
9439,aladhātu,aladhatu,1,1,0,0,8
9440,icchiyatīti,icchiyatiti,3,3,0,0,11
9441,kamalanti,kamalanti,1,1,0,0,9
9442,kathiyatīti,kathiyatiti,7,7,0,0,11
9443,vineyyapāṇaoghanti,vineyyapanaoghanti,1,1,0,0,18
9444,vinetabbasattasamūhanti,vinetabbasattasamuhanti,1,1,0,0,23
9445,vinetabbo,vinetabbo,19,17,2,0,9
9446,dametabbo,dametabbo,2,2,0,0,9
9447,satthārāti,sattharati,2,1,1,0,10
9448,vineyyo,vineyyo,2,2,0,0,7
9449,vipubbanidhātu,vipubbanidhatu,1,1,0,0,14
9450,damane,damane,13,12,1,0,6
9451,paṇanti,pananti,2,2,0,0,7
9452,pāṇaṃ,panam,398,371,27,0,5
9453,jīvitindriyaṃ,jivitindriyam,1054,1021,33,0,13
9454,paṇadhātu,panadhatu,1,1,0,0,9
9455,pāṇo,pano,130,109,21,0,4
9456,vineyyappāṇo,vineyyappano,1,1,0,0,12
9457,avayavena,avayavena,47,46,1,0,9
9458,M0.0149,M0.0149,70,70,0,0,7
9459,vineyyappāṇānaṃ,vineyyappananam,1,1,0,0,15
9460,vineyyappāṇogho,vineyyappanogho,1,1,0,0,15
9461,dhammaraṃsivarehīti,dhammaramsivarehiti,1,0,1,0,19
9462,uttamadhammasaṅkhātaraṃsīhi,uttamadhammasankhataramsihi,2,2,0,0,27
9463,dhammoti,dhammoti,509,281,228,0,8
9464,yathānusiṭṭhaṃ,yathanusittham,173,159,14,0,14
9465,paṭipajjamāne,patipajjamane,43,38,5,0,13
9466,apāyesu,apayesu,214,203,11,0,7
9467,vaṭṭadukkhesu,vattadukkhesu,4,4,0,0,13
9468,apatamāne,apatamane,41,35,6,0,9
9469,apāyādinibbattakakilesaṃ,apayadinibbattakakilesam,1,1,0,0,24
9470,caturiyamaggo,caturiyamaggo,2,2,0,0,13
9471,nippariyāyato,nippariyayato,210,207,3,0,13
9472,ariyamaggassa,ariyamaggassa,184,180,4,0,13
9473,samucchedappahānavasena,samucchedappahanavasena,23,22,1,0,23
9474,samucchedakattā,samucchedakatta,3,3,0,0,15
9475,nissaraṇappahānavasena,nissaranappahanavasena,1,1,0,0,22
9476,ārammaṇabhāvaṃ,arammanabhavam,18,17,1,0,14
9477,tadatthasiddhihetuttā,tadatthasiddhihetutta,1,1,0,0,21
9478,caturiyaphalañca,caturiyaphalanca,1,1,0,0,16
9479,pariyattidhammo,pariyattidhammo,60,59,1,0,15
9480,pariyāyato,pariyayato,142,134,8,0,10
9481,phalassa,phalassa,662,648,14,0,8
9482,viddhaṃsi,viddhamsi,2,2,0,0,9
9483,tabbānaṃ,tabbanam,3,3,0,0,8
9484,paṭippassambhanappahānavasena,patippassambhanappahanavasena,1,1,0,0,29
9485,maggānukūlappa,magganukulappa,1,1,0,0,14
9486,vattattā,vattatta,1,1,0,0,8
9487,pariyattidhammassa,pariyattidhammassa,26,25,1,0,18
9488,tadaṅgappahānavasena,tadangappahanavasena,17,17,0,0,20
9489,tadadhigama,tadadhigama,1,1,0,0,11
9490,hetuttā,hetutta,16,15,1,0,7
9491,dhunāti,dhunati,39,38,1,0,7
9492,dhunadhātu,dhunadhatu,1,1,0,0,10
9493,rammo,rammo,22,20,2,0,5
9494,paṭivijjhiyati,pativijjhiyati,2,2,0,0,14
9495,sacchikariyati,sacchikariyati,1,1,0,0,14
9496,ārammaṇa,arammana,87,79,8,0,8
9497,karaṇavasenāti,karanavasenati,1,1,0,0,14
9498,dhaṃseti,dhamseti,9,8,1,0,8
9499,paṭippassambheti,patippassambheti,32,32,0,0,16
9500,maggappahīnakilesavāsananti,maggappahinakilesavasananti,1,1,0,0,27
9501,ariyaphalaṃ,ariyaphalam,32,28,4,0,11
9502,dhaṃsadhātu,dhamsadhatu,2,2,0,0,11
9503,viddhaṃsane,viddhamsane,4,3,1,0,11
9504,sesanayena,sesanayena,1,1,0,0,10
9505,dasavidho,dasavidho,26,26,0,0,9
9506,chattavimāne,chattavimane,3,0,3,0,12
9507,rāgavirāgamanejamasokaṃ,ragaviragamanejamasokam,13,13,0,0,23
9508,dhammamasaṅkhatamappaṭikūlaṃ,dhammamasankhatamappatikulam,10,10,0,0,28
9509,madhuramimaṃ,madhuramimam,18,11,7,0,12
9510,paguṇaṃ,pagunam,163,139,24,0,7
9511,suvibhattaṃ,suvibhattam,54,43,11,0,11
9512,dhammamimaṃ,dhammamimam,13,13,0,0,11
9513,saraṇattamupehī,saranattamupehi,1,1,0,0,15
9514,M0.0150,M0.0150,73,73,0,0,7
9515,māṇava,manava,354,341,13,0,6
9516,rāgavirāgaṃ,ragaviragam,4,2,2,0,11
9517,rāgavigataṃ,ragavigatam,1,1,0,0,11
9518,maggadhammañca,maggadhammanca,3,3,0,0,14
9519,ejāsaṅkhātataṇhāvirahitaṃ,ejasankhatatanhavirahitam,1,1,0,0,25
9520,asokaṃ,asokam,93,77,16,0,6
9521,sokavirahitaṃ,sokavirahitam,1,1,0,0,13
9522,phaladhammañca,phaladhammanca,1,1,0,0,14
9523,asaṅkhataṃ,asankhatam,319,288,31,0,10
9524,saṅkhatavirahitaṃ,sankhatavirahitam,1,1,0,0,17
9525,nibbānadhammañca,nibbanadhammanca,1,1,0,0,16
9526,appaṭikūlaṃ,appatikulam,28,11,17,0,11
9527,avirodhanaṃ,avirodhanam,9,8,1,0,11
9528,madhuraṃ,madhuram,251,224,27,0,8
9529,atthabyañjana,atthabyanjana,1,1,0,0,13
9530,sampannattā,sampannatta,24,24,0,0,11
9531,pakaṭṭhaguṇaṃ,pakatthagunam,1,1,0,0,13
9532,vibhajitabbaṃ,vibhajitabbam,60,58,2,0,13
9533,pariyattidhammañca,pariyattidhammanca,5,5,0,0,18
9534,saraṇattaṃ,saranattam,1,1,0,0,10
9535,saraṇabhāvaṃ,saranabhavam,1,1,0,0,12
9536,upehi,upehi,15,13,2,0,5
9537,upagacchāhīti,upagacchahiti,2,2,0,0,13
9538,kāmarāgādibhedo,kamaragadibhedo,2,2,0,0,15
9539,sabbopi,sabbopi,378,367,11,0,7
9540,virajjati,virajjati,225,217,8,0,9
9541,pahiyati,pahiyati,1,1,0,0,8
9542,rāgavirāgoti,ragaviragoti,11,2,9,0,12
9543,kathito,kathito,512,464,48,0,7
9544,ejāsaṅkhātāya,ejasankhataya,12,12,0,0,13
9545,antonijjhānalakkhaṇassa,antonijjhanalakkhanassa,7,7,0,0,23
9546,sokassa,sokassa,41,39,2,0,7
9547,taduppattiyā,taduppattiya,6,6,0,0,12
9548,sabbaso,sabbaso,2156,2077,79,0,7
9549,parikkhīṇattā,parikkhinatta,27,27,0,0,13
9550,anejama,anejama,1,1,0,0,7
9551,sokanti,sokanti,1,1,0,0,7
9552,paccayena,paccayena,227,220,7,0,9
9553,asaṅkhatattā,asankhatatta,9,8,1,0,12
9554,dhammamasaṅkhatanti,dhammamasankhatanti,2,2,0,0,19
9555,avirodhadīpanato,avirodhadipanato,7,7,0,0,16
9556,atthabyañjanassa,atthabyanjanassa,4,4,0,0,16
9557,sampannatāya,sampannataya,7,7,0,0,12
9558,pakaṭṭhaguṇavibhāvanato,pakatthagunavibhavanato,7,7,0,0,23
9559,vibhajitattā,vibhajitatta,5,5,0,0,12
9560,appaṭikūlantiādinā,appatikulantiadina,1,1,0,0,18
9561,pariyatti,pariyatti,153,133,20,0,9
9562,rāgavirāganti,ragaviraganti,1,1,0,0,13
9563,anejamasokanti,anejamasokanti,5,2,3,0,14
9564,suvibhattanti,suvibhattanti,1,1,0,0,13
9565,piṭakattayena,pitakattayena,6,6,0,0,13
9566,vibhattā,vibhatta,302,293,9,0,8
9567,sabbadhammakkhandhā,sabbadhammakkhandha,6,6,0,0,19
9568,sāmaññato,samannato,335,325,10,0,9
9569,subodhesīti,subodhesiti,2,1,1,0,11
9570,raṃsīti,ramsiti,7,4,3,0,7
9571,rasiyanti,rasiyanti,1,1,0,0,9
9572,assādiyantīti,assadiyantiti,2,2,0,0,13
9573,raṃsī,ramsi,19,17,2,0,5
9574,rasanti,rasanti,20,19,1,0,7
9575,assādenti,assadenti,58,57,1,0,9
9576,rasadhātu,rasadhatu,49,49,0,0,9
9577,assādane,assadane,16,10,6,0,8
9578,rasiyati,rasiyati,1,1,0,0,8
9579,sinehiyati,sinehiyati,1,1,0,0,10
9580,sinehe,sinehe,7,7,0,0,6
9581,niggahītāgamo,niggahitagamo,71,71,0,0,13
9582,patthitabboti,patthitabboti,1,1,0,0,13
9583,varati,varati,6,6,0,0,6
9584,nivāreti,nivareti,143,140,3,0,8
9585,hīnanti,hinanti,18,14,4,0,7
9586,patthane,patthane,4,2,2,0,8
9587,dhammaraṃsi,dhammaramsi,4,4,0,0,11
9588,dhammassa,dhammassa,7423,7359,64,0,9
9589,abhedūpacārena,abhedupacarena,3,3,0,0,14
9590,M0.0151,M0.0151,70,70,0,0,7
9591,dhammaraṃsivaro,dhammaramsivaro,1,1,0,0,15
9592,dhammaraṃsivarehi,dhammaramsivarehi,1,1,0,0,17
9593,paṭivijjhayamānena,pativijjhayamanena,1,1,0,0,18
9594,pabodhesi,pabodhesi,10,10,0,0,9
9595,vikāsetīti,vikasetiti,2,2,0,0,10
9596,phusayitvā,phusayitva,4,4,0,0,10
9597,kuhara,kuhara,1,1,0,0,6
9598,sare,sare,460,419,41,0,4
9599,vikāseti,vikaseti,2,2,0,0,8
9600,dhammadesanāsaṅkhātaraṃsiyā,dhammadesanasankhataramsiya,1,1,0,0,27
9601,kamalasarasaṅkhāte,kamalasarasankhate,1,1,0,0,18
9602,bhavattaye,bhavattaye,8,8,0,0,10
9603,vasantaṃ,vasantam,80,76,4,0,8
9604,puññūpanissayaṃ,punnupanissayam,1,1,0,0,15
9605,paṭivijjhārahaṃ,pativijjharaham,1,1,0,0,15
9606,paṭivijjhayamāno,pativijjhayamano,1,1,0,0,16
9607,phaladhammena,phaladhammena,1,1,0,0,13
9608,byāpitakkittinañcāti,byapitakkittinancati,1,0,1,0,20
9609,tiloke,tiloke,13,12,1,0,6
9610,patthaṭaparikittanaṃ,patthataparikittanam,2,2,0,0,20
9611,patthaṭathutighosikanti,patthatathutighosikanti,1,1,0,0,23
9612,casaddo,casaddo,81,80,1,0,7
9613,padapūraṇamattoyeva,padapuranamattoyeva,1,1,0,0,19
9614,āpati,apati,2,1,1,0,5
9615,byāpito,byapito,5,5,0,0,7
9616,vipubbaāpadhātu,vipubbaapadhatu,1,1,0,0,15
9617,byāpane,byapane,17,14,3,0,7
9618,byāpanaṃ,byapanam,8,8,0,0,8
9619,byāpitaṃ,byapitam,3,3,0,0,8
9620,kittiyate,kittiyate,2,2,0,0,9
9621,abhitthaviyate,abhitthaviyate,1,1,0,0,14
9622,kittinaṃ,kittinam,2,2,0,0,8
9623,thutikriyā,thutikriya,1,1,0,0,10
9624,kittiyati,kittiyati,1,1,0,0,9
9625,devamanussehīti,devamanussehiti,5,2,3,0,15
9626,thutighoso,thutighoso,25,21,4,0,10
9627,kittadhātu,kittadhatu,2,2,0,0,10
9628,abhitthavane,abhitthavane,1,1,0,0,12
9629,patthaṭo,patthato,21,20,1,0,8
9630,kittano,kittano,1,1,0,0,7
9631,byāpitakkittino,byapitakkittino,1,1,0,0,15
9632,sammāsambuddhotyādīhi,sammasambuddhotyadihi,1,1,0,0,21
9633,thomito,thomito,33,33,0,0,7
9634,kittisaddo,kittisaddo,193,192,1,0,10
9635,abbhuggacchatīti,abbhuggacchatiti,7,3,4,0,16
9636,byāpitakkittinanti,byapitakkittinanti,1,1,0,0,18
9637,ekacakkhūti,ekacakkhuti,2,1,1,0,11
9638,arūpasaṅkhātānaṃ,arupasankhatanam,1,1,0,0,16
9639,paññācakkhubhūtanti,pannacakkhubhutanti,1,1,0,0,19
9640,bhūtaṃpaññācakkhu,bhutampannacakkhu,1,1,0,0,17
9641,tilokekaccakkhu,tilokekaccakkhu,3,3,0,0,15
9642,ekacakkhusaddassa,ekacakkhusaddassa,1,1,0,0,17
9643,brahmassarotiādīsu,brahmassarotiadisu,1,1,0,0,18
9644,paññācakkhuṃ,pannacakkhum,21,20,1,0,12
9645,bhūto,bhuto,184,179,5,0,5
9646,pattoti,pattoti,224,182,42,0,7
9647,tilokekaccakkhubhūtanti,tilokekaccakkhubhutanti,1,1,0,0,23
9648,bhūtasaddalopaṃ,bhutasaddalopam,1,1,0,0,15
9649,M0.0152,M0.0152,72,72,0,0,7
9650,tilokekaccakkhunti,tilokekaccakkhunti,2,2,0,0,18
9651,ekabhūto,ekabhuto,2,2,0,0,8
9652,paññācakkhu,pannacakkhu,86,78,8,0,11
9653,mayattā,mayatta,1,1,0,0,7
9654,taduppādanato,taduppadanato,11,11,0,0,13
9655,cakkhubhūto,cakkhubhuto,59,43,16,0,11
9656,ñāṇabhūto,nanabhuto,34,26,8,0,9
9657,dhammabhūto,dhammabhuto,55,41,14,0,11
9658,brahmabhūto,brahmabhuto,55,41,14,0,11
9659,madhupiṇḍikasutte,madhupindikasutte,2,1,1,0,17
9660,hāvuso,havuso,52,49,3,0,6
9661,jānaṃ,janam,614,520,94,0,5
9662,passaṃ,passam,419,375,44,0,6
9663,vattā,vatta,193,174,19,0,5
9664,ninnetā,ninneta,32,26,6,0,7
9665,amatassa,amatassa,127,99,28,0,8
9666,dātā,data,147,131,16,0,4
9667,dhammassāmī,dhammassami,70,62,8,0,11
9668,puthujjanehi,puthujjanehi,38,36,2,0,12
9669,atidukkhamitaṭṭhānaṃ,atidukkhamitatthanam,2,2,0,0,20
9670,kasirena,kasirena,116,109,7,0,8
9671,khamitabbanti,khamitabbanti,6,6,0,0,13
9672,dukhamaṃ,dukhamam,1,1,0,0,8
9673,iṭṭhāniṭṭhādi,itthanitthadi,1,1,0,0,13
9674,dukkhamanti,dukkhamanti,3,3,0,0,11
9675,gajjabandhattā,gajjabandhatta,1,1,0,0,14
9676,kakāralopaṃ,kakaralopam,4,4,0,0,11
9677,dukhamanti,dukhamanti,1,1,0,0,10
9678,dukhamasahano,dukhamasahano,1,1,0,0,13
9679,parisahane,parisahane,4,2,2,0,10
9680,sudukkhamitaṃ,sudukkhamitam,1,1,0,0,13
9681,iṭṭhā,ittha,214,209,5,0,5
9682,niṭṭhādiārammaṇaṃ,nitthadiarammanam,1,1,0,0,17
9683,sītuṇhādiṃ,situnhadim,1,1,0,0,10
9684,lābhālābhayasāyasa,labhalabhayasayasa,1,1,0,0,18
9685,nindapasaṃsasukhadukkhasaṅkhātaṃ,nindapasamsasukhadukkhasankhatam,1,1,0,0,32
9686,lokadhammañca,lokadhammanca,1,1,0,0,13
9687,khamati,khamati,579,576,3,0,7
9688,adhivāseti,adhivaseti,116,112,4,0,10
9689,dukhamasahananti,dukhamasahananti,1,1,0,0,16
9690,sīlakkhandhādiṃ,silakkhandhadim,2,2,0,0,15
9691,pariyesamānaṃ,pariyesamanam,4,4,0,0,13
9692,gavesamānaṃ,gavesamanam,3,3,0,0,11
9693,mahante,mahante,302,287,15,0,7
9694,pariyesatīti,pariyesatiti,19,8,11,0,12
9695,mahesī,mahesi,152,141,11,0,6
9696,mahantasaddūpa,mahantasaddupa,1,1,0,0,14
9697,esadhātu,esadhatu,1,1,0,0,8
9698,mahāniddese,mahaniddese,43,28,15,0,11
9699,mahesīti,mahesiti,20,10,10,0,8
9700,sīlakkhandhaṃ,silakkhandham,66,56,10,0,13
9701,esi,esi,23,23,0,0,3
9702,gavesi,gavesi,9,9,0,0,6
9703,pariyesīti,pariyesiti,28,28,0,0,10
9704,samādhikkhandhaṃ,samadhikkhandham,50,45,5,0,16
9705,paññākkhandhaṃ,pannakkhandham,34,32,2,0,14
9706,vimuttikkhandhaṃ,vimuttikkhandham,22,20,2,0,16
9707,vimuttiñāṇadassanakkhandhaṃ,vimuttinanadassanakkhandham,24,22,2,0,27
9708,esī,esi,37,36,1,0,3
9709,gavesī,gavesi,67,66,1,0,6
9710,sattatiṃsabodhipakkhiya,sattatimsabodhipakkhiya,1,1,0,0,23
9711,satipaṭṭhāne,satipatthane,202,194,8,0,12
9712,sammappadhāne,sammappadhane,91,88,3,0,13
9713,iddhipāde,iddhipade,69,69,0,0,9
9714,M0.0153,M0.0153,68,68,0,0,7
9715,bojjhaṅge,bojjhange,227,218,9,0,9
9716,aṭṭhaṅgikaṃ,atthangikam,439,427,12,0,11
9717,paramatthaṃ,paramattham,83,76,7,0,11
9718,mahesakkhehi,mahesakkhehi,8,7,1,0,12
9719,esiyati,esiyati,1,1,0,0,7
9720,gavesiyati,gavesiyati,1,1,0,0,10
9721,pariyesiyati,pariyesiyati,1,1,0,0,12
9722,kahaṃ,kaham,708,690,18,0,5
9723,esito,esito,6,6,0,0,5
9724,gavesito,gavesito,7,7,0,0,8
9725,udayapabba,udayapabba,1,1,0,0,10
9726,vitthiṇṇabimbo,vitthinnabimbo,1,1,0,0,14
9727,vitthāraparimaṇḍalo,vittharaparimandalo,1,1,0,0,19
9728,vipulārammaṇasabbaññutañāṇavā,vipularammanasabbannutananava,1,1,0,0,29
9729,ekabuddhabhūto,ekabuddhabhuto,2,2,0,0,14
9730,buddhādicco,buddhadicco,4,4,0,0,11
9731,kuhare,kuhare,1,1,0,0,6
9732,vinetabbasattasamūhaṃ,vinetabbasattasamuham,1,1,0,0,21
9733,dhammaraṃ,dhammaram,1,1,0,0,9
9734,sīvarehi,sivarehi,1,1,0,0,8
9735,paṭivedhayamānena,pativedhayamanena,1,1,0,0,17
9736,vikāsesi,vikasesi,3,3,0,0,8
9737,byāpitakkittinaṃ,byapitakkittinam,1,1,0,0,16
9738,patthaṭathutighosikaṃ,patthatathutighosikam,1,1,0,0,21
9739,kāmarūpaarūpa,kamarupaarupa,1,1,0,0,13
9740,paññācakkhubhūtaṃ,pannacakkhubhutam,1,1,0,0,17
9741,vīsatimavandanagāthāvaṇṇanā,visatimavandanagathavannana,1,1,0,0,27
9742,M0.0154,M0.0154,71,71,0,0,7
9743,vīsatimāya,visatimaya,2,2,0,0,10
9744,bodhisattakāle,bodhisattakale,18,17,1,0,14
9745,jīvitapariccāgādīhi,jivitapariccagadihi,1,1,0,0,19
9746,dānādidasapāramiyo,danadidasaparamiyo,1,1,0,0,18
9747,pūrentehi,purentehi,9,9,0,0,9
9748,tyādimāha,tyadimaha,36,36,0,0,9
9749,raja,raja,6,6,0,0,4
9750,garulahūhi,garulahuhi,1,1,0,0,10
9751,vīsatakkharehi,visatakkharehi,1,1,0,0,14
9752,vuttagāthāti,vuttagathati,1,1,0,0,12
9753,vutta,vutta,65,51,14,0,5
9754,mīdisantu,midisantu,1,1,0,0,9
9755,nāmato,namato,83,79,4,0,6
9756,rajā,raja,11,11,0,0,4
9757,garullahū,garullahu,2,2,0,0,9
9758,rajagaṇā,rajagana,3,3,0,0,8
9759,īdisantu,idisantu,1,1,0,0,8
9760,īdisaṃ,idisam,256,238,18,0,6
9761,nāmena,namena,692,683,9,0,6
9762,jinoti,jinoti,24,9,15,0,6
9763,devaputtakilesābhisaṅkhārakhandhamaccuvasena,devaputtakilesabhisankharakhandhamaccuvasena,1,1,0,0,44
9764,buddhasāvakāpi,buddhasavakapi,8,8,0,0,14
9765,jinattā,jinatta,1,1,0,0,7
9766,jinā,jina,30,28,2,0,4
9767,parūpa,parupa,1,1,0,0,6
9768,nissayavirahaniratisayavasena,nissayavirahaniratisayavasena,1,1,0,0,29
9769,pañcamārajinattā,pancamarajinatta,1,1,0,0,16
9770,dhātukathāmūlaṭīkāyaṃ,dhatukathamulatikayam,1,0,1,0,21
9771,balavidhamana,balavidhamana,1,1,0,0,13
9772,visayātikkamavasena,visayatikkamavasena,2,2,0,0,19
9773,devaputtamārassa,devaputtamarassa,10,9,1,0,16
9774,apavattikaraṇavasena,apavattikaranavasena,1,1,0,0,20
9775,kilesābhisaṅkhāramārānaṃ,kilesabhisankharamaranam,4,4,0,0,24
9776,samudayappahānapariññāvasena,samudayappahanaparinnavasena,5,5,0,0,28
9777,khandhamārassa,khandhamarassa,2,2,0,0,14
9778,maccumārassa,maccumarassa,5,4,1,0,12
9779,bhañjitattā,bhanjitatta,3,3,0,0,11
9780,parūpanissayarahitaṃ,parupanissayarahitam,3,2,1,0,20
9781,niratisayaṃ,niratisayam,4,4,0,0,11
9782,bhañjanaṃ,bhanjanam,10,10,0,0,9
9783,bhagavāeva,bhagavaeva,1,1,0,0,10
9784,mārabhañjanoti,marabhanjanoti,1,1,0,0,14
9785,M0.0155,M0.0155,69,69,0,0,7
9786,anekasaṃsārabhave,anekasamsarabhave,2,2,0,0,17
9787,jātisaddo,jatisaddo,7,7,0,0,9
9788,anekattho,anekattho,11,11,0,0,9
9789,ekampi,ekampi,551,515,36,0,6
9790,jātiṃ,jatim,484,437,47,0,5
9791,dvepi,dvepi,903,856,47,0,5
9792,jātiyoti,jatiyoti,12,6,6,0,8
9793,visākhe,visakhe,215,211,4,0,7
9794,nigaṇṭhā,nigantha,157,152,5,0,8
9795,samaṇajātīti,samanajatiti,1,1,0,0,12
9796,nikāye,nikaye,92,86,6,0,6
9797,tiri,tiri,1,1,0,0,4
9798,tiṇajāti,tinajati,12,11,1,0,8
9799,nābhiyā,nabhiya,61,59,2,0,7
9800,uggantvā,uggantva,145,141,4,0,8
9801,nabhaṃ,nabham,135,119,16,0,6
9802,āhacca,ahacca,313,291,22,0,6
9803,ahosīti,ahositi,659,557,102,0,7
9804,paññattiyaṃ,pannattiyam,50,46,4,0,11
9805,khandhehi,khandhehi,904,891,13,0,9
9806,saṅgahitāti,sangahitati,158,144,14,0,11
9807,saṅkhatalakkhaṇe,sankhatalakkhane,7,6,1,0,16
9808,mātukucchiyaṃ,matukucchiyam,75,75,0,0,13
9809,viññāṇaṃ,vinnanam,3022,2831,191,0,8
9810,pātubhūtaṃ,patubhutam,87,84,3,0,10
9811,tadupādāya,tadupadaya,50,50,0,0,10
9812,sāvassa,savassa,11,9,2,0,7
9813,jātīti,jatiti,97,52,45,0,6
9814,paṭisandhiyaṃ,patisandhiyam,286,258,28,0,13
9815,sampatijāto,sampatijato,35,35,0,0,11
9816,ānanda,ananda,2773,2700,73,0,6
9817,bodhisattoti,bodhisattoti,19,11,8,0,12
9818,pasūtiyaṃ,pasutiyam,7,6,1,0,9
9819,anupakuṭṭho,anupakuttho,15,14,1,0,11
9820,jātivādenāti,jativadenati,10,7,3,0,12
9821,kule,kule,791,752,39,0,4
9822,yatohaṃ,yatoham,22,22,0,0,7
9823,bhagini,bhagini,227,219,8,0,7
9824,ariyasīle,ariyasile,3,3,0,0,9
9825,anekasaṃsārabhaveti,anekasamsarabhaveti,1,1,0,0,19
9826,viññātabbo,vinnatabbo,204,203,1,0,10
9827,jāyati,jayati,779,760,19,0,6
9828,yoni,yoni,154,124,30,0,4
9829,gatiādi,gatiadi,1,1,0,0,7
9830,vibhāgoti,vibhagoti,12,9,3,0,9
9831,jāyanti,jayanti,477,463,14,0,7
9832,nibbattanti,nibbattanti,276,272,4,0,11
9833,khandhādayoti,khandhadayoti,5,4,1,0,13
9834,janidhātu,janidhatu,1,1,0,0,9
9835,nibbattaneti,nibbattaneti,1,1,0,0,12
9836,anekā,aneka,93,91,2,0,5
9837,saputtadāraṃ,saputtadaram,8,6,2,0,12
9838,puttena,puttena,197,194,3,0,7
9839,sahitaṃ,sahitam,116,93,23,0,7
9840,putto,putto,1980,1946,34,0,5
9841,pavane,pavane,92,85,7,0,6
9842,mātāpitūnaṃ,matapitunam,487,478,9,0,11
9843,manaṃ,manam,518,454,64,0,5
9844,dhītā,dhita,520,508,12,0,5
9845,virūpeka,virupeka,1,1,0,0,8
9846,sesoyaṃ,sesoyam,1,1,0,0,7
9847,sāmikena,samikena,89,86,3,0,8
9848,dhariyateti,dhariyateti,1,1,0,0,11
9849,dāro,daro,16,13,3,0,4
9850,do,do,89,62,27,0,2
9851,purisena,purisena,393,384,9,0,8
9852,bhogaṃ,bhogam,169,157,12,0,6
9853,dīyatīti,diyatiti,19,15,4,0,8
9854,dākucchitā,dakucchita,1,1,0,0,10
9855,kārena,karena,73,73,0,0,6
9856,bhariyā,bhariya,745,732,13,0,7
9857,dāpubbaramudhātu,dapubbaramudhatu,1,1,0,0,16
9858,dāsaddo,dasaddo,7,7,0,0,7
9859,kucchitattho,kucchitattho,2,2,0,0,12
9860,dārayante,darayante,2,2,0,0,9
9861,dara,dara,36,11,25,0,4
9862,vidāraṇe,vidarane,31,27,4,0,8
9863,akattari,akattari,9,8,1,0,8
9864,kārake,karake,59,58,1,0,6
9865,saññāyaṃ,sannayam,75,70,5,0,8
9866,puttadāro,puttadaro,8,8,0,0,9
9867,samāhāradvandepi,samaharadvandepi,9,9,0,0,16
9868,M0.0156,M0.0156,72,72,0,0,7
9869,pulliṅgaṃ,pullingam,42,42,0,0,9
9870,icchanti,icchanti,449,443,6,0,8
9871,saputtadāro,saputtadaro,51,51,0,0,11
9872,puttadārapariccāgo,puttadarapariccago,3,3,0,0,18
9873,aṅgajīvitampīti,angajivitampiti,1,0,1,0,15
9874,hatthapādakaṇṇanāsacakkhādisarīrāvayavañca,hatthapadakannanasacakkhadisariravayavanca,2,2,0,0,42
9875,jīvitindriya,jivitindriya,3,3,0,0,12
9876,paṭibaddhasakalasarīrañca,patibaddhasakalasariranca,2,2,0,0,25
9877,kāyeti,kayeti,51,6,45,0,6
9878,aṅgo,ango,19,16,3,0,4
9879,cakkhādisarīrāvayavo,cakkhadisariravayavo,1,1,0,0,20
9880,jīvadhātu,jivadhatu,2,2,0,0,9
9881,pāṇadhāraṇe,panadharane,9,8,1,0,11
9882,jīvitañca,jivitanca,44,43,1,0,9
9883,aṅgajīvitaṃ,angajivitam,1,1,0,0,11
9884,pisaddo,pisaddo,112,112,0,0,7
9885,sampiṇḍanattho,sampindanattho,99,97,2,0,14
9886,dhanaraṭṭhapariccāgaṃ,dhanaratthapariccagam,1,1,0,0,21
9887,sampiṇḍeti,sampindeti,137,136,1,0,10
9888,sīlakkhandhaṭṭha,silakkhandhattha,1,0,1,0,16
9889,aṅgapariccāgaṃ,angapariccagam,10,10,0,0,14
9890,jīvitadhanarajjaputtadārapariccāganti,jivitadhanarajjaputtadarapariccaganti,1,1,0,0,37
9891,sambhāvanattho,sambhavanattho,24,24,0,0,14
9892,sabbaññutañāṇahetupi,sabbannutananahetupi,1,1,0,0,20
9893,puttadāraaṅgajīvitampi,puttadaraangajivitampi,2,2,0,0,22
9894,pariccajeti,pariccajeti,5,4,1,0,11
9895,dhanādibāhiravatthu,dhanadibahiravatthu,1,1,0,0,19
9896,pariccāgepīti,pariccagepiti,1,1,0,0,13
9897,sambhāveti,sambhaveti,29,29,0,0,10
9898,bodhipematoti,bodhipematoti,1,0,1,0,13
9899,arahattamaggasabbaññutañāṇasaṅkhātāya,arahattamaggasabbannutananasankhataya,1,1,0,0,37
9900,bodhiyā,bodhiya,283,268,15,0,7
9901,piyamānattā,piyamanatta,2,2,0,0,11
9902,hetvatthe,hetvatthe,57,51,6,0,9
9903,topaccayo,topaccayo,15,15,0,0,9
9904,bujjhatīti,bujjhatiti,103,90,13,0,10
9905,ñeyyadhamme,neyyadhamme,4,4,0,0,11
9906,sabbaññutañāṇe,sabbannutanane,2,2,0,0,14
9907,ariyamagge,ariyamagge,86,78,8,0,10
9908,nāriyaṃ,nariyam,40,38,2,0,7
9909,sarūpekase,sarupekase,1,1,0,0,10
9910,savasena,savasena,1,1,0,0,8
9911,piyanaṃ,piyanam,2,2,0,0,7
9912,pemo,pemo,9,9,0,0,4
9913,piyāyitabboti,piyayitabboti,5,5,0,0,13
9914,pīdhātu,pidhatu,2,2,0,0,7
9915,tappanakantīsu,tappanakantisu,11,10,1,0,14
9916,manipaccayo,manipaccayo,6,6,0,0,11
9917,bodhipemo,bodhipemo,1,1,0,0,9
9918,puttadāraaṅgajīvitehipi,puttadaraangajivitehipi,1,1,0,0,23
9919,sataguṇena,satagunena,44,44,0,0,10
9920,sahassaguṇena,sahassagunena,42,42,0,0,13
9921,sahassaguṇenapi,sahassagunenapi,3,3,0,0,15
9922,bodhiñāṇameva,bodhinanameva,1,1,0,0,13
9923,piyanti,piyanti,6,6,0,0,7
9924,vessantarajātake,vessantarajatake,8,4,4,0,16
9925,dessā,dessa,29,27,2,0,5
9926,puttā,putta,624,594,30,0,5
9927,maddī,maddi,121,119,2,0,5
9928,dessiyā,dessiya,6,6,0,0,7
9929,piyaṃ,piyam,471,426,45,0,5
9930,piye,piye,55,51,4,0,4
9931,adāsahaṃ,adasaham,99,93,6,0,8
9932,alaggamānasoti,alaggamanasoti,1,0,1,0,14
9933,M0.0157,M0.0157,72,72,0,0,7
9934,puttadāraaṅgajīvitādīsu,puttadaraangajivitadisu,2,2,0,0,23
9935,anallīyana,analliyana,1,1,0,0,10
9936,laganaṃ,laganam,7,6,1,0,7
9937,saṅganaṃ,sanganam,2,2,0,0,8
9938,laggo,laggo,71,70,1,0,5
9939,lagati,lagati,5,5,0,0,6
9940,saṅgati,sangati,162,153,9,0,7
9941,allayati,allayati,1,1,0,0,8
9942,lagadhātu,lagadhatu,1,1,0,0,9
9943,saṅge,sange,42,37,5,0,5
9944,allīyane,alliyane,3,3,0,0,8
9945,gapaccayo,gapaccayo,1,1,0,0,9
9946,alaggo,alaggo,33,31,2,0,6
9947,puttadāra,puttadara,1,1,0,0,9
9948,aṅgajīvitādīsūti,angajivitadisuti,1,1,0,0,16
9949,ārammaṇanti,arammananti,60,60,0,0,11
9950,mano,mano,1424,1251,173,0,4
9951,mānaso,manaso,45,40,5,0,6
9952,atthikassāti,atthikassati,2,0,2,0,12
9953,putta,putta,185,178,7,0,5
9954,dārādiṃ,daradim,1,1,0,0,7
9955,kāmikassa,kamikassa,2,2,0,0,9
9956,paṭiggāhakassa,patiggahakassa,29,29,0,0,14
9957,atthiko,atthiko,109,108,1,0,7
9958,adāsiyevāti,adasiyevati,1,0,1,0,11
9959,pūjānuggahakāmatāya,pujanuggahakamataya,4,4,0,0,19
9960,ñāṇasampayuttapariccāgacetanāya,nanasampayuttapariccagacetanaya,1,1,0,0,31
9961,adāsievāti,adasievati,1,1,0,0,10
9962,pāramīpūraṇa,paramipurana,1,1,0,0,12
9963,sarāgasadosasamohasseva,saragasadosasamohasseva,5,5,0,0,23
9964,gatānaṃ,gatanam,52,52,0,0,7
9965,yācakānaṃ,yacakanam,77,75,2,0,9
9966,alaṅkatapaṭiyattaṃ,alankatapatiyattam,54,53,1,0,18
9967,kantitvā,kantitva,36,34,2,0,8
9968,galalohitaṃ,galalohitam,14,14,0,0,11
9969,suañjitāni,suanjitani,8,8,0,0,10
9970,akkhīni,akkhini,346,339,7,0,7
9971,uppāṭetvā,uppatetva,132,129,3,0,9
9972,kulavaṃsappadīpaṃ,kulavamsappadipam,4,4,0,0,17
9973,manāpacāriniṃ,manapacarinim,6,6,0,0,13
9974,bhariyañca,bhariyanca,24,24,0,0,10
9975,kheḷapiṇḍamiva,khelapindamiva,1,1,0,0,14
9976,dīyamānova,diyamanova,1,1,0,0,10
9977,sammāsambodhiñāṇaṃ,sammasambodhinanam,2,2,0,0,18
9978,laddhuṃ,laddhum,320,312,8,0,7
9979,apariccajitvā,apariccajitva,21,21,0,0,13
9980,buddhabhūtapubbā,buddhabhutapubba,2,2,0,0,16
9981,paccekabuddhāriyasāvakā,paccekabuddhariyasavaka,1,1,0,0,23
9982,puttadāraaṅgajīvitaṃ,puttadaraangajivitam,1,1,0,0,20
9983,apariccajantāpi,apariccajantapi,1,1,0,0,15
9984,paccekabuddhāriyasāvakabodhiñāṇaṃ,paccekabuddhariyasavakabodhinanam,1,1,0,0,33
9985,samatthāva,samatthava,1,1,0,0,10
9986,tasmāyeva,tasmayeva,36,36,0,0,9
9987,kassāti,kassati,18,15,3,0,7
9988,vessantarajātakaṭṭha,vessantarajatakattha,1,0,1,0,20
9989,sabbabodhisattā,sabbabodhisatta,7,6,1,0,15
9990,dhanapariccāgaṃ,dhanapariccagam,11,10,1,0,15
9991,puttapariccāgaṃ,puttapariccagam,2,2,0,0,15
9992,bhariyapariccāgaṃ,bhariyapariccagam,2,2,0,0,17
9993,jīvitapariccāganti,jivitapariccaganti,2,2,0,0,18
9994,natthī,natthi,1191,1029,162,0,6
9995,mahāpariccāgaguṇehi,mahapariccagagunehi,1,1,0,0,19
9996,thomanaṃ,thomanam,52,48,4,0,8
9997,dānādipāramīpūraṇaguṇena,danadiparamipuranagunena,1,1,0,0,24
9998,dānapāramintiādimāha,danaparamintiadimaha,1,1,0,0,20
9999,M0.0158,M0.0158,72,72,0,0,7
