100000,yūsaṃ,yusam,16,15,1,0,5
100001,paṭaṅgamakkhikādīnaṃ,patangamakkhikadinam,1,1,0,0,20
100002,sinīyate,siniyate,2,2,0,0,8
100003,samaggena,samaggena,169,158,11,0,9
100004,bandhiyateti,bandhiyateti,1,1,0,0,12
100005,baddhasīmā,baddhasima,58,53,5,0,10
100006,abaddhasīmāti,abaddhasimati,8,8,0,0,13
100007,abaddhasīmā,abaddhasima,12,7,5,0,11
100008,mariyādakaraṇavasena,mariyadakaranavasena,1,1,0,0,20
100009,moḷikaraṇavasena,molikaranavasena,1,1,0,0,16
100010,asiyati,asiyati,2,2,0,0,7
100011,bhuñjiyatīti,bhunjiyatiti,1,1,0,0,12
100012,asnātha,asnatha,8,7,1,0,7
100013,vibādhane,vibadhane,1,0,1,0,9
100014,kilisnāti,kilisnati,1,1,0,0,9
100015,kilesoti,kilesoti,10,5,5,0,8
100016,uddhasa,uddhasa,1,0,1,0,7
100017,uddhasnāti,uddhasnati,1,1,0,0,10
100018,abhikkhaṇe,abhikkhane,1,0,1,0,10
100019,isnāti,isnati,1,1,0,0,6
100020,visnāti,visnati,1,1,0,0,7
100021,sinehasavanapūraṇesu,sinehasavanapuranesu,1,0,1,0,20
100022,pusnāti,pusnati,2,2,0,0,7
100023,musnāti,musnati,1,1,0,0,7
100024,kiyādī,kiyadi,4,3,1,0,6
100025,sāsanā,sasana,30,30,0,0,6
100026,tadanurūpakā,tadanurupaka,1,1,0,0,12
100027,gahādigaṇika,gahadiganika,1,1,0,0,12
100028,gahādi,gahadi,10,0,10,0,6
100029,gahādī,gahadi,6,0,6,0,6
100030,athameko,athameko,1,1,0,0,8
100031,cintāya,cintaya,17,17,0,0,7
100032,pakkhipiṃsu,pakkhipimsu,45,44,1,0,11
100033,gaṇheyya,ganheyya,192,189,3,0,8
100034,suvicakkhaṇo,suvicakkhano,1,1,0,0,12
100035,hitvāna,hitvana,70,58,12,0,7
100036,nāppaṇhā,nappanha,2,1,1,0,8
100037,ekalakkhaṇaṃ,ekalakkhanam,7,5,2,0,12
100038,katañcekalakkhaṇaṃ,katancekalakkhanam,1,1,0,0,18
100039,lopa,lopa,10,9,1,0,4
100040,mitiādīni,mitiadini,1,1,0,0,9
100041,lakkhaṇāniva,lakkhananiva,1,1,0,0,12
100042,dujjānaṃ,dujjanam,46,38,8,0,8
100043,takkagāhinā,takkagahina,1,1,0,0,11
100044,ggaho,ggaho,3,3,0,0,5
100045,uṇhāpetī,unhapeti,5,5,0,0,8
100046,ādirūpāni,adirupani,1,1,0,0,9
100047,saddaphalaṃ,saddaphalam,1,1,0,0,11
100048,kilesupādānaṃ,kilesupadanam,1,1,0,0,13
100049,upādānanti,upadananti,27,27,0,0,10
100050,samīpattho,samipattho,4,4,0,0,10
100051,ādāna,adana,1,0,1,0,5
100052,daḷhaggahaṇe,dalhaggahane,1,1,0,0,12
100053,kāmupādānaṃ,kamupadanam,170,150,20,0,11
100054,daḷhaggahaṇaṃ,dalhaggahanam,9,7,2,0,13
100055,sithilaggahaṇaṃ,sithilaggahanam,1,1,0,0,15
100056,upādānameva,upadanameva,2,2,0,0,11
100057,adhigaṇhāti,adhiganhati,22,21,1,0,11
100058,niggaṇhāti,nigganhati,62,58,4,0,10
100059,padhānagaṇhanako,padhanaganhanako,1,1,0,0,16
100060,uggaṇhituṃ,ugganhitum,27,26,1,0,10
100061,gaṇhitvā,ganhitva,328,324,4,0,8
100062,gahessāmi,gahessami,13,13,0,0,9
100063,uggāhako,uggahako,4,4,0,0,8
100064,saṅgāhako,sangahako,45,43,2,0,9
100065,ajjhogāḷho,ajjhogalho,29,26,3,0,10
100066,gaṇhāpeti,ganhapeti,60,58,2,0,9
100067,gaṇhāpayati,ganhapayati,2,2,0,0,11
100068,uggaṇhāpenti,ugganhapenti,7,6,1,0,12
100069,amaccasahassena,amaccasahassena,13,13,0,0,15
100070,gaṇhāpetvā,ganhapetva,49,48,1,0,10
100071,upajjhaṃ,upajjham,84,71,13,0,8
100072,gāhāpetabbo,gahapetabbo,22,22,0,0,11
100073,gāheti,gaheti,25,25,0,0,6
100074,gāhayati,gahayati,4,4,0,0,8
100075,gāhāpessati,gahapessati,3,3,0,0,11
100076,gāhetvā,gahetva,73,71,2,0,7
100077,saṅgayhati,sangayhati,106,106,0,0,10
100078,gaṇhiyati,ganhiyati,1,1,0,0,9
100079,gaṇhiyanti,ganhiyanti,1,1,0,0,10
100080,uggaṇhiyantī,ugganhiyanti,1,1,0,0,12
100081,saṅgahetā,sangaheta,5,4,1,0,9
100082,gheppanti,gheppanti,2,2,0,0,9
100083,gheppasī,gheppasi,1,1,0,0,8
100084,gaṇhasī,ganhasi,4,4,0,0,7
100085,gaṇhāpetī,ganhapeti,8,6,2,0,9
100086,aggahī,aggahi,15,15,0,0,6
100087,mattikāpattaṃ,mattikapattam,24,23,1,0,13
100088,aggahuṃ,aggahum,2,2,0,0,7
100089,aggahiṃsu,aggahimsu,2,2,0,0,9
100090,aggahesuṃ,aggahesum,80,74,6,0,9
100091,bhavissantīādīsu,bhavissantiadisu,1,1,0,0,16
100092,gahessati,gahessati,22,22,0,0,9
100093,gahessanti,gahessanti,11,11,0,0,10
100094,aggahissā,aggahissa,1,1,0,0,9
100095,aggahissaṃsu,aggahissamsu,1,1,0,0,12
100096,uṇha,unha,2,1,1,0,4
100097,dabbamapekkhati,dabbamapekkhati,1,1,0,0,15
100098,paṭihanatī,patihanati,2,2,0,0,10
100099,uṇhabhāvassa,unhabhavassa,3,3,0,0,12
100100,uṇhabhāvo,unhabhavo,9,8,1,0,9
100101,sītabhāvo,sitabhavo,5,5,0,0,9
100102,vipāsāyaṃ,vipasayam,1,0,1,0,9
100103,paritassatīti,paritassatiti,28,8,20,0,13
100104,juṇhe,junhe,63,62,1,0,5
100105,juṇhoti,junhoti,2,0,2,0,7
100106,joseti,joseti,2,2,0,0,6
100107,pītiṃsomanassañca,pitimsomanassanca,1,1,0,0,17
100108,nippabhāpi,nippabhapi,1,1,0,0,10
100109,candatārakappabhāsenapi,candatarakappabhasenapi,1,1,0,0,23
100110,sappabhā,sappabha,3,3,0,0,8
100111,saṇhavācā,sanhavaca,2,2,0,0,9
100112,tanukariyati,tanukariyati,1,1,0,0,12
100113,pharusabhāvena,pharusabhavena,1,1,0,0,14
100114,atisukhumampi,atisukhumampi,6,6,0,0,13
100115,tiṇho,tinho,2,1,1,0,5
100116,hitamāsīsantehi,hitamasisantehi,1,1,0,0,15
100117,seviyateti,seviyateti,1,1,0,0,10
100118,jīvitahetu,jivitahetu,16,16,0,0,10
100119,mahāsippāni,mahasippani,3,3,0,0,11
100120,sūramati,suramati,1,1,0,0,8
100121,mokkhañāṇaṃ,mokkhananam,1,1,0,0,11
100122,kriyāvidhi,kriyavidhi,1,1,0,0,10
100123,dhanubbedo,dhanubbedo,1,1,0,0,10
100124,hatthisikkhā,hatthisikkha,2,2,0,0,12
100125,kāmatantaṃ,kamatantam,1,1,0,0,10
100126,assalakkhaṇaṃ,assalakkhanam,5,5,0,0,13
100127,vejjakañcāti,vejjakancati,1,1,0,0,12
100128,kaṇhāti,kanhati,18,0,18,0,7
100129,apabhassarabhāvakaraṇattā,apabhassarabhavakaranatta,1,1,0,0,25
100130,kucchitabbā,kucchitabba,1,1,0,0,11
100131,garahitabbāti,garahitabbati,2,2,0,0,13
100132,kāḷavaṇṇattā,kalavannatta,4,4,0,0,12
100133,suvaṇṇavaṇṇādikaṃ,suvannavannadikam,1,1,0,0,17
100134,kucchitabbo,kucchitabbo,1,1,0,0,11
100135,ninditabboti,ninditabboti,1,1,0,0,12
100136,bhūmippadesasmiṃ,bhumippadesasmim,1,1,0,0,16
100137,tacasā,tacasa,3,3,0,0,6
100138,antosāro,antosaro,9,8,1,0,8
100139,dhātugaṇe,dhatugane,1,1,0,0,9
100140,ppo,ppo,1,0,1,0,3
100141,ākhyātattevadissati,akhyatattevadissati,1,1,0,0,19
100142,usagahe,usagahe,1,0,1,0,7
100143,nāmatteva,namatteva,1,1,0,0,9
100144,gaṇanicchayo,gananicchayo,1,1,0,0,12
100145,taṇhāyatī,tanhayati,2,2,0,0,9
100146,mettāyatī,mettayati,1,1,0,0,9
100147,kriyāpadattepi,kriyapadattepi,2,2,0,0,14
100148,paccayavatā,paccayavata,2,2,0,0,11
100149,nipphanna,nipphanna,6,6,0,0,9
100150,saddasmā,saddasma,1,1,0,0,8
100151,rūpiyasaṃvohārasikkhāpadavaṇṇanāyaṃ,rupiyasamvoharasikkhapadavannanayam,1,0,1,0,35
100152,vāsiphalaṃ,vasiphalam,5,5,0,0,10
100153,tāpetvā,tapetva,66,66,0,0,7
100154,kāritasaññassa,karitasannassa,1,1,0,0,14
100155,vuttappakāra,vuttappakara,2,2,0,0,12
100156,uṇhāpayatī,unhapayati,1,1,0,0,10
100157,kāritapadassa,karitapadassa,1,1,0,0,13
100158,diṭṭhattāyeva,ditthattayeva,1,1,0,0,13
100159,uṇhatī,unhati,2,2,0,0,6
100160,kattupadampi,kattupadampi,1,1,0,0,12
100161,kattukāritapadānaṃ,kattukaritapadanam,1,1,0,0,18
100162,ekadhātumhi,ekadhatumhi,2,2,0,0,11
100163,upalabbhamānattā,upalabbhamanatta,4,4,0,0,16
100164,gacchāpetīti,gacchapetiti,1,1,0,0,12
100165,uṇhatīti,unhatiti,1,1,0,0,8
100166,vicinitabbāni,vicinitabbani,2,2,0,0,13
100167,sāsanaṭṭhitiyā,sasanatthitiya,8,8,0,0,14
100168,dhāretabbā,dharetabba,139,139,0,0,10
100169,vācetabbā,vacetabba,5,5,0,0,9
100170,tanādigaṇika,tanadiganika,1,1,0,0,12
100171,taniyyati,taniyyati,3,3,0,0,9
100172,taniyyanti,taniyyanti,2,2,0,0,10
100173,vitaniyyatī,vitaniyyati,2,2,0,0,11
100174,patāyate,patayate,2,2,0,0,8
100175,pataññatī,patannati,1,1,0,0,9
100176,tanituṃ,tanitum,2,2,0,0,7
100177,tanitvāna,tanitvana,1,1,0,0,9
100178,mantādirūpāni,mantadirupani,1,1,0,0,13
100179,āyabhūte,ayabhute,10,10,0,0,8
100180,tanūti,tanuti,3,0,3,0,6
100181,kalalato,kalalato,10,8,2,0,8
100182,kammādīhi,kammadihi,18,18,0,0,9
100183,vitthāriyati,vitthariyati,1,1,0,0,12
100184,pāpiyatīti,papiyatiti,1,1,0,0,10
100185,tanū,tanu,18,11,7,0,4
100186,sarīravācakā,sariravacaka,1,1,0,0,12
100187,mahājano,mahajano,586,580,6,0,8
100188,sarīranti,sariranti,103,101,2,0,9
100189,khandhapañcakamattameva,khandhapancakamattameva,1,1,0,0,23
100190,attaniyaṃ,attaniyam,71,64,7,0,9
100191,kāmarāgabyāpādānaṃ,kamaragabyapadanam,39,36,3,0,18
100192,tanuttakaraṃ,tanuttakaram,4,3,1,0,12
100193,sakadāgāmimaggacittaṃ,sakadagamimaggacittam,7,5,2,0,21
100194,appatthavācako,appatthavacako,1,1,0,0,14
100195,appatthavācakassa,appatthavacakassa,1,1,0,0,17
100196,nipātapadanti,nipatapadanti,8,8,0,0,13
100197,vuttaṭṭhānampi,vuttatthanampi,1,1,0,0,14
100198,anipphannapāṭipadikoti,anipphannapatipadikoti,6,6,0,0,22
100199,tanotha,tanotha,2,2,0,0,7
100200,tanomi,tanomi,2,2,0,0,6
100201,tanoma,tanoma,2,2,0,0,6
100202,tanunte,tanunte,2,2,0,0,7
100203,tanuse,tanuse,4,4,0,0,6
100204,tanuvhe,tanuvhe,3,3,0,0,7
100205,tane,tane,2,2,0,0,4
100206,tanumhe,tanumhe,2,2,0,0,7
100207,tanotu,tanotu,3,3,0,0,6
100208,tanontu,tanontu,3,3,0,0,7
100209,taneyya,taneyya,3,3,0,0,7
100210,taneyyuṃ,taneyyum,3,3,0,0,8
100211,vitana,vitana,1,1,0,0,6
100212,vitanu,vitanu,1,1,0,0,6
100213,atanā,atana,1,1,0,0,5
100214,atanu,atanu,1,1,0,0,5
100215,ammāya,ammaya,14,14,0,0,6
100216,patanu,patanu,1,1,0,0,6
100217,atani,atani,3,3,0,0,5
100218,ataniṃsu,atanimsu,3,3,0,0,8
100219,tanissati,tanissati,3,3,0,0,9
100220,tanissanti,tanissanti,3,3,0,0,10
100221,atanissā,atanissa,1,1,0,0,8
100222,atanissaṃsu,atanissamsu,1,1,0,0,11
100223,taniyyasī,taniyyasi,1,1,0,0,9
100224,viññāpetuṃ,vinnapetum,88,84,4,0,10
100225,tvampi,tvampi,306,295,11,0,6
100226,pabbajituṃ,pabbajitum,156,154,2,0,10
100227,sahassampi,sahassampi,49,46,3,0,10
100228,cintanasamatthatāya,cintanasamatthataya,1,1,0,0,19
100229,avisaye,avisaye,33,31,2,0,7
100230,sakkontī,sakkonti,41,32,9,0,8
100231,sakkontaṃ,sakkontam,3,3,0,0,9
100232,khuṇu,khunu,1,0,1,0,5
100233,khiṇu,khinu,1,0,1,0,5
100234,khuṇoti,khunoti,1,1,0,0,7
100235,khiṇoti,khinoti,3,3,0,0,7
100236,iṇoti,inoti,1,1,0,0,5
100237,tiṇu,tinu,1,0,1,0,4
100238,tiṇoti,tinoti,1,1,0,0,6
100239,yavasaṃ,yavasam,14,14,0,0,7
100240,tiṇiyate,tiniyate,1,1,0,0,8
100241,tiṇabhakkhehi,tinabhakkhehi,1,1,0,0,13
100242,goṇādīhi,gonadihi,1,1,0,0,8
100243,khādiyateti,khadiyateti,2,2,0,0,11
100244,ghiṇu,ghinu,1,0,1,0,5
100245,ghiṇoti,ghinoti,1,1,0,0,7
100246,anālāpakaraṇaṃ,analapakaranam,1,1,0,0,14
100247,nibbacanatākaraṇaṃ,nibbacanatakaranam,1,1,0,0,18
100248,hanoti,hanoti,1,1,0,0,6
100249,panu,panu,2,1,1,0,4
100250,panoti,panoti,1,1,0,0,6
100251,panute,panute,1,1,0,0,6
100252,manute,manute,5,5,0,0,6
100253,nivisati,nivisati,88,87,1,0,8
100254,punnapuṃsakaliṅgatā,punnapumsakalingata,1,1,0,0,19
100255,rāgopi,ragopi,12,12,0,0,6
100256,arahattampi,arahattampi,20,18,2,0,11
100257,antalikkhacaro,antalikkhacaro,44,38,6,0,14
100258,appattamānaso,appattamanaso,23,21,2,0,13
100259,arahattañca,arahattanca,48,46,2,0,11
100260,pāpasāsane,papasasane,1,1,0,0,10
100261,khilasāsane,khilasasane,1,1,0,0,11
100262,sampayuttamanasi,sampayuttamanasi,1,0,1,0,16
100263,mānasanti,manasanti,13,13,0,0,9
100264,tannibbattattā,tannibbattatta,3,3,0,0,14
100265,arahattassa,arahattassa,122,119,3,0,11
100266,mānasatā,manasata,3,3,0,0,8
100267,manūti,manuti,9,3,6,0,6
100268,cakkhupasādena,cakkhupasadena,10,10,0,0,14
100269,manū,manu,4,4,0,0,4
100270,mātāpibhuṭṭhāne,matapibhutthane,1,1,0,0,15
100271,manunāmako,manunamako,1,1,0,0,10
100272,mahāsammatarājā,mahasammataraja,5,5,0,0,15
100273,sakalalokassa,sakalalokassa,15,15,0,0,13
100274,vuttappakārassa,vuttappakarassa,47,47,0,0,15
100275,dantajanakārasahito,dantajanakarasahito,1,1,0,0,19
100276,mānava,manava,2,1,1,0,6
100277,sabbasattasādhāraṇavacano,sabbasattasadharanavacano,2,2,0,0,25
100278,muddhaja,muddhaja,4,4,0,0,8
100279,kārasahito,karasahito,1,1,0,0,10
100280,kucchitamūḷhāpaccavacano,kucchitamulhapaccavacano,2,2,0,0,24
100281,vīmaṃsitvā,vimamsitva,218,213,5,0,10
100282,atthuddhāravacane,atthuddharavacane,1,1,0,0,17
100283,antaraantarikā,antaraantarika,1,0,1,0,14
100284,āharaṇassa,aharanassa,1,1,0,0,10
100285,vīmaṃsanā,vimamsana,3,3,0,0,9
100286,cūḷakammavibhaṅgasuttasmiñhi,culakammavibhangasuttasminhi,1,0,1,0,28
100287,māṇavotodeyyaputto,manavotodeyyaputto,1,1,0,0,18
100288,subhoti,subhoti,14,5,9,0,7
100289,dassanīyo,dassaniyo,93,90,3,0,9
100290,aṅgasubhatāya,angasubhataya,5,5,0,0,13
100291,taruṇakāle,tarunakale,24,23,1,0,10
100292,vohariṃsu,voharimsu,22,22,0,0,9
100293,mahallakakālepi,mahallakakalepi,15,15,0,0,15
100294,vohārena,voharena,48,48,0,0,8
100295,māṇavavohāro,manavavoharo,3,3,0,0,12
100296,muddhadhātukā,muddhadhatuka,1,1,0,0,13
100297,vohariṃsū,voharimsu,2,1,1,0,9
100298,jaṇa,jana,1,0,1,0,4
100299,māṇavoti,manavoti,22,6,16,0,8
100300,sattopi,sattopi,11,10,1,0,7
100301,coropi,coropi,10,10,0,0,6
100302,coditā,codita,39,36,3,0,6
100303,devadūtehi,devadutehi,16,16,0,0,10
100304,pamajjanti,pamajjanti,21,21,0,0,10
100305,katakammehipi,katakammehipi,4,4,0,0,13
100306,akatakammehipī,akatakammehipi,4,4,0,0,14
100307,vissaratīti,vissaratiti,5,4,1,0,11
100308,vītopamānamappamāṇamanāthanāthaṃ,vitopamanamappamanamanathanatham,1,1,0,0,32
100309,vītopamānaṃ,vitopamanam,1,0,1,0,11
100310,vītopamaṃ,vitopamam,1,1,0,0,9
100311,nirupamanti,nirupamanti,1,1,0,0,11
100312,upametabbākāro,upametabbakaro,2,2,0,0,14
100313,upameyyo,upameyyo,1,1,0,0,8
100314,tejoparakkamādīhi,tejoparakkamadihi,1,1,0,0,17
100315,upametabbattā,upametabbatta,1,1,0,0,13
100316,tejoparakkamādayo,tejoparakkamadayo,1,1,0,0,17
100317,tejādīhi,tejadihi,1,1,0,0,8
100318,tejādiupametabbākāro,tejadiupametabbakaro,1,1,0,0,20
100319,hīnūpamāvasena,hinupamavasena,1,1,0,0,14
100320,utusamuṭṭhānattepi,utusamutthanattepi,1,1,0,0,18
100321,kammapaccayautusamuṭṭhānattā,kammapaccayautusamutthanatta,1,1,0,0,28
100322,miniyati,miniyati,1,1,0,0,8
100323,paricchindiyatīti,paricchindiyatiti,1,1,0,0,17
100324,upakaroti,upakaroti,1,1,0,0,9
100325,apakaroti,apakaroti,1,1,0,0,9
100326,paṭikaroti,patikaroti,26,24,2,0,10
100327,paṭisaṅkharoti,patisankharoti,3,3,0,0,14
100328,abhisaṅkharoti,abhisankharoti,135,134,1,0,14
100329,kārāgamaṭṭhāne,karagamatthane,2,2,0,0,14
100330,tasmiṃyevaṭhāne,tasmimyevathane,1,1,0,0,15
100331,vipariyāye,vipariyaye,1,1,0,0,10
100332,kariyyati,kariyyati,2,2,0,0,9
100333,kayyati,kayyati,4,4,0,0,7
100334,pakarīyati,pakariyati,1,1,0,0,10
100335,pakariyyati,pakariyyati,1,1,0,0,11
100336,paṭisaṅkhariyyati,patisankhariyyati,1,1,0,0,17
100337,abhisaṅkhariyyati,abhisankhariyyati,1,1,0,0,17
100338,kayiratīti,kayiratiti,2,1,1,0,10
100339,kayiratī,kayirati,5,5,0,0,8
100340,adesitavatthukā,adesitavatthuka,12,12,0,0,15
100341,ādiantabhūtānaṃ,adiantabhutanam,1,1,0,0,15
100342,vipariyāyenāti,vipariyayenati,3,1,2,0,14
100343,kārāpayatī,karapayati,2,2,0,0,10
100344,hetukatturūpānī,hetukatturupani,1,1,0,0,15
100345,kubbatī,kubbati,5,5,0,0,7
100346,ntapadassa,ntapadassa,2,2,0,0,10
100347,ayojetabbattā,ayojetabbatta,1,1,0,0,13
100348,kubbasi,kubbasi,3,3,0,0,7
100349,kubbatha,kubbatha,2,2,0,0,8
100350,kubbāmi,kubbami,1,1,0,0,7
100351,kubbāma,kubbama,1,1,0,0,7
100352,kubbante,kubbante,6,6,0,0,8
100353,kubbase,kubbase,1,1,0,0,7
100354,kubbavhe,kubbavhe,1,1,0,0,8
100355,kubbe,kubbe,6,6,0,0,5
100356,kubbamhe,kubbamhe,1,1,0,0,8
100357,vuttarūpāni,vuttarupani,12,12,0,0,11
100358,kubbatu,kubbatu,2,2,0,0,7
100359,kubbeyya,kubbeyya,4,4,0,0,8
100360,kubbeyyuṃ,kubbeyyum,1,1,0,0,9
100361,ntapadāni,ntapadani,1,1,0,0,9
100362,kubbasī,kubbasi,8,7,1,0,7
100363,pāḷinayadassanato,palinayadassanato,2,2,0,0,17
100364,maññantā,mannanta,13,13,0,0,8
100365,nānukubbantī,nanukubbanti,1,1,0,0,12
100366,kārapaccayassādesabhūto,karapaccayassadesabhuto,1,1,0,0,23
100367,sareyeva,sareyeva,2,2,0,0,8
100368,pappotīti,pappotiti,13,12,1,0,9
100369,parasarassābhāvato,parasarassabhavato,1,1,0,0,18
100370,krubbatī,krubbati,1,1,0,0,8
100371,pharusāhi,pharusahi,27,26,1,0,9
100372,pakrubbamāno,pakrubbamano,3,3,0,0,12
100373,saddasatthanayavidūro,saddasatthanayaviduro,1,1,0,0,21
100374,pāḷigatidassanato,paligatidassanato,4,4,0,0,17
100375,padamālāpi,padamalapi,2,2,0,0,10
100376,yojetabbāva,yojetabbava,2,2,0,0,11
100377,upetīti,upetiti,76,39,37,0,7
100378,aṭṭhakathāgatidassanato,atthakathagatidassanato,1,1,0,0,23
100379,sabbhayo,sabbhayo,2,2,0,0,8
100380,sabbhiṃ,sabbhim,6,5,1,0,7
100381,sabbhinā,sabbhina,1,1,0,0,8
100382,krubbanti,krubbanti,2,2,0,0,9
100383,krubbasī,krubbasi,1,1,0,0,8
100384,yathāpaṭiññātā,yathapatinnata,1,1,0,0,14
100385,anuppattā,anuppatta,160,153,7,0,9
100386,kuruse,kuruse,5,5,0,0,6
100387,kuruvhe,kuruvhe,2,2,0,0,7
100388,karumhe,karumhe,1,1,0,0,7
100389,kubbantaṃ,kubbantam,8,7,1,0,9
100390,kurussu,kurussu,3,3,0,0,7
100391,kuruvho,kuruvho,3,3,0,0,7
100392,kubbāmase,kubbamase,3,3,0,0,9
100393,pañcamīvasena,pancamivasena,2,2,0,0,13
100394,vivāhaṃ,vivaham,15,14,1,0,7
100395,asaṃyuttaṃ,asamyuttam,5,4,1,0,10
100396,vacanassāvayavabhūto,vacanassavayavabhuto,1,1,0,0,20
100397,mavacanassa,mavacanassa,1,1,0,0,11
100398,vattamānāvacanavasena,vattamanavacanavasena,1,1,0,0,21
100399,pañcamīvacanavasena,pancamivacanavasena,1,1,0,0,19
100400,nāmikapadato,namikapadato,1,1,0,0,12
100401,gatāse,gatase,25,24,1,0,6
100402,panākhyātikapadato,panakhyatikapadato,1,1,0,0,18
100403,sādesanirādesavasena,sadesaniradesavasena,1,1,0,0,20
100404,okkantāmasi,okkantamasi,3,3,0,0,11
100405,kareyyātha,kareyyatha,18,17,1,0,10
100406,kareyyāma,kareyyama,34,34,0,0,9
100407,kubberaṃ,kubberam,1,1,0,0,8
100408,kubbetho,kubbetho,1,1,0,0,8
100409,kubbeyyavho,kubbeyyavho,1,1,0,0,11
100410,kareyyāmhe,kareyyamhe,1,1,0,0,10
100411,sattamīvasena,sattamivasena,3,3,0,0,13
100412,karu,karu,1,1,0,0,4
100413,karimha,karimha,12,12,0,0,7
100414,karire,karire,1,1,0,0,6
100415,karittho,karittho,2,2,0,0,8
100416,karivho,karivho,1,1,0,0,7
100417,kariṃ,karim,15,15,0,0,5
100418,karimhe,karimhe,1,1,0,0,7
100419,karāti,karati,3,0,3,0,6
100420,karīti,kariti,15,11,4,0,6
100421,paṭhamapurisayojanāya,pathamapurisayojanaya,2,2,0,0,21
100422,akaraṃ,akaram,52,42,10,0,6
100423,kammadukkaṭaṃ,kammadukkatam,2,2,0,0,13
100424,paṭhamapurisappayogo,pathamapurisappayogo,4,4,0,0,20
100425,majjhimapurisappayogo,majjhimapurisappayogo,2,2,0,0,21
100426,mahāparādhaṃ,mahaparadham,3,3,0,0,12
100427,mahāpāpaṃ,mahapapam,2,2,0,0,9
100428,jātakaṭṭhakathāvasenāpi,jatakatthakathavasenapi,1,1,0,0,23
100429,paṭhamuttamapurisappayogo,pathamuttamapurisappayogo,1,1,0,0,25
100430,yathāvuttavibhattivasena,yathavuttavibhattivasena,1,1,0,0,24
100431,bhattāraṃ,bhattaram,62,57,5,0,9
100432,pariyesa,pariyesa,36,36,0,0,8
100433,parokkhāyattanopadamajjhimapurisekavacanavasena,parokkhayattanopadamajjhimapurisekavacanavasena,1,1,0,0,47
100434,rassapāṭhopi,rassapathopi,1,1,0,0,12
100435,akaru,akaru,2,2,0,0,5
100436,sabbārivijayaṃ,sabbarivijayam,1,1,0,0,14
100437,akarāti,akarati,1,0,1,0,7
100438,atītakriyāvācako,atitakriyavacako,1,1,0,0,16
100439,udakamāharī,udakamahari,1,1,0,0,11
100440,atītavācakapaṭṭhamapurisappayogabhāve,atitavacakapatthamapurisappayogabhave,1,1,0,0,37
100441,hiyyattanajjatanīvibhattiyo,hiyyattanajjatanivibhattiyo,1,1,0,0,27
100442,pañcamīvibhattiatthe,pancamivibhattiatthe,1,1,0,0,20
100443,āharasī,aharasi,7,7,0,0,7
100444,majjhimapurisappayogārahā,majjhimapurisappayogaraha,1,1,0,0,25
100445,jīrīti,jiriti,3,1,2,0,6
100446,alabbhaneyyaṃ,alabbhaneyyam,5,5,0,0,13
100447,atītavācakapaṭhamapurisappayogabhāve,atitavacakapathamapurisappayogabhave,1,1,0,0,36
100448,ajjatanīvibhattipañcamīvibhattiatthe,ajjatanivibhattipancamivibhattiatthe,1,1,0,0,36
100449,jīratū,jiratu,1,1,0,0,6
100450,paṭhamapurisappayogārahā,pathamapurisappayogaraha,1,1,0,0,24
100451,jarāsabhāvaṃ,jarasabhavam,5,4,1,0,12
100452,jīritu,jiritu,1,1,0,0,6
100453,sesesupī,sesesupi,4,4,0,0,8
100454,rassapāṭhopī,rassapathopi,1,1,0,0,12
100455,atikara,atikara,2,2,0,0,7
100456,cariya,cariya,4,4,0,0,6
100457,mayhampetaṃ,mayhampetam,8,7,1,0,11
100458,ācariya,acariya,277,274,3,0,7
100459,atikkantakaraṇaṃ,atikkantakaranam,2,2,0,0,16
100460,paṭhamapurisavasena,pathamapurisavasena,6,6,0,0,19
100461,vattabbamevāti,vattabbamevati,21,21,0,0,14
100462,yojanāpi,yojanapi,6,6,0,0,8
100463,kātabbāva,katabbava,3,3,0,0,9
100464,akattha,akattha,31,31,0,0,7
100465,akarotha,akarotha,1,1,0,0,8
100466,akaramha,akaramha,7,7,0,0,8
100467,akamha,akamha,2,2,0,0,6
100468,saṃvaḍḍhayitvā,samvaddhayitva,3,3,0,0,14
100469,puḷinacetiyaṃ,pulinacetiyam,1,1,0,0,13
100470,akatthuṃ,akatthum,1,1,0,0,8
100471,akuruse,akuruse,1,1,0,0,7
100472,akaravhaṃ,akaravham,1,1,0,0,9
100473,padāvayava,padavayava,1,1,0,0,10
100474,apadāvayavaanekantapadāvayava,apadavayavaanekantapadavayava,1,1,0,0,29
100475,sosaddattha,sosaddattha,1,1,0,0,11
100476,apadāvayavo,apadavayavo,1,1,0,0,11
100477,samūhatāse,samuhatase,6,5,1,0,10
100478,anekantapadāvayavo,anekantapadavayavo,1,1,0,0,18
100479,arogā,aroga,95,93,2,0,5
100480,gaṇhāmase,ganhamase,8,8,0,0,9
100481,pañcamīvibhattiyaṃ,pancamivibhattiyam,1,1,0,0,18
100482,vacanassāvayavo,vacanassavayavo,2,2,0,0,15
100483,pañcamīvibhattiyuttānaṃ,pancamivibhattiyuttanam,2,2,0,0,23
100484,patthanāsīsanatthānaṃ,patthanasisanatthanam,2,2,0,0,21
100485,gaṇhāmā,ganhama,25,25,0,0,7
100486,anekantapadāvayavattaṃ,anekantapadavayavattam,1,1,0,0,22
100487,eseseti,eseseti,5,0,5,0,7
100488,esoso,esoso,1,1,0,0,5
100489,ekaṭṭho,ekattho,3,3,0,0,7
100490,kārādesakaraṇavasena,karadesakaranavasena,1,1,0,0,20
100491,hiyyattanīparassapade,hiyyattaniparassapade,1,1,0,0,21
100492,uttamapurisabahuvacanantaṃ,uttamapurisabahuvacanantam,2,2,0,0,26
100493,hiyyattanīattanopade,hiyyattaniattanopade,1,1,0,0,20
100494,akaṃsuṃ,akamsum,2,2,0,0,7
100495,akaroti,akaroti,2,1,1,0,7
100496,varañce,varance,25,23,2,0,7
100497,majjhimapurisekavacanatthaṃ,majjhimapurisekavacanattham,1,1,0,0,27
100498,avijjamānattepi,avijjamanattepi,1,1,0,0,15
100499,vuttaṭṭhāne,vuttatthane,55,55,0,0,11
100500,majjhimapurisavacanaṃ,majjhimapurisavacanam,2,2,0,0,21
100501,tādisañhi,tadisanhi,34,34,0,0,9
100502,paṭhamapurisavacanameva,pathamapurisavacanameva,1,1,0,0,23
100503,paṭhamapurisapāḷiyo,pathamapurisapaliyo,1,1,0,0,19
100504,sūkaramukho,sukaramukho,8,6,2,0,11
100505,akarimha,akarimha,10,10,0,0,8
100506,akāsimha,akasimha,3,3,0,0,8
100507,akarū,akaru,2,2,0,0,5
100508,akaruse,akaruse,1,1,0,0,7
100509,akarivhaṃ,akarivham,1,1,0,0,9
100510,akarimhe,akarimhe,1,1,0,0,8
100511,karissatha,karissatha,46,43,3,0,10
100512,karissate,karissate,3,3,0,0,9
100513,karissante,karissante,4,4,0,0,10
100514,karissase,karissase,2,2,0,0,9
100515,karissavhe,karissavhe,2,2,0,0,10
100516,purisakāriyaṃ,purisakariyam,5,5,0,0,13
100517,karissamhe,karissamhe,1,1,0,0,10
100518,kāhanti,kahanti,31,29,2,0,7
100519,kāhatha,kahatha,5,5,0,0,7
100520,kāhinti,kahinti,7,6,1,0,7
100521,akarissa,akarissa,6,6,0,0,8
100522,akarissaṃsūti,akarissamsuti,1,1,0,0,13
100523,kayiranti,kayiranti,10,10,0,0,9
100524,kayirasi,kayirasi,2,2,0,0,8
100525,kayirāmi,kayirami,7,7,0,0,8
100526,kayiratu,kayiratu,4,4,0,0,8
100527,kayirantu,kayirantu,1,1,0,0,9
100528,kuyirā,kuyira,2,2,0,0,6
100529,kumbhimhipa,kumbhimhipa,1,1,0,0,11
100530,cātañcāpi,catancapi,1,1,0,0,9
100531,padakkhiṇaṃ,padakkhinam,680,664,16,0,11
100532,kumbhimhipi,kumbhimhipi,1,1,0,0,11
100533,añjalinti,anjalinti,1,1,0,0,9
100534,kayiretha,kayiretha,1,1,0,0,9
100535,kayireraṃ,kayireram,1,1,0,0,9
100536,kayiretho,kayiretho,1,1,0,0,9
100537,kayirāvho,kayiravho,1,1,0,0,9
100538,kayiraṃ,kayiram,2,2,0,0,7
100539,kayirāmhe,kayiramhe,1,1,0,0,9
100540,kayirāti,kayirati,33,6,27,0,8
100541,puññañce,punnance,9,9,0,0,8
100542,majjhimapurisavasena,majjhimapurisavasena,2,2,0,0,20
100543,kayirāsī,kayirasi,1,1,0,0,8
100544,labhetha,labhetha,271,250,21,0,8
100545,varadaṃ,varadam,10,9,1,0,7
100546,labhethā,labhetha,2,2,0,0,8
100547,samāsethā,samasetha,2,1,1,0,9
100548,purisavipallāsaṃ,purisavipallasam,2,2,0,0,16
100549,uttamapurisavasenattho,uttamapurisavasenattho,2,2,0,0,22
100550,tumhehipi,tumhehipi,18,17,1,0,9
100551,kareyyāsī,kareyyasi,36,34,2,0,9
100552,majjhimapurisavasenattho,majjhimapurisavasenattho,1,1,0,0,24
100553,aṭṭhakathācariyehipi,atthakathacariyehipi,3,3,0,0,20
100554,paramakosallasamannāgatattā,paramakosallasamannagatatta,1,1,0,0,27
100555,purisavipallāsavasena,purisavipallasavasena,2,2,0,0,21
100556,purisavipallāso,purisavipallaso,2,2,0,0,15
100557,limpethā,limpetha,1,1,0,0,8
100558,labhe,labhe,45,39,6,0,5
100559,athā,atha,29,25,4,0,4
100560,purisavipallāsena,purisavipallasena,1,1,0,0,17
100561,labheti,labheti,5,2,3,0,7
100562,uttamapurisavacanaṃ,uttamapurisavacanam,1,1,0,0,19
100563,vajjhañcāpi,vajjhancapi,4,4,0,0,11
100564,pamocaye,pamocaye,15,15,0,0,8
100565,adhikārantare,adhikarantare,1,1,0,0,13
100566,adhikārantaravasena,adhikarantaravasena,1,1,0,0,19
100567,labheyyanti,labheyyanti,6,5,1,0,11
100568,dvinnamatthānaṃ,dvinnamatthanam,2,2,0,0,15
100569,cetesu,cetesu,39,35,4,0,6
100570,dujjāno,dujjano,46,46,0,0,7
100571,gahetabbāva,gahetabbava,4,4,0,0,11
100572,vacanavipallāso,vacanavipallaso,14,14,0,0,15
100573,kālavipallāso,kalavipallaso,1,1,0,0,13
100574,akkharavipallāsoti,akkharavipallasoti,1,1,0,0,18
100575,kayirāthāti,kayirathati,5,2,3,0,11
100576,attanopadavasena,attanopadavasena,2,2,0,0,16
100577,majjhimapurisabahuvacanavasena,majjhimapurisabahuvacanavasena,2,2,0,0,30
100578,paṭhamapurisekavacanavasena,pathamapurisekavacanavasena,2,2,0,0,27
100579,dadantā,dadanta,14,14,0,0,7
100580,kayirāthā,kayiratha,2,2,0,0,9
100581,kareyyāthayevāti,kareyyathayevati,1,1,0,0,16
100582,puññānī,punnani,21,21,0,0,7
100583,paccayasahitāni,paccayasahitani,2,2,0,0,15
100584,appasiddhānīti,appasiddhaniti,1,1,0,0,14
100585,kattukārakakammakārakādivācako,kattukarakakammakarakadivacako,1,1,0,0,30
100586,pulliṅgopi,pullingopi,1,1,0,0,10
100587,rajatakārakammakāralohakārādivācako,rajatakarakammakaralohakaradivacako,1,1,0,0,35
100588,kārāpetīti,karapetiti,3,2,1,0,10
100589,kārāpako,karapako,7,6,1,0,8
100590,krubbaṃ,krubbam,3,2,1,0,7
100591,kubbāno,kubbano,4,4,0,0,7
100592,pakruṃbbamāno,pakrumbbamano,1,1,0,0,13
100593,kārāpikā,karapika,3,3,0,0,8
100594,kubbantī,kubbanti,3,3,0,0,8
100595,kārāpakaṃ,karapakam,1,1,0,0,9
100596,parikkhato,parikkhato,4,4,0,0,10
100597,akrubbato,akrubbato,3,3,0,0,9
100598,kārasaṃyogavantāni,karasamyogavantani,1,1,0,0,18
100599,kle,kle,1,0,1,0,3
100600,sasaddo,sasaddo,2,2,0,0,7
100601,adissamānopi,adissamanopi,1,1,0,0,12
100602,aṭṭhakathācariyādīhi,atthakathacariyadihi,1,1,0,0,20
100603,gahetabbova,gahetabbova,11,11,0,0,11
100604,kriyākriyāpattivibhāgadesako,kriyakriyapattivibhagadesako,5,3,2,0,28
100605,kāretuṃ,karetum,93,89,4,0,7
100606,adhikacca,adhikacca,1,1,0,0,9
100607,kariyāna,kariyana,1,1,0,0,8
100608,purakkhitvā,purakkhitva,5,5,0,0,11
100609,kaccāti,kaccati,2,0,2,0,7
100610,adhikaccāti,adhikaccati,2,0,2,0,11
100611,panetādisaṃ,panetadisam,1,1,0,0,11
100612,anukūlaṃ,anukulam,30,28,2,0,8
100613,therikāgāthāyaṃ,therikagathayam,1,0,1,0,15
100614,gotamiyā,gotamiya,25,25,0,0,8
100615,parinibbānavacane,parinibbanavacane,1,1,0,0,17
100616,nipacca,nipacca,45,45,0,0,7
100617,appamattakaṃ,appamattakam,158,148,10,0,12
100618,atthātisayayogaṃ,atthatisayayogam,1,1,0,0,16
100619,taṇhaṅkaroti,tanhankaroti,1,0,1,0,12
100620,kāraṇāti,karanati,39,29,10,0,8
100621,pakrubbamānoti,pakrubbamanoti,2,1,1,0,14
100622,manāpe,manape,16,16,0,0,6
100623,piyāyamāno,piyayamano,1,1,0,0,10
100624,tussamāno,tussamano,2,2,0,0,9
100625,modamāno,modamano,14,13,1,0,8
100626,sevatī,sevati,7,6,1,0,6
100627,mantenti,mantenti,22,22,0,0,8
100628,parikkhāra,parikkhara,3,1,2,0,10
100629,parikkhāroti,parikkharoti,31,20,11,0,12
100630,nagaraparikkhārehi,nagaraparikkharehi,14,13,1,0,18
100631,suparikkhittaṃ,suparikkhittam,7,7,0,0,14
100632,setaparikkhāro,setaparikkharo,3,3,0,0,14
100633,jīvitaparikkhārā,jivitaparikkhara,30,30,0,0,16
100634,samudānetabbā,samudanetabba,26,26,0,0,13
100635,sambhāro,sambharo,26,22,4,0,8
100636,etthetañhi,etthetanhi,1,1,0,0,10
100637,tanādī,tanadi,4,3,1,0,6
100638,vividhatthasāraṃ,vividhatthasaram,1,1,0,0,16
100639,matiṅkaraṃ,matinkaram,1,1,0,0,10
100640,viññujanādhirāmaṃ,vinnujanadhiramam,1,1,0,0,17
100641,uḷārachandehi,ularachandehi,1,1,0,0,13
100642,susevanīyaṃ,susevaniyam,1,1,0,0,11
100643,suvaṇṇahaṃsehi,suvannahamsehi,1,1,0,0,14
100644,suciṃva,sucimva,1,1,0,0,7
100645,sattarasamo,sattarasamo,30,30,0,0,11
100646,curādigaṇaparidīpana,curadiganaparidipana,1,1,0,0,20
100647,pacuratthahitakkaraṃ,pacuratthahitakkaram,1,1,0,0,20
100648,kagaṇanāmaṃ,kagananamam,1,1,0,0,11
100649,corikāti,corikati,13,12,1,0,8
100650,dhtu,dhtu,1,1,0,0,4
100651,corī,cori,23,19,4,0,4
100652,coretu,coretu,3,3,0,0,6
100653,corayituṃ,corayitum,3,3,0,0,9
100654,coretvā,coretva,3,3,0,0,7
100655,corayitvā,corayitva,3,3,0,0,9
100656,kattutthesu,kattutthesu,1,1,0,0,11
100657,corāpeti,corapeti,3,3,0,0,8
100658,corāpayati,corapayati,3,3,0,0,10
100659,corāpetuṃ,corapetum,1,1,0,0,9
100660,corāpayituṃ,corapayitum,1,1,0,0,11
100661,corāpetvā,corapetva,1,1,0,0,9
100662,corāpayitvā,corapayitva,1,1,0,0,11
100663,kammedhanaṃ,kammedhanam,1,1,0,0,11
100664,coriyati,coriyati,1,1,0,0,8
100665,coritaṃ,coritam,2,2,0,0,7
100666,olokayati,olokayati,1,1,0,0,9
100667,ulloketi,ulloketi,7,7,0,0,8
100668,ullokayati,ullokayati,1,1,0,0,10
100669,apaloketi,apaloketi,7,7,0,0,9
100670,apalokayati,apalokayati,1,1,0,0,11
100671,ālokayati,alokayati,2,2,0,0,9
100672,viloketi,viloketi,54,50,4,0,8
100673,vilokayati,vilokayati,1,1,0,0,10
100674,lokanaṃ,lokanam,4,4,0,0,7
100675,ullokanaṃ,ullokanam,2,2,0,0,9
100676,apalokanaṃ,apalokanam,14,12,2,0,10
100677,avalokanaṃ,avalokanam,2,1,1,0,10
100678,oloketuṃ,oloketum,83,81,2,0,8
100679,olokayituṃ,olokayitum,1,1,0,0,10
100680,olokayitvā,olokayitva,1,1,0,0,10
100681,olokāpeti,olokapeti,2,2,0,0,9
100682,olokāpayati,olokapayati,1,1,0,0,11
100683,olokāpetuṃ,olokapetum,4,4,0,0,10
100684,olokāpayituṃ,olokapayitum,1,1,0,0,12
100685,olokāpetvā,olokapetva,2,2,0,0,10
100686,olokāpayitvā,olokapayitva,1,1,0,0,12
100687,rāgādikilesabahulatāya,ragadikilesabahulataya,3,3,0,0,22
100688,kāmāvacarasattā,kamavacarasatta,2,2,0,0,15
100689,jhānābhiññāparibuddhiyā,jhanabhinnaparibuddhiya,2,2,0,0,23
100690,rūpāvacarasattā,rupavacarasatta,7,7,0,0,15
100691,āneñjasamādhibahulatāya,anenjasamadhibahulataya,3,3,0,0,23
100692,visadindriyattā,visadindriyatta,2,2,0,0,15
100693,arūpāvacarasattā,arupavacarasatta,4,4,0,0,16
100694,indriyaloko,indriyaloko,6,3,3,0,11
100695,kilissanaṃ,kilissanam,5,5,0,0,10
100696,vipākadukkhanti,vipakadukkhanti,2,2,0,0,15
100697,dukkhabahulatāya,dukkhabahulataya,14,14,0,0,16
100698,sampattibhavabhāvato,sampattibhavabhavato,2,2,0,0,20
100699,vimuttiparipācakehi,vimuttiparipacakehi,2,2,0,0,19
100700,khandhaloko,khandhaloko,17,16,1,0,11
100701,āyatanaloko,ayatanaloko,17,17,0,0,11
100702,dhātulokoti,dhatulokoti,2,2,0,0,11
100703,khandhalokādayo,khandhalokadayo,3,2,1,0,15
100704,tadantogadhāyeva,tadantogadhayeva,2,2,0,0,16
100705,brahmaloko,brahmaloko,63,55,8,0,10
100706,tevattate,tevattate,1,1,0,0,9
100707,sattavisattatāya,sattavisattataya,13,13,0,0,16
100708,tasā,tasa,33,25,8,0,4
100709,okāsabhūtoti,okasabhutoti,3,3,0,0,12
100710,tadādhāraṇatāya,tadadharanataya,1,1,0,0,15
100711,duvidhopi,duvidhopi,78,71,7,0,9
100712,rūpādidhamme,rupadidhamme,12,11,1,0,12
100713,paññattattā,pannattatta,80,80,0,0,11
100714,upādāpaññattibhūto,upadapannattibhuto,1,1,0,0,18
100715,aparamatthasabhāvo,aparamatthasabhavo,2,2,0,0,18
100716,sappaccaye,sappaccaye,6,6,0,0,10
100717,rūpārūpadhamme,ruparupadhamme,33,33,0,0,14
100718,tadubhayassāpi,tadubhayassapi,8,8,0,0,14
100719,upādānānaṃ,upadananam,91,89,2,0,10
100720,paccayāyattavuttitā,paccayayattavuttita,8,8,0,0,19
100721,upacaritabbā,upacaritabba,1,1,0,0,12
100722,tadubhaye,tadubhaye,16,16,0,0,9
100723,saṅkhariyanti,sankhariyanti,1,1,0,0,13
100724,lujjanti,lujjanti,15,15,0,0,8
100725,palujjanti,palujjanti,25,22,3,0,10
100726,paccayāyattavuttitāya,paccayayattavuttitaya,17,17,0,0,21
100727,maggaphaladhammānampi,maggaphaladhammanampi,3,3,0,0,21
100728,lujjanapalujjanatte,lujjanapalujjanatte,1,1,0,0,19
100729,tebhūmikadhammānaṃyeva,tebhumikadhammanamyeva,1,1,0,0,22
100730,adhippetattā,adhippetatta,321,321,0,0,12
100731,lokatāpajjanaṃ,lokatapajjanam,1,1,0,0,14
100732,lokuttarā,lokuttara,347,324,23,0,9
100733,ālokenti,alokenti,1,1,0,0,8
100734,passesu,passesu,226,222,4,0,7
100735,apaloketvā,apaloketva,162,156,6,0,10
100736,jānāpanaṃ,janapanam,3,3,0,0,9
100737,nāgāvalokitaṃ,nagavalokitam,1,1,0,0,13
100738,avaloketvā,avaloketva,3,3,0,0,10
100739,purimakāyaṃ,purimakayam,4,4,0,0,11
100740,ālokite,alokite,39,34,5,0,7
100741,vilokite,vilokite,35,35,0,0,8
100742,ālokitaṃ,alokitam,49,40,9,0,8
100743,vilokitanti,vilokitanti,5,5,0,0,11
100744,thaketi,thaketi,3,3,0,0,7
100745,thakayati,thakayati,1,1,0,0,9
100746,vitakkayati,vitakkayati,2,2,0,0,11
100747,vitakkitā,vitakkita,3,2,1,0,9
100748,ūhananti,uhananti,20,18,2,0,8
100749,vitakkanamattameva,vitakkanamattameva,3,3,0,0,18
100750,byappanā,byappana,26,24,2,0,8
100751,abhiniropanā,abhiniropana,32,29,3,0,12
100752,pariyāyasaddā,pariyayasadda,7,7,0,0,13
100753,vitakketīti,vitakketiti,9,7,2,0,11
100754,sañjānanakāraṇanti,sanjananakarananti,2,2,0,0,18
100755,kārānubandhavasena,karanubandhavasena,1,1,0,0,18
100756,evaṃvuttehi,evamvuttehi,1,1,0,0,11
100757,pāpuṇantā,papunanta,11,11,0,0,9
100758,nipphannarūpāyeva,nipphannarupayeva,1,1,0,0,17
100759,vigataniggahītāgamarūpāni,vigataniggahitagamarupani,1,1,0,0,25
100760,aṅkayati,ankayati,1,1,0,0,8
100761,aṅkanaṃ,ankanam,3,3,0,0,7
100762,cakkaṅkitacaraṇo,cakkankitacarano,1,1,0,0,16
100763,sakketi,sakketi,1,1,0,0,7
100764,sakkayati,sakkayati,1,1,0,0,9
100765,vakketi,vakketi,2,2,0,0,7
100766,vakkayati,vakkayati,2,2,0,0,9
100767,nakketi,nakketi,1,1,0,0,7
100768,nakkayati,nakkayati,1,1,0,0,9
100769,cakka,cakka,11,6,5,0,5
100770,cukka,cukka,1,0,1,0,5
100771,cakkayati,cakkayati,1,1,0,0,9
100772,cukketi,cukketi,1,1,0,0,7
100773,cukkayati,cukkayati,1,1,0,0,9
100774,ratnadhammakhuracakkādīsu,ratnadhammakhuracakkadisu,1,1,0,0,25
100775,jātānī,jatani,30,26,4,0,6
100776,cappamādo,cappamado,1,1,0,0,9
100777,vattassu,vattassu,6,4,2,0,8
100778,pāturahosī,paturahosi,16,16,0,0,10
100779,cakkenā,cakkena,7,7,0,0,7
100780,asanimaṇḍaleti,asanimandaleti,1,1,0,0,14
100781,taṅketi,tanketi,1,1,0,0,7
100782,taṅkayati,tankayati,1,1,0,0,9
100783,akka,akka,2,1,1,0,4
100784,thavanaṃ,thavanam,4,3,1,0,8
100785,akketi,akketi,1,1,0,0,6
100786,akkayati,akkayati,1,1,0,0,8
100787,mahājutitāya,mahajutitaya,1,1,0,0,12
100788,sūriyasamā,suriyasama,8,5,3,0,10
100789,udetayaṃ,udetayam,8,6,2,0,8
100790,abhikkhuti,abhikkhuti,1,1,0,0,10
100791,hikketi,hikketi,1,1,0,0,7
100792,hikkayati,hikkayati,1,1,0,0,9
100793,nikka,nikka,1,0,1,0,5
100794,nikketi,nikketi,1,1,0,0,7
100795,nikkayati,nikkayati,1,1,0,0,9
100796,vācāsaṅkhātaṃ,vacasankhatam,2,2,0,0,13
100797,bukketi,bukketi,1,1,0,0,7
100798,bukkayati,bukkayati,2,2,0,0,9
100799,lokiyappayogo,lokiyappayogo,1,1,0,0,13
100800,paṭhantepi,pathantepi,1,1,0,0,10
100801,sunakhabhassanamevādhippetaṃ,sunakhabhassanamevadhippetam,1,1,0,0,28
100802,laka,laka,1,0,1,0,4
100803,daketi,daketi,2,1,1,0,6
100804,dakayati,dakayati,1,1,0,0,8
100805,laketi,laketi,1,1,0,0,6
100806,lakayati,lakayati,1,1,0,0,8
100807,takkayati,takkayati,3,3,0,0,9
100808,cika,cika,1,0,1,0,4
100809,sika,sika,1,0,1,0,4
100810,ciketi,ciketi,1,1,0,0,6
100811,cikayati,cikayati,1,1,0,0,8
100812,siketi,siketi,1,1,0,0,6
100813,sikayati,sikayati,1,1,0,0,8
100814,passanaṃ,passanam,6,5,1,0,8
100815,lañjanaṃ,lanjanam,1,1,0,0,8
100816,lakkhayati,lakkhayati,3,3,0,0,10
100817,sallakkheti,sallakkheti,54,53,1,0,11
100818,sallakkhayati,sallakkhayati,1,1,0,0,13
100819,usunā,usuna,32,29,3,0,5
100820,khīye,khiye,10,9,1,0,5
100821,lakkhe,lakkhe,9,7,2,0,6
100822,kappalakkhaṇaṃ,kappalakkhanam,1,1,0,0,14
100823,golakkhaṇaṃ,golakkhanam,3,3,0,0,11
100824,itthilakkhaṇaṃ,itthilakkhanam,5,5,0,0,14
100825,sallakkhanā,sallakkhana,1,1,0,0,11
100826,upalakkhanā,upalakkhana,1,1,0,0,11
100827,paccupalakkhanā,paccupalakkhana,1,1,0,0,15
100828,paccayantāya,paccayantaya,1,1,0,0,12
100829,mādipubbānaṃ,madipubbanam,1,1,0,0,12
100830,dantajo,dantajo,6,6,0,0,7
100831,bhakkhayanti,bhakkhayanti,6,5,1,0,12
100832,migādhamā,migadhama,10,10,0,0,9
100833,bhakkhatī,bhakkhati,1,1,0,0,9
100834,nakkheti,nakkheti,1,1,0,0,8
100835,nakkhayati,nakkhayati,1,1,0,0,10
100836,makkhane,makkhane,1,0,1,0,8
100837,makkheti,makkheti,37,37,0,0,8
100838,makkhayati,makkhayati,1,1,0,0,10
100839,makkhī,makkhi,52,45,7,0,6
100840,makkhoti,makkhoti,8,3,5,0,8
100841,kataguṇaṃ,katagunam,20,20,0,0,9
100842,guṇadhaṃsanā,gunadhamsana,1,1,0,0,12
100843,makkhaṃ,makkham,40,35,5,0,7
100844,asahamāno,asahamano,33,33,0,0,9
100845,avamaññanaṃ,avamannanam,2,2,0,0,11
100846,yakkheti,yakkheti,2,1,1,0,8
100847,yakkhayati,yakkhayati,1,1,0,0,10
100848,mahāyakkha,mahayakkha,3,3,0,0,10
100849,sabbabhūtānamissarā,sabbabhutanamissara,2,1,1,0,19
100850,yakkhayoniyaṃ,yakkhayoniyam,11,11,0,0,13
100851,nibbattasatto,nibbattasatto,6,6,0,0,13
100852,paramayakkhavisuddhiṃ,paramayakkhavisuddhim,1,1,0,0,21
100853,paññāpentī,pannapenti,9,8,1,0,10
100854,yakkhopi,yakkhopi,8,8,0,0,8
100855,khīṇāsavopi,khinasavopi,13,13,0,0,11
100856,yakkhoyeva,yakkhoyeva,1,1,0,0,10
100857,mahānubhāvatāya,mahanubhavataya,19,19,0,0,15
100858,yakkhiyati,yakkhiyati,1,1,0,0,10
100859,saraṇagatehi,saranagatehi,1,1,0,0,12
100860,nānāpaccayehi,nanapaccayehi,2,2,0,0,13
100861,nānābalīhi,nanabalihi,1,1,0,0,10
100862,pūjiyatīti,pujiyatiti,1,1,0,0,10
100863,pañcasvetesu,pancasvetesu,1,1,0,0,12
100864,ālocane,alocane,3,1,2,0,7
100865,phārusse,pharusse,1,0,1,0,8
100866,phārussaṃ,pharussam,1,0,1,0,9
100867,rukkheti,rukkheti,7,6,1,0,8
100868,rukkhayati,rukkhayati,1,1,0,0,10
100869,rukkhakeso,rukkhakeso,1,1,0,0,10
100870,atirukkhavacano,atirukkhavacano,1,1,0,0,15
100871,atirukkhavāco,atirukkhavaco,1,1,0,0,13
100872,atirukkhavācoti,atirukkhavacoti,1,0,1,0,15
100873,atipharusavacanoti,atipharusavacanoti,1,1,0,0,18
100874,cittīkaraṇe,cittikarane,1,0,1,0,11
100875,cittīkaraṇaṃ,cittikaranam,3,1,2,0,12
100876,vicitrabhāvakaraṇaṃ,vicitrabhavakaranam,1,1,0,0,19
100877,liṅgeti,lingeti,8,6,2,0,7
100878,liṅgayati,lingayati,1,1,0,0,9
100879,dīgharassakisathūlaparimaṇḍalādibhedaṃ,digharassakisathulaparimandaladibhedam,1,1,0,0,38
100880,saṇṭhānanti,santhananti,5,4,1,0,11
100881,liṅgīyati,lingiyati,5,5,0,0,9
100882,avijjātaṇhākammehi,avijjatanhakammehi,1,1,0,0,18
100883,utunā,utuna,24,21,3,0,5
100884,cuṇṇādīhi,cunnadihi,8,8,0,0,9
100885,sarīramiti,sariramiti,1,1,0,0,10
100886,ajjhattasantānatiṇarukkhādikuṇḍalakaraṇḍakādīsu,ajjhattasantanatinarukkhadikundalakarandakadisu,1,1,0,0,47
100887,pavattasaṇṭhānavasenetaṃ,pavattasanthanavasenetam,1,1,0,0,24
100888,saddappavattinimitte,saddappavattinimitte,2,2,0,0,20
100889,itthibyañjane,itthibyanjane,2,2,0,0,13
100890,purisabyañjane,purisabyanjane,2,2,0,0,14
100891,rukkhoti,rukkhoti,19,13,6,0,8
100892,purisaliṅganimittakuttākappānaṃ,purisalinganimittakuttakappanam,5,5,0,0,31
100893,liṅgena,lingena,44,41,3,0,7
100894,jānāma,janama,205,203,2,0,6
100895,nimittehi,nimittehi,69,69,0,0,9
100896,āgantukabhāvo,agantukabhavo,1,1,0,0,13
100897,āgantukā,agantuka,161,154,7,0,8
100898,tannimitte,tannimitte,4,4,0,0,10
100899,kāṭakoṭacikāya,katakotacikaya,4,3,1,0,14
100900,maga,maga,1,0,1,0,4
100901,mageti,mageti,1,1,0,0,6
100902,magayati,magayati,2,2,0,0,8
100903,magayamāno,magayamano,6,6,0,0,10
100904,mūsikaṃ,musikam,24,22,2,0,7
100905,migoti,migoti,16,4,12,0,6
100906,hariṇa,harina,2,2,0,0,6
100907,avasesāpi,avasesapi,13,13,0,0,9
100908,susīmajātake,susimajatake,1,0,1,0,12
100909,setadantā,setadanta,9,8,1,0,9
100910,hemajālābhisañchannā,hemajalabhisanchanna,3,3,0,0,20
100911,hatthinopi,hatthinopi,3,3,0,0,10
100912,kāḷamigā,kalamiga,2,2,0,0,8
100913,magiyati,magiyati,1,1,0,0,8
100914,jīvitakappanatthāya,jivitakappanatthaya,1,1,0,0,19
100915,maṃsādīhi,mamsadihi,3,3,0,0,9
100916,luddehi,luddehi,6,6,0,0,7
100917,anvesiyati,anvesiyati,1,1,0,0,10
100918,pariyesiyatīti,pariyesiyatiti,1,1,0,0,14
100919,araññajātā,arannajata,1,1,0,0,10
100920,sasapasadahariṇeṇeyyādayo,sasapasadaharineneyyadayo,1,1,0,0,25
100921,catuppādā,catuppada,3,3,0,0,9
100922,maggeti,maggeti,18,7,11,0,7
100923,maggayati,maggayati,1,1,0,0,9
100924,magganaṃ,magganam,1,1,0,0,8
100925,paṭipadāya,patipadaya,470,458,12,0,10
100926,pakatimaggassa,pakatimaggassa,6,6,0,0,14
100927,upāyassa,upayassa,5,5,0,0,8
100928,mahāvihāravāsīnaṃ,mahaviharavasinam,91,82,9,0,17
100929,vācanāmagganissitaṃ,vacanamagganissitam,11,10,1,0,19
100930,kathāpabandhopi,kathapabandhopi,1,1,0,0,15
100931,maggamūḷhehi,maggamulhehi,2,2,0,0,12
100932,maggitabboti,maggitabboti,4,4,0,0,12
100933,pakatimaggamūḷhehi,pakatimaggamulhehi,1,1,0,0,18
100934,paṭipadāsaṅkhātāriyamaggamūḷhā,patipadasankhatariyamaggamulha,1,1,0,0,30
100935,addhikānaṃ,addhikanam,8,8,0,0,10
100936,sabbadāyeva,sabbadayeva,1,1,0,0,11
100937,paramadullabhā,paramadullabha,9,9,0,0,14
100938,avijjāsammūḷhehi,avijjasammulhehi,1,1,0,0,16
100939,nipphādetukāmehi,nipphadetukamehi,1,1,0,0,16
100940,upāyepi,upayepi,1,1,0,0,7
100941,khandhāyatanādīnaṃ,khandhayatanadinam,8,8,0,0,18
100942,kusalādīnañca,kusaladinanca,6,6,0,0,13
100943,avabodhassa,avabodhassa,7,7,0,0,11
100944,saccappaṭivedhasseva,saccappativedhasseva,2,2,0,0,20
100945,upāyabhāvato,upayabhavato,34,34,0,0,12
100946,abhidhammakathāmaggo,abhidhammakathamaggo,4,2,2,0,20
100947,abhidhammakathāpabandho,abhidhammakathapabandho,2,2,0,0,23
100948,abhidhammakathāmaggoti,abhidhammakathamaggoti,1,1,0,0,22
100949,pakatipaṭipadāmaggānaṃ,pakatipatipadamagganam,1,1,0,0,22
100950,añjhasaṃ,anjhasam,1,1,0,0,8
100951,vaṭumā,vatuma,3,3,0,0,6
100952,yanaṃ,yanam,4,4,0,0,5
100953,addhāna,addhana,12,8,4,0,7
100954,maddhā,maddha,7,7,0,0,6
100955,santatī,santati,20,20,0,0,7
100956,paṭipadāmaggassa,patipadamaggassa,1,1,0,0,16
100957,añjasaṃ,anjasam,74,66,8,0,7
100958,nāvātiādīni,navatiadini,1,1,0,0,11
100959,vuttaṭṭhānābhāvato,vuttatthanabhavato,1,1,0,0,18
100960,abhidhānasatthesu,abhidhanasatthesu,2,2,0,0,17
100961,tadabhidhānānaṃ,tadabhidhananam,1,1,0,0,15
100962,nāvāviyāti,navaviyati,1,1,0,0,10
100963,nāvāyeva,navayeva,2,2,0,0,8
100964,nāvāpariyāyo,navapariyayo,1,1,0,0,12
100965,imepi,imepi,123,119,4,0,5
100966,taṃpariyāyāyeva,tampariyayayeva,1,1,0,0,15
100967,saṅkamanti,sankamanti,25,25,0,0,10
100968,ariyamaggasseva,ariyamaggasseva,7,7,0,0,15
100969,samārūyha,samaruyha,1,1,0,0,9
100970,santāressaṃ,santaressam,21,19,2,0,11
100971,dhammasetuṃ,dhammasetum,6,5,1,0,11
100972,ariyamaggassetaṃ,ariyamaggassetam,6,6,0,0,16
100973,susaṅkhatā,susankhata,4,4,0,0,10
100974,atthasaṃvaṇṇanā,atthasamvannana,41,36,5,0,15
100975,bhisīti,bhisiti,16,3,13,0,7
100976,kullā,kulla,1,1,0,0,5
100977,atthasaṃvaṇṇanāya,atthasamvannanaya,17,17,0,0,17
100978,nāvātiādīnipi,navatiadinipi,1,1,0,0,13
100979,yathāvuttameva,yathavuttameva,30,30,0,0,14
100980,dhammasetunti,dhammasetunti,1,1,0,0,13
100981,maggasetuṃ,maggasetum,2,2,0,0,10
100982,dhammasetūti,dhammasetuti,2,2,0,0,12
100983,brahmajālasuttantaṭṭhakathāyaṃ,brahmajalasuttantatthakathayam,1,0,1,0,30
100984,dakkhiṇuttarena,dakkhinuttarena,4,4,0,0,15
100985,assatthadumarājānaṃ,assatthadumarajanam,2,2,0,0,19
100986,pubbuttarabhāge,pubbuttarabhage,2,2,0,0,15
100987,aṭṭhakathāpadesesu,atthakathapadesesu,1,1,0,0,18
100988,maggavācakassa,maggavacakassa,2,2,0,0,14
100989,dakkhiṇadisato,dakkhinadisato,11,11,0,0,14
100990,uttaradisābhāgo,uttaradisabhago,3,3,0,0,15
100991,dakkhiṇuttaroti,dakkhinuttaroti,1,1,0,0,15
100992,evaṃbhūtena,evambhutena,7,7,0,0,11
100993,bodhimaṇḍapavisanaṃ,bodhimandapavisanam,1,1,0,0,19
100994,pavisitvāti,pavisitvati,19,8,11,0,11
100995,dakkhiṇuttarenāti,dakkhinuttarenati,3,0,3,0,17
100996,dakkhiṇapacchimuttarena,dakkhinapacchimuttarena,2,2,0,0,23
100997,ādiavasānaggahaṇena,adiavasanaggahanena,1,1,0,0,19
100998,majjhassapi,majjhassapi,1,1,0,0,11
100999,gahaṇaṃyeva,gahanamyeva,1,1,0,0,11
101000,jātakanidāne,jatakanidane,3,1,2,0,12
101001,ārūyha,aruyha,4,4,0,0,6
101002,dakkhiṇadisābhāge,dakkhinadisabhage,24,24,0,0,17
101003,uttarābhimukho,uttarabhimukho,37,36,1,0,14
101004,dakkhiṇacakkavāḷaṃ,dakkhinacakkavalam,5,5,0,0,18
101005,avīcisampattaṃ,avicisampattam,7,7,0,0,14
101006,uttaracakkavāḷaṃ,uttaracakkavalam,5,5,0,0,16
101007,ullaṅghitvā,ullanghitva,35,34,1,0,11
101008,bhavaggappattaṃ,bhavaggappattam,7,7,0,0,15
101009,sambodhipāpuṇaṭṭhānaṃ,sambodhipapunatthanam,1,1,0,0,21
101010,pacchimadisābhāgaṃ,pacchimadisabhagam,5,5,0,0,18
101011,aṭṭhāsī,atthasi,46,40,6,0,7
101012,disāvācako,disavacako,2,2,0,0,10
101013,dakkhiṇuttarenā,dakkhinuttarena,2,2,0,0,15
101014,dakkhiṇuttarāyā,dakkhinuttaraya,2,2,0,0,15
101015,disāvācakassapi,disavacakassapi,1,1,0,0,15
101016,duratikkamā,duratikkama,12,12,0,0,11
101017,disābhāgaṃ,disabhagam,26,26,0,0,10
101018,disābhāgo,disabhago,1,1,0,0,9
101019,lighi,lighi,1,0,1,0,5
101020,laṅgheti,langheti,9,9,0,0,8
101021,appasiddhānipi,appasiddhanipi,1,1,0,0,14
101022,lokikappayogadassanavasena,lokikappayogadassanavasena,1,1,0,0,26
101023,bhūvādigaṇacurādi,bhuvadiganacuradi,1,0,1,0,17
101024,gaṇapariyāpannassa,ganapariyapannassa,2,2,0,0,18
101025,gatyatthavācakaullaṅghanatthaparidīpakassa,gatyatthavacakaullanghanatthaparidipakassa,1,1,0,0,42
101026,laṅghayitvāna,langhayitvana,5,5,0,0,13
101027,pañcamiyampi,pancamiyampi,1,1,0,0,12
101028,āvuto,avuto,21,19,2,0,5
101029,sattilaṅghanajātake,sattilanghanajatake,1,0,1,0,19
101030,gatyatthavācakassa,gatyatthavacakassa,1,1,0,0,18
101031,ullaṅghanatthaparidīpakassa,ullanghanatthaparidipakassa,1,1,0,0,27
101032,laṅghayitvā,langhayitva,6,6,0,0,11
101033,laṅghayitvānā,langhayitvana,1,1,0,0,13
101034,laṅghayatī,langhayati,1,1,0,0,10
101035,bhāsatthavācakassa,bhasatthavacakassa,1,1,0,0,18
101036,tathārūpāni,tatharupani,22,19,3,0,11
101037,dīghadassīhi,dighadassihi,1,1,0,0,12
101038,abhimatattā,abhimatatta,3,3,0,0,11
101039,bhāsatthavācikāpi,bhasatthavacikapi,1,1,0,0,17
101040,appasiddhānampi,appasiddhanampi,1,1,0,0,15
101041,sāsanānukūlānaṃ,sasananukulanam,1,1,0,0,15
101042,ananukūlānañca,ananukulananca,1,1,0,0,14
101043,appasiddhānaṃ,appasiddhanam,1,1,0,0,13
101044,agha,agha,3,0,3,0,4
101045,agheti,agheti,3,1,2,0,6
101046,aghantaṃ,aghantam,1,1,0,0,8
101047,paṭisevissaṃ,patisevissam,5,5,0,0,12
101048,vāḷamigākiṇṇe,valamigakinne,33,33,0,0,13
101049,khaggadīpinisevite,khaggadipinisevite,9,9,0,0,18
101050,aghena,aghena,1,1,0,0,6
101051,dukkhahetupi,dukkhahetupi,2,2,0,0,12
101052,kilesahetupi,kilesahetupi,2,2,0,0,12
101053,attasukhassa,attasukhassa,6,6,0,0,12
101054,samācaranti,samacaranti,12,12,0,0,11
101055,phuṭṭhā,phuttha,65,60,5,0,7
101056,khalitāpi,khalitapi,4,4,0,0,9
101057,chandā,chanda,76,69,7,0,6
101058,itiādivacanañca,itiadivacananca,10,10,0,0,15
101059,dukkhādihetu,dukkhadihetu,1,1,0,0,12
101060,pāpakaraṇassa,papakaranassa,1,1,0,0,13
101061,heke,heke,45,35,10,0,4
101062,avaṇṇasaṃsaggabhayā,avannasamsaggabhaya,4,4,0,0,19
101063,puneke,puneke,8,8,0,0,6
101064,pahū,pahu,9,7,2,0,4
101065,samātaraṃ,samataram,2,2,0,0,9
101066,loceti,loceti,3,3,0,0,6
101067,locayati,locayati,4,4,0,0,8
101068,kici,kici,1,0,1,0,4
101069,kiñceti,kinceti,2,2,0,0,7
101070,kiñcayati,kincayati,1,1,0,0,9
101071,palibodho,palibodho,180,160,20,0,9
101072,kiñcana,kincana,16,11,5,0,7
101073,maddanatthe,maddanatthe,1,1,0,0,11
101074,vīhiṃ,vihim,25,25,0,0,5
101075,maddantā,maddanta,38,38,0,0,8
101076,kiñcehi,kincehi,10,10,0,0,7
101077,kāpilā,kapila,5,5,0,0,6
101078,pañceti,panceti,3,3,0,0,7
101079,papañceti,papanceti,23,22,1,0,9
101080,papañcayati,papancayati,1,1,0,0,11
101081,papañcā,papanca,51,35,16,0,7
101082,papañcāti,papancati,9,5,4,0,9
101083,taṇhāmānadiṭṭhiyo,tanhamanaditthiyo,18,15,3,0,17
101084,attanissitānaṃ,attanissitanam,4,4,0,0,14
101085,papañcenti,papancenti,37,35,2,0,10
101086,vitthinnaṃ,vitthinnam,1,1,0,0,10
101087,vitthārenti,vittharenti,12,12,0,0,11
101088,ṭhapentīti,thapentiti,31,20,11,0,10
101089,kathentānaṃ,kathentanam,67,64,3,0,11
101090,papañco,papanco,82,78,4,0,7
101091,cirabhāvaṃ,cirabhavam,1,1,0,0,10
101092,papañcoti,papancoti,8,3,5,0,9
101093,sicca,sicca,1,0,1,0,5
101094,kuḍḍane,kuddane,1,0,1,0,7
101095,sicceti,sicceti,1,1,0,0,7
101096,siccayati,siccayati,1,1,0,0,9
101097,palambhane,palambhane,2,1,1,0,10
101098,palambhanaṃ,palambhanam,1,0,1,0,11
101099,upalāpanaṃ,upalapanam,5,4,1,0,10
101100,vañcayati,vancayati,1,1,0,0,9
101101,cacceti,cacceti,1,1,0,0,7
101102,caccayati,caccayati,1,1,0,0,9
101103,cāveti,caveti,92,89,3,0,6
101104,cāvayati,cavayati,3,3,0,0,8
101105,brute,brute,1,1,0,0,5
101106,añceti,anceti,1,1,0,0,6
101107,añcayati,ancayati,1,1,0,0,8
101108,ācikkhantaṃ,acikkhantam,15,15,0,0,11
101109,raca,raca,2,1,1,0,4
101110,raceti,raceti,1,1,0,0,6
101111,racayati,racayati,1,1,0,0,8
101112,kesaracanā,kesaracana,2,2,0,0,10
101113,pisuṇabhāvo,pisunabhavo,1,1,0,0,11
101114,sūcayati,sucayati,7,7,0,0,8
101115,saṃyamane,samyamane,3,1,2,0,9
101116,paccayati,paccayati,1,1,0,0,9
101117,viyojanasampajjanesu,viyojanasampajjanesu,1,0,1,0,20
101118,receti,receti,1,1,0,0,6
101119,recayati,recayati,1,1,0,0,8
101120,seṭṭhiputtaṃ,setthiputtam,31,31,0,0,12
101121,vireceyya,vireceyya,1,1,0,0,9
101122,vireceti,vireceti,11,11,0,0,8
101123,virecayati,virecayati,1,1,0,0,10
101124,vaceti,vaceti,1,1,0,0,6
101125,vacayati,vacayati,1,1,0,0,8
101126,antevāsikaṃ,antevasikam,56,53,3,0,11
101127,vācayatī,vacayati,1,1,0,0,8
101128,acceti,acceti,21,21,0,0,6
101129,accayati,accayati,2,2,0,0,8
101130,suceti,suceti,1,1,0,0,6
101131,attatthaparatthādibhede,attatthaparatthadibhede,6,5,1,0,23
101132,kacceti,kacceti,2,2,0,0,7
101133,kaccayati,kaccayati,1,1,0,0,9
101134,kacco,kacco,5,4,1,0,5
101135,kaccoti,kaccoti,2,1,1,0,7
101136,rūpasampattiyā,rupasampattiya,32,32,0,0,14
101137,ādipuriso,adipuriso,4,4,0,0,9
101138,kātiyānā,katiyana,2,1,1,0,8
101139,kātiyānī,katiyani,7,7,0,0,8
101140,abyattāyaṃ,abyattayam,1,0,1,0,10
101141,mileccheti,mileccheti,2,2,0,0,10
101142,milecchayati,milecchayati,1,1,0,0,12
101143,milakkhūti,milakkhuti,2,0,2,0,10
101144,avakkhepe,avakkhepe,1,0,1,0,9
101145,avakkhepo,avakkhepo,1,0,1,0,9
101146,adhokhipanaṃ,adhokhipanam,1,1,0,0,12
101147,kuccheti,kuccheti,1,1,0,0,8
101148,kucchayati,kucchayati,1,1,0,0,10
101149,viccheti,viccheti,1,1,0,0,8
101150,vicchayati,vicchayati,1,1,0,0,10
101151,vajjayati,vajjayati,1,1,0,0,9
101152,parivajjanako,parivajjanako,1,1,0,0,13
101153,sīlavantehi,silavantehi,42,39,3,0,11
101154,karissasīti,karissasiti,16,12,4,0,11
101155,tujja,tujja,1,0,1,0,5
101156,tujjeti,tujjeti,1,1,0,0,7
101157,tujjayati,tujjayati,1,1,0,0,9
101158,tuñjeti,tunjeti,2,2,0,0,7
101159,tuñjayati,tunjayati,2,2,0,0,9
101160,piñjeti,pinjeti,2,2,0,0,7
101161,piñjayati,pinjayati,2,2,0,0,9
101162,khañjeti,khanjeti,1,1,0,0,8
101163,khañjayati,khanjayati,1,1,0,0,10
101164,tādisāniyeva,tadisaniyeva,1,1,0,0,12
101165,gativekalleti,gativekalleti,1,1,0,0,13
101166,pūjayati,pujayati,10,10,0,0,8
101167,pūjaneyyo,pujaneyyo,2,2,0,0,9
101168,pūjetabbo,pujetabbo,16,16,0,0,9
101169,maddanasaddesu,maddanasaddesu,1,0,1,0,14
101170,gajeti,gajeti,1,1,0,0,6
101171,gajayati,gajayati,1,1,0,0,8
101172,magganasaṅkhāresu,magganasankharesu,1,0,1,0,17
101173,vajeti,vajeti,15,7,8,0,6
101174,vajayati,vajayati,1,1,0,0,8
101175,santajjane,santajjane,2,0,2,0,10
101176,tajjayati,tajjayati,1,1,0,0,9
101177,santajjeti,santajjeti,4,4,0,0,10
101178,santajjayati,santajjayati,1,1,0,0,12
101179,santajjito,santajjito,11,11,0,0,10
101180,paṭisajjane,patisajjane,1,0,1,0,11
101181,ajjeti,ajjeti,2,2,0,0,6
101182,ajjayati,ajjayati,1,1,0,0,8
101183,sajjayati,sajjayati,1,1,0,0,9
101184,gamanasajjo,gamanasajjo,3,3,0,0,11
101185,bhajeti,bhajeti,2,1,1,0,7
101186,bhajayati,bhajayati,1,1,0,0,9
101187,bhajatī,bhajati,29,21,8,0,7
101188,luji,luji,1,0,1,0,4
101189,luñjeti,lunjeti,1,1,0,0,7
101190,luñjayati,lunjayati,1,1,0,0,9
101191,bhañjeti,bhanjeti,1,1,0,0,8
101192,bhañjayati,bhanjayati,1,1,0,0,10
101193,rojeti,rojeti,1,1,0,0,6
101194,rojayati,rojayati,1,1,0,0,8
101195,puthakammaṃ,puthakammam,1,0,1,0,11
101196,bhājeti,bhajeti,12,12,0,0,7
101197,bhājayati,bhajayati,3,3,0,0,9
101198,vibhājeti,vibhajeti,1,1,0,0,9
101199,vibhājayati,vibhajayati,1,1,0,0,11
101200,sītisevanesu,sitisevanesu,1,0,1,0,12
101201,sabhājeti,sabhajeti,1,1,0,0,9
101202,sabhājayati,sabhajayati,1,1,0,0,11
101203,lajeti,lajeti,1,1,0,0,6
101204,lajayati,lajayati,1,1,0,0,8
101205,lājā,laja,25,21,4,0,4
101206,saṃyojeti,samyojeti,7,7,0,0,9
101207,saṃyojayati,samyojayati,1,1,0,0,11
101208,soceyyālaṅkāresu,soceyyalankaresu,1,0,1,0,16
101209,majjeti,majjeti,3,2,1,0,7
101210,majjayati,majjayati,1,1,0,0,9
101211,sammajjeti,sammajjeti,1,1,0,0,10
101212,sammajjayati,sammajjayati,1,1,0,0,12
101213,sammajjā,sammajja,2,2,0,0,8
101214,bhājanadānesu,bhajanadanesu,1,0,1,0,13
101215,sañcaya,sancaya,5,5,0,0,7
101216,jhaña,jhana,2,0,2,0,5
101217,buddhavacanānukūlaṃ,buddhavacananukulam,1,1,0,0,19
101218,ghaṭṭa,ghatta,3,1,2,0,6
101219,ghaṭṭane,ghattane,11,10,1,0,8
101220,ghaṭṭayati,ghattayati,2,2,0,0,10
101221,ghaṭṭesi,ghattesi,25,25,0,0,8
101222,gaṭoti,gatoti,1,0,1,0,6
101223,pānīyaghaṭo,paniyaghato,2,2,0,0,11
101224,macchaghaṭā,macchaghata,1,1,0,0,11
101225,avasandane,avasandane,1,0,1,0,10
101226,avasandanaṃ,avasandanam,1,0,1,0,11
101227,naṭeti,nateti,1,1,0,0,6
101228,naṭayati,natayati,1,1,0,0,8
101229,kuṭṭa,kutta,1,0,1,0,5
101230,cuṭeti,cuteti,2,2,0,0,6
101231,cuṭayati,cutayati,2,2,0,0,8
101232,chuṭeti,chuteti,1,1,0,0,7
101233,chuṭayati,chutayati,1,1,0,0,9
101234,kuṭṭeti,kutteti,3,1,2,0,7
101235,kuṭṭayati,kuttayati,1,1,0,0,9
101236,puṭṭa,putta,1,0,1,0,5
101237,caṭṭa,catta,1,0,1,0,5
101238,appabhāve,appabhave,1,0,1,0,9
101239,puṭṭeti,putteti,1,1,0,0,7
101240,puṭṭayati,puttayati,1,1,0,0,9
101241,cuṭṭeti,cutteti,1,1,0,0,7
101242,cuṭṭayati,cuttayati,1,1,0,0,9
101243,moṭeti,moteti,1,1,0,0,6
101244,moṭayati,motayati,1,1,0,0,8
101245,suṭṭa,sutta,1,0,1,0,5
101246,aṭṭeti,atteti,1,1,0,0,6
101247,aṭṭayati,attayati,1,1,0,0,8
101248,suṭṭeti,sutteti,1,1,0,0,7
101249,suṭṭayati,suttayati,1,1,0,0,9
101250,khaṭṭa,khatta,1,0,1,0,6
101251,khaṭṭeti,khatteti,1,1,0,0,8
101252,khaṭṭayati,khattayati,1,1,0,0,10
101253,saṭṭa,satta,1,0,1,0,5
101254,saṭṭeti,satteti,1,1,0,0,7
101255,saṭṭayati,sattayati,1,1,0,0,9
101256,tuvaṭṭa,tuvatta,3,2,1,0,7
101257,nipajjāyaṃ,nipajjayam,2,1,1,0,10
101258,tuvaṭṭeti,tuvatteti,1,1,0,0,9
101259,tuvaṭṭayati,tuvattayati,1,1,0,0,11
101260,ekamañce,ekamance,38,35,3,0,8
101261,tuvaṭṭenti,tuvattenti,26,26,0,0,10
101262,chaṭṭa,chatta,1,0,1,0,6
101263,chaṭṭane,chattane,1,0,1,0,8
101264,chaṭṭeti,chatteti,4,4,0,0,8
101265,chaṭṭayati,chattayati,1,1,0,0,10
101266,noce,noce,4,4,0,0,4
101267,rūpiyachaṭṭako,rupiyachattako,2,2,0,0,14
101268,sammannitabbo,sammannitabbo,128,127,1,0,13
101269,poṭeti,poteti,3,3,0,0,6
101270,poṭayati,potayati,3,3,0,0,8
101271,kīṭayati,kitayati,1,1,0,0,8
101272,cuṭi,cuti,1,0,1,0,4
101273,cuṇṭeti,cunteti,1,1,0,0,7
101274,cuṇṭayati,cuntayati,1,1,0,0,9
101275,luṇṭeti,lunteti,1,1,0,0,7
101276,luṇṭayati,luntayati,1,1,0,0,9
101277,kūṭeti,kuteti,3,2,1,0,6
101278,kūṭayati,kutayati,1,1,0,0,8
101279,kūṭā,kuta,7,7,0,0,4
101280,kuṭatāpaso,kutatapaso,1,1,0,0,10
101281,vibhede,vibhede,1,0,1,0,7
101282,phoṭeti,photeti,4,4,0,0,7
101283,phoṭayati,photayati,1,1,0,0,9
101284,phoṭesuṃ,photesum,12,8,4,0,8
101285,saṅghāṭe,sanghate,4,3,1,0,8
101286,hantyatthe,hantyatthe,1,0,1,0,10
101287,ghaṭi,ghati,5,3,2,0,5
101288,pāṭeti,pateti,1,1,0,0,6
101289,loṭeti,loteti,1,1,0,0,6
101290,loṭayati,lotayati,1,1,0,0,8
101291,ghaṇṭeti,ghanteti,1,1,0,0,8
101292,ghaṇṭayati,ghantayati,1,1,0,0,10
101293,paṭeti,pateti,1,1,0,0,6
101294,paṭayati,patayati,1,1,0,0,8
101295,vaṭeti,vateti,2,2,0,0,6
101296,vaṭayati,vatayati,2,2,0,0,8
101297,kheṭeti,kheteti,1,1,0,0,7
101298,kheṭayati,khetayati,1,1,0,0,9
101299,khoṭa,khota,1,0,1,0,5
101300,khoṭeti,khoteti,1,1,0,0,7
101301,khoṭayati,khotayati,1,1,0,0,9
101302,kuṭeti,kuteti,1,1,0,0,6
101303,kuṭayati,kutayati,1,1,0,0,8
101304,yuṭa,yuta,1,0,1,0,4
101305,yoṭeti,yoteti,1,1,0,0,6
101306,yoṭayati,yotayati,1,1,0,0,8
101307,vibhajane,vibhajane,6,4,2,0,9
101308,saṭheti,satheti,3,3,0,0,7
101309,ālasiye,alasiye,3,2,1,0,7
101310,soṭheti,sotheti,1,1,0,0,7
101311,soṭhayati,sothayati,1,1,0,0,9
101312,suṇṭheti,suntheti,1,1,0,0,8
101313,suṇṭhayati,sunthayati,1,1,0,0,10
101314,asammābhāsane,asammabhasane,2,1,1,0,13
101315,saṭhayatīti,sathayatiti,1,1,0,0,11
101316,vajjamaññesaṃ,vajjamannesam,8,8,0,0,13
101317,kaliṃva,kalimva,6,5,1,0,7
101318,kitavāsaṭho,kitavasatho,1,1,0,0,11
101319,kitavā,kitava,8,7,1,0,6
101320,kaṭhi,kathi,2,1,1,0,5
101321,kaṇṭheti,kantheti,4,1,3,0,8
101322,kaṇṭhayati,kanthayati,1,1,0,0,10
101323,paṇḍeti,pandeti,1,1,0,0,7
101324,paṇḍayati,pandayati,1,1,0,0,9
101325,uppaṇḍeti,uppandeti,5,5,0,0,9
101326,uppaṇḍayati,uppandayati,1,1,0,0,11
101327,bhikkhuniṃ,bhikkhunim,517,494,23,0,10
101328,uppaṇḍiṃsu,uppandimsu,1,1,0,0,10
101329,ukkhepe,ukkhepe,2,0,2,0,7
101330,laṇḍeti,landeti,1,1,0,0,7
101331,laṇḍayati,landayati,1,1,0,0,9
101332,khaṇḍeti,khandeti,2,2,0,0,8
101333,kaṇḍeti,kandeti,1,1,0,0,7
101334,kaṇḍayati,kandayati,1,1,0,0,9
101335,piṇḍeti,pindeti,3,3,0,0,7
101336,piṇḍayati,pindayati,1,1,0,0,9
101337,piṇḍoti,pindoti,4,0,4,0,7
101338,samūhasaṅkhāto,samuhasankhato,6,6,0,0,14
101339,kalāpopi,kalapopi,1,1,0,0,8
101340,āhārasaṅkhāto,aharasankhato,1,1,0,0,13
101341,piṇḍopi,pindopi,1,1,0,0,7
101342,piṇḍoyeva,pindoyeva,1,1,0,0,9
101343,kuṇḍeti,kundeti,3,2,1,0,7
101344,kuṇḍayati,kundayati,1,1,0,0,9
101345,kalyāṇatā,kalyanata,12,12,0,0,9
101346,bhaṇḍeti,bhandeti,1,1,0,0,8
101347,bhaṇḍayati,bhandayati,1,1,0,0,10
101348,bhaṇḍoti,bhandoti,1,0,1,0,8
101349,samalaṅkaritvā,samalankaritva,7,7,0,0,14
101350,bhaṇḍenā,bhandena,1,1,0,0,8
101351,daṇḍavinipāte,dandavinipate,1,0,1,0,13
101352,daṇḍeti,dandeti,8,1,7,0,7
101353,daṇḍayati,dandayati,3,3,0,0,9
101354,chaḍḍane,chaddane,5,4,1,0,8
101355,chaḍḍayati,chaddayati,2,2,0,0,10
101356,chaḍḍanako,chaddanako,1,1,0,0,10
101357,chaḍḍiyati,chaddiyati,1,1,0,0,10
101358,chaḍḍito,chaddito,25,25,0,0,8
101359,chaḍḍituṃ,chadditum,1,1,0,0,9
101360,chaḍḍayituṃ,chaddayitum,1,1,0,0,11
101361,chaḍḍayitvā,chaddayitva,9,9,0,0,11
101362,ḍhakārantadhātu,dhakarantadhatu,1,1,0,0,15
101363,ākiraṇe,akirane,1,0,1,0,7
101364,kaṃsapātiyā,kamsapatiya,11,11,0,0,11
101365,pāyāsaṃ,payasam,130,128,2,0,7
101366,vaḍḍhayati,vaddhayati,5,5,0,0,10
101367,vitthinnatā,vitthinnata,1,1,0,0,11
101368,sīlādidhammo,siladidhammo,4,4,0,0,12
101369,vaṇṇayati,vannayati,4,4,0,0,9
101370,chavithutikulavaggakāraṇasaṇṭhānapamāṇarūpāyatanādīsu,chavithutikulavaggakaranasanthanapamanarupayatanadisu,5,5,0,0,53
101371,suvaṇṇavaṇṇosi,suvannavannosi,13,13,0,0,14
101372,chaviyaṃ,chaviyam,17,11,6,0,8
101373,saññūḷhā,sannulha,11,11,0,0,8
101374,kulavagge,kulavagge,8,8,0,0,9
101375,gandhathenoti,gandhathenoti,9,9,0,0,13
101376,hatthirājavaṇṇaṃ,hatthirajavannam,14,14,0,0,16
101377,abhinimminitvā,abhinimminitva,73,72,1,0,14
101378,rūpāyataneti,rupayataneti,1,1,0,0,12
101379,chavigatā,chavigata,5,5,0,0,9
101380,ugghosananti,ugghosananti,3,3,0,0,12
101381,vaṇṇiyati,vanniyati,4,4,0,0,9
101382,vavatthapiyatīti,vavatthapiyatiti,1,1,0,0,16
101383,kulavaggo,kulavaggo,3,3,0,0,9
101384,vibhāviyatīti,vibhaviyatiti,1,1,0,0,13
101385,dīgharassādivasena,digharassadivasena,3,3,0,0,18
101386,saṇṭhahananti,santhahananti,3,3,0,0,13
101387,aḍḍhamahantādivasena,addhamahantadivasena,1,1,0,0,20
101388,pamiyatīti,pamiyatiti,1,1,0,0,10
101389,vikāramāpajjamānaṃ,vikaramapajjamanam,3,3,0,0,18
101390,saṇṭhānajāti,santhanajati,1,1,0,0,12
101391,rūpāyatanakāraṇapamāṇaguṇapasaṃsājātarūpapuḷinakkharādīsu,rupayatanakaranapamanagunapasamsajatarupapulinakkharadisu,1,1,0,0,57
101392,sapparājavaṇṇaṃ,sapparajavannam,5,4,1,0,15
101393,brāhmaṇova,brahmanova,77,74,3,0,10
101394,rūpāyatane,rupayatane,24,23,1,0,10
101395,harāmi,harami,15,13,2,0,6
101396,bhañjāmi,bhanjami,8,7,1,0,8
101397,vaṇṇārahassa,vannarahassa,61,60,1,0,12
101398,añjanavaṇṇena,anjanavannena,6,6,0,0,13
101399,kāliṅgamhi,kalingamhi,1,1,0,0,10
101400,vanimhase,vanimhase,5,5,0,0,9
101401,jātarūpe,jatarupe,4,4,0,0,8
101402,puḷine,puline,3,3,0,0,6
101403,heme,heme,3,3,0,0,4
101404,rūpāyatanajātisu,rupayatanajatisu,1,1,0,0,16
101405,guṇakkharesu,gunakkharesu,1,1,0,0,12
101406,chavisampattigaruḷajātarūpesu,chavisampattigarulajatarupesu,1,1,0,0,29
101407,dubbaṇṇe,dubbanne,118,116,2,0,8
101408,duggate,duggate,111,111,0,0,7
101409,suvaṇṇatā,suvannata,11,9,2,0,9
101410,sussaratā,sussarata,3,3,0,0,9
101411,suvaṇṇā,suvanna,23,23,0,0,7
101412,parivārayantī,parivarayanti,2,2,0,0,13
101413,jātarūpeti,jatarupeti,1,1,0,0,10
101414,puṇeti,puneti,5,4,1,0,6
101415,puṇayati,punayati,1,1,0,0,8
101416,cuṇeti,cuneti,1,1,0,0,6
101417,cuṇayati,cunayati,1,1,0,0,8
101418,cuṇṇeti,cunneti,3,3,0,0,7
101419,cuṇṇayati,cunnayati,1,1,0,0,9
101420,saṇeti,saneti,1,1,0,0,6
101421,saṇayati,sanayati,1,1,0,0,8
101422,kuṇeti,kuneti,2,2,0,0,6
101423,kuṇayati,kunayati,2,2,0,0,8
101424,kuṇahattho,kunahattho,1,1,0,0,10
101425,tūṇeti,tuneti,1,1,0,0,6
101426,tūṇayati,tunayati,1,1,0,0,8
101427,tūṇī,tuni,2,2,0,0,4
101428,tūṇīti,tuniti,1,0,1,0,6
101429,sarakalāpo,sarakalapo,1,1,0,0,10
101430,tūṇenti,tunenti,1,1,0,0,7
101431,bhūṇa,bhuna,1,0,1,0,5
101432,bhūṇeti,bhuneti,1,1,0,0,7
101433,bhūṇayati,bhunayati,1,1,0,0,9
101434,kāṇeti,kaneti,1,1,0,0,6
101435,kāṇayati,kanayati,1,1,0,0,8
101436,parihīnakkhi,parihinakkhi,1,1,0,0,12
101437,ekakkhinā,ekakkhina,1,1,0,0,9
101438,ubhayakkhikāṇo,ubhayakkhikano,9,6,3,0,14
101439,kāṇandha,kanandha,1,0,1,0,8
101440,ekatthasannipāte,ekatthasannipate,1,1,0,0,16
101441,kāṇakacchapopamasutte,kanakacchapopamasutte,1,0,1,0,21
101442,ekakkhikāṇo,ekakkhikano,12,9,3,0,11
101443,tesamayugaḷatte,tesamayugalatte,1,1,0,0,15
101444,dvinnamākārānaṃ,dvinnamakaranam,1,1,0,0,15
101445,kosalasaṃyuttaṭṭhakathāyaṃ,kosalasamyuttatthakathayam,1,0,1,0,26
101446,ovadeyyānusāseyyā,ovadeyyanusaseyya,1,1,0,0,17
101447,ovādānusāsanānaṃ,ovadanusasananam,1,1,0,0,16
101448,savisesatā,savisesata,1,1,0,0,10
101449,avisesatā,avisesata,1,1,0,0,9
101450,gaṇeti,ganeti,28,24,4,0,6
101451,gaṇayati,ganayati,3,3,0,0,8
101452,gaṇanāti,gananati,15,4,11,0,8
101453,gaṇoti,ganoti,19,5,14,0,6
101454,samūhassa,samuhassa,9,9,0,0,9
101455,sannicayo,sannicayo,22,21,1,0,9
101456,nicayo,nicayo,15,10,5,0,6
101457,jālañca,jalanca,20,19,1,0,7
101458,samūhatthābhidhāyakāti,samuhatthabhidhayakati,1,1,0,0,22
101459,saṅghagaṇasamūhā,sanghaganasamuha,1,0,1,0,16
101460,samūhatthavācakā,samuhatthavacaka,1,1,0,0,16
101461,saṅghagaṇa,sanghagana,2,0,2,0,10
101462,saddāyeva,saddayeva,4,4,0,0,9
101463,visesakapadena,visesakapadena,1,1,0,0,14
101464,bhikkhusamūhe,bhikkhusamuhe,5,5,0,0,13
101465,aññamaññañca,annamannanca,43,41,2,0,12
101466,samānatthavisayā,samanatthavisaya,1,1,0,0,16
101467,asamānatthavisayā,asamanatthavisaya,1,1,0,0,17
101468,gaṇetabboti,ganetabboti,1,1,0,0,11
101469,kaṇṇeti,kanneti,4,1,3,0,7
101470,kaṇṇayati,kannayati,1,1,0,0,9
101471,kaṇṇayanti,kannayanti,1,1,0,0,10
101472,guṇeti,guneti,11,4,7,0,6
101473,guṇayati,gunayati,1,1,0,0,8
101474,sīlādidhammānaṃ,siladidhammanam,5,5,0,0,15
101475,taṃhetuāmantanaṃ,tamhetuamantanam,1,1,0,0,16
101476,khettasampanne,khettasampanne,1,1,0,0,14
101477,ropitaṃ,ropitam,53,51,2,0,7
101478,pavassante,pavassante,3,3,0,0,10
101479,kassakassa,kassakassa,23,23,0,0,10
101480,tuṭṭhiuppattikāraṇattā,tutthiuppattikaranatta,1,1,0,0,22
101481,hetuvasena,hetuvasena,16,16,0,0,10
101482,niccetanassapi,niccetanassapi,1,1,0,0,14
101483,āmantāpanakāraṇattā,amantapanakaranatta,1,1,0,0,19
101484,dhātusaddaṃ,dhatusaddam,1,1,0,0,11
101485,vaṇeti,vaneti,2,1,1,0,6
101486,vaṇayati,vanayati,2,2,0,0,8
101487,vaṇoti,vanoti,7,3,4,0,6
101488,vicuṇṇeti,vicunneti,1,1,0,0,9
101489,chiddāvachiddaṃ,chiddavachiddam,33,29,4,0,15
101490,paṇṇeti,panneti,6,2,4,0,7
101491,paṇṇayati,pannayati,1,1,0,0,9
101492,tālapaṇṇaṃ,talapannam,26,24,2,0,10
101493,sūpeyyapaṇṇaṃ,supeyyapannam,6,5,1,0,13
101494,haritabhāvavigatepi,haritabhavavigatepi,1,1,0,0,19
101495,vatthusmiṃ,vatthusmim,1875,1838,37,0,10
101496,paṇṇabhāvo,pannabhavo,1,1,0,0,10
101497,rūḷhito,rulhito,5,5,0,0,7
101498,paṇeti,paneti,6,6,0,0,6
101499,paṇayati,panayati,1,1,0,0,8
101500,daṇḍaṃ,dandam,313,281,32,0,6
101501,cintanā,cintana,17,16,1,0,7
101502,cintanako,cintanako,1,1,0,0,9
101503,cintāpeti,cintapeti,5,5,0,0,9
101504,cintāpayatī,cintapayati,2,2,0,0,11
101505,sabbacittasādhāraṇavasenetaṃ,sabbacittasadharanavasenetam,1,1,0,0,28
101506,vatvāpi,vatvapi,115,113,2,0,7
101507,cintanavijānanā,cintanavijanana,1,1,0,0,15
101508,nānāsabhāvā,nanasabhava,27,26,1,0,11
101509,vijānātī,vijanati,17,16,1,0,8
101510,duppaññassa,duppannassa,20,20,0,0,11
101511,cintayatopi,cintayatopi,1,1,0,0,11
101512,sukhumatthādhigamo,sukhumatthadhigamo,1,1,0,0,18
101513,saññāpaññākiccehi,sannapannakiccehi,1,1,0,0,17
101514,visiṭṭhavisayaggahaṇaṃ,visitthavisayaggahanam,1,1,0,0,22
101515,dīpetuṃ,dipetum,144,132,12,0,7
101516,sabbacittasādhāraṇattā,sabbacittasadharanatta,5,5,0,0,22
101517,vijānanatthaṃ,vijananattham,7,7,0,0,13
101518,saññāpaññākiccāvisiṭṭhavisayaggahaṇaṃ,sannapannakiccavisitthavisayaggahanam,1,1,0,0,37
101519,aññagaṇikadhātuvasenapi,annaganikadhatuvasenapi,1,1,0,0,23
101520,pakāsayāma,pakasayama,1,1,0,0,10
101521,lokiyakusalākusalamahākriyacittaṃ,lokiyakusalakusalamahakriyacittam,1,1,0,0,33
101522,javanavīthivasena,javanavithivasena,4,4,0,0,17
101523,citanti,citanti,5,5,0,0,7
101524,sippajātaṃ,sippajatam,6,6,0,0,10
101525,citteneva,citteneva,75,73,2,0,9
101526,karaṇato,karanato,49,49,0,0,8
101527,vicitteti,vicitteti,1,1,0,0,9
101528,cittakaraṇatāya,cittakaranataya,5,5,0,0,15
101529,cittatāya,cittataya,15,13,2,0,9
101530,yathānurūpato,yathanurupato,9,9,0,0,13
101531,sarāgasadosādibhedabhinnattā,saragasadosadibhedabhinnatta,1,1,0,0,28
101532,sampayuttabhūmiārammaṇahīnamajjhimapaṇītādhipatīnaṃ,sampayuttabhumiarammanahinamajjhimapanitadhipatinam,3,3,0,0,51
101533,vicittatā,vicittata,5,5,0,0,9
101534,vicittānaṃ,vicittanam,3,3,0,0,10
101535,samudāyavohārena,samudayavoharena,4,4,0,0,16
101536,avayavopi,avayavopi,2,2,0,0,9
101537,pabbatanadīsamuddādiekadesesu,pabbatanadisamuddadiekadesesu,2,2,0,0,29
101538,diṭṭhesu,ditthesu,23,23,0,0,8
101539,pabbatādayo,pabbatadayo,6,6,0,0,11
101540,kāmañcettha,kamancettha,126,126,0,0,11
101541,vuttappakārānamatthānaṃ,vuttappakaranamatthanam,1,1,0,0,23
101542,bavati,bavati,1,1,0,0,6
101543,abhisaṅkhatattā,abhisankhatatta,19,18,1,0,15
101544,parittakriyadvayaṃ,parittakriyadvayam,1,1,0,0,18
101545,antimajavanañca,antimajavananca,2,2,0,0,15
101546,labbhamānacintanavicittatādivasena,labbhamanacintanavicittatadivasena,2,2,0,0,34
101547,hasituppādo,hasituppado,11,10,1,0,11
101548,aññajavanagatikoyevāti,annajavanagatikoyevati,1,1,0,0,22
101549,mānasañca,manasanca,5,4,1,0,9
101550,nāmānetāni,namanetani,1,1,0,0,10
101551,cittakamme,cittakamme,7,7,0,0,10
101552,acchariyeti,acchariyeti,2,2,0,0,11
101553,vicittavatthābharaṇā,vicittavatthabharana,23,23,0,0,20
101554,cittarūpaṃva,cittarupamva,5,5,0,0,12
101555,sañcetane,sancetane,2,1,1,0,9
101556,ceteti,ceteti,336,324,12,0,6
101557,attabyābādhāyapi,attabyabadhayapi,50,48,2,0,16
101558,parabyābādhāyapi,parabyabadhayapi,69,69,0,0,16
101559,ubhayabyābādhāyapi,ubhayabyabadhayapi,66,66,0,0,18
101560,nisedha,nisedha,4,4,0,0,7
101561,jutindhara,jutindhara,6,6,0,0,10
101562,sañcetanā,sancetana,90,85,5,0,9
101563,cetayitaṃ,cetayitam,17,14,3,0,9
101564,cetetvā,cetetva,21,21,0,0,7
101565,cetayitvā,cetayitva,16,15,1,0,9
101566,sañcicca,sancicca,333,310,23,0,8
101567,voropeti,voropeti,74,74,0,0,8
101568,cetanāti,cetanati,36,10,26,0,8
101569,abhisandahatīti,abhisandahatiti,10,8,2,0,15
101570,sañcetanāti,sancetanati,1,0,1,0,11
101571,cetanākāro,cetanakaro,1,1,0,0,10
101572,sañciccāti,sanciccati,18,2,16,0,10
101573,cecca,cecca,16,15,1,0,5
101574,abhivitaritvāti,abhivitaritvati,6,1,5,0,15
101575,cetanāya,cetanaya,344,340,4,0,8
101576,kammañhi,kammanhi,17,16,1,0,8
101577,jinenāhacca,jinenahacca,1,1,0,0,11
101578,cetanāhaṃ,cetanaham,17,14,3,0,9
101579,nimanteti,nimanteti,65,65,0,0,9
101580,nimantayati,nimantayati,2,2,0,0,11
101581,āmanteti,amanteti,13,13,0,0,8
101582,āmantayati,amantayati,3,3,0,0,10
101583,mantayanti,mantayanti,11,11,0,0,10
101584,mantayiṃsu,mantayimsu,60,60,0,0,10
101585,rahogatā,rahogata,37,37,0,0,8
101586,nimantayittha,nimantayittha,13,13,0,0,13
101587,āmantayittha,amantayittha,5,5,0,0,12
101588,visukammaṃ,visukammam,5,5,0,0,10
101589,mahiddhikaṃ,mahiddhikam,23,21,2,0,11
101590,mantāpeti,mantapeti,1,1,0,0,9
101591,mantāpayatī,mantapayati,1,1,0,0,11
101592,mantāti,mantati,15,5,10,0,7
101593,gavesanasaññā,gavesanasanna,1,1,0,0,13
101594,mantoti,mantoti,8,4,4,0,7
101595,guttabhāsanaṃ,guttabhasanam,2,2,0,0,13
101596,upassutikāpi,upassutikapi,1,1,0,0,12
101597,khippamupeti,khippamupeti,6,6,0,0,12
101598,chaḷaṅgamanto,chalangamanto,1,1,0,0,13
101599,parivattenti,parivattenti,19,19,0,0,12
101600,brahmacintitaṃ,brahmacintitam,7,5,2,0,14
101601,byākaraṇa,byakarana,4,4,0,0,9
101602,chandovicitivasena,chandovicitivasena,1,1,0,0,18
101603,chaḷaṅgo,chalango,4,4,0,0,8
101604,vedaṅgānī,vedangani,1,1,0,0,9
101605,vedādivijjā,vedadivijja,1,1,0,0,11
101606,yanteti,yanteti,1,1,0,0,7
101607,yantayati,yantayati,1,1,0,0,9
101608,telayantaṃ,telayantam,2,2,0,0,10
101609,yathācakkaṃ,yathacakkam,1,1,0,0,11
101610,sattayati,sattayati,2,2,0,0,9
101611,āmappayoge,amappayoge,1,0,1,0,10
101612,āmappayogo,amappayogo,1,0,1,0,10
101613,ussannakriyā,ussannakriya,1,1,0,0,12
101614,santeti,santeti,58,6,52,0,7
101615,santayati,santayati,1,1,0,0,9
101616,saṃsandane,samsandane,21,20,1,0,10
101617,kitteti,kitteti,12,12,0,0,7
101618,kittayati,kittayati,1,1,0,0,9
101619,kittanā,kittana,2,2,0,0,7
101620,parikittanā,parikittana,1,1,0,0,11
101621,tanteti,tanteti,2,1,1,0,7
101622,tantayati,tantayati,1,1,0,0,9
101623,satanto,satanto,1,1,0,0,7
101624,sappadhānoti,sappadhanoti,1,1,0,0,12
101625,nikāropakāresu,nikaropakaresu,1,0,1,0,14
101626,yateti,yateti,2,2,0,0,6
101627,yatayati,yatayati,1,1,0,0,8
101628,niyyāteti,niyyateti,14,14,0,0,9
101629,niyyātayati,niyyatayati,1,1,0,0,11
101630,niyyādeti,niyyadeti,6,6,0,0,9
101631,niyyādayati,niyyadayati,1,1,0,0,11
101632,niyyādayitvāna,niyyadayitvana,4,4,0,0,14
101633,aṇaṇo,anano,18,12,6,0,5
101634,pateti,pateti,3,1,2,0,6
101635,patayati,patayati,1,1,0,0,8
101636,gatisukhasevanesu,gatisukhasevanesu,1,0,1,0,17
101637,sevananti,sevananti,2,2,0,0,9
101638,vāteti,vateti,1,1,0,0,6
101639,vātayati,vatayati,1,1,0,0,8
101640,vātapupphaṃ,vatapuppham,4,3,1,0,11
101641,anuvāto,anuvato,7,7,0,0,7
101642,keta,keta,1,0,1,0,4
101643,keteti,keteti,2,2,0,0,6
101644,santānakriyāyaṃ,santanakriyayam,1,0,1,0,15
101645,santānakriyā,santanakriya,1,0,1,0,12
101646,pabandhakriyā,pabandhakriya,1,1,0,0,13
101647,avicchedakaraṇaṃ,avicchedakaranam,1,1,0,0,16
101648,lāyitvā,layitva,33,33,0,0,7
101649,haritaṃ,haritam,43,35,8,0,7
101650,khādāti,khadati,9,8,1,0,7
101651,lapasi,lapasi,16,15,1,0,6
101652,gatasattaṃ,gatasattam,8,6,2,0,10
101653,vigatajīvitaṃ,vigatajivitam,3,3,0,0,13
101654,jiṇṇagoṇaṃ,jinnagonam,3,3,0,0,10
101655,jīvitavacanaṃ,jivitavacanam,1,1,0,0,13
101656,uñchena,unchena,53,47,6,0,7
101657,paggahena,paggahena,28,23,5,0,9
101658,yāpetuṃ,yapetum,82,75,7,0,7
101659,pattakathanaṃ,pattakathanam,1,1,0,0,13
101660,avamocane,avamocane,1,0,1,0,9
101661,sutteti,sutteti,23,7,16,0,7
101662,suttayati,suttayati,1,1,0,0,9
101663,muttayati,muttayati,2,2,0,0,9
101664,omutteti,omutteti,1,1,0,0,8
101665,omuttayati,omuttayati,1,1,0,0,10
101666,muttāpeti,muttapeti,1,1,0,0,9
101667,muttāpayatī,muttapayati,1,1,0,0,11
101668,kattara,kattara,2,0,2,0,7
101669,sethille,sethille,1,0,1,0,8
101670,kattareti,kattareti,1,1,0,0,9
101671,kattarayati,kattarayati,3,3,0,0,11
101672,kattarasuppaṃ,kattarasuppam,3,2,1,0,13
101673,kattaroti,kattaroti,1,0,1,0,9
101674,sithilabhāvena,sithilabhavena,6,6,0,0,14
101675,sithilo,sithilo,15,13,2,0,7
101676,kattaradaṇḍoti,kattaradandoti,2,0,2,0,14
101677,kattarehi,kattarehi,1,1,0,0,9
101678,jiṇṇamanussehi,jinnamanussehi,1,1,0,0,14
101679,gahetabbatāya,gahetabbataya,12,12,0,0,13
101680,kattarānaṃ,kattaranam,1,1,0,0,10
101681,jiṇṇakāle,jinnakale,21,21,0,0,9
101682,gahetabbadaṇḍo,gahetabbadando,1,1,0,0,14
101683,jiṇṇasuppaṃ,jinnasuppam,1,1,0,0,11
101684,kattarañca,kattaranca,1,1,0,0,10
101685,suppañcāti,suppancati,1,1,0,0,10
101686,kattarasuppanti,kattarasuppanti,1,1,0,0,15
101687,cittakaraṇe,cittakarane,1,0,1,0,11
101688,dassanepi,dassanepi,13,12,1,0,9
101689,cittakaraṇaṃ,cittakaranam,1,0,1,0,12
101690,vicittabhāvakaraṇaṃ,vicittabhavakaranam,1,1,0,0,19
101691,cittayati,cittayati,1,1,0,0,9
101692,parikathā,parikatha,19,6,13,0,9
101693,sākacchatīti,sakacchatiti,1,0,1,0,12
101694,tthakārassa,tthakarassa,24,24,0,0,11
101695,ṭṭhakārattaṃ,tthakarattam,1,1,0,0,12
101696,tthamabhivaṇṇenti,tthamabhivannenti,2,2,0,0,17
101697,byañjanatthapadānugaṃ,byanjanatthapadanugam,2,2,0,0,21
101698,nidānavatthusambandhaṃ,nidanavatthusambandham,2,2,0,0,22
101699,ninnānākaraṇaṃ,ninnanakaranam,73,73,0,0,14
101700,panthenti,panthenti,1,1,0,0,9
101701,kathitassa,kathitassa,11,10,1,0,10
101702,niggahītāgamavajjitāni,niggahitagamavajjitani,1,1,0,0,22
101703,puttha,puttha,1,0,1,0,6
101704,puttheti,puttheti,1,1,0,0,8
101705,putthayati,putthayati,1,1,0,0,10
101706,muttha,muttha,1,0,1,0,6
101707,muttheti,muttheti,1,1,0,0,8
101708,mutthayati,mutthayati,1,1,0,0,10
101709,vattha,vattha,9,8,1,0,6
101710,vattheti,vattheti,2,1,1,0,8
101711,vatthayati,vatthayati,1,1,0,0,10
101712,potheti,potheti,9,9,0,0,7
101713,pothayati,pothayati,2,2,0,0,9
101714,pothetvā,pothetva,135,134,1,0,8
101715,dubbalye,dubbalye,5,1,4,0,8
101716,satheti,satheti,2,2,0,0,7
101717,sathayati,sathayati,2,2,0,0,9
101718,atthayanti,atthayanti,6,6,0,0,10
101719,paccatthikā,paccatthika,75,62,13,0,11
101720,kātha,katha,1,0,1,0,5
101721,kātheti,katheti,1,1,0,0,7
101722,kāthayati,kathayati,1,1,0,0,9
101723,santha,santha,1,0,1,0,6
101724,santheti,santheti,1,1,0,0,8
101725,santhayati,santhayati,1,1,0,0,10
101726,gantheti,gantheti,8,7,1,0,8
101727,ganthayati,ganthayati,1,1,0,0,10
101728,hadeti,hadeti,1,1,0,0,6
101729,hadayati,hadayati,1,1,0,0,8
101730,ohadayati,ohadayati,1,1,0,0,9
101731,vedayamāno,vedayamano,77,77,0,0,10
101732,kudi,kudi,1,0,1,0,4
101733,anatabhāsane,anatabhasane,1,0,1,0,12
101734,kundeti,kundeti,1,1,0,0,7
101735,kundayati,kundayati,1,1,0,0,9
101736,medayati,medayati,1,1,0,0,8
101737,chādayati,chadayati,6,6,0,0,9
101738,paṭicchādayati,paticchadayati,2,2,0,0,14
101739,paṭicchādiyateti,paticchadiyateti,1,1,0,0,16
101740,āṇattiyañca,anattiyanca,4,3,1,0,11
101741,codeti,codeti,315,311,4,0,6
101742,codayati,codayati,2,2,0,0,8
101743,cuditako,cuditako,28,22,6,0,8
101744,buddhacodito,buddhacodito,3,3,0,0,12
101745,codanāti,codanati,9,3,6,0,8
101746,cālanā,calana,4,2,2,0,6
101747,cālanāti,calanati,2,0,2,0,8
101748,dosāropanāti,dosaropanati,2,2,0,0,12
101749,chaddeti,chaddeti,1,1,0,0,8
101750,chaddayati,chaddayati,1,1,0,0,10
101751,vittiyoge,vittiyoge,1,0,1,0,9
101752,madeti,madeti,1,1,0,0,6
101753,cehanākhyānanivāsesu,cehanakhyananivasesu,1,0,1,0,20
101754,cehanā,cehana,1,0,1,0,6
101755,ākhyānaṃ,akhyanam,6,5,1,0,8
101756,nivasanaṃ,nivasanam,2,2,0,0,9
101757,paṭivedeti,pativedeti,4,4,0,0,10
101758,paṭivedayati,pativedayati,3,3,0,0,12
101759,saddayati,saddayati,1,1,0,0,9
101760,visaddeti,visaddeti,1,1,0,0,9
101761,visaddayati,visaddayati,1,1,0,0,11
101762,saddāyatī,saddayati,12,12,0,0,9
101763,pabbatāyatī,pabbatayati,2,2,0,0,11
101764,nipphannaṃyevāti,nipphannamyevati,1,1,0,0,16
101765,saddiyatīti,saddiyatiti,1,1,0,0,11
101766,yathāvuccatīti,yathavuccatiti,1,1,0,0,14
101767,udīriyati,udiriyati,2,2,0,0,9
101768,abhilapiyatīti,abhilapiyatiti,1,1,0,0,14
101769,sūdeti,sudeti,3,2,1,0,6
101770,sūdayati,sudayati,1,1,0,0,8
101771,bhattakārako,bhattakarako,29,29,0,0,12
101772,sātacce,satacce,2,1,1,0,7
101773,sātaccaṃ,sataccam,18,10,8,0,8
101774,satatabhāvo,satatabhavo,6,6,0,0,11
101775,nirantarabhāvo,nirantarabhavo,2,2,0,0,14
101776,kandeti,kandeti,1,1,0,0,7
101777,ekatokaraṇaṃ,ekatokaranam,3,3,0,0,12
101778,modeti,modeti,2,2,0,0,6
101779,sattūni,sattuni,1,1,0,0,7
101780,sappinā,sappina,74,72,2,0,7
101781,nādeti,nadeti,10,6,4,0,6
101782,nādayati,nadayati,2,2,0,0,8
101783,hetukatturūpānīti,hetukatturupaniti,1,1,0,0,17
101784,sīhanādena,sihanadena,6,6,0,0,10
101785,abhinādayī,abhinadayi,1,1,0,0,10
101786,hetukatturūpasadisānampi,hetukatturupasadisanampi,1,1,0,0,24
101787,sandissanato,sandissanato,4,4,0,0,12
101788,sādeti,sadeti,3,3,0,0,6
101789,assādayati,assadayati,2,2,0,0,10
101790,devasaddo,devasaddo,14,13,1,0,9
101791,meghasaddo,meghasaddo,5,5,0,0,10
101792,gadeti,gadeti,1,1,0,0,6
101793,gadayati,gadayati,1,1,0,0,8
101794,padeti,padeti,19,5,14,0,6
101795,padayati,padayati,1,1,0,0,8
101796,pajjatī,pajjati,4,1,3,0,7
101797,chiddeti,chiddeti,2,1,1,0,8
101798,chiddayati,chiddayati,1,1,0,0,10
101799,anekasatadhā,anekasatadha,2,2,0,0,12
101800,dvedhākaraṇaṃ,dvedhakaranam,1,1,0,0,13
101801,dvidhākaraṇaṃ,dvidhakaranam,7,7,0,0,13
101802,chedanampi,chedanampi,1,1,0,0,10
101803,dvidhākaraṇaṃyeva,dvidhakaranamyeva,1,1,0,0,17
101804,aparassa,aparassa,82,80,2,0,8
101805,chinnakoṭṭhāsassa,chinnakotthasassa,1,1,0,0,17
101806,koṭṭhāsena,kotthasena,26,26,0,0,10
101807,chedayati,chedayati,3,3,0,0,9
101808,chedayi,chedayi,10,10,0,0,7
101809,mādisāti,madisati,4,1,3,0,8
101810,sandīpane,sandipane,1,0,1,0,9
101811,īdeti,ideti,1,1,0,0,5
101812,īdayati,idayati,1,1,0,0,7
101813,addeti,addeti,2,2,0,0,6
101814,addayati,addayati,1,1,0,0,8
101815,suddhakattuvaseneva,suddhakattuvaseneva,1,1,0,0,19
101816,visaṃvādeti,visamvadeti,29,26,3,0,11
101817,saccanti,saccanti,85,70,15,0,8
101818,lokassā,lokassa,101,96,5,0,7
101819,suddhakattudīpakapāḷinayā,suddhakattudipakapalinaya,1,1,0,0,25
101820,visaṃvādetīti,visamvadetiti,11,6,5,0,13
101821,vippalambheti,vippalambheti,9,8,1,0,13
101822,jappo,jappo,4,3,1,0,5
101823,vādasaṅkhātā,vadasankhata,1,1,0,0,12
101824,chadī,chadi,1,0,1,0,5
101825,īkārantoyaṃ,ikarantoyam,1,1,0,0,11
101826,saniggahītāgamānissa,saniggahitagamanissa,1,1,0,0,20
101827,ruccatīti,ruccatiti,47,29,18,0,9
101828,chādentaṃ,chadentam,11,7,4,0,9
101829,vadī,vadi,11,10,1,0,4
101830,īkāranto,ikaranto,1,1,0,0,8
101831,imassapi,imassapi,51,50,1,0,8
101832,anupasaggāni,anupasaggani,1,1,0,0,12
101833,saddasatthepi,saddasatthepi,2,2,0,0,13
101834,anupasaggavandanathutiatthaṃ,anupasaggavandanathutiattham,1,1,0,0,28
101835,abhivādeti,abhivadeti,45,43,2,0,10
101836,abhivādayati,abhivadayati,2,2,0,0,12
101837,abhivādetvā,abhivadetva,1264,1261,3,0,11
101838,sopasaggāni,sopasaggani,1,1,0,0,11
101839,abhivādetvāti,abhivadetvati,12,2,10,0,13
101840,vadāpetvā,vadapetva,13,13,0,0,9
101841,vandanto,vandanto,22,20,2,0,8
101842,vadāpeti,vadapeti,19,19,0,0,8
101843,saddasatthanayamaggahetvā,saddasatthanayamaggahetva,1,1,0,0,25
101844,abhivādanañhi,abhivadananhi,1,1,0,0,13
101845,vandanaṃyeva,vandanamyeva,1,1,0,0,12
101846,vadāpanaṃ,vadapanam,2,2,0,0,9
101847,sambandhitattā,sambandhitatta,2,2,0,0,14
101848,abhivādanasīlissā,abhivadanasilissa,1,1,0,0,17
101849,abhivādāpanasīlissā,abhivadapanasilissa,1,1,0,0,19
101850,vadāpanamadhippetaṃ,vadapanamadhippetam,1,1,0,0,19
101851,vadāpanathutīsū,vadapanathutisu,2,2,0,0,15
101852,nissandehavacanaṃ,nissandehavacanam,1,1,0,0,17
101853,abhivādanathutīsū,abhivadanathutisu,5,5,0,0,17
101854,vadāpanamanadhippetanti,vadapanamanadhippetanti,1,1,0,0,23
101855,vuddhena,vuddhena,5,5,0,0,8
101856,akathetabbato,akathetabbato,1,1,0,0,13
101857,atthappakāsanamatteyeva,atthappakasanamatteyeva,1,1,0,0,23
101858,chedāpetī,chedapeti,1,1,0,0,9
101859,sakāritāni,sakaritani,1,1,0,0,10
101860,dhātuniddeso,dhatuniddeso,4,4,0,0,12
101861,kathitotipi,kathitotipi,1,1,0,0,11
101862,abhivādetī,abhivadeti,1,1,0,0,10
101863,anupasaggāniyeva,anupasagganiyeva,1,1,0,0,16
101864,suddhakattupadāniyeva,suddhakattupadaniyeva,1,1,0,0,21
101865,abhivādayitvā,abhivadayitva,2,2,0,0,13
101866,abhivādayiṃ,abhivadayim,19,18,1,0,11
101867,vadāpanena,vadapanena,1,1,0,0,10
101868,asambandhattā,asambandhatta,2,2,0,0,13
101869,vadāpanattho,vadapanattho,5,5,0,0,12
101870,vandanattho,vandanattho,1,1,0,0,11
101871,thomanattho,thomanattho,1,1,0,0,11
101872,abhivādānathutīsū,abhivadanathutisu,1,1,0,0,17
101873,gativimuttaṃ,gativimuttam,25,12,13,0,12
101874,padānamatthaṃ,padanamattham,3,3,0,0,13
101875,ṭīkācariyenapi,tikacariyenapi,1,0,1,0,14
101876,vandanathomanatthoyeva,vandanathomanatthoyeva,1,1,0,0,22
101877,vandanathomanatthāyeva,vandanathomanatthayeva,1,1,0,0,22
101878,kāritapaccayo,karitapaccayo,3,3,0,0,13
101879,tisuddhakattupadassapi,tisuddhakattupadassapi,1,1,0,0,22
101880,hetukattupadavasena,hetukattupadavasena,1,1,0,0,19
101881,padassapi,padassapi,2,2,0,0,9
101882,kāritapaccayantaṃ,karitapaccayantam,2,2,0,0,17
101883,mantayatī,mantayati,1,1,0,0,9
101884,suddhakattupadānaṃ,suddhakattupadanam,1,1,0,0,18
101885,abhivādāpetvā,abhivadapetva,2,2,0,0,13
101886,abhivādāpayitvā,abhivadapayitva,1,1,0,0,15
101887,vidhurajātakappadesaṃ,vidhurajatakappadesam,1,0,1,0,21
101888,abhivādeyya,abhivadeyya,26,26,0,0,11
101889,abhivādāpayetha,abhivadapayetha,12,11,1,0,15
101890,hantumiccheyya,hantumiccheyya,11,11,0,0,14
101891,nupapajjatī,nupapajjati,3,3,0,0,11
101892,abhivādeyyāti,abhivadeyyati,2,0,2,0,13
101893,aṭṭakathāya,attakathaya,1,1,0,0,11
101894,iccheyya,iccheyya,63,61,2,0,8
101895,vajjhaṃ,vajjham,33,30,3,0,7
101896,vajjhena,vajjhena,2,2,0,0,8
101897,vandāhīti,vandahiti,2,1,1,0,9
101898,vandāpeyyā,vandapeyya,1,1,0,0,10
101899,khādāpentī,khadapenti,4,3,1,0,10
101900,karaṇavasena,karanavasena,67,66,1,0,12
101901,vajjhenā,vajjhena,1,1,0,0,8
101902,dvikammakattā,dvikammakatta,9,9,0,0,13
101903,sakāritapaccayassa,sakaritapaccayassa,1,1,0,0,18
101904,sakammakadhātuyāti,sakammakadhatuyati,1,1,0,0,18
101905,atitthe,atitthe,16,16,0,0,7
101906,pakkhandantī,pakkhandanti,2,2,0,0,12
101907,atthamaggahetvā,atthamaggahetva,1,1,0,0,15
101908,vohāravisaye,voharavisaye,1,1,0,0,12
101909,kosallasamannāgatattā,kosallasamannagatatta,1,1,0,0,21
101910,saṇhasukhumamatthaṃ,sanhasukhumamattham,1,1,0,0,19
101911,dhātuyevatthaṃ,dhatuyevattham,1,1,0,0,14
101912,kāritapaccayaparikappanena,karitapaccayaparikappanena,1,1,0,0,26
101913,kāritatthamādāya,karitatthamadaya,1,1,0,0,16
101914,randha,randha,3,1,2,0,6
101915,randheti,randheti,2,2,0,0,8
101916,randhayati,randhayati,1,1,0,0,10
101917,sokāya,sokaya,9,7,2,0,6
101918,randhehi,randhehi,6,6,0,0,8
101919,randhako,randhako,1,1,0,0,8
101920,sūdena,sudena,6,6,0,0,6
101921,randhiyati,randhiyati,1,1,0,0,10
101922,randhito,randhito,1,1,0,0,8
101923,randhanaṃ,randhanam,1,1,0,0,9
101924,sūdaṃ,sudam,3,3,0,0,5
101925,randhāpeti,randhapeti,1,1,0,0,10
101926,randhāpayati,randhapayati,1,1,0,0,12
101927,randhetuṃ,randhetum,1,1,0,0,9
101928,randhayituṃ,randhayitum,1,1,0,0,11
101929,randhitvā,randhitva,1,1,0,0,9
101930,randhayitvā,randhayitva,3,3,0,0,11
101931,randhiya,randhiya,1,1,0,0,8
101932,dhāveti,dhaveti,1,1,0,0,7
101933,dhāvayati,dhavayati,1,1,0,0,9
101934,sūcane,sucane,4,3,1,0,6
101935,pariplutā,paripluta,1,1,0,0,9
101936,gandhayati,gandhayati,6,6,0,0,10
101937,gandhoti,gandhoti,21,11,10,0,8
101938,paṭicchannaṃ,paticchannam,328,299,29,0,12
101939,pupphaphalādiṃ,pupphaphaladim,4,4,0,0,14
101940,upasaṃharanto,upasamharanto,22,20,2,0,13
101941,gamudhara,gamudhara,1,0,1,0,9
101942,dhātudvayavasenapi,dhatudvayavasenapi,1,1,0,0,18
101943,dhariyatīti,dhariyatiti,3,3,0,0,11
101944,sūcanatopi,sucanatopi,3,3,0,0,10
101945,uppalagandhatheno,uppalagandhatheno,1,1,0,0,17
101946,vadhayati,vadhayati,2,2,0,0,9
101947,bundheti,bundheti,1,1,0,0,8
101948,bundhayati,bundhayati,1,1,0,0,10
101949,palibundheti,palibundheti,2,2,0,0,12
101950,palibundhayati,palibundhayati,1,1,0,0,14
101951,vikāravasena,vikaravasena,4,4,0,0,12
101952,palibodhoti,palibodhoti,20,12,8,0,11
101953,āvāsapalibodhādi,avasapalibodhadi,1,1,0,0,16
101954,taṇhāmānadiṭṭhittayañca,tanhamanaditthittayanca,1,1,0,0,23
101955,chedanapūraṇesu,chedanapuranesu,1,0,1,0,15
101956,vaddheti,vaddheti,2,2,0,0,8
101957,vaddhakīti,vaddhakiti,1,0,1,0,10
101958,gahakārako,gahakarako,1,1,0,0,10
101959,gaddha,gaddha,1,0,1,0,6
101960,gaddheti,gaddheti,1,1,0,0,8
101961,gaddhayati,gaddhayati,1,1,0,0,10
101962,gaddhoti,gaddhoti,1,0,1,0,8
101963,pahaṃsane,pahamsane,1,0,1,0,9
101964,sadheti,sadheti,1,1,0,0,7
101965,sadhayati,sadhayati,1,1,0,0,9
101966,diṭṭhūpasaṃhāre,ditthupasamhare,1,0,1,0,15
101967,diṭṭhūpasaṃhāro,ditthupasamharo,1,0,1,0,15
101968,cakkhusaññitāya,cakkhusannitaya,3,3,0,0,15
101969,upasaṃhāro,upasamharo,4,4,0,0,10
101970,sasambhāracakkhuno,sasambharacakkhuno,7,7,0,0,18
101971,setamaṇḍalaparikkhittassa,setamandalaparikkhittassa,8,8,0,0,25
101972,kaṇhamaṇḍalassa,kanhamandalassa,12,12,0,0,15
101973,sarīrasaṇṭhānuppattidesabhūte,sarirasanthanuppattidesabhute,5,5,0,0,29
101974,diṭṭhimaṇḍale,ditthimandale,5,5,0,0,13
101975,ṭīkāyampi,tikayampi,5,4,1,0,9
101976,diṭṭhimaṇḍaleti,ditthimandaleti,2,1,1,0,15
101977,abhimukhaṭṭhitānaṃ,abhimukhatthitanam,1,1,0,0,18
101978,evaṃbhūtāya,evambhutaya,4,4,0,0,11
101979,upasaṃhāre,upasamhare,4,4,0,0,10
101980,andheti,andheti,2,2,0,0,7
101981,andhayati,andhayati,2,2,0,0,9
101982,andhayiṃsu,andhayimsu,1,1,0,0,10
101983,andhoti,andhoti,8,1,7,0,7
101984,cakkhūnaṃ,cakkhunam,21,21,0,0,9
101985,naṭṭhanayano,natthanayano,2,2,0,0,12
101986,desakaraṇavasena,desakaranavasena,1,1,0,0,16
101987,rūpanipphatti,rupanipphatti,1,1,0,0,13
101988,bādheti,badheti,17,16,1,0,7
101989,bādhayati,badhayati,3,3,0,0,9
101990,baddhosi,baddhosi,7,7,0,0,8
101991,mārapāsena,marapasena,7,7,0,0,10
101992,bādhetīti,badhetiti,4,3,1,0,9
101993,bādhayatīti,badhayatiti,1,0,1,0,11
101994,bādhesi,badhesi,4,4,0,0,7
101995,anicchantimicchasī,anicchantimicchasi,1,1,0,0,18
101996,bādhesīti,badhesiti,3,1,2,0,9
101997,bandhasīti,bandhasiti,2,2,0,0,10
101998,bādhayatī,badhayati,1,1,0,0,9
101999,baddhoti,baddhoti,15,7,8,0,8
102000,bādhiyate,badhiyate,1,1,0,0,9
102001,bandhiyate,bandhiyate,1,1,0,0,10
102002,pemane,pemane,2,1,1,0,6
102003,mānayati,manayati,6,6,0,0,8
102004,vimāneti,vimaneti,12,10,2,0,8
102005,vimānayati,vimanayati,1,1,0,0,10
102006,paṭimāneti,patimaneti,2,2,0,0,10
102007,paṭimānayati,patimanayati,1,1,0,0,12
102008,mānanā,manana,2,2,0,0,6
102009,sammānanā,sammanana,3,2,1,0,9
102010,vimānanā,vimanana,8,6,2,0,8
102011,vimānanaṃ,vimananam,1,1,0,0,9
102012,amānanā,amanana,6,5,1,0,7
102013,hīnasammānanā,hinasammanana,3,3,0,0,13
102014,vīmaṃsiyatīti,vimamsiyatiti,1,1,0,0,13
102015,vīmaṃsiyamāno,vimamsiyamano,2,2,0,0,13
102016,vīmaṃsanto,vimamsanto,77,75,2,0,10
102017,mānentī,manenti,1,1,0,0,7
102018,mānentīti,manentiti,5,0,5,0,9
102019,piyāyanti,piyayanti,24,24,0,0,9
102020,pūjentīti,pujentiti,11,6,5,0,9
102021,vevacanatthappakāsanavasena,vevacanatthappakasanavasena,1,1,0,0,27
102022,mānanapūjana,mananapujana,1,0,1,0,12
102023,pariyāyasaddattā,pariyayasaddatta,2,2,0,0,16
102024,vimānetīti,vimanetiti,3,0,3,0,10
102025,vimā,vima,1,0,1,0,4
102026,sobhāvisesayogato,sobhavisesayogato,1,1,0,0,17
102027,visiṭṭhamāniyatāya,visitthamaniyataya,1,1,0,0,18
102028,mānetabbanti,manetabbanti,2,2,0,0,12
102029,vasanaṭṭhānabhūtaṃ,vasanatthanabhutam,3,3,0,0,18
102030,thaddhatā,thaddhata,6,5,1,0,9
102031,thaneti,thaneti,1,1,0,0,7
102032,thanayati,thanayati,2,2,0,0,9
102033,thanayaṃ,thanayam,17,12,5,0,8
102034,satakkaku,satakkaku,3,3,0,0,9
102035,ninnañca,ninnanca,13,12,1,0,8
102036,abhivassaṃ,abhivassam,5,4,1,0,10
102037,pāvusako,pavusako,1,1,0,0,8
102038,thanayanto,thanayanto,6,5,1,0,10
102039,savijjuko,savijjuko,3,3,0,0,9
102040,ūneti,uneti,1,1,0,0,5
102041,ūnayati,unayati,1,1,0,0,7
102042,dhaneti,dhaneti,3,1,2,0,7
102043,dhanayati,dhanayati,1,1,0,0,9
102044,dhanīti,dhaniti,1,0,1,0,7
102045,saddāyitabbanti,saddayitabbanti,1,1,0,0,15
102046,icchāyampi,icchayampi,1,1,0,0,10
102047,vidhūrassa,vidhurassa,1,1,0,0,10
102048,dhaniyyatī,dhaniyyati,3,3,0,0,10
102049,dhaniyyatīti,dhaniyyatiti,2,0,2,0,12
102050,coriyaṃ,coriyam,8,7,1,0,7
102051,theneti,theneti,4,4,0,0,7
102052,thenayati,thenayati,1,1,0,0,9
102053,thenetvā,thenetva,49,46,3,0,8
102054,tāneti,taneti,1,1,0,0,6
102055,tānayati,tanayati,1,1,0,0,8
102056,savuddhikā,savuddhika,2,2,0,0,10
102057,vitthāratthavasena,vittharatthavasena,1,1,0,0,18
102058,avuddhikā,avuddhika,3,3,0,0,9
102059,ñapa,napa,3,1,2,0,4
102060,tosananisānesu,tosananisanesu,1,0,1,0,14
102061,ñāpayati,napayati,6,6,0,0,8
102062,paññāpeti,pannapeti,98,96,2,0,9
102063,paññāpayati,pannapayati,7,7,0,0,11
102064,paññāpetī,pannapeti,10,10,0,0,9
102065,paññāpetīti,pannapetiti,17,9,8,0,11
102066,katanibbacanehi,katanibbacanehi,4,4,0,0,15
102067,vākyāvayavehi,vakyavayavehi,4,4,0,0,13
102068,vitthāravasena,vittharavasena,27,27,0,0,14
102069,desitehi,desitehi,7,7,0,0,8
102070,cittaparitosanaṃ,cittaparitosanam,6,5,1,0,16
102071,buddhinisānañca,buddhinisananca,3,3,0,0,15
102072,nikkhipane,nikkhipane,8,7,1,0,10
102073,paññapetī,pannapeti,29,27,2,0,9
102074,rassattampi,rassattampi,1,1,0,0,11
102075,paññapeti,pannapeti,276,269,7,0,9
102076,paññapāpetī,pannapapeti,1,1,0,0,11
102077,paññāpayatī,pannapayati,1,1,0,0,11
102078,lapeti,lapeti,1,1,0,0,6
102079,lapayati,lapayati,1,1,0,0,8
102080,kathāsallāpo,kathasallapo,86,86,0,0,12
102081,byapa,byapa,1,0,1,0,5
102082,jhāpayati,jhapayati,2,2,0,0,9
102083,jhatto,jhatto,2,2,0,0,6
102084,jhattoti,jhattoti,1,0,1,0,8
102085,khuddāpareto,khuddapareto,1,1,0,0,12
102086,pācanagginā,pacanaggina,2,2,0,0,11
102087,jhāpitoti,jhapitoti,1,1,0,0,9
102088,nīvaraṇadhamme,nivaranadhamme,2,2,0,0,14
102089,jhāpetīti,jhapetiti,26,23,3,0,9
102090,savuddhikaṃ,savuddhikam,1,1,0,0,11
102091,jhāpāpeti,jhapapeti,1,1,0,0,9
102092,jhāpāpayati,jhapapayati,1,1,0,0,11
102093,rūpakriyā,rupakriya,1,0,1,0,9
102094,pakāsanakriyā,pakasanakriya,1,1,0,0,13
102095,rūpayatīti,rupayatiti,22,17,5,0,10
102096,vaṇṇavikāraṃ,vannavikaram,23,22,1,0,12
102097,āpajjamānaṃ,apajjamanam,30,29,1,0,11
102098,bhijjanādiatthaṃ,bhijjanadiattham,1,1,0,0,16
102099,vidhimhi,vidhimhi,13,9,4,0,8
102100,sīhaseyyaṃ,sihaseyyam,93,76,17,0,10
102101,kappayati,kappayati,4,4,0,0,9
102102,vāsamakappayi,vasamakappayi,3,3,0,0,13
102103,pakappentaṃ,pakappentam,1,1,0,0,11
102104,kappitamassu,kappitamassu,1,1,0,0,12
102105,pakappeti,pakappeti,33,32,1,0,9
102106,pakappayati,pakappayati,1,1,0,0,11
102107,saṅkappeti,sankappeti,33,33,0,0,10
102108,saṅkappayati,sankappayati,1,1,0,0,12
102109,vikappo,vikappo,69,62,7,0,7
102110,kappasamaṇo,kappasamano,1,1,0,0,11
102111,kappoti,kappoti,30,16,14,0,7
102112,paricchedavasena,paricchedavasena,24,24,0,0,16
102113,kappiyatīti,kappiyatiti,1,1,0,0,11
102114,saṅkappoti,sankappoti,17,8,9,0,10
102115,saṅkappanaṃ,sankappanam,11,10,1,0,11
102116,anekantikabhāvo,anekantikabhavo,1,1,0,0,15
102117,abhisaddahanavohārakālapaññattichedanavikappalesasamantabhāvādianekattho,abhisaddahanavoharakalapannattichedanavikappalesasamantabhavadianekattho,6,6,0,0,72
102118,okappanīyametaṃ,okappaniyametam,5,4,1,0,15
102119,abhisaddahanamattho,abhisaddahanamattho,7,7,0,0,19
102120,samaṇakappehi,samanakappehi,27,26,1,0,13
102121,niccakappaṃ,niccakappam,41,34,7,0,11
102122,viharāmī,viharami,106,104,2,0,8
102123,iccāyasmā,iccayasma,179,127,52,0,9
102124,kappitakesamassū,kappitakesamassu,22,22,0,0,16
102125,dvaṅgulakappo,dvangulakappo,18,18,0,0,13
102126,kevalakappaṃ,kevalakappam,143,117,26,0,12
102127,samantabhāvo,samantabhavo,16,16,0,0,12
102128,vitakkavidhānapaṭibhāgapaññattikālaparamāyuvohārasamantabhāvābhisaddahana,vitakkavidhanapatibhagapannattikalaparamayuvoharasamantabhavabhisaddahana,1,1,0,0,73
102129,chedana,chedana,10,10,0,0,7
102130,viniyoga,viniyoga,1,1,0,0,8
102131,vinaya,vinaya,36,33,3,0,6
102132,lesantara,lesantara,1,1,0,0,9
102133,kappataṇhādiṭṭhiasaṅkhyeyyakappamahākappādīsu,kappatanhaditthiasankhyeyyakappamahakappadisu,1,1,0,0,45
102134,nekkhammasaṅkappo,nekkhammasankappo,27,20,7,0,17
102135,abyāpādasaṅkappo,abyapadasankappo,20,17,3,0,16
102136,vikappaṃ,vikappam,113,97,16,0,8
102137,āpajjeyyā,apajjeyya,35,32,3,0,9
102138,adhikavidhānaṃ,adhikavidhanam,13,12,1,0,14
102139,sāvakena,savakena,68,64,4,0,8
102140,mantayamānā,mantayamana,18,17,1,0,11
102141,jānimhā,janimha,12,12,0,0,7
102142,paṭibhāge,patibhage,16,16,0,0,9
102143,satthusadisenāti,satthusadisenati,3,3,0,0,16
102144,ākaṅkhamāno,akankhamano,292,288,4,0,11
102145,vātiṭṭheyya,vatittheyya,1,1,0,0,11
102146,kappāvasesaṃ,kappavasesam,50,46,4,0,12
102147,āyukappo,ayukappo,16,16,0,0,8
102148,samaṇavohāre,samanavohare,2,2,0,0,12
102149,saddhāsaddahanā,saddhasaddahana,1,1,0,0,15
102150,okappanā,okappana,33,32,1,0,8
102151,abhippasādo,abhippasado,24,23,1,0,11
102152,abhisaddahane,abhisaddahane,3,3,0,0,13
102153,saddhāyanti,saddhayanti,2,2,0,0,11
102154,upakappatī,upakappati,15,15,0,0,10
102155,viniyoge,viniyoge,3,3,0,0,8
102156,kappakatena,kappakatena,9,9,0,0,11
102157,akappakataṃ,akappakatam,13,12,1,0,11
102158,saṃsibbitaṃ,samsibbitam,13,12,1,0,11
102159,vinayakriyāyaṃ,vinayakriyayam,2,2,0,0,14
102160,handāhaṃ,handaham,247,242,5,0,8
102161,lese,lese,6,6,0,0,4
102162,āpāyiko,apayiko,133,126,7,0,7
102163,kappaṭṭho,kappattho,118,111,7,0,9
102164,nirayamhi,nirayamhi,59,56,3,0,9
102165,antarakappe,antarakappe,10,10,0,0,11
102166,kappayanti,kappayanti,16,10,6,0,10
102167,purakkharonti,purakkharonti,1,1,0,0,13
102168,dhammāpi,dhammapi,54,46,8,0,8
102169,paṭicchitāse,paticchitase,7,6,1,0,12
102170,sīlavatena,silavatena,22,15,7,0,10
102171,taṇhādiṭṭhīsu,tanhaditthisu,5,5,0,0,13
102172,uddānato,uddanato,39,36,3,0,8
102173,taṇhākappo,tanhakappo,32,32,0,0,10
102174,diṭṭhikappo,ditthikappo,31,31,0,0,11
102175,anekepi,anekepi,138,130,8,0,7
102176,saṃvaṭṭakappe,samvattakappe,52,49,3,0,13
102177,vivaṭṭakappe,vivattakappe,41,41,0,0,12
102178,asaṅkhyeyyakappe,asankhyeyyakappe,6,6,0,0,16
102179,asaṅkhyeyyānī,asankhyeyyani,11,9,2,0,13
102180,abhisaddahanepi,abhisaddahanepi,1,1,0,0,15
102181,lesakepi,lesakepi,1,1,0,0,8
102182,vikappantarakappesu,vikappantarakappesu,1,1,0,0,19
102183,taṇhādiṭṭhisvasaṅkhaye,tanhaditthisvasankhaye,1,1,0,0,22
102184,kampayati,kampayati,1,1,0,0,9
102185,calanatthe,calanatthe,3,3,0,0,10
102186,pavattahetukatturūpasadisāni,pavattahetukatturupasadisani,1,1,0,0,28
102187,kampatī,kampati,15,12,3,0,7
102188,akammakasuddhakatturūpaṃ,akammakasuddhakatturupam,1,1,0,0,24
102189,kampetī,kampeti,2,2,0,0,7
102190,akammakāya,akammakaya,1,1,0,0,10
102191,sakammakarūpadassanato,sakammakarupadassanato,1,1,0,0,22
102192,khapi,khapi,1,0,1,0,5
102193,khampeti,khampeti,1,1,0,0,8
102194,khampayati,khampayati,1,1,0,0,10
102195,thūpeti,thupeti,1,1,0,0,7
102196,thūpayati,thupayati,2,2,0,0,9
102197,thūpikā,thupika,3,3,0,0,7
102198,tapeti,tapeti,4,3,1,0,6
102199,tapayati,tapayati,3,3,0,0,8
102200,pajjane,pajjane,1,0,1,0,7
102201,upayati,upayati,2,2,0,0,7
102202,capeti,capeti,1,1,0,0,6
102203,capayati,capayati,1,1,0,0,8
102204,suppa,suppa,2,1,1,0,5
102205,suppeti,suppeti,1,1,0,0,7
102206,suppayati,suppayati,1,1,0,0,9
102207,ḍapa,dapa,1,0,1,0,4
102208,ḍāpeti,dapeti,1,1,0,0,6
102209,ḍāpayati,dapayati,1,1,0,0,8
102210,ḍepeti,depeti,1,1,0,0,6
102211,ḍepayati,depayati,1,1,0,0,8
102212,avakampane,avakampane,2,0,2,0,10
102213,kapeti,kapeti,1,1,0,0,6
102214,kapayati,kapayati,1,1,0,0,8
102215,kapaṇoti,kapanoti,6,1,5,0,8
102216,karuṇāyitabbo,karunayitabbo,8,8,0,0,13
102217,kappatī,kappati,224,214,10,0,7
102218,kopeti,kopeti,75,74,1,0,6
102219,dhūpeti,dhupeti,2,2,0,0,7
102220,dhūpayati,dhupayati,1,1,0,0,9
102221,kipa,kipa,1,0,1,0,4
102222,dubballe,dubballe,1,0,1,0,8
102223,kipeti,kipeti,1,1,0,0,6
102224,kipayati,kipayati,1,1,0,0,8
102225,khepa,khepa,1,0,1,0,5
102226,khepayati,khepayati,4,4,0,0,9
102227,āpu,apu,1,0,1,0,3
102228,lambane,lambane,1,0,1,0,7
102229,āpeti,apeti,7,6,1,0,5
102230,āpayati,apayati,2,2,0,0,7
102231,tāpeti,tapeti,14,13,1,0,6
102232,tāpayati,tapayati,2,2,0,0,8
102233,tapoti,tapoti,22,5,17,0,6
102234,tāpanaṭṭhena,tapanatthena,4,4,0,0,12
102235,opathapa,opathapa,1,0,1,0,8
102236,thapane,thapane,1,0,1,0,7
102237,opeti,opeti,4,3,1,0,5
102238,opayati,opayati,1,1,0,0,7
102239,thapeti,thapeti,7,7,0,0,7
102240,thapayati,thapayati,1,1,0,0,9
102241,thapito,thapito,2,2,0,0,7
102242,thapayitvā,thapayitva,1,1,0,0,10
102243,paṭicchadaṃ,paticchadam,10,7,3,0,11
102244,vavaṭṭhapeti,vavatthapeti,1,1,0,0,12
102245,voṭṭhabbanaṃ,votthabbanam,59,51,8,0,12
102246,thapanaṃ,thapanam,2,2,0,0,8
102247,kāradvayassa,karadvayassa,4,4,0,0,12
102248,byavatthāpakacittassa,byavatthapakacittassa,1,1,0,0,21
102249,voṭṭhabbaṃ,votthabbam,12,12,0,0,10
102250,māpa,mapa,4,3,1,0,4
102251,māpane,mapane,1,0,1,0,6
102252,paṇṇasālaṃ,pannasalam,246,239,7,0,10
102253,māpeti,mapeti,14,14,0,0,6
102254,māpayati,mapayati,2,2,0,0,8
102255,pāṇamatimāpeti,panamatimapeti,1,1,0,0,14
102256,paṇṇasālā,pannasala,59,52,7,0,9
102257,yapa,yapa,2,1,1,0,4
102258,yāpane,yapane,3,2,1,0,6
102259,yāpeti,yapeti,215,208,7,0,6
102260,yāpetīti,yapetiti,34,24,10,0,8
102261,payogatte,payogatte,1,1,0,0,9
102262,kāritapadaṃ,karitapadam,1,1,0,0,11
102263,uyyāpenti,uyyapenti,3,3,0,0,9
102264,phakā,phaka,1,0,1,0,5
102265,rantādhāturūpāni,rantadhaturupani,1,1,0,0,16
102266,sambeti,sambeti,1,1,0,0,7
102267,sambayati,sambayati,1,1,0,0,9
102268,sabi,sabi,3,1,2,0,4
102269,parimaṇḍalatā,parimandalata,12,12,0,0,13
102270,kumbeti,kumbeti,1,1,0,0,7
102271,kumbayati,kumbayati,1,1,0,0,9
102272,dubi,dubi,1,0,1,0,4
102273,lumbeti,lumbeti,1,1,0,0,7
102274,lumbayati,lumbayati,1,1,0,0,9
102275,dumbeti,dumbeti,1,1,0,0,7
102276,dumbayati,dumbayati,1,1,0,0,9
102277,niketane,niketane,7,6,1,0,8
102278,pubbeti,pubbeti,119,20,99,0,7
102279,pubbayati,pubbayati,1,1,0,0,9
102280,gabbeti,gabbeti,1,1,0,0,7
102281,gabbayati,gabbayati,1,1,0,0,9
102282,gabbanaṃ,gabbanam,1,1,0,0,8
102283,gabbito,gabbito,5,5,0,0,7
102284,gabbatīti,gabbatiti,1,0,1,0,9
102285,bakārantadhāturūpāni,bakarantadhaturupani,1,1,0,0,20
102286,pabhāveti,pabhaveti,5,4,1,0,9
102287,pabhāvayati,pabhavayati,1,1,0,0,11
102288,itthambhūto,itthambhuto,10,7,3,0,11
102289,purisamanugacchanto,purisamanugacchanto,1,1,0,0,19
102290,sesakriyāpadesupi,sesakriyapadesupi,1,1,0,0,17
102291,suddhakatturūpattā,suddhakatturupatta,1,1,0,0,18
102292,itthambhūtoti,itthambhutoti,1,0,1,0,13
102293,dvigaṇikānaṃ,dviganikanam,1,1,0,0,12
102294,aṭṭhakathāṭīkānayanissitaṃ,atthakathatikanayanissitam,1,1,0,0,26
102295,cakkhubhūtoti,cakkhubhutoti,5,0,5,0,13
102296,pariṇeti,parineti,4,4,0,0,8
102297,yāthāvadassanasādhanato,yathavadassanasadhanato,2,2,0,0,23
102298,dassanakiccapariṇāyakaṭṭhena,dassanakiccaparinayakatthena,4,4,0,0,28
102299,bhūtotipi,bhutotipi,1,1,0,0,9
102300,paññācakkhumayattā,pannacakkhumayatta,6,6,0,0,18
102301,viditakaraṇaṭṭhena,viditakaranatthena,20,20,0,0,18
102302,aviparītasabhāvaṭṭhena,aviparitasabhavatthena,6,6,0,0,22
102303,pariyattidhammappavattanato,pariyattidhammappavattanato,3,3,0,0,27
102304,hadayena,hadayena,72,70,2,0,8
102305,nicchāritadhammamayoti,niccharitadhammamayoti,6,6,0,0,22
102306,bodhipakkhiyadhammehi,bodhipakkhiyadhammehi,5,5,0,0,21
102307,taduppādanattā,taduppadanatta,2,2,0,0,14
102308,suddhodanamahārājaputtaṃ,suddhodanamaharajaputtam,1,1,0,0,24
102309,buddhabhūtaṃ,buddhabhutam,17,17,0,0,12
102310,sambhāveyyāma,sambhaveyyama,4,4,0,0,13
102311,pabbajeyyāthā,pabbajeyyatha,6,6,0,0,13
102312,therā,thera,763,734,29,0,5
102313,revataṃ,revatam,42,40,2,0,7
102314,sahajātiyaṃ,sahajatiyam,5,5,0,0,11
102315,sambhāviṃsū,sambhavimsu,1,1,0,0,11
102316,devabhūto,devabhuto,37,37,0,0,9
102317,saṃsāramocakapetavatthu,samsaramocakapetavatthu,1,0,1,0,23
102318,timanussesu,timanussesu,1,1,0,0,11
102319,manussabhāvaṃ,manussabhavam,23,23,0,0,13
102320,manobhāvanīyā,manobhavaniya,9,7,2,0,13
102321,anukampati,anukampati,19,19,0,0,10
102322,manobhāvanīyāti,manobhavaniyati,2,0,2,0,15
102323,dīghāyukā,dighayuka,94,93,1,0,9
102324,bhadantā,bhadanta,48,48,0,0,8
102325,abyāpajjā,abyapajja,41,41,0,0,9
102326,anukampitabbāti,anukampitabbati,1,1,0,0,15
102327,manovaḍḍhanakāti,manovaddhanakati,1,1,0,0,16
102328,ābhaṇḍane,abhandane,1,0,1,0,9
102329,labhayati,labhayati,1,1,0,0,9
102330,jambheti,jambheti,1,1,0,0,8
102331,jambhayati,jambhayati,1,1,0,0,10
102332,lābheti,labheti,10,3,7,0,7
102333,lābhayati,labhayati,3,3,0,0,9
102334,dabhī,dabhi,1,0,1,0,5
102335,īkārantāyaṃ,ikarantayam,1,1,0,0,11
102336,dabheti,dabheti,1,1,0,0,7
102337,dabhayati,dabhayati,1,1,0,0,9
102338,dūbha,dubha,1,0,1,0,5
102339,dūbheti,dubheti,1,1,0,0,7
102340,dūbhayati,dubhayati,1,1,0,0,9
102341,vambha,vambha,1,0,1,0,6
102342,vambheti,vambheti,124,123,1,0,8
102343,vambhayati,vambhayati,1,1,0,0,10
102344,vambhanā,vambhana,8,7,1,0,8
102345,vambhenti,vambhenti,21,17,4,0,9
102346,ācameti,acameti,4,2,2,0,7
102347,ācamayati,acamayati,1,1,0,0,9
102348,ācamanakumbhī,acamanakumbhi,5,5,0,0,13
102349,ācamayitvā,acamayitva,3,3,0,0,10
102350,appasakkārapetavatthupāḷi,appasakkarapetavatthupali,1,0,1,0,25
102351,ācamayitvāti,acamayitvati,2,0,2,0,12
102352,hatthapādadhovanapubbakaṃ,hatthapadadhovanapubbakam,2,2,0,0,25
102353,vikkhāletvā,vikkhaletva,66,65,1,0,11
102354,bhūvādigaṇikatte,bhuvadiganikatte,1,1,0,0,16
102355,camatī,camati,1,1,0,0,6
102356,bhakkhanatthaṃ,bhakkhanattham,1,1,0,0,14
102357,kāmanā,kamana,1,1,0,0,6
102358,kāmayamāno,kamayamano,10,9,1,0,10
102359,kāmento,kamento,4,4,0,0,7
102360,kāmoti,kamoti,20,13,7,0,6
102361,rūpādivisayaṃ,rupadivisayam,6,6,0,0,13
102362,kāmiyatīti,kamiyatiti,2,2,0,0,10
102363,kilesakāmavatthukāmavasenetaṃ,kilesakamavatthukamavasenetam,1,1,0,0,29
102364,tebhūmakavaṭṭasaṅkhātañca,tebhumakavattasankhatanca,1,1,0,0,25
102365,accantakaṇhadhammasamaṅgitāya,accantakanhadhammasamangitaya,1,1,0,0,29
102366,papañcasamatikkantepi,papancasamatikkantepi,1,1,0,0,21
102367,buddhapaccekabuddhabuddhasāvake,buddhapaccekabuddhabuddhasavake,1,1,0,0,31
102368,ṭhapetuṃ,thapetum,354,329,25,0,8
102369,vuttañcetaṃ,vuttancetam,86,79,7,0,11
102370,vandehamassatthaṃ,vandehamassattham,1,1,0,0,17
102371,kāmoghatiṇṇena,kamoghatinnena,1,1,0,0,14
102372,dammakopi,dammakopi,1,1,0,0,9
102373,cattāriyeva,cattariyeva,10,10,0,0,11
102374,vohārasīsena,voharasisena,1,1,0,0,12
102375,icchākantīsū,icchakantisu,1,0,1,0,12
102376,khayasundarābhirūpaabbhanumodanesu,khayasundarabhirupaabbhanumodanesu,5,5,0,0,34
102377,ciranisinno,ciranisinno,23,23,0,0,11
102378,puggalānaṃ,puggalanam,760,731,29,0,10
102379,obhāsayaṃ,obhasayam,70,54,16,0,9
102380,abhirūpe,abhirupe,27,25,2,0,8
102381,abbhanumodane,abbhanumodane,19,19,0,0,13
102382,khayasmiṃ,khayasmim,22,16,6,0,9
102383,aparivesane,aparivesane,1,0,1,0,11
102384,yamayati,yamayati,1,1,0,0,8
102385,sāmeti,sameti,3,3,0,0,6
102386,sāmayati,samayati,3,3,0,0,8
102387,nisāmeti,nisameti,6,6,0,0,8
102388,nisāmayati,nisamayati,2,2,0,0,10
102389,paṭisāmeti,patisameti,30,30,0,0,10
102390,paṭisāmayati,patisamayati,1,1,0,0,12
102391,paṭisāmanaṃ,patisamanam,17,12,5,0,11
102392,yajetha,yajetha,29,27,2,0,7
102393,upayogavasena,upayogavasena,12,12,0,0,13
102394,saṃvaccharassa,samvaccharassa,6,6,0,0,14
102395,nisāmetīti,nisametiti,2,0,2,0,10
102396,nisāmehīti,nisamehiti,6,0,6,0,10
102397,vitakkehi,vitakkehi,22,22,0,0,9
102398,upadhārehīti,upadharehiti,7,7,0,0,12
102399,paṭisāmetīti,patisametiti,3,0,3,0,12
102400,guttaṭṭhāne,guttatthane,17,17,0,0,11
102401,ālocanaṃ,alocanam,8,7,1,0,8
102402,rūpaṃva,rupamva,3,3,0,0,7
102403,olokehīti,olokehiti,6,6,0,0,9
102404,upasaggayogato,upasaggayogato,1,1,0,0,14
102405,savanepi,savanepi,4,4,0,0,8
102406,kaṇhājināyāpi,kanhajinayapi,1,1,0,0,13
102407,amayati,amayati,1,1,0,0,7
102408,bilaṅkapādo,bilankapado,2,2,0,0,11
102409,andhanakho,andhanakho,7,6,1,0,10
102410,andhanakhoti,andhanakhoti,2,0,2,0,12
102411,pūtinakho,putinakho,2,2,0,0,9
102412,sarogattaṃ,sarogattam,1,1,0,0,10
102413,bhāmeti,bhameti,1,1,0,0,7
102414,bhāmayati,bhamayati,1,1,0,0,9
102415,goma,goma,1,0,1,0,4
102416,gometi,gometi,1,1,0,0,6
102417,gomayati,gomayati,1,1,0,0,8
102418,svāntane,svantane,1,0,1,0,8
102419,svāntanaṃ,svantanam,1,0,1,0,9
102420,sāmappayogo,samappayogo,1,1,0,0,11
102421,saṅgāmeti,sangameti,1,1,0,0,9
102422,saṅgāmayati,sangamayati,1,1,0,0,11
102423,saṅgāmesuṃ,sangamesum,11,10,1,0,10
102424,īsamadhivāsane,isamadhivasane,1,1,0,0,14
102425,kāmāvacaradhamme,kamavacaradhamme,18,17,1,0,16
102426,rūpārūpadhammo,ruparupadhammo,2,2,0,0,14
102427,samudāgameti,samudagameti,1,1,0,0,12
102428,samudāgamayati,samudagamayati,1,1,0,0,14
102429,dhammasavanantarāyaṃ,dhammasavanantarayam,1,1,0,0,20
102430,āgametha,agametha,37,37,0,0,8
102431,āgamethā,agametha,17,17,0,0,8
102432,samudāgamanaṃ,samudagamanam,8,6,2,0,13
102433,samudāgametīti,samudagametiti,2,1,1,0,14
102434,bhūvādigaṇe,bhuvadigane,6,5,1,0,11
102435,upasagganipātapubbakāni,upasagganipatapubbakani,1,1,0,0,23
102436,āgametī,agameti,1,1,0,0,7
102437,rādi,radi,4,1,3,0,4
102438,jigucchāyaṃ,jigucchayam,4,3,1,0,11
102439,yāveti,yaveti,1,1,0,0,6
102440,yāvayati,yavayati,1,1,0,0,8
102441,byayeti,byayeti,1,1,0,0,7
102442,byayayati,byayayati,1,1,0,0,9
102443,tādisaṃyeva,tadisamyeva,52,51,1,0,11
102444,parayati,parayati,1,1,0,0,8
102445,parentī,parenti,4,4,0,0,7
102446,parentīti,parentiti,3,0,3,0,9
102447,arahattatthāya,arahattatthaya,12,12,0,0,14
102448,gareti,gareti,1,1,0,0,6
102449,garayati,garayati,1,1,0,0,8
102450,asaṃsaye,asamsaye,7,5,2,0,8
102451,careti,careti,57,16,41,0,6
102452,carayati,carayati,1,1,0,0,8
102453,pūri,puri,8,7,1,0,4
102454,appāyane,appayane,1,0,1,0,8
102455,vareti,vareti,6,2,4,0,6
102456,varayati,varayati,2,2,0,0,8
102457,varanto,varanto,2,1,1,0,7
102458,varemi,varemi,4,4,0,0,6
102459,variyate,variyate,1,1,0,0,8
102460,varitabboti,varitabboti,1,1,0,0,11
102461,varetīti,varetiti,2,2,0,0,8
102462,patthentoti,patthentoti,4,3,1,0,11
102463,mahāmahārahaṃ,mahamaharaham,1,1,0,0,13
102464,nīvaraṇā,nivarana,324,305,19,0,8
102465,sudassanaṃ,sudassanam,44,38,6,0,10
102466,bodhivaraṃ,bodhivaram,3,3,0,0,10
102467,purāṇakaviracanāyaṃ,puranakaviracanayam,1,1,0,0,19
102468,yācāmi,yacami,96,96,0,0,6
102469,pavāretī,pavareti,32,27,5,0,8
102470,nisedhanatthe,nisedhanatthe,1,1,0,0,13
102471,akkhepe,akkhepe,2,1,1,0,7
102472,sarayati,sarayati,1,1,0,0,8
102473,sāreti,sareti,48,47,1,0,6
102474,sārayati,sarayati,4,4,0,0,8
102475,kumārayati,kumarayati,2,2,0,0,10
102476,atidaharattā,atidaharatta,4,4,0,0,12
102477,itaratrāpi,itaratrapi,5,5,0,0,10
102478,vikkanti,vikkanti,1,0,1,0,8
102479,vikkamanaṃ,vikkamanam,2,2,0,0,10
102480,sūreti,sureti,2,1,1,0,6
102481,sūrayati,surayati,1,1,0,0,8
102482,vīreti,vireti,1,1,0,0,6
102483,vīrayati,virayati,1,1,0,0,8
102484,sāsanikehi,sasanikehi,6,6,0,0,10
102485,dhātusabhāvānampi,dhatusabhavanampi,1,1,0,0,17
102486,sūravīra,suravira,1,0,1,0,8
102487,visiṭṭhauro,visitthauro,1,1,0,0,11
102488,mahāvīroti,mahaviroti,9,1,8,0,10
102489,mahāvikkanto,mahavikkanto,4,4,0,0,12
102490,kammasampatti,kammasampatti,1,0,1,0,13
102491,parisamāpanaṃ,parisamapanam,17,17,0,0,13
102492,niṭṭhāpanaṃ,nitthapanam,5,5,0,0,11
102493,tīreti,tireti,42,32,10,0,6
102494,tīrayati,tirayati,2,2,0,0,8
102495,vikkamāmi,vikkamami,3,3,0,0,9
102496,pāremi,paremi,3,3,0,0,6
102497,santīraṇaṃ,santiranam,46,39,7,0,10
102498,tīraṇapariññāti,tiranaparinnati,3,1,2,0,15
102499,pāremīti,paremiti,2,0,2,0,8
102500,sakkomīti,sakkomiti,35,27,8,0,9
102501,īreti,ireti,2,2,0,0,5
102502,jareti,jareti,1,1,0,0,6
102503,nivārayati,nivarayati,17,17,0,0,10
102504,parivārayati,parivarayati,1,1,0,0,12
102505,pavāreti,pavareti,222,219,3,0,8
102506,pavārayati,pavarayati,1,1,0,0,10
102507,pavāraṇaṃ,pavaranam,296,281,15,0,9
102508,kāmyadānaṃ,kamyadanam,1,1,0,0,10
102509,ādhārako,adharako,15,15,0,0,8
102510,anekavidhesu,anekavidhesu,3,3,0,0,12
102511,uppādito,uppadito,49,45,4,0,8
102512,sotāpannādīhi,sotapannadihi,5,5,0,0,13
102513,puthujjanehītipi,puthujjanehitipi,1,1,0,0,16
102514,catubhūmiko,catubhumiko,1,1,0,0,11
102515,sakalakkhaṇaṃ,sakalakkhanam,1,1,0,0,13
102516,kakkhaḷattādinā,kakkhalattadina,5,5,0,0,15
102517,phusanādinā,phusanadina,1,1,0,0,11
102518,santiādinā,santiadina,1,1,0,0,10
102519,sakasakabhāvena,sakasakabhavena,1,1,0,0,15
102520,sallakkhiyatītipi,sallakkhiyatitipi,1,1,0,0,17
102521,tepiṭako,tepitako,17,17,0,0,8
102522,pāḷidhammo,palidhammo,8,8,0,0,10
102523,sakatthaparatthādibhee,sakatthaparatthadibhee,1,1,0,0,22
102524,dhūdhātuvasenapi,dhudhatuvasenapi,1,1,0,0,16
102525,maggadhamme,maggadhamme,3,3,0,0,11
102526,phalanibbānapariyattidhammesu,phalanibbanapariyattidhammesu,1,1,0,0,29
102527,pariyattihetuguṇanissattanijjīvatādīsu,pariyattihetugunanissattanijjivatadisu,3,3,0,0,38
102528,pariyāpuṇāti,pariyapunati,71,68,3,0,12
102529,dhammapaṭisambhidā,dhammapatisambhida,177,161,16,0,18
102530,samavipākino,samavipakino,12,12,0,0,12
102531,dhammānupassī,dhammanupassi,243,237,6,0,13
102532,nissattanijjīvatāyaṃ,nissattanijjivatayam,4,4,0,0,20
102533,sabhāvapaññāpuññapaññattiāpattipariyattinissattanijjīvatāvikāraguṇapacca,sabhavapannapunnapannattiapattipariyattinissattanijjivatavikaragunapacca,1,1,0,0,72
102534,yapaccayuppannādīsu,yapaccayuppannadisu,1,1,0,0,19
102535,gharamesino,gharamesino,17,16,1,0,11
102536,socatī,socati,33,32,1,0,6
102537,paññattidhammā,pannattidhamma,6,6,0,0,14
102538,niruttidhammā,niruttidhamma,2,2,0,0,13
102539,adhivacanādhammā,adhivacanadhamma,1,1,0,0,16
102540,saṅghādisesā,sanghadisesa,351,344,7,0,12
102541,jātidhammā,jatidhamma,52,50,2,0,10
102542,jarādhammā,jaradhamma,33,33,0,0,10
102543,maraṇadhammā,maranadhamma,43,43,0,0,12
102544,buddhadhammānaṃ,buddhadhammanam,9,6,3,0,15
102545,ṭhitāvasā,thitavasa,1,1,0,0,9
102546,dhammaṭṭhitatā,dhammatthitata,43,33,10,0,14
102547,dhammaniyāmatā,dhammaniyamata,31,27,4,0,14
102548,paccayuppanne,paccayuppanne,11,11,0,0,13
102549,pariyattisaccasamādhipaññāpakatipuññāpattiñeyyādīsu,pariyattisaccasamadhipannapakatipunnapattineyyadisu,3,3,0,0,51
102550,pariyāpuṇātī,pariyapunati,8,7,1,0,12
102551,evaṃdhammā,evamdhamma,57,53,4,0,10
102552,jātidhammānaṃ,jatidhammanam,22,18,4,0,13
102553,dhammacāriṃ,dhammacarim,38,31,7,0,11
102554,dhammasaddappavattivisayā,dhammasaddappavattivisaya,1,1,0,0,25
102555,yuttivisayādayo,yuttivisayadayo,1,1,0,0,15
102556,manañca,mananca,80,72,8,0,7
102557,manoviññāṇaṃ,manovinnanam,310,293,17,0,12
102558,nijjīvatā,nijjivata,1,1,0,0,9
102559,pariyattipaccayesu,pariyattipaccayesu,1,1,0,0,18
102560,nissattatāya,nissattataya,1,1,0,0,12
102561,paññattiyampi,pannattiyampi,6,6,0,0,13
102562,paccayuppannakepi,paccayuppannakepi,1,1,0,0,17
102563,saccasamādhipakatiñeyyesu,saccasamadhipakatineyyesu,1,1,0,0,25
102564,yuttiyampi,yuttiyampi,1,1,0,0,10
102565,dhammasaddassa,dhammasaddassa,12,12,0,0,14
102566,pavattivisayānaṃ,pavattivisayanam,1,1,0,0,16
102567,dasadhāva,dasadhava,7,6,1,0,9
102568,ñeyyamagge,neyyamagge,1,1,0,0,10
102569,visayapuññesu,visayapunnesu,1,1,0,0,13
102570,dasasvatthesu,dasasvatthesu,1,1,0,0,13
102571,atthuddhāroti,atthuddharoti,9,6,3,0,13
102572,samānasaddavacanīyānaṃ,samanasaddavacaniyanam,4,4,0,0,22
102573,uddharaṇaṃ,uddharanam,93,79,14,0,10
102574,pālayati,palayati,6,6,0,0,8
102575,buddhapālo,buddhapalo,1,1,0,0,10
102576,ambapālī,ambapali,23,22,1,0,8
102577,pālinā,palina,4,3,1,0,6
102578,pālito,palito,23,23,0,0,6
102579,antodakaṃ,antodakam,1,1,0,0,9
102580,rakkhaṇaṭṭhena,rakkhanatthena,1,1,0,0,14
102581,taḷākassa,talakassa,43,39,4,0,9
102582,thirā,thira,44,43,1,0,5
102583,mahatīti,mahatiti,7,5,2,0,8
102584,pakaṭṭhānaṃ,pakatthanam,12,12,0,0,11
102585,ukkaṭṭhānaṃ,ukkatthanam,10,10,0,0,11
102586,sīlādiatthānaṃ,siladiatthanam,5,5,0,0,14
102587,bodhanato,bodhanato,14,14,0,0,9
102588,sabhāvaniruttibhāvato,sabhavaniruttibhavato,4,4,0,0,21
102589,bhāsitattā,bhasitatta,27,27,0,0,10
102590,vacanappabandhānaṃ,vacanappabandhanam,6,6,0,0,18
102591,āḷīti,aliti,6,5,1,0,5
102592,pāḷidhamme,palidhamme,25,25,0,0,10
102593,taḷākapāḷiyampi,talakapaliyampi,1,1,0,0,15
102594,pantiyañceva,pantiyanceva,1,1,0,0,12
102595,vijānatā,vijanata,30,28,2,0,8
102596,atthamupaparikkhantī,atthamupaparikkhanti,2,2,0,0,20
102597,pariyattidhammasaṅkhāte,pariyattidhammasankhate,1,1,0,0,23
102598,pāḷī,pali,27,24,3,0,4
102599,taḷākapāḷiyaṃ,talakapaliyam,1,1,0,0,13
102600,nisīdiṃsū,nisidimsu,5,2,3,0,9
102601,nisīdiṃsūti,nisidimsuti,10,5,5,0,11
102602,pantivācako,pantivacako,1,1,0,0,11
102603,teleti,teleti,3,2,1,0,6
102604,telayati,telayati,1,1,0,0,8
102605,tiloti,tiloti,2,1,1,0,6
102606,tilagaccho,tilagaccho,1,1,0,0,10
102607,tapphalaṃ,tapphalam,8,8,0,0,9
102608,tilānaṃ,tilanam,17,17,0,0,7
102609,sāsapatelaṃ,sasapatelam,16,16,0,0,11
102610,yujjeyyāti,yujjeyyati,28,27,1,0,10
102611,tilasinehane,tilasinehane,1,0,1,0,12
102612,sinehassa,sinehassa,14,14,0,0,9
102613,madhukatelaṃ,madhukatelam,13,13,0,0,12
102614,tilagacchatapphalavācakānaṃ,tilagacchatapphalavacakanam,1,1,0,0,27
102615,pakāsanamukhena,pakasanamukhena,1,1,0,0,15
102616,sāsapādīnaṃ,sasapadinam,7,6,1,0,11
102617,atelattaṃ,atelattam,1,1,0,0,9
102618,taddhitavidhāne,taddhitavidhane,2,2,0,0,15
102619,sinehasaṅkhātassa,sinehasankhatassa,1,1,0,0,17
102620,telassa,telassa,45,43,2,0,7
102621,jahāma,jahama,8,8,0,0,6
102622,udāharaṇappakāsane,udaharanappakasane,1,1,0,0,18
102623,tilatelaṃ,tilatelam,23,23,0,0,9
102624,visesavacanampi,visesavacanampi,1,1,0,0,15
102625,tela,tela,3,1,2,0,4
102626,tilatele,tilatele,2,2,0,0,8
102627,hariṇamigetipi,harinamigetipi,1,1,0,0,14
102628,jāleti,jaleti,9,9,0,0,6
102629,jālayati,jalayati,1,1,0,0,8
102630,jālāti,jalati,4,1,3,0,6
102631,khāleti,khaleti,1,1,0,0,7
102632,khālayati,khalayati,1,1,0,0,9
102633,pakkhāleti,pakkhaleti,3,3,0,0,10
102634,pakkhālayati,pakkhalayati,1,1,0,0,12
102635,tāleti,taleti,1,1,0,0,6
102636,tālayati,talayati,2,2,0,0,8
102637,tāloti,taloti,1,0,1,0,6
102638,tiṇarājarukkho,tinarajarukkho,1,1,0,0,14
102639,pāṇitalabhūmitalādi,panitalabhumitaladi,1,1,0,0,19
102640,vatthujātanti,vatthujatanti,1,1,0,0,13
102641,toleti,toleti,1,1,0,0,6
102642,tolayati,tolayati,1,1,0,0,8
102643,dula,dula,2,1,1,0,4
102644,ukkhepo,ukkhepo,6,5,1,0,7
102645,doleti,doleti,1,1,0,0,6
102646,dolayati,dolayati,1,1,0,0,8
102647,doliyati,doliyati,1,1,0,0,8
102648,ukkhipiyati,ukkhipiyati,4,4,0,0,11
102649,yathānipannako,yathanipannako,1,1,0,0,14
102650,vula,vula,1,0,1,0,4
102651,nimmajjane,nimmajjane,1,0,1,0,10
102652,voleti,voleti,1,1,0,0,6
102653,voyalati,voyalati,1,1,0,0,8
102654,mīleti,mileti,1,1,0,0,6
102655,mīlayati,milayati,1,1,0,0,8
102656,mīlanaṃ,milanam,1,1,0,0,7
102657,ummīlanaṃ,ummilanam,2,2,0,0,9
102658,rohane,rohane,3,2,1,0,6
102659,mūleti,muleti,33,7,26,0,6
102660,mūlayati,mulayati,7,7,0,0,8
102661,mūlatī,mulati,1,1,0,0,6
102662,rukkhādi,rukkhadi,1,1,0,0,8
102663,acchinnena,acchinnena,3,3,0,0,10
102664,rūhatīti,ruhatiti,17,6,11,0,8
102665,anupaddave,anupaddave,10,10,0,0,10
102666,taṇhānusaye,tanhanusaye,10,10,0,0,11
102667,anūhate,anuhate,21,19,2,0,7
102668,dukkhamidaṃ,dukkhamidam,47,39,8,0,11
102669,kālayati,kalayati,5,5,0,0,8
102670,pileti,pileti,1,1,0,0,6
102671,pilayati,pilayati,1,1,0,0,8
102672,maccupi,maccupi,3,3,0,0,7
102673,sabhūtapacaniṃpacī,sabhutapacanimpaci,1,1,0,0,18
102674,samucchedavasena,samucchedavasena,155,153,2,0,16
102675,nāsitoti,nasitoti,3,2,1,0,8
102676,kālakato,kalakato,88,86,2,0,8
102677,maraṇassābhidhānāni,maranassabhidhanani,1,1,0,0,19
102678,sulla,sulla,2,1,1,0,5
102679,sulleti,sulleti,1,1,0,0,7
102680,sullayati,sullayati,1,1,0,0,9
102681,ileti,ileti,1,1,0,0,5
102682,ilayati,ilayati,1,1,0,0,7
102683,vāleti,valeti,1,1,0,0,6
102684,vālayati,valayati,1,1,0,0,8
102685,laleti,laleti,1,1,0,0,6
102686,dāleti,daleti,2,2,0,0,6
102687,padālayati,padalayati,1,1,0,0,10
102688,kālayitabbā,kalayitabba,1,1,0,0,11
102689,saṅkhāyitabbāti,sankhayitabbati,1,1,0,0,15
102690,patiṭṭhāvasena,patitthavasena,11,10,1,0,14
102691,ādhārabhāvo,adharabhavo,12,12,0,0,11
102692,uppattinivāraṇavasena,uppattinivaranavasena,1,1,0,0,21
102693,vāsīliyati,vasiliyati,1,1,0,0,10
102694,upacāriyati,upacariyati,1,1,0,0,11
102695,dhāriyatīti,dhariyatiti,1,1,0,0,11
102696,avippakiṇṇatāsaṅkhātaṃ,avippakinnatasankhatam,1,1,0,0,22
102697,ādhārabhāvasaṅkhātaṃ,adharabhavasankhatam,1,1,0,0,20
102698,kālopadese,kalopadese,1,0,1,0,10
102699,veleti,veleti,1,1,0,0,6
102700,velayati,velayati,3,3,0,0,8
102701,velayatī,velayati,1,1,0,0,8
102702,paribrūhanaṃ,paribruhanam,5,4,1,0,12
102703,thūleti,thuleti,1,1,0,0,7
102704,thūlayati,thulayati,1,1,0,0,9
102705,paleti,paleti,63,54,9,0,6
102706,palayati,palayati,2,2,0,0,8
102707,rasamādāya,rasamadaya,5,5,0,0,10
102708,suttaguḷaṃ,suttagulam,13,13,0,0,10
102709,yattakehi,yattakehi,24,22,2,0,9
102710,suttehi,suttehi,84,83,1,0,7
102711,veṭhitaṃ,vethitam,11,11,0,0,8
102712,tattakehi,tattakehi,12,12,0,0,9
102713,ciṅgula,cingula,1,0,1,0,7
102714,paribbhamane,paribbhamane,1,0,1,0,12
102715,ciṅguleti,cinguleti,1,1,0,0,9
102716,ciṅgulayati,cingulayati,1,1,0,0,11
102717,ciṅgulayitvā,cingulayitva,2,2,0,0,12
102718,yāvatikā,yavatika,168,150,18,0,8
102719,abhisaṅkhārassa,abhisankharassa,18,15,3,0,15
102720,tāvatikaṃ,tavatikam,11,11,0,0,9
102721,papatī,papati,1,1,0,0,6
102722,ciṅgulayitvāti,cingulayitvati,1,0,1,0,14
102723,paribbhamitvā,paribbhamitva,12,12,0,0,13
102724,parikūjane,parikujane,1,0,1,0,10
102725,parikūjanaṃ,parikujanam,1,0,1,0,11
102726,devayati,devayati,4,4,0,0,8
102727,paridevitvā,paridevitva,64,64,0,0,11
102728,gandhapisananti,gandhapisananti,1,1,0,0,15
102729,civa,civa,1,0,1,0,4
102730,civeti,civeti,1,1,0,0,6
102731,civayati,civayati,1,1,0,0,8
102732,posayati,posayati,3,3,0,0,8
102733,gaṇikarūpassa,ganikarupassa,1,1,0,0,13
102734,kāritaṭṭhāne,karitatthane,1,1,0,0,12
102735,posāpeti,posapeti,1,1,0,0,8
102736,posāpayatī,posapayati,1,1,0,0,10
102737,paṭiharaṇe,patiharane,1,0,1,0,10
102738,peseti,peseti,75,74,1,0,6
102739,pesayati,pesayati,2,2,0,0,8
102740,balapāṇanesu,balapananesu,1,0,1,0,12
102741,piseti,piseti,1,1,0,0,6
102742,pisayati,pisayati,2,2,0,0,8
102743,pasi,pasi,1,0,1,0,4
102744,paṃseti,pamseti,1,1,0,0,7
102745,paṃsayati,pamsayati,1,1,0,0,9
102746,jaṃseti,jamseti,1,1,0,0,7
102747,jaṃsayati,jamsayati,1,1,0,0,9
102748,silesa,silesa,5,4,1,0,6
102749,sileseti,sileseti,1,1,0,0,8
102750,silesayati,silesayati,1,1,0,0,10
102751,lūsa,lusa,1,0,1,0,4
102752,lūseti,luseti,1,1,0,0,6
102753,lūsayati,lusayati,1,1,0,0,8
102754,punsa,punsa,1,0,1,0,5
102755,abhimaddane,abhimaddane,1,0,1,0,11
102756,niggahītatthaṃ,niggahitattham,1,1,0,0,14
102757,puṃseti,pumseti,2,2,0,0,7
102758,puṃsayati,pumsayati,1,1,0,0,9
102759,puṃsakoti,pumsakoti,1,0,1,0,9
102760,itthibhāvapumbhāvarahito,itthibhavapumbhavarahito,1,1,0,0,24
102761,abhimaddanaṃ,abhimaddanam,3,3,0,0,12
102762,napuṃsakoti,napumsakoti,3,1,2,0,11
102763,dhūseti,dhuseti,1,1,0,0,7
102764,dhūsayati,dhusayati,1,1,0,0,9
102765,kopakaraṇaṃ,kopakaranam,6,6,0,0,11
102766,rosayati,rosayati,1,1,0,0,8
102767,rosoti,rosoti,1,0,1,0,6
102768,byusa,byusa,1,0,1,0,5
102769,byoseti,byoseti,1,1,0,0,7
102770,byosayati,byosayati,1,1,0,0,9
102771,jāseti,jaseti,2,2,0,0,6
102772,jāsayati,jasayati,2,2,0,0,8
102773,daṃseti,damseti,3,3,0,0,7
102774,daṃsayati,damsayati,3,3,0,0,9
102775,daṃsanoti,damsanoti,1,0,1,0,9
102776,daṃsanti,damsanti,1,1,0,0,8
102777,dasi,dasi,3,1,2,0,4
102778,vidaṃsayati,vidamsayati,1,1,0,0,11
102779,tasseti,tasseti,4,4,0,0,7
102780,tassayati,tassayati,1,1,0,0,9
102781,sattibandhane,sattibandhane,1,0,1,0,13
102782,sattibandhanaṃ,sattibandhanam,1,0,1,0,14
102783,samatthatākaraṇaṃ,samatthatakaranam,1,1,0,0,17
102784,vasseti,vasseti,10,4,6,0,7
102785,vassayati,vassayati,1,1,0,0,9
102786,tāḷanaṃ,talanam,5,3,2,0,7
102787,pāsayati,pasayati,1,1,0,0,8
102788,pāsanti,pasanti,2,2,0,0,7
102789,sakuṇapāsādi,sakunapasadi,1,1,0,0,12
102790,ghusi,ghusi,1,0,1,0,5
102791,visaddane,visaddane,1,0,1,0,9
102792,visaddanaṃ,visaddanam,1,0,1,0,10
102793,ugghosanaṃ,ugghosanam,6,6,0,0,10
102794,ghoseti,ghoseti,10,10,0,0,7
102795,silyayoge,silyayoge,1,0,1,0,9
102796,silyayogo,silyayogo,1,0,1,0,9
102797,lāsiyaṃ,lasiyam,1,1,0,0,7
102798,nāṭakanāṭanaṃ,natakanatanam,1,1,0,0,13
102799,recakadānaṃ,recakadanam,1,1,0,0,11
102800,lāseti,laseti,1,1,0,0,6
102801,lāsayati,lasayati,1,1,0,0,8
102802,lāsento,lasento,1,1,0,0,7
102803,lāsentī,lasenti,1,1,0,0,7
102804,vādentiyāpi,vadentiyapi,17,17,0,0,11
102805,lāsenti,lasenti,14,14,0,0,7
102806,naccantiyāpi,naccantiyapi,27,25,2,0,12
102807,lāsentiyāpi,lasentiyapi,25,25,0,0,11
102808,naccantī,naccanti,8,8,0,0,8
102809,lāsentīti,lasentiti,2,0,2,0,9
102810,uplavamānā,uplavamana,1,1,0,0,10
102811,lāsiyanāṭakaṃ,lasiyanatakam,3,2,1,0,13
102812,nāṭenti,natenti,4,4,0,0,7
102813,recakaṃ,recakam,6,3,3,0,7
102814,bhūseti,bhuseti,1,1,0,0,7
102815,bhūsayati,bhusayati,2,2,0,0,9
102816,vibhūseti,vibhuseti,6,4,2,0,9
102817,vibhūsayati,vibhusayati,1,1,0,0,11
102818,sinehanachedāvaharaṇesu,sinehanachedavaharanesu,1,0,1,0,23
102819,avaharaṇaṃ,avaharanam,33,32,1,0,10
102820,corikāya,corikaya,41,40,1,0,8
102821,vāsayati,vasayati,7,7,0,0,8
102822,nivāraṇaṃ,nivaranam,93,77,16,0,9
102823,tāseti,taseti,4,4,0,0,6
102824,tāsayati,tasayati,2,2,0,0,8
102825,dhasa,dhasa,1,0,1,0,5
102826,dhāseti,dhaseti,1,1,0,0,7
102827,dhāsayati,dhasayati,1,1,0,0,9
102828,bhāseti,bhaseti,9,8,1,0,7
102829,bhāsayati,bhasayati,1,1,0,0,9
102830,tusi,tusi,1,0,1,0,4
102831,tuṃseti,tumseti,1,1,0,0,7
102832,tuṃsayati,tumsayati,1,1,0,0,9
102833,piṃseti,pimseti,1,1,0,0,7
102834,piṃsayati,pimsayati,1,1,0,0,9
102835,kuṃseti,kumseti,1,1,0,0,7
102836,kuṃsayati,kumsayati,1,1,0,0,9
102837,khusi,khusi,1,0,1,0,5
102838,akkosane,akkosane,8,7,1,0,8
102839,khuṃseti,khumseti,10,10,0,0,8
102840,khuṃsayati,khumsayati,1,1,0,0,10
102841,khuṃsanā,khumsana,3,3,0,0,8
102842,gaveseti,gaveseti,1,1,0,0,8
102843,gavesayati,gavesayati,1,1,0,0,10
102844,gavesako,gavesako,1,1,0,0,8
102845,gavesanā,gavesana,13,13,0,0,8
102846,gaveṭṭhi,gavetthi,3,3,0,0,8
102847,hiṃseti,himseti,4,2,2,0,7
102848,hiṃsayati,himsayati,1,1,0,0,9
102849,nivāsayati,nivasayati,2,2,0,0,10
102850,aṃseti,amseti,7,3,4,0,6
102851,aṃsayati,amsayati,1,1,0,0,8
102852,aṃsoti,amsoti,4,2,2,0,6
102853,koṭṭhāsopi,kotthasopi,1,1,0,0,10
102854,khandhopi,khandhopi,10,10,0,0,9
102855,aṃsāti,amsati,2,0,2,0,6
102856,arisarogo,arisarogo,2,2,0,0,9
102857,meseti,meseti,1,1,0,0,6
102858,mesayati,mesayati,1,1,0,0,8
102859,raseti,raseti,6,2,4,0,6
102860,rasayati,rasayati,2,2,0,0,8
102861,rasiyate,rasiyate,1,1,0,0,8
102862,assādiyate,assadiyate,1,1,0,0,10
102863,rasetīti,rasetiti,1,0,1,0,8
102864,sinehasambandho,sinehasambandho,1,1,0,0,15
102865,sāmaggirasoti,samaggirasoti,1,1,0,0,13
102866,arasarūpo,arasarupo,27,25,2,0,9
102867,siya,siya,1,0,1,0,4
102868,seseti,seseti,18,6,12,0,6
102869,sesayati,sesayati,2,2,0,0,8
102870,viseseti,viseseti,68,67,1,0,8
102871,visesayati,visesayati,2,2,0,0,10
102872,sammisse,sammisse,2,1,1,0,8
102873,misseti,misseti,2,1,1,0,7
102874,missayati,missayati,1,1,0,0,9
102875,sammisseti,sammisseti,1,1,0,0,10
102876,sammissayati,sammissayati,1,1,0,0,12
102877,missito,missito,5,5,0,0,7
102878,sammissito,sammissito,1,1,0,0,10
102879,alambusājātake,alambusajatake,2,1,1,0,14
102880,missāti,missati,2,1,1,0,7
102881,vattabbanāmaṃ,vattabbanamam,1,1,0,0,13
102882,sammissanatāya,sammissanataya,1,1,0,0,14
102883,josayati,josayati,1,1,0,0,8
102884,pahāsane,pahasane,1,0,1,0,8
102885,maseti,maseti,1,1,0,0,6
102886,masayati,masayati,1,1,0,0,8
102887,titikkhāyaṃ,titikkhayam,1,0,1,0,11
102888,mariseti,mariseti,1,1,0,0,8
102889,marisayati,marisayati,1,1,0,0,10
102890,pesako,pesako,1,1,0,0,6
102891,desayati,desayati,37,26,11,0,8
102892,desetā,deseta,19,18,1,0,6
102893,araheti,araheti,1,1,0,0,7
102894,arahayati,arahayati,1,1,0,0,9
102895,sineha,sineha,3,1,2,0,6
102896,sineheti,sineheti,9,9,0,0,8
102897,sinehayati,sinehayati,4,4,0,0,10
102898,varaheti,varaheti,1,1,0,0,8
102899,varahayati,varahayati,1,1,0,0,10
102900,eṇeyyā,eneyya,7,7,0,0,6
102901,raheti,raheti,3,3,0,0,6
102902,rahayati,rahayati,1,1,0,0,8
102903,parikatthane,parikatthane,1,0,1,0,12
102904,caheti,caheti,1,1,0,0,6
102905,cahayati,cahayati,1,1,0,0,8
102906,maheti,maheti,5,3,2,0,6
102907,mahayati,mahayati,1,1,0,0,8
102908,piheti,piheti,28,28,0,0,6
102909,pihālu,pihalu,1,1,0,0,6
102910,apiho,apiho,1,1,0,0,5
102911,vimhāpane,vimhapane,1,0,1,0,9
102912,kuheti,kuheti,2,2,0,0,6
102913,kuhayati,kuhayati,3,3,0,0,8
102914,lokavimhāpanaṃ,lokavimhapanam,1,1,0,0,14
102915,kuhanā,kuhana,48,37,11,0,6
102916,saheti,saheti,1,1,0,0,6
102917,sahayati,sahayati,1,1,0,0,8
102918,sahatī,sahati,3,3,0,0,6
102919,vinindane,vinindane,1,0,1,0,9
102920,garaheti,garaheti,1,1,0,0,8
102921,garahayati,garahayati,1,1,0,0,10
102922,garahatī,garahati,6,5,1,0,8
102923,tāḷayati,talayati,1,1,0,0,8
102924,patāḷeti,pataleti,1,1,0,0,8
102925,patāḷayati,patalayati,1,1,0,0,10
102926,kaṃsatāḷādi,kamsataladi,2,2,0,0,11
102927,khaḷa,khala,1,0,1,0,5
102928,khaḷeti,khaleti,1,1,0,0,7
102929,khaḷayati,khalayati,1,1,0,0,9
102930,iḷa,ila,1,0,1,0,3
102931,iḷeti,ileti,1,1,0,0,5
102932,iḷayati,ilayati,1,1,0,0,7
102933,joḷeti,joleti,1,1,0,0,6
102934,joḷayati,jolayati,1,1,0,0,8
102935,avagāhane,avagahane,1,0,1,0,9
102936,nippīḷeti,nippileti,4,4,0,0,9
102937,nippīḷayati,nippilayati,1,1,0,0,11
102938,pīḷanako,pilanako,1,1,0,0,8
102939,nippīḷanako,nippilanako,1,1,0,0,11
102940,lāḷeti,laleti,2,2,0,0,6
102941,upalāḷeti,upalaleti,1,1,0,0,9
102942,upalāḷayati,upalalayati,1,1,0,0,11
102943,gaṇaṭṭhāya,ganatthaya,1,1,0,0,10
102944,vilāsanatthe,vilasanatthe,1,1,0,0,12
102945,laḷatī,lalati,1,1,0,0,6
102946,siḷa,sila,1,0,1,0,4
102947,seḷane,selane,1,0,1,0,6
102948,seḷeti,seleti,1,1,0,0,6
102949,seḷayati,selayati,1,1,0,0,8
102950,seḷento,selento,3,3,0,0,7
102951,seḷetīti,seletiti,1,0,1,0,8
102952,seḷitasaddaṃ,selitasaddam,2,2,0,0,12
102953,curādī,curadi,2,2,0,0,6
102954,pamukhagaṇo,pamukhagano,1,1,0,0,11
102955,supacurahitakāmo,supacurahitakamo,1,1,0,0,16
102956,sikkheyya,sikkheyya,185,183,2,0,9
102957,supacuranayapāṭhe,supacuranayapathe,1,1,0,0,17
102958,piyusamiva,piyusamiva,1,1,0,0,10
102959,gaṇaparidīpano,ganaparidipano,1,1,0,0,14
102960,aṭṭhārasamo,attharasamo,26,26,0,0,11
102961,sabbagaṇavinicchaya,sabbaganavinicchaya,1,1,0,0,19
102962,sabbagaṇavinicchayaṃ,sabbaganavinicchayam,1,1,0,0,20
102963,paṭubhāvatthaṃ,patubhavattham,2,2,0,0,14
102964,parame,parame,30,25,5,0,6
102965,paccayādivibhāgehi,paccayadivibhagehi,1,1,0,0,18
102966,sukhaggāhāya,sukhaggahaya,1,1,0,0,12
102967,vikaraṇapaccayavasena,vikaranapaccayavasena,1,1,0,0,21
102968,sānusāro,sanusaro,2,2,0,0,8
102969,kārameva,karameva,3,3,0,0,8
102970,suvādi,suvadi,2,0,2,0,6
102971,kyādi,kyadi,2,1,1,0,5
102972,catassetā,catasseta,1,1,0,0,9
102973,sabbadhātukanāmikā,sabbadhatukanamika,1,1,0,0,18
102974,visayesveva,visayesveva,1,1,0,0,11
102975,cupalabbhati,cupalabbhati,1,1,0,0,12
102976,ccādīrūpāni,ccadirupani,1,1,0,0,11
102977,rudhādīṃ,rudhadim,1,0,1,0,8
102978,rūpamāhu,rupamahu,2,2,0,0,8
102979,hinotī,hinoti,3,1,2,0,6
102980,ādirūpaṃ,adirupam,1,1,0,0,8
102981,kināti,kinati,4,4,0,0,6
102982,ccādirūpañca,ccadirupanca,1,1,0,0,12
102983,kyādīnaṃ,kyadinam,1,0,1,0,8
102984,saṇhañca,sanhanca,5,5,0,0,8
102985,saṇhakoti,sanhakoti,1,1,0,0,9
102986,tiṇhuṇha,tinhunha,1,1,0,0,8
102987,sanoti,sanoti,2,2,0,0,6
102988,sakkota,sakkota,1,1,0,0,7
102989,ppoti,ppoti,2,2,0,0,5
102990,ccādirūpaṃ,ccadirupam,1,1,0,0,10
102991,corayante,corayante,2,2,0,0,9
102992,ccādikañcāpi,ccadikancapi,1,1,0,0,12
102993,vikaraṇavasenevaṃ,vikaranavasenevam,1,1,0,0,17
102994,matānugo,matanugo,1,1,0,0,8
102995,kiriyāya,kiriyaya,213,212,1,0,8
102996,dhāraṇato,dharanato,31,31,0,0,9
102997,dvidhāpi,dvidhapi,70,68,2,0,8
102998,sakammākammato,sakammakammato,1,1,0,0,14
102999,gamibhakkhā,gamibhakkha,1,0,1,0,11
103000,ṭhāsā,thasa,1,0,1,0,5
103001,upasaggaṃ,upasaggam,13,10,3,0,9
103002,sakammakakammabhūto,sakammakakammabhuto,1,1,0,0,19
103003,sakammake,sakammake,1,1,0,0,9
103004,ekakammadvikammato,ekakammadvikammato,1,1,0,0,18
103005,tividhāpi,tividhapi,41,40,1,0,9
103006,dvikammakā,dvikammaka,3,3,0,0,10
103007,duhikaravahā,duhikaravaha,1,0,1,0,12
103008,sakammākammakattamhi,sakammakammakattamhi,1,1,0,0,20
103009,dhātūnamupasaggato,dhatunamupasaggato,1,1,0,0,18
103010,ekaṭṭhānā,ekatthana,1,1,0,0,9
103011,dviṭṭhānā,dvitthana,4,3,1,0,9
103012,bhūpacā,bhupaca,1,0,1,0,7
103013,tiṭṭhānā,titthana,1,1,0,0,8
103014,ṭhānatopi,thanatopi,2,2,0,0,9
103015,niyogena,niyogena,4,4,0,0,8
103016,vuddhikā,vuddhika,1,1,0,0,8
103017,savuddhāvuddhikā,savuddhavuddhika,1,1,0,0,16
103018,vuddhivasenāpi,vuddhivasenapi,1,1,0,0,14
103019,dhātusaṅgaho,dhatusangaho,7,7,0,0,12
103020,aluttavikaraṇā,aluttavikarana,1,1,0,0,14
103021,luttavikaraṇā,luttavikarana,2,2,0,0,13
103022,luttāluttavikaraṇā,luttaluttavikarana,1,1,0,0,18
103023,tatrāluttavikaraṇā,tatraluttavikarana,1,1,0,0,18
103024,suddhassarā,suddhassara,4,3,1,0,11
103025,ekassarā,ekassara,10,10,0,0,8
103026,tathānekassarāti,tathanekassarati,1,1,0,0,16
103027,yuyātāpābhālādī,yuyatapabhaladi,1,0,1,0,15
103028,catudhādinayo,catudhadinayo,1,1,0,0,13
103029,yathāvuttānusārato,yathavuttanusarato,3,3,0,0,18
103030,āivaṇṇauvaṇṇantaeo,aivannauvannantaeo,1,0,1,0,18
103031,ntavasā,ntavasa,1,1,0,0,7
103032,avaṇṇivaṇṇuvaṇṇante,avannivannuvannante,1,0,1,0,19
103033,anekassaradhātū,anekassaradhatu,1,1,0,0,15
103034,sattadhāva,sattadhava,7,7,0,0,10
103035,pannarasadhāpi,pannarasadhapi,1,1,0,0,14
103036,dhātūnamidha,dhatunamidha,3,3,0,0,12
103037,tappabhedaṃ,tappabhedam,2,2,0,0,11
103038,pakāseyyuṃ,pakaseyyum,2,2,0,0,10
103039,khijini,khijini,1,0,1,0,7
103040,ekārantā,ekaranta,1,1,0,0,8
103041,kakkhū,kakkhu,1,0,1,0,6
103042,kārantāti,karantati,1,1,0,0,9
103043,pannarasavidhena,pannarasavidhena,1,0,1,0,16
103044,tettiṃsavidhenapi,tettimsavidhenapi,1,1,0,0,17
103045,cekassarāpi,cekassarapi,1,0,1,0,11
103046,chakārantā,chakaranta,1,1,0,0,10
103047,ntakā,ntaka,5,5,0,0,5
103048,ḍhantā,dhanta,1,1,0,0,6
103049,tettiṃsadhā,tettimsadha,2,1,1,0,11
103050,ḍhaṇaḷā,dhanala,2,0,2,0,7
103051,padādimhi,padadimhi,1,1,0,0,9
103052,tenekassaradhātūsu,tenekassaradhatusu,1,1,0,0,18
103053,kathīyare,kathiyare,1,1,0,0,9
103054,kārantati,karantati,1,1,0,0,9
103055,ppaccayayogato,ppaccayayogato,1,1,0,0,14
103056,pacibhikkhichidikhādi,pacibhikkhichidikhadi,1,0,1,0,21
103057,gatigacchatihotīti,gatigacchatihotiti,1,0,1,0,18
103058,ādivohāramuddhare,adivoharamuddhare,1,1,0,0,17
103059,tettiṃsabhedehi,tettimsabhedehi,1,1,0,0,15
103060,gahitesu,gahitesu,71,70,1,0,8
103061,nikhilesu,nikhilesu,1,1,0,0,9
103062,sahahiṃsaīha,sahahimsaiha,1,0,1,0,12
103063,sahanato,sahanato,39,39,0,0,8
103064,hananato,hananato,40,40,0,0,8
103065,vātātapādiparissayampi,vatatapadiparissayampi,2,2,0,0,22
103066,ghāṭitehī,ghatitehi,1,1,0,0,9
103067,gocaratthāya,gocaratthaya,30,30,0,0,12
103068,khuddake,khuddake,101,97,4,0,8
103069,agaṇhanto,aganhanto,32,32,0,0,9
103070,visamagate,visamagate,7,6,1,0,10
103071,āpādesī,apadesi,2,2,0,0,7
103072,anuddayavasena,anuddayavasena,1,1,0,0,14
103073,sahitabbe,sahitabbe,1,1,0,0,9
103074,khuddakasattepi,khuddakasattepi,1,1,0,0,15
103075,hiṃsitabbe,himsitabbe,1,1,0,0,10
103076,kāyūpapanne,kayupapanne,1,1,0,0,11
103077,ādiantavipallāsato,adiantavipallasato,2,2,0,0,18
103078,hiṃsanaṭṭhenapi,himsanatthenapi,1,1,0,0,15
103079,nisajjaṭṭhānacaṅkame,nisajjatthanacankame,17,17,0,0,20
103080,alīnavīriyo,alinaviriyo,6,6,0,0,11
103081,paggahitamano,paggahitamano,6,6,0,0,13
103082,sahanā,sahana,4,4,0,0,6
103083,sīghajavattato,sighajavattato,1,1,0,0,14
103084,sakyasīhassa,sakyasihassa,2,2,0,0,12
103085,saharā,sahara,1,1,0,0,6
103086,hananā,hanana,4,4,0,0,6
103087,sīghajavattā,sighajavatta,4,4,0,0,12
103088,tadatthuddhāro,tadatthuddharo,1,1,0,0,14
103089,migarāje,migaraje,6,6,0,0,8
103090,senāpati,senapati,188,188,0,0,8
103091,tenupasaṅkamī,tenupasankami,21,17,4,0,13
103092,sadisakappanāya,sadisakappanaya,4,4,0,0,15
103093,paññattiyañcāpi,pannattiyancapi,1,1,0,0,15
103094,appaṭipuggale,appatipuggale,1,1,0,0,13
103095,rūpiruppati,rupiruppati,1,0,1,0,11
103096,nibbacanadvayaṃ,nibbacanadvayam,2,2,0,0,15
103097,ruppanaṭṭhenā,ruppanatthena,4,1,3,0,13
103098,pasavatemanatthena,pasavatemanatthena,1,1,0,0,18
103099,udinā,udina,1,0,1,0,5
103100,samuddati,samuddati,2,2,0,0,9
103101,attasannissitānaṃ,attasannissitanam,1,1,0,0,17
103102,macchamakarādīnaṃ,macchamakaradinam,1,1,0,0,17
103103,samuddanaṭṭhena,samuddanatthena,7,7,0,0,15
103104,kiledanaṭṭhena,kiledanatthena,3,3,0,0,14
103105,tenamanaṭṭhenāti,tenamanatthenati,1,1,0,0,16
103106,nāgaseno,nagaseno,101,99,2,0,8
103107,milindena,milindena,11,11,0,0,9
103108,udakasamattā,udakasamatta,1,1,0,0,12
103109,kallosi,kallosi,86,86,0,0,7
103110,nāgasenā,nagasena,86,86,0,0,8
103111,bhadantanāgasena,bhadantanagasena,1,0,1,0,16
103112,pakatisamuddaṃ,pakatisamuddam,2,2,0,0,14
103113,matampi,matampi,1,1,0,0,7
103114,taṇhāsamuddo,tanhasamuddo,11,9,2,0,12
103115,samuddopeso,samuddopeso,7,6,1,0,11
103116,samuddasarikkhakāni,samuddasarikkhakani,1,1,0,0,19
103117,taṇhācakkhusotādīni,tanhacakkhusotadini,1,1,0,0,19
103118,dhātuvasā,dhatuvasa,10,10,0,0,9
103119,khani,khani,1,0,1,0,5
103120,pubbatopi,pubbatopi,1,1,0,0,9
103121,saddakkhandhavidū,saddakkhandhavidu,1,1,0,0,17
103122,pañcupādānakkhandhāpi,pancupadanakkhandhapi,8,8,0,0,21
103123,dukkhadhammoyeva,dukkhadhammoyeva,1,1,0,0,16
103124,jātijarābyādhimaraṇadukkhādīhi,jatijarabyadhimaranadukkhadihi,1,1,0,0,30
103125,dukkhehi,dukkhehi,133,133,0,0,8
103126,khādiyatīti,khadiyatiti,1,1,0,0,11
103127,avadāriyatītipi,avadariyatitipi,1,1,0,0,15
103128,khaniyati,khaniyati,1,1,0,0,9
103129,parikhaññatītipi,parikhannatitipi,1,1,0,0,16
103130,suññākāraṃ,sunnakaram,1,1,0,0,10
103131,dhāretītipi,dharetitipi,1,1,0,0,11
103132,rūpakkhandhādi,rupakkhandhadi,2,2,0,0,14
103133,atthuddhārato,atthuddharato,5,3,2,0,13
103134,rāsiguṇapaṇṇattīsu,rasigunapannattisu,1,1,0,0,18
103135,rūḷhiyaṃ,rulhiyam,1,1,0,0,8
103136,sammohavinodaniyaṃ,sammohavinodaniyam,42,7,35,0,18
103137,sambahulesu,sambahulesu,16,15,1,0,11
103138,rūḷhiyanti,rulhiyanti,1,1,0,0,10
103139,udakāḷhakānī,udakalhakani,5,5,0,0,12
103140,udakāḷhakasatānī,udakalhakasatani,3,3,0,0,16
103141,udakāḷhakasahassānī,udakalhakasahassani,3,3,0,0,19
103142,udakāḷhakasatasahassānī,udakalhakasatasahassani,4,4,0,0,23
103143,udakakkhandhoti,udakakkhandhoti,2,2,0,0,15
103144,bahukameva,bahukameva,6,6,0,0,10
103145,rajakkhandho,rajakkhandho,5,5,0,0,12
103146,gavakkhandho,gavakkhandho,4,4,0,0,12
103147,balakkhandho,balakkhandho,4,4,0,0,12
103148,puññakkhandhoti,punnakkhandhoti,4,4,0,0,15
103149,gavādayo,gavadayo,2,2,0,0,8
103150,sīlakkhandho,silakkhandho,104,90,14,0,12
103151,samādhikkhandho,samadhikkhandho,64,60,4,0,15
103152,paṇṇattito,pannattito,4,4,0,0,10
103153,viññāṇakkhandho,vinnanakkhandho,624,616,8,0,15
103154,svāyamidha,svayamidha,34,33,1,0,10
103155,khandhaṭṭho,khandhattho,17,12,5,0,11
103156,piṇḍaṭṭho,pindattho,3,2,1,0,9
103157,pūgaṭṭho,pugattho,2,2,0,0,8
103158,ghaṭaṭṭho,ghatattho,2,2,0,0,9
103159,rāsaṭṭho,rasattho,21,20,1,0,8
103160,rāsilakkhaṇā,rasilakkhana,2,2,0,0,12
103161,khandhāti,khandhati,82,49,33,0,9
103162,koṭṭhāsaṭṭhātipi,kotthasatthatipi,1,1,0,0,16
103163,codiyamānā,codiyamana,12,12,0,0,10
103164,dassāma,dassama,149,148,1,0,7
103165,koṭṭhāsalakkhaṇā,kotthasalakkhana,2,2,0,0,16
103166,khandhātipi,khandhatipi,1,1,0,0,11
103167,rūpakkhandhoti,rupakkhandhoti,59,42,17,0,14
103168,rūparāsi,ruparasi,4,4,0,0,8
103169,vedanākkhandhoti,vedanakkhandhoti,47,37,10,0,16
103170,vedanārāsi,vedanarasi,2,2,0,0,10
103171,vedanākoṭṭhāso,vedanakotthaso,1,1,0,0,14
103172,khandhato,khandhato,129,125,4,0,9
103173,otāreti,otareti,34,34,0,0,7
103174,mahāhanusabhakkhandho,mahahanusabhakkhandho,5,5,0,0,21
103175,papadato,papadato,1,1,0,0,8
103176,tani,tani,1,0,1,0,4
103177,āyānaṃ,ayanam,18,18,0,0,6
103178,tananato,tananato,15,15,0,0,8
103179,āyatassa,ayatassa,14,14,0,0,8
103180,nayanato,nayanato,25,25,0,0,8
103181,taṃtaṃdvārārammaṇā,tamtamdvararammana,8,8,0,0,18
103182,vāyamantīti,vayamantiti,7,5,2,0,11
103183,tananti,tananti,1,1,0,0,7
103184,vitthārentīti,vittharentiti,11,8,3,0,13
103185,pavattayantīti,pavattayantiti,6,6,0,0,14
103186,sabbepime,sabbepime,64,62,2,0,9
103187,nivāsaṭṭhānaṭṭhena,nivasatthanatthena,18,18,0,0,18
103188,ākaraṭṭhena,akaratthena,17,17,0,0,11
103189,samosaraṇaṭṭhānaṭṭhena,samosaranatthanatthena,13,13,0,0,22
103190,sañjātidesaṭṭhena,sanjatidesatthena,26,26,0,0,17
103191,kāraṇaṭṭhena,karanatthena,30,28,2,0,12
103192,cakkhuādīsu,cakkhuadisu,7,7,0,0,11
103193,tadāyattavuttitāyāti,tadayattavuttitayati,37,37,0,0,20
103194,ākiṇṇā,akinna,22,21,1,0,6
103195,tadārammaṇattā,tadarammanatta,6,6,0,0,14
103196,dvārārammaṇavasena,dvararammanavasena,1,1,0,0,18
103197,samosaraṇato,samosaranato,10,9,1,0,12
103198,tannissayārammaṇabhāvena,tannissayarammanabhavena,4,4,0,0,24
103199,uppattito,uppattito,106,103,3,0,9
103200,kāraṇaṭṭhenāti,karanatthenati,7,6,1,0,14
103201,yathāvuttenatthena,yathavuttenatthena,39,39,0,0,18
103202,āyatanañcāti,ayatanancati,31,30,1,0,12
103203,dhammāyatanaṃ,dhammayatanam,893,885,8,0,13
103204,tāvettha,tavettha,163,161,2,0,8
103205,vinicchayoti,vinicchayoti,80,56,24,0,12
103206,jātideso,jatideso,1,1,0,0,8
103207,samosaraṇaṭṭhānañca,samosaranatthananca,2,2,0,0,19
103208,vidividehi,vidividehi,1,0,1,0,10
103209,kārapubbakehi,karapubbakehi,1,1,0,0,13
103210,antavirahita,antavirahita,1,0,1,0,12
103211,saddūpapadena,saddupapadena,1,1,0,0,13
103212,sudhīmatā,sudhimata,3,3,0,0,9
103213,pūretuṃ,puretum,90,83,7,0,7
103214,ayuttaṭṭhena,ayuttatthena,7,7,0,0,12
103215,kāyaduccaritādi,kayaduccaritadi,14,14,0,0,15
103216,avindiyaṃ,avindiyam,31,28,3,0,9
103217,aladdhabbaṃ,aladdhabbam,2,1,1,0,11
103218,tabbiparītato,tabbiparitato,9,9,0,0,13
103219,kāyasucaritādi,kayasucaritadi,12,12,0,0,14
103220,vindiyaṃ,vindiyam,33,30,3,0,8
103221,antavirahite,antavirahite,13,11,2,0,12
103222,sabbabhavayonigativiññāṇaṭṭhitisattāvāsesu,sabbabhavayonigativinnanatthitisattavasesu,1,1,0,0,42
103223,javāpetīti,javapetiti,13,11,2,0,10
103224,avijjamānesu,avijjamanesu,15,13,2,0,12
103225,itthipurisādīsu,itthipurisadisu,9,9,0,0,15
103226,khandhādīsu,khandhadisu,73,65,8,0,11
103227,vatthārammaṇapaṭiccasamuppādapaṭiccasamuppannā,vattharammanapaticcasamuppadapaticcasamuppanna,1,1,0,0,46
103228,chādanatopi,chadanatopi,6,6,0,0,11
103229,saddatthato,saddatthato,18,18,0,0,11
103230,chādanakiccattā,chadanakiccatta,1,1,0,0,15
103231,byañjanatthaṃ,byanjanattham,3,3,0,0,13
103232,sabhāvatthaṃ,sabhavattham,7,7,0,0,12
103233,apicā,apica,170,23,147,0,5
103234,vatthārammaṇāni,vattharammanani,7,7,0,0,15
103235,idamārammaṇaṃ,idamarammanam,2,2,0,0,13
103236,tappaṭicchādikā,tappaticchadika,3,3,0,0,15
103237,vatthārammaṇasabhāvacchādanato,vattharammanasabhavacchadanato,2,2,0,0,30
103238,avijjādīnaṃ,avijjadinam,99,97,2,0,11
103239,paṭiccasamuppādabhāvassa,paticcasamuppadabhavassa,3,3,0,0,24
103240,jarāmaraṇādīnaṃ,jaramaranadinam,20,20,0,0,15
103241,paṭiccasamuppannabhāvassa,paticcasamuppannabhavassa,3,3,0,0,25
103242,chādanato,chadanato,5,5,0,0,9
103243,paṭiccasamuppādapaṭiccasamuppannachādanaṃ,paticcasamuppadapaticcasamuppannachadanam,2,2,0,0,41
103244,duggatigāmikammassa,duggatigamikammassa,4,4,0,0,19
103245,visesappaccayattā,visesappaccayatta,2,2,0,0,17
103246,visesapaccayo,visesapaccayo,73,67,6,0,13
103247,vindanīyassa,vindaniyassa,1,1,0,0,12
103248,pavattāpanaṃ,pavattapanam,3,3,0,0,12
103249,uppādanaṃ,uppadanam,53,52,1,0,9
103250,sammohabhāveneva,sammohabhaveneva,3,3,0,0,16
103251,anabhisamayabhūtattā,anabhisamayabhutatta,3,3,0,0,20
103252,javāpetī,javapeti,1,1,0,0,8
103253,vaṇṇāgamavipariyāyavikāravināsadhātuatthavisesayogehi,vannagamavipariyayavikaravinasadhatuatthavisesayogehi,3,3,0,0,53
103254,pañcavidhassa,pancavidhassa,23,23,0,0,13
103255,niruttilakkhaṇassa,niruttilakkhanassa,3,3,0,0,18
103256,āgamaṃ,agamam,59,48,11,0,6
103257,saddasaṇṭhiti,saddasanthiti,1,1,0,0,13
103258,arārū,araru,1,0,1,0,5
103259,papada,papada,1,1,0,0,6
103260,vāthavā,vathava,1,1,0,0,7
103261,akārapubbato,akarapubbato,1,1,0,0,12
103262,ārakādiravassitā,arakadiravassita,1,1,0,0,16
103263,aggadakkhiṇeyyattā,aggadakkhineyyatta,11,11,0,0,18
103264,cīvarādipaccaye,civaradipaccaye,9,9,0,0,15
103265,pūjāvisesañcāti,pujavisesancati,1,1,0,0,15
103266,pūjāvisesaṃ,pujavisesam,10,10,0,0,11
103267,nāmametaṃ,namametam,20,20,0,0,9
103268,hanīti,haniti,6,3,3,0,6
103269,rāgādisaṅkhātā,ragadisankhata,6,6,0,0,14
103270,paññāsatthena,pannasatthena,10,10,0,0,13
103271,yañcetaṃ,yancetam,41,36,5,0,8
103272,avijjābhavataṇhāmayanābhiṃ,avijjabhavatanhamayanabhim,2,2,0,0,26
103273,puññādiabhisaṅkhārāraṃ,punnadiabhisankhararam,5,3,2,0,22
103274,jarāmaraṇanemiṃ,jaramarananemim,2,2,0,0,15
103275,āsavasamudayamayena,asavasamudayamayena,10,8,2,0,19
103276,vibhavarathe,vibhavarathe,1,1,0,0,12
103277,samāyojitaṃ,samayojitam,9,7,2,0,11
103278,anādikālappavattaṃ,anadikalappavattam,9,7,2,0,18
103279,vīriyapādehi,viriyapadehi,8,8,0,0,12
103280,sīlapathaviyaṃ,silapathaviyam,13,11,2,0,14
103281,saddhāhatthena,saddhahatthena,15,15,0,0,14
103282,kammakkhayakaraṃ,kammakkhayakaram,18,15,3,0,16
103283,ñāṇaparasuṃ,nanaparasum,1,1,0,0,11
103284,hanītipi,hanitipi,1,1,0,0,8
103285,ñāṇāsinā,nanasina,10,10,0,0,8
103286,lokanāthena,lokanathena,34,33,1,0,11
103287,attahitaṃ,attahitam,19,18,1,0,9
103288,parahitañca,parahitanca,8,8,0,0,11
103289,paripūretuṃ,paripuretum,19,16,3,0,11
103290,paṭipajjantehi,patipajjantehi,7,7,0,0,14
103291,rahitabbā,rahitabba,3,3,0,0,9
103292,pariccajitabbā,pariccajitabba,6,6,0,0,14
103293,parihātabbāti,parihatabbati,1,1,0,0,13
103294,rahāti,rahati,3,3,0,0,6
103295,arahaṃṃ,arahamm,1,1,0,0,7
103296,rahitabbato,rahitabbato,5,5,0,0,11
103297,sekkhehi,sekkhehi,6,6,0,0,8
103298,kalyāṇaputhujjanehi,kalyanaputhujjanehi,3,3,0,0,19
103299,rahitabbo,rahitabbo,3,3,0,0,9
103300,pariccajitabbo,pariccajitabbo,3,3,0,0,14
103301,sacchikatadhammā,sacchikatadhamma,1,1,0,0,16
103302,suddhagocarā,suddhagocara,12,10,2,0,12
103303,rahoti,rahoti,26,6,20,0,6
103304,paccājātīti,paccajatiti,5,5,0,0,11
103305,pāsaṃsattā,pasamsatta,6,6,0,0,10
103306,sadaṃ,sadam,1,1,0,0,5
103307,pāsaṃsabhāvo,pasamsabhavo,3,3,0,0,12
103308,anaññasādhāraṇo,anannasadharano,33,33,0,0,15
103309,yathābhuccaguṇādhigato,yathabhuccagunadhigato,7,7,0,0,22
103310,pāsaṃsattāpi,pasamsattapi,3,3,0,0,12
103311,pāsaṃsiyattāpi,pasamsiyattapi,4,4,0,0,14
103312,ārakattā,arakatta,104,101,3,0,8
103313,rahābhāvā,rahabhava,15,15,0,0,9
103314,dūreti,dureti,46,30,16,0,6
103315,āsanneti,asanneti,7,4,3,0,8
103316,dhātusaddanissitāni,dhatusaddanissitani,1,1,0,0,19
103317,dhātunissitā,dhatunissita,1,1,0,0,12
103318,adhātunissitā,adhatunissita,1,1,0,0,13
103319,hatattā,hatatta,75,71,4,0,7
103320,kilesārīna,kilesarina,9,7,2,0,10
103321,hatasaṃsāracakkāro,hatasamsaracakkaro,7,7,0,0,18
103322,paccayādīna,paccayadina,9,7,2,0,11
103323,cāraho,caraho,7,7,0,0,6
103324,ṭīkācariyehipi,tikacariyehipi,1,0,1,0,14
103325,suppahīnattā,suppahinatta,43,43,0,0,12
103326,vidūnamaraheyyato,vidunamaraheyyato,4,4,0,0,17
103327,gadi,gadi,1,0,1,0,4
103328,topi,topi,5,5,0,0,4
103329,dhātunissitaṃ,dhatunissitam,1,1,0,0,13
103330,gamanampi,gamanampi,18,16,2,0,9
103331,parisuddhamanavajjaṃ,parisuddhamanavajjam,6,4,2,0,20
103332,bhaga,bhaga,1,0,1,0,5
103333,saddūpapadato,saddupapadato,2,2,0,0,13
103334,vanu,vanu,1,0,1,0,4
103335,bhagasaṅkhātā,bhagasankhata,2,2,0,0,13
103336,lokiyalokuttarasampattiyo,lokiyalokuttarasampattiyo,5,5,0,0,25
103337,sevīti,seviti,5,3,2,0,6
103338,somanassakumārattabhāvādīsu,somanassakumarattabhavadisu,1,1,0,0,27
103339,carimattabhāve,carimattabhave,7,7,0,0,14
103340,nakkhattehi,nakkhattehi,4,4,0,0,11
103341,bhagasaṅkhāte,bhagasankhate,2,2,0,0,13
103342,sineruyugandharauttarakuruhimavantādibhājanaloke,sineruyugandharauttarakuruhimavantadibhajanaloke,1,1,0,0,48
103343,tannivāsitattāvāsasamatikkamanato,tannivasitattavasasamatikkamanato,1,1,0,0,33
103344,parū,paru,6,2,4,0,4
103345,papadatopi,papadatopi,1,1,0,0,10
103346,uttamavācī,uttamavaci,1,1,0,0,10
103347,taddhitapaccayiṃ,taddhitapaccayim,1,1,0,0,16
103348,mahāpurisavācakaṃ,mahapurisavacakam,1,1,0,0,17
103349,saddamīrenti,saddamirenti,1,1,0,0,12
103350,uttamatthavācaka,uttamatthavacaka,1,1,0,0,16
103351,saddūpapadamudhātādivasena,saddupapadamudhatadivasena,1,1,0,0,26
103352,saddūpapada,saddupapada,2,2,0,0,11
103353,dhātādivasena,dhatadivasena,1,1,0,0,13
103354,dānasīlādiguṇavisesayogena,danasiladigunavisesayogena,4,4,0,0,26
103355,adhikataraṃ,adhikataram,38,37,1,0,11
103356,ñāṇavisesena,nanavisesena,8,8,0,0,12
103357,idhalokaṃ,idhalokam,25,17,8,0,9
103358,attabhūtato,attabhutato,4,4,0,0,11
103359,dhammakāyato,dhammakayato,4,4,0,0,12
103360,yojeīti,yojeiti,1,1,0,0,7
103361,kilesāriṃ,kilesarim,3,3,0,0,9
103362,dānādikriyāva,danadikriyava,1,1,0,0,13
103363,mahākaruṇasāsane,mahakarunasasane,1,1,0,0,16
103364,karuṇāti,karunati,20,14,6,0,8
103365,paradukkaṃ,paradukkam,1,1,0,0,10
103366,vikkhipatīti,vikkhipatiti,20,17,3,0,12
103367,sukhāpetītipi,sukhapetitipi,1,1,0,0,13
103368,vidividhavida,vidividhavida,1,0,1,0,13
103369,saddanipphattikovido,saddanipphattikovido,1,1,0,0,20
103370,kāyasucaritādiṃ,kayasucaritadim,9,9,0,0,15
103371,upalabhatīti,upalabhatiti,1,1,0,0,12
103372,tamokhandhādipadālanaṭṭhena,tamokhandhadipadalanatthena,1,1,0,0,27
103373,karotītipi,karotitipi,19,19,0,0,10
103374,sammohaṃ,sammoham,132,126,6,0,8
103375,hiṃsatītipi,himsatitipi,1,1,0,0,11
103376,siriñcāpi,sirincapi,3,3,0,0,9
103377,tiṭṭhatītipi,titthatitipi,1,1,0,0,12
103378,rāpubbatiratopi,rapubbatiratopi,1,1,0,0,15
103379,vūpasamakāloti,vupasamakaloti,1,1,0,0,14
103380,cubhohi,cubhohi,1,1,0,0,7
103381,phagguṇoti,phaggunoti,1,1,0,0,10
103382,rammake,rammake,8,7,1,0,7
103383,vārijā,varija,4,3,1,0,6
103384,māsoti,masoti,11,9,2,0,6
103385,aparaṇṇavisesassapi,aparannavisesassapi,1,1,0,0,19
103386,suvaṇṇamāsassapi,suvannamasassapi,1,1,0,0,16
103387,aparaṇṇaviseso,aparannaviseso,1,1,0,0,14
103388,yathāparimite,yathaparimite,1,1,0,0,13
103389,bhakkhiyatīti,bhakkhiyatiti,1,1,0,0,13
103390,masiyati,masiyati,2,2,0,0,8
103391,āmasiyati,amasiyati,1,1,0,0,9
103392,gaṇhiyatīti,ganhiyatiti,1,1,0,0,11
103393,vadacare,vadacare,1,0,1,0,8
103394,saṃvacchara,samvacchara,2,1,1,0,11
103395,samudīreyya,samudireyya,2,2,0,0,11
103396,dhammappavattiñca,dhammappavattinca,4,4,0,0,17
103397,bhidibhikkhi,bhidibhikkhi,1,0,1,0,12
103398,bhayavācakaṃ,bhayavacakam,1,1,0,0,12
103399,kathayeyya,kathayeyya,4,3,1,0,10
103400,chinnabhinnapaṭadharotipi,chinnabhinnapatadharotipi,1,1,0,0,25
103401,bhikkhanasīlotipi,bhikkhanasilotipi,1,1,0,0,17
103402,ikkhanasīloti,ikkhanasiloti,1,1,0,0,13
103403,sadabhidīhi,sadabhidihi,1,0,1,0,11
103404,sīdanasabhāve,sidanasabhave,1,1,0,0,13
103405,sīdanasabhāvā,sidanasabhava,3,3,0,0,13
103406,nibbānamāgama,nibbanamagama,1,1,0,0,13
103407,saṃsīdanasabhāvino,samsidanasabhavino,1,1,0,0,18
103408,klesā,klesa,3,3,0,0,5
103409,b,b,1,0,1,0,1
103410,rūdhātu,rudhatu,1,1,0,0,7
103411,brūhitā,bruhita,2,2,0,0,7
103412,porāṇācariyā,poranacariya,6,6,0,0,12
103413,bravantā,bravanta,1,1,0,0,8
103414,sīdantīti,sidantiti,10,6,4,0,9
103415,khādatītipi,khadatitipi,2,2,0,0,11
103416,suṭṭu,suttu,4,4,0,0,5
103417,khanatītipi,khanatitipi,4,4,0,0,11
103418,gamudhā,gamudha,1,0,1,0,7
103419,gandhayatīti,gandhayatiti,7,6,1,0,12
103420,duggandhaṃ,duggandham,106,104,2,0,10
103421,manāpagandho,manapagandho,1,1,0,0,12
103422,sugandhabhāvena,sugandhabhavena,1,1,0,0,15
103423,amanāpagandho,amanapagandho,1,1,0,0,13
103424,sugandhanti,sugandhanti,2,2,0,0,11
103425,chedanavācakatte,chedanavacakatte,1,1,0,0,16
103426,atijātaṃ,atijatam,2,2,0,0,8
103427,anujātaṃ,anujatam,7,6,1,0,8
103428,puttamicchanti,puttamicchanti,6,6,0,0,14
103429,avajātaṃ,avajatam,4,4,0,0,8
103430,kulagandhano,kulagandhano,4,4,0,0,12
103431,khādaamagami,khadaamagami,1,0,1,0,12
103432,andhagandhā,andhagandha,1,0,1,0,11
103433,dhariyate,dhariyate,1,1,0,0,9
103434,buddhadattācariyena,buddhadattacariyena,9,5,4,0,19
103435,veyyākaraṇena,veyyakaranena,57,54,3,0,13
103436,niruttinayadassinā,niruttinayadassina,1,1,0,0,18
103437,ramāsa,ramasa,1,0,1,0,6
103438,dhātutopi,dhatutopi,1,1,0,0,9
103439,dhammarasaññuno,dhammarasannuno,1,1,0,0,15
103440,asantītipi,asantitipi,1,1,0,0,10
103441,ramamānā,ramamana,6,5,1,0,8
103442,paridīpito,paridipito,25,23,2,0,10
103443,bhakkhanti,bhakkhanti,4,4,0,0,10
103444,paridīpitoti,paridipitoti,2,2,0,0,12
103445,kammakārakabhāvena,kammakarakabhavena,1,1,0,0,18
103446,avuttesu,avuttesu,4,4,0,0,8
103447,padesupi,padesupi,24,24,0,0,8
103448,susobhano,susobhano,2,2,0,0,9
103449,dhātucintāya,dhatucintaya,1,1,0,0,12
103450,anipphannāti,anipphannati,5,5,0,0,12
103451,pītalohitakā,pitalohitaka,1,0,1,0,12
103452,dhagā,dhaga,1,0,1,0,5
103453,anipphannaṃva,anipphannamva,1,1,0,0,13
103454,pekkhanti,pekkhanti,8,8,0,0,9
103455,gavādi,gavadi,4,3,1,0,6
103456,vidhibhedato,vidhibhedato,1,1,0,0,12
103457,anipphannaṃ,anipphannam,7,6,1,0,11
103458,iccādikaṃbravuṃ,iccadikambravum,1,1,0,0,15
103459,anipphannā,anipphanna,16,13,3,0,10
103460,viḍūḍabhā,vidudabha,1,0,1,0,9
103461,dhāturūpakasaddā,dhaturupakasadda,1,1,0,0,16
103462,viḍūḍabho,vidudabho,2,2,0,0,9
103463,anipphannāni,anipphannani,8,7,1,0,12
103464,pītavaṇṇe,pitavanne,1,1,0,0,9
103465,pītatīti,pitatiti,1,1,0,0,8
103466,kiyate,kiyate,1,1,0,0,6
103467,kathiyateti,kathiyateti,1,1,0,0,11
103468,nibbacanamarahantīti,nibbacanamarahantiti,1,1,0,0,20
103469,nipphannānīti,nipphannaniti,1,1,0,0,13
103470,nīlati,nilati,2,2,0,0,6
103471,pītatītiādīni,pitatitiadini,1,1,0,0,13
103472,yācanopatāpissariyāsīsanesūti,yacanopatapissariyasisanesuti,1,0,1,0,29
103473,gaṇhiṃsuyeva,ganhimsuyeva,1,1,0,0,12
103474,kriyāpadaparihīno,kriyapadaparihino,1,1,0,0,17
103475,buddhuppāde,buddhuppade,572,571,1,0,11
103476,asañcarantaṃ,asancarantam,1,1,0,0,12
103477,purāṇabhāsābhūtaṃ,puranabhasabhutam,1,1,0,0,17
103478,byātī,byati,1,1,0,0,5
103479,pītatī,pitati,1,1,0,0,6
103480,purāṇabhāsābhūtehi,puranabhasabhutehi,1,1,0,0,18
103481,cūḷabodhi,culabodhi,2,2,0,0,9
103482,viḍūḍabha,vidudabha,1,0,1,0,9
103483,dhūmāyati,dhumayati,24,21,3,0,9
103484,duddubhāyati,duddubhayati,12,10,2,0,12
103485,mettāyati,mettayati,9,9,0,0,9
103486,mamāyati,mamayati,35,33,2,0,8
103487,paṭīyati,patiyati,3,3,0,0,8
103488,pamāṇayati,pamanayati,3,2,1,0,10
103489,anipphannāyeva,anipphannayeva,1,1,0,0,14
103490,dhūmamiva,dhumamiva,1,1,0,0,9
103491,duddubhaiti,duddubhaiti,1,1,0,0,11
103492,visuddhāyati,visuddhayati,2,1,1,0,12
103493,pabbatāyanti,pabbatayanti,3,3,0,0,12
103494,pabbatāyasi,pabbatayasi,2,2,0,0,11
103495,pabbatāyatha,pabbatayatha,1,1,0,0,12
103496,pabbatāyāmi,pabbatayami,1,1,0,0,11
103497,pabbatāyāmā,pabbatayama,1,1,0,0,11
103498,chattīyatī,chattiyati,1,1,0,0,10
103499,kāritavasenapi,karitavasenapi,1,1,0,0,14
103500,pabbatāyantaṃ,pabbatayantam,2,2,0,0,13
103501,puttiyantaṃ,puttiyantam,1,1,0,0,11
103502,nipphannānipphannapadāni,nipphannanipphannapadani,1,1,0,0,24
103503,vibhāvitāni,vibhavitani,8,8,0,0,11
103504,dhātugaṇalakkhaṇaṃ,dhatuganalakkhanam,1,1,0,0,18
103505,adhātulakkhaṇaṃ,adhatulakkhanam,2,1,1,0,15
103506,kāritapaccayayogaṃ,karitapaccayayogam,1,1,0,0,18
103507,sakāritekakammadvikammatikammapadaṃ,sakaritekakammadvikammatikammapadam,1,1,0,0,35
103508,ūhanīyarūpagaṇaṃ,uhaniyarupaganam,2,1,1,0,16
103509,ekagaṇikadvigaṇikategaṇikapadaṃ,ekaganikadviganikateganikapadam,1,1,0,0,31
103510,suddhakattuhetukattupadarūpaṃ,suddhakattuhetukattupadarupam,1,1,0,0,29
103511,kammabhāvapadarūpaṃ,kammabhavapadarupam,1,1,0,0,19
103512,ekakāritadvikāritapadaṃ,ekakaritadvikaritapadam,1,1,0,0,23
103513,akāritadvikammakapadañca,akaritadvikammakapadanca,1,1,0,0,24
103514,suddhakattuppayoge,suddhakattuppayoge,1,1,0,0,18
103515,suddhassaradhātuto,suddhassaradhatuto,1,1,0,0,18
103516,ekassarato,ekassarato,1,1,0,0,10
103517,anekassarato,anekassarato,1,1,0,0,12
103518,parabhāvo,parabhavo,13,11,2,0,9
103519,sāmaññalakkhaṇavasena,samannalakkhanavasena,6,6,0,0,21
103520,visesalakkhaṇavasena,visesalakkhanavasena,3,3,0,0,20
103521,kārantānekassaradhātuto,karantanekassaradhatuto,1,1,0,0,23
103522,niggahītāgamanañca,niggahitagamananca,3,3,0,0,18
103523,niggahītāgamanamattañca,niggahitagamanamattanca,3,3,0,0,23
103524,bhūvādigaṇalakkhaṇaṃ,bhuvadiganalakkhanam,1,0,1,0,20
103525,ākyātatte,akyatatte,1,1,0,0,9
103526,saddhiṃniyatavasena,saddhimniyatavasena,1,1,0,0,19
103527,niggahītāgamanaṃ,niggahitagamanam,1,1,0,0,16
103528,ivaṇṇekārokāra,ivannekarokara,1,0,1,0,14
103529,niyatavasena,niyatavasena,5,5,0,0,12
103530,nāmakatte,namakatte,1,1,0,0,9
103531,aniyatavasena,aniyatavasena,2,2,0,0,13
103532,rudhādigaṇalakkhaṇaṃ,rudhadiganalakkhanam,1,0,1,0,20
103533,ādesalābhālābhino,adesalabhalabhino,1,1,0,0,17
103534,divādigaṇalakkhaṇaṃ,divadiganalakkhanam,1,0,1,0,19
103535,svādigaṇalakkhaṇaṃ,svadiganalakkhanam,1,0,1,0,18
103536,kiyādigaṇalakkhaṇaṃ,kiyadiganalakkhanam,1,0,1,0,19
103537,appakatarappayogavasena,appakatarappayogavasena,1,1,0,0,23
103538,pacurappayogavasena,pacurappayogavasena,1,1,0,0,19
103539,gahādigaṇalakkhaṇaṃ,gahadiganalakkhanam,1,0,1,0,19
103540,oyira,oyira,3,0,3,0,5
103541,ppaccayānaṃ,ppaccayanam,3,3,0,0,11
103542,tanādigaṇalakkhaṇaṃ,tanadiganalakkhanam,1,0,1,0,19
103543,kārantadhātuto,karantadhatuto,1,1,0,0,14
103544,curādigaṇalakkhaṇaṃ,curadiganalakkhanam,1,0,1,0,19
103545,gaṇasūcakānaṃ,ganasucakanam,1,1,0,0,13
103546,paccayānamaparattaṃ,paccayanamaparattam,1,1,0,0,19
103547,dhātugaṇalakkhaṇamadhātulakkhaṇaṃ,dhatuganalakkhanamadhatulakkhanam,1,1,0,0,33
103548,kāritapaccayassa,karitapaccayassa,1,1,0,0,16
103549,ṇāpayo,napayo,2,2,0,0,6
103550,kāritapaccayā,karitapaccaya,2,1,1,0,13
103551,ādantā,adanta,1,1,0,0,6
103552,caturodve,caturodve,1,1,0,0,9
103553,adhātuto,adhatuto,2,2,0,0,8
103554,obhāseti,obhaseti,46,41,5,0,8
103555,obhāsayati,obhasayati,1,1,0,0,10
103556,uvaṇṇantadhāturūpāni,uvannantadhaturupani,1,1,0,0,20
103557,hāpeti,hapeti,91,84,7,0,6
103558,hāpayati,hapayati,4,4,0,0,8
103559,nhāpeti,nhapeti,2,2,0,0,7
103560,nhāpayati,nhapayati,1,1,0,0,9
103561,nahāpeti,nahapeti,1,1,0,0,8
103562,nahāpayati,nahapayati,1,1,0,0,10
103563,sosāpeti,sosapeti,2,2,0,0,8
103564,sosāpayati,sosapayati,1,1,0,0,10
103565,ghosāpeti,ghosapeti,1,1,0,0,9
103566,ghosāpayati,ghosapayati,1,1,0,0,11
103567,kārantadhāturupāni,karantadhaturupani,1,1,0,0,18
103568,niggacchāpetīti,niggacchapetiti,1,1,0,0,15
103569,etesamattho,etesamattho,2,2,0,0,11
103570,suddhakattubhāvena,suddhakattubhavena,1,1,0,0,18
103571,ñāyoti,nayoti,15,6,9,0,6
103572,pāveti,paveti,1,1,0,0,6
103573,pāvayati,pavayati,1,1,0,0,8
103574,vadāpetīti,vadapetiti,3,3,0,0,10
103575,papubbāya,papubbaya,1,1,0,0,9
103576,kaṅkheti,kankheti,1,1,0,0,8
103577,kaṅkhayati,kankhayati,1,1,0,0,10
103578,kaṅkhāpeti,kankhapeti,1,1,0,0,10
103579,kaṅkhāpayati,kankhapayati,1,1,0,0,12
103580,ācikkhāpeti,acikkhapeti,1,1,0,0,11
103581,ācikkhāpayati,acikkhapayati,1,1,0,0,13
103582,vaṇṇantadhāturūpāni,vannantadhaturupani,1,1,0,0,19
103583,khiyeti,khiyeti,1,1,0,0,7
103584,khiyayati,khiyayati,1,1,0,0,9
103585,milāyeti,milayeti,1,1,0,0,8
103586,milāyayati,milayayati,1,1,0,0,10
103587,ekārantadhāturūpāni,ekarantadhaturupani,1,1,0,0,19
103588,siyeti,siyeti,1,1,0,0,6
103589,siyayati,siyayati,1,1,0,0,8
103590,pabbatāyāyati,pabbatayayati,1,1,0,0,13
103591,puttiyāyati,puttiyayati,1,1,0,0,11
103592,adhātunissitāni,adhatunissitani,1,1,0,0,15
103593,avuttānipi,avuttanipi,4,4,0,0,10
103594,pāḷinayaññunāti,palinayannunati,1,1,0,0,15
103595,kāritapaccayayogo,karitapaccayayogo,1,1,0,0,17
103596,sakāritekakammādīni,sakaritekakammadini,2,1,1,0,19
103597,dvikammā,dvikamma,7,7,0,0,8
103598,kāritapaccaye,karitapaccaye,1,1,0,0,13
103599,paremahiṃ,paremahim,1,1,0,0,9
103600,dvikammikā,dvikammika,3,3,0,0,10
103601,tikammā,tikamma,1,1,0,0,7
103602,sevakaṃ,sevakam,4,4,0,0,7
103603,kammatthadīpakaṃyeva,kammatthadipakamyeva,1,1,0,0,20
103604,gūpaṃ,gupam,1,1,0,0,5
103605,vinindati,vinindati,1,1,0,0,9
103606,paṭirundheti,patirundheti,1,1,0,0,12
103607,buddheti,buddheti,4,2,2,0,8
103608,palibuddheti,palibuddheti,5,1,4,0,12
103609,pagabbati,pagabbati,1,1,0,0,9
103610,katturūpañceva,katturupanceva,1,1,0,0,14
103611,hetukatturūpañca,hetukatturupanca,2,2,0,0,16
103612,kanteti,kanteti,1,1,0,0,7
103613,kantayati,kantayati,1,1,0,0,9
103614,hetukatturūpameva,hetukatturupameva,1,1,0,0,17
103615,suddhakatturūpañceva,suddhakatturupanceva,1,1,0,0,20
103616,miyyatīti,miyyatiti,7,0,7,0,9
103617,kattupadañceva,kattupadanceva,1,1,0,0,14
103618,kammapadañca,kammapadanca,2,2,0,0,12
103619,bhāvethāti,bhavethati,4,1,3,0,10
103620,bahuvacanañceva,bahuvacananceva,1,1,0,0,15
103621,saṃyamissaṃ,samyamissam,5,2,3,0,11
103622,anāgatavacanañceva,anagatavacananceva,1,1,0,0,18
103623,atītavacanañca,atitavacananca,1,1,0,0,14
103624,ākhyātañceva,akhyatanceva,1,1,0,0,12
103625,nāmikañca,namikanca,2,2,0,0,9
103626,nikkhaṇaṃ,nikkhanam,1,0,1,0,9
103627,nāmikañceva,namikanceva,1,1,0,0,11
103628,ākhyātañca,akhyatanca,1,1,0,0,10
103629,nikhaṇaṃ,nikhanam,20,17,3,0,8
103630,parikappavacanaṃ,parikappavacanam,12,11,1,0,16
103631,anāgatādhivacanantipi,anagatadhivacanantipi,1,1,0,0,21
103632,vaṭṭateva,vattateva,24,24,0,0,9
103633,ūhanīyapadāni,uhaniyapadani,1,1,0,0,13
103634,dubbiññeyyavisesāni,dubbinneyyavisesani,1,1,0,0,19
103635,sammohakarāni,sammohakarani,1,1,0,0,13
103636,ācariyapācariye,acariyapacariye,1,1,0,0,15
103637,vedanīyānīti,vedaniyaniti,1,1,0,0,12
103638,ūhanīyarūpagaṇo,uhaniyarupagano,1,1,0,0,15
103639,ekagaṇikādīni,ekaganikadini,1,0,1,0,13
103640,gaṇikavasenāyaṃ,ganikavasenayam,1,1,0,0,15
103641,ekagaṇikā,ekaganika,2,2,0,0,9
103642,saṃvidhāpeti,samvidhapeti,1,1,0,0,12
103643,vidhāpetī,vidhapeti,1,1,0,0,9
103644,anuvidhīyatī,anuvidhiyati,1,1,0,0,12
103645,nidhīyatī,nidhiyati,2,2,0,0,9
103646,dhapiyatīti,dhapiyatiti,1,1,0,0,11
103647,anuvidhiyyati,anuvidhiyyati,4,3,1,0,13
103648,anuvidhiyyanti,anuvidhiyyanti,2,2,0,0,14
103649,anuvidhiyyasi,anuvidhiyyasi,1,1,0,0,13
103650,anuvidhiyyāmī,anuvidhiyyami,1,1,0,0,13
103651,anuvidhiyyasī,anuvidhiyyasi,1,1,0,0,13
103652,pāḷinayānukūlo,palinayanukulo,1,1,0,0,14
103653,nāmikapadatte,namikapadatte,1,1,0,0,13
103654,salakkhaṇadhāraṇato,salakkhanadharanato,5,5,0,0,19
103655,dukkhavidhānato,dukkhavidhanato,1,1,0,0,15
103656,dukkhadhānato,dukkhadhanato,2,2,0,0,13
103657,pathavīdhātādidhātuyo,pathavidhatadidhatuyo,1,1,0,0,21
103658,salakkhaṇadhāraṇatoti,salakkhanadharanatoti,2,0,2,0,21
103659,titthiyaparikappito,titthiyaparikappito,3,3,0,0,19
103660,evamādiko,evamadiko,41,40,1,0,9
103661,evametā,evameta,27,27,0,0,7
103662,dukkhavidhānatoti,dukkhavidhanatoti,1,0,1,0,17
103663,vidahanato,vidahanato,13,13,0,0,10
103664,ayalohādidhātuyo,ayalohadidhatuyo,2,2,0,0,16
103665,ayalohādianekappakāraṃ,ayalohadianekappakaram,1,1,0,0,22
103666,dukkhadhānatoti,dukkhadhanatoti,1,0,1,0,15
103667,anappakassa,anappakassa,2,2,0,0,11
103668,vidhānamattato,vidhanamattato,2,2,0,0,14
103669,avasavattanato,avasavattanato,31,30,1,0,14
103670,kāraṇabhūtāhi,karanabhutahi,6,6,0,0,13
103671,tathāvihitañca,tathavihitanca,5,5,0,0,14
103672,etesveva,etesveva,23,23,0,0,8
103673,nijjīvaṭṭho,nijjivattho,5,2,3,0,11
103674,dhātavoti,dhatavoti,1,1,0,0,9
103675,dhātuyosaṃ,dhatuyosam,1,1,0,0,10
103676,jīvasaññāsamūhanatthaṃ,jivasannasamuhanattham,2,2,0,0,22
103677,dhātudesanaṃ,dhatudesanam,5,5,0,0,12
103678,anuvidhiyyatī,anuvidhiyyati,2,2,0,0,13
103679,tipurisamaṇḍito,tipurisamandito,1,1,0,0,15
103680,ekavacanabahuvacaniko,ekavacanabahuvacaniko,1,1,0,0,21
103681,paṭhamāvibhattippayogo,pathamavibhattippayogo,1,1,0,0,22
103682,tassevānuvidhiyyatī,tassevanuvidhiyyati,3,3,0,0,19
103683,vidhurassa,vidhurassa,44,42,2,0,10
103684,pahīyissantī,pahiyissanti,4,4,0,0,12
103685,giridattanāmakassa,giridattanamakassa,1,1,0,0,18
103686,assagopakassa,assagopakassa,1,1,0,0,13
103687,anukarotīti,anukarotiti,2,1,1,0,11
103688,anuvidadhātī,anuvidadhati,1,1,0,0,12
103689,paṇḍavenā,pandavena,1,1,0,0,9
103690,tatiyantaṃ,tatiyantam,1,1,0,0,10
103691,avacanena,avacanena,6,6,0,0,9
103692,bhāvapadanti,bhavapadanti,2,2,0,0,12
103693,vihita,vihita,2,1,1,0,6
103694,ekanta,ekanta,29,23,6,0,6
103695,dutiyappayoge,dutiyappayoge,1,1,0,0,13
103696,dhanute,dhanute,1,1,0,0,7
103697,tatiyappayoge,tatiyappayoge,1,1,0,0,13
103698,pajahissantī,pajahissanti,2,2,0,0,12
103699,pajahissatī,pajahissati,5,5,0,0,11
103700,pajahiyissantī,pajahiyissanti,2,2,0,0,14
103701,rūpattā,rupatta,7,6,1,0,7
103702,pahāyissantī,pahayissanti,2,2,0,0,12
103703,kattupadarūpaṃ,kattupadarupam,1,1,0,0,14
103704,ājañño,ajanno,17,14,3,0,6
103705,akammakassa,akammakassa,1,1,0,0,11
103706,kattupadarūpassa,kattupadarupassa,1,1,0,0,16
103707,aggijāhi,aggijahi,1,1,0,0,8
103708,kammeyeva,kammeyeva,7,7,0,0,9
103709,kammakattuvasena,kammakattuvasena,3,3,0,0,16
103710,kariyateti,kariyateti,3,3,0,0,10
103711,sakammakadhāturūpāni,sakammakadhaturupani,1,1,0,0,20
103712,ṭhitabhāvo,thitabhavo,10,10,0,0,10
103713,adabbavuttino,adabbavuttino,3,3,0,0,13
103714,bhāvassekattā,bhavassekatta,3,3,0,0,13
103715,paṭhamapurisasseva,pathamapurisasseva,2,2,0,0,18
103716,payogañca,payoganca,21,20,1,0,9
103717,tadatthayojanañca,tadatthayojananca,1,1,0,0,17
103718,aṭṭhakathādīhi,atthakathadihi,1,1,0,0,14
103719,jariyyati,jariyyati,2,2,0,0,9
103720,sādhāraṇarūpavibhāvanā,sadharanarupavibhavana,1,1,0,0,22
103721,jariyyatī,jariyyati,1,1,0,0,9
103722,jariyyatīti,jariyyatiti,1,0,1,0,11
103723,tejogatena,tejogatena,4,4,0,0,10
103724,kupitena,kupitena,22,22,0,0,8
103725,ekāhikādijararogena,ekahikadijararogena,3,3,0,0,19
103726,jariyati,jariyati,1,0,1,0,8
103727,indriyavekalyataṃ,indriyavekalyatam,1,1,0,0,17
103728,balakkhayaṃ,balakkhayam,2,2,0,0,11
103729,palitavalitādiñca,palitavalitadinca,1,1,0,0,17
103730,gaṇikoyaṃ,ganikoyam,1,1,0,0,9
103731,kammarahitappayogānaṃ,kammarahitappayoganam,1,1,0,0,21
103732,akammakoyevāti,akammakoyevati,1,1,0,0,14
103733,atthayojanānayena,atthayojananayena,2,2,0,0,17
103734,cajatīti,cajatiti,2,2,0,0,8
103735,miyatī,miyati,1,1,0,0,6
103736,mārāpayatī,marapayati,1,1,0,0,10
103737,kāritapadasaṅkhātāni,karitapadasankhatani,1,1,0,0,20
103738,mārāpayatīti,marapayatiti,1,1,0,0,12
103739,māriyati,mariyati,2,2,0,0,8
103740,mārāpiyatīti,marapiyatiti,1,1,0,0,12
103741,bhāvapadamappasiddhaṃ,bhavapadamappasiddham,1,1,0,0,21
103742,pasiddhatā,pasiddhata,1,1,0,0,10
103743,appasiddhatā,appasiddhata,1,1,0,0,12
103744,ekagaṇiko,ekaganiko,1,1,0,0,9
103745,saṅkhādati,sankhadati,3,3,0,0,10
103746,pūvaṃ,puvam,112,111,1,0,5
103747,khādeti,khadeti,3,2,1,0,7
103748,khādāpeti,khadapeti,12,12,0,0,9
103749,khādāpayati,khadapayati,1,1,0,0,11
103750,akhādantaṃ,akhadantam,1,1,0,0,10
103751,khādantaṃ,khadantam,15,15,0,0,9
103752,khādāhīti,khadahiti,3,3,0,0,9
103753,khādāpako,khadapako,1,1,0,0,9
103754,khādāpayatīti,khadapayatiti,1,1,0,0,13
103755,saṃkhajjati,samkhajjati,1,1,0,0,11
103756,saṅkhādiyati,sankhadiyati,1,1,0,0,12
103757,atrapanāyaṃ,atrapanayam,1,1,0,0,11
103758,pāhaṃ,paham,10,10,0,0,5
103759,khajjiṃ,khajjim,8,8,0,0,7
103760,seyyathāpāhaṃ,seyyathapaham,9,8,1,0,13
103761,khajjāmi,khajjami,22,21,1,0,8
103762,abhinandeyyaṃ,abhinandeyyam,8,8,0,0,13
103763,anāgatenapāhaṃ,anagatenapaham,2,2,0,0,14
103764,khajjeyyaṃ,khajjeyyam,7,7,0,0,10
103765,seyyathāpetarahi,seyyathapetarahi,2,2,0,0,16
103766,khajjāmī,khajjami,8,8,0,0,8
103767,sakammakattā,sakammakatta,7,7,0,0,12
103768,gaṇikoti,ganikoti,1,1,0,0,8
103769,santāyati,santayati,1,1,0,0,9
103770,bhāvapadañca,bhavapadanca,1,1,0,0,12
103771,visujjhati,visujjhati,239,228,11,0,10
103772,sodhayati,sodhayati,2,2,0,0,9
103773,sodhāpayati,sodhapayati,1,1,0,0,11
103774,asuddhaṃ,asuddham,26,24,2,0,8
103775,sodhayatīti,sodhayatiti,1,1,0,0,11
103776,asuddhaṭṭhānaṃ,asuddhatthanam,1,1,0,0,14
103777,asodhetvā,asodhetva,16,16,0,0,9
103778,sodhehī,sodhehi,7,7,0,0,7
103779,sodhāpako,sodhapako,1,1,0,0,9
103780,sodhāpayatīti,sodhapayatiti,1,1,0,0,13
103781,labbhamānanayo,labbhamananayo,1,1,0,0,14
103782,alabbhamānanayo,alabbhamananayo,1,1,0,0,15
103783,paccantadesavisaye,paccantadesavisaye,8,8,0,0,18
103784,nimantetvā,nimantetva,334,333,1,0,10
103785,tuṭṭhamānasā,tutthamanasa,58,58,0,0,12
103786,pilindavaccho,pilindavaccho,60,60,0,0,13
103787,pabbhāraṃ,pabbharam,38,33,5,0,9
103788,sodhāpemi,sodhapemi,3,3,0,0,9
103789,kattakāmo,kattakamo,1,1,0,0,9
103790,sodhāpanaṃ,sodhapanam,1,1,0,0,10
103791,sodhiyati,sodhiyati,2,2,0,0,9
103792,dvigaṇikatte,dviganikatte,1,0,1,0,12
103793,sumbhotī,sumbhoti,1,1,0,0,8
103794,sobheti,sobheti,8,8,0,0,7
103795,sobhayati,sobhayati,2,2,0,0,9
103796,sumbheti,sumbheti,2,2,0,0,8
103797,sumbhayati,sumbhayati,1,1,0,0,10
103798,sumbhāpeti,sumbhapeti,1,1,0,0,10
103799,sumbhāpayati,sumbhapayati,1,1,0,0,12
103800,kammabhāvapadāni,kammabhavapadani,1,1,0,0,16
103801,bhūvādirudhādi,bhuvadirudhadi,1,0,1,0,14
103802,gaṇikarūpāni,ganikarupani,2,2,0,0,12
103803,paripaccanti,paripaccanti,4,4,0,0,12
103804,pakkāni,pakkani,15,15,0,0,7
103805,duveti,duveti,36,20,16,0,6
103806,dvigaṇikarūpassa,dviganikarupassa,1,1,0,0,16
103807,sakammakattaṃ,sakammakattam,3,3,0,0,13
103808,apacci,apacci,9,9,0,0,6
103809,akammakattaṃyeva,akammakattamyeva,1,1,0,0,16
103810,gaṇikarūpassapi,ganikarupassapi,1,1,0,0,15
103811,bhittiṃ,bhittim,104,97,7,0,7
103812,rūpapadānaṃ,rupapadanam,1,1,0,0,11
103813,sakammakattepi,sakammakattepi,2,2,0,0,14
103814,pattānaṃ,pattanam,98,93,5,0,8
103815,rūpapadāni,rupapadani,2,2,0,0,10
103816,akammakāniyeva,akammakaniyeva,2,2,0,0,14
103817,rūpapadassa,rupapadassa,6,6,0,0,11
103818,vipaccantī,vipaccanti,10,10,0,0,10
103819,āsavehi,asavehi,244,229,15,0,7
103820,vimucciṃsū,vimuccimsu,10,10,0,0,10
103821,āsavato,asavato,1,1,0,0,7
103822,akammakattañca,akammakattanca,1,1,0,0,14
103823,sakammakattañca,sakammakattanca,1,1,0,0,15
103824,akammakattenapi,akammakattenapi,1,1,0,0,15
103825,sakammakattenapi,sakammakattenapi,1,1,0,0,16
103826,akammakatteneva,akammakatteneva,1,1,0,0,15
103827,sakammakattena,sakammakattena,1,1,0,0,14
103828,vuttappayogānaṃ,vuttappayoganam,1,1,0,0,15
103829,asamānattā,asamanatta,13,12,1,0,10
103830,kammarahitakattuvācaka,kammarahitakattuvacaka,1,1,0,0,22
103831,paccayantampi,paccayantampi,2,2,0,0,13
103832,kattusahitakammavācaka,kattusahitakammavacaka,1,1,0,0,22
103833,kammarahita,kammarahita,1,1,0,0,11
103834,paccayavantattā,paccayavantatta,1,1,0,0,15
103835,āsavehī,asavehi,3,3,0,0,7
103836,apādānakārakavācakaṃ,apadanakarakavacakam,1,1,0,0,20
103837,kattukārakavācakaṃ,kattukarakavacakam,3,3,0,0,18
103838,kattusahitakammavācakattā,kattusahitakammavacakatta,1,1,0,0,25
103839,kammakārakavācakaṃ,kammakarakavacakam,3,3,0,0,18
103840,vuttappayogesu,vuttappayogesu,1,1,0,0,14
103841,pācāpayatī,pacapayati,1,1,0,0,10
103842,anante,anante,7,7,0,0,6
103843,bodhisambhāre,bodhisambhare,16,16,0,0,13
103844,paripācesi,paripacesi,7,7,0,0,10
103845,paripāceti,paripaceti,40,34,6,0,10
103846,paripācayatī,paripacayati,1,1,0,0,12
103847,bhūvādidivādi,bhuvadidivadi,1,0,1,0,13
103848,dvigaṇikarūpāni,dviganikarupani,1,1,0,0,15
103849,tegaṇikatte,teganikatte,1,0,1,0,11
103850,hetuphalaṃ,hetuphalam,37,33,4,0,10
103851,paccāmittaṃ,paccamittam,23,23,0,0,11
103852,sunāti,sunati,1,1,0,0,6
103853,bhūvādisvādikiyādi,bhuvadisvadikiyadi,1,0,1,0,18
103854,gaṇikāni,ganikani,1,1,0,0,8
103855,saviyyati,saviyyati,1,1,0,0,9
103856,yodhena,yodhena,2,2,0,0,7
103857,suniyyati,suniyyati,1,1,0,0,9
103858,tegaṇikarūpāni,teganikarupani,1,1,0,0,14
103859,nayavibhāvanā,nayavibhavana,1,1,0,0,13
103860,bhvādirudhādi,bhvadirudhadi,1,0,1,0,13
103861,svādidivādi,svadidivadi,1,0,1,0,11
103862,rudhādikadivādiṭṭhā,rudhadikadivadittha,1,0,1,0,19
103863,bhūvādikacurādi,bhuvadikacuradi,1,0,1,0,15
103864,bhūvādikagahādiṭṭhā,bhuvadikagahadittha,1,0,1,0,19
103865,bhvādisvādikiyādi,bhvadisvadikiyadi,1,0,1,0,17
103866,evamādippabhedehi,evamadippabhedehi,1,1,0,0,17
103867,vitthārentu,vittharentu,1,1,0,0,11
103868,ekagaṇikadvigaṇikategaṇikavasena,ekaganikadviganikateganikavasena,1,1,0,0,32
103869,suddhakattuhetukattukammabhāvapadāni,suddhakattuhetukattukammabhavapadani,1,1,0,0,36
103870,sakāritekakammāni,sakaritekakammani,1,1,0,0,17
103871,sakāritadvikammāni,sakaritadvikammani,1,1,0,0,18
103872,sakāritatikammāni,sakaritatikammani,1,1,0,0,17
103873,ekakāritadvikāritapadānaṃ,ekakaritadvikaritapadanam,1,0,1,0,25
103874,vacanokāso,vacanokaso,12,12,0,0,10
103875,pariyosiyati,pariyosiyati,1,1,0,0,12
103876,pariyosiyatīti,pariyosiyatiti,1,0,1,0,14
103877,iccupasaggavasena,iccupasaggavasena,3,3,0,0,17
103878,vippakataṃ,vippakatam,108,98,10,0,10
103879,pariyosāpeti,pariyosapeti,92,92,0,0,12
103880,mekaṃ,mekam,3,2,1,0,5
103881,pariava,pariava,1,0,1,0,7
103882,laddhakāritapaccayattā,laddhakaritapaccayatta,2,2,0,0,22
103883,ekakammameva,ekakammameva,1,1,0,0,12
103884,sakāritapadaṃ,sakaritapadam,2,2,0,0,13
103885,pariyosāvāpeti,pariyosavapeti,6,6,0,0,14
103886,dvikāritaṃ,dvikaritam,1,0,1,0,10
103887,laddhakāritapaccayadvayattā,laddhakaritapaccayadvayatta,1,1,0,0,27
103888,dvikammakaṃ,dvikammakam,1,1,0,0,11
103889,pariyosāvāpetī,pariyosavapeti,2,2,0,0,14
103890,paccayadvayaṃ,paccayadvayam,3,3,0,0,13
103891,kārāgamañca,karagamanca,1,1,0,0,11
103892,anubandha,anubandha,2,2,0,0,9
103893,kāralopañca,karalopanca,1,1,0,0,11
103894,paṭhamapaccaye,pathamapaccaye,1,1,0,0,14
103895,pubbasaralopaṃ,pubbasaralopam,1,1,0,0,14
103896,nipphajjatīti,nipphajjatiti,27,27,0,0,13
103897,āhaccadesitākārena,ahaccadesitakarena,1,1,0,0,18
103898,saṅghādisesassa,sanghadisesassa,429,429,0,0,15
103899,saṅghādisesassā,sanghadisesassa,28,26,2,0,15
103900,ānetabbaṃ,anetabbam,7,7,0,0,9
103901,attanāti,attanati,37,2,35,0,8
103902,vippakaraṇakriyāya,vippakaranakriyaya,1,1,0,0,18
103903,pariyosāpetīti,pariyosapetiti,5,1,4,0,14
103904,abyayapadabhūtena,abyayapadabhutena,1,1,0,0,17
103905,abyayapadaṃ,abyayapadam,4,4,0,0,11
103906,saddasadisaṃ,saddasadisam,4,4,0,0,12
103907,tatiyāvibhatyantaṃ,tatiyavibhatyantam,1,1,0,0,18
103908,pariyosāpetī,pariyosapeti,6,6,0,0,12
103909,pāṇātipātī,panatipati,156,150,6,0,10
103910,pariyosāvāpetīti,pariyosavapetiti,1,0,1,0,16
103911,parehīti,parehiti,12,1,11,0,8
103912,karaṇavacananti,karanavacananti,24,24,0,0,15
103913,sunakhehī,sunakhehi,1,1,0,0,9
103914,acchariyabbhutanayavicitte,acchariyabbhutanayavicitte,1,1,0,0,26
103915,dvikāritapaccayavantampi,dvikaritapaccayavantampi,1,1,0,0,24
103916,padamatthīti,padamatthiti,1,1,0,0,12
103917,pakaraṇaṃ,pakaranam,148,145,3,0,9
103918,tesaññeva,tesanneva,209,204,5,0,9
103919,matīti,matiti,4,3,1,0,6
103920,akāritadvikammikapadānaṃ,akaritadvikammikapadanam,1,0,1,0,24
103921,duhikaravahipucchi,duhikaravahipucchi,1,0,1,0,18
103922,bhikkhi,bhikkhi,2,1,1,0,7
103923,nibrūti,nibruti,1,0,1,0,7
103924,bhaṇivadivacibhāsi,bhanivadivacibhasi,1,0,1,0,18
103925,sāsidahināthadhātu,sasidahinathadhatu,1,0,1,0,18
103926,pabhutīti,pabhutiti,20,2,18,0,9
103927,pavadumapi,pavadumapi,1,1,0,0,10
103928,kāritappaccayehi,karitappaccayehi,1,1,0,0,16
103929,apādānādike,apadanadike,1,1,0,0,11
103930,pubbavidhimhā,pubbavidhimha,1,1,0,0,13
103931,sahime,sahime,1,1,0,0,6
103932,nimittanti,nimittanti,59,58,1,0,10
103933,sanantanā,sanantana,5,4,1,0,9
103934,duhā,duha,1,0,1,0,4
103935,tikammāpi,tikammapi,1,1,0,0,9
103936,gopāladārako,gopaladarako,3,3,0,0,12
103937,majjeyyā,majjeyya,1,1,0,0,8
103938,manogaṇikassa,manoganikassa,1,1,0,0,13
103939,aññādisampi,annadisampi,1,1,0,0,11
103940,gopālaṃ,gopalam,1,1,0,0,7
103941,duhāpeti,duhapeti,2,2,0,0,8
103942,gopālena,gopalena,3,2,1,0,8
103943,duhatīti,duhatiti,3,1,2,0,8
103944,apādānavisayattā,apadanavisayatta,1,1,0,0,16
103945,dvikammakabhāvo,dvikammakabhavo,4,4,0,0,15
103946,visāṇato,visanato,7,7,0,0,8
103947,duhaṃ,duham,1,1,0,0,5
103948,apādānavisayattepi,apadanavisayattepi,1,1,0,0,18
103949,gavāvayavabhūtassa,gavavayavabhutassa,1,1,0,0,18
103950,visāṇassa,visanassa,1,1,0,0,9
103951,duhanto,duhanto,3,3,0,0,7
103952,dvikammikabhāvo,dvikammikabhavo,2,2,0,0,15
103953,duhino,duhino,1,0,1,0,6
103954,payogoyaṃ,payogoyam,2,2,0,0,9
103955,kaṭṭhamaṅgāraṃ,katthamangaram,5,5,0,0,14
103956,aṅgāraṃ,angaram,27,24,3,0,7
103957,pariccattakāraṇavasena,pariccattakaranavasena,1,1,0,0,22
103958,kaṭṭhañhi,katthanhi,2,2,0,0,9
103959,aṅgārabhāvassa,angarabhavassa,1,1,0,0,14
103960,kaṭṭhabhāvo,katthabhavo,1,1,0,0,11
103961,apariccattakāraṇavasena,apariccattakaranavasena,1,1,0,0,23
103962,suvaṇṇañhi,suvannanhi,2,2,0,0,10
103963,kaṭakabhāvassa,katakabhavassa,1,1,0,0,14
103964,kārakabhūtassa,karakabhutassa,2,2,0,0,14
103965,suvaṇṇabhāvo,suvannabhavo,12,12,0,0,12
103966,visesantaruppattibhāvena,visesantaruppattibhavena,1,1,0,0,24
103967,ṭhānantaradānavasena,thanantaradanavasena,1,1,0,0,20
103968,uparājaṃ,uparajam,7,6,1,0,8
103969,karomī,karomi,209,208,1,0,6
103970,tikammikappayogopi,tikammikappayogopi,1,1,0,0,18
103971,kārente,karente,429,428,1,0,7
103972,dvikammakappayogo,dvikammakappayogo,1,1,0,0,17
103973,kenāyaṃ,kenayam,21,20,1,0,7
103974,dvikammikappayogo,dvikammikappayogo,1,1,0,0,17
103975,kāretīti,karetiti,98,86,12,0,8
103976,rājabhāvaṃ,rajabhavam,24,23,1,0,10
103977,kārayatīti,karayatiti,6,6,0,0,10
103978,kārāpehi,karapehi,1,1,0,0,8
103979,abhisiñcāpehi,abhisincapehi,1,1,0,0,13
103980,abhisiñcitukāmāti,abhisincitukamati,1,1,0,0,17
103981,samatthito,samatthito,8,8,0,0,10
103982,kārenteti,karenteti,3,1,2,0,9
103983,kārayanteti,karayanteti,1,1,0,0,11
103984,kāritavisaye,karitavisaye,1,1,0,0,12
103985,upayogatthaññeva,upayogatthanneva,1,1,0,0,16
103986,cakkhundriyādinibbacanatthavibhāvanāya,cakkhundriyadinibbacanatthavibhavanaya,1,1,0,0,38
103987,cakkhudvāre,cakkhudvare,157,146,11,0,11
103988,cakkhudvārabhāve,cakkhudvarabhave,3,3,0,0,16
103989,taṃdvārikehi,tamdvarikehi,3,3,0,0,12
103990,indabhāvaṃ,indabhavam,3,3,0,0,10
103991,paramissarabhāvaṃ,paramissarabhavam,3,3,0,0,17
103992,rūpaggahaṇe,rupaggahane,6,6,0,0,11
103993,anuvatteti,anuvatteti,9,9,0,0,10
103994,anuvattantī,anuvattanti,3,2,1,0,11
103995,dvikammako,dvikammako,7,6,1,0,10
103996,tikammakehiyeva,tikammakehiyeva,1,1,0,0,15
103997,kammārena,kammarena,2,2,0,0,9
103998,evampettha,evampettha,105,105,0,0,10
103999,dvikammakappayogā,dvikammakappayoga,1,1,0,0,17
104000,pavattakaraṇavisayattā,pavattakaranavisayatta,1,1,0,0,22
104001,vahi,vahi,4,3,1,0,4
104002,rājapurisā,rajapurisa,103,103,0,0,10
104003,parābhavantaṃ,parabhavantam,8,6,2,0,13
104004,mahākassapena,mahakassapena,37,37,0,0,13
104005,āyācito,ayacito,48,48,0,0,7
104006,dhammadesanaṃ,dhammadesanam,1397,1383,14,0,13
104007,akathitakammaṃ,akathitakammam,4,3,1,0,14
104008,sampadānavisayattā,sampadanavisayatta,1,1,0,0,18
104009,anusāsasi,anusasasi,11,10,1,0,9
104010,dhuttajanaṃ,dhuttajanam,1,1,0,0,11
104011,kamanuttaraṃ,kamanuttaram,4,3,1,0,12
104012,ratnavaraṃ,ratnavaram,2,2,0,0,10
104013,jināmā,jinama,2,2,0,0,6
104014,puṇṇakajātakapāḷi,punnakajatakapali,1,0,1,0,17
104015,tatthāyamattho,tatthayamattho,6,6,0,0,14
104016,iṭṭhakāyo,itthakayo,7,7,0,0,9
104017,gandhakuṭiṃ,gandhakutim,161,155,6,0,11
104018,upāsakaṃ,upasakam,239,229,10,0,8
104019,dhāretū,dharetu,49,48,1,0,7
104020,adhippāyena,adhippayena,510,507,3,0,11
104021,bhajāmi,bhajami,7,7,0,0,7
104022,sevāmi,sevami,14,14,0,0,6
104023,bujjhāmī,bujjhami,3,3,0,0,8
104024,dhātuppayogena,dhatuppayogena,1,1,0,0,14
104025,adhippāyatthato,adhippayatthato,2,2,0,0,15
104026,dvikammikadhāturūpāni,dvikammikadhaturupani,1,1,0,0,21
104027,iccevamamhehi,iccevamamhehi,1,1,0,0,13
104028,taṃrūpāni,tamrupani,1,1,0,0,9
104029,nānāatthehi,nanaatthehi,1,1,0,0,11
104030,vibhāventehipi,vibhaventehipi,1,1,0,0,14
104031,sarūpaparicchedo,sarupaparicchedo,1,1,0,0,16
104032,atthaparicchedo,atthaparicchedo,1,1,0,0,15
104033,tadubhayañhi,tadubhayanhi,3,3,0,0,12
104034,āgamādhigamasampannehi,agamadhigamasampannehi,1,1,0,0,22
104035,atthātisayayuttāpi,atthatisayayuttapi,1,1,0,0,18
104036,yenekatthadharā,yenekatthadhara,1,1,0,0,15
104037,tenekatthadharāva,tenekatthadharava,1,1,0,0,17
104038,nānūpasaggehive,nanupasaggehive,1,1,0,0,15
104039,tesamatthaparamaṃ,tesamatthaparamam,1,1,0,0,17
104040,paṭisambhidāmatiyute,patisambhidamatiyute,1,1,0,0,20
104041,sabbagaṇavinicchayo,sabbaganavinicchayo,1,1,0,0,19
104042,ekūnavīsatimo,ekunavisatimo,24,24,0,0,13
104043,rūpavibhāvanāya,rupavibhavanaya,1,0,1,0,15
104044,dhātuvibhāvanā,dhatuvibhavana,1,0,1,0,14
104045,padarūpasiddhi,padarupasiddhi,1,1,0,0,14
104046,visuddhasaddhammasahassadīdhitiṃ,visuddhasaddhammasahassadidhitim,1,1,0,0,32
104047,subuddhasambodhiyugandharoditaṃ,subuddhasambodhiyugandharoditam,1,1,0,0,31
104048,tibuddhakhettekadivākaraṃ,tibuddhakhettekadivakaram,1,1,0,0,25
104049,bhivandiya,bhivandiya,3,3,0,0,10
104050,kaccāyanañcācariyaṃ,kaccayanancacariyam,1,1,0,0,19
104051,kaccāyanavaṇṇanādiṃ,kaccayanavannanadim,1,1,0,0,19
104052,bālappabodhatthamujuṃ,balappabodhatthamujum,1,1,0,0,21
104053,sukaṇḍaṃ,sukandam,1,1,0,0,8
104054,padarūpasiddhiṃ,padarupasiddhim,1,0,1,0,15
104055,sandhikaṇḍa,sandhikanda,2,2,0,0,11
104056,jinasāsanādhigamassa,jinasasanadhigamassa,1,1,0,0,20
104057,akkharakosallamūlakattā,akkharakosallamulakatta,1,1,0,0,23
104058,sampādetabbanti,sampadetabbanti,6,6,0,0,15
104059,abhidheyyappayojanavākyamidamuccate,abhidheyyappayojanavakyamidamuccate,1,1,0,0,35
104060,lokiyalokuttarādibhedo,lokiyalokuttaradibhedo,1,1,0,0,22
104061,sithiladhanitādiakkharavipattiyañhi,sithiladhanitadiakkharavipattiyanhi,1,1,0,0,35
104062,dunnayatā,dunnayata,2,2,0,0,9
104063,padānipi,padanipi,2,2,0,0,8
104064,akkharasannipātarūpattā,akkharasannipatarupatta,1,1,0,0,23
104065,akkharesveva,akkharesveva,1,1,0,0,12
104066,sampādeyya,sampadeyya,10,10,0,0,10
104067,hitatthiko,hitatthiko,5,5,0,0,10
104068,uṭṭhānādīhi,utthanadihi,4,4,0,0,11
104069,saññāvidhāna,sannavidhana,1,1,0,0,12
104070,tatthādo,tatthado,3,3,0,0,8
104071,saddalakkhaṇe,saddalakkhane,2,2,0,0,13
104072,vohāraviññāpanatthaṃ,voharavinnapanattham,1,1,0,0,20
104073,saññāvidhānamārabhīyate,sannavidhanamarabhiyate,1,1,0,0,23
104074,jinavacanānurūpā,jinavacananurupa,2,2,0,0,16
104075,ekacattālīsamattā,ekacattalisamatta,1,1,0,0,17
104076,lava,lava,7,6,1,0,4
104077,nakkharantīti,nakkharantiti,1,1,0,0,13
104078,akārādīnamanukkamo,akaradinamanukkamo,1,1,0,0,18
104079,ṭhānādikkamasannissito,thanadikkamasannissito,2,2,0,0,22
104080,ṭhānakaraṇappayatanehi,thanakaranappayatanehi,1,1,0,0,22
104081,jāyante,jayante,49,46,3,0,7
104082,kaṇṭhatālumuddhadantaoṭṭhanāsikāvasena,kanthatalumuddhadantaotthanasikavasena,1,1,0,0,38
104083,kaṇṭhajā,kanthaja,2,0,2,0,8
104084,nāsikaṭṭhānajaṃ,nasikatthanajam,1,0,1,0,15
104085,sakaṭṭhānajā,sakatthanaja,1,0,1,0,12
104086,nāsikaṭṭhānajā,nasikatthanaja,1,0,1,0,14
104087,pañcameheva,pancameheva,3,3,0,0,11
104088,antaṭṭhāhi,antatthahi,3,3,0,0,10
104089,orasanti,orasanti,1,1,0,0,8
104090,vadantettha,vadantettha,1,1,0,0,11
104091,kaṇṭhajaṃ,kanthajam,1,1,0,0,9
104092,tadasaṃyutaṃ,tadasamyutam,1,1,0,0,12
104093,jivhāmajjhaṃ,jivhamajjham,3,3,0,0,12
104094,tālujānaṃ,talujanam,3,3,0,0,9
104095,jivhopaggaṃ,jivhopaggam,4,4,0,0,11
104096,muddhajānaṃ,muddhajanam,3,3,0,0,11
104097,jivhāggaṃ,jivhaggam,1,1,0,0,9
104098,dantajānaṃ,dantajanam,3,3,0,0,10
104099,sakaṭṭhānakaraṇā,sakatthanakarana,1,1,0,0,16
104100,saṃvutādikaraṇaviseso,samvutadikaranaviseso,2,2,0,0,21
104101,saṃvutatta,samvutatta,2,2,0,0,10
104102,vivaṭattaṃ,vivatattam,3,3,0,0,10
104103,sesasarānaṃ,sesasaranam,2,2,0,0,11
104104,kārānañca,karananca,1,1,0,0,9
104105,phuṭṭhaṃ,phuttham,52,50,2,0,8
104106,īsaṃphuṭṭhaṃ,isamphuttham,1,1,0,0,12
104107,yaralavānanti,yaralavananti,1,1,0,0,13
104108,ṭhānakaraṇappayatanasutikālabhinnesu,thanakaranappayatanasutikalabhinnesu,1,1,0,0,36
104109,nissayā,nissaya,59,55,4,0,7
104110,nissayādo,nissayado,1,1,0,0,9
104111,vaggekajā,vaggekaja,1,1,0,0,9
104112,bahuttādo,bahuttado,1,1,0,0,9
104113,ṭhānalahukkamā,thanalahukkama,1,1,0,0,14
104114,ṭhānānaṃ,thananam,31,27,4,0,8
104115,paṭipāṭivasāpi,patipativasapi,1,1,0,0,14
104116,nissayādippabhedehi,nissayadippabhedehi,1,1,0,0,19
104117,tesamanukkamo,tesamanukkamo,1,1,0,0,13
104118,ekenādhikā,ekenadhika,1,1,0,0,10
104119,gaṇanaparicchedena,gananaparicchedena,4,4,0,0,18
104120,adhikakkharavantāni,adhikakkharavantani,1,1,0,0,19
104121,ekatālīsato,ekatalisato,1,1,0,0,11
104122,buddhavacanānīti,buddhavacananiti,1,1,0,0,16
104123,dīpetācariyāsabho,dipetacariyasabho,1,1,0,0,17
104124,apekkhākaraṇatthaṃ,apekkhakaranattham,1,1,0,0,18
104125,oiti,oiti,5,5,0,0,4
104126,odantā,odanta,4,3,1,0,6
104127,sārentītipi,sarentitipi,1,1,0,0,11
104128,lahukā,lahuka,53,51,2,0,6
104129,accharāsaṅghātaakkhinimīlanasaṅkhātaṃ,accharasanghataakkhinimilanasankhatam,1,1,0,0,37
104130,mattāya,mattaya,87,83,4,0,7
104131,kamattā,kamatta,1,1,0,0,7
104132,dvimattā,dvimatta,3,3,0,0,8
104133,aḍḍhamattā,addhamatta,2,2,0,0,10
104134,diyaḍḍhamattassāpi,diyaddhamattassapi,1,1,0,0,18
104135,rassakālayogato,rassakalayogato,1,1,0,0,15
104136,rassakālavanto,rassakalavanto,1,1,0,0,14
104137,sararassa,sararassa,1,0,1,0,9
104138,ggahaṇāni,ggahanani,2,2,0,0,9
104139,diyaḍḍhamattikānampi,diyaddhamattikanampi,1,1,0,0,20
104140,dīghakāle,dighakale,4,4,0,0,9
104141,tabbanto,tabbanto,1,1,0,0,8
104142,saṃyogapubbā,samyogapubba,3,3,0,0,12
104143,ekārokārā,ekarokara,3,3,0,0,9
104144,saṃyogabhūte,samyogabhute,1,1,0,0,12
104145,rassakkharo,rassakkharo,1,1,0,0,11
104146,garusañño,garusanno,2,2,0,0,9
104147,garukato,garukato,86,84,2,0,8
104148,lahuko,lahuko,47,43,4,0,6
104149,byañjīyati,byanjiyati,7,7,0,0,10
104150,kārādīsvakāro,karadisvakaro,1,1,0,0,13
104151,pañcapañcavibhāgena,pancapancavibhagena,1,1,0,0,19
104152,maiti,maiti,1,1,0,0,5
104153,paṭhamakkharavasena,pathamakkharavasena,3,3,0,0,19
104154,vaggādivohāraṃ,vaggadivoharam,1,1,0,0,14
104155,pañcapañcavibhāgenāti,pancapancavibhagenati,1,1,0,0,21
104156,panānantaravuttanidassanattho,pananantaravuttanidassanattho,1,1,0,0,29
104157,rassassaraṃ,rassassaram,1,1,0,0,11
104158,niggahetvā,niggahetva,102,102,0,0,10
104159,niggahetvāna,niggahetvana,2,2,0,0,12
104160,mukhenāvivaṭena,mukhenavivatena,1,1,0,0,15
104161,sarānugaṃ,saranugam,2,2,0,0,9
104162,avuttānaṃ,avuttanam,20,17,3,0,9
104163,parasamaññānampi,parasamannanampi,1,1,0,0,16
104164,paribhāsamāha,paribhasamaha,7,7,0,0,13
104165,sakkataganthe,sakkataganthe,1,1,0,0,13
104166,ghosāghosalopasavaṇṇasaṃyogaliṅgādikā,ghosaghosalopasavannasamyogalingadika,1,1,0,0,37
104167,veyyākaraṇe,veyyakarane,20,19,1,0,11
104168,veyyākaraṇamadhītānaṃ,veyyakaranamadhitanam,1,1,0,0,21
104169,samaññātyattho,samannatyattho,1,1,0,0,14
104170,payujjanaṃ,payujjanam,2,2,0,0,10
104171,viniyogo,viniyogo,2,2,0,0,8
104172,tatiyacatutthapañcamā,tatiyacatutthapancama,4,3,1,0,21
104173,dutiyacatutthā,dutiyacatuttha,5,5,0,0,14
104174,dhanitā,dhanita,4,2,2,0,7
104175,sithilāti,sithilati,1,0,1,0,9
104176,rassassarā,rassassara,1,1,0,0,10
104177,sakadīghehi,sakadighehi,1,1,0,0,11
104178,sarānantaritāni,saranantaritani,2,2,0,0,15
104179,dhātuppaccayavibhattivajjitamatthavaṃ,dhatuppaccayavibhattivajjitamatthavam,3,3,0,0,37
104180,vibhatyantaṃ,vibhatyantam,7,7,0,0,12
104181,saññāvidhānaṃ,sannavidhanam,3,3,0,0,13
104182,sarasandhividhāna,sarasandhividhana,1,1,0,0,17
104183,upaṭṭhānaṃ,upatthanam,589,516,73,0,10
104184,itīdha,itidha,63,63,0,0,6
104185,sarādisaññāyaṃ,saradisannayam,1,1,0,0,14
104186,sabbasandhikaraṇaṭṭhāne,sabbasandhikaranatthane,1,1,0,0,23
104187,byañjanaviyojanatthaṃ,byanjanaviyojanattham,1,1,0,0,21
104188,sarenāti,sarenati,1,0,1,0,8
104189,sahayoge,sahayoge,22,22,0,0,8
104190,sandhitabbe,sandhitabbe,1,1,0,0,11
104191,sarasahitaṃ,sarasahitam,1,1,0,0,11
104192,anatikkamanto,anatikkamanto,7,7,0,0,13
104193,adhoṭhitamassarañca,adhothitamassaranca,1,1,0,0,19
104194,viyojayeti,viyojayeti,4,1,3,0,10
104195,viyojetabbaṃ,viyojetabbam,3,3,0,0,12
104196,assara,assara,1,0,1,0,6
104197,ggahaṇasāmatthiyena,ggahanasamatthiyena,1,1,0,0,19
104198,lopoti,lopoti,20,19,1,0,6
104199,anuccāraṇaṃ,anuccaranam,8,7,1,0,11
104200,kāriyīniddeso,kariyiniddeso,2,2,0,0,13
104201,lopañāpanatthaṃ,lopanapanattham,1,1,0,0,15
104202,nimittaniddeso,nimittaniddeso,1,1,0,0,14
104203,nimittasattamī,nimittasattami,2,2,0,0,14
104204,nimittopādānasāmatthiyato,nimittopadanasamatthiyato,1,1,0,0,25
104205,sandhikāriyaṃ,sandhikariyam,2,2,0,0,13
104206,kāriyaniddeso,kariyaniddeso,2,2,0,0,13
104207,paralopavidhānato,paralopavidhanato,1,1,0,0,17
104208,pubbalopavidhānanti,pubbalopavidhananti,1,1,0,0,19
104209,vidhānanti,vidhananti,11,11,0,0,10
104210,sararahitaṃ,sararahitam,1,1,0,0,11
104211,paranayanaṃ,paranayanam,3,3,0,0,11
104212,yutta,yutta,8,7,1,0,5
104213,niggahītanisedhanatthaṃ,niggahitanisedhanattham,1,1,0,0,23
104214,paranayanasandeho,paranayanasandeho,1,1,0,0,17
104215,lokaggapuggalo,lokaggapuggalo,2,2,0,0,14
104216,tīṇimāni,tinimani,135,129,6,0,8
104217,mātupaṭṭhānaṃ,matupatthanam,12,12,0,0,13
104218,bījako,bijako,20,20,0,0,6
104219,evātīdha,evatidha,5,5,0,0,8
104220,pubbalope,pubbalope,6,6,0,0,9
104221,vibhattivipariṇāmo,vibhattiviparinamo,13,13,0,0,18
104222,asamānarūpamhā,asamanarupamha,1,1,0,0,14
104223,yathāvavatthitarūpapariggahe,yathavavatthitarupapariggahe,1,1,0,0,28
104224,niccamaniccamasantañca,niccamaniccamasantanca,2,2,0,0,22
104225,vidhimettha,vidhimettha,1,1,0,0,11
104226,yassadāni,yassadani,67,62,5,0,9
104227,chāyāva,chayava,49,45,4,0,7
104228,itīpi,itipi,1,1,0,0,5
104229,assamaṇīsi,assamanisi,6,6,0,0,10
104230,cakkhundriya,cakkhundriya,1,1,0,0,12
104231,akataññūsi,akatannusi,5,5,0,0,10
104232,ākāseva,akaseva,15,14,1,0,7
104233,vasaloti,vasaloti,2,1,1,0,8
104234,moggallānosi,moggallanosi,7,7,0,0,12
104235,sugatovādo,sugatovado,4,4,0,0,10
104236,diṭṭhāsavo,ditthasavo,102,94,8,0,10
104237,diṭṭhogho,ditthogho,38,36,2,0,9
104238,kutettha,kutettha,78,63,15,0,8
104239,vavatthitavibhāsāya,vavatthitavibhasaya,1,1,0,0,19
104240,avaṇṇato,avannato,1,1,0,0,8
104241,sarodānītīvevādiṃ,sarodanitivevadim,1,1,0,0,17
104242,luppataññato,luppatannato,1,1,0,0,12
104243,āsevādivivajjito,asevadivivajjito,1,1,0,0,16
104244,pubbāvaṇṇassarānaṃ,pubbavannassaranam,1,1,0,0,18
104245,asarūpe,asarupe,6,6,0,0,7
104246,ivaṇṇa,ivanna,5,2,3,0,6
104247,ggahaṇañca,ggahananca,18,18,0,0,10
104248,sīhagatiyā,sihagatiya,7,7,0,0,10
104249,idhānuvattetabbaṃ,idhanuvattetabbam,1,1,0,0,17
104250,vaṇṇabhūto,vannabhuto,1,1,0,0,10
104251,kārabhūto,karabhuto,1,1,0,0,9
104252,pubbassare,pubbassare,3,3,0,0,10
104253,asavaṇṇā,asavanna,1,0,1,0,8
104254,ṭhānāsannavasena,thanasannavasena,4,4,0,0,16
104255,ivaṇṇukārānamekārokārā,ivannukaranamekarokara,1,1,0,0,22
104256,jineritaṃ,jineritam,6,6,0,0,9
104257,candodayo,candodayo,1,1,0,0,9
104258,yathodake,yathodake,17,15,2,0,9
104259,upasampadā,upasampada,357,342,15,0,10
104260,asarūpeti,asarupeti,2,0,2,0,9
104261,avaṇṇe,avanne,32,29,3,0,6
104262,vuttavidhi,vuttavidhi,14,14,0,0,10
104263,diṭṭhupādānaṃ,ditthupadanam,110,98,12,0,13
104264,mudindriyaṃ,mudindriyam,4,4,0,0,11
104265,missaroti,missaroti,2,1,1,0,9
104266,atthikā,atthika,67,64,3,0,7
104267,upadhāritaṃ,upadharitam,22,22,0,0,11
104268,appassuto,appassuto,84,76,8,0,9
104269,upanissayo,upanissayo,246,232,14,0,10
104270,pubbassarānaṃ,pubbassaranam,2,2,0,0,13
104271,rassassarānaṃ,rassassaranam,1,1,0,0,13
104272,savaṇṇadīgho,savannadigho,1,1,0,0,12
104273,buddhānussati,buddhanussati,53,46,7,0,13
104274,sātthikā,satthika,147,147,0,0,8
104275,paññavāssa,pannavassa,6,5,1,0,10
104276,tadāhaṃ,tadaham,152,147,5,0,7
104277,gacchāmīti,gacchamiti,66,53,13,0,10
104278,kikīva,kikiva,17,14,3,0,6
104279,hūpakāraṃ,hupakaram,1,1,0,0,9
104280,madhūdakaṃ,madhudakam,2,2,0,0,10
104281,sūpadhāritaṃ,supadharitam,41,39,2,0,12
104282,idānāhaṃ,idanaham,45,45,0,0,8
104283,itarītarena,itaritarena,116,104,12,0,11
104284,kammūpanissayo,kammupanissayo,2,2,0,0,14
104285,rattūparato,rattuparato,34,26,8,0,11
104286,kimpimāya,kimpimaya,2,2,0,0,9
104287,pañcasupādānakkhandhesu,pancasupadanakkhandhesu,2,2,0,0,23
104288,pañcaṅgiko,pancangiko,81,72,9,0,10
104289,satindriyaṃ,satindriyam,292,281,11,0,11
104290,lahuṭṭhānaṃ,lahutthanam,77,65,12,0,11
104291,gacchāmahaṃ,gacchamaham,35,35,0,0,11
104292,nāmenti,namenti,21,21,0,0,7
104293,saṅghāṭi,sanghati,84,81,3,0,8
104294,parassarānaṃ,parassaranam,1,1,0,0,12
104295,parassare,parassare,1,1,0,0,9
104296,kvacidīghaṃ,kvacidigham,1,1,0,0,11
104297,luttadīghaggahaṇānukaḍḍhanatthaṃ,luttadighaggahananukaddhanattham,1,1,0,0,32
104298,nukaḍḍhitamuttaratra,nukaddhitamuttaratra,1,1,0,0,20
104299,nānuvattate,nanuvattate,1,1,0,0,11
104300,vītipatanti,vitipatanti,13,12,1,0,11
104301,vītināmenti,vitinamenti,22,22,0,0,11
104302,saṅghāṭīpi,sanghatipi,2,2,0,0,10
104303,jīvitahetūpi,jivitahetupi,3,3,0,0,12
104304,idānipi,idanipi,114,113,1,0,7
104305,padantabhūtassa,padantabhutassa,1,1,0,0,15
104306,kāremeteyesaddādissevāyaṃ,karemeteyesaddadissevayam,1,1,0,0,25
104307,edanto,edanto,2,1,1,0,6
104308,ādesiṭṭhāne,adesitthane,2,2,0,0,11
104309,ādissatīti,adissatiti,2,2,0,0,10
104310,pabbatyāhaṃ,pabbatyaham,6,5,1,0,11
104311,yyāssa,yyassa,5,5,0,0,6
104312,damento,damento,6,6,0,0,7
104313,addhamāsaṃ,addhamasam,52,47,5,0,10
104314,āpāthaṃ,apatham,241,225,16,0,7
104315,kārassedaṃ,karassedam,1,1,0,0,10
104316,tāvatakvassa,tavatakvassa,9,9,0,0,12
104317,khvajja,khvajja,14,13,1,0,7
104318,yatvādhikaraṇaṃ,yatvadhikaranam,9,7,2,0,15
104319,anvaddhamāsaṃ,anvaddhamasam,76,63,13,0,13
104320,anvebhi,anvebhi,1,1,0,0,7
104321,dvākāro,dvakaro,11,11,0,0,7
104322,cakkhvāpāthaṃ,cakkhvapatham,2,2,0,0,13
104323,pātvākāsi,patvakasi,45,45,0,0,9
104324,yohaṃ,yoham,96,91,5,0,5
104325,sāgataṃ,sagatam,25,25,0,0,7
104326,sādhāvuso,sadhavuso,55,54,1,0,9
104327,viravanti,viravanti,16,15,1,0,9
104328,paṭisanthāravutti,patisantharavutti,5,5,0,0,17
104329,anubhuyyate,anubhuyyate,3,3,0,0,11
104330,ākato,akato,2,2,0,0,5
104331,maṇḍūkagatiyā,mandukagatiya,13,13,0,0,13
104332,vityānubhuyyate,vityanubhuyyate,1,1,0,0,15
104333,nadyāsanno,nadyasanno,1,1,0,0,10
104334,itihidaṃ,itihidam,9,9,0,0,8
104335,canti,canti,1,0,1,0,5
104336,atipatiitīnaṃti,atipatiitinamti,1,1,0,0,15
104337,saddassedaṃ,saddassedam,1,1,0,0,11
104338,icceso,icceso,2,2,0,0,6
104339,akata,akata,3,3,0,0,5
104340,kārassevāyaṃ,karassevayam,2,2,0,0,12
104341,ggahaṇassa,ggahanassa,2,2,0,0,10
104342,cantassā,cantassa,1,1,0,0,8
104343,tisuttassa,tisuttassa,1,1,0,0,10
104344,niratthakatā,niratthakata,14,13,1,0,12
104345,accodātā,accodata,2,2,0,0,8
104346,ākaṅkhamānena,akankhamanena,30,25,5,0,13
104347,vāivaṇṇe,vaivanne,1,1,0,0,8
104348,atissāti,atissati,1,0,1,0,8
104349,upasaggānukaraṇametaṃ,upasagganukaranametam,1,1,0,0,21
104350,vibhattilopābhāvo,vibhattilopabhavo,2,2,0,0,17
104351,saddavidhinisedhappakaraṇato,saddavidhinisedhappakaranato,1,1,0,0,28
104352,saddantabhūtaṃti,saddantabhutamti,1,1,0,0,16
104353,ivaṇṇanti,ivannanti,1,1,0,0,9
104354,asarūpādhikārato,asarupadhikarato,1,1,0,0,16
104355,itipatī,itipati,1,0,1,0,7
104356,namantassa,namantassa,10,8,2,0,10
104357,isigaṇo,isigano,28,28,0,0,7
104358,itīdaṃ,itidam,1,1,0,0,6
104359,abhiiccetassa,abhiiccetassa,1,1,0,0,13
104360,chaṭṭhiyojanaṃ,chatthiyojanam,1,1,0,0,14
104361,ādesāpekkhato,adesapekkhato,1,1,0,0,13
104362,pubbassaralopo,pubbassaralopo,15,15,0,0,14
104363,abbhokāso,abbhokaso,59,48,11,0,9
104364,ajjhagamā,ajjhagama,12,11,1,0,9
104365,ajjhupagato,ajjhupagato,14,13,1,0,11
104366,adhī,adhi,2,2,0,0,4
104367,ajjhoiti,ajjhoiti,1,1,0,0,8
104368,vuttarūpā,vuttarupa,1,1,0,0,9
104369,saralopaparanayanāni,saralopaparanayanani,3,3,0,0,20
104370,ajjhiṭṭho,ajjhittho,34,30,4,0,9
104371,ekamidha,ekamidha,1,1,0,0,8
104372,ahantīdha,ahantidha,1,1,0,0,9
104373,saralopadīghā,saralopadigha,1,1,0,0,13
104374,yathātathā,yathatatha,3,2,1,0,10
104375,dvayaparassedaṃ,dvayaparassedam,1,1,0,0,15
104376,dīghasaramhā,dighasaramha,1,1,0,0,12
104377,saddādibhūtassa,saddadibhutassa,1,1,0,0,15
104378,desesu,desesu,13,13,0,0,6
104379,sampattesu,sampattesu,15,15,0,0,10
104380,ivaṇṇauvaṇṇaiccete,ivannauvannaiccete,1,1,0,0,18
104381,savaṇṇaggahaṇatthaṃ,savannaggahanattham,1,1,0,0,19
104382,pasaññāva,pasannava,1,1,0,0,9
104383,liṅgantaṃva,lingantamva,1,1,0,0,11
104384,liṅgamajjhe,lingamajjhe,1,1,0,0,11
104385,dviliṅgante,dvilingante,1,1,0,0,11
104386,iyauva,iyauva,1,0,1,0,6
104387,tiyaddhaṃ,tiyaddham,10,7,3,0,9
104388,sattamiyatthe,sattamiyatthe,10,6,4,0,13
104389,pañcamiyantaṃ,pancamiyantam,1,1,0,0,13
104390,duvaṅgikaṃ,duvangikam,56,53,3,0,10
104391,puthuvāsane,puthuvasane,2,2,0,0,11
104392,sayambhuvāsane,sayambhuvasane,3,3,0,0,14
104393,agyāgāre,agyagare,35,35,0,0,8
104394,sattamīatthe,sattamiatthe,1,1,0,0,12
104395,bhikkhuāsane,bhikkhuasane,1,1,0,0,12
104396,saddaggahaṇena,saddaggahanena,15,15,0,0,14
104397,uvaṇṇassa,uvannassa,9,9,0,0,9
104398,uvaavā,uvaava,1,0,1,0,6
104399,nipātassa,nipatassa,14,14,0,0,9
104400,asantuppatti,asantuppatti,2,2,0,0,12
104401,nimittāsannavasena,nimittasannavasena,1,1,0,0,18
104402,yava,yava,2,1,1,0,4
104403,dibho,dibho,1,1,0,0,5
104404,ikārekārādīsu,ikarekaradisu,1,1,0,0,13
104405,yathāyeva,yathayeva,2,2,0,0,9
104406,māyidaṃ,mayidam,6,6,0,0,7
104407,māyevaṃ,mayevam,1,1,0,0,7
104408,taṃyidaṃ,tamyidam,1,1,0,0,8
104409,nayidaṃ,nayidam,391,353,38,0,7
104410,nayimāni,nayimani,5,5,0,0,8
104411,navayime,navayime,11,11,0,0,8
104412,buddhānaṃyeva,buddhanamyeva,48,47,1,0,13
104413,pathavīyeva,pathaviyeva,21,21,0,0,11
104414,tesuyeva,tesuyeva,61,60,1,0,8
104415,viyañjanā,viyanjana,5,5,0,0,9
104416,viyākāsi,viyakasi,155,153,2,0,8
104417,pariantaṃ,pariantam,1,1,0,0,9
104418,pariyādānaṃ,pariyadanam,112,102,10,0,11
104419,pariyuṭṭhānaṃ,pariyutthanam,98,84,14,0,13
104420,pariyesati,pariyesati,289,285,4,0,10
104421,pariyosānamiti,pariyosanamiti,1,1,0,0,14
104422,niyāyogo,niyayogo,2,2,0,0,8
104423,upaparikkhati,upaparikkhati,47,46,1,0,13
104424,vakāroti,vakaroti,1,0,1,0,8
104425,avaṇṇukāresu,avannukaresu,1,1,0,0,12
104426,tivaṅgulaṃ,tivangulam,5,5,0,0,10
104427,pāguññavujutā,pagunnavujuta,3,3,0,0,13
104428,ppabhutito,ppabhutito,1,1,0,0,10
104429,chandānurakkhaṇādimhi,chandanurakkhanadimhi,2,2,0,0,21
104430,garumessati,garumessati,2,2,0,0,11
104431,mijjhati,mijjhati,86,86,0,0,8
104432,mabhipūjayi,mabhipujayi,1,1,0,0,11
104433,ekamekassa,ekamekassa,114,109,5,0,10
104434,midhekacce,midhekacce,75,75,0,0,10
104435,āsatimeva,asatimeva,1,1,0,0,9
104436,dakāro,dakaro,39,36,3,0,6
104437,tattasādīhi,tattasadihi,1,1,0,0,11
104438,nipātato,nipatato,5,5,0,0,8
104439,sakideva,sakideva,104,102,2,0,8
104440,sakadāgāmi,sakadagami,24,20,4,0,10
104441,mahāvuttisuttena,mahavuttisuttena,3,3,0,0,16
104442,kenacideva,kenacideva,246,235,11,0,10
104443,kismiñcideva,kismincideva,102,88,14,0,12
104444,sammadattho,sammadattho,10,9,1,0,11
104445,yadatthaṃ,yadattham,92,88,4,0,9
104446,yadantarā,yadantara,1,1,0,0,9
104447,tadantarā,tadantara,12,11,1,0,9
104448,tadaṅgavimutti,tadangavimutti,8,7,1,0,14
104449,yatetattasehi,yatetattasehi,1,1,0,0,13
104450,aññadatthaṃ,annadattham,6,6,0,0,11
104451,bahudeva,bahudeva,79,70,9,0,8
104452,ahudeva,ahudeva,46,42,4,0,7
104453,atthakāmena,atthakamena,24,24,0,0,11
104454,yāvāhaṃ,yavaham,58,57,1,0,7
104455,tāvāhaṃ,tavaham,118,112,6,0,7
104456,punāparaṃ,punaparam,73,70,3,0,9
104457,nakāro,nakaro,19,18,1,0,6
104458,āyatādimhi,ayatadimhi,1,1,0,0,10
104459,ajjādito,ajjadito,1,1,0,0,8
104460,ihaggādimhi,ihaggadimhi,1,1,0,0,11
104461,dupātu,dupatu,1,1,0,0,6
104462,pāta,pata,1,1,0,0,4
104463,caturādito,caturadito,1,1,0,0,10
104464,nirīhakaṃ,nirihakam,9,7,2,0,9
104465,niruttaro,niruttaro,17,14,3,0,9
104466,durāgataṃ,duragatam,7,7,0,0,9
104467,duruttaṃ,duruttam,38,34,4,0,8
104468,pāturahesuṃ,paturahesum,58,53,5,0,11
104469,punarāgaccheyya,punaragaccheyya,2,2,0,0,15
104470,punaruttaṃ,punaruttam,12,9,3,0,10
104471,punareva,punareva,14,13,1,0,8
104472,punareti,punareti,4,4,0,0,8
104473,pātarāso,pataraso,7,5,2,0,8
104474,caturaṅgikaṃ,caturangikam,44,44,0,0,12
104475,caturārakkhā,caturarakkha,5,5,0,0,12
104476,caturiddhipādapaṭilābho,caturiddhipadapatilabho,2,2,0,0,23
104477,caturoghanittharaṇatthaṃ,caturoghanittharanattham,4,4,0,0,24
104478,bhatturatthe,bhatturatthe,8,8,0,0,12
104479,vuttiresā,vuttiresa,12,10,2,0,9
104480,pathavīdhāturevesā,pathavidhaturevesa,9,9,0,0,18
104481,ivevesu,ivevesu,1,1,0,0,7
104482,chandānurakkhaṇe,chandanurakkhane,7,4,3,0,16
104483,vijjurivabbhakūṭe,vijjurivabbhakute,1,1,0,0,17
104484,āragge,aragge,22,20,2,0,6
104485,usabhoriva,usabhoriva,7,6,1,0,10
104486,dvādhiṭṭhitaṃ,dvadhitthitam,11,10,1,0,13
104487,chasaṅkhyāhi,chasankhyahi,1,1,0,0,12
104488,laḷānamaviseso,lalanamaviseso,4,4,0,0,14
104489,chaḷāsīti,chalasiti,3,3,0,0,9
104490,chaḷaṃsā,chalamsa,3,3,0,0,8
104491,sarasandhividhānaṃ,sarasandhividhanam,1,1,0,0,18
104492,itthiliṅgasaddo,itthilingasaddo,5,5,0,0,15
104493,āppaccayo,appaccayo,9,8,1,0,9
104494,liṅgamhā,lingamha,43,43,0,0,8
104495,ppaccayo,ppaccayo,181,181,0,0,8
104496,pakatyatthajotakā,pakatyatthajotaka,1,1,0,0,17
104497,itthippaccayā,itthippaccaya,1,1,0,0,13
104498,syādayo,syadayo,11,11,0,0,7
104499,paccayatthassa,paccayatthassa,2,2,0,0,14
104500,sakatthassāpi,sakatthassapi,1,1,0,0,13
104501,paranayane,paranayane,2,2,0,0,10
104502,paccayantassāpi,paccayantassapi,1,1,0,0,15
104503,aliṅgattā,alingatta,2,2,0,0,9
104504,vibhattuppattiyamasampattāyaṃ,vibhattuppattiyamasampattayam,2,2,0,0,29
104505,itthippaccayantassāpi,itthippaccayantassapi,1,1,0,0,21
104506,nāmabyapadeso,namabyapadeso,7,7,0,0,13
104507,dyuppatti,dyuppatti,40,40,0,0,9
104508,gasipī,gasipi,2,2,0,0,6
104509,liṅgassanto,lingassanto,2,2,0,0,11
104510,gassā,gassa,1,1,0,0,5
104511,saralopapakatibhāvā,saralopapakatibhava,3,3,0,0,19
104512,ekavacanānaṃ,ekavacananam,9,9,0,0,12
104513,liṅgassākārā,lingassakara,1,1,0,0,12
104514,pariyantānaṃ,pariyantanam,5,3,2,0,12
104515,aññatthāyādeso,annatthayadeso,1,1,0,0,14
104516,ūkāsephālikā,ukasephalika,1,1,0,0,12
104517,lambusā,lambusa,3,3,0,0,7
104518,vasudhādayo,vasudhadayo,3,3,0,0,11
104519,ālapaneva,alapaneva,1,1,0,0,9
104520,ekārattaṃ,ekarattam,4,4,0,0,9
104521,annāyo,annayo,2,2,0,0,6
104522,ambāyo,ambayo,2,2,0,0,6
104523,liṅgassantā,lingassanta,1,1,0,0,11
104524,ivaṇṇuvaṇṇehi,ivannuvannehi,5,5,0,0,13
104525,rattihi,rattihi,2,2,0,0,7
104526,rattibhi,rattibhi,2,2,0,0,8
104527,rattinaṃ,rattinam,3,3,0,0,8
104528,vaṇṇantato,vannantato,1,1,0,0,10
104529,vaṇṇantatopi,vannantatopi,1,1,0,0,12
104530,sīhamaṇḍūkagatīhi,sihamandukagatihi,1,1,0,0,17
104531,yovacanekavacana,yovacanekavacana,1,0,1,0,16
104532,vacanekavacanavibhattīnamādese,vacanekavacanavibhattinamadese,1,1,0,0,30
104533,kārassevādhikārato,karassevadhikarato,1,1,0,0,18
104534,pasañña,pasanna,1,0,1,0,7
104535,vaṇṇova,vannova,5,5,0,0,7
104536,nivattanatthaṃ,nivattanattham,64,64,0,0,14
104537,oādesā,oadesa,4,4,0,0,6
104538,rattisu,rattisu,1,1,0,0,7
104539,evamaññānipi,evamannanipi,5,5,0,0,12
104540,ndubhi,ndubhi,1,1,0,0,6
104541,kārantanāmāni,karantanamani,2,2,0,0,13
104542,ittha,ittha,2,2,0,0,5
104543,anadā,anada,1,0,1,0,5
104544,ggahaṇama,ggahanama,1,1,0,0,9
104545,disampiṇḍanatthaṃ,disampindanattham,1,1,0,0,17
104546,puthugavā,puthugava,1,0,1,0,9
104547,pakatibhāvo,pakatibhavo,11,11,0,0,11
104548,dutiyekavacane,dutiyekavacane,3,3,0,0,14
104549,lopābhāve,lopabhave,12,12,0,0,9
104550,yonamokāro,yonamokaro,3,3,0,0,10
104551,talana,talana,2,2,0,0,6
104552,sijjhantānaṃ,sijjhantanam,1,1,0,0,12
104553,ānattaggahaṇādinā,anattaggahanadina,1,1,0,0,17
104554,nipphādanaṃ,nipphadanam,10,9,1,0,11
104555,atraja,atraja,2,1,1,0,6
104556,nipphādanūpāyantaradassanatthanti,nipphadanupayantaradassanatthanti,1,1,0,0,33
104557,amādisutte,amadisutte,1,1,0,0,10
104558,nāsānañcāttaṃ,nasanancattam,1,1,0,0,13
104559,jaccā,jacca,37,35,2,0,5
104560,ekarajjenāti,ekarajjenati,3,1,2,0,12
104561,kārādesadvittāni,karadesadvittani,1,1,0,0,16
104562,nadīhi,nadihi,14,14,0,0,6
104563,nadībhi,nadibhi,3,3,0,0,7
104564,gandhabbī,gandhabbi,10,10,0,0,9
104565,vānarī,vanari,3,3,0,0,6
104566,sūkarī,sukari,6,6,0,0,6
104567,saddasamā,saddasama,1,1,0,0,9
104568,īppaccaye,ippaccaye,1,1,0,0,9
104569,ayyakavaruṇa,ayyakavaruna,1,0,1,0,12
104570,īkāre,ikare,5,5,0,0,5
104571,antāpekkhāyaṃ,antapekkhayam,4,4,0,0,13
104572,puthaviyo,puthaviyo,1,1,0,0,9
104573,mahāvuttinā,mahavuttina,140,140,0,0,11
104574,ṇantu,nantu,1,0,1,0,5
104575,ppaccayantehi,ppaccayantehi,1,1,0,0,13
104576,dhikāro,dhikaro,10,10,0,0,7
104577,nivattanattho,nivattanattho,4,4,0,0,13
104578,ppaccayassa,ppaccayassa,26,26,0,0,11
104579,kārappaccaye,karappaccaye,3,3,0,0,12
104580,guṇavatiyo,gunavatiyo,3,3,0,0,10
104581,guṇavantiyo,gunavantiyo,1,1,0,0,11
104582,yasavatī,yasavati,19,19,0,0,8
104583,iccādisutte,iccadisutte,6,6,0,0,11
104584,pubbalopassa,pubbalopassa,3,3,0,0,12
104585,nisedhanato,nisedhanato,9,9,0,0,11
104586,parasare,parasare,2,2,0,0,8
104587,kārantesu,karantesu,1,1,0,0,9
104588,daṇḍiniyo,dandiniyo,1,1,0,0,9
104589,piyabhāṇinī,piyabhanini,29,29,0,0,11
104590,pokkharinī,pokkharini,1,1,0,0,10
104591,miccādisutte,miccadisutte,1,1,0,0,12
104592,saraloparassattāni,saraloparassattani,1,1,0,0,18
104593,paracittaviduniyo,paracittaviduniyo,12,12,0,0,17
104594,yakkhiniyo,yakkhiniyo,18,18,0,0,10
104595,sīhiniyo,sihiniyo,1,1,0,0,8
104596,amādesādiabhāvova,amadesadiabhavova,1,1,0,0,17
104597,yāguhi,yaguhi,3,3,0,0,6
104598,yāgubhi,yagubhi,2,2,0,0,7
104599,yāgunaṃ,yagunam,2,2,0,0,7
104600,yāgusu,yagusu,1,1,0,0,6
104601,sassuādīni,sassuadini,1,1,0,0,10
104602,āratta,aratta,3,1,2,0,6
104603,desābhāve,desabhave,13,13,0,0,9
104604,desova,desova,1,1,0,0,6
104605,māta,mata,3,3,0,0,4
104606,mātare,matare,4,4,0,0,6
104607,mātarebhi,matarebhi,4,4,0,0,9
104608,mātuhi,matuhi,1,1,0,0,6
104609,mātubhi,matubhi,1,1,0,0,7
104610,mātunaṃ,matunam,2,2,0,0,7
104611,mātaresu,mataresu,4,4,0,0,8
104612,mātusu,matusu,1,1,0,0,6
104613,duhitaro,duhitaro,1,1,0,0,8
104614,gotitthisaṅgaho,gotitthisangaho,1,1,0,0,15
104615,dvipadamidaṃ,dvipadamidam,4,4,0,0,12
104616,saralopapakatibhāvādi,saralopapakatibhavadi,1,1,0,0,21
104617,nibhāve,nibhave,1,1,0,0,7
104618,cāette,caette,1,1,0,0,6
104619,ārambhā,arambha,5,5,0,0,7
104620,āettaṃ,aettam,1,1,0,0,6
104621,kvacidevidha,kvacidevidha,1,1,0,0,12
104622,vikappenekāro,vikappenekaro,2,2,0,0,13
104623,ghāna,ghana,28,28,0,0,5
104624,jhāna,jhana,32,26,6,0,5
104625,jālamaṅgalaṃ,jalamangalam,1,1,0,0,12
104626,naḷina,nalina,3,3,0,0,6
104627,ṅga,nga,5,5,0,0,3
104628,pulina,pulina,3,3,0,0,6
104629,susāna,susana,4,3,1,0,6
104630,yudhaṃ,yudham,2,2,0,0,6
104631,cīvara,civara,17,14,3,0,6
104632,ndriyaṃ,ndriyam,2,2,0,0,7
104633,nayana,nayana,8,8,0,0,6
104634,sopāna,sopana,5,5,0,0,6
104635,lohā,loha,2,2,0,0,4
104636,lāta,lata,3,3,0,0,4
104637,rammaṇā,rammana,6,6,0,0,7
104638,caraṇa,carana,5,5,0,0,6
104639,tīracchatta,tiracchatta,1,1,0,0,11
104640,tatiyekavacanādīsu,tatiyekavacanadisu,1,1,0,0,18
104641,thāmaddhā,thamaddha,1,0,1,0,9
104642,dīnamantassapi,dinamantassapi,1,1,0,0,14
104643,kammathāma,kammathama,1,0,1,0,10
104644,cukāro,cukaro,1,1,0,0,6
104645,smiṃnī,smimni,1,1,0,0,6
104646,purimasamaṃ,purimasamam,19,19,0,0,11
104647,assaddhā,assaddha,96,89,7,0,8
104648,samāsassā,samasassa,1,1,0,0,9
104649,samāsantassa,samasantassa,3,3,0,0,12
104650,samāsattā,samasatta,5,5,0,0,9
104651,assaddhāni,assaddhani,9,8,1,0,10
104652,mukhanāsikā,mukhanasika,1,0,1,0,11
104653,dvandekattā,dvandekatta,1,1,0,0,11
104654,sabbatthekavacanameva,sabbatthekavacanameva,3,3,0,0,21
104655,mukhanāsika,mukhanasika,2,2,0,0,11
104656,mukhanāsikena,mukhanasikena,1,1,0,0,13
104657,sukhabhārī,sukhabhari,1,1,0,0,10
104658,anapuṃsakattābhāvā,anapumsakattabhava,1,1,0,0,18
104659,smimpi,smimpi,1,1,0,0,6
104660,sukhakārīni,sukhakarini,3,3,0,0,11
104661,sukhakārinaṃ,sukhakarinam,1,1,0,0,12
104662,sukhakāriṃ,sukhakarim,1,1,0,0,10
104663,āyusāti,ayusati,1,1,0,0,7
104664,manogaṇādittā,manoganaditta,1,1,0,0,13
104665,āyūnamiccādi,ayunamiccadi,1,1,0,0,12
104666,assuādīni,assuadini,2,2,0,0,9
104667,puṃsakaliṅgo,pumsakalingo,1,1,0,0,12
104668,dhammaññūādīni,dhammannuadini,1,1,0,0,14
104669,cittagosa,cittagosa,1,0,1,0,9
104670,kulassā,kulassa,1,1,0,0,7
104671,ṭhānappayatanāsannattā,thanappayatanasannatta,1,1,0,0,22
104672,rassattamukāro,rassattamukaro,1,1,0,0,14
104673,cittagū,cittagu,2,2,0,0,7
104674,cittagūni,cittaguni,1,1,0,0,9
104675,assaddhamathaṭṭhi,assaddhamathatthi,1,1,0,0,17
104676,cittagūti,cittaguti,1,1,0,0,9
104677,sabbanāmattā,sabbanamatta,2,2,0,0,12
104678,niravasesattho,niravasesattho,7,6,1,0,14
104679,pulliṅgavisiṭṭhatthābhidhāyī,pullingavisitthatthabhidhayi,1,1,0,0,28
104680,sabbanāmasaññā,sabbanamasanna,1,1,0,0,14
104681,sabbanāmasaññānaṃ,sabbanamasannanam,1,1,0,0,17
104682,catutthekavacane,catutthekavacane,2,2,0,0,16
104683,catutthekavacanassā,catutthekavacanassa,1,1,0,0,19
104684,desābhāvo,desabhavo,3,3,0,0,9
104685,paṭisedhanivattanatthaṃ,patisedhanivattanattham,1,1,0,0,23
104686,smiṃnaṃ,smimnam,9,8,1,0,7
104687,svekavacanesu,svekavacanesu,3,3,0,0,13
104688,ekavacanaṭṭhānasambhūtesu,ekavacanatthanasambhutesu,1,1,0,0,25
104689,dhikārato,dhikarato,7,7,0,0,9
104690,uttarāyāti,uttarayati,2,2,0,0,10
104691,saṃya,samya,1,0,1,0,5
104692,mādesā,madesa,4,4,0,0,6
104693,katarakatama,katarakatama,1,0,1,0,12
104694,vuttappaṭiyogavacano,vuttappatiyogavacano,1,1,0,0,20
104695,adhikatāparavacano,adhikataparavacano,2,2,0,0,18
104696,dvandasamāsaṭṭhā,dvandasamasattha,1,1,0,0,16
104697,sabbanāmakārato,sabbanamakarato,1,1,0,0,15
104698,disādivavatthānavacanā,disadivavatthanavacana,1,1,0,0,22
104699,parāti,parati,2,0,2,0,6
104700,pubbehi,pubbehi,10,10,0,0,7
104701,pubbebhi,pubbebhi,2,2,0,0,8
104702,pubbesānaṃ,pubbesanam,3,3,0,0,10
104703,vikappenākārekārā,vikappenakarekara,1,1,0,0,17
104704,pubbamhā,pubbamha,1,1,0,0,8
104705,pubbesu,pubbesu,9,8,1,0,7
104706,pubbāyo,pubbayo,3,3,0,0,7
104707,pulliṅgasamaṃ,pullingasamam,26,26,0,0,13
104708,parāparadakkhiṇuttarādhara,paraparadakkhinuttaradhara,1,0,1,0,26
104709,saṃsāna,samsana,1,0,1,0,7
104710,mādesābhāvo,madesabhavo,1,1,0,0,11
104711,vinādhikārena,vinadhikarena,3,3,0,0,13
104712,tatiyāsamāsepi,tatiyasamasepi,1,1,0,0,14
104713,sabbanāmikavidhānaṃ,sabbanamikavidhanam,1,1,0,0,19
104714,disatthasabbanāmānaṃ,disatthasabbanamanam,1,1,0,0,20
104715,sabbanāmikavidhānaṃva,sabbanamikavidhanamva,1,1,0,0,21
104716,yadantarāḷanti,yadantaralanti,1,1,0,0,14
104717,dakkhiṇapubbassaṃ,dakkhinapubbassam,2,2,0,0,17
104718,yateta,yateta,2,0,2,0,6
104719,saddādīnamālapane,saddadinamalapane,1,1,0,0,17
104720,parammukha,parammukha,1,1,0,0,10
104721,accantasamīpadūra,accantasamipadura,1,1,0,0,17
104722,pucchanatthavacanā,pucchanatthavacana,2,2,0,0,18
104723,nesānaṃ,nesanam,7,7,0,0,7
104724,mhāmhī,mhamhi,1,1,0,0,6
104725,pakatisandhividhāna,pakatisandhividhana,1,1,0,0,19
104726,sarānameva,saranameva,1,1,0,0,10
104727,sandhikāriye,sandhikariye,1,1,0,0,12
104728,chandabhedāsukhuccāraṇaṭṭhāne,chandabhedasukhuccaranatthane,1,1,0,0,29
104729,sandhicchārahitaṭṭhāne,sandhiccharahitatthane,1,1,0,0,22
104730,lopādesavikāramāpajjanteti,lopadesavikaramapajjanteti,1,1,0,0,26
104731,pakatiṭṭhānaṃ,pakatitthanam,1,0,1,0,13
104732,ālapanantā,alapananta,1,1,0,0,10
104733,anitismiṃ,anitismim,1,1,0,0,9
104734,acchandānurakkhaṇe,acchandanurakkhane,1,1,0,0,18
104735,padantadīghā,padantadigha,1,1,0,0,12
104736,ikārukārā,ikarukara,1,1,0,0,9
104737,nāmapadantātītakriyādimhīti,namapadantatitakriyadimhiti,1,1,0,0,27
104738,ālapanantesu,alapanantesu,1,0,1,0,12
104739,cānanda,cananda,33,33,0,0,7
104740,aniccasaññā,aniccasanna,112,107,5,0,11
104741,ādīnavasaññā,adinavasanna,11,10,1,0,12
104742,sivika,sivika,1,1,0,0,6
104743,pubbassaralopa,pubbassaralopa,1,1,0,0,14
104744,desādayo,desadayo,1,1,0,0,8
104745,padantadīghesu,padantadighesu,1,0,1,0,14
104746,ajjhabhāsi,ajjhabhasi,197,194,3,0,10
104747,ottharati,ottharati,45,45,0,0,9
104748,appicchā,appiccha,375,372,3,0,8
104749,bhikkhūujjhāyiṃsu,bhikkhuujjhayimsu,1,1,0,0,17
104750,evamāhaṃsu,evamahamsu,633,631,2,0,10
104751,ārakkhakā,arakkhaka,4,4,0,0,9
104752,amatapadaṃ,amatapadam,37,30,7,0,10
104753,viccessati,viccessati,1,1,0,0,10
104754,oṭṭhavacittakā,otthavacittaka,3,3,0,0,14
104755,āmantayī,amantayi,26,24,2,0,8
104756,itīvevetthādīsu,itivevetthadisu,1,1,0,0,15
104757,sandhipi,sandhipi,1,1,0,0,8
104758,āgatamhā,agatamha,24,24,0,0,8
104759,katamāssu,katamassu,1,1,0,0,9
104760,marīva,mariva,1,1,0,0,6
104761,parisuddhetthāyasmanto,parisuddhetthayasmanto,22,22,0,0,22
104762,sacesa,sacesa,1,1,0,0,6
104763,asamāseti,asamaseti,1,0,1,0,9
104764,jivhāyatanaṃ,jivhayatanam,116,116,0,0,12
104765,avijjogho,avijjogho,64,61,3,0,9
104766,itthindriyaṃ,itthindriyam,758,741,17,0,12
104767,bhayatupaṭṭhānaṃ,bhayatupatthanam,15,14,1,0,16
104768,acchandānurakkhaṇeti,acchandanurakkhaneti,1,0,1,0,20
104769,missaro,missaro,5,5,0,0,7
104770,nāmapadantaikārukāresu,namapadantaikarukaresu,1,0,1,0,22
104771,āhariṃsu,aharimsu,63,63,0,0,8
104772,manasākāsi,manasakasi,47,47,0,0,10
104773,pakatirūpā,pakatirupa,1,1,0,0,10
104774,dīgharassalopehi,digharassalopehi,1,1,0,0,16
104775,vikārābhāvo,vikarabhavo,8,8,0,0,11
104776,vedanākkhandho,vedanakkhandho,1390,1372,18,0,14
104777,bhāgyavā,bhagyava,26,24,2,0,8
104778,tuṇhībhūto,tunhibhuto,89,87,2,0,10
104779,pakatisandhividhānaṃ,pakatisandhividhanam,1,1,0,0,20
104780,byañjanasandhividhāna,byanjanasandhividhana,1,1,0,0,21
104781,pappontīti,pappontiti,3,3,0,0,10
104782,suttasukhuccāraṇachandānurakkhaṇaṭṭhānesu,suttasukhuccaranachandanurakkhanatthanesu,1,1,0,0,41
104783,tyassa,tyassa,36,36,0,0,6
104784,madhuva,madhuva,1,1,0,0,7
104785,madhuvā,madhuva,10,9,1,0,7
104786,maṅkū,manku,14,14,0,0,5
104787,svākkhāto,svakkhato,223,217,6,0,9
104788,yvāhaṃ,yvaham,48,46,2,0,6
104789,suhujū,suhuju,8,6,2,0,6
104790,anūpaghāto,anupaghato,14,14,0,0,10
104791,dūrakkhaṃ,durakkham,8,7,1,0,9
104792,dūramaṃ,duramam,11,10,1,0,7
104793,sūrakkhaṃ,surakkham,1,1,0,0,9
104794,dūharatā,duharata,1,1,0,0,8
104795,patiliyyati,patiliyyati,1,1,0,0,11
104796,sāvake,savake,216,207,9,0,6
104797,yathābhāvī,yathabhavi,2,2,0,0,10
104798,pubbasmiṃyevādhikāre,pubbasmimyevadhikare,1,1,0,0,20
104799,yiṭṭhaṃva,yitthamva,3,3,0,0,9
104800,hutaṃva,hutamva,3,3,0,0,7
104801,yadiva,yadiva,5,5,0,0,6
104802,parākamo,parakamo,1,1,0,0,8
104803,āsādo,asado,1,1,0,0,5
104804,lābhimhi,labhimhi,47,47,0,0,8
104805,vasimhi,vasimhi,27,27,0,0,7
104806,thullaccayo,thullaccayo,4,3,1,0,11
104807,daññā,danna,2,2,0,0,5
104808,dīyyati,diyyati,2,2,0,0,7
104809,sūyyati,suyyati,3,3,0,0,7
104810,tasmiṃyevādhikāre,tasmimyevadhikare,3,3,0,0,17
104811,etata,etata,1,0,1,0,5
104812,saddantokārassevāyaṃ,saddantokarassevayam,1,1,0,0,20
104813,pattosi,pattosi,24,22,2,0,7
104814,vipariṇāmena,viparinamena,19,19,0,0,12
104815,byañjanassā,byanjanassa,11,11,0,0,11
104816,rassākārato,rassakarato,2,2,0,0,11
104817,paṭikamukusa,patikamukusa,1,1,0,0,12
104818,sasādīnamādibyañjanānaṃ,sasadinamadibyanjananam,1,1,0,0,23
104819,vatādīnamādi,vatadinamadi,1,1,0,0,12
104820,vaṭudisādīnamantañca,vatudisadinamantanca,1,1,0,0,20
104821,niupasagga,niupasagga,2,2,0,0,10
104822,santasaddādesādiparañca,santasaddadesadiparanca,1,1,0,0,23
104823,apadantā,apadanta,1,1,0,0,8
104824,nākāradīghato,nakaradighato,1,1,0,0,13
104825,kārādi,karadi,6,6,0,0,6
104826,talanādīnamādeso,talanadinamadeso,1,1,0,0,16
104827,sayādinaṃ,sayadinam,1,1,0,0,9
104828,dhātvantassādeso,dhatvantassadeso,1,1,0,0,16
104829,sīsakāro,sisakaro,1,1,0,0,8
104830,bhamādīnamādi,bhamadinamadi,1,1,0,0,13
104831,catutthadutiyā,catutthadutiya,5,5,0,0,14
104832,paṭīsu,patisu,1,0,1,0,6
104833,vippayutto,vippayutto,74,71,3,0,10
104834,suppasanno,suppasanno,4,4,0,0,10
104835,appativattiyo,appativattiyo,2,2,0,0,13
104836,adhipatippaccayo,adhipatippaccayo,1,1,0,0,16
104837,suppaṭipanno,suppatipanno,169,166,3,0,12
104838,suppaṭipatti,suppatipatti,6,6,0,0,12
104839,kamādidhātūsu,kamadidhatusu,1,0,1,0,13
104840,ākamati,akamati,2,2,0,0,7
104841,akkamati,akkamati,27,26,1,0,8
104842,paṭikkosati,patikkosati,29,28,1,0,11
104843,anukkosati,anukkosati,2,2,0,0,10
104844,ākosati,akosati,2,2,0,0,7
104845,akkuddho,akkuddho,11,10,1,0,8
104846,atikkodho,atikkodho,2,2,0,0,9
104847,anukkayo,anukkayo,2,2,0,0,8
104848,anuggaho,anuggaho,34,28,6,0,8
104849,candaggaho,candaggaho,1,1,0,0,10
104850,diṭṭhiggāho,ditthiggaho,14,14,0,0,11
104851,assavā,assava,42,39,3,0,6
104852,passambhanto,passambhanto,1,1,0,0,12
104853,vissambhati,vissambhati,1,1,0,0,11
104854,aṭṭassaro,attassaro,2,2,0,0,9
104855,vissarati,vissarati,4,3,1,0,9
104856,vissasanto,vissasanto,7,7,0,0,10
104857,mahussasanto,mahussasanto,1,1,0,0,12
104858,āsāso,asaso,2,2,0,0,5
104859,avissajjento,avissajjento,7,7,0,0,12
104860,vissajjento,vissajjento,127,124,3,0,11
104861,pariccajanto,pariccajanto,23,23,0,0,12
104862,upakkiliṭṭho,upakkilittho,15,15,0,0,12
104863,āyabbayo,ayabbayo,1,1,0,0,8
104864,udabbahi,udabbahi,4,4,0,0,8
104865,sampaṭicchannaṃ,sampaticchannam,2,2,0,0,15
104866,saṅkamanto,sankamanto,6,5,1,0,10
104867,patigayhati,patigayhati,1,1,0,0,11
104868,manopakopaṃ,manopakopam,3,3,0,0,11
104869,tikādīsu,tikadisu,7,5,2,0,8
104870,kusalattikaṃ,kusalattikam,37,35,2,0,12
104871,pītittikaṃ,pitittikam,8,8,0,0,10
104872,hetuttikaṃ,hetuttikam,2,2,0,0,10
104873,vedanāttikaṃ,vedanattikam,15,15,0,0,12
104874,bodhittayaṃ,bodhittayam,2,2,0,0,11
104875,ekattiṃsa,ekattimsa,4,4,0,0,9
104876,sīlabbataṃ,silabbatam,91,66,25,0,10
104877,sappītiko,sappitiko,69,68,1,0,9
104878,vaṭu,vatu,3,2,1,0,4
104879,disādīnamante,disadinamante,1,0,1,0,13
104880,upasaggādiparesu,upasaggadiparesu,1,0,1,0,16
104881,ukaṃso,ukamso,2,2,0,0,6
104882,dukaraṃ,dukaram,1,1,0,0,7
104883,nikaṅkho,nikankho,1,1,0,0,8
104884,nikkaṅkhe,nikkankhe,2,2,0,0,9
104885,uññātaṃ,unnatam,8,7,1,0,7
104886,uyyutto,uyyutto,16,16,0,0,7
104887,dussaho,dussaho,3,3,0,0,7
104888,tajjo,tajjo,47,45,2,0,5
104889,tammayo,tammayo,19,14,5,0,7
104890,catuppādo,catuppado,2,2,0,0,9
104891,chappadikā,chappadika,2,2,0,0,10
104892,saddiṭṭhi,sadditthi,1,1,0,0,9
104893,chasaṭṭhi,chasatthi,36,33,3,0,9
104894,yakārādimhi,yakaradimhi,1,0,1,0,11
104895,nīyyati,niyyati,2,2,0,0,7
104896,abhibhūyya,abhibhuyya,3,3,0,0,10
104897,viceyya,viceyya,89,73,16,0,7
104898,anākāra,anakara,1,0,1,0,7
104899,yavatamādese,yavatamadese,1,0,1,0,12
104900,vipali,vipali,1,1,0,0,6
104901,talanadakārānaṃ,talanadakaranam,3,2,1,0,15
104902,talanada,talanada,1,0,1,0,8
104903,saṃyogabyañjanāni,samyogabyanjanani,1,1,0,0,17
104904,calañaja,calanaja,2,0,2,0,8
104905,kacaṭapa,kacatapa,3,0,3,0,8
104906,vaggādesatthaṃ,vaggadesattham,1,1,0,0,14
104907,kārādesatthañca,karadesatthanca,1,1,0,0,15
104908,yavatamādesassa,yavatamadesassa,1,1,0,0,15
104909,appekacce,appekacce,315,307,8,0,9
104910,appekadā,appekada,51,51,0,0,8
104911,añāyo,anayo,1,1,0,0,5
104912,ākāsānañcāyatanaṃ,akasanancayatanam,375,354,21,0,17
104913,ujjugatesu,ujjugatesu,5,5,0,0,10
104914,suggatinti,suggatinti,5,5,0,0,10
104915,vaggacatutthadutiyesu,vaggacatutthadutiyesu,1,1,0,0,21
104916,vaggacatutthadutiyānaṃ,vaggacatutthadutiyanam,1,1,0,0,22
104917,sadisavasena,sadisavasena,5,5,0,0,12
104918,niyamatthamāha,niyamatthamaha,2,2,0,0,14
104919,vaggatatiya,vaggatatiya,1,1,0,0,11
104920,paṭhamakkharā,pathamakkhara,1,1,0,0,13
104921,dvibhāvaṃ,dvibhavam,4,4,0,0,9
104922,tatiyapaṭhamāva,tatiyapathamava,1,1,0,0,15
104923,niyamattā,niyamatta,1,1,0,0,9
104924,ghosāghosa,ghosaghosa,1,0,1,0,10
104925,catutthadutiyāva,catutthadutiyava,1,1,0,0,16
104926,aniṭṭhappasaṅgosiyā,anitthappasangosiya,1,1,0,0,19
104927,tannayo,tannayo,1,1,0,0,7
104928,vaggapañcamānaṃ,vaggapancamanam,1,1,0,0,15
104929,ghosatte,ghosatte,1,1,0,0,8
104930,tatiyappasaṅgona,tatiyappasangona,1,1,0,0,16
104931,ṭhānādhikārato,thanadhikarato,2,2,0,0,14
104932,gharādīsu,gharadisu,1,0,1,0,9
104933,niādiparacatutthesu,niadiparacatutthesu,1,0,1,0,19
104934,pagharati,pagharati,1,1,0,0,9
104935,uggharati,uggharati,2,2,0,0,9
104936,ugghāṭeti,ugghateti,31,28,3,0,9
104937,dugghoso,dugghoso,1,1,0,0,8
104938,cajjhānaphalo,cajjhanaphalo,1,1,0,0,13
104939,paṭhamajjhānaṃ,pathamajjhanam,318,303,15,0,14
104940,abhijjhāyati,abhijjhayati,22,22,0,0,12
104941,viddhaṃseti,viddhamseti,50,48,2,0,11
104942,uddhaṃsito,uddhamsito,2,2,0,0,10
104943,niddhāro,niddharo,1,1,0,0,8
104944,niddhuto,niddhuto,4,4,0,0,8
104945,ubbhato,ubbhato,14,13,1,0,7
104946,catuddhā,catuddha,4,4,0,0,8
104947,cabhubbhi,cabhubbhi,1,1,0,0,9
104948,chaddhā,chaddha,9,9,0,0,7
104949,mādesādīsu,madesadisu,1,0,1,0,10
104950,āsabbhaṃ,asabbham,1,1,0,0,8
104951,sīlavantassa,silavantassa,21,19,2,0,12
104952,rassākāratoparaṃ,rassakaratoparam,1,0,1,0,16
104953,vaggadutiyesu,vaggadutiyesu,1,0,1,0,13
104954,pañcakkhandhā,pancakkhandha,365,331,34,0,13
104955,evaṃrūpakkhandho,evamrupakkhandho,1,1,0,0,16
104956,akkhamo,akkhamo,71,69,2,0,7
104957,dhātukkhobho,dhatukkhobho,10,9,1,0,12
104958,āyukkhayo,ayukkhayo,7,7,0,0,9
104959,setachattaṃ,setachattam,1,1,0,0,11
104960,sabbacchannaṃ,sabbacchannam,8,6,2,0,13
104961,vicchinnaṃ,vicchinnam,3,3,0,0,10
104962,bodhicchāyā,bodhicchaya,2,2,0,0,11
104963,jambucchāyā,jambucchaya,3,3,0,0,11
104964,samucchedo,samucchedo,20,18,2,0,10
104965,tatraṭṭhito,tatratthito,6,6,0,0,11
104966,thalaṭṭhaṃ,thalattham,26,23,3,0,10
104967,jalaṭṭhaṃ,jalattham,5,5,0,0,9
104968,adhiṭṭhitaṃ,adhitthitam,52,49,3,0,11
104969,garuṭṭhāniyo,garutthaniyo,33,33,0,0,12
104970,suppaṭṭhāno,suppatthano,1,1,0,0,11
104971,vitthambhito,vitthambhito,5,5,0,0,12
104972,papphoṭeti,papphoteti,5,5,0,0,10
104973,nipphalaṃ,nipphalam,25,24,1,0,9
104974,vipphāro,vippharo,12,9,3,0,8
104975,paripphuseyya,paripphuseyya,1,1,0,0,13
104976,madhupphāṇitaṃ,madhupphanitam,3,3,0,0,14
104977,ākārato,akarato,37,30,7,0,7
104978,ākhāto,akhato,2,2,0,0,6
104979,ākkhāto,akkhato,1,1,0,0,7
104980,āṇākkhettaṃ,anakkhettam,21,15,6,0,11
104981,saññākkhandho,sannakkhandho,722,718,4,0,13
104982,āchādayati,achadayati,1,1,0,0,10
104983,ācchādayati,acchadayati,1,1,0,0,11
104984,ācchindati,acchindati,1,1,0,0,10
104985,nāvāṭṭhaṃ,navattham,1,1,0,0,9
104986,āttharati,attharati,1,1,0,0,9
104987,āpphoṭeti,apphoteti,1,1,0,0,9
104988,santhuto,santhuto,3,3,0,0,8
104989,tamphalaṃ,tamphalam,3,3,0,0,9
104990,pūvakhajjakaṃ,puvakhajjakam,8,8,0,0,13
104991,chaviyādīni,chaviyadini,3,3,0,0,11
104992,nikamati,nikamati,1,1,0,0,8
104993,nipatti,nipatti,1,1,0,0,7
104994,nicarati,nicarati,1,1,0,0,8
104995,nitaraṇaṃ,nitaranam,1,1,0,0,9
104996,caggahaṇassa,caggahanassa,1,1,0,0,12
104997,bahulatthattā,bahulatthatta,1,1,0,0,13
104998,tarānaṃ,taranam,1,1,0,0,7
104999,vaggadutiyo,vaggadutiyo,1,1,0,0,11
105000,nittharaṇaṃ,nittharanam,9,7,2,0,11
105001,kuva,kuva,7,3,4,0,4
105002,vajādīnaṃ,vajadinam,1,1,0,0,9
105003,dvirūpassāti,dvirupassati,1,1,0,0,12
105004,sadhātvantayādesassa,sadhatvantayadesassa,1,1,0,0,20
105005,pavajati,pavajati,1,1,0,0,8
105006,nivānaṃ,nivanam,1,1,0,0,7
105007,udabbayaṃ,udabbayam,1,1,0,0,9
105008,taruṇādīnaṃ,tarunadinam,1,1,0,0,11
105009,paripanno,paripanno,2,2,0,0,9
105010,palipanno,palipanno,16,16,0,0,9
105011,taluno,taluno,2,2,0,0,6
105012,sukhumālo,sukhumalo,38,36,2,0,9
105013,dukkatādīnaṃ,dukkatadinam,1,1,0,0,12
105014,sukaṭaṃ,sukatam,3,3,0,0,7
105015,pahaṭo,pahato,36,36,0,0,6
105016,visaṭo,visato,4,4,0,0,6
105017,niyatādīnaṃ,niyatadinam,1,1,0,0,11
105018,nijādissa,nijadissa,1,1,0,0,9
105019,nijaṃputtaṃ,nijamputtam,1,1,0,0,11
105020,kulūpagādīnaṃ,kulupagadinam,1,1,0,0,13
105021,kulūpago,kulupago,5,5,0,0,8
105022,pariādito,pariadito,1,0,1,0,9
105023,panidhānaṃ,panidhanam,1,1,0,0,10
105024,paṇipāto,panipato,21,9,12,0,8
105025,pariṇato,parinato,12,12,0,0,8
105026,pariṇāmo,parinamo,20,20,0,0,8
105027,ninnayo,ninnayo,1,1,0,0,7
105028,uṇṇato,unnato,3,2,1,0,6
105029,oṇato,onato,9,8,1,0,5
105030,patiaggi,patiaggi,1,1,0,0,8
105031,patihaññati,patihannati,2,2,0,0,11
105032,puthajano,puthajano,1,1,0,0,9
105033,puthabhūtaṃ,puthabhutam,1,1,0,0,11
105034,ggahaṇādhikārena,ggahanadhikarena,1,1,0,0,16
105035,aputhantassāpi,aputhantassapi,1,1,0,0,14
105036,itvevaṃ,itvevam,2,2,0,0,7
105037,avanaddho,avanaddho,2,2,0,0,9
105038,avavadati,avavadati,1,1,0,0,9
105039,avasānamitīdha,avasanamitidha,1,1,0,0,14
105040,onaddho,onaddho,13,12,1,0,7
105041,avagahetvā,avagahetva,1,1,0,0,10
105042,oggahaṇañca,oggahananca,1,1,0,0,11
105043,tassokārassa,tassokarassa,1,1,0,0,12
105044,upoccāritaṃ,upoccaritam,1,1,0,0,11
105045,okāraviparītoti,okaraviparitoti,1,0,1,0,15
105046,ukārassetaṃ,ukarassetam,1,1,0,0,11
105047,tthaci,tthaci,1,1,0,0,6
105048,ggahetvā,ggahetva,2,2,0,0,8
105049,atippakho,atippakho,1,1,0,0,9
105050,parasataṃ,parasatam,1,1,0,0,9
105051,parasahassaṃ,parasahassam,1,1,0,0,12
105052,atippa,atippa,2,0,2,0,6
105053,yavamada,yavamada,1,1,0,0,8
105054,manamayaṃ,manamayam,1,1,0,0,9
105055,ayamayaṃ,ayamayam,2,2,0,0,8
105056,manogaṇādīnamanto,manoganadinamanto,1,1,0,0,17
105057,ottamāpajjate,ottamapajjate,1,1,0,0,13
105058,siroruho,siroruho,4,4,0,0,8
105059,manamattena,manamattena,1,1,0,0,11
105060,manacchaṭṭhānaṃ,manacchatthanam,38,36,2,0,15
105061,ayakapallaṃ,ayakapallam,3,3,0,0,11
105062,tamavinodano,tamavinodano,3,3,0,0,12
105063,byañjanasandhividhānaṃ,byanjanasandhividhanam,1,1,0,0,22
105064,niggahītasandhividhāna,niggahitasandhividhana,1,1,0,0,22
105065,nimittānusvarānaṃ,nimittanusvaranam,1,1,0,0,17
105066,tabbaggapañcamo,tabbaggapancamo,2,2,0,0,15
105067,raṇañjaho,rananjaho,11,11,0,0,9
105068,taṅkhaṇaṃ,tankhanam,22,22,0,0,9
105069,taṃkhaṇaṃ,tamkhanam,6,6,0,0,9
105070,saṃgaho,samgaho,1,1,0,0,7
105071,taṅghataṃ,tanghatam,2,2,0,0,9
105072,tañchannaṃ,tanchannam,2,2,0,0,10
105073,tañjātaṃ,tanjatam,2,2,0,0,8
105074,taññāṇaṃ,tannanam,2,2,0,0,8
105075,taṇḍahati,tandahati,2,2,0,0,9
105076,tantanoti,tantanoti,2,2,0,0,9
105077,tanthiraṃ,tanthiram,2,2,0,0,9
105078,tandānaṃ,tandanam,2,2,0,0,8
105079,niccutaṃ,niccutam,2,2,0,0,8
105080,tampatto,tampatto,3,3,0,0,8
105081,tesambodho,tesambodho,1,1,0,0,10
105082,saṃbhūto,sambhuto,1,1,0,0,8
105083,dātuṅgato,datungato,2,2,0,0,9
105084,copari,copari,1,1,0,0,6
105085,vijjhantare,vijjhantare,1,1,0,0,11
105086,ggahaṇakaraṇamatthantaraviññāpanatthaṃ,ggahanakaranamatthantaravinnapanattham,1,1,0,0,38
105087,upasaggapumantassa,upasaggapumantassa,1,1,0,0,18
105088,paṭisaṃlīno,patisamlino,1,1,0,0,11
105089,paṭisallīno,patisallino,47,45,2,0,11
105090,sallekho,sallekho,90,83,7,0,8
105091,puṃliṅgaṃ,pumlingam,3,3,0,0,9
105092,paccattaññevapaccattaṃ,paccattannevapaccattam,1,1,0,0,22
105093,evahi,evahi,1,0,1,0,5
105094,saṃyācikāya,samyacikaya,7,7,0,0,11
105095,ānantarikaṃ,anantarikam,19,19,0,0,11
105096,yamāhu,yamahu,52,41,11,0,6
105097,saññācikāya,sannacikaya,49,44,5,0,11
105098,ānantarikaññamāhu,anantarikannamahu,2,2,0,0,17
105099,vavatthitavibhāsattāva,vavatthitavibhasattava,1,1,0,0,22
105100,padantato,padantato,1,1,0,0,9
105101,kāraparato,karaparato,1,1,0,0,10
105102,niggahītā,niggahita,2,2,0,0,9
105103,sukhuccāraṇatthamakkharalopopīti,sukhuccaranatthamakkharalopopiti,1,1,0,0,32
105104,pariyesanāya,pariyesanaya,37,34,3,0,12
105105,pariyesanātiādi,pariyesanatiadi,1,1,0,0,15
105106,nindituṃ,ninditum,5,5,0,0,8
105107,saddādhikārassa,saddadhikarassa,1,1,0,0,15
105108,dhanameva,dhanameva,21,21,0,0,9
105109,kimetaṃ,kimetam,74,69,5,0,7
105110,yadaniccaṃ,yadaniccam,124,121,3,0,10
105111,tadanattā,tadanatta,70,70,0,0,9
105112,madāti,madati,4,0,4,0,6
105113,saraṇama,saranama,3,3,0,0,8
105114,sukhuccāraṇaṭṭhāne,sukhuccaranatthane,2,2,0,0,18
105115,adāsāhaṃ,adasaham,4,4,0,0,8
105116,tathāgatāhaṃ,tathagataham,1,1,0,0,12
105117,saṃrāgo,samrago,3,3,0,0,7
105118,saṃrambho,samrambho,2,2,0,0,9
105119,avisaṃhāro,avisamharo,2,2,0,0,10
105120,pavāsiṃ,pavasim,1,1,0,0,7
105121,kāresu,karesu,3,3,0,0,6
105122,upasaggantassa,upasaggantassa,2,2,0,0,14
105123,ariyasaccāna,ariyasaccana,25,21,4,0,12
105124,sāratto,saratto,166,165,1,0,7
105125,avisāhāro,avisaharo,44,40,4,0,9
105126,gantukāmo,gantukamo,203,200,3,0,9
105127,abhinanduṃ,abhinandum,15,8,7,0,10
105128,uttariṃ,uttarim,344,327,17,0,7
105129,vaggantattaṃ,vaggantattam,11,11,0,0,12
105130,kalindāni,kalindani,1,1,0,0,9
105131,kindāni,kindani,1,1,0,0,7
105132,uttarimpi,uttarimpi,53,53,0,0,9
105133,dātumpi,datumpi,13,12,1,0,7
105134,sadisaṃva,sadisamva,2,2,0,0,9
105135,dātumapi,datumapi,2,2,0,0,8
105136,itīvīdānisīpevādito,itividanisipevadito,1,1,0,0,19
105137,visaññogova,visannogova,1,1,0,0,11
105138,saṃyogekadesassa,samyogekadesassa,1,1,0,0,16
105139,purimabyañjanassa,purimabyanjanassa,1,1,0,0,17
105140,byañjanānamekatra,byanjananamekatra,1,1,0,0,17
105141,saṃyujjatīti,samyujjatiti,3,2,1,0,12
105142,sarūpasaṃyogopi,sarupasamyogopi,1,1,0,0,15
105143,yāvacidha,yavacidha,1,1,0,0,9
105144,aṇuthūlāni,anuthulani,1,1,0,0,10
105145,ibhīdha,ibhidha,1,1,0,0,7
105146,rassatoyevāyaṃ,rassatoyevayam,1,1,0,0,14
105147,taṃsampayuttā,tamsampayutta,118,110,8,0,13
105148,taṃsabhāvo,tamsabhavo,10,10,0,0,10
105149,sanamaṃ,sanamam,1,1,0,0,7
105150,lopādesakāriye,lopadesakariye,1,1,0,0,14
105151,tadapavādatthamāha,tadapavadatthamaha,1,1,0,0,18
105152,avuttavisesānampi,avuttavisesanampi,1,1,0,0,17
105153,vuttanayātidesatthamatidesamāha,vuttanayatidesatthamatidesamaha,1,1,0,0,31
105154,upadiṭṭhā,upadittha,1,1,0,0,9
105155,upasagganipātādayo,upasagganipatadayo,1,1,0,0,18
105156,sarasandhādīsu,sarasandhadisu,1,1,0,0,14
105157,pariyādīnaṃ,pariyadinam,2,2,0,0,11
105158,rahanādivaṇṇassa,rahanadivannassa,1,1,0,0,16
105159,yavādīhi,yavadihi,1,1,0,0,8
105160,pariyudāhāsi,pariyudahasi,1,1,0,0,12
105161,payirudāhāsi,payirudahasi,12,12,0,0,12
105162,ayirassa,ayirassa,2,2,0,0,8
105163,abhineyya,abhineyya,1,1,0,0,9
105164,anabhineyya,anabhineyya,8,5,3,0,11
105165,jānāthā,janatha,96,92,4,0,7
105166,tadamināpi,tadaminapi,12,8,4,0,10
105167,niggahītasandhividhānaṃ,niggahitasandhividhanam,1,1,0,0,23
105168,sunicchayo,sunicchayo,1,1,0,0,10
105169,mayettha,mayettha,2,2,0,0,8
105170,rūpasiddhiyaṃ,rupasiddhiyam,7,6,1,0,13
105171,sandhikaṇḍo,sandhikando,3,3,0,0,11
105172,nāmikavibhatyāvatāro,namikavibhatyavataro,1,1,0,0,20
105173,atthābhimukhaṃ,atthabhimukham,5,5,0,0,14
105174,namanato,namanato,18,17,1,0,8
105175,catthassa,catthassa,8,8,0,0,9
105176,nāmanato,namanato,4,4,0,0,8
105177,dabbābhidhānaṃ,dabbabhidhanam,2,2,0,0,14
105178,anvattharuḷhīvasena,anvattharulhivasena,3,3,0,0,19
105179,pumitthinapuṃsakaliṅgavasena,pumitthinapumsakalingavasena,1,1,0,0,28
105180,sāmaññaguṇakriyāyadicchāvasena,samannagunakriyayadicchavasena,1,1,0,0,30
105181,sirivaḍḍhotiādi,sirivaddhotiadi,1,1,0,0,15
105182,aṭṭhavidhaṃ,atthavidham,107,97,10,0,11
105183,avaṇṇivaṇṇuvaṇṇokāraniggahītantapakatibhedena,avannivannuvannokaraniggahitantapakatibhedena,1,1,0,0,45
105184,kārantamhā,karantamha,1,1,0,0,10
105185,jātinimittā,jatinimitta,1,1,0,0,11
105186,divibhattiyo,divibhattiyo,1,1,0,0,12
105187,yojīyante,yojiyante,4,4,0,0,9
105188,jinavacanaṃ,jinavacanam,19,16,3,0,11
105189,jinavacanassa,jinavacanassa,1,1,0,0,13
105190,tepiṭakassa,tepitakassa,8,8,0,0,11
105191,anurūpamevāti,anurupamevati,3,3,0,0,13
105192,mūlabhāsā,mulabhasa,5,5,0,0,9
105193,yāyādikappikā,yayadikappika,3,3,0,0,13
105194,ssutālāpā,ssutalapa,1,1,0,0,9
105195,sīhagatikamaṇḍūkagatikayathānupubbikavasena,sihagatikamandukagatikayathanupubbikavasena,1,1,0,0,43
105196,sīhagatiko,sihagatiko,1,1,0,0,10
105197,pubbāparavilokanato,pubbaparavilokanato,1,1,0,0,19
105198,yathānupubbikoyeva,yathanupubbikoyeva,1,1,0,0,18
105199,sakkatavisadisaṃ,sakkatavisadisam,1,1,0,0,16
105200,jinavacanānurūpavasena,jinavacananurupavasena,1,1,0,0,22
105201,pakatiṭṭhapanatthaṃ,pakatitthapanattham,1,1,0,0,19
105202,dhātuppaccayavibhattivajjitassa,dhatuppaccayavibhattivajjitassa,1,1,0,0,31
105203,liṅgasaññāyaṃ,lingasannayam,2,2,0,0,13
105204,vibhattippaccayādividhāne,vibhattippaccayadividhane,1,1,0,0,25
105205,ggahaṇamanuvattate,ggahanamanuvattate,8,8,0,0,18
105206,tavetunādipaccayantanipātatopi,tavetunadipaccayantanipatatopi,1,1,0,0,30
105207,kammādivasena,kammadivasena,9,8,1,0,13
105208,liṅgatthaṃ,lingattham,3,3,0,0,10
105209,vibhajantīti,vibhajantiti,10,9,1,0,12
105210,smāhi,smahi,2,0,2,0,5
105211,dvisatta,dvisatta,1,1,0,0,8
105212,saññādhikāraparibhāsāvidhisuttesu,sannadhikaraparibhasavidhisuttesu,1,1,0,0,33
105213,saññāsuttaṃ,sannasuttam,10,9,1,0,11
105214,vibhattiiccanena,vibhattiiccanena,1,1,0,0,16
105215,purimasuttena,purimasuttena,3,3,0,0,13
105216,ekayogo,ekayogo,1,1,0,0,7
105217,kattabboti,kattabboti,15,12,3,0,10
105218,paṭhamādivohāro,pathamadivoharo,1,1,0,0,15
105219,ekavacanādivohāro,ekavacanadivoharo,1,1,0,0,17
105220,parasamaññāvasena,parasamannavasena,5,5,0,0,17
105221,dutiyātiādi,dutiyatiadi,1,1,0,0,11
105222,purimasutte,purimasutte,14,14,0,0,11
105223,saññākaraṇe,sannakarane,1,1,0,0,11
105224,appakataniratthakavidhippasaṅgo,appakataniratthakavidhippasango,1,1,0,0,31
105225,padanipphādanampi,padanipphadanampi,1,1,0,0,17
105226,jinavacanassāvirodhenāti,jinavacanassavirodhenati,1,1,0,0,24
105227,paribhāsantaramāha,paribhasantaramaha,1,1,0,0,18
105228,uparodho,uparodho,8,8,0,0,8
105229,saddenākhyātañca,saddenakhyatanca,1,1,0,0,16
105230,nipphādīyatīti,nipphadiyatiti,3,3,0,0,14
105231,dvivacanāggahaṇaṃ,dvivacanaggahanam,1,1,0,0,17
105232,sakkatavisadisato,sakkatavisadisato,1,1,0,0,17
105233,vibhattippaccayādividhānañca,vibhattippaccayadividhananca,1,1,0,0,28
105234,sabbasyādivibhattippasaṅge,sabbasyadivibhattippasange,1,1,0,0,26
105235,saddappavattī,saddappavatti,2,2,0,0,13
105236,vatticchāvasā,vatticchavasa,4,4,0,0,13
105237,aniyamenekavacanabahuvacanappasaṅge,aniyamenekavacanabahuvacanappasange,1,1,0,0,35
105238,ekamhī,ekamhi,1,1,0,0,6
105239,liṅgatthassekattavacanicchāyaṃ,lingatthassekattavacanicchayam,1,1,0,0,30
105240,paṭhamekavacanaṃ,pathamekavacanam,6,6,0,0,16
105241,nenā,nena,1,1,0,0,4
105242,paṭhamāniddiṭṭhassa,pathamanidditthassa,1,1,0,0,19
105243,kāriyino,kariyino,2,2,0,0,8
105244,chaṭṭhīvipariṇāmena,chatthiviparinamena,1,1,0,0,19
105245,ādesāpekkhanti,adesapekkhanti,1,1,0,0,14
105246,vibhattikāriyavidhippakaraṇato,vibhattikariyavidhippakaranato,1,1,0,0,30
105247,ggahaṇānuvattanato,ggahananuvattanato,1,1,0,0,18
105248,kāriyavidhāne,kariyavidhane,1,1,0,0,13
105249,vibhattiyevāti,vibhattiyevati,1,1,0,0,14
105250,tadapavādena,tadapavadena,1,1,0,0,12
105251,pubbalopamāha,pubbalopamaha,1,1,0,0,13
105252,pubbassarassa,pubbassarassa,1,1,0,0,13
105253,ādesappaccayādibhūte,adesappaccayadibhute,1,1,0,0,20
105254,punaggahaṇaṃ,punaggahanam,4,4,0,0,12
105255,katasaralopanimitteyeva,katasaralopanimitteyeva,1,1,0,0,23
105256,pakatibhāvatthaṃ,pakatibhavattham,1,1,0,0,16
105257,pakatibhāvavidhānasāmatthiyato,pakatibhavavidhanasamatthiyato,1,1,0,0,30
105258,amādesappaccayādibhūte,amadesappaccayadibhute,1,1,0,0,22
105259,paretipi,paretipi,1,1,0,0,8
105260,tyādivibhattiyo,tyadivibhattiyo,4,4,0,0,15
105261,paccayattena,paccayattena,8,7,1,0,12
105262,ādiggahaṇamākhyātakitakesvāgamatthidaṃ,adiggahanamakhyatakitakesvagamatthidam,1,1,0,0,38
105263,paccayasāhacariyā,paccayasahacariya,1,1,0,0,17
105264,pakatīparo,pakatiparo,1,1,0,0,10
105265,padantassaralopo,padantassaralopo,1,1,0,0,16
105266,bbhāhādike,bbhahadike,1,1,0,0,10
105267,saralopanivattanatthaṃ,saralopanivattanattham,1,1,0,0,22
105268,purisaiti,purisaiti,1,1,0,0,9
105269,samānarūpānaṃ,samanarupanam,1,1,0,0,13
105270,sissate,sissate,1,1,0,0,7
105271,asakinti,asakinti,1,1,0,0,8
105272,asakimpayoge,asakimpayoge,1,1,0,0,12
105273,nāsakiṃ,nasakim,1,0,1,0,7
105274,kavibhattivisayānamevāsakimpayoge,kavibhattivisayanamevasakimpayoge,1,1,0,0,33
105275,evāyanti,evayanti,3,3,0,0,8
105276,vicchāpayoge,vicchapayoge,1,1,0,0,12
105277,tippasaṅgo,tippasango,1,1,0,0,10
105278,niddeseneva,niddeseneva,2,2,0,0,11
105279,vicchāpayogasiddhiyā,vicchapayogasiddhiya,1,1,0,0,20
105280,ñāpitattā,napitatta,4,4,0,0,9
105281,sahavacanicchāya,sahavacanicchaya,1,1,0,0,16
105282,mekaseso,mekaseso,1,1,0,0,8
105283,ekasesvasakiṃ,ekasesvasakim,1,1,0,0,13
105284,liṅgatthassa,lingatthassa,2,2,0,0,12
105285,huttavacanicchāyaṃ,huttavacanicchayam,1,1,0,0,18
105286,paṭhamāyonīnaṃ,pathamayoninam,1,1,0,0,14
105287,dutiyāyonīnañca,dutiyayoninanca,1,1,0,0,15
105288,yayākkamaṃ,yayakkamam,1,1,0,0,10
105289,ākārekārādesā,akarekaradesa,2,2,0,0,13
105290,sabbādesatthaṃ,sabbadesattham,1,1,0,0,14
105291,purimasadisameva,purimasadisameva,82,82,0,0,16
105292,vavatthitapibhāsattho,vavatthitapibhasattho,1,1,0,0,21
105293,niccameva,niccameva,44,36,8,0,9
105294,aniccañca,aniccanca,8,6,2,0,9
105295,katatte,katatte,1,1,0,0,7
105296,vidhiṃ,vidhim,94,83,11,0,6
105297,tatthevālapanavacanicchāyaṃ,tatthevalapanavacanicchayam,1,1,0,0,27
105298,bhimukhaṃ,bhimukham,3,3,0,0,9
105299,ālapanatthādhike,alapanatthadhike,1,1,0,0,16
105300,ekavacanādi,ekavacanadi,2,2,0,0,11
105301,pitusatthu,pitusatthu,1,0,1,0,10
105302,kārattamāpajjate,karattamapajjate,1,1,0,0,16
105303,adūraṭṭhassālapanevāyaṃ,aduratthassalapanevayam,1,1,0,0,23
105304,dutiyatthasampiṇḍanatthaṃ,dutiyatthasampindanattham,1,1,0,0,25
105305,vacanameva,vacanameva,47,45,2,0,10
105306,ñāpakamaññatthāpi,napakamannatthapi,1,1,0,0,17
105307,ālapanāggahaṇassa,alapanaggahanassa,1,1,0,0,17
105308,ālapanābhibyattiyā,alapanabhibyattiya,1,1,0,0,18
105309,kammatthavacanicchāyaṃ,kammatthavacanicchayam,1,1,0,0,22
105310,vikaroti,vikaroti,3,3,0,0,8
105311,kriyānimittaṃ,kriyanimittam,1,1,0,0,13
105312,kattuvacanicchāyaṃ,kattuvacanicchayam,1,1,0,0,18
105313,attappadhāno,attappadhano,6,6,0,0,12
105314,tatiyekavacanaṃ,tatiyekavacanam,1,1,0,0,15
105315,enāti,enati,1,0,1,0,5
105316,bahuvacanamhi,bahuvacanamhi,2,2,0,0,13
105317,vibhattirūpesu,vibhattirupesu,1,1,0,0,14
105318,karaṇavacanicchāyaṃ,karanavacanicchayam,1,1,0,0,19
105319,āviṭṭhena,avitthena,1,1,0,0,9
105320,sampadānavacanicchāyaṃ,sampadanavacanicchayam,1,1,0,0,22
105321,antabhūtā,antabhuta,1,1,0,0,9
105322,rassasarā,rassasara,4,4,0,0,9
105323,ggahaṇamikārukārānaṃ,ggahanamikarukaranam,1,1,0,0,20
105324,tatthevāpādānavacanicchāyaṃ,tatthevapadanavacanicchayam,1,1,0,0,27
105325,avadhibhūtā,avadhibhuta,1,1,0,0,11
105326,smāsmiṃna,smasmimna,1,0,1,0,9
105327,tatiyāsamaṃ,tatiyasamam,4,4,0,0,11
105328,sāmivacanicchāyaṃ,samivacanicchayam,1,1,0,0,17
105329,sāmisaññaṃ,samisannam,1,1,0,0,10
105330,okāsavacanicchāyaṃ,okasavacanicchayam,1,1,0,0,18
105331,kattukammānaṃ,kattukammanam,4,4,0,0,13
105332,sugatena,sugatena,56,50,6,0,8
105333,sugatehi,sugatehi,9,9,0,0,8
105334,sugatebhi,sugatebhi,7,7,0,0,9
105335,sugatānaṃ,sugatanam,8,8,0,0,9
105336,sugatasmā,sugatasma,3,3,0,0,9
105337,sugatamhā,sugatamha,3,3,0,0,9
105338,sugatasmiṃ,sugatasmim,7,7,0,0,10
105339,sugatamhi,sugatamhi,3,3,0,0,9
105340,sugatesu,sugatesu,15,15,0,0,8
105341,raga,raga,3,3,0,0,4
105342,pisāca,pisaca,3,3,0,0,6
105343,mātaṅga,matanga,14,13,1,0,7
105344,jaṅgama,jangama,3,3,0,0,7
105345,turaṅga,turanga,5,5,0,0,7
105346,kacchapa,kacchapa,8,7,1,0,8
105347,taraccha,taraccha,2,2,0,0,8
105348,soṇā,sona,42,41,1,0,4
105349,āloka,aloka,6,5,1,0,5
105350,nilayā,nilaya,3,3,0,0,6
105351,nila,nila,3,3,0,0,4
105352,vāyāma,vayama,4,4,0,0,6
105353,nigamā,nigama,15,15,0,0,6
105354,ghosa,ghosa,3,3,0,0,5
105355,paṭighā,patigha,6,5,1,0,7
105356,lobhā,lobha,45,33,12,0,5
105357,sārambha,sarambha,6,5,1,0,8
105358,pamāda,pamada,17,17,0,0,6
105359,makkhā,makkha,5,5,0,0,6
105360,punnāga,punnaga,8,7,1,0,7
105361,pūga,puga,3,3,0,0,4
105362,panasā,panasa,18,18,0,0,6
105363,campaka,campaka,6,4,2,0,7
105364,hintāla,hintala,5,5,0,0,7
105365,bakula,bakula,2,1,1,0,6
105366,jjuna,jjuna,3,3,0,0,5
105367,kiṃsukā,kimsuka,9,9,0,0,7
105368,mandāra,mandara,2,2,0,0,7
105369,pucimanda,pucimanda,2,2,0,0,9
105370,karañja,karanja,2,2,0,0,7
105371,sakunaṇḍaja,sakunandaja,1,1,0,0,11
105372,manogaṇādissa,manoganadissa,1,0,1,0,13
105373,nāsasmāsmiṃsu,nasasmasmimsu,2,2,0,0,13
105374,purisasamaṃ,purisasamam,7,7,0,0,11
105375,manopabhuti,manopabhuti,1,1,0,0,11
105376,ikārākārādesā,ikarakaradesa,1,1,0,0,13
105377,bilapadā,bilapada,1,0,1,0,8
105378,ntussā,ntussa,4,4,0,0,6
105379,ggahaṇakaraṇato,ggahanakaranato,1,1,0,0,15
105380,vaṇṇaiccete,vannaiccete,1,1,0,0,11
105381,sasmiṃnā,sasmimna,1,0,1,0,8
105382,iccayamādeso,iccayamadeso,3,3,0,0,12
105383,nābyapadeso,nabyapadeso,1,1,0,0,11
105384,guṇavantamhī,gunavantamhi,1,1,0,0,12
105385,kulavā,kulava,3,3,0,0,6
105386,ggahaṇakaraṇaṃ,ggahanakaranam,2,2,0,0,14
105387,attanisedhanatthaṃ,attanisedhanattham,1,1,0,0,18
105388,guṇavantādīsu,gunavantadisu,1,1,0,0,13
105389,hirimā,hirima,42,41,1,0,6
105390,kalimā,kalima,6,6,0,0,6
105391,bandhumantu,bandhumantu,1,0,1,0,11
105392,bandhumantassa,bandhumantassa,1,1,0,0,14
105393,ccevamādīnaṃ,ccevamadinam,1,1,0,0,12
105394,ppaccayantānaṃ,ppaccayantanam,1,1,0,0,14
105395,aṃrūpaṃ,amrupam,1,1,0,0,7
105396,āpajjate,apajjate,10,10,0,0,8
105397,saralopa,saralopa,1,1,0,0,8
105398,smi,smi,21,20,1,0,3
105399,kāriyātidesoyaṃ,kariyatidesoyam,1,1,0,0,15
105400,obhāvo,obhavo,2,1,1,0,6
105401,bhontādi,bhontadi,1,1,0,0,8
105402,bhontā,bhonta,10,10,0,0,6
105403,bhonte,bhonte,5,5,0,0,6
105404,bhadantassa,bhadantassa,8,7,1,0,11
105405,bhaddanta,bhaddanta,7,5,2,0,9
105406,bhadanta,bhadanta,9,8,1,0,8
105407,saddādeso,saddadeso,4,4,0,0,9
105408,kārepi,karepi,4,4,0,0,6
105409,disaddato,disaddato,1,1,0,0,9
105410,brahmattasakharājā,brahmattasakharaja,1,0,1,0,18
105411,vikappanattho,vikappanattho,26,23,3,0,13
105412,savibhattissā,savibhattissa,2,2,0,0,13
105413,raññorājino,rannorajino,1,0,1,0,11
105414,amhatumhanturājabrahmattasakhasatthupitādīhi,amhatumhanturajabrahmattasakhasatthupitadihi,2,1,1,0,44
105415,amhatumhanturājabrahmattasakhasatthupituiccevamādīhi,amhatumhanturajabrahmattasakhasatthupituiccevamadihi,1,1,0,0,52
105416,nābhāvātideso,nabhavatideso,2,2,0,0,13
105417,atideso,atideso,10,9,1,0,7
105418,taṃrūpaṃ,tamrupam,5,4,1,0,8
105419,taṃsabhāvatā,tamsabhavata,10,10,0,0,12
105420,suttañceva,suttanceva,2,2,0,0,10
105421,kāriyātidesoti,kariyatidesoti,1,1,0,0,14
105422,brahmattasakhā,brahmattasakha,1,0,1,0,14
105423,pāṭhasāmatthiyato,pathasamatthiyato,1,1,0,0,17
105424,rūpātideso,rupatideso,1,0,1,0,10
105425,ggahaṇānukaḍḍhanatthaṃ,ggahananukaddhanattham,1,1,0,0,22
105426,utta,utta,3,1,2,0,4
105427,bhāvaniddeso,bhavaniddeso,16,15,1,0,12
105428,abhāvadassanattho,abhavadassanattho,1,1,0,0,17
105429,iccādeso,iccadeso,8,8,0,0,8
105430,kammacammamuddhā,kammacammamuddha,1,0,1,0,16
105431,tatiyādīsveva,tatiyadisveva,1,1,0,0,13
105432,nābhāvātideseneva,nabhavatideseneva,1,0,1,0,17
105433,uttarasuttena,uttarasuttena,1,1,0,0,13
105434,ekayogamakatvā,ekayogamakatva,1,1,0,0,14
105435,attantata,attantata,1,0,1,0,9
105436,cāyono,cayono,1,0,1,0,6
105437,nonānaṃsa,nonanamsa,1,0,1,0,9
105438,sakhantassa,sakhantassa,4,4,0,0,11
105439,sakhantassā,sakhantassa,1,1,0,0,11
105440,paṭhamādutiyāsu,pathamadutiyasu,5,5,0,0,15
105441,maghavayuvā,maghavayuva,1,0,1,0,11
105442,dīnamantassa,dinamantassa,4,4,0,0,12
105443,pumakammathāmantassa,pumakammathamantassa,1,1,0,0,20
105444,vibhattimhī,vibhattimhi,1,1,0,0,11
105445,savibhattiggahaṇanivattanatthaṃ,savibhattiggahananivattanattham,1,1,0,0,31
105446,yuvamaghavā,yuvamaghava,2,0,2,0,11
105447,sabbavibhattīsu,sabbavibhattisu,7,7,0,0,15
105448,pumantassukāro,pumantassukaro,1,1,0,0,14
105449,yuvādīsu,yuvadisu,1,1,0,0,8
105450,iccetesūti,iccetesuti,1,1,0,0,10
105451,saññaka,sannaka,1,1,0,0,7
105452,kāravajjito,karavajjito,1,1,0,0,11
105453,paresūti,paresuti,7,3,4,0,8
105454,sāsu,sasu,2,2,0,0,4
105455,gāṇḍīvadhanvāpabhutayo,gandivadhanvapabhutayo,1,1,0,0,22
105456,itthivācakehi,itthivacakehi,1,1,0,0,13
105457,ākārivaṇṇuvaṇṇehi,akarivannuvannehi,1,1,0,0,17
105458,liṅgassantabhūtā,lingassantabhuta,1,1,0,0,16
105459,kāralopā,karalopa,1,1,0,0,8
105460,katanikāralopā,katanikaralopa,1,0,1,0,14
105461,ālapanepevaṃ,alapanepevam,2,2,0,0,12
105462,pubbassaralope,pubbassaralope,5,5,0,0,14
105463,dīghābhāvo,dighabhavo,1,1,0,0,10
105464,aggihi,aggihi,2,2,0,0,6
105465,aggibhi,aggibhi,5,5,0,0,7
105466,agginaṃ,agginam,1,1,0,0,7
105467,aggisu,aggisu,1,1,0,0,6
105468,jaladhi,jaladhi,5,5,0,0,7
105469,urudhiti,urudhiti,1,1,0,0,8
105470,varamati,varamati,11,11,0,0,8
105471,udadhippabhutayo,udadhippabhutayo,2,2,0,0,16
105472,ṇḍīsaddo,ndisaddo,1,1,0,0,8
105473,etthevā,ettheva,6,4,2,0,7
105474,napuṃsakavajjitāni,napumsakavajjitani,1,1,0,0,18
105475,rassamāpajjanteti,rassamapajjanteti,1,1,0,0,17
105476,rassattābhāvo,rassattabhavo,1,1,0,0,13
105477,visadāvisadākāravohārobhayamuttakā,visadavisadakaravoharobhayamuttaka,1,1,0,0,34
105478,pumādijānane,pumadijanane,2,2,0,0,12
105479,hetubhāvato,hetubhavato,51,50,1,0,11
105480,liṅgamīritā,lingamirita,1,1,0,0,11
105481,sālapanānaṃ,salapananam,1,1,0,0,11
105482,adhikāraṃ,adhikaram,96,91,5,0,9
105483,akatarassāpi,akatarassapi,1,1,0,0,12
105484,itiādināva,itiadinava,12,12,0,0,10
105485,punārambho,punarambho,3,3,0,0,10
105486,niyamattho,niyamattho,11,11,0,0,10
105487,vammī,vammi,2,2,0,0,5
105488,mālyakārī,malyakari,2,2,0,0,9
105489,gāmaṇino,gamanino,3,3,0,0,8
105490,gāmaṇinaṃ,gamaninam,1,1,0,0,9
105491,gāmaṇiṃ,gamanim,19,18,1,0,7
105492,ādesābhāvova,adesabhavova,1,1,0,0,12
105493,ppabhutayo,ppabhutayo,1,1,0,0,10
105494,saddaggahaṇaṃ,saddaggahanam,21,21,0,0,13
105495,noggahaṇānuvattanatthaṃ,noggahananuvattanattham,1,1,0,0,23
105496,jantusabbaññū,jantusabbannu,1,0,1,0,13
105497,vavatthitavibhāsattho,vavatthitavibhasattho,3,3,0,0,21
105498,bhikkhuppabhutito,bhikkhuppabhutito,1,1,0,0,17
105499,hetuādito,hetuadito,1,1,0,0,9
105500,amuppabhutito,amuppabhutito,1,1,0,0,13
105501,jhalapehī,jhalapehi,4,4,0,0,9
105502,bhikkhuhi,bhikkhuhi,7,7,0,0,9
105503,bhikkhubhi,bhikkhubhi,2,2,0,0,10
105504,bhikkhusu,bhikkhusu,16,16,0,0,9
105505,hetujantu,hetujantu,1,0,1,0,9
105506,mitibhāvaniddesena,mitibhavaniddesena,2,2,0,0,18
105507,aniyamaṃ,aniyamam,9,9,0,0,8
105508,catuubhanadīgavā,catuubhanadigava,1,0,1,0,16
105509,satthunāti,satthunati,4,3,1,0,10
105510,naṃmhī,nammhi,4,4,0,0,6
105511,desāpavādoyaṃ,desapavadoyam,1,1,0,0,13
105512,bhāvaniddesenārābhāvo,bhavaniddesenarabhavo,1,1,0,0,21
105513,ārattaṃ,arattam,2,2,0,0,7
105514,ikāre,ikare,4,4,0,0,5
105515,kattāre,kattare,2,2,0,0,7
105516,kattārebhi,kattarebhi,2,2,0,0,10
105517,kattunaṃ,kattunam,3,3,0,0,8
105518,kattusu,kattusu,2,2,0,0,7
105519,netu,netu,4,4,0,0,4
105520,jetu,jetu,4,4,0,0,4
105521,chettu,chettu,4,4,0,0,6
105522,bhettu,bhettu,3,3,0,0,6
105523,boddhu,boddhu,2,2,0,0,6
105524,viññāpetu,vinnapetu,1,1,0,0,9
105525,ādayopi,adayopi,8,8,0,0,7
105526,sakamandhātādīnañca,sakamandhatadinanca,1,0,1,0,19
105527,sakamandhātu,sakamandhatu,5,4,1,0,12
105528,mahāmandhātuppabhutayo,mahamandhatuppabhutayo,1,1,0,0,22
105529,desābhāvepi,desabhavepi,1,1,0,0,11
105530,asimhīti,asimhiti,1,0,1,0,8
105531,adhikavacanamatthantaraviññāpanatthaṃ,adhikavacanamatthantaravinnapanattham,1,1,0,0,37
105532,dīnamikāro,dinamikaro,1,1,0,0,10
105533,dhītito,dhitito,1,1,0,0,7
105534,pitipakkho,pitipakkho,5,5,0,0,10
105535,mātipakkhoti,matipakkhoti,1,1,0,0,12
105536,pitare,pitare,4,4,0,0,6
105537,pituhi,pituhi,3,3,0,0,6
105538,pitubhi,pitubhi,2,2,0,0,7
105539,dīghābhāve,dighabhave,1,1,0,0,10
105540,pitunaṃ,pitunam,4,4,0,0,7
105541,pitusu,pitusu,2,2,0,0,6
105542,abhibhuvo,abhibhuvo,4,4,0,0,9
105543,abhibhu,abhibhu,20,19,1,0,7
105544,abhibhunā,abhibhuna,6,6,0,0,9
105545,abhibhūhi,abhibhuhi,4,4,0,0,9
105546,abhibhūbhi,abhibhubhi,1,1,0,0,10
105547,abhibhūnaṃ,abhibhunam,3,3,0,0,10
105548,vessabhū,vessabhu,82,68,14,0,8
105549,sahabhūādayo,sahabhuadayo,1,1,0,0,12
105550,ādesova,adesova,1,1,0,0,7
105551,dhikārassa,dhikarassa,4,4,0,0,10
105552,tathaññū,tathannu,1,1,0,0,8
105553,seddena,seddena,1,1,0,0,7
105554,smāsmiṃsu,smasmimsu,1,0,1,0,9
105555,aṃmhī,ammhi,2,1,1,0,5
105556,āvassa,avassa,1,1,0,0,6
105557,goṇasmā,gonasma,1,1,0,0,7
105558,goṇasmiṃ,gonasmim,1,1,0,0,8
105559,tipadamidaṃ,tipadamidam,2,2,0,0,11
105560,saddokārassa,saddokarassa,2,2,0,0,12
105561,gavaṃpatissa,gavampatissa,1,1,0,0,12
105562,gunnaṃgonaṃ,gunnamgonam,1,1,0,0,11
105563,ggi,ggi,3,3,0,0,3
105564,bhibhū,bhibhu,1,1,0,0,6
105565,pulliṅgasaṅgaho,pullingasangaho,1,1,0,0,15
105566,etimāsamī,etimasami,1,1,0,0,9
105567,etimā,etima,1,0,1,0,5
105568,pañcamiyantavasena,pancamiyantavasena,1,1,0,0,18
105569,nassāya,nassaya,4,4,0,0,7
105570,pañcamīchaṭṭhīsu,pancamichatthisu,1,1,0,0,16
105571,tatiyācatutthīsamaṃ,tatiyacatutthisamam,2,2,0,0,19
105572,desābhāvā,desabhava,1,1,0,0,9
105573,desagatikattā,desagatikatta,1,1,0,0,13
105574,desepi,desepi,2,2,0,0,6
105575,saddādhikārato,saddadhikarato,1,1,0,0,14
105576,aññekā,anneka,1,0,1,0,6
105577,saddādīnamantassa,saddadinamantassa,1,1,0,0,17
105578,sabbassimassā,sabbassimassa,1,1,0,0,13
105579,anitthiliṅgassevetaṃ,anitthilingassevetam,1,1,0,0,20
105580,āppaccayantāniddesā,appaccayantaniddesa,1,1,0,0,19
105581,avuttato,avuttato,2,2,0,0,8
105582,anitthiliṅgassevettha,anitthilingassevettha,1,1,0,0,21
105583,gahaṇañhi,gahananhi,1,1,0,0,9
105584,imassiti,imassiti,1,1,0,0,8
105585,smiṃsaṃ,smimsam,1,0,1,0,7
105586,mādesasilopā,madesasilopa,1,1,0,0,12
105587,catutthiyaṃ,catutthiyam,7,7,0,0,11
105588,vuddhilopā,vuddhilopa,2,1,1,0,10
105589,puṃsake,pumsake,1,0,1,0,7
105590,iccayamāgamo,iccayamagamo,1,1,0,0,12
105591,anuvattamāna,anuvattamana,1,1,0,0,12
105592,amuhi,amuhi,2,2,0,0,5
105593,amubhi,amubhi,2,2,0,0,6
105594,adussa,adussa,4,4,0,0,6
105595,amusaṃ,amusam,4,4,0,0,6
105596,amusānaṃ,amusanam,2,2,0,0,8
105597,amusu,amusu,1,1,0,0,5
105598,amusi,amusi,1,0,1,0,5
105599,imassida,imassida,1,0,1,0,8
105600,miccādito,miccadito,2,2,0,0,9
105601,ppaccayato,ppaccayato,1,1,0,0,10
105602,vibhattibhedesu,vibhattibhedesu,1,1,0,0,15
105603,ppaccayāvasiṭṭha,ppaccayavasittha,1,1,0,0,16
105604,mādippaccayānaṃ,madippaccayanam,1,1,0,0,15
105605,vibhattiyova,vibhattiyova,1,1,0,0,12
105606,niggahītalopādi,niggahitalopadi,1,1,0,0,15
105607,parāyaṃ,parayam,1,1,0,0,7
105608,lopavidhissa,lopavidhissa,1,1,0,0,12
105609,balavatarattā,balavataratta,4,4,0,0,13
105610,vibhattiparattābhāvā,vibhattiparattabhava,1,1,0,0,20
105611,tadanuparodhenā,tadanuparodhena,3,3,0,0,15
105612,niggahītalope,niggahitalope,2,2,0,0,13
105613,bahuvacanantova,bahuvacanantova,4,4,0,0,15
105614,namokāro,namokaro,1,1,0,0,8
105615,purisāubhe,purisaubhe,1,1,0,0,10
105616,ekārassokāro,ekarassokaro,1,1,0,0,12
105617,ubhesu,ubhesu,1,1,0,0,6
105618,saṅkhyāsaṅkhyeyyavacanā,sankhyasankhyeyyavacana,1,1,0,0,23
105619,vācitattā,vacitatta,1,1,0,0,9
105620,saṅkhyāsaddassa,sankhyasaddassa,3,3,0,0,15
105621,bahuvacanu,bahuvacanu,1,0,1,0,10
105622,ccāraṇaṃ,ccaranam,1,1,0,0,8
105623,dutiyāyampi,dutiyayampi,2,2,0,0,11
105624,itthiyaṃti,itthiyamti,1,1,0,0,10
105625,yosū,yosu,2,2,0,0,4
105626,tayocattārotīṇi,tayocattarotini,1,0,1,0,15
105627,nnaṃ,nnam,2,2,0,0,4
105628,cattārotīṇi,cattarotini,1,0,1,0,11
105629,byavadhānato,byavadhanato,1,1,0,0,12
105630,yathāvuttādeso,yathavuttadeso,1,1,0,0,14
105631,caturukārassa,caturukarassa,1,1,0,0,13
105632,nīlādiguṇanāmañca,niladigunanamanca,1,1,0,0,17
105633,taddhitaṃ,taddhitam,7,6,1,0,9
105634,sāmaññavutyatītādikitantaṃ,samannavutyatitadikitantam,1,1,0,0,26
105635,etamiti,etamiti,2,2,0,0,7
105636,thīpunnapuṃsakāniti,thipunnapumsakaniti,1,1,0,0,19
105637,aliṅganāma,alinganama,1,1,0,0,10
105638,athāliṅgesu,athalingesu,1,1,0,0,11
105639,nāmesu,namesu,14,14,0,0,6
105640,tumhamha,tumhamha,2,0,2,0,8
105641,panāliṅgattā,panalingatta,2,2,0,0,12
105642,samānarūpaṃ,samanarupam,7,7,0,0,11
105643,tvaṃahaṃ,tvamaham,1,0,1,0,8
105644,tuva,tuva,2,1,1,0,4
105645,mahemase,mahemase,3,3,0,0,8
105646,amhassā,amhassa,1,1,0,0,7
105647,gāravabahumānena,garavabahumanena,7,7,0,0,16
105648,bahuttasamāropā,bahuttasamaropa,1,1,0,0,15
105649,tumhamhe,tumhamhe,3,0,3,0,8
105650,vikappenāyaṃ,vikappenayam,2,2,0,0,12
105651,vijjhantarassa,vijjhantarassa,1,1,0,0,14
105652,tuyhaṃmayhaṃ,tuyhammayham,1,0,1,0,12
105653,miccādeso,miccadeso,1,1,0,0,9
105654,amhatumhanturāja,amhatumhanturaja,1,1,0,0,16
105655,bhāvātideso,bhavatideso,1,1,0,0,11
105656,smiṃmhī,smimmhi,1,1,0,0,7
105657,ādesantaravidhāne,adesantaravidhane,1,1,0,0,17
105658,ekavacanesū,ekavacanesu,1,1,0,0,11
105659,bahuvacanesū,bahuvacanesu,1,1,0,0,12
105660,desissāmi,desissami,7,7,0,0,9
105661,tumhāka,tumhaka,13,13,0,0,7
105662,catutthīchaṭṭhīsū,catutthichatthisu,1,1,0,0,17
105663,catutthīchaṭṭhīsu,catutthichatthisu,1,1,0,0,17
105664,vikappanatthāya,vikappanatthaya,9,9,0,0,15
105665,pādādo,padado,4,4,0,0,6
105666,diyoge,diyoge,2,2,0,0,6
105667,socāmi,socami,52,52,0,0,6
105668,tuyhañcāpi,tuyhancapi,3,3,0,0,10
105669,raṭṭhavaḍḍhana,ratthavaddhana,30,30,0,0,14
105670,evamidaṃ,evamidam,191,187,4,0,8
105671,dīghamaddhānaṃ,dighamaddhanam,144,132,12,0,14
105672,sandhāvitaṃ,sandhavitam,53,40,13,0,11
105673,saṃsaritaṃ,samsaritam,70,55,15,0,10
105674,mamañceva,mamanceva,47,38,9,0,9
105675,tumhākañcāti,tumhakancati,7,1,6,0,12
105676,mamabravīti,mamabraviti,1,1,0,0,11
105677,temekavacane,temekavacane,1,1,0,0,12
105678,tatiyābahuvacane,tatiyabahuvacane,1,1,0,0,16
105679,maṭṭhārasa,mattharasa,2,0,2,0,10
105680,ntānaṃ,ntanam,5,5,0,0,6
105681,cāliṅgattā,calingatta,1,1,0,0,10
105682,tiliṅgepi,tilingepi,1,1,0,0,9
105683,itthippaccayābhāvo,itthippaccayabhavo,2,2,0,0,18
105684,vattamānānamantassa,vattamananamantassa,1,1,0,0,19
105685,ādesāpavādoyaṃ,adesapavadoyam,1,1,0,0,14
105686,dutiyāyañca,dutiyayanca,2,2,0,0,11
105687,saṅkhyānamanto,sankhyanamanto,1,1,0,0,14
105688,ttadīghāpavādoyaṃ,ttadighapavadoyam,1,1,0,0,17
105689,aṭṭhanava,atthanava,2,1,1,0,9
105690,dvandasamāse,dvandasamase,3,3,0,0,12
105691,dviekaaṭṭha,dviekaattha,1,0,1,0,11
105692,kādasa,kadasa,1,1,0,0,6
105693,dvidasa,dvidasa,2,2,0,0,7
105694,tiṃsā,timsa,17,16,1,0,5
105695,itiādināti,itiadinati,10,9,1,0,10
105696,dasassā,dasassa,4,4,0,0,7
105697,tuttarapadādi,tuttarapadadi,2,1,1,0,13
105698,ssādimhi,ssadimhi,2,2,0,0,8
105699,upapadassa,upapadassa,2,2,0,0,10
105700,uttarapadādimhi,uttarapadadimhi,1,1,0,0,15
105701,vīsatīsu,visatisu,2,1,1,0,8
105702,pannapaṇṇa,pannapanna,2,0,2,0,10
105703,paṇṇarasa,pannarasa,2,2,0,0,9
105704,chadasa,chadasa,1,1,0,0,7
105705,chassā,chassa,3,3,0,0,6
105706,laḷā,lala,4,0,4,0,4
105707,namaviseso,namaviseso,2,2,0,0,10
105708,pannarasādīsu,pannarasadisu,1,1,0,0,13
105709,lopādi,lopadi,4,4,0,0,6
105710,aliṅganāmaṃ,alinganamam,1,1,0,0,11
105711,vibhattippaccayavidhāna,vibhattippaccayavidhana,1,1,0,0,23
105712,vibhattippaccayantā,vibhattippaccayanta,1,1,0,0,19
105713,suddhanāmato,suddhanamato,1,1,0,0,12
105714,vibhatyantapadattaṃ,vibhatyantapadattam,1,1,0,0,19
105715,purisato,purisato,4,4,0,0,8
105716,aggito,aggito,38,33,5,0,6
105717,gahapatito,gahapatito,1,1,0,0,10
105718,hatthito,hatthito,8,8,0,0,8
105719,sabbaññuto,sabbannuto,2,2,0,0,10
105720,kaññato,kannato,3,3,0,0,7
105721,itthito,itthito,5,5,0,0,7
105722,bhikkhunito,bhikkhunito,6,6,0,0,11
105723,dīgharassāpaccayesu,digharassapaccayesu,2,1,1,0,19
105724,yāguto,yaguto,2,2,0,0,6
105725,jambuto,jambuto,8,7,1,0,7
105726,cittato,cittato,406,402,4,0,7
105727,āyuto,ayuto,4,4,0,0,5
105728,katarato,katarato,1,1,0,0,8
105729,katamato,katamato,2,2,0,0,8
105730,pubbato,pubbato,6,6,0,0,7
105731,aparato,aparato,5,4,1,0,7
105732,amuto,amuto,3,3,0,0,5
105733,trato,trato,1,0,1,0,5
105734,kehīti,kehiti,4,4,0,0,6
105735,tothesū,tothesu,1,1,0,0,7
105736,sabbassetassā,sabbassetassa,1,1,0,0,13
105737,thaṃdānihatodhesu,thamdanihatodhesu,1,0,1,0,17
105738,thaṃdānihatodha,thamdanihatodha,1,0,1,0,15
105739,imasmāti,imasmati,2,1,1,0,8
105740,ppabhutīhi,ppabhutihi,1,1,0,0,10
105741,aniccādī,aniccadi,1,0,1,0,8
105742,ādimhībhi,adimhibhi,1,1,0,0,9
105743,sīsato,sisato,81,79,2,0,6
105744,aniccenāti,aniccenati,2,1,1,0,10
105745,aniccato,aniccato,1027,953,74,0,8
105746,sammasati,sammasati,132,130,2,0,9
105747,gaṇḍato,gandato,55,44,11,0,7
105748,amuttha,amuttha,1,1,0,0,7
105749,sabbasminti,sabbasminti,2,2,0,0,11
105750,ppaccayepare,ppaccayepare,1,1,0,0,12
105751,mādiavappaccayepi,madiavappaccayepi,1,1,0,0,17
105752,kissā,kissa,2,2,0,0,5
105753,hiṃhaṃsu,himhamsu,2,1,1,0,8
105754,hiñcanaṃdācana,hincanamdacana,1,0,1,0,14
105755,miccādīsupi,miccadisupi,1,1,0,0,11
105756,kisminti,kisminti,1,1,0,0,8
105757,ppaccayā,ppaccaya,11,11,0,0,8
105758,imasminti,imasminti,6,5,1,0,9
105759,adhikāroyaṃ,adhikaroyam,1,1,0,0,11
105760,sabbaaññaekaya,sabbaannaekaya,1,0,1,0,14
105761,dācana,dacana,1,0,1,0,6
105762,kādeso,kadeso,2,2,0,0,6
105763,nipātanena,nipatanena,12,12,0,0,10
105764,dānidā,danida,1,0,1,0,6
105765,imassā,imassa,23,21,2,0,6
105766,vibhattippaccayavidhānaṃ,vibhattippaccayavidhanam,1,1,0,0,24
105767,opasaggikapada,opasaggikapada,1,1,0,0,14
105768,athāliṅgasaṅkhyāvibhattibhedā,athalingasankhyavibhattibheda,1,1,0,0,29
105769,pīsati,pisati,1,0,1,0,6
105770,dikamma,dikamma,2,2,0,0,7
105771,padhāni,padhani,1,1,0,0,7
105772,ssariya,ssariya,3,3,0,0,7
105773,ntobhāvaviyoga,ntobhavaviyoga,1,1,0,0,14
105774,tappara,tappara,3,3,0,0,7
105775,bhusattha,bhusattha,6,6,0,0,9
105776,sambhavatitti,sambhavatitti,1,1,0,0,13
105777,anāvila,anavila,2,2,0,0,7
105778,patthanādīsu,patthanadisu,2,2,0,0,12
105779,ayamupasaggo,ayamupasaggo,1,1,0,0,12
105780,pakārādīsu,pakaradisu,1,1,0,0,10
105781,pavāsī,pavasi,1,1,0,0,6
105782,pavuddhakāyo,pavuddhakayo,1,1,0,0,12
105783,pahūtamannaṃ,pahutamannam,1,1,0,0,12
105784,anāvile,anavile,3,2,1,0,7
105785,pasannamudakaṃ,pasannamudakam,1,1,0,0,14
105786,paṇihitaṃ,panihitam,21,13,8,0,9
105787,parihāni,parihani,184,179,5,0,8
105788,parājaya,parajaya,3,3,0,0,8
105789,gativikkamā,gativikkama,1,1,0,0,11
105790,masanādīsu,masanadisu,2,2,0,0,10
105791,vikkame,vikkame,2,1,1,0,7
105792,nissesa,nissesa,5,5,0,0,7
105793,niggata,niggata,5,5,0,0,7
105794,nīharaṇa,niharana,4,4,0,0,8
105795,ntopavesanā,ntopavesana,2,2,0,0,11
105796,bhāvanisedha,bhavanisedha,1,1,0,0,12
105797,nikkhanta,nikkhanta,8,8,0,0,9
105798,pātubhāvā,patubhava,81,79,2,0,9
105799,vadhāraṇa,vadharana,4,4,0,0,9
105800,vibhajana,vibhajana,5,5,0,0,9
105801,upamū,upamu,1,1,0,0,5
105802,padhāraṇā,padharana,3,3,0,0,9
105803,vasānachekādīsu,vasanachekadisu,1,1,0,0,15
105804,nissese,nissese,2,1,1,0,7
105805,niggate,niggate,8,6,2,0,7
105806,niyyāti,niyyati,178,170,8,0,7
105807,nīharaṇe,niharane,10,8,2,0,8
105808,antopavesane,antopavesane,2,1,1,0,12
105809,nikhāto,nikhato,9,8,1,0,7
105810,nikkhante,nikkhante,113,109,4,0,9
105811,nibbāno,nibbano,1,1,0,0,7
105812,nimmitaṃ,nimmitam,122,118,4,0,8
105813,nīharaṇā,niharana,3,3,0,0,8
105814,varaṇādīsu,varanadisu,2,2,0,0,10
105815,uggatu,uggatu,2,2,0,0,6
105816,ddhakamma,ddhakamma,6,6,0,0,9
105817,padhāna,padhana,21,20,1,0,7
105818,viyoga,viyoga,9,9,0,0,6
105819,atthalābhasatti,atthalabhasatti,1,1,0,0,15
105820,sarūpakathanādīsu,sarupakathanadisu,2,2,0,0,17
105821,uṭṭhito,utthito,77,77,0,0,7
105822,ubbāsito,ubbasito,2,2,0,0,8
105823,ubbhūto,ubbhuto,1,1,0,0,7
105824,atthalābhe,atthalabhe,1,0,1,0,10
105825,sarūpakathane,sarupakathane,1,0,1,0,13
105826,asobhanā,asobhana,3,3,0,0,8
105827,bhāvakucchitā,bhavakucchita,1,1,0,0,13
105828,virūpatādīsu,virupatadisu,4,4,0,0,12
105829,asobhane,asobhane,1,0,1,0,8
105830,dussassaṃ,dussassam,11,7,4,0,9
105831,virūpatāyaṃ,virupatayam,2,0,2,0,11
105832,samodhāna,samodhana,3,3,0,0,9
105833,sammāsama,sammasama,2,2,0,0,9
105834,samantabhāvasaṅgata,samantabhavasangata,1,1,0,0,19
105835,saṅkhepabhusattha,sankhepabhusattha,1,1,0,0,17
105836,sahattha,sahattha,3,3,0,0,8
105837,appattha,appattha,2,2,0,0,8
105838,bhimukhabhāva,bhimukhabhava,2,2,0,0,13
105839,saṅgaha,sangaha,19,17,2,0,7
105840,pidhāna,pidhana,2,2,0,0,7
105841,punappunakaraṇa,punappunakarana,1,1,0,0,15
105842,samiddhādīsu,samiddhadisu,2,2,0,0,12
105843,samodhāne,samodhane,9,8,1,0,9
105844,sammāsamesu,sammasamesu,1,0,1,0,11
105845,samullapanā,samullapana,5,5,0,0,11
105846,saṃvāso,samvaso,131,120,11,0,7
105847,samaggho,samaggho,1,1,0,0,8
105848,pabhave,pabhave,4,3,1,0,7
105849,punappunakaraṇe,punappunakarane,3,2,1,0,15
105850,sandhāvati,sandhavati,96,92,4,0,10
105851,vigata,vigata,8,7,1,0,6
105852,adhobhāga,adhobhaga,2,2,0,0,9
105853,paribhava,paribhava,2,2,0,0,9
105854,nicchayadesa,nicchayadesa,1,1,0,0,12
105855,theyyādīsu,theyyadisu,3,3,0,0,10
105856,avakkhittacakkhu,avakkhittacakkhu,1,1,0,0,16
105857,omukkaupāhano,omukkaupahano,1,1,0,0,13
105858,nupacchinna,nupacchinna,2,2,0,0,11
105859,pacchattha,pacchattha,1,1,0,0,10
105860,sādissa,sadissa,5,5,0,0,7
105861,hīnatatiyattha,hinatatiyattha,1,1,0,0,14
105862,lakkhaṇi,lakkhani,10,10,0,0,8
105863,tthambhūtakkhāna,tthambhutakkhana,5,5,0,0,16
105864,bhāga,bhaga,9,9,0,0,5
105865,vicchādīsu,vicchadisu,5,5,0,0,10
105866,anugate,anugate,11,10,1,0,7
105867,anupacchinne,anupacchinne,5,4,1,0,12
105868,anusayo,anusayo,127,114,13,0,7
105869,pacchāsaddatthe,pacchasaddatthe,1,0,1,0,15
105870,anurathaṃ,anuratham,5,5,0,0,9
105871,sādisse,sadisse,4,1,3,0,7
105872,anusāriputtaṃ,anusariputtam,3,3,0,0,13
105873,itthambhūtakkhāne,itthambhutakkhane,3,1,2,0,17
105874,anusiyā,anusiya,2,2,0,0,7
105875,dīyatu,diyatu,9,8,1,0,6
105876,samantatobhāva,samantatobhava,2,2,0,0,14
105877,liṅgana,lingana,5,5,0,0,7
105878,nivāsanapūjābhojanā,nivasanapujabhojana,1,1,0,0,19
105879,vajānana,vajanana,2,2,0,0,8
105880,dosakkhāna,dosakkhana,4,4,0,0,10
105881,samantatobhāve,samantatobhave,1,0,1,0,14
105882,parivisati,parivisati,26,26,0,0,10
105883,avajānane,avajanane,1,0,1,0,9
105884,vijjuiccādi,vijjuiccadi,1,1,0,0,11
105885,adhiki,adhiki,3,3,0,0,6
105886,rūparibhāvā,ruparibhava,1,1,0,0,11
105887,dhibhavanajjhāyanā,dhibhavanajjhayana,1,1,0,0,18
105888,dhiṭṭhānanicchayapāpuṇanādīsu,dhitthananicchayapapunanadisu,1,1,0,0,29
105889,adhisīlaṃ,adhisilam,85,69,16,0,9
105890,adhirohati,adhirohati,1,1,0,0,10
105891,adhibhavane,adhibhavane,1,0,1,0,11
105892,ajjhāyane,ajjhayane,4,3,1,0,9
105893,bhūmikampādiṃ,bhumikampadim,1,1,0,0,13
105894,abhimukhabhāva,abhimukhabhava,2,2,0,0,14
105895,sāruppavandana,saruppavandana,1,1,0,0,14
105896,abhivassati,abhivassati,16,16,0,0,11
105897,abhiruhati,abhiruhati,50,50,0,0,10
105898,patigata,patigata,1,1,0,0,8
105899,paṭilomapatinidhi,patilomapatinidhi,1,1,0,0,17
105900,patidāna,patidana,1,1,0,0,8
105901,nisedhanivattana,nisedhanivattana,1,1,0,0,16
105902,patikaraṇā,patikarana,1,1,0,0,10
105903,patibodha,patibodha,1,1,0,0,9
105904,bhāgavicchādīsu,bhagavicchadisu,1,1,0,0,15
105905,patigate,patigate,2,1,1,0,8
105906,patinidhimhi,patinidhimhi,2,0,2,0,12
105907,ācariyato,acariyato,14,14,0,0,9
105908,patidāne,patidane,3,1,2,0,8
105909,telatthikassa,telatthikassa,1,1,0,0,13
105910,paṭisedhanaṃ,patisedhanam,12,12,0,0,12
105911,patikaraṇe,patikarane,1,0,1,0,10
105912,patikāro,patikaro,1,1,0,0,8
105913,patiggaṇhāti,patigganhati,2,2,0,0,12
105914,patibodhe,patibodhe,2,1,1,0,9
105915,paṭicce,paticce,1,0,1,0,7
105916,suṭṭhusammā,sutthusamma,1,1,0,0,11
105917,sukhatthādīsu,sukhatthadisu,2,2,0,0,13
105918,suṭṭhusammādatthesu,sutthusammadatthesu,1,0,1,0,19
105919,gatotipi,gatotipi,17,16,1,0,8
105920,sukhatthe,sukhatthe,1,0,1,0,9
105921,abhimukhabhāvu,abhimukhabhavu,2,2,0,0,14
105922,bhividhi,bhividhi,2,2,0,0,8
105923,cchāparissajana,cchaparissajana,1,1,0,0,15
105924,ādikammaggahaṇa,adikammaggahana,1,1,0,0,15
105925,vhānādīsu,vhanadisu,1,1,0,0,9
105926,āpabbatā,apabbata,3,3,0,0,8
105927,ākumāraṃ,akumaram,3,3,0,0,8
105928,āpattimāpanno,apattimapanno,1,1,0,0,13
105929,parissajane,parissajane,1,0,1,0,11
105930,abhikkamanā,abhikkamana,1,1,0,0,11
105931,bhusatthādīsu,bhusatthadisu,4,4,0,0,13
105932,atikkante,atikkante,131,124,7,0,9
105933,atikusalo,atikusalo,2,2,0,0,9
105934,ativuddhi,ativuddhi,2,2,0,0,9
105935,samuccaya,samuccaya,9,9,0,0,9
105936,merumpi,merumpi,3,3,0,0,7
105937,vinivijjhitvā,vinivijjhitva,109,108,1,0,13
105938,apekkhāyaṃ,apekkhayam,4,3,1,0,10
105939,aniyato,aniyato,270,262,8,0,7
105940,antampi,antampi,10,10,0,0,7
105941,antaguṇampi,antagunampi,9,9,0,0,11
105942,garahe,garahe,6,4,2,0,6
105943,paṇḍitaka,panditaka,5,5,0,0,9
105944,labhittha,labhittha,12,12,0,0,9
105945,apagata,apagata,3,3,0,0,7
105946,vajjana,vajjana,3,3,0,0,7
105947,padussanādīsu,padussanadisu,2,2,0,0,13
105948,apagate,apagate,21,19,2,0,7
105949,apamāno,apamano,1,1,0,0,7
105950,vuddhāpacāyī,vuddhapacayi,4,4,0,0,12
105951,padussane,padussane,3,2,1,0,9
105952,upagamana,upagamana,2,2,0,0,9
105953,samīpū,samipu,2,2,0,0,6
105954,papatti,papatti,5,5,0,0,7
105955,sādissā,sadissa,2,2,0,0,7
105956,dhikū,dhiku,1,1,0,0,5
105957,paribhāvā,paribhava,3,3,0,0,9
105958,nasana,nasana,2,2,0,0,6
105959,pubbakamma,pubbakamma,2,2,0,0,10
105960,gayhākāra,gayhakara,2,2,0,0,9
105961,upagamane,upagamane,5,4,1,0,9
105962,upanisīdeyya,upanisideyya,21,21,0,0,12
105963,upapattito,upapattito,54,51,3,0,10
105964,ikkhatīti,ikkhatiti,23,21,2,0,9
105965,upapadati,upapadati,1,1,0,0,9
105966,upadhā,upadha,1,1,0,0,6
105967,pubbakamme,pubbakamme,1,0,1,0,10
105968,buddhupaṭṭhāko,buddhupatthako,11,11,0,0,14
105969,upāyāso,upayaso,117,89,28,0,7
105970,upanissayoti,upanissayoti,26,24,2,0,12
105971,nekenekatthavisayā,nekenekatthavisaya,2,2,0,0,18
105972,neruttikābravuṃ,neruttikabravum,2,2,0,0,15
105973,nāmākhyātavisesakattā,namakhyatavisesakatta,1,1,0,0,21
105974,syādimhi,syadimhi,4,4,0,0,8
105975,saṅkhyākammādibhedābhāvā,sankhyakammadibhedabhava,1,1,0,0,24
105976,paṭhamekavacanameva,pathamekavacanameva,2,2,0,0,19
105977,suttapadā,suttapada,1,0,1,0,9
105978,sasaṅkhyattadīpanatthanti,sasankhyattadipanatthanti,1,1,0,0,25
105979,upeccatthaṃ,upeccattham,1,1,0,0,11
105980,sajjantīti,sajjantiti,4,3,1,0,10
105981,padādimajjhante,padadimajjhante,2,2,0,0,15
105982,nipatantiti,nipatantiti,1,1,0,0,11
105983,tamanuvattate,tamanuvattate,1,1,0,0,13
105984,tamevañño,tamevanno,1,1,0,0,9
105985,upasaggagatī,upasaggagati,2,2,0,0,12
105986,opasaggikapadaṃ,opasaggikapadam,2,2,0,0,15
105987,nepātikapada,nepatikapada,1,1,0,0,12
105988,samuccayavikappanapaṭisedhapūraṇādiatthaṃ,samuccayavikappanapatisedhapuranadiattham,1,1,0,0,41
105989,asatvavācakaṃ,asatvavacakam,1,1,0,0,13
105990,nepātikaṃ,nepatikam,8,7,1,0,9
105991,samuccayā,samuccaya,3,3,0,0,9
105992,nvācaye,nvacaye,2,2,0,0,7
105993,tarītarayogasamāhārā,taritarayogasamahara,1,1,0,0,20
105994,vadhāraṇādīsu,vadharanadisu,2,2,0,0,13
105995,vikappanū,vikappanu,1,1,0,0,9
105996,pamāna,pamana,2,2,0,0,6
105997,vavatthitavibhāsāsu,vavatthitavibhasasu,1,1,0,0,19
105998,paṭisedhanatthe,patisedhanatthe,4,4,0,0,15
105999,bhūsanesu,bhusanesu,2,2,0,0,9
106000,pūraṇatthaṃ,puranattham,4,3,1,0,11
106001,atthapūraṇaṃ,atthapuranam,3,2,1,0,12
106002,padapūraṇañca,padapurananca,3,3,0,0,13
106003,padapūraṇāni,padapuranani,1,1,0,0,12
106004,nantariyā,nantariya,2,2,0,0,9
106005,dhikārādīsu,dhikaradisu,2,2,0,0,11
106006,paṭisedhā,patisedha,18,18,0,0,9
106007,pasiddhīsu,pasiddhisu,2,2,0,0,10
106008,ekaṃsa,ekamsa,2,2,0,0,6
106009,khedā,kheda,3,3,0,0,5
106010,nukampasaṅkappesu,nukampasankappesu,1,1,0,0,17
106011,avadhāraṇesu,avadharanesu,2,2,0,0,12
106012,nivattanādīsu,nivattanadisu,2,2,0,0,13
106013,visesepi,visesepi,5,5,0,0,8
106014,kaṃsatthepi,kamsatthepi,1,1,0,0,11
106015,sambhamesupi,sambhamesupi,1,1,0,0,12
106016,katamanti,katamanti,25,23,2,0,9
106017,vibhattiyuttaṃ,vibhattiyuttam,2,2,0,0,14
106018,avibhattiyuttañca,avibhattiyuttanca,2,2,0,0,17
106019,dāpetuṃ,dapetum,24,20,4,0,7
106020,pañcamiyatthe,pancamiyatthe,9,6,3,0,13
106021,sattamyatthepi,sattamyatthepi,1,1,0,0,14
106022,trathā,tratha,1,0,1,0,6
106023,dipaccayantā,dipaccayanta,1,1,0,0,12
106024,parajja,parajja,1,0,1,0,7
106025,parasuve,parasuve,12,10,2,0,8
106026,bhūtapubbaṃ,bhutapubbam,205,177,28,0,11
106027,kālasattamiyā,kalasattamiya,2,2,0,0,13
106028,vibhattiyuttāni,vibhattiyuttani,2,2,0,0,15
106029,avibhattiyuttesu,avibhattiyuttesu,2,2,0,0,16
106030,saṃsayatthe,samsayatthe,7,7,0,0,11
106031,kaccinu,kaccinu,1,0,1,0,7
106032,kinnunanukathaṃ,kinnunanukatham,1,0,1,0,15
106033,pucchanatthe,pucchanatthe,11,11,0,0,12
106034,vākyaparisamattīsu,vakyaparisamattisu,2,2,0,0,18
106035,paricchedanatthe,paricchedanatthe,3,3,0,0,16
106036,seyyathāpināma,seyyathapinama,3,2,1,0,14
106037,tathānāma,tathanama,2,1,1,0,9
106038,yathācatathāca,yathacatathaca,1,0,1,0,14
106039,yoggatā,yoggata,3,3,0,0,7
106040,padatthānativattanidassanesu,padatthanativattanidassanesu,1,1,0,0,28
106041,upadesa,upadesa,2,2,0,0,7
106042,pasaṃsana,pasamsana,6,6,0,0,9
106043,patthanesu,patthanesu,2,2,0,0,10
106044,pañhesu,panhesu,59,56,3,0,7
106045,yācanesu,yacanesu,2,2,0,0,8
106046,codanatthe,codanatthe,28,27,1,0,10
106047,anumodane,anumodane,2,2,0,0,9
106048,anussavaṇa,anussavana,1,1,0,0,10
106049,assaddheyyesu,assaddheyyesu,1,1,0,0,13
106050,anumānā,anumana,2,2,0,0,7
106051,nussaraṇa,nussarana,2,2,0,0,9
106052,parivitakkanesu,parivitakkanesu,1,1,0,0,15
106053,kāraṇapucchane,karanapucchane,2,2,0,0,14
106054,kāraṇacchedanatthe,karanacchedanatthe,2,2,0,0,18
106055,samakriyāyaṃ,samakriyayam,2,2,0,0,12
106056,asaṅghāte,asanghate,2,2,0,0,9
106057,appaṭhame,appathame,3,3,0,0,9
106058,sakiñca,sakinca,1,0,1,0,7
106059,saṅkhyāvibhāge,sankhyavibhage,1,1,0,0,14
106060,mandatthe,mandatthe,2,2,0,0,9
106061,saṅkāvaṭṭhāne,sankavatthane,1,1,0,0,13
106062,thirāvadhāraṇesu,thiravadharanesu,1,1,0,0,16
106063,passituna,passituna,4,4,0,0,9
106064,passitvāna,passitvana,8,8,0,0,10
106065,disvānadassetvā,disvanadassetva,1,1,0,0,15
106066,dātuna,datuna,2,2,0,0,6
106067,dāpetvā,dapetva,125,122,3,0,7
106068,nihacca,nihacca,16,15,1,0,7
106069,nāmākhyātopasaggavinimuttaṃ,namakhyatopasaggavinimuttam,1,1,0,0,27
106070,yadabyayalakkhaṇaṃ,yadabyayalakkhanam,1,1,0,0,18
106071,padattayā,padattaya,1,1,0,0,9
106072,nipatatyantarā,nipatatyantara,1,1,0,0,14
106073,nepātikanti,nepatikanti,1,1,0,0,11
106074,abyaya,abyaya,2,1,1,0,6
106075,nepātikapadaṃ,nepatikapadam,4,4,0,0,13
106076,napuṃsakamathāparaṃ,napumsakamathaparam,1,1,0,0,19
106077,tiliṅgañca,tilinganca,2,2,0,0,10
106078,aliṅgañca,alinganca,3,3,0,0,9
106079,padarūpasiddhiyaṃ,padarupasiddhiyam,6,6,0,0,17
106080,nāmakaṇḍo,namakando,3,3,0,0,9
106081,kārakakaṇḍa,karakakanda,3,3,0,0,11
106082,vibhattīnamatthabhedā,vibhattinamatthabheda,1,1,0,0,21
106083,paṭhamādibhedena,pathamadibhedena,2,2,0,0,16
106084,sattavidhā,sattavidha,43,41,2,0,10
106085,purisotiādīnañhi,purisotiadinanhi,1,1,0,0,16
106086,pakatippaccayādivibhāgakappanāya,pakatippaccayadivibhagakappanaya,3,3,0,0,32
106087,nipphāditānaṃ,nipphaditanam,1,1,0,0,13
106088,saddappatirūpakānaṃ,saddappatirupakanam,1,1,0,0,19
106089,pakatirūpaṃ,pakatirupam,11,11,0,0,11
106090,avayavattā,avayavatta,2,2,0,0,10
106091,visadāvisadobhayarahitākāravohārasaṅkhātena,visadavisadobhayarahitakaravoharasankhatena,1,1,0,0,43
106092,tividhaliṅgena,tividhalingena,1,1,0,0,14
106093,sahitatthassa,sahitatthassa,1,1,0,0,13
106094,tabbinimuttassupasaggādīnamatthassa,tabbinimuttassupasaggadinamatthassa,1,1,0,0,35
106095,līnassa,linassa,16,16,0,0,7
106096,liṅganato,linganato,1,1,0,0,9
106097,anvatthanāmavasena,anvatthanamavasena,3,3,0,0,18
106098,pāṭipadikāparanāmadheyyaṃ,patipadikaparanamadheyyam,1,1,0,0,25
106099,divibhatyantapadapakatirūpameva,divibhatyantapadapakatirupameva,1,1,0,0,31
106100,liṅgassattho,lingassattho,1,1,0,0,12
106101,pabandhavisesākārena,pabandhavisesakarena,1,1,0,0,20
106102,paññāpīyamāno,pannapiyamano,1,1,0,0,13
106103,tadaññānaññabhāvena,tadannanannabhavena,2,2,0,0,19
106104,anibbacanīyo,anibbacaniyo,1,1,0,0,12
106105,samūhasantānādibhedo,samuhasantanadibhedo,1,1,0,0,20
106106,upādāpaññattisaṅkhāto,upadapannattisankhato,1,1,0,0,21
106107,ghaṭapaṭādivohārattho,ghatapatadivoharattho,1,1,0,0,21
106108,pathavīdhātuphassādīnaṃ,pathavidhatuphassadinam,1,1,0,0,23
106109,sabhāvadhammānaṃ,sabhavadhammanam,43,43,0,0,16
106110,kāladesādibhedabhinnānaṃ,kaladesadibhedabhinnanam,2,2,0,0,24
106111,vijātiyavinivatto,vijatiyavinivatto,1,1,0,0,17
106112,sajātiyasādhāraṇo,sajatiyasadharano,2,2,0,0,17
106113,yathāsaṅketamāropasiddho,yathasanketamaropasiddho,1,1,0,0,24
106114,tajjāpaññattisaṅkhāto,tajjapannattisankhato,1,1,0,0,21
106115,kakkhaḷattaphusanādisāmaññākāro,kakkhalattaphusanadisamannakaro,1,1,0,0,31
106116,kammādisaṃsaṭṭho,kammadisamsattho,2,2,0,0,16
106117,dutiyādīnaṃ,dutiyadinam,18,15,3,0,11
106118,vidhīyamānattā,vidhiyamanatta,3,3,0,0,14
106119,kammādisaṃsaggarahito,kammadisamsaggarahito,2,2,0,0,21
106120,liṅgasaṅkhyāparimāṇayutto,lingasankhyaparimanayutto,1,1,0,0,25
106121,tabbinimuttupasaggādipadatthabhūto,tabbinimuttupasaggadipadatthabhuto,1,1,0,0,34
106122,ākhyātakitakataddhitasamāsehi,akhyatakitakataddhitasamasehi,1,1,0,0,29
106123,atthavisesassābhāvena,atthavisesassabhavena,1,1,0,0,21
106124,liṅgatthamattassa,lingatthamattassa,1,1,0,0,17
106125,paṭhamāyeva,pathamayeva,3,3,0,0,11
106126,paṭhamāvupasaggatthe,pathamavupasaggatthe,1,1,0,0,20
106127,kesañcatthe,kesancatthe,1,1,0,0,11
106128,nipātasaddānaṃ,nipatasaddanam,2,2,0,0,14
106129,liṅgādike,lingadike,1,1,0,0,9
106130,suddhebhihite,suddhebhihite,1,1,0,0,13
106131,kammādiatthepi,kammadiatthepi,1,1,0,0,14
106132,saliṅge,salinge,18,13,5,0,7
106133,saparimāṇe,saparimane,1,1,0,0,10
106134,āḷhakaṃ,alhakam,11,11,0,0,7
106135,liṅgādivinimutte,lingadivinimutte,1,1,0,0,16
106136,sattāmatte,sattamatte,3,3,0,0,10
106137,sakkālabbhā,sakkalabbha,1,1,0,0,11
106138,avhānanti,avhananti,1,1,0,0,9
106139,laddhasarūpassa,laddhasarupassa,1,1,0,0,15
106140,abhimukhīkaraṇaṃ,abhimukhikaranam,8,8,0,0,16
106141,katābhimukho,katabhimukho,2,2,0,0,12
106142,yojīyati,yojiyati,13,13,0,0,8
106143,āmantanasamaye,amantanasamaye,1,1,0,0,14
106144,kriyāyogābhāvato,kriyayogabhavato,1,1,0,0,16
106145,kārakavohāraṃ,karakavoharam,1,1,0,0,13
106146,anabhihite,anabhihite,6,6,0,0,10
106147,evāyaṃ,evayam,49,47,2,0,6
106148,vacanañcettha,vacanancettha,7,7,0,0,13
106149,liṅgakālavacanamatantaṃ,lingakalavacanamatantam,1,1,0,0,23
106150,kriyānipphattiyā,kriyanipphattiya,1,1,0,0,16
106151,kāraṇamuccate,karanamuccate,1,1,0,0,13
106152,sampadānamapādānamokāso,sampadanamapadanamokaso,1,1,0,0,23
106153,parikappato,parikappato,5,5,0,0,11
106154,kriyābhāvato,kriyabhavato,1,1,0,0,12
106155,kammādīnaṃ,kammadinam,18,18,0,0,10
106156,channampi,channampi,37,37,0,0,9
106157,kārakavohāro,karakavoharo,2,2,0,0,12
106158,nibbattanīyaṃ,nibbattaniyam,1,1,0,0,13
106159,vikaraṇīyaṃ,vikaraniyam,1,1,0,0,11
106160,pāpaṇīyañcāti,papaniyancati,1,1,0,0,13
106161,keyūraṃ,keyuram,3,2,1,0,7
106162,payirupāsati,payirupasati,95,94,1,0,12
106163,nibbattivikatippattibhedena,nibbattivikatippattibhedena,1,1,0,0,27
106164,kriyābhigammaṃ,kriyabhigammam,1,1,0,0,14
106165,sukhaṅgāraṃ,sukhangaram,1,1,0,0,11
106166,icchitānicchitakathitākathitādibhedamanapekkhitvā,icchitanicchitakathitakathitadibhedamanapekkhitva,1,1,0,0,49
106167,atthantaravikappanavādhikārato,atthantaravikappanavadhikarato,1,1,0,0,30
106168,kammasaññā,kammasanna,1,1,0,0,10
106169,anicchitakammaṃ,anicchitakammam,1,0,1,0,15
106170,yaññadattaṃ,yannadattam,5,5,0,0,11
106171,yācate,yacate,11,10,1,0,6
106172,dvikammikāya,dvikammikaya,2,2,0,0,12
106173,yācanakriyāya,yacanakriyaya,1,1,0,0,13
106174,pattumicchitatarattā,pattumicchitataratta,1,1,0,0,20
106175,samiddhaṃ,samiddham,47,42,5,0,9
106176,abhihitakamme,abhihitakamme,1,0,1,0,13
106177,yācīyate,yaciyate,3,3,0,0,8
106178,payojjakakattubhūte,payojjakakattubhute,1,1,0,0,19
106179,niccasampatte,niccasampatte,1,1,0,0,13
106180,vikappatthoyaṃ,vikappatthoyam,1,1,0,0,14
106181,tamañño,tamanno,52,51,1,0,7
106182,kattukammani,kattukammani,1,1,0,0,12
106183,kāriteti,kariteti,2,1,1,0,8
106184,abhihite,abhihite,4,4,0,0,8
106185,gamīyate,gamiyate,3,3,0,0,8
106186,bodhīyate,bodhiyate,2,2,0,0,9
106187,dabbaguṇakriyāhi,dabbagunakriyahi,1,1,0,0,16
106188,kāladdhānavācīhi,kaladdhanavacihi,2,2,0,0,16
106189,gavapānaṃ,gavapanam,11,9,2,0,9
106190,kammappavacanīyehi,kammappavacaniyehi,1,1,0,0,18
106191,nipātopasaggehi,nipatopasaggehi,2,2,0,0,15
106192,pavacanīyaṃ,pavacaniyam,4,3,1,0,11
106193,kammappavacanīyā,kammappavacaniya,4,1,3,0,16
106194,anvādayo,anvadayo,1,1,0,0,8
106195,pabbajitamanu,pabbajitamanu,1,1,0,0,13
106196,pabbajiṃsu,pabbajimsu,126,126,0,0,10
106197,avabaddhāti,avabaddhati,1,1,0,0,11
106198,tthambhūtakkhānabhāga,tthambhutakkhanabhaga,1,1,0,0,21
106199,vicchāsu,vicchasu,4,4,0,0,8
106200,anavo,anavo,1,1,0,0,5
106201,sūriyuggamanaṃ,suriyuggamanam,34,30,4,0,14
106202,bhakkhā,bhakkha,26,24,2,0,7
106203,pātubhaveyyuṃ,patubhaveyyum,10,9,1,0,13
106204,vicchāyoge,vicchayoge,1,0,1,0,10
106205,atthamatthaṃ,atthamattham,1,1,0,0,12
106206,hantāra,hantara,1,1,0,0,7
106207,miccevamādi,miccevamadi,1,1,0,0,11
106208,chaṭṭhīnaṃ,chatthinam,1,1,0,0,10
106209,antarāabhito,antaraabhito,1,1,0,0,12
106210,paṭibhātiyoge,patibhatiyoge,1,1,0,0,13
106211,rājagahassa,rajagahassa,51,50,1,0,11
106212,nāḷandāya,nalandaya,11,10,1,0,9
106213,majjheti,majjheti,77,13,64,0,8
106214,nerañjaraṃ,neranjaram,16,13,3,0,10
106215,upaṭṭhahatīti,upatthahatiti,7,7,0,0,13
106216,tatiyāsattamīnamatthe,tatiyasattaminamatthe,2,2,0,0,21
106217,nālapissati,nalapissati,1,1,0,0,11
106218,upāyamantarena,upayamantarena,2,2,0,0,14
106219,upānvajjhāvasassa,upanvajjhavasassa,1,1,0,0,17
106220,adhisiṭṭhāvasānaṃ,adhisitthavasanam,1,1,0,0,17
106221,tappānacāre,tappanacare,1,1,0,0,11
106222,dipubbassa,dipubbassa,1,1,0,0,10
106223,anuvasati,anuvasati,3,3,0,0,9
106224,adhivasati,adhivasati,4,4,0,0,10
106225,āvasati,avasati,13,13,0,0,7
106226,adhitiṭṭhati,adhititthati,19,18,1,0,12
106227,tappānacāresu,tappanacaresu,3,1,2,0,13
106228,upakaraṇabhūtena,upakaranabhutena,1,1,0,0,16
106229,abyavadhānena,abyavadhanena,7,7,0,0,13
106230,sabbakārakānaṃ,sabbakarakanam,1,1,0,0,14
106231,kriyāsādhakatte,kriyasadhakatte,1,1,0,0,15
106232,kattūpakaraṇabhūtesu,kattupakaranabhutesu,1,1,0,0,20
106233,sādhakatamasseva,sadhakatamasseva,1,1,0,0,16
106234,sabbavisesena,sabbavisesena,1,1,0,0,13
106235,kriyāsaṃsiddhihetutā,kriyasamsiddhihetuta,1,1,0,0,20
106236,sambhāvīyati,sambhaviyati,2,2,0,0,12
106237,ajjhattika,ajjhattika,5,5,0,0,10
106238,bāhiravasena,bahiravasena,2,2,0,0,12
106239,itthambhūtalakkhaṇe,itthambhutalakkhane,51,51,0,0,19
106240,kriyāpavagge,kriyapavagge,2,2,0,0,12
106241,pubbasadisasamūnattha,pubbasadisasamunattha,1,1,0,0,21
106242,nipuṇa,nipuna,10,9,1,0,6
106243,missaka,missaka,6,6,0,0,7
106244,sakhilatthādiyoge,sakhilatthadiyoge,1,1,0,0,17
106245,kāladdhānesu,kaladdhanesu,2,1,1,0,12
106246,paccattakammatthapañcamiyatthādīsu,paccattakammatthapancamiyatthadisu,1,1,0,0,34
106247,suddhakattā,suddhakatta,9,8,1,0,11
106248,kammakattāti,kammakattati,4,4,0,0,12
106249,akarontaṃ,akarontam,46,45,1,0,9
106250,hetvatthanidassanaṃ,hetvatthanidassanam,1,1,0,0,19
106251,sāmatthiyadassanavasena,samatthiyadassanavasena,1,1,0,0,23
106252,uṭṭhāpayatītiādikañca,utthapayatitiadikanca,1,1,0,0,21
106253,sijjheyya,sijjheyya,7,7,0,0,9
106254,hetukattusaññā,hetukattusanna,1,1,0,0,14
106255,odanoti,odanoti,3,2,1,0,7
106256,nibbatteti,nibbatteti,123,119,4,0,10
106257,appayutto,appayutto,4,4,0,0,9
106258,hetukattāti,hetukattati,1,1,0,0,11
106259,payojako,payojako,8,8,0,0,8
106260,asato,asato,19,19,0,0,5
106261,jananakriyāya,jananakriyaya,2,2,0,0,13
106262,kattubhāvosiyāti,kattubhavosiyati,1,1,0,0,16
106263,saddappayogo,saddappayogo,17,17,0,0,12
106264,saddābhidheyyatāya,saddabhidheyyataya,1,1,0,0,18
106265,vikappabuddhigahitākāroyeva,vikappabuddhigahitakaroyeva,1,1,0,0,27
106266,saddenābhidhīyate,saddenabhidhiyate,1,1,0,0,17
106267,vatthusabhāvo,vatthusabhavo,1,1,0,0,13
106268,sutamayañāṇenapi,sutamayananenapi,1,1,0,0,16
106269,paccakkhena,paccakkhena,3,3,0,0,11
106270,vatthusabhāvasacchikaraṇappasaṅgo,vatthusabhavasacchikaranappasango,1,1,0,0,33
106271,musāvāda,musavada,6,6,0,0,8
106272,kudiṭṭhivādādīnamabhāvappasaṅgo,kuditthivadadinamabhavappasango,1,1,0,0,31
106273,buddhiparikappitapaññattivasenapi,buddhiparikappitapannattivasenapi,1,1,0,0,33
106274,saddappavatti,saddappavatti,8,8,0,0,13
106275,saṃyogādissapi,samyogadissapi,1,1,0,0,14
106276,kattukārakatāti,kattukarakatati,1,1,0,0,15
106277,vohāravisayo,voharavisayo,3,3,0,0,12
106278,nekantaparamatthiko,nekantaparamatthiko,1,1,0,0,19
106279,buddhisaṅkappito,buddhisankappito,1,1,0,0,16
106280,tassatthoti,tassatthoti,3,1,2,0,11
106281,vijjamānova,vijjamanova,1,1,0,0,11
106282,bodhito,bodhito,35,35,0,0,7
106283,saddhehi,saddhehi,15,15,0,0,8
106284,kārito,karito,76,74,2,0,6
106285,itthambhūtassa,itthambhutassa,12,9,3,0,14
106286,bhinnena,bhinnena,36,34,2,0,8
106287,paggharantena,paggharantena,19,19,0,0,13
106288,paṭivissakānaṃ,pativissakanam,3,3,0,0,14
106289,ujjhāpesi,ujjhapesi,13,13,0,0,9
106290,ūnapañcabandhanena,unapancabandhanena,20,18,2,0,18
106291,cetāpeyya,cetapeyya,36,28,8,0,9
106292,paribbājakamaddakkhi,paribbajakamaddakkhi,2,2,0,0,20
106293,ekāheneva,ekaheneva,25,25,0,0,9
106294,pāyāsi,payasi,258,256,2,0,6
106295,māsehi,masehi,148,146,2,0,6
106296,niṭṭhāpesi,nitthapesi,122,120,2,0,10
106297,yojanena,yojanena,8,8,0,0,8
106298,adhītaṃ,adhitam,1,1,0,0,7
106299,kriyāpavaggoti,kriyapavaggoti,1,0,1,0,14
106300,pariniṭṭhāpanaṃ,parinitthapanam,4,4,0,0,15
106301,pubbādiyoge,pubbadiyoge,2,0,2,0,11
106302,kahāpaṇena,kahapanena,13,13,0,0,10
106303,ācārena,acarena,45,43,2,0,7
106304,sammannati,sammannati,131,127,4,0,10
106305,tilehi,tilehi,7,7,0,0,6
106306,sumuttā,sumutta,22,19,3,0,7
106307,mahāsamaṇena,mahasamanena,10,10,0,0,12
106308,miccevamādīhi,miccevamadihi,1,1,0,0,13
106309,sahatthepi,sahatthepi,1,1,0,0,10
106310,dabba,dabba,59,50,9,0,5
106311,vitakkena,vitakkena,92,90,2,0,9
106312,antevāsikasaddhivihārikehi,antevasikasaddhiviharikehi,1,1,0,0,26
106313,ācariyupajjhāyānaṃ,acariyupajjhayanam,75,73,2,0,18
106314,piyehi,piyehi,78,72,6,0,6
106315,manāpehi,manapehi,54,51,3,0,8
106316,nānābhāvo,nanabhavo,46,41,5,0,9
106317,tiṇṇena,tinnena,12,12,0,0,7
106318,thāmadassinā,thamadassina,10,10,0,0,12
106319,ajinasāṭiyā,ajinasatiya,13,13,0,0,11
106320,kokālikena,kokalikena,5,5,0,0,10
106321,bālehi,balehi,37,35,2,0,6
106322,ggahaṇamihānuvattate,ggahanamihanuvattate,1,1,0,0,20
106323,hetvatthappayoge,hetvatthappayoge,3,2,1,0,16
106324,diṭṭhasāmatthiyaṃ,ditthasamatthiyam,1,1,0,0,17
106325,jaccāvasalo,jaccavasalo,1,1,0,0,11
106326,kulī,kuli,2,2,0,0,4
106327,kāladdhānadisādesādīsu,kaladdhanadisadesadisu,1,1,0,0,22
106328,dhammassavaṇaṃ,dhammassavanam,1,1,0,0,14
106329,puratthimena,puratthimena,37,30,7,0,12
106330,kasivanto,kasivanto,4,4,0,0,9
106331,janoghamaparena,janoghamaparena,4,3,1,0,15
106332,aṅgamassa,angamassa,1,1,0,0,9
106333,visesīyati,visesiyati,7,7,0,0,10
106334,gottādi,gottadi,4,4,0,0,7
106335,gottanāmajātisippavayoguṇasaṅkhāte,gottanamajatisippavayogunasankhate,1,1,0,0,34
106336,sāriputtoti,sariputtoti,31,16,15,0,11
106337,tadahu,tadahu,159,157,2,0,6
106338,sattavassiko,sattavassiko,47,46,1,0,12
106339,anusāseyya,anusaseyya,15,14,1,0,10
106340,sampaṭicchāmi,sampaticchami,14,14,0,0,13
106341,sippena,sippena,17,17,0,0,7
106342,assake,assake,1,1,0,0,6
106343,diyyamānassānivāraṇajjhesanānumativasena,diyyamanassanivaranajjhesananumativasena,1,1,0,0,40
106344,ajjhesane,ajjhesane,7,5,2,0,9
106345,anirākaraṇārādhanābbhanuññavasena,anirakaranaradhanabbhanunnavasena,1,1,0,0,33
106346,dātukāmoti,datukamoti,4,3,1,0,10
106347,rocanā,rocana,1,0,1,0,6
106348,yassāyasmato,yassayasmato,201,201,0,0,12
106349,ssāsūya,ssasuya,1,0,1,0,7
106350,anupatigiṇapubbakattārocanatthatadattha,anupatiginapubbakattarocanatthatadattha,1,0,1,0,39
106351,āsisattha,asisattha,1,0,1,0,9
106352,bhiyyasattamyatthesu,bhiyyasattamyatthesu,1,0,1,0,20
106353,catuppadamidaṃ,catuppadamidam,4,4,0,0,14
106354,jighaṃsāyaṃ,jighamsayam,1,1,0,0,11
106355,tadatthavācīnañca,tadatthavacinanca,2,2,0,0,17
106356,hiṃsāsaṃrādhesu,himsasamradhesu,1,1,0,0,15
106357,dassanaṅkesūti,dassanankesuti,3,3,0,0,14
106358,savaṇeti,savaneti,1,1,0,0,8
106359,pubbakattā,pubbakatta,3,2,1,0,10
106360,ārocanatthappayoge,arocanatthappayoge,2,1,1,0,18
106361,alamatthappayoge,alamatthappayoge,1,1,0,0,16
106362,āsisatthappayoge,asisatthappayoge,1,1,0,0,16
106363,bhiyyappayogesu,bhiyyappayogesu,1,1,0,0,15
106364,kammādikārakaṃ,kammadikarakam,1,1,0,0,14
106365,pahiṇatikappati,pahinatikappati,1,1,0,0,15
106366,upamāñjalikaraṇa,upamanjalikarana,1,1,0,0,16
106367,atthaseyyappabhutiyoge,atthaseyyappabhutiyoge,1,1,0,0,22
106368,silāghādippayoge,silaghadippayoge,1,0,1,0,16
106369,upajjhāyassa,upajjhayassa,342,332,10,0,12
106370,apalapatīti,apalapatiti,1,1,0,0,11
106371,upagamanaṃ,upagamanam,97,85,12,0,10
106372,bhuñjamānassa,bhunjamanassa,10,10,0,0,13
106373,dhārayatippayoge,dharayatippayoge,1,0,1,0,16
106374,dhanikoyeva,dhanikoyeva,1,1,0,0,11
106375,dhārayāma,dharayama,4,4,0,0,9
106376,icchitoyeva,icchitoyeva,1,1,0,0,11
106377,sambuddhānaṃ,sambuddhanam,20,17,3,0,12
106378,satīmataṃ,satimatam,8,7,1,0,9
106379,patthentīti,patthentiti,9,7,2,0,11
106380,kodhādiatthānaṃ,kodhadiatthanam,1,0,1,0,15
106381,kuppeyyaṃ,kuppeyyam,7,4,3,0,9
106382,dubbhati,dubbhati,32,32,0,0,8
106383,vipucchanaṃ,vipucchanam,1,1,0,0,11
106384,kammavikhyāpanatthaṃ,kammavikhyapanattham,1,1,0,0,20
106385,ārādho,aradho,3,3,0,0,6
106386,suṇotissa,sunotissa,1,1,0,0,9
106387,paccāyoge,paccayoge,1,1,0,0,9
106388,giṇassa,ginassa,1,1,0,0,7
106389,anupatiyoge,anupatiyoge,1,1,0,0,11
106390,vacanakammassa,vacanakammassa,2,2,0,0,14
106391,sādhukāradānādinā,sadhukaradanadina,2,2,0,0,17
106392,ussāhayatīti,ussahayatiti,1,1,0,0,12
106393,vijāniyāti,vijaniyati,9,4,5,0,10
106394,āmanta,amanta,17,16,1,0,6
106395,gacchāmāti,gacchamati,49,39,10,0,10
106396,ārocana,arocana,1,0,1,0,7
106397,kathanappakāratthattā,kathanappakaratthatta,1,1,0,0,21
106398,desanatthādippayogepi,desanatthadippayogepi,1,1,0,0,21
106399,sampadānasaññā,sampadanasanna,2,2,0,0,14
106400,buddhassatthāya,buddhassatthaya,2,2,0,0,15
106401,dhammassatthāya,dhammassatthaya,1,1,0,0,15
106402,saṅghassatthāya,sanghassatthaya,15,14,1,0,15
106403,paṭisevāmi,patisevami,21,21,0,0,10
106404,davāya,davaya,59,56,3,0,6
106405,madāya,madaya,43,43,0,0,6
106406,maṇḍanāya,mandanaya,37,37,0,0,9
106407,vibhūsanāya,vibhusanaya,35,35,0,0,11
106408,lokamanukampitunti,lokamanukampitunti,1,1,0,0,18
106409,arahapaṭikkhepā,arahapatikkhepa,1,1,0,0,15
106410,paṭikkhepe,patikkhepe,34,32,2,0,10
106411,tettha,tettha,8,8,0,0,6
106412,catumaṭṭhassa,catumatthassa,3,3,0,0,13
106413,kammaniyeva,kammaniyeva,1,1,0,0,11
106414,kaḷiṅgarassa,kalingarassa,2,2,0,0,12
106415,nibbānāya,nibbanaya,204,202,2,0,9
106416,vajantiyā,vajantiya,9,8,1,0,9
106417,āsīsanatthe,asisanatthe,2,0,2,0,11
106418,āyubhaddakusalā,ayubhaddakusala,1,0,1,0,15
106419,diyogeyeva,diyogeyeva,1,1,0,0,10
106420,sasmiṃnāsū,sasmimnasu,1,1,0,0,10
106421,āvikaraṇa,avikarana,1,0,1,0,9
106422,pātubhavanā,patubhavana,1,0,1,0,11
106423,āvikaromi,avikaromi,2,2,0,0,9
106424,pahiṇādikriyāyoge,pahinadikriyayoge,1,1,0,0,17
106425,phāsuādināmapayoge,phasuadinamapayoge,1,1,0,0,18
106426,dūtaṃ,dutam,231,223,8,0,5
106427,saddayoge,saddayoge,3,3,0,0,9
106428,sotthisvāgatādī,sotthisvagatadi,1,0,1,0,15
106429,adurāgataṃ,aduragatam,34,31,3,0,10
106430,paccissate,paccissate,2,2,0,0,10
106431,kimapādānaṃ,kimapadanam,1,1,0,0,11
106432,avadhito,avadhito,1,1,0,0,8
106433,bhayahetuto,bhayahetuto,5,5,0,0,11
106434,akkhātārā,akkhatara,1,1,0,0,9
106435,niddiṭṭhavisayaṃ,nidditthavisayam,7,5,2,0,16
106436,upāttavisayaṃ,upattavisayam,4,3,1,0,13
106437,anumeyyavisayañcāti,anumeyyavisayancati,2,2,0,0,19
106438,apādānasaññāvisayassa,apadanasannavisayassa,1,1,0,0,21
106439,kriyāvisesassa,kriyavisesassa,1,1,0,0,14
106440,nivārentī,nivarenti,5,5,0,0,9
106441,kāyasaṃyogapubbakāpagamanaṃ,kayasamyogapubbakapagamanam,1,1,0,0,27
106442,cittasaṃyogapubbakassa,cittasamyogapubbakassa,1,1,0,0,22
106443,apagamanassa,apagamanassa,4,4,0,0,12
106444,apādānasaññā,apadanasanna,2,2,0,0,12
106445,apagamanakriyaṃ,apagamanakriyam,2,2,0,0,15
106446,upāttaṃ,upattam,3,3,0,0,7
106447,ajjhāhaṭaṃ,ajjhahatam,2,2,0,0,10
106448,valāhakā,valahaka,32,32,0,0,8
106449,kusūlato,kusulato,2,2,0,0,8
106450,nikkhamma,nikkhamma,289,283,6,0,9
106451,pubbakriyā,pubbakriya,3,3,0,0,10
106452,ajjhāharīyati,ajjhahariyati,2,2,0,0,13
106453,anumeyyavisayaṃ,anumeyyavisayam,2,0,2,0,15
106454,māthurā,mathura,8,8,0,0,7
106455,pāṭaliputtakehi,pataliputtakehi,6,6,0,0,15
106456,ukkaṃsīyantīti,ukkamsiyantiti,1,1,0,0,14
106457,anumeyyova,anumeyyova,1,1,0,0,10
106458,kriyāviseso,kriyaviseso,6,6,0,0,11
106459,dūrantikā,durantika,2,1,1,0,9
106460,disutte,disutte,7,7,0,0,7
106461,vibhatta,vibhatta,1,0,1,0,8
106462,calācalavasena,calacalavasena,1,1,0,0,14
106463,duvidhampi,duvidhampi,136,129,7,0,10
106464,dhāvatā,dhavata,5,5,0,0,7
106465,hatthimhā,hatthimha,2,2,0,0,9
106466,aṅkusadhārī,ankusadhari,1,1,0,0,11
106467,otaranti,otaranti,61,60,1,0,8
106468,vanacarā,vanacara,2,2,0,0,8
106469,akkhātari,akkhatari,2,1,1,0,9
106470,ācariyamhā,acariyamha,18,16,2,0,10
106471,dhātunāmāni,dhatunamani,1,0,1,0,11
106472,avihitalakkhaṇānaṃ,avihitalakkhananam,1,1,0,0,18
106473,nipātayoge,nipatayoge,1,1,0,0,10
106474,taṃyuttaṃ,tamyuttam,1,1,0,0,9
106475,dhātuppayoge,dhatuppayoge,1,0,1,0,12
106476,parāji,paraji,1,0,1,0,6
106477,pabhūyoge,pabhuyoge,1,1,0,0,9
106478,janiyoge,janiyoge,1,1,0,0,8
106479,jāyamānassa,jayamanassa,23,22,1,0,11
106480,aññatthitarā,annatthitara,1,0,1,0,12
106481,upasaggayuttesu,upasaggayuttesu,1,0,1,0,15
106482,apaparī,apapari,1,0,1,0,7
106483,vajjanatthehi,vajjanatthehi,1,1,0,0,13
106484,mariyādābhividhiatthe,mariyadabhividhiatthe,1,1,0,0,21
106485,āyoge,ayoge,8,8,0,0,5
106486,patinidhipatidānatthena,patinidhipatidanatthena,1,1,0,0,23
106487,abhibyāpetvāti,abhibyapetvati,2,2,0,0,14
106488,nipātayuttesu,nipatayuttesu,1,0,1,0,13
106489,nānākulā,nanakula,13,12,1,0,8
106490,kammāpādānakārakamajjhepi,kammapadanakarakamajjhepi,1,1,0,0,25
106491,kāladdhānehi,kaladdhanehi,1,1,0,0,12
106492,pabhutyā,pabhutya,2,1,1,0,8
106493,diatthe,diatthe,1,1,0,0,7
106494,tadatthappayoge,tadatthappayoge,2,2,0,0,15
106495,kārādhikārato,karadhikarato,1,1,0,0,13
106496,anicchitañca,anicchitanca,1,1,0,0,12
106497,rakkhaṇañcettha,rakkhanancettha,2,2,0,0,15
106498,tāyanañca,tayananca,1,1,0,0,9
106499,vāraye,varaye,16,16,0,0,6
106500,pāpānivārenti,papanivarenti,1,1,0,0,13
106501,nānābhayato,nanabhayato,2,2,0,0,11
106502,nānārogato,nanarogato,1,1,0,0,10
106503,nānāupaddavato,nanaupaddavato,1,1,0,0,14
106504,antaradhāyantena,antaradhayantena,1,1,0,0,16
106505,antaradhānevāyaṃ,antaradhanevayam,1,1,0,0,16
106506,nilīyatīti,niliyatiti,5,2,3,0,10
106507,antarahito,antarahito,143,140,3,0,10
106508,dūrantikaddhakālanimmānatvālopadisāyogavibhattārappayoga,durantikaddhakalanimmanatvalopadisayogavibhattarappayoga,1,0,1,0,56
106509,pubbayoga,pubbayoga,1,0,1,0,9
106510,kathanathokākattūsu,kathanathokakattusu,1,0,1,0,19
106511,āratippayoge,aratippayoge,1,1,0,0,12
106512,suddhatthappayoge,suddhatthappayoge,2,1,1,0,17
106513,pamocanatthappayoge,pamocanatthappayoge,2,1,1,0,19
106514,vivittatthappayoge,vivittatthappayoge,1,1,0,0,18
106515,bandhanatthappayoge,bandhanatthappayoge,2,1,1,0,19
106516,thokatthe,thokatthe,2,1,1,0,9
106517,yadavadhibhūtaṃ,yadavadhibhutam,1,1,0,0,15
106518,hetukammādibhūtañca,hetukammadibhutanca,1,1,0,0,19
106519,dūrantikañca,durantikanca,1,1,0,0,12
106520,dūrantikatthañcāti,durantikatthancati,1,1,0,0,18
106521,dūrantikaṃ,durantikam,1,0,1,0,10
106522,sarūpekasesaṃ,sarupekasesam,7,7,0,0,13
106523,dūrantikatthappayoge,durantikatthappayoge,1,1,0,0,20
106524,dūratthappayoge,duratthappayoge,1,0,1,0,15
106525,kīvadūro,kivaduro,4,4,0,0,8
106526,nātidūre,natidure,69,64,5,0,8
106527,dūratova,duratova,315,312,3,0,8
106528,namassanti,namassanti,117,112,5,0,10
106529,āgacchantaṃ,agacchantam,359,357,2,0,11
106530,antikatthappayoge,antikatthappayoge,1,0,1,0,17
106531,addhakālanimmāne,addhakalanimmane,1,0,1,0,16
106532,rājagahato,rajagahato,44,44,0,0,10
106533,pañcacattālīsayojanamatthake,pancacattalisayojanamatthake,8,8,0,0,28
106534,ekanavutikappamatthake,ekanavutikappamatthake,11,11,0,0,22
106535,vassasahassaccayena,vassasahassaccayena,5,5,0,0,19
106536,uppajjissati,uppajjissati,3189,3186,3,0,12
106537,tvāpaccayantassa,tvapaccayantassa,1,0,1,0,16
106538,tadatthasambhavepi,tadatthasambhavepi,1,1,0,0,18
106539,saṅkameyyāti,sankameyyati,3,3,0,0,12
106540,disatthavācīhi,disatthavacihi,2,1,1,0,14
106541,disatthe,disatthe,4,2,2,0,8
106542,avīcito,avicito,38,38,0,0,7
106543,uparibhavaggā,uparibhavagga,1,1,0,0,13
106544,dakkhiṇatotiādi,dakkhinatotiadi,1,1,0,0,15
106545,paccayopi,paccayopi,20,20,0,0,9
106546,vibhattasseva,vibhattasseva,1,1,0,0,13
106547,tadaññato,tadannato,5,5,0,0,9
106548,dānato,danato,47,47,0,0,6
106549,assutameva,assutameva,2,2,0,0,10
106550,bahutaraṃ,bahutaram,218,209,9,0,9
106551,āratippayogo,aratippayogo,1,0,1,0,12
106552,viramaṇatthasaddappayogo,viramanatthasaddappayogo,1,1,0,0,24
106553,appaṭivirato,appativirato,15,15,0,0,12
106554,musāvādā,musavada,270,264,6,0,8
106555,anupakkuṭṭho,anupakkuttho,52,50,2,0,12
106556,muttohaṃ,muttoham,4,4,0,0,8
106557,sarūpekasesassa,sarupekasesassa,1,1,0,0,15
106558,tiha,tiha,30,22,8,0,4
106559,buddhosmi,buddhosmi,23,20,3,0,9
106560,kilamatha,kilamatha,6,6,0,0,9
106561,vuttamiccādīsu,vuttamiccadisu,1,1,0,0,14
106562,vivecanaṃ,vivecanam,22,22,0,0,9
106563,āyāmato,ayamato,82,81,1,0,7
106564,candabhāgāya,candabhagaya,21,21,0,0,12
106565,navayojanasataparimāṇo,navayojanasataparimano,3,3,0,0,22
106566,majjhimapadeso,majjhimapadeso,5,5,0,0,14
106567,vidatthiyo,vidatthiyo,106,93,13,0,10
106568,icceteti,icceteti,1,1,0,0,8
106569,ubbedhena,ubbedhena,53,53,0,0,9
106570,sāsaparāsi,sasaparasi,2,2,0,0,10
106571,paṭhamatthavācakena,pathamatthavacakena,1,1,0,0,19
106572,pubbayogo,pubbayogo,58,38,20,0,9
106573,adisatthavuttino,adisatthavuttino,1,1,0,0,16
106574,diggahaṇassupalakkhaṇanti,diggahanassupalakkhananti,1,1,0,0,25
106575,diyogepi,diyogepi,1,1,0,0,8
106576,pubbenāhosi,pubbenahosi,1,1,0,0,11
106577,paccantimā,paccantima,55,55,0,0,10
106578,bandhanahetumhi,bandhanahetumhi,1,1,0,0,15
106579,phalasādhanahetubhūtassa,phalasadhanahetubhutassa,1,1,0,0,24
106580,guṇavacanaṃ,gunavacanam,4,3,1,0,11
106581,issariyā,issariya,8,8,0,0,8
106582,issariyena,issariyena,32,31,1,0,10
106583,sīlato,silato,64,59,5,0,6
106584,pañhakathanesu,panhakathanesu,1,0,1,0,14
106585,kutosi,kutosi,7,7,0,0,6
106586,pāṭaliputtato,pataliputtato,12,11,1,0,13
106587,asatvavacane,asatvavacane,2,1,1,0,12
106588,akārake,akarake,3,2,1,0,7
106589,ñāpakahetumhi,napakahetumhi,1,0,1,0,13
106590,cakkhuviññāṇa,cakkhuvinnana,5,4,1,0,13
106591,tāvidaṃ,tavidam,6,5,1,0,7
106592,ahetukaṃ,ahetukam,469,456,13,0,8
106593,ekasadisabhāvāpattito,ekasadisabhavapattito,6,5,1,0,21
106594,udayabbayapīḷanā,udayabbayapilana,3,2,1,0,16
106595,avasavattittā,avasavattitta,9,8,1,0,13
106596,anattāti,anattati,161,133,28,0,8
106597,vihitattā,vihitatta,14,14,0,0,9
106598,avijjāpaccayā,avijjapaccaya,448,407,41,0,13
106599,saṅkhārapaccayā,sankharapaccaya,313,306,7,0,15
106600,asesavirāganirodhā,asesaviraganirodha,109,107,2,0,18
106601,saṅkhāranirodho,sankharanirodho,91,89,2,0,15
106602,viññāṇanirodhā,vinnananirodha,33,33,0,0,14
106603,pariggayhatīti,pariggayhatiti,7,7,0,0,14
106604,sāmisañño,samisanno,1,1,0,0,9
106605,sāmitabba,samitabba,1,1,0,0,9
106606,rujādiyogepi,rujadiyogepi,1,1,0,0,12
106607,kriyābhisambandhābhāvā,kriyabhisambandhabhava,1,1,0,0,22
106608,sāmibhāvo,samibhavo,16,15,1,0,9
106609,kriyākārakabhāvassa,kriyakarakabhavassa,1,1,0,0,19
106610,phalabhāvena,phalabhavena,19,19,0,0,12
106611,sevakādibhāvena,sevakadibhavena,2,2,0,0,15
106612,bhaṇḍabhāvena,bhandabhavena,2,2,0,0,13
106613,samūhāvayavavikāra,samuhavayavavikara,1,1,0,0,18
106614,kāriyaavatthā,kariyaavattha,1,1,0,0,13
106615,kriyādivasena,kriyadivasena,2,2,0,0,13
106616,sabbassāpi,sabbassapi,74,68,6,0,10
106617,sambandhādhārabhūto,sambandhadharabhuto,1,1,0,0,19
106618,visesanaṭṭhānī,visesanatthani,1,1,0,0,14
106619,āgamīvasena,agamivasena,2,2,0,0,11
106620,kriyākārakasañjāto,kriyakarakasanjato,6,6,0,0,18
106621,assedaṃ,assedam,1,1,0,0,7
106622,bhāvahetuko,bhavahetuko,1,1,0,0,11
106623,pāratantyañhi,paratantyanhi,2,2,0,0,13
106624,bhavetito,bhavetito,1,1,0,0,9
106625,upādhiṭṭhānā,upadhitthana,1,1,0,0,12
106626,visesyādito,visesyadito,1,1,0,0,11
106627,visesanato,visesanato,5,4,1,0,10
106628,aññasāmito,annasamito,1,1,0,0,10
106629,nivattetīti,nivattetiti,11,9,2,0,11
106630,visesīyatīti,visesiyatiti,5,5,0,0,12
106631,visesitabbo,visesitabbo,3,1,2,0,11
106632,visesitabbayoge,visesitabbayoge,1,1,0,0,15
106633,visesanatova,visesanatova,2,2,0,0,12
106634,bhaṇḍena,bhandena,16,14,2,0,8
106635,samīpasambandhe,samipasambandhe,2,1,1,0,15
106636,ambavanassa,ambavanassa,5,5,0,0,11
106637,samūhasambandhe,samuhasambandhe,3,2,1,0,15
106638,avayavasambandhe,avayavasambandhe,8,7,1,0,16
106639,manussasseva,manussasseva,14,13,1,0,12
106640,vikārasambandhe,vikarasambandhe,4,3,1,0,15
106641,bhaṭṭhadhaññānaṃ,bhatthadhannanam,3,3,0,0,16
106642,kāriyasambandhe,kariyasambandhe,1,0,1,0,15
106643,avatthāsambandhe,avatthasambandhe,1,0,1,0,16
106644,jātisambandhe,jatisambandhe,1,0,1,0,13
106645,guṇasambandhe,gunasambandhe,1,0,1,0,13
106646,guṇaghoso,gunaghoso,5,5,0,0,9
106647,samāyogo,samayogo,12,11,1,0,8
106648,vimokkho,vimokkho,561,499,62,0,8
106649,paññāpāramiṃ,pannaparamim,35,34,1,0,12
106650,pubbacariyaṃ,pubbacariyam,20,19,1,0,12
106651,paṭubhāvo,patubhavo,6,6,0,0,9
106652,lahutā,lahuta,106,96,10,0,6
106653,upacayo,upacayo,208,196,12,0,7
106654,kriyāsambandhe,kriyasambandhe,1,0,1,0,14
106655,ukkhipanaṃ,ukkhipanam,28,28,0,0,10
106656,avakkhepanaṃ,avakkhepanam,3,2,1,0,12
106657,hatthassa,hatthassa,44,44,0,0,9
106658,samiñjanaṃ,saminjanam,8,6,2,0,10
106659,pasāraṇaṃ,pasaranam,11,9,2,0,9
106660,dhātūnaṃyeva,dhatunamyeva,8,8,0,0,12
106661,nāmagottādi,namagottadi,4,4,0,0,11
106662,ṭhānito,thanito,1,0,1,0,7
106663,āgamito,agamito,1,0,1,0,7
106664,sāmiyoge,samiyoge,1,0,1,0,8
106665,rujādiyoge,rujadiyoge,2,1,1,0,10
106666,mahāsenāpatīnaṃ,mahasenapatinam,9,9,0,0,15
106667,ujjhāpetabbaṃ,ujjhapetabbam,13,11,2,0,13
106668,vikanditabbaṃ,vikanditabbam,1,1,0,0,13
106669,viravitabbaṃ,viravitabbam,10,9,1,0,12
106670,musāvādassa,musavadassa,43,40,3,0,11
106671,pupphena,pupphena,42,42,0,0,8
106672,ghatassa,ghatassa,4,4,0,0,8
106673,suhitatthayoge,suhitatthayoge,1,0,1,0,14
106674,odanassa,odanassa,21,21,0,0,8
106675,odanenāti,odanenati,1,1,0,0,9
106676,imameva,imameva,274,251,23,0,7
106677,nānappakārassa,nanappakarassa,36,34,2,0,14
106678,asucino,asucino,33,30,3,0,7
106679,paccavekkhati,paccavekkhati,558,554,4,0,13
106680,tulyatthakimalamādiyoge,tulyatthakimalamadiyoge,1,0,1,0,23
106681,tuṭṭhassa,tutthassa,22,22,0,0,9
106682,tuṭṭhenāti,tutthenati,1,1,0,0,10
106683,kitappaccayayoge,kitappaccayayoge,1,0,1,0,16
106684,aparibhuttaṃ,aparibhuttam,25,22,3,0,12
106685,kāyagatāsati,kayagatasati,122,118,4,0,12
106686,aparibhuttā,aparibhutta,8,8,0,0,11
106687,kusalādiyoge,kusaladiyoge,1,0,1,0,12
106688,amaggassa,amaggassa,3,3,0,0,9
106689,dutiyāpañcamīnamatthe,dutiyapancaminamatthe,1,1,0,0,21
106690,kitakayoge,kitakayoge,3,2,1,0,10
106691,sandhātā,sandhata,30,30,0,0,8
106692,anuppadātā,anuppadata,33,33,0,0,10
106693,vipākassa,vipakassa,283,278,5,0,9
106694,vedako,vedako,35,34,1,0,6
106695,akaraṇaṃ,akaranam,193,171,22,0,8
106696,arajakena,arajakena,2,2,0,0,9
106697,vatthānaṃ,vatthanam,52,44,8,0,9
106698,agopālakena,agopalakena,2,2,0,0,11
106699,saricchādīnaṃ,saricchadinam,1,0,1,0,13
106700,kammappaccayā,kammappaccaya,2,2,0,0,13
106701,patikurute,patikurute,6,6,0,0,10
106702,kaṇḍassa,kandassa,15,15,0,0,8
106703,parihānibhayatthayoge,parihanibhayatthayoge,1,0,1,0,21
106704,āsivisānaṃ,asivisanam,1,1,0,0,10
106705,anumoditā,anumodita,10,10,0,0,9
106706,niṭṭhādīsu,nitthadisu,1,0,1,0,10
106707,sukhakāmī,sukhakami,1,1,0,0,9
106708,katavanto,katavanto,2,2,0,0,9
106709,katāvī,katavi,24,24,0,0,6
106710,ādhārīyati,adhariyati,4,4,0,0,10
106711,kattukammasamavetānaṃ,kattukammasamavetanam,1,1,0,0,21
106712,nisajjapacanādikriyānaṃ,nisajjapacanadikriyanam,1,1,0,0,23
106713,patiṭṭhānaṭṭhena,patitthanatthena,36,36,0,0,16
106714,devadattataṇḍulānaṃ,devadattatandulanam,1,1,0,0,19
106715,taṃsamavetaṃ,tamsamavetam,1,1,0,0,12
106716,āsanapacanasaṅkhātaṃ,asanapacanasankhatam,1,1,0,0,20
106717,panāyamokāso,panayamokaso,1,1,0,0,12
106718,vesayikoti,vesayikoti,1,1,0,0,10
106719,ādheyyena,adheyyena,2,2,0,0,9
106720,ādheyyabhūtaṃ,adheyyabhutam,1,1,0,0,13
106721,khīlesu,khilesu,2,2,0,0,7
106722,dadhimhi,dadhimhi,8,8,0,0,8
106723,paccekasiddhānaṃ,paccekasiddhanam,2,2,0,0,16
106724,upasilesena,upasilesena,1,1,0,0,11
106725,upagamo,upagamo,2,2,0,0,7
106726,ādheyyo,adheyyo,1,1,0,0,7
106727,upasilissati,upasilissati,1,1,0,0,12
106728,allīyitvā,alliyitva,26,26,0,0,9
106729,ghaṭesu,ghatesu,7,7,0,0,7
106730,samīpivohāraṃ,samipivoharam,1,1,0,0,13
106731,tadāyattavuttitādīpanatthaṃ,tadayattavuttitadipanattham,1,1,0,0,27
106732,sāvatthiyā,savatthiya,132,126,6,0,10
106733,aññatthābhāvavasena,annatthabhavavasena,1,1,0,0,19
106734,desantarāvacchedavasena,desantaravacchedavasena,2,2,0,0,23
106735,pakkhanti,pakkhanti,7,6,1,0,9
106736,jalesu,jalesu,3,3,0,0,6
106737,ramatī,ramati,71,55,16,0,6
106738,cāyamādhāro,cayamadharo,1,1,0,0,11
106739,parikappitavasena,parikappitavasena,1,1,0,0,17
106740,byāpikādito,byapikadito,1,1,0,0,11
106741,tilakhīrādi,tilakhiradi,2,2,0,0,11
106742,gaṅgādi,gangadi,2,2,0,0,7
106743,sāmissarādhipatidāyādasakkhīpatibhūpasūtakusalehi,samissaradhipatidayadasakkhipatibhupasutakusalehi,1,0,1,0,49
106744,sakkhipatibhū,sakkhipatibhu,1,1,0,0,13
106745,pasūta,pasuta,1,1,0,0,6
106746,kusalaiccetehi,kusalaiccetehi,1,1,0,0,14
106747,ubhayatthaṃ,ubhayattham,13,13,0,0,11
106748,ekadesassa,ekadesassa,31,31,0,0,10
106749,samudāyavāciliṅgamhā,samudayavacilingamha,1,1,0,0,20
106750,addhikesu,addhikesu,3,3,0,0,9
106751,bhāvavatā,bhavavata,1,1,0,0,9
106752,akāmakānaṃ,akamakanam,15,13,2,0,10
106753,rudantānaṃ,rudantanam,16,13,3,0,10
106754,rudantesu,rudantesu,2,2,0,0,9
106755,kammakaraṇanimittaiccetesvatthesu,kammakarananimittaiccetesvatthesu,1,1,0,0,33
106756,cumbitvā,cumbitva,27,27,0,0,8
106757,aṇumattesu,anumattesu,103,88,15,0,10
106758,vajjesu,vajjesu,113,100,13,0,7
106759,sampajānamusāvāde,sampajanamusavade,64,55,9,0,17
106760,musāvādanimittaṃ,musavadanimittam,1,1,0,0,16
106761,musāvādappaccayāti,musavadappaccayati,1,1,0,0,18
106762,palālamayaṃ,palalamayam,2,2,0,0,11
106763,kañcanamayaṃ,kancanamayam,2,2,0,0,12
106764,bojjhaṅgikañca,bojjhangikanca,1,1,0,0,14
106765,nimesa,nimesa,1,1,0,0,6
106766,muhutta,muhutta,2,2,0,0,7
106767,pubbaṇhādiko,pubbanhadiko,2,2,0,0,12
106768,kriyantarūpalakkhaṇāva,kriyantarupalakkhanava,1,1,0,0,22
106769,kālatthe,kalatthe,2,2,0,0,8
106770,bhāvalakkhaṇe,bhavalakkhane,16,16,0,0,13
106771,phussamāsamhā,phussamasamha,1,1,0,0,13
106772,māsesu,masesu,27,27,0,0,6
106773,vesākhamāso,vesakhamaso,1,1,0,0,11
106774,bhāvenabhāvalakkhaṇe,bhavenabhavalakkhane,13,12,1,0,20
106775,bhikkhusaṅghesu,bhikkhusanghesu,3,3,0,0,15
106776,jāyamāne,jayamane,15,12,3,0,8
106777,saṃkampi,samkampi,10,10,0,0,8
106778,sampavedhi,sampavedhi,21,20,1,0,10
106779,pāsāṇā,pasana,50,43,7,0,6
106780,kaṭhalā,kathala,9,8,1,0,7
106781,khāṇukaṇṭakā,khanukantaka,6,6,0,0,12
106782,vivajjenti,vivajjenti,8,7,1,0,10
106783,lokanāyake,lokanayake,52,50,2,0,10
106784,upājhādhikissaravacane,upajhadhikissaravacane,1,0,1,0,22
106785,adhikatthe,adhikatthe,2,2,0,0,10
106786,issaratthe,issaratthe,1,1,0,0,10
106787,adhikissaravacane,adhikissaravacane,1,1,0,0,17
106788,adhikavacane,adhikavacane,1,0,1,0,12
106789,khāriyā,khariya,8,8,0,0,7
106790,adhikoti,adhikoti,5,5,0,0,8
106791,sammutiupapattivisuddhidevasaṅkhātehi,sammutiupapattivisuddhidevasankhatehi,1,1,0,0,37
106792,tividhehipi,tividhehipi,1,1,0,0,11
106793,issaravacane,issaravacane,2,1,1,0,12
106794,brahmadattissarā,brahmadattissara,3,3,0,0,16
106795,pañcālāti,pancalati,5,3,2,0,9
106796,maṇḍitaussukkaiccetesvatthesu,manditaussukkaiccetesvatthesu,1,1,0,0,29
106797,maṇḍita,mandita,1,0,1,0,7
106798,pasannatthavācako,pasannatthavacako,1,1,0,0,17
106799,ussukka,ussukka,1,0,1,0,7
106800,saīhattho,saihattho,1,1,0,0,9
106801,saññāvasā,sannavasa,2,2,0,0,9
106802,chabbīsatīvidhaṃ,chabbisatividham,1,1,0,0,16
106803,paccattavacanādivasena,paccattavacanadivasena,1,1,0,0,22
106804,bhummālapanamaṭṭhamaṃ,bhummalapanamatthamam,1,1,0,0,21
106805,kārakakaṇḍo,karakakando,3,3,0,0,11
106806,aññamaññasambandhīnaṃ,annamannasambandhinam,2,2,0,0,21
106807,nāmanissitattā,namanissitatta,2,2,0,0,14
106808,sayañca,sayanca,153,151,2,0,7
106809,nāmikattā,namikatta,2,2,0,0,9
106810,nāmānantaraṃ,namanantaram,2,2,0,0,12
106811,niccasamāsoti,niccasamasoti,1,1,0,0,13
106812,assapadaviggaho,assapadaviggaho,1,1,0,0,15
106813,upasaggaparattā,upasaggaparatta,1,1,0,0,15
106814,chaṭṭhekavacanaṃ,chatthekavacanam,2,2,0,0,16
106815,aññapadena,annapadena,10,10,0,0,10
106816,samāsavidhāne,samasavidhane,2,2,0,0,13
106817,nāmiko,namiko,2,2,0,0,6
106818,attapubbakehi,attapubbakehi,1,1,0,0,13
106819,samasīyate,samasiyate,1,1,0,0,10
106820,abyayībhāvādisaññāvidhāyakasuttāneva,abyayibhavadisannavidhayakasuttaneva,1,1,0,0,36
106821,saññāvidhānamukhena,sannavidhanamukhena,1,1,0,0,19
106822,samāsavidhāyakānīti,samasavidhayakaniti,1,1,0,0,19
106823,liṅgavacanabhedepi,lingavacanabhedepi,3,3,0,0,18
106824,byayarahitattā,byayarahitatta,3,3,0,0,14
106825,vibhāvayatīti,vibhavayatiti,2,2,0,0,13
106826,abyayatthapubbaṅgamattā,abyayatthapubbangamatta,2,2,0,0,23
106827,anabyayaṃ,anabyayam,2,2,0,0,9
106828,pubbapadatthappadhāno,pubbapadatthappadhano,2,2,0,0,21
106829,upasagganipātānameva,upasagganipatanameva,1,1,0,0,20
106830,vākyamiti,vakyamiti,1,1,0,0,9
106831,ruḷhaṃ,rulham,10,10,0,0,6
106832,divibhatyantāni,divibhatyantani,1,1,0,0,15
106833,samassateti,samassateti,3,3,0,0,11
106834,saṅkhipiyatīti,sankhipiyatiti,1,1,0,0,14
106835,padasaṅkhepo,padasankhepo,1,1,0,0,12
106836,padappaccayasaṃhitaṃ,padappaccayasamhitam,1,1,0,0,20
106837,hotevaṃ,hotevam,1,1,0,0,7
106838,tesamantaraṃ,tesamantaram,2,2,0,0,12
106839,duvidhañcassa,duvidhancassa,1,1,0,0,13
106840,samasanaṃ,samasanam,3,3,0,0,9
106841,saddasamasanamatthasamasanañca,saddasamasanamatthasamasananca,1,1,0,0,30
106842,luttasamāse,luttasamase,1,1,0,0,11
106843,paripuṇṇameva,paripunnameva,17,17,0,0,13
106844,aluttasamāse,aluttasamase,1,1,0,0,12
106845,atthasamasanameva,atthasamasanameva,1,1,0,0,17
106846,vibhattilopābhāvato,vibhattilopabhavato,1,1,0,0,19
106847,payojanāni,payojanani,14,13,1,0,10
106848,ekapadattamekavibhattittañcāti,ekapadattamekavibhattittancati,1,1,0,0,30
106849,yuttatto,yuttatto,1,0,1,0,8
106850,saṅgato,sangato,7,7,0,0,7
106851,saṅgatatthena,sangatatthena,1,1,0,0,13
106852,yuttattha,yuttattha,3,0,3,0,9
106853,ekatthībhāvo,ekatthibhavo,8,8,0,0,12
106854,samāsalakkhaṇanti,samasalakkhananti,1,1,0,0,17
106855,ākhyātena,akhyatena,6,6,0,0,9
106856,sambandhatthena,sambandhatthena,1,1,0,0,15
106857,devadattassā,devadattassa,5,5,0,0,12
106858,aññamaññānapekkhesu,annamannanapekkhesu,1,1,0,0,19
106859,aññasāpekkhesu,annasapekkhesu,1,1,0,0,14
106860,ayuttatthatāya,ayuttatthataya,1,1,0,0,14
106861,taddhitappaccayehi,taddhitappaccayehi,1,1,0,0,18
106862,dippaccayehi,dippaccayehi,1,1,0,0,12
106863,ekatthībhūtā,ekatthibhuta,1,1,0,0,12
106864,yuttatthā,yuttattha,1,1,0,0,9
106865,taddhitā,taddhita,10,8,2,0,8
106866,dippaccayantānañca,dippaccayantananca,1,1,0,0,18
106867,ggahaṇādhikāre,ggahanadhikare,1,1,0,0,14
106868,gahaṇena,gahanena,109,107,2,0,8
106869,dippaccayanta,dippaccayanta,1,1,0,0,13
106870,lopanivattanatthaṃ,lopanivattanattham,1,1,0,0,18
106871,vibhattīsū,vibhattisu,2,2,0,0,10
106872,yuttatthabhūtassa,yuttatthabhutassa,1,1,0,0,17
106873,tividhassapi,tividhassapi,15,15,0,0,12
106874,kiṃsamudaya,kimsamudaya,1,0,1,0,11
106875,niggahītantassapi,niggahitantassapi,1,1,0,0,17
106876,nimittābhāve,nimittabhave,7,7,0,0,12
106877,nemittakābhāvassa,nemittakabhavassa,1,1,0,0,17
106878,ayamatideso,ayamatideso,1,1,0,0,11
106879,sakatthavirahenidha,sakatthavirahenidha,1,1,0,0,19
106880,liṅgabhāvābhāvā,lingabhavabhava,1,1,0,0,15
106881,nāmabyapadesātidesamāha,namabyapadesatidesamaha,1,1,0,0,23
106882,nāmaṃvā,namamva,1,0,1,0,7
106883,kitantā,kitanta,1,1,0,0,7
106884,samāsā,samasa,7,7,0,0,6
106885,tavetuna,tavetuna,3,0,3,0,8
106886,dippaccayante,dippaccayante,1,1,0,0,13
106887,kiccappaccaya,kiccappaccaya,1,1,0,0,13
106888,āīinī,aiini,1,0,1,0,5
106889,itthippaccayantādissapi,itthippaccayantadissapi,1,1,0,0,23
106890,nāmabyapadesatthaṃ,namabyapadesattham,1,1,0,0,18
106891,atthavataṃ,atthavatam,1,1,0,0,10
106892,samudāyānaṃ,samudayanam,2,2,0,0,11
106893,samāsassevāti,samasassevati,1,1,0,0,13
106894,niyamatthanti,niyamatthanti,3,3,0,0,13
106895,liṅgātidese,lingatidese,1,1,0,0,11
106896,adhipaññaṃ,adhipannam,17,16,1,0,10
106897,adhiñāṇaṃṃ,adhinanamm,1,1,0,0,10
106898,rūpappasaṅgo,rupappasango,2,2,0,0,12
106899,tipaññaṃ,tipannam,1,1,0,0,8
106900,atidesaliṅgassa,atidesalingassa,1,1,0,0,15
106901,pañcamyāyamambhāvo,pancamyayamambhavo,1,1,0,0,18
106902,adhikārato,adhikarato,57,57,0,0,10
106903,tatiyāsattamīchaṭṭhīnantu,tatiyasattamichatthinantu,1,1,0,0,25
106904,upanagarena,upanagarena,1,1,0,0,11
106905,upanagarehi,upanagarehi,2,2,0,0,11
106906,upanagarā,upanagara,1,1,0,0,9
106907,upanagaramhā,upanagaramha,1,1,0,0,12
106908,upanagarasmā,upanagarasma,1,1,0,0,12
106909,upanagarassa,upanagarassa,1,1,0,0,12
106910,upanagarānaṃ,upanagaranam,1,1,0,0,12
106911,upanagaramhi,upanagaramhi,1,1,0,0,12
106912,upanagarasmiṃ,upanagarasmim,1,1,0,0,13
106913,upanagaresu,upanagaresu,1,1,0,0,11
106914,nimmasakaṃ,nimmasakam,2,2,0,0,10
106915,pacchāatthe,pacchaatthe,1,0,1,0,11
106916,anuvātaṃ,anuvatam,34,29,5,0,8
106917,yoggatāyaṃ,yoggatayam,1,0,1,0,10
106918,yathāsarūpaṃ,yathasarupam,2,2,0,0,12
106919,rūpayogganti,rupayogganti,1,1,0,0,12
106920,attānamattānaṃ,attanamattanam,1,1,0,0,14
106921,anupubbiyaṃ,anupubbiyam,1,0,1,0,11
106922,jeṭṭhānaṃ,jetthanam,13,12,1,0,9
106923,anujeṭṭhaṃ,anujettham,4,4,0,0,10
106924,paṭilomaṃ,patilomam,34,31,3,0,9
106925,paṭipathaṃ,patipatham,49,46,3,0,10
106926,pativātaṃ,pativatam,1,1,0,0,9
106927,pariyādābhividhīsu,pariyadabhividhisu,1,0,1,0,18
106928,āpāṇakoṭiyā,apanakotiya,2,2,0,0,11
106929,āpāṇakoṭikaṃ,apanakotikam,27,20,7,0,12
106930,ākumārehi,akumarehi,2,2,0,0,9
106931,samiddhīti,samiddhiti,6,1,5,0,10
106932,samāseva,samaseva,1,1,0,0,8
106933,nānuvattetabbaṃ,nanuvattetabbam,1,1,0,0,15
106934,digudvandabahubbīhīsupi,digudvandabahubbihisupi,1,1,0,0,23
106935,samāsantassarassa,samasantassarassa,1,1,0,0,17
106936,vibhattīna,vibhattina,2,2,0,0,10
106937,mādeso,madeso,9,9,0,0,6
106938,amikiccāti,amikiccati,1,1,0,0,10
106939,samāsanapuṃsakarassattādīsu,samasanapumsakarassattadisu,1,1,0,0,27
106940,katesu,katesu,37,36,1,0,6
106941,adhitti,adhitti,2,2,0,0,7
106942,upasaggapubbako,upasaggapubbako,1,0,1,0,15
106943,nipātapubbako,nipatapubbako,1,0,1,0,13
106944,padatthānatikkame,padatthanatikkame,1,0,1,0,17
106945,balamanatikkamitvā,balamanatikkamitva,1,1,0,0,18
106946,yāvatāyukaṃ,yavatayukam,274,266,8,0,11
106947,parabhāgo,parabhago,10,9,1,0,9
106948,antonagaraṃ,antonagaram,41,41,0,0,11
106949,antovassaṃ,antovassam,60,54,6,0,10
106950,bahinagaraṃ,bahinagaram,10,10,0,0,11
106951,uparipāsādaṃ,uparipasadam,10,10,0,0,12
106952,uparimañcaṃ,uparimancam,2,2,0,0,11
106953,heṭṭhāmañcaṃ,hetthamancam,25,25,0,0,12
106954,bhattassa,bhattassa,84,82,2,0,9
106955,sākallatthe,sakallatthe,1,0,1,0,11
106956,samakkhikaṃ,samakkhikam,6,6,0,0,11
106957,parivajjetīti,parivajjetiti,15,5,10,0,13
106958,oragaṅgamiccādi,oragangamiccadi,1,1,0,0,15
106959,navavidho,navavidho,47,42,5,0,9
106960,visesanapubbapado,visesanapubbapado,5,3,2,0,17
106961,visesanuttarapado,visesanuttarapado,4,3,1,0,17
106962,visesanobhayapado,visesanobhayapado,6,4,2,0,17
106963,upamānuttarapado,upamanuttarapado,4,3,1,0,16
106964,sambhāvanāpubbapado,sambhavanapubbapado,5,3,2,0,19
106965,avadhāraṇapubbapado,avadharanapubbapado,4,2,2,0,19
106966,nipātapubbapado,nipatapubbapado,2,2,0,0,15
106967,pubbapado,pubbapado,2,2,0,0,9
106968,dipubbapado,dipubbapado,1,1,0,0,11
106969,tulyādhikaraṇabhāvappasiddhatthaṃ,tulyadhikaranabhavappasiddhattham,1,1,0,0,33
106970,nāmikāni,namikani,1,1,0,0,8
106971,kammadhārayasañño,kammadharayasanno,1,1,0,0,17
106972,dvipadaṃ,dvipadam,12,7,5,0,8
106973,tulyādhikaraṇaṃ,tulyadhikaranam,15,14,1,0,15
106974,bhinnappavattinimittānaṃ,bhinnappavattinimittanam,1,1,0,0,24
106975,kammamiva,kammamiva,5,5,0,0,9
106976,kriyañca,kriyanca,5,5,0,0,8
106977,payojanassa,payojanassa,4,4,0,0,11
106978,katthajotakassa,katthajotakassa,1,1,0,0,15
106979,nāmadvayassa,namadvayassa,2,2,0,0,12
106980,samāsasaññāvibhattilopapakatibhāvā,samasasannavibhattilopapakatibhava,1,1,0,0,34
106981,vuttatthānamappayogo,vuttatthanamappayogo,7,7,0,0,20
106982,saddānamappayogo,saddanamappayogo,1,1,0,0,16
106983,visesanabhūtassa,visesanabhutassa,2,2,0,0,16
106984,desavidhānatova,desavidhanatova,1,1,0,0,15
106985,kammadhārayadigusamāsā,kammadharayadigusamasa,1,1,0,0,22
106986,tappurisasadisattā,tappurisasadisatta,2,2,0,0,18
106987,anvatthasaññāya,anvatthasannaya,2,2,0,0,15
106988,tappurisoti,tappurisoti,5,3,2,0,11
106989,guṇamativatto,gunamativatto,1,1,0,0,13
106990,uttarapadatthappadhāno,uttarapadatthappadhano,3,3,0,0,22
106991,abhidheyyavacano,abhidheyyavacano,3,3,0,0,16
106992,paraliṅgo,paralingo,1,1,0,0,9
106993,dantapuriso,dantapuriso,1,1,0,0,11
106994,vīrapuriso,virapuriso,4,4,0,0,10
106995,setahatthī,setahatthi,3,3,0,0,10
106996,vibhāsādhikārato,vibhasadhikarato,2,2,0,0,16
106997,mantāniputto,mantaniputto,5,5,0,0,12
106998,devarājāti,devarajati,5,4,1,0,10
106999,pubbabhūto,pubbabhuto,1,1,0,0,10
107000,itthivācako,itthivacako,2,2,0,0,11
107001,itthippaccayassa,itthippaccayassa,2,2,0,0,16
107002,nivatti,nivatti,93,93,0,0,7
107003,khattiyakaññāyo,khattiyakannayo,4,4,0,0,15
107004,rattalatā,rattalata,2,2,0,0,9
107005,dutiyabhikkhā,dutiyabhikkha,2,2,0,0,13
107006,nāgamāṇavikā,nagamanavika,19,19,0,0,12
107007,pubbapadassevāyaṃ,pubbapadassevayam,2,2,0,0,17
107008,pumbhāvātideso,pumbhavatideso,7,6,1,0,14
107009,khattiyakumārī,khattiyakumari,1,1,0,0,14
107010,kumārasamaṇī,kumarasamani,1,1,0,0,12
107011,taruṇabrāhmaṇī,tarunabrahmani,1,1,0,0,14
107012,kumārīratanaṃ,kumariratanam,2,2,0,0,13
107013,samaṇīpadumaṃ,samanipadumam,2,2,0,0,13
107014,bhāsitapumāti,bhasitapumati,4,2,2,0,13
107015,gaṅgānadī,ganganadi,3,3,0,0,9
107016,taṇhānadī,tanhanadi,15,13,2,0,9
107017,nandāpokkharaṇī,nandapokkharani,5,5,0,0,15
107018,nandādevī,nandadevi,7,7,0,0,9
107019,puratthimo,puratthimo,10,10,0,0,10
107020,puratthimakāyo,puratthimakayo,2,2,0,0,14
107021,kāyekadeso,kayekadeso,3,3,0,0,10
107022,pacchimakāyo,pacchimakayo,4,4,0,0,12
107023,sabbakāyo,sabbakayo,2,2,0,0,9
107024,purāṇavihāro,puranaviharo,1,1,0,0,12
107025,navāvāso,navavaso,2,2,0,0,8
107026,kataranikāyo,kataranikayo,2,2,0,0,12
107027,katamanikāyo,katamanikayo,1,1,0,0,12
107028,hetuppaccayo,hetuppaccayo,1,1,0,0,12
107029,abahulaṃ,abahulam,1,1,0,0,8
107030,bahulīkataṃ,bahulikatam,71,67,4,0,11
107031,jīvitappadhānaṃ,jivitappadhanam,2,2,0,0,15
107032,jīvitanavakaṃ,jivitanavakam,19,18,1,0,13
107033,visesanuttarapade,visesanuttarapade,2,1,1,0,17
107034,jinavacanānuparodhato,jinavacananuparodhato,1,1,0,0,21
107035,therācariyapaṇḍitādi,theracariyapanditadi,1,1,0,0,20
107036,sāriputtatthero,sariputtatthero,131,126,5,0,15
107037,mahāmoggallānatthero,mahamoggallanatthero,69,66,3,0,20
107038,mahākassapatthero,mahakassapatthero,84,79,5,0,17
107039,buddhaghosācariyo,buddhaghosacariyo,4,4,0,0,17
107040,dhammapālācariyo,dhammapalacariyo,4,4,0,0,16
107041,ācariyaguttiloti,acariyaguttiloti,1,1,0,0,16
107042,mahosadhapaṇḍito,mahosadhapandito,26,26,0,0,16
107043,vatthuviseso,vatthuviseso,1,1,0,0,12
107044,uṇhañcāti,unhancati,3,3,0,0,9
107045,siniddhuṇho,siniddhunho,2,2,0,0,11
107046,khañjakhujjo,khanjakhujjo,3,3,0,0,12
107047,andhabadhiro,andhabadhiro,6,6,0,0,12
107048,chinnabhinnaṃ,chinnabhinnam,5,5,0,0,13
107049,sittasammaṭṭhaṃ,sittasammattham,3,3,0,0,15
107050,gatapaccāgataṃ,gatapaccagatam,13,9,4,0,14
107051,upamānuttarapade,upamanuttarapade,1,0,1,0,16
107052,abhidhānānurodhato,abhidhananurodhato,1,1,0,0,18
107053,upamānabhūtaṃ,upamanabhutam,2,2,0,0,13
107054,munivasabho,munivasabho,3,3,0,0,11
107055,buddhanāgo,buddhanago,10,10,0,0,10
107056,saddhammaraṃsi,saddhammaramsi,3,3,0,0,14
107057,vinayasāgaro,vinayasagaro,5,5,0,0,12
107058,puṇḍarīkamiva,pundarikamiva,1,1,0,0,13
107059,samaṇapuṇḍarīko,samanapundariko,23,21,2,0,15
107060,samaṇapadumo,samanapadumo,24,22,2,0,12
107061,mukhapadumaṃ,mukhapadumam,5,5,0,0,12
107062,dhammabuddhi,dhammabuddhi,3,3,0,0,12
107063,dhammasaññā,dhammasanna,46,45,1,0,11
107064,dhammasaṅkhāto,dhammasankhato,3,3,0,0,14
107065,pāṇasaññitā,panasannita,22,21,1,0,11
107066,asubhasaññā,asubhasanna,62,57,5,0,11
107067,anattasaññā,anattasanna,77,71,6,0,11
107068,dhītusaññā,dhitusanna,1,1,0,0,10
107069,attasaññā,attasanna,23,21,2,0,9
107070,atthisaññā,atthisanna,1,1,0,0,10
107071,attadiṭṭhi,attaditthi,15,15,0,0,10
107072,guṇadhanaṃ,gunadhanam,5,5,0,0,10
107073,paññādhanaṃ,pannadhanam,17,16,1,0,11
107074,cakkhudhātu,cakkhudhatu,214,207,7,0,11
107075,cakkhudvāraṃ,cakkhudvaram,9,9,0,0,12
107076,rūpārammaṇamiccādi,ruparammanamiccadi,1,1,0,0,18
107077,nanipātapubbapado,nanipatapubbapado,5,3,2,0,17
107078,vibhattilopādimhi,vibhattilopadimhi,2,2,0,0,17
107079,nipātapadassa,nipatapadassa,1,1,0,0,13
107080,tappurisekadesattā,tappurisekadesatta,1,1,0,0,18
107081,desādiniyamaṃ,desadiniyamam,3,3,0,0,13
107082,cāphalo,caphalo,1,1,0,0,7
107083,kathamabrāhmaṇoti,kathamabrahmanoti,1,1,0,0,17
107084,nisedhatthānuvādena,nisedhatthanuvadena,2,2,0,0,19
107085,paṭisedhavidhi,patisedhavidhi,2,2,0,0,14
107086,micchāñāṇattākhyāpanāyopapajjate,micchananattakhyapanayopapajjate,1,1,0,0,32
107087,cassattho,cassattho,1,1,0,0,9
107088,pasajjappaṭisedhapariyudāsavasena,pasajjappatisedhapariyudasavasena,1,1,0,0,33
107089,asūriyapassā,asuriyapassa,4,4,0,0,12
107090,rājadārā,rajadara,1,1,0,0,8
107091,uttarapadatthassa,uttarapadatthassa,3,3,0,0,17
107092,pasajjappaṭisedhavācī,pasajjappatisedhavaci,1,0,1,0,21
107093,abrāhmaṇa,abrahmana,2,2,0,0,9
107094,amanussā,amanussa,127,127,0,0,8
107095,uttarapadatthaṃ,uttarapadattham,2,2,0,0,15
107096,pariyudāsitvā,pariyudasitva,2,2,0,0,13
107097,taṃsadise,tamsadise,12,12,0,0,9
107098,paṭipādayati,patipadayati,6,6,0,0,12
107099,pariyudāsavācī,pariyudasavaci,2,1,1,0,14
107100,pasajjappaṭisedhassa,pasajjappatisedhassa,1,1,0,0,20
107101,vatthunatthitā,vatthunatthita,2,2,0,0,14
107102,pariyudāsalakkhaṇaṃ,pariyudasalakkhanam,2,2,0,0,19
107103,nvevaṃ,nvevam,1,1,0,0,6
107104,kathamuttarapadatthappadhānatā,kathamuttarapadatthappadhanata,1,1,0,0,30
107105,brāhmaṇādiatthasseva,brahmanadiatthasseva,1,1,0,0,20
107106,taṃsadisādiatthassāpi,tamsadisadiatthassapi,1,1,0,0,21
107107,kevalābrāhmaṇādiatthesveva,kevalabrahmanadiatthesveva,1,1,0,0,26
107108,viyasattāyaṃ,viyasattayam,1,1,0,0,12
107109,sadisādivācakena,sadisadivacakena,1,1,0,0,16
107110,taṃsadisatadaññatabbiruddhatadabhāvesupi,tamsadisatadannatabbiruddhatadabhavesupi,1,1,0,0,40
107111,yādiyoge,yadiyoge,1,1,0,0,8
107112,anubhavanaabhibhavanādīsu,anubhavanaabhibhavanadisu,1,1,0,0,25
107113,uttarapadatthajotakoyevettha,uttarapadatthajotakoyevettha,1,1,0,0,28
107114,abrāhmaṇoti,abrahmanoti,4,4,0,0,11
107115,brāhmaṇasadisoti,brahmanasadisoti,2,2,0,0,16
107116,assamaṇo,assamano,75,72,3,0,8
107117,asaṃkiliṭṭhā,asamkilittha,31,30,1,0,12
107118,apariyāpannā,apariyapanna,177,171,6,0,12
107119,kusalapaṭipakkhāti,kusalapatipakkhati,4,4,0,0,18
107120,pasajjappaṭisedhe,pasajjappatisedhe,2,1,1,0,17
107121,akaronto,akaronto,166,160,6,0,8
107122,anupavādo,anupavado,8,8,0,0,9
107123,anādāya,anadaya,29,28,1,0,7
107124,anoloketvā,anoloketva,97,97,0,0,10
107125,kupubbapado,kupubbapado,1,0,1,0,11
107126,kucchitamannanti,kucchitamannanti,1,1,0,0,16
107127,kadada,kadada,1,0,1,0,6
107128,kudiṭṭhi,kuditthi,4,4,0,0,8
107129,bahuvacanuccāraṇato,bahuvacanuccaranato,1,1,0,0,19
107130,kucchitatthe,kucchitatthe,4,3,1,0,12
107131,pādipubbapado,padipubbapado,3,1,2,0,13
107132,niccasamāsova,niccasamasova,2,2,0,0,13
107133,vaddhaṃ,vaddham,5,5,0,0,7
107134,atidevo,atidevo,25,24,1,0,7
107135,adhidevo,adhidevo,3,3,0,0,8
107136,avihitalakkhaṇā,avihitalakkhana,1,1,0,0,15
107137,nāmanipātopasaggā,namanipatopasagga,1,1,0,0,17
107138,acandamullokikāni,acandamullokikani,3,3,0,0,17
107139,assaddhabhojī,assaddhabhoji,2,2,0,0,13
107140,alavaṇabhojītiādīsu,alavanabhojitiadisu,1,1,0,0,19
107141,ayuttatthattā,ayuttatthatta,2,2,0,0,13
107142,sutapubbo,sutapubbo,7,7,0,0,9
107143,gatapubbo,gatapubbo,13,13,0,0,9
107144,sutapubbā,sutapubba,12,12,0,0,9
107145,gatapubbā,gatapubba,9,9,0,0,9
107146,samāsasaññāyaṃ,samasasannayam,1,1,0,0,14
107147,pakatibhāve,pakatibhave,2,2,0,0,11
107148,digusañño,digusanno,1,1,0,0,9
107149,digusadisattā,digusadisatta,1,1,0,0,13
107150,digūti,diguti,3,1,2,0,6
107151,saṅkhyāpubbattanapuṃsakekattasaṅkhātehi,sankhyapubbattanapumsakekattasankhatehi,1,1,0,0,39
107152,saṅkhyāsaddasseva,sankhyasaddasseva,1,1,0,0,17
107153,samāhāradigussetaṃ,samaharadigussetam,1,1,0,0,18
107154,nāmabyapadesasyādyuppatti,namabyapadesasyadyuppatti,1,1,0,0,25
107155,mādesādi,madesadi,2,2,0,0,8
107156,tilokena,tilokena,3,3,0,0,8
107157,tilokasmā,tilokasma,1,1,0,0,9
107158,tilokamhā,tilokamha,1,1,0,0,9
107159,tilokamhi,tilokamhi,1,1,0,0,9
107160,tilokasmiṃ,tilokasmim,2,2,0,0,10
107161,samāhaṭāni,samahatani,17,17,0,0,10
107162,malānaṃ,malanam,10,9,1,0,7
107163,catussaccaṃ,catussaccam,3,3,0,0,11
107164,pañcasikkhāpadaṃ,pancasikkhapadam,5,4,1,0,16
107165,aṭṭhasīlaṃ,atthasilam,4,4,0,0,10
107166,navalokuttaraṃ,navalokuttaram,6,6,0,0,14
107167,dasasīlaṃ,dasasilam,20,20,0,0,9
107168,satayojanaṃ,satayojanam,8,8,0,0,11
107169,godāvarīnamantassa,godavarinamantassa,1,1,0,0,18
107170,rājādigaṇassetaṃ,rajadiganassetam,1,1,0,0,16
107171,rājādī,rajadi,1,0,1,0,6
107172,bahubbīhādimhi,bahubbihadimhi,1,1,0,0,14
107173,pūtī,puti,5,4,1,0,4
107174,ntassikāro,ntassikaro,1,1,0,0,10
107175,samāsantagatānamanto,samasantagatanamanto,1,1,0,0,20
107176,samāsādiṃ,samasadim,1,1,0,0,9
107177,pubbasarassa,pubbasarassa,3,3,0,0,12
107178,asamāhāradigu,asamaharadigu,2,0,2,0,13
107179,ekadhammo,ekadhammo,99,93,6,0,9
107180,ekaputto,ekaputto,13,13,0,0,8
107181,dasasahassacakkavāḷāni,dasasahassacakkavalani,1,1,0,0,22
107182,tappurisasamāsa,tappurisasamasa,2,2,0,0,15
107183,tappurisasamāso,tappurisasamaso,4,4,0,0,15
107184,dutiyādīsu,dutiyadisu,52,49,3,0,10
107185,dutiyātappuriso,dutiyatappuriso,6,6,0,0,15
107186,gatanissitātītātikkantappattāpannādīhi,gatanissitatitatikkantappattapannadihi,1,1,0,0,38
107187,mādivibhatyantāni,madivibhatyantani,1,1,0,0,17
107188,yuttatthāni,yuttatthani,2,2,0,0,11
107189,tappurisasañño,tappurisasanno,1,1,0,0,14
107190,abhidheyyavacanaliṅgo,abhidheyyavacanalingo,1,1,0,0,21
107191,kitantattā,kitantatta,2,2,0,0,10
107192,vibhattilopādi,vibhattilopadi,2,2,0,0,14
107193,pubbasamaṃ,pubbasamam,9,8,1,0,10
107194,saraṇagato,saranagato,17,16,1,0,10
107195,saraṇagatā,saranagata,5,5,0,0,10
107196,saraṇagatāyo,saranagatayo,2,2,0,0,12
107197,saraṇagataṃ,saranagatam,5,5,0,0,11
107198,saraṇagatāni,saranagatani,2,2,0,0,12
107199,araññagato,arannagato,81,74,7,0,10
107200,dhammanissito,dhammanissito,5,5,0,0,13
107201,atthanissito,atthanissito,4,4,0,0,12
107202,kālātīto,kalatito,3,3,0,0,8
107203,lokātikkantaṃ,lokatikkantam,2,2,0,0,13
107204,dukkhappatto,dukkhappatto,12,12,0,0,12
107205,sotāpanno,sotapanno,550,526,24,0,9
107206,nirodhasamāpanno,nirodhasamapanno,19,19,0,0,16
107207,rathāruḷho,ratharulho,3,3,0,0,10
107208,sabbarattisobhano,sabbarattisobhano,1,1,0,0,17
107209,upapadasamāse,upapadasamase,2,1,1,0,13
107210,niccattā,niccatta,14,14,0,0,8
107211,vinayadharo,vinayadharo,190,188,2,0,11
107212,tavantumānantā,tavantumananta,1,0,1,0,14
107213,dikitantehi,dikitantehi,1,1,0,0,11
107214,vavatthitavibhāsādhikārato,vavatthitavibhasadhikarato,1,1,0,0,26
107215,anabhidhānato,anabhidhanato,4,4,0,0,13
107216,abhidhānalakkhaṇā,abhidhanalakkhana,2,2,0,0,17
107217,taddhitasamāsakitakāti,taddhitasamasakitakati,1,1,0,0,22
107218,kitaka,kitaka,3,3,0,0,6
107219,samūnattha,samunattha,1,1,0,0,10
107220,missasakhilādīhi,missasakhiladihi,1,1,0,0,16
107221,buddhabhāsito,buddhabhasito,10,10,0,0,13
107222,jinadesito,jinadesito,2,2,0,0,10
107223,satthuvaṇṇito,satthuvannito,5,5,0,0,13
107224,viññugarahito,vinnugarahito,5,5,0,0,13
107225,viññuppasattho,vinnuppasattho,2,2,0,0,14
107226,sukehi,sukehi,3,3,0,0,6
107227,sukāhataṃ,sukahatam,1,1,0,0,9
107228,rogapīḷito,rogapilito,3,3,0,0,10
107229,aggidaḍḍho,aggidaddho,5,5,0,0,10
107230,sappadaṭṭho,sappadattho,3,3,0,0,11
107231,apakato,apakato,8,7,1,0,7
107232,icchāpakato,icchapakato,55,55,0,0,11
107233,ñāṇasampayuttaṃ,nanasampayuttam,117,114,3,0,15
107234,mittasaṃsaggo,mittasamsaggo,3,3,0,0,13
107235,piyavippayogo,piyavippayogo,17,15,2,0,13
107236,jātitthaddho,jatitthaddho,3,2,1,0,12
107237,guṇahīno,gunahino,5,5,0,0,8
107238,guṇavuḍḍho,gunavuddho,6,4,2,0,10
107239,catuvaggakaraṇīyaṃ,catuvaggakaraniyam,4,4,0,0,18
107240,catuvaggādikattabbaṃ,catuvaggadikattabbam,5,5,0,0,20
107241,parasunā,parasuna,2,2,0,0,8
107242,māsapubbo,masapubbo,3,3,0,0,9
107243,mātusadiso,matusadiso,5,5,0,0,10
107244,sīlavikalo,silavikalo,3,3,0,0,10
107245,vācānipuṇo,vacanipuno,3,3,0,0,10
107246,yāvakālikasaṃmissaṃ,yavakalikasammissam,1,1,0,0,19
107247,vācāsakhilo,vacasakhilo,3,3,0,0,11
107248,satthukappo,satthukappo,9,9,0,0,11
107249,guṇādhiko,gunadhiko,3,3,0,0,9
107250,khīrodano,khirodano,3,3,0,0,9
107251,assena,assena,21,21,0,0,6
107252,assaratho,assaratho,9,9,0,0,9
107253,maggacittaṃ,maggacittam,65,64,1,0,11
107254,pakatimedhāvī,pakatimedhavi,2,2,0,0,13
107255,tatiyātappuriso,tatiyatappuriso,7,7,0,0,15
107256,tadatthaatthahitadeyyādīhi,tadatthaatthahitadeyyadihi,1,1,0,0,26
107257,kathinacīvaratthāyāti,kathinacivaratthayati,1,1,0,0,21
107258,cīvaradussaṃ,civaradussam,7,7,0,0,12
107259,cīvaramūlyaṃ,civaramulyam,2,2,0,0,12
107260,yāgutaṇḍulā,yagutandula,2,2,0,0,11
107261,bhattataṇḍulā,bhattatandula,2,2,0,0,13
107262,saṅghabhattaṃ,sanghabhattam,79,64,15,0,13
107263,āgantukānamatthāya,agantukanamatthaya,1,1,0,0,18
107264,gamikabhattaṃ,gamikabhattam,20,20,0,0,13
107265,pāsādāya,pasadaya,3,3,0,0,8
107266,pāsādadabbaṃ,pasadadabbam,2,2,0,0,12
107267,bhikkhusaṅghassatthāya,bhikkhusanghassatthaya,1,1,0,0,22
107268,bhikkhusaṅghattho,bhikkhusanghattho,2,2,0,0,17
107269,bhikkhusaṅghatthā,bhikkhusanghattha,2,2,0,0,17
107270,bhikkhusaṅghatthaṃ,bhikkhusanghattham,2,2,0,0,18
107271,yassatthāya,yassatthaya,144,142,2,0,11
107272,yadattho,yadattho,8,7,1,0,8
107273,yadatthā,yadattha,7,7,0,0,8
107274,saṃvaratthāya,samvaratthaya,21,21,0,0,13
107275,samādhatthāya,samadhatthaya,8,8,0,0,13
107276,nibbidā,nibbida,118,105,13,0,7
107277,virāgatthāya,viragatthaya,11,11,0,0,12
107278,vimuttatthāya,vimuttatthaya,7,7,0,0,13
107279,saṅghadeyyaṃ,sanghadeyyam,2,2,0,0,12
107280,catutthītappuriso,catutthitappuriso,5,5,0,0,17
107281,apagamana,apagamana,3,3,0,0,9
107282,mocanatthādīhi,mocanatthadihi,2,2,0,0,14
107283,methunasmā,methunasma,12,11,1,0,10
107284,palāpāpagato,palapapagato,2,2,0,0,12
107285,nagaraniggato,nagaraniggato,3,3,0,0,13
107286,piṇḍapātapaṭikkanto,pindapatapatikkanto,128,128,0,0,19
107287,nikkhantaṃ,nikkhantam,125,117,8,0,10
107288,gāmanikkhantaṃ,gamanikkhantam,1,1,0,0,14
107289,rukkhaggā,rukkhagga,4,4,0,0,9
107290,rukkhaggapatito,rukkhaggapatito,2,2,0,0,15
107291,sāsanacuto,sasanacuto,2,2,0,0,10
107292,āpattivuṭṭhānaṃ,apattivutthanam,21,18,3,0,15
107293,dharaṇitaluggato,dharanitaluggato,1,1,0,0,16
107294,sabbabhavanissaṭo,sabbabhavanissato,2,2,0,0,17
107295,bhayatthādiyoge,bhayatthadiyoge,1,0,1,0,15
107296,amanussehi,amanussehi,38,38,0,0,10
107297,amanussabhayaṃ,amanussabhayam,3,3,0,0,14
107298,pāpabhīto,papabhito,2,2,0,0,9
107299,pāpabhīruko,papabhiruko,6,6,0,0,11
107300,akattabbato,akattabbato,11,11,0,0,11
107301,akattabbavirati,akattabbavirati,4,4,0,0,15
107302,kāyaduccaritavirati,kayaduccaritavirati,12,8,4,0,19
107303,vacīduccaritavirati,vaciduccaritavirati,10,10,0,0,19
107304,bandhanamutto,bandhanamutto,3,3,0,0,13
107305,vanamutto,vanamutto,4,4,0,0,9
107306,bandhanamokkho,bandhanamokkho,8,7,1,0,14
107307,kammasamuṭṭhitaṃ,kammasamutthitam,4,4,0,0,16
107308,ukkaṭṭhukkaṭṭhaṃ,ukkatthukkattham,2,2,0,0,16
107309,omakomakaṃ,omakomakam,2,2,0,0,10
107310,utujaṃ,utujam,19,13,6,0,6
107311,āhārajaṃ,aharajam,12,7,5,0,8
107312,pañcamītappuriso,pancamitappuriso,5,5,0,0,16
107313,ācariyapūjako,acariyapujako,3,3,0,0,13
107314,buddhasāvako,buddhasavako,20,18,2,0,12
107315,buddharūpaṃ,buddharupam,23,23,0,0,11
107316,samuddaghoso,samuddaghoso,3,3,0,0,12
107317,pupphagandho,pupphagandho,34,30,4,0,12
107318,kāyalahutā,kayalahuta,36,31,5,0,10
107319,maraṇassati,maranassati,47,44,3,0,11
107320,ayassa,ayassa,6,6,0,0,6
107321,suvaṇṇakaṭāhaṃ,suvannakataham,8,8,0,0,14
107322,pānīyathālakaṃ,paniyathalakam,29,26,3,0,14
107323,sappikumbho,sappikumbho,13,13,0,0,11
107324,samāsādimhi,samasadimhi,4,4,0,0,11
107325,devarājaṃ,devarajam,7,7,0,0,9
107326,ttābhāve,ttabhave,4,4,0,0,8
107327,devarājāno,devarajano,5,5,0,0,10
107328,devasakhāno,devasakhano,1,1,0,0,11
107329,pumantalopādi,pumantalopadi,1,1,0,0,13
107330,hatthipadaṃ,hatthipadam,23,23,0,0,11
107331,itthirūpaṃ,itthirupam,78,69,9,0,10
107332,bhikkhunisaṅgho,bhikkhunisangho,137,137,0,0,15
107333,jambusākhā,jambusakha,4,4,0,0,10
107334,kārūkārānaṃ,karukaranam,2,2,0,0,11
107335,bhaṭasambandhe,bhatasambandhe,1,1,0,0,14
107336,aññamaññānapekkhatāya,annamannanapekkhataya,1,1,0,0,21
107337,ayuttatthabhāvato,ayuttatthabhavato,2,2,0,0,17
107338,kosalassa,kosalassa,80,79,1,0,9
107339,asamatthattā,asamatthatta,20,20,0,0,12
107340,gurukulaṃ,gurukulam,6,6,0,0,9
107341,sāvakasaṅghotiādi,savakasanghotiadi,2,2,0,0,17
107342,chaṭṭhītappuriso,chatthitappuriso,8,8,0,0,16
107343,rūpasañcetanā,rupasancetana,24,24,0,0,13
107344,cakkhumhi,cakkhumhi,49,45,4,0,9
107345,sannissitaṃ,sannissitam,11,10,1,0,11
107346,dhammābhirati,dhammabhirati,2,2,0,0,13
107347,dhammaruci,dhammaruci,14,12,2,0,10
107348,dhammagāravo,dhammagaravo,12,12,0,0,12
107349,dhammanirutti,dhammanirutti,2,2,0,0,13
107350,dānādhimutti,danadhimutti,3,3,0,0,12
107351,bhavantarakataṃ,bhavantarakatam,4,4,0,0,15
107352,dassanassādo,dassanassado,8,8,0,0,12
107353,araññavāso,arannavaso,28,28,0,0,10
107354,vikāle,vikale,397,370,27,0,6
107355,vikālabhojanaṃ,vikalabhojanam,49,38,11,0,14
107356,kālavassaṃ,kalavassam,3,3,0,0,10
107357,vanapupphaṃ,vanapuppham,2,2,0,0,11
107358,vanamahiso,vanamahiso,2,2,0,0,10
107359,gāmasūkaro,gamasukaro,9,8,1,0,10
107360,samuddamaccho,samuddamaccho,2,2,0,0,13
107361,āvāṭakacchapo,avatakacchapo,4,4,0,0,13
107362,āvāṭamaṇḍūko,avatamanduko,2,2,0,0,12
107363,titthanāvā,titthanava,2,2,0,0,10
107364,itthidhutto,itthidhutto,22,22,0,0,11
107365,chāyāsukkho,chayasukkho,2,2,0,0,11
107366,aṅgārapakkaṃ,angarapakkam,4,3,1,0,12
107367,cārakabaddho,carakabaddho,1,1,0,0,12
107368,vanacaro,vanacaro,15,15,0,0,8
107369,jalaṭṭho,jalattho,5,5,0,0,8
107370,sattamītappuriso,sattamitappuriso,4,4,0,0,16
107371,accantā,accanta,15,13,2,0,7
107372,mādivibhatyantaṃ,madivibhatyantam,1,1,0,0,16
107373,accantāni,accantani,1,1,0,0,9
107374,velaṃ,velam,112,104,8,0,5
107375,ativelo,ativelo,1,1,0,0,7
107376,nissitanti,nissitanti,14,14,0,0,10
107377,anvatthaṃ,anvattham,3,3,0,0,9
107378,pariccattanti,pariccattanti,4,4,0,0,13
107379,ajjhayanāya,ajjhayanaya,1,1,0,0,11
107380,pariyajjhayano,pariyajjhayano,1,1,0,0,14
107381,alaṃkammo,alamkammo,1,1,0,0,9
107382,alaṃvacano,alamvacano,1,1,0,0,10
107383,vānato,vanato,13,11,2,0,6
107384,nikkosambī,nikkosambi,1,1,0,0,10
107385,niyyāto,niyyato,5,5,0,0,7
107386,parahiyyo,parahiyyo,3,3,0,0,9
107387,uparigaṅgaṃ,uparigangam,2,2,0,0,11
107388,heṭṭhānadī,hetthanadi,2,2,0,0,10
107389,antosamāpatti,antosamapatti,2,2,0,0,13
107390,rājahaṃso,rajahamso,12,12,0,0,9
107391,māsaddhaṃ,masaddham,1,1,0,0,9
107392,addhāmalakaṃ,addhamalakam,1,1,0,0,12
107393,āmalakaddhaṃ,amalakaddham,1,1,0,0,12
107394,kahāpaṇassa,kahapanassa,30,30,0,0,11
107395,aḍḍhakahāpaṇaṃ,addhakahapanam,3,3,0,0,14
107396,aḍḍhamāsakaṃ,addhamasakam,13,11,2,0,12
107397,aḍḍharattaṃ,addharattam,12,10,2,0,11
107398,pacchārattaṃ,paccharattam,1,1,0,0,12
107399,pubbanhaṃ,pubbanham,1,1,0,0,9
107400,sāyanhaṃ,sayanham,5,5,0,0,8
107401,anhā,anha,1,0,1,0,4
107402,amādiparatappuriso,amadiparatappuriso,1,1,0,0,18
107403,pabhaṅkarā,pabhankara,14,12,2,0,10
107404,parapadebhī,parapadebhi,2,2,0,0,11
107405,samāsasaññā,samasasanna,2,2,0,0,11
107406,sahasākataṃ,sahasakatam,1,1,0,0,11
107407,bhayatūpaṭṭhānaṃ,bhayatupatthanam,2,2,0,0,16
107408,paratoghoso,paratoghoso,16,15,1,0,11
107409,gavaṃpatitthero,gavampatitthero,4,4,0,0,15
107410,manasikāro,manasikaro,467,429,38,0,10
107411,pubbenivāso,pubbenivaso,27,24,3,0,11
107412,sarasijamiccādi,sarasijamiccadi,1,1,0,0,15
107413,alopatappuriso,alopatappuriso,2,2,0,0,14
107414,bahubbīhisamāso,bahubbihisamaso,8,8,0,0,15
107415,dvipado,dvipado,10,9,1,0,7
107416,tipado,tipado,5,4,1,0,6
107417,upamānapubbapado,upamanapubbapado,6,4,2,0,16
107418,saṅkhyobhayapado,sankhyobhayapado,4,2,2,0,16
107419,disantarāḷattho,disantaralattho,3,1,2,0,15
107420,byatihāralakkhaṇo,byatiharalakkhano,4,3,1,0,17
107421,vibhatyatthesu,vibhatyatthesu,2,2,0,0,14
107422,samasyamānapadato,samasyamanapadato,1,1,0,0,17
107423,paṭhamadutiyādivibhatyantānaṃ,pathamadutiyadivibhatyantanam,1,1,0,0,29
107424,padānamatthesu,padanamatthesu,1,1,0,0,14
107425,bahubbīhisañño,bahubbihisanno,1,1,0,0,14
107426,bahubbīhisadisattā,bahubbihisadisatta,1,1,0,0,18
107427,ayampisamāso,ayampisamaso,1,1,0,0,12
107428,anvatthasaññāvasena,anvatthasannavasena,1,1,0,0,19
107429,bahubbīhīti,bahubbihiti,4,2,2,0,11
107430,aññapadatthappadhāno,annapadatthappadhano,2,2,0,0,20
107431,tagguṇasaṃviññāṇātagguṇasaṃviññāṇavasena,taggunasamvinnanataggunasamvinnanavasena,1,1,0,0,40
107432,visesanabhūto,visesanabhuto,2,2,0,0,13
107433,aññapadattha,annapadattha,4,2,2,0,12
107434,tagguṇasaṃviññāṇo,taggunasamvinnano,7,5,2,0,17
107435,lambakaṇṇamānayāti,lambakannamanayati,1,1,0,0,18
107436,atagguṇasaṃviññāṇo,ataggunasamvinnano,5,3,2,0,18
107437,bahudhanamānayāti,bahudhanamanayati,1,1,0,0,17
107438,āgata,agata,14,8,6,0,5
107439,dutiyāvibhatyatthabhūte,dutiyavibhatyatthabhute,2,2,0,0,23
107440,saṅghārāmasaṅkhāte,sangharamasankhate,2,2,0,0,18
107441,tadatthajotanatthameva,tadatthajotanatthameva,1,1,0,0,22
107442,tadanantaraṃ,tadanantaram,423,407,16,0,12
107443,padantaraṃ,padantaram,4,4,0,0,10
107444,kammatthassa,kammatthassa,2,2,0,0,12
107445,abhihitattā,abhihitatta,2,2,0,0,11
107446,abhidheyyaliṅgavacano,abhidheyyalingavacano,1,1,0,0,21
107447,āgatasamaṇā,agatasamana,3,3,0,0,11
107448,āgatasamaṇaṃ,agatasamanam,4,4,0,0,12
107449,paṭipannā,patipanna,212,205,7,0,9
107450,addhikā,addhika,17,14,3,0,7
107451,paṭipannaddhiko,patipannaddhiko,2,2,0,0,15
107452,abhiruḷhā,abhirulha,13,13,0,0,9
107453,abhiruḷhavāṇijā,abhirulhavanija,1,1,0,0,15
107454,jitamāro,jitamaro,4,4,0,0,8
107455,paṭividdhasabbadhammo,patividdhasabbadhammo,3,3,0,0,21
107456,upanītaṃ,upanitam,55,54,1,0,8
107457,samaṇassāti,samanassati,2,1,1,0,11
107458,upanītabhojano,upanitabhojano,2,2,0,0,14
107459,upahaṭo,upahato,1,1,0,0,7
107460,upahaṭabali,upahatabali,1,1,0,0,11
107461,apetaviññāṇo,apetavinnano,7,7,0,0,12
107462,matakāyo,matakayo,2,2,0,0,8
107463,apagatabhayabheravo,apagatabhayabheravo,2,2,0,0,19
107464,chinnā,chinna,85,82,3,0,6
107465,paripuṇṇasaṅkappo,paripunnasankappo,72,72,0,0,17
107466,dvihattho,dvihattho,5,3,2,0,9
107467,parimāṇametesanti,parimanametesanti,2,2,0,0,17
107468,parimāṇa,parimana,15,13,2,0,8
107469,sannidhānato,sannidhanato,4,4,0,0,12
107470,malamassāti,malamassati,1,1,0,0,11
107471,kuṇapaṃ,kunapam,68,63,5,0,7
107472,dummano,dummano,185,180,5,0,7
107473,khantisaṅkhātaṃ,khantisankhatam,2,2,0,0,15
107474,khantibalo,khantibalo,4,4,0,0,10
107475,indanāmo,indanamo,2,2,0,0,8
107476,chandajātā,chandajata,13,11,2,0,10
107477,yathicchitattā,yathicchitatta,2,2,0,0,14
107478,chandajāto,chandajato,57,54,3,0,10
107479,assātipi,assatipi,4,4,0,0,8
107480,jātachando,jatachando,4,4,0,0,10
107481,sañjātapītisomanasso,sanjatapitisomanasso,9,9,0,0,20
107482,pītisomanassasañjāto,pitisomanassasanjato,3,3,0,0,20
107483,jātamāso,jatamaso,2,2,0,0,8
107484,jaṅghāyassā,janghayassa,1,1,0,0,11
107485,bahubbīhivisayoyaṃ,bahubbihivisayoyam,1,1,0,0,18
107486,taddhitasamāsanāmopasaggādīsu,taddhitasamasanamopasaggadisu,1,1,0,0,29
107487,ādimajjhuttarabhūtānaṃ,adimajjhuttarabhutanam,1,1,0,0,22
107488,jinavacanānuparodhena,jinavacananuparodhena,3,3,0,0,21
107489,aparabhūtesu,aparabhutesu,1,1,0,0,12
107490,pākaṭānūpa,pakatanupa,1,1,0,0,10
107491,ghātādo,ghatado,1,1,0,0,7
107492,madhuvādisu,madhuvadisu,1,1,0,0,11
107493,rūpādo,rupado,1,1,0,0,6
107494,tādisūti,tadisuti,5,1,4,0,8
107495,uttarapadantassa,uttarapadantassa,1,1,0,0,16
107496,khamādhano,khamadhano,2,2,0,0,10
107497,saddhādhuro,saddhadhuro,7,7,0,0,11
107498,saddhāpakatiko,saddhapakatiko,3,3,0,0,14
107499,paññāpakatiko,pannapakatiko,5,5,0,0,13
107500,paññāvisuddhiko,pannavisuddhiko,2,2,0,0,15
107501,samaṇibhattiko,samanibhattiko,1,1,0,0,14
107502,kumāribhattiko,kumaribhattiko,1,1,0,0,14
107503,kumāribhatti,kumaribhatti,1,1,0,0,12
107504,bahudāsiko,bahudasiko,1,1,0,0,10
107505,bahukumārikaṃ,bahukumarikam,2,2,0,0,13
107506,gāṇṭhivo,ganthivo,1,1,0,0,8
107507,kvacisamāsantagatā,kvacisamasantagata,1,1,0,0,18
107508,gāṇṭhivadhanvā,ganthivadhanva,1,1,0,0,14
107509,sahassathāmadhanu,sahassathamadhanu,2,2,0,0,17
107510,paccakkhadhammo,paccakkhadhammo,10,7,3,0,15
107511,viditadhammo,viditadhammo,28,23,5,0,12
107512,byālambambudharabindūni,byalambambudharabinduni,1,1,0,0,23
107513,sulabho,sulabho,12,12,0,0,7
107514,sulabhapiṇḍo,sulabhapindo,4,4,0,0,12
107515,rājadhāniyaṃ,rajadhaniyam,6,6,0,0,12
107516,ākiṇṇamanussā,akinnamanussa,18,18,0,0,13
107517,bahutāpaso,bahutapaso,2,2,0,0,10
107518,upacitamaṃsalohitaṃ,upacitamamsalohitam,2,2,0,0,19
107519,bahussāmikaṃ,bahussamikam,1,1,0,0,12
107520,samāsantagatā,samasantagata,1,1,0,0,13
107521,niccatthaṃ,niccattham,1,1,0,0,10
107522,nadīti,naditi,24,20,4,0,6
107523,itthivācakānaṃ,itthivacakanam,1,1,0,0,14
107524,nadisaññassa,nadisannassa,1,1,0,0,12
107525,bahujambukaṃ,bahujambukam,2,2,0,0,12
107526,bahunārikoti,bahunarikoti,1,1,0,0,12
107527,chaṭṭhībahubbīhinā,chatthibahubbihina,1,1,0,0,18
107528,bahubhattuko,bahubhattuko,2,2,0,0,12
107529,ekarattiṃ,ekarattim,60,58,2,0,9
107530,ekarattivāso,ekarattivaso,5,5,0,0,12
107531,samānavāso,samanavaso,8,7,1,0,10
107532,byañjanamassa,byanjanamassa,4,3,1,0,13
107533,ubhabhobyañjanako,ubhabhobyanjanako,1,1,0,0,17
107534,chattapāṇi,chattapani,21,19,2,0,10
107535,daṇḍapāṇi,dandapani,9,8,1,0,9
107536,satthapāṇi,satthapani,4,4,0,0,10
107537,satthahattho,satthahattho,2,2,0,0,12
107538,dānajjhāsayo,danajjhasayo,20,20,0,0,12
107539,dānādhimuttiko,danadhimuttiko,3,3,0,0,14
107540,buddhabhattiko,buddhabhattiko,3,3,0,0,14
107541,saddhammagāravo,saddhammagaravo,3,3,0,0,15
107542,parakkamenādhigatā,parakkamenadhigata,1,1,0,0,18
107543,dhammādhigatabhogā,dhammadhigatabhoga,3,3,0,0,18
107544,oṇīto,onito,4,4,0,0,5
107545,pattato,pattato,49,48,1,0,7
107546,oṇītapattapāṇi,onitapattapani,2,2,0,0,14
107547,pubbaddhaṃ,pubbaddham,10,10,0,0,10
107548,sīhapubbaddhakāyo,sihapubbaddhakayo,13,10,3,0,17
107549,aputtako,aputtako,19,19,0,0,8
107550,ahetuko,ahetuko,300,300,0,0,7
107551,asaṃvāsā,asamvasa,27,20,7,0,8
107552,avuṭṭhiko,avutthiko,5,5,0,0,9
107553,abhikkhuko,abhikkhuko,98,93,5,0,10
107554,uttaroti,uttaroti,14,10,4,0,8
107555,ggahaṇamupalakkhaṇaṃ,ggahanamupalakkhanam,1,1,0,0,20
107556,anāsavā,anasava,285,267,18,0,7
107557,paṭhamāyatthe,pathamayatthe,2,0,2,0,13
107558,sahapubbapado,sahapubbapado,3,2,1,0,13
107559,sahetu,sahetu,26,25,1,0,6
107560,sappītikā,sappitika,64,64,0,0,9
107561,sakileso,sakileso,11,9,2,0,8
107562,saupādāno,saupadano,15,15,0,0,9
107563,samūluddhato,samuluddhato,1,1,0,0,12
107564,upamānopameyyabhāvappasiddhatthaṃ,upamanopameyyabhavappasiddhattham,1,1,0,0,33
107565,kāyabyāmānaṃ,kayabyamanam,2,2,0,0,12
107566,samappamāṇatāya,samappamanataya,3,3,0,0,15
107567,soyaṃnigrodhaparimaṇḍalo,soyamnigrodhaparimandalo,1,1,0,0,24
107568,saṅkhapaṇḍaro,sankhapandaro,3,3,0,0,13
107569,kākasūro,kakasuro,4,4,0,0,8
107570,paramatthadassanatoti,paramatthadassanatoti,2,2,0,0,21
107571,atthabhūto,atthabhuto,8,8,0,0,10
107572,andhabhūto,andhabhuto,20,16,4,0,10
107573,muñjapabbajamiva,munjapabbajamiva,2,2,0,0,16
107574,muñjapabbajabhūtā,munjapabbajabhuta,9,8,1,0,17
107575,tantākulakamiva,tantakulakamiva,3,3,0,0,15
107576,tantākulakajātā,tantakulakajata,14,11,3,0,15
107577,nāgagati,nagagati,3,3,0,0,8
107578,sīhagati,sihagati,3,3,0,0,8
107579,nāgavikkamo,nagavikkamo,3,3,0,0,11
107580,sīhavikkamo,sihavikkamo,4,4,0,0,11
107581,eṇissa,enissa,3,3,0,0,6
107582,jaṅghāti,janghati,4,2,2,0,8
107583,dvattipattā,dvattipatta,9,8,1,0,11
107584,dvīhaṃ,dviham,24,24,0,0,6
107585,tīhaṃ,tiham,19,18,1,0,5
107586,dvīhatīhaṃ,dvihatiham,45,43,2,0,10
107587,chappañcavācā,chappancavaca,4,4,0,0,13
107588,sattaṭṭhamāsā,sattatthamasa,3,3,0,0,13
107589,ekayojanadviyojanāni,ekayojanadviyojanani,3,3,0,0,20
107590,pubbadakkhiṇā,pubbadakkhina,2,2,0,0,13
107591,tulyādhikaraṇapadaparattābhāvā,tulyadhikaranapadaparattabhava,1,1,0,0,30
107592,disantarāḷatthe,disantaralatthe,1,1,0,0,15
107593,aparadakkhiṇā,aparadakkhina,3,3,0,0,13
107594,pacchimuttarā,pacchimuttara,3,3,0,0,13
107595,uttarapadatthappadhānattā,uttarapadatthappadhanatta,4,4,0,0,25
107596,sabbanāmikavidhānampi,sabbanamikavidhanampi,1,1,0,0,21
107597,bhavatiyeva,bhavatiyeva,2,2,0,0,11
107598,dakkhiṇapubbassamiti,dakkhinapubbassamiti,1,1,0,0,20
107599,antassikāro,antassikaro,1,1,0,0,11
107600,paṭhamāvibhatyatthabahubbīhi,pathamavibhatyatthabahubbihi,1,1,0,0,28
107601,itarītarayoga,itaritarayoga,1,1,0,0,13
107602,samāhāratthabhedena,samaharatthabhedena,1,1,0,0,19
107603,itarītarayoge,itaritarayoge,7,6,1,0,13
107604,sāriputtamoggallāna,sariputtamoggallana,2,2,0,0,19
107605,samuccayajotanatthaṃ,samuccayajotanattham,1,1,0,0,20
107606,nānānāmānameva,nananamanameva,1,1,0,0,14
107607,sampiṇḍanaṃ,sampindanam,20,17,3,0,11
107608,anvācaye,anvacaye,2,2,0,0,8
107609,kriyāsāpekkhatāya,kriyasapekkhataya,2,2,0,0,17
107610,yuttatthabhāvato,yuttatthabhavato,1,1,0,0,16
107611,dvandasadisattā,dvandasadisatta,2,2,0,0,15
107612,dvandoti,dvandoti,3,1,2,0,8
107613,ubhayapadatthappadhāno,ubhayapadatthappadhano,2,2,0,0,22
107614,ubhayapadatthappadhānatte,ubhayapadatthappadhanatte,1,1,0,0,25
107615,kathamekatthībhāvo,kathamekatthibhavo,1,1,0,0,18
107616,sadisādiatthepi,sadisadiatthepi,1,1,0,0,15
107617,saddappavattisambhavenadvinnaṃ,saddappavattisambhavenadvinnam,1,1,0,0,30
107618,atthadvayadīpakattā,atthadvayadipakatta,1,1,0,0,19
107619,dvandavisayameva,dvandavisayameva,2,2,0,0,16
107620,tesamatthadvayadīpakattā,tesamatthadvayadipakatta,1,1,0,0,24
107621,anubhavaabhibhavādike,anubhavaabhibhavadike,1,1,0,0,21
107622,ādiupasaggasahitova,adiupasaggasahitova,1,1,0,0,19
107623,disaddantarasahitānameva,disaddantarasahitanameva,1,1,0,0,24
107624,atthadvayadīpanaṃ,atthadvayadipanam,1,1,0,0,17
107625,kevalānanti,kevalananti,1,1,0,0,11
107626,yathāvuttasamuccayadīpakattā,yathavuttasamuccayadipakatta,1,1,0,0,28
107627,dvandepekatthitāti,dvandepekatthitati,1,1,0,0,18
107628,samāsasaññāvibhattilopādi,samasasannavibhattilopadi,1,1,0,0,25
107629,accitataraṃ,accitataram,1,1,0,0,11
107630,itarītarayogassa,itaritarayogassa,2,2,0,0,16
107631,avayavappadhānattā,avayavappadhanatta,3,3,0,0,18
107632,khattiyabrāhmaṇā,khattiyabrahmana,5,5,0,0,16
107633,ādipubbapa,adipubbapa,1,1,0,0,10
107634,tudaṃpati,tudampati,1,1,0,0,9
107635,jayampatikā,jayampatika,28,28,0,0,11
107636,appasaraṃ,appasaram,2,2,0,0,9
107637,nigamajanapadā,nigamajanapada,2,2,0,0,14
107638,garuḷā,garula,26,25,1,0,6
107639,surāsuragaruḷamanujabhujagagandhabbā,surasuragarulamanujabhujagagandhabba,1,1,0,0,36
107640,ivaṇṇu,ivannu,16,15,1,0,6
107641,vaṇṇantānaṃ,vannantanam,4,4,0,0,11
107642,aggidhūmā,aggidhuma,2,2,0,0,9
107643,gatibuddhibhujapaṭhaharakarasayā,gatibuddhibhujapathaharakarasaya,2,2,0,0,32
107644,dhātuliṅgāni,dhatulingani,4,4,0,0,12
107645,sarādi,saradi,2,2,0,0,6
107646,atthadhammā,atthadhamma,3,3,0,0,11
107647,atthasaddā,atthasadda,2,2,0,0,10
107648,sotañcā,sotanca,1,1,0,0,7
107649,dvandasamāsaṃ,dvandasamasam,4,4,0,0,13
107650,ekattañcā,ekattanca,1,1,0,0,9
107651,samāhāradvandasamāsepi,samaharadvandasamasepi,1,1,0,0,22
107652,senaṅgatthānaṃ,senangatthanam,1,1,0,0,14
107653,khuddajantukavividha,khuddajantukavividha,1,1,0,0,20
107654,viruddhavisabhāgatthaiccevamādīnañca,viruddhavisabhagatthaiccevamadinanca,1,1,0,0,36
107655,yoggāni,yoggani,9,9,0,0,7
107656,pāṇitūriya,panituriya,1,1,0,0,10
107657,yoggasenā,yoggasena,1,1,0,0,9
107658,tāsamaṅgāni,tasamangani,1,1,0,0,11
107659,pāṇitūriyayoggasenaṅgāni,panituriyayoggasenangani,2,1,1,0,24
107660,dvandato,dvandato,7,7,0,0,8
107661,parattā,paratta,5,5,0,0,7
107662,paccekamabhisambajjhate,paccekamabhisambajjhate,2,2,0,0,23
107663,jantukā,jantuka,1,1,0,0,7
107664,khuddajantukā,khuddajantuka,2,1,1,0,13
107665,niccavirodhino,niccavirodhino,1,1,0,0,14
107666,kiccatoti,kiccatoti,20,1,19,0,9
107667,pubbanipātassa,pubbanipatassa,1,1,0,0,14
107668,pāṇitūriyayoggasenaṅgakhuddajantukavividhaviruddhavisabhāgatthā,panituriyayoggasenangakhuddajantukavividhaviruddhavisabhagattha,1,1,0,0,63
107669,tadādayo,tadadayo,1,1,0,0,8
107670,aññoññaliṅgavisesita,annonnalingavisesita,1,1,0,0,20
107671,saṅkhyāparimāṇattha,sankhyaparimanattha,1,1,0,0,19
107672,pacanacaṇḍālattha,pacanacandalattha,1,1,0,0,17
107673,disatthādīnañca,disatthadinanca,1,1,0,0,15
107674,pāṇyaṅgatthabhāvato,panyangatthabhavato,1,1,0,0,19
107675,cakkhusotasaddānaṃ,cakkhusotasaddanam,1,1,0,0,18
107676,nāmabyapadese,namabyapadese,9,9,0,0,13
107677,cakkhusota,cakkhusota,6,5,1,0,10
107678,cakkhusotena,cakkhusotena,1,1,0,0,12
107679,kaṇṇanāsaṃ,kannanasam,11,11,0,0,10
107680,pāṇipādaṃ,panipadam,2,2,0,0,9
107681,maṃsalohitānītiādīnaṃ,mamsalohitanitiadinam,1,1,0,0,21
107682,itarītarayogena,itaritarayogena,2,2,0,0,15
107683,tāḷañca,talanca,2,2,0,0,7
107684,hatthatāḷaṃ,hatthatalam,5,5,0,0,11
107685,ḍaṃṇḍimā,damndima,1,1,0,0,8
107686,saṅkhapaṇavaḍiṇḍimaṃ,sankhapanavadindimam,2,2,0,0,20
107687,paṇavādayo,panavadayo,2,2,0,0,10
107688,pattikā,pattika,40,39,1,0,7
107689,saravāraṇaphalakaṃ,saravaranaphalakam,3,3,0,0,18
107690,kalāpoti,kalapoti,2,1,1,0,8
107691,tūṇīraṃ,tuniram,4,4,0,0,7
107692,kunthā,kuntha,3,1,2,0,6
107693,sukhumakipillikā,sukhumakipillika,2,2,0,0,16
107694,kīṭā,kita,11,10,1,0,4
107695,kapālapiṭṭhikapāṇā,kapalapitthikapana,2,2,0,0,18
107696,ahī,ahi,8,7,1,0,3
107697,nakulā,nakula,18,18,0,0,6
107698,sappamaṇḍūkaṃ,sappamandukam,3,3,0,0,13
107699,garuḷasappaṃ,garulasappam,2,2,0,0,12
107700,satisampajaññaṃ,satisampajannam,74,60,14,0,15
107701,lobhamohaṃ,lobhamoham,2,2,0,0,10
107702,dosamohaṃ,dosamoham,2,2,0,0,9
107703,ahirikānottappaṃ,ahirikanottappam,2,2,0,0,16
107704,thinamiddhaṃ,thinamiddham,321,301,20,0,12
107705,uddhaccakukkuccamiccādi,uddhaccakukkuccamiccadi,1,1,0,0,23
107706,niddesadassanato,niddesadassanato,3,3,0,0,16
107707,paṭisandhippavattiyantiādi,patisandhippavattiyantiadi,1,1,0,0,26
107708,aññoññaliṅgavisesitānaṃ,annonnalingavisesitanam,1,0,1,0,23
107709,kvacādī,kvacadi,1,1,0,0,7
107710,sākhāpalāsamiccādi,sakhapalasamiccadi,1,1,0,0,18
107711,saṅkhyāparimāṇatthānaṃ,sankhyaparimanatthanam,1,0,1,0,22
107712,ekakañca,ekakanca,2,2,0,0,8
107713,dukañca,dukanca,31,31,0,0,7
107714,ekakadukaṃ,ekakadukam,4,4,0,0,10
107715,saṅkhyādvande,sankhyadvande,1,1,0,0,13
107716,appasaṅkhyā,appasankhya,1,1,0,0,11
107717,pacanacaṇḍālatthānaṃ,pacanacandalatthanam,1,0,1,0,20
107718,orabbhikasūkarikaṃ,orabbhikasukarikam,3,3,0,0,18
107719,sākuṇikamāgavikaṃ,sakunikamagavikam,2,2,0,0,17
107720,pukkusachavaḍāhakaṃ,pukkusachavadahakam,4,4,0,0,19
107721,venā,vena,20,19,1,0,4
107722,tacchakā,tacchaka,20,18,2,0,8
107723,rathakārā,rathakara,23,19,4,0,9
107724,cammakārā,cammakara,14,14,0,0,9
107725,disatthānaṃ,disatthanam,1,0,1,0,11
107726,vibhattilopañca,vibhattilopanca,2,2,0,0,15
107727,pubbāpara,pubbapara,4,3,1,0,9
107728,pubbāparena,pubbaparena,20,16,4,0,11
107729,pubbāparassa,pubbaparassa,5,5,0,0,12
107730,puratthimapacchimaṃ,puratthimapacchimam,2,2,0,0,19
107731,janapadādīnamekattaṃ,janapadadinamekattam,1,1,0,0,20
107732,kattābhāve,kattabhave,1,1,0,0,10
107733,assatthā,assattha,10,10,0,0,8
107734,kapitthā,kapittha,11,10,1,0,8
107735,dvandasamāsādimhi,dvandasamasadimhi,1,1,0,0,17
107736,vikappenekattaṃ,vikappenekattam,1,1,0,0,15
107737,assatthakapitthaṃ,assatthakapittham,1,1,0,0,17
107738,assatthakapitthā,assatthakapittha,1,1,0,0,16
107739,ambapanasaṃ,ambapanasam,2,2,0,0,11
107740,ambapanasā,ambapanasa,2,2,0,0,10
107741,dhavassakaṇṇakaṃ,dhavassakannakam,1,1,0,0,16
107742,dhavassakaṇṇakā,dhavassakannaka,1,1,0,0,15
107743,tiṇānaṃ,tinanam,26,24,2,0,7
107744,usīrāni,usirani,2,2,0,0,7
107745,bīraṇāni,biranani,3,3,0,0,8
107746,usīrabīraṇāni,usirabiranani,2,2,0,0,13
107747,kāsakusaṃ,kasakusam,4,4,0,0,9
107748,hatthigavassavaḷavaṃ,hatthigavassavalavam,6,6,0,0,20
107749,hatthigavassavaḷavā,hatthigavassavalava,3,3,0,0,19
107750,gomahiṃsaṃ,gomahimsam,6,6,0,0,10
107751,gomahiṃsā,gomahimsa,3,3,0,0,9
107752,sīhabyagghataracchaṃ,sihabyagghataraccham,2,2,0,0,20
107753,sīhabyagghataracchā,sihabyagghataraccha,2,2,0,0,19
107754,jātarūparajatāni,jataruparajatani,2,2,0,0,16
107755,maṇimuttasaṅkhaveḷuriyaṃ,manimuttasankhaveluriyam,1,1,0,0,24
107756,maṇimuttasaṅkhaveḷuriyā,manimuttasankhaveluriya,1,1,0,0,23
107757,sālī,sali,15,12,3,0,4
107758,janapadānaṃ,janapadanam,11,10,1,0,11
107759,mallā,malla,70,69,1,0,5
107760,aṅgamagadhaṃ,angamagadham,2,2,0,0,12
107761,aṅgamagadhā,angamagadha,19,19,0,0,11
107762,aññoññappaṭipakkhadhammānaṃ,annonnappatipakkhadhammanam,1,1,0,0,27
107763,sakuṇatthānañca,sakunatthananca,1,1,0,0,15
107764,sāvajjānavajjā,savajjanavajja,29,29,0,0,14
107765,hīnappaṇītā,hinappanita,5,5,0,0,11
107766,sukhadukkhāni,sukhadukkhani,29,29,0,0,13
107767,paṭighānunayā,patighanunaya,1,1,0,0,13
107768,chāyātapaṃ,chayatapam,2,2,0,0,10
107769,chāyātapā,chayatapa,1,1,0,0,9
107770,ālokandhakāraṃ,alokandhakaram,2,2,0,0,14
107771,ālokandhakārā,alokandhakara,2,2,0,0,13
107772,rattindivā,rattindiva,33,31,2,0,10
107773,kārikārānamattaṃ,karikaranamattam,1,1,0,0,16
107774,haṃsabakaṃ,hamsabakam,2,2,0,0,10
107775,haṃsabakā,hamsabaka,2,2,0,0,9
107776,mayūrakoñcaṃ,mayurakoncam,2,2,0,0,12
107777,mayūrakoñcā,mayurakonca,2,2,0,0,11
107778,sukasālikaṃ,sukasalikam,2,2,0,0,11
107779,sukasālikā,sukasalika,2,2,0,0,10
107780,accitappasaraṃ,accitappasaram,1,1,0,0,14
107781,ivaṇṇuvaṇṇakaṃ,ivannuvannakam,1,1,0,0,14
107782,sarādyakārantaṃ,saradyakarantam,1,1,0,0,15
107783,bahūsvaniyamo,bahusvaniyamo,1,1,0,0,13
107784,pubbuttarubhayaññatthappadhānattā,pubbuttarubhayannatthappadhanatta,1,1,0,0,33
107785,kammadhārayehi,kammadharayehi,1,1,0,0,14
107786,dudhā,dudha,8,8,0,0,5
107787,caturaṭṭhadhāti,caturatthadhati,1,1,0,0,15
107788,vibhatyantā,vibhatyanta,2,2,0,0,11
107789,apaccādiatthavisese,apaccadiatthavisese,1,1,0,0,19
107790,taddhituppattīti,taddhituppattiti,1,1,0,0,16
107791,taddhitavidhānamārabhīyate,taddhitavidhanamarabhiyate,1,1,0,0,26
107792,tividhaliṅgato,tividhalingato,1,1,0,0,14
107793,dipaccayānametaṃ,dipaccayanametam,1,1,0,0,16
107794,upakārā,upakara,28,27,1,0,7
107795,taddhitāti,taddhitati,2,2,0,0,10
107796,anvatthabhūtaparasamaññāvasenāpi,anvatthabhutaparasamannavasenapi,1,1,0,0,32
107797,dippaccayāva,dippaccayava,1,1,0,0,12
107798,chaṭṭhiyantato,chatthiyantato,8,8,0,0,14
107799,parāva,parava,1,1,0,0,6
107800,apaccatthasambandhiliṅgato,apaccatthasambandhilingato,1,1,0,0,26
107801,chaṭṭhiyantāyeva,chatthiyantayeva,1,1,0,0,16
107802,patīyanti,patiyanti,1,1,0,0,9
107803,taddhitappaccayānaṃ,taddhitappaccayanam,1,1,0,0,19
107804,nubandhānaṃ,nubandhanam,1,1,0,0,11
107805,vāsaṃyogantassa,vasamyogantassa,2,1,1,0,15
107806,saṃyoganto,samyoganto,2,2,0,0,10
107807,tadañño,tadanno,37,37,0,0,7
107808,asaṃyoganto,asamyoganto,1,0,1,0,11
107809,sarānamādisarassa,saranamadisarassa,1,1,0,0,17
107810,taddhitappaccaye,taddhitappaccaye,1,1,0,0,16
107811,vāsiṭṭhādīsu,vasitthadisu,1,1,0,0,12
107812,niccāyaṃ,niccayam,1,1,0,0,8
107813,aniccoḷumpikādisu,aniccolumpikadisu,1,1,0,0,17
107814,vavatthitavibhāsato,vavatthitavibhasato,5,5,0,0,19
107815,saddaggahaṇamavadhāraṇatthaṃ,saddaggahanamavadharanattham,1,1,0,0,28
107816,vuddhiyā,vuddhiya,24,23,1,0,8
107817,aniyamappasaṅge,aniyamappasange,1,1,0,0,15
107818,niyamatthaṃ,niyamattham,6,6,0,0,11
107819,ṇṇu,nnu,1,0,1,0,3
107820,vaṇṇānameva,vannanameva,1,1,0,0,11
107821,saddaggahaṇamavuddhisampiṇḍanatthaṃ,saddaggahanamavuddhisampindanattham,1,1,0,0,35
107822,avadhāraṇatthaṃ,avadharanattham,10,10,0,0,15
107823,yuvaṇṇā,yuvanna,3,2,1,0,7
107824,ṭhānaniyamavacanaṃ,thananiyamavacanam,1,1,0,0,18
107825,āyonaṃ,ayonam,2,2,0,0,6
107826,vuddhibhāvappasaṅganivattanatthaṃ,vuddhibhavappasanganivattanattham,1,1,0,0,33
107827,katavuddhīnaṃ,katavuddhinam,1,1,0,0,13
107828,sabhāvavuddhīnaṃ,sabhavavuddhinam,1,1,0,0,16
107829,saralopomādesappaccayādimhi,saralopomadesappaccayadimhi,1,1,0,0,27
107830,taddhitasamāsa,taddhitasamasa,2,2,0,0,14
107831,vāsiṭṭhā,vasittha,2,2,0,0,8
107832,nattupanattādayopi,nattupanattadayopi,1,1,0,0,18
107833,tadupacārato,tadupacarato,3,3,0,0,12
107834,vāsiṭṭhāyeva,vasitthayeva,1,1,0,0,12
107835,gottataddhite,gottataddhite,1,1,0,0,13
107836,paṭhamappakatitoyeva,pathamappakatitoyeva,1,1,0,0,20
107837,ṇappaccayantattā,nappaccayantatta,1,1,0,0,16
107838,ntūhī,ntuhi,1,1,0,0,5
107839,saralopādiṃ,saralopadim,1,1,0,0,11
107840,itthippaccayantattā,itthippaccayantatta,1,1,0,0,19
107841,vāsiṭṭhiyo,vasitthiyo,1,1,0,0,10
107842,vāsiṭṭhāni,vasitthani,3,3,0,0,10
107843,taddhitantassa,taddhitantassa,1,1,0,0,14
107844,vesāmittassa,vesamittassa,2,2,0,0,12
107845,ayuvaṇṇattābhāvā,ayuvannattabhava,1,1,0,0,16
107846,baladevo,baladevo,12,12,0,0,8
107847,vākyavuttiyo,vakyavuttiyo,1,1,0,0,12
107848,saṃsaṭṭha,samsattha,5,3,2,0,9
107849,ggahaṇāva,ggahanava,1,1,0,0,9
107850,iccate,iccate,1,1,0,0,6
107851,vuddhattho,vuddhattho,2,2,0,0,10
107852,vuddhiabhāvova,vuddhiabhavova,3,3,0,0,14
107853,kaccassa,kaccassa,1,1,0,0,8
107854,moggallassa,moggallassa,1,1,0,0,11
107855,kuñjāyano,kunjayano,2,2,0,0,9
107856,kuñjāno,kunjano,2,2,0,0,7
107857,ākatigaṇo,akatigano,8,8,0,0,9
107858,vinatārohiṇī,vinatarohini,1,0,1,0,12
107859,sarantassā,sarantassa,4,4,0,0,10
107860,rohiṇiyā,rohiniya,4,4,0,0,8
107861,nadiyāputto,nadiyaputto,1,1,0,0,11
107862,anteyyo,anteyyo,3,3,0,0,7
107863,āheyyo,aheyyo,3,3,0,0,6
107864,bālāya,balaya,7,7,0,0,6
107865,dakkhassāpaccaṃ,dakkhassapaccam,1,1,0,0,15
107866,dakkhī,dakkhi,1,1,0,0,6
107867,dakkhayo,dakkhayo,1,1,0,0,8
107868,doṇassa,donassa,6,6,0,0,7
107869,kaṇḍi,kandi,3,3,0,0,5
107870,jinadattassa,jinadattassa,2,2,0,0,12
107871,apaccatthe,apaccatthe,7,7,0,0,10
107872,vimātuyā,vimatuya,1,1,0,0,8
107873,vemātiko,vematiko,1,1,0,0,8
107874,aditiyā,aditiya,6,5,1,0,7
107875,taddhitabhūte,taddhitabhute,1,1,0,0,13
107876,ivaṇṇopīti,ivannopiti,1,1,0,0,10
107877,kārasaṃyogassa,karasamyogassa,3,3,0,0,14
107878,ditiyā,ditiya,3,3,0,0,6
107879,kvacādimajjhuttaresū,kvacadimajjhuttaresu,1,1,0,0,20
107880,avihitalakkhaṇesu,avihitalakkhanesu,2,2,0,0,17
107881,āgama,agama,4,2,2,0,5
107882,viparītaādesā,viparitaadesa,1,1,0,0,13
107883,saṃyogantattepi,samyogantattepi,1,1,0,0,15
107884,kuruno,kuruno,2,2,0,0,6
107885,upagussa,upagussa,2,2,0,0,8
107886,ṇavopagvādīhi,navopagvadihi,1,0,1,0,13
107887,pakāravācakattā,pakaravacakatta,1,1,0,0,15
107888,kārantatoyevāyaṃ,karantatoyevayam,1,1,0,0,16
107889,opagavaṃ,opagavam,2,2,0,0,8
107890,bhagguno,bhagguno,2,2,0,0,8
107891,paṇḍuno,panduno,3,3,0,0,7
107892,upavindussa,upavindussa,2,2,0,0,11
107893,opavindavo,opavindavo,2,2,0,0,10
107894,abhisāriṇiyā,abhisariniya,1,1,0,0,12
107895,puttaṭṭhāniyattāti,puttatthaniyattati,1,1,0,0,18
107896,apaccataddhitaṃ,apaccataddhitam,2,2,0,0,15
107897,saṃsaṭṭhādīsvatthesu,samsatthadisvatthesu,1,1,0,0,20
107898,telikī,teliki,1,1,0,0,6
107899,egāḷikaṃ,egalikam,1,1,0,0,8
107900,loṇikaṃ,lonikam,20,16,4,0,7
107901,vuddhiabhāvapakkhe,vuddhiabhavapakkhe,1,1,0,0,18
107902,kulliko,kulliko,2,2,0,0,7
107903,aññatthesupi,annatthesupi,3,3,0,0,12
107904,aveccādhīte,aveccadhite,2,2,0,0,11
107905,tenakatādisannidhānaniyogasippabhaṇḍajīvikatthesu,tenakatadisannidhananiyogasippabhandajivikatthesu,1,0,1,0,49
107906,tamadhīteti,tamadhiteti,1,1,0,0,11
107907,katādīsvatthesu,katadisvatthesu,1,1,0,0,15
107908,sannidhāno,sannidhano,2,2,0,0,10
107909,dutiyādivibhatyantehi,dutiyadivibhatyantehi,1,1,0,0,21
107910,ppaccayādimhi,ppaccayadimhi,2,2,0,0,13
107911,iccebhesaṃ,iccebhesam,1,1,0,0,10
107912,ādisarānaṃ,adisaranam,2,2,0,0,10
107913,ekāravuddhāgamo,ekaravuddhagamo,1,1,0,0,15
107914,namādesabhūtato,namadesabhutato,1,1,0,0,15
107915,yave,yave,5,3,2,0,4
107916,eovuddhiyo,eovuddhiyo,2,2,0,0,10
107917,nyāyamadhīteti,nyayamadhiteti,1,1,0,0,14
107918,takkiko,takkiko,5,5,0,0,7
107919,vediko,vediko,4,4,0,0,6
107920,nemittiko,nemittiko,13,12,1,0,9
107921,sasare,sasare,1,1,0,0,6
107922,vavatthita,vavatthita,5,5,0,0,10
107923,therehi,therehi,156,151,5,0,7
107924,saṅgīti,sangiti,42,38,4,0,7
107925,therikā,therika,5,3,2,0,7
107926,pañcasatikā,pancasatika,3,3,0,0,11
107927,sattasatikā,sattasatika,3,3,0,0,11
107928,ṇavaṇikā,navanika,2,2,0,0,8
107929,anuvattita,anuvattita,3,3,0,0,10
107930,sannidhānatthe,sannidhanatthe,1,0,1,0,14
107931,sārīrikaṃ,saririkam,10,10,0,0,9
107932,navakammiko,navakammiko,19,19,0,0,11
107933,vanakammiko,vanakammiko,9,8,1,0,11
107934,ādikammiko,adikammiko,47,39,8,0,10
107935,odariko,odariko,5,5,0,0,7
107936,cetasikā,cetasika,184,175,9,0,8
107937,sippatthe,sippatthe,1,0,1,0,9
107938,bhaṇḍatthe,bhandatthe,2,1,1,0,10
107939,pūviko,puviko,2,2,0,0,6
107940,paṇṇiko,panniko,4,4,0,0,7
107941,tambūliko,tambuliko,1,1,0,0,9
107942,loṇiko,loniko,2,2,0,0,6
107943,jīvikatthe,jivikatthe,1,0,1,0,10
107944,urabbhamassa,urabbhamassa,1,1,0,0,12
107945,jīvikāti,jivikati,6,3,3,0,8
107946,katādī,katadi,1,1,0,0,6
107947,baddhaṃ,baddham,100,89,11,0,7
107948,evamādiatthe,evamadiatthe,1,1,0,0,12
107949,bāḷisiko,balisiko,16,15,1,0,8
107950,saṅghikā,sanghika,40,37,3,0,8
107951,parimāṇanti,parimananti,11,11,0,0,11
107952,khārikaṃ,kharikam,20,17,3,0,8
107953,doṇikaṃ,donikam,1,1,0,0,7
107954,aṭṭhamāsiko,atthamasiko,1,1,0,0,11
107955,kahāpaṇiko,kahapaniko,2,2,0,0,10
107956,āsītikā,asitika,2,2,0,0,7
107957,nāvutikā,navutika,2,2,0,0,8
107958,sandiṭṭhamarahatīti,sanditthamarahatiti,1,1,0,0,19
107959,sīlatthe,silatthe,1,0,1,0,8
107960,paṃsukūladhāraṇaṃ,pamsukuladharanam,4,4,0,0,17
107961,tecīvariko,tecivariko,34,31,3,0,10
107962,bhojanasīlo,bhojanasilo,1,1,0,0,11
107963,ekāsaniko,ekasaniko,10,8,2,0,9
107964,jātatthe,jatatthe,2,1,1,0,8
107965,sāmuddiko,samuddiko,2,2,0,0,9
107966,vassesu,vassesu,41,41,0,0,7
107967,vassiko,vassiko,25,21,4,0,7
107968,vassikaṃ,vassikam,28,22,6,0,8
107969,hemantiko,hemantiko,19,14,5,0,9
107970,vāsantiko,vasantiko,1,1,0,0,9
107971,cātuddasiko,catuddasiko,24,21,3,0,11
107972,māgadhikaṃ,magadhikam,4,4,0,0,10
107973,kāpilavatthiko,kapilavatthiko,1,1,0,0,14
107974,saṃvattatītipi,samvattatitipi,5,5,0,0,14
107975,mātikaṃ,matikam,195,175,20,0,7
107976,sambhūtatthe,sambhutatthe,1,0,1,0,12
107977,upadhitassa,upadhitassa,1,1,0,0,11
107978,asaṅkhāroyeva,asankharoyeva,1,1,0,0,13
107979,asaṅkhārikaṃ,asankharikam,43,34,9,0,12
107980,sasaṅkhārikaṃ,sasankharikam,33,25,8,0,13
107981,opasaggikaṃ,opasaggikam,1,1,0,0,11
107982,catumahārāje,catumaharaje,1,1,0,0,12
107983,cātumahārājikā,catumaharajika,74,64,10,0,14
107984,tenarattaṃ,tenarattam,1,0,1,0,10
107985,rāgatthavācakā,ragatthavacaka,1,1,0,0,14
107986,kusumbhena,kusumbhena,2,2,0,0,10
107987,nīlena,nilena,10,10,0,0,6
107988,mahiṃsassa,mahimsassa,4,4,0,0,10
107989,māhiṃsaṃ,mahimsam,2,2,0,0,8
107990,cammādikaṃ,cammadikam,1,1,0,0,10
107991,yūnamāgamo,yunamagamo,1,1,0,0,10
107992,isūsabhaujādinaṃ,isusabhaujadinam,1,1,0,0,16
107993,cāttānantare,cattanantare,1,1,0,0,12
107994,avidūrabhavo,avidurabhavo,1,1,0,0,12
107995,tamaveccādhīte,tamaveccadhite,1,1,0,0,14
107996,iccevamādīsvatthesu,iccevamadisvatthesu,2,2,0,0,19
107997,sārasā,sarasa,2,2,0,0,6
107998,sārasaṃ,sarasam,2,2,0,0,7
107999,saṃvaḍḍhitattā,samvaddhitatta,3,3,0,0,14
108000,mettī,metti,9,9,0,0,5
108001,porī,pori,81,53,28,0,4
108002,pāvuse,pavuse,13,13,0,0,6
108003,pāvusaṃ,pavusam,5,4,1,0,7
108004,sāradaṃ,saradam,9,8,1,0,7
108005,vimho,vimho,1,1,0,0,5
108006,mathurāyaṃ,mathurayam,2,2,0,0,10
108007,māthuraṃ,mathuram,1,1,0,0,8
108008,taddhitatopi,taddhitatopi,1,1,0,0,12
108009,sasara,sasara,1,1,0,0,6
108010,māthurako,mathurako,2,2,0,0,9
108011,rājagahā,rajagaha,31,30,1,0,8
108012,rājagaho,rajagaho,2,2,0,0,8
108013,rājagahako,rajagahako,35,35,0,0,10
108014,sāgalako,sagalako,1,1,0,0,8
108015,pāṭaliputto,pataliputto,1,1,0,0,11
108016,pāṭaliputtako,pataliputtako,8,8,0,0,13
108017,jātotiādiatthe,jatotiadiatthe,1,1,0,0,14
108018,vesālo,vesalo,1,1,0,0,6
108019,vesālako,vesalako,1,1,0,0,8
108020,kusināre,kusinare,1,1,0,0,8
108021,kosināro,kosinaro,1,1,0,0,8
108022,sāketo,saketo,3,3,0,0,6
108023,sāketako,saketako,2,2,0,0,8
108024,kosambako,kosambako,4,4,0,0,9
108025,indapatto,indapatto,1,1,0,0,9
108026,indapattako,indapattako,2,2,0,0,11
108027,kapillo,kapillo,1,1,0,0,7
108028,kapillako,kapillako,1,1,0,0,9
108029,bhārukaccho,bharukaccho,1,1,0,0,11
108030,bhārukacchako,bharukacchako,4,4,0,0,13
108031,nāgaro,nagaro,2,2,0,0,6
108032,nāgarako,nagarako,2,2,0,0,8
108033,janapadanāmesu,janapadanamesu,1,1,0,0,14
108034,aṅgako,angako,10,10,0,0,6
108035,kosalako,kosalako,15,15,0,0,8
108036,kambojako,kambojako,2,2,0,0,9
108037,gandhārako,gandharako,4,4,0,0,10
108038,sovīro,soviro,1,1,0,0,6
108039,sovīrako,sovirako,2,2,0,0,8
108040,sindhavako,sindhavako,2,2,0,0,10
108041,suraṭṭhe,suratthe,1,1,0,0,8
108042,suraṭṭhassa,suratthassa,2,2,0,0,11
108043,soraṭṭho,sorattho,11,11,0,0,8
108044,soraṭṭhako,soratthako,1,1,0,0,10
108045,mahāraṭṭho,maharattho,4,4,0,0,10
108046,mahāraṭṭhako,maharatthako,1,1,0,0,12
108047,nakkhattayoge,nakkhattayoge,2,1,1,0,13
108048,puṇṇacandayuttāya,punnacandayuttaya,2,2,0,0,17
108049,magasirena,magasirena,1,1,0,0,10
108050,candayuttena,candayuttena,3,3,0,0,12
108051,maghāya,maghaya,3,3,0,0,7
108052,phagguniyā,phagguniya,1,1,0,0,10
108053,jeṭṭhāya,jetthaya,3,3,0,0,8
108054,uttarāsāḷhāya,uttarasalhaya,1,1,0,0,13
108055,āsāḷhī,asalhi,1,1,0,0,6
108056,savaṇena,savanena,5,5,0,0,8
108057,sāvaṇī,savani,1,1,0,0,6
108058,bhaddena,bhaddena,2,2,0,0,8
108059,assayujena,assayujena,1,1,0,0,10
108060,vatthuvijjo,vatthuvijjo,2,2,0,0,11
108061,āyaso,ayaso,1,1,0,0,5
108062,parimāṇamassāti,parimanamassati,16,16,0,0,15
108063,arahatītiādīsu,arahatitiadisu,1,1,0,0,14
108064,sāgaleyyako,sagaleyyako,1,1,0,0,11
108065,mithileyyako,mithileyyako,3,3,0,0,12
108066,seleyyakaṃ,seleyyakam,5,2,3,0,10
108067,koleyyako,koleyyako,2,2,0,0,9
108068,pabbateyyā,pabbateyya,30,27,3,0,10
108069,pabbateyyaṃ,pabbateyyam,2,2,0,0,11
108070,pathassa,pathassa,11,10,1,0,8
108071,sapatissa,sapatissa,1,1,0,0,9
108072,matteyyaṃ,matteyyam,1,1,0,0,9
108073,dakkhiṇamarahatīti,dakkhinamarahatiti,1,1,0,0,18
108074,antimā,antima,11,9,2,0,6
108075,paccantimo,paccantimo,4,3,1,0,10
108076,ganthimo,ganthimo,1,1,0,0,8
108077,manussajātiyaṃ,manussajatiyam,6,6,0,0,14
108078,samānajātiyo,samanajatiyo,2,2,0,0,12
108079,bhavotiādīsvapi,bhavotiadisvapi,1,1,0,0,15
108080,vuttiko,vuttiko,3,3,0,0,7
108081,hānabhāgo,hanabhago,6,6,0,0,9
108082,ṭhitibhāgiyo,thitibhagiyo,23,18,5,0,12
108083,bodhipakkhiyā,bodhipakkhiya,64,57,7,0,13
108084,pañcavagge,pancavagge,4,4,0,0,10
108085,pañcavaggiyā,pancavaggiya,68,66,2,0,12
108086,yaṇya,yanya,1,0,1,0,5
108087,sakiyo,sakiyo,2,2,0,0,6
108088,sādhuhitabhavajātā,sadhuhitabhavajata,1,0,1,0,18
108089,diatthesu,diatthesu,1,1,0,0,9
108090,sabbhaṃ,sabbham,1,1,0,0,7
108091,talanā,talana,2,2,0,0,6
108092,medhāya,medhaya,22,22,0,0,7
108093,dibyā,dibya,9,8,1,0,5
108094,brāhmaññā,brahmanna,1,1,0,0,9
108095,āruppā,aruppa,115,104,11,0,6
108096,kaṇaṇā,kanana,1,0,1,0,6
108097,kaṇaṇa,kanana,1,0,1,0,6
108098,porisako,porisako,1,1,0,0,8
108099,vuddhānaṃ,vuddhanam,25,25,0,0,9
108100,vuddhako,vuddhako,1,1,0,0,8
108101,oṭṭhako,otthako,1,1,0,0,7
108102,orabbhako,orabbhako,1,1,0,0,9
108103,rājako,rajako,11,11,0,0,6
108104,gāmajanabandhusahāya,gamajanabandhusahaya,1,0,1,0,20
108105,niccamitthiliṅgatā,niccamitthilingata,2,2,0,0,18
108106,madaniyo,madaniyo,2,2,0,0,8
108107,madaniyā,madaniya,1,1,0,0,8
108108,pasādaniyaṃ,pasadaniyam,4,3,1,0,11
108109,diatthepi,diatthepi,1,1,0,0,9
108110,upādāniyā,upadaniya,92,85,7,0,9
108111,upamāvāciliṅgato,upamavacilingato,1,1,0,0,16
108112,tannissitaṃ,tannissitam,37,29,8,0,11
108113,tadassaṭhānaṃ,tadassathanam,1,1,0,0,13
108114,duṭṭhullā,dutthulla,71,59,12,0,9
108115,paṭhamāvibhatyantato,pathamavibhatyantato,1,1,0,0,20
108116,abhijjhālū,abhijjhalu,13,10,3,0,10
108117,abhijjhālavo,abhijjhalavo,1,1,0,0,12
108118,abhijjhāluko,abhijjhaluko,2,2,0,0,12
108119,abhijjhālukā,abhijjhaluka,1,1,0,0,12
108120,abhijjhālukaṃ,abhijjhalukam,1,1,0,0,13
108121,sītāluko,sitaluko,1,1,0,0,8
108122,dayāluko,dayaluko,3,3,0,0,8
108123,hīnova,hinova,2,2,0,0,6
108124,oramattakaṃ,oramattakam,23,18,5,0,11
108125,sīlamattakaṃ,silamattakam,24,18,6,0,12
108126,paṭibhāgakucchitasaññānukampādiatthesu,patibhagakucchitasannanukampadiatthesu,1,1,0,0,38
108127,hatthikā,hatthika,14,14,0,0,8
108128,assakā,assaka,4,4,0,0,6
108129,brāhmaṇako,brahmanako,2,2,0,0,10
108130,paṇḍitako,panditako,2,2,0,0,9
108131,veyyākaraṇako,veyyakaranako,2,2,0,0,13
108132,katako,katako,4,2,2,0,6
108133,anukampāyaṃ,anukampayam,1,0,1,0,11
108134,puttako,puttako,18,18,0,0,7
108135,kiṃyateta,kimyateta,1,0,1,0,9
108136,parimāṇatthe,parimanatthe,1,1,0,0,12
108137,ttakavantu,ttakavantu,1,0,1,0,10
108138,vantumhi,vantumhi,2,1,1,0,8
108139,yāvā,yava,12,9,3,0,4
108140,etāvā,etava,1,1,0,0,5
108141,etāvanto,etavanto,1,1,0,0,8
108142,pakarīyatīti,pakariyatiti,1,1,0,0,12
108143,tappakatiyā,tappakatiya,1,1,0,0,11
108144,tappakativacanaṃ,tappakativacanam,1,0,1,0,16
108145,sovaṇṇamayo,sovannamayo,30,28,2,0,11
108146,suvaṇṇamayā,suvannamaya,20,20,0,0,11
108147,iddhimayaṃ,iddhimayam,18,12,6,0,10
108148,manato,manato,30,29,1,0,6
108149,ayasāpakataṃ,ayasapakatam,1,1,0,0,12
108150,kateti,kateti,35,17,18,0,6
108151,saṃsaṭṭhādianekatthataddhitaṃ,samsatthadianekatthataddhitam,1,1,0,0,29
108152,ttanaṇeyyā,ttananeyya,1,0,1,0,10
108153,dippaccayā,dippaccaya,2,2,0,0,10
108154,buddhisaddā,buddhisadda,5,5,0,0,11
108155,tadabhidhāneṇyattatādayo,tadabhidhanenyattatadayo,1,1,0,0,24
108156,ṇyattattana,nyattattana,1,0,1,0,11
108157,ppaccayoyaṃ,ppaccayoyam,1,1,0,0,11
108158,lopañcā,lopanca,1,1,0,0,7
108159,avaṇṇa,avanna,4,2,2,0,6
108160,udaggassa,udaggassa,5,5,0,0,9
108161,odagyaṃ,odagyam,30,21,9,0,7
108162,aṇaṇassa,ananassa,1,1,0,0,8
108163,āṇaṇyaṃ,ananyam,23,14,9,0,7
108164,vedhabyaṃ,vedhabyam,21,20,1,0,9
108165,dubbalassa,dubbalassa,45,45,0,0,10
108166,dubbalyaṃ,dubbalyam,61,53,8,0,9
108167,capalassa,capalassa,2,2,0,0,9
108168,maccharassa,maccharassa,3,3,0,0,11
108169,muṇḍiyaṃ,mundiyam,13,12,1,0,8
108170,mūḷhiyaṃ,mulhiyam,1,1,0,0,8
108171,paṇḍitassa,panditassa,166,164,2,0,10
108172,paṇḍityaṃ,pandityam,1,1,0,0,9
108173,kārasaṃyogādīnaṃ,karasamyogadinam,1,1,0,0,16
108174,bahussutassa,bahussutassa,54,54,0,0,12
108175,porohiccaṃ,porohiccam,3,3,0,0,10
108176,adhipatissa,adhipatissa,2,2,0,0,11
108177,muṭṭhassatissa,mutthassatissa,38,36,2,0,14
108178,muṭṭhassaccaṃ,mutthassaccam,43,35,8,0,13
108179,kvacādimajjhuttarā,kvacadimajjhuttara,1,1,0,0,18
108180,disuttena,disuttena,4,4,0,0,9
108181,suhadassa,suhadassa,3,3,0,0,9
108182,bhāvosohajjaṃ,bhavosohajjam,1,1,0,0,13
108183,kusīdassabhāvokosajjaṃ,kusidassabhavokosajjam,1,1,0,0,22
108184,vaggādesā,vaggadesa,1,1,0,0,9
108185,sovacassaṃ,sovacassam,6,6,0,0,10
108186,dovacassaṃ,dovacassam,11,10,1,0,10
108187,nipakassa,nipakassa,9,9,0,0,9
108188,dubhagassa,dubhagassa,2,2,0,0,10
108189,vāṇijassa,vanijassa,16,16,0,0,9
108190,sokhummaṃ,sokhummam,4,4,0,0,9
108191,dummedhassa,dummedhassa,3,3,0,0,11
108192,dummejjhaṃ,dummejjham,21,17,4,0,10
108193,brāhmaññaṃ,brahmannam,2,2,0,0,10
108194,nipuṇassa,nipunassa,11,9,2,0,9
108195,ggahaṇeneva,ggahaneneva,12,12,0,0,11
108196,thadhaṇa,thadhana,1,0,1,0,8
108197,chajhaña,chajhana,1,0,1,0,8
108198,ttatā,ttata,2,1,1,0,5
108199,paṃsukūlikatā,pamsukulikata,1,1,0,0,13
108200,tecīvarikattaṃ,tecivarikattam,2,2,0,0,14
108201,tecīvarikatā,tecivarikata,2,2,0,0,12
108202,odarikattaṃ,odarikattam,5,4,1,0,11
108203,odarikatā,odarikata,1,1,0,0,9
108204,manussatā,manussata,1,1,0,0,9
108205,nīlatā,nilata,1,1,0,0,6
108206,yācakattaṃ,yacakattam,1,1,0,0,10
108207,yācakatā,yacakata,1,1,0,0,8
108208,daṇḍitā,dandita,1,1,0,0,7
108209,saccavāditā,saccavadita,5,4,1,0,11
108210,kataññutā,katannuta,43,38,5,0,9
108211,appicchatā,appicchata,57,50,7,0,10
108212,asaṃsaggatā,asamsaggata,1,1,0,0,11
108213,bhassārāmatā,bhassaramata,23,23,0,0,12
108214,puthujjanassa,puthujjanassa,363,340,23,0,13
108215,ṇeyye,neyye,2,1,1,0,5
108216,ādhipabheyyaṃ,adhipabheyyam,1,1,0,0,13
108217,kavissa,kavissa,1,1,0,0,7
108218,bhāvokāveyyaṃ,bhavokaveyyam,1,1,0,0,13
108219,ṇyā,nya,1,0,1,0,3
108220,paribhaṭassa,paribhatassa,11,11,0,0,12
108221,pāribhaṭyaṃ,paribhatyam,7,4,3,0,11
108222,pāribhaṭyassa,paribhatyassa,2,2,0,0,13
108223,pāribhaṭyatā,paribhatyata,7,4,3,0,12
108224,sovacassatā,sovacassata,40,33,7,0,11
108225,bhisaggassa,bhisaggassa,1,1,0,0,11
108226,saṭhassa,sathassa,19,18,1,0,8
108227,sāṭheyyaṃ,satheyyam,92,76,16,0,9
108228,yathābhūtameva,yathabhutameva,13,13,0,0,14
108229,karuṇāyeva,karunayeva,5,5,0,0,10
108230,pattakālameva,pattakalameva,6,5,1,0,13
108231,ākāsānantameva,akasanantameva,10,9,1,0,14
108232,kāyapāguññameva,kayapagunnameva,1,1,0,0,15
108233,visama,visama,7,6,1,0,6
108234,visamattaṃ,visamattam,1,1,0,0,10
108235,visamatā,visamata,2,2,0,0,8
108236,sucitā,sucita,3,3,0,0,6
108237,paṭutā,patuta,1,1,0,0,6
108238,āttañcā,attanca,1,1,0,0,7
108239,ādirassattañca,adirassattanca,1,1,0,0,14
108240,bhāvokomāraṃ,bhavokomaram,1,1,0,0,12
108241,sāmaggī,samaggi,97,87,10,0,7
108242,ramaṇīyatā,ramaniyata,6,6,0,0,10
108243,manuññattaṃ,manunnattam,1,1,0,0,11
108244,manuññatā,manunnata,1,1,0,0,9
108245,piyarūpakaṃ,piyarupakam,1,1,0,0,11
108246,piyarūpattaṃ,piyarupattam,1,1,0,0,12
108247,piyarūpatā,piyarupata,1,1,0,0,10
108248,kalyāṇakaṃ,kalyanakam,1,1,0,0,10
108249,kalyāṇattaṃ,kalyanattam,1,1,0,0,11
108250,corakaṃ,corakam,1,1,0,0,7
108251,corattaṃ,corattam,2,2,0,0,8
108252,coratā,corata,1,1,0,0,6
108253,aḍḍhakaṃ,addhakam,2,2,0,0,8
108254,aḍḍhattaṃ,addhattam,1,1,0,0,9
108255,aḍḍhatā,addhata,7,7,0,0,7
108256,bhāvataddhitaṃ,bhavataddhitam,2,2,0,0,14
108257,pāpataraṃ,papataram,8,8,0,0,9
108258,pāpatamā,papatama,1,1,0,0,8
108259,pāpatamaṃ,papatamam,1,1,0,0,9
108260,pāpisikā,papisika,1,1,0,0,8
108261,pāpisikaṃ,papisikam,1,1,0,0,9
108262,pāpiyā,papiya,4,4,0,0,6
108263,pāpiyaṃ,papiyam,3,3,0,0,7
108264,pāpiṭṭhā,papittha,4,4,0,0,8
108265,pāpiṭṭhaṃ,papittham,3,3,0,0,9
108266,paṭutaro,patutaro,4,4,0,0,8
108267,paṭutamo,patutamo,2,2,0,0,8
108268,paṭisiko,patisiko,1,1,0,0,8
108269,paṭiyo,patiyo,2,2,0,0,6
108270,paṭiṭṭho,patittho,2,2,0,0,8
108271,varataro,varataro,5,5,0,0,8
108272,varatamo,varatamo,1,1,0,0,8
108273,varisiko,varisiko,1,1,0,0,8
108274,variyo,variyo,1,1,0,0,6
108275,variṭṭho,varittho,3,3,0,0,8
108276,paṇītatamo,panitatamo,4,4,0,0,10
108277,lopamakatvā,lopamakatva,2,2,0,0,11
108278,antikoti,antikoti,2,2,0,0,8
108279,bāḷhoti,balhoti,2,2,0,0,7
108280,guṇavāti,gunavati,6,4,2,0,8
108281,satimāti,satimati,38,15,23,0,8
108282,visesataddhitaṃ,visesataddhitam,1,1,0,0,15
108283,paṭhamāvibhatyantā,pathamavibhatyanta,1,1,0,0,18
108284,medhāmāyā,medhamaya,1,0,1,0,9
108285,medhāviniyo,medhaviniyo,1,1,0,0,11
108286,medhāvi,medhavi,7,6,1,0,7
108287,māyāvinī,mayavini,2,2,0,0,8
108288,māyāvi,mayavi,5,5,0,0,6
108289,ālā,ala,1,0,1,0,3
108290,picchaṃ,piccham,3,3,0,0,7
108291,tuṇḍilo,tundilo,8,8,0,0,7
108292,tadassatthī,tadassatthi,4,4,0,0,11
108293,tapassino,tapassino,76,73,3,0,9
108294,pakārattho,pakarattho,46,46,0,0,10
108295,chattiko,chattiko,1,1,0,0,8
108296,kesiko,kesiko,1,1,0,0,6
108297,kuñjā,kunja,1,1,0,0,5
108298,hanū,hanu,2,2,0,0,4
108299,nagaro,nagaro,4,4,0,0,6
108300,guṇāditovantu,gunaditovantu,1,0,1,0,13
108301,ṇeyyaṇantūhī,neyyanantuhi,1,1,0,0,12
108302,avaṇṇantarahitehi,avannantarahitehi,1,1,0,0,17
108303,paṭhamāvibhatyantehi,pathamavibhatyantehi,1,1,0,0,20
108304,ntusamaṃ,ntusamam,1,1,0,0,8
108305,āyussukārāsamantumhi,ayussukarasamantumhi,1,0,1,0,20
108306,asādeso,asadeso,1,1,0,0,7
108307,gomanto,gomanto,2,2,0,0,7
108308,gomatī,gomati,1,1,0,0,6
108309,gomantī,gomanti,1,1,0,0,7
108310,gomaṃ,gomam,1,1,0,0,5
108311,assatthitaddhitaṃ,assatthitaddhitam,2,2,0,0,17
108312,saṅkhyāpūraṇo,sankhyapurano,1,0,1,0,13
108313,pañcamā,pancama,84,84,0,0,7
108314,vīriyapāramī,viriyaparami,21,16,5,0,12
108315,aṭṭhamā,atthama,62,62,0,0,7
108316,navamī,navami,4,4,0,0,6
108317,navamā,navama,57,57,0,0,6
108318,dasamī,dasami,2,2,0,0,6
108319,catucha,catucha,1,0,1,0,7
108320,thaṭha,thatha,1,0,1,0,6
108321,chaṭṭhā,chattha,80,79,1,0,7
108322,chāhamassa,chahamassa,1,1,0,0,10
108323,duta,duta,2,1,1,0,4
108324,duvaṅgaṃ,duvangam,6,4,2,0,8
108325,aḍḍhuḍḍhadivaḍḍhadiyaḍḍhaḍḍhatiyā,addhuddhadivaddhadiyaddhaddhatiya,1,0,1,0,33
108326,catutthadutiyatatiyānaṃ,catutthadutiyatatiyanam,1,1,0,0,23
108327,aḍḍhuḍḍhadivaḍḍhadiyaḍḍhaaḍḍhatiyā,addhuddhadivaddhadiyaddhaaddhatiya,1,0,1,0,34
108328,aḍḍhūpapadapādānasāmatthā,addhupapadapadanasamattha,1,1,0,0,25
108329,aḍḍhapubbakā,addhapubbaka,1,1,0,0,12
108330,catutthadutiyādayo,catutthadutiyadayo,1,1,0,0,18
108331,tappurisasamāse,tappurisasamase,1,1,0,0,15
108332,dvekaṭṭhānaṃ,dvekatthanam,1,1,0,0,12
108333,itaresa,itaresa,1,1,0,0,7
108334,masantañca,masantanca,2,2,0,0,10
108335,dasara,dasara,2,2,0,0,6
108336,vaṇṇamattattā,vannamattatta,1,1,0,0,13
108337,vaṇṇamattappasaṅgipi,vannamattappasangipi,1,1,0,0,20
108338,dasseva,dasseva,2,2,0,0,7
108339,nimittāsannabhāvato,nimittasannabhavato,1,1,0,0,19
108340,liṅgattayepi,lingattayepi,2,2,0,0,12
108341,kādito,kadito,1,1,0,0,6
108342,paccayāyogā,paccayayoga,1,1,0,0,11
108343,laddhamanteti,laddhamanteti,1,1,0,0,13
108344,itthiyaṃyeva,itthiyamyeva,2,2,0,0,12
108345,kādasī,kadasi,1,1,0,0,6
108346,ekādasamaṃ,ekadasamam,156,154,2,0,10
108347,bārasamo,barasamo,1,1,0,0,8
108348,dvādasī,dvadasi,1,1,0,0,7
108349,dināti,dinati,1,1,0,0,6
108350,ādaso,adaso,1,1,0,0,5
108351,terasī,terasi,2,2,0,0,6
108352,catuddasamo,catuddasamo,1,1,0,0,11
108353,cakuddasī,cakuddasi,1,1,0,0,9
108354,pañcasaddassa,pancasaddassa,2,2,0,0,13
108355,vīsesu,visesu,1,1,0,0,6
108356,ādesāpi,adesapi,1,1,0,0,7
108357,pañcadasamo,pancadasamo,9,9,0,0,11
108358,niccañcā,niccanca,1,1,0,0,8
108359,soḷase,solase,8,8,0,0,6
108360,cattālīse,cattalise,4,4,0,0,9
108361,terase,terase,11,9,2,0,6
108362,hotāyaṃ,hotayam,6,6,0,0,7
108363,soḷasī,solasi,2,2,0,0,6
108364,aṭṭhādasamo,atthadasamo,2,2,0,0,11
108365,sattadasamo,sattadasamo,3,3,0,0,11
108366,ūnā,una,28,28,0,0,3
108367,ekūnavīsatādayo,ekunavisatadayo,1,1,0,0,15
108368,kavacanantā,kavacananta,2,2,0,0,11
108369,bhikkhūnamekūnavīsati,bhikkhunamekunavisati,2,2,0,0,21
108370,bhikkhūnamekūnavīsatiṃ,bhikkhunamekunavisatim,1,1,0,0,22
108371,bhikkhūnamekūnavīsatiyā,bhikkhunamekunavisatiya,1,1,0,0,23
108372,vīsatādīsupi,visatadisupi,1,1,0,0,12
108373,dasadasā,dasadasa,1,1,0,0,8
108374,ekasese,ekasese,7,7,0,0,7
108375,sattāsa,sattasa,1,0,1,0,7
108376,yonañcī,yonanci,1,0,1,0,7
108377,ṭhiri,thiri,1,0,1,0,5
108378,tītuti,tituti,1,0,1,0,6
108379,chakkasattaka,chakkasattaka,1,0,1,0,13
108380,aṭṭhaka,atthaka,3,2,1,0,7
108381,yonañca,yonanca,1,1,0,0,7
108382,dvidasatthavācakassa,dvidasatthavacakassa,1,1,0,0,20
108383,saṅkhyānamanteti,sankhyanamanteti,1,1,0,0,16
108384,tiṃsānamante,timsanamante,1,1,0,0,12
108385,tiāgamo,tiagamo,1,1,0,0,7
108386,kusalacittāni,kusalacittani,11,11,0,0,13
108387,ekavīsatimo,ekavisatimo,22,22,0,0,11
108388,bāvīsatimo,bavisatimo,10,10,0,0,10
108389,dvāvīsaṃ,dvavisam,3,3,0,0,8
108390,dvāvīsatimo,dvavisatimo,9,9,0,0,11
108391,tevīsati,tevisati,79,71,8,0,8
108392,tevīsaṃ,tevisam,3,2,1,0,7
108393,tevīsatimo,tevisatimo,18,18,0,0,10
108394,catuvīsaṃ,catuvisam,1,1,0,0,9
108395,catuvīsatimo,catuvisatimo,16,16,0,0,12
108396,paṇṇavīsaṃ,pannavisam,1,1,0,0,10
108397,paṇṇavīsatimo,pannavisatimo,1,1,0,0,13
108398,pañcavīsaṃ,pancavisam,5,5,0,0,10
108399,pañcavīsatimo,pancavisatimo,12,12,0,0,13
108400,chabbīsati,chabbisati,30,29,1,0,10
108401,chabbīsaṃ,chabbisam,4,4,0,0,9
108402,chabbīsatimo,chabbisatimo,9,9,0,0,12
108403,sattavīsaṃ,sattavisam,2,2,0,0,10
108404,sattavīsatimo,sattavisatimo,7,7,0,0,13
108405,aṭṭhavīsaṃ,atthavisam,1,1,0,0,10
108406,aṭṭhavīsatimo,atthavisatimo,8,8,0,0,13
108407,ekūnatiṃsati,ekunatimsati,6,6,0,0,12
108408,ekūnatiṃsaṃvā,ekunatimsamva,1,1,0,0,13
108409,ekūnatiṃsatimo,ekunatimsatimo,10,10,0,0,14
108410,tiīsa,tiisa,1,0,1,0,5
108411,vīsatisamaṃ,visatisamam,1,1,0,0,11
108412,ekatiṃsati,ekatimsati,2,2,0,0,10
108413,bāttiṃsaṃ,battimsam,1,1,0,0,9
108414,dvattiṃsaṃ,dvattimsam,2,2,0,0,10
108415,tettiṃsaṃ,tettimsam,6,6,0,0,9
108416,catudasatthavācakassa,catudasatthavacakassa,1,1,0,0,21
108417,cattālīsatimo,cattalisatimo,2,2,0,0,13
108418,tecattālīsaṃ,tecattalisam,13,11,2,0,12
108419,pañcadasatthavācakassa,pancadasatthavacakassa,1,1,0,0,22
108420,paṇṇā,panna,5,2,3,0,5
108421,ekapaññāsaṃ,ekapannasam,2,2,0,0,11
108422,chadasatthavācakassa,chadasatthavacakassa,1,1,0,0,20
108423,dvesaṭṭhi,dvesatthi,4,4,0,0,9
108424,dvisaṭṭhi,dvisatthi,3,3,0,0,9
108425,sattadasatthavācakassa,sattadasatthavacakassa,1,1,0,0,22
108426,dvāsattari,dvasattari,3,3,0,0,10
108427,dvāsattati,dvasattati,21,21,0,0,10
108428,dvisattari,dvisattari,3,3,0,0,10
108429,disattati,disattati,1,1,0,0,9
108430,aṭṭhadasatthavācakassa,atthadasatthavacakassa,1,1,0,0,22
108431,ekāsīti,ekasiti,21,19,2,0,7
108432,dveasīti,dveasiti,21,17,4,0,8
108433,caturāsīti,caturasiti,275,268,7,0,10
108434,navadasatthavācakassa,navadasatthavacakassa,1,1,0,0,21
108435,dvānavuti,dvanavuti,7,7,0,0,9
108436,dvenavuti,dvenavuti,21,21,0,0,9
108437,dvinavuti,dvinavuti,3,3,0,0,9
108438,catunavuti,catunavuti,6,6,0,0,10
108439,dasadasakatthavācakassa,dasadasakatthavacakassa,1,1,0,0,23
108440,satadasakatthavācakassa,satadasakatthavacakassa,1,1,0,0,23
108441,napuṃsakamekavacanantañca,napumsakamekavacanantanca,1,1,0,0,25
108442,tiṃsādīsupi,timsadisupi,1,1,0,0,11
108443,dvikanti,dvikanti,1,1,0,0,8
108444,chaṭṭhītappurisaṃ,chatthitappurisam,1,1,0,0,17
108445,dvisatanti,dvisatanti,1,1,0,0,10
108446,saṅkhyānamuttari,sankhyanamuttari,1,1,0,0,16
108447,dasasatasahassaṃ,dasasatasahassam,6,6,0,0,16
108448,koṭippakoṭi,kotippakoti,9,9,0,0,11
108449,asaṅkhyeyyanti,asankhyeyyanti,8,8,0,0,14
108450,koṭippabhutinaṃ,kotippabhutinam,1,1,0,0,15
108451,vīsasaṅkhyānañca,visasankhyananca,2,2,0,0,16
108452,gaṇanato,gananato,64,57,7,0,8
108453,dviko,dviko,1,1,0,0,5
108454,paṇṇāsakaṃ,pannasakam,4,4,0,0,10
108455,satakaṃ,satakam,2,2,0,0,7
108456,sahassakaṃ,sahassakam,1,1,0,0,10
108457,saṅkhyātaddhitaṃ,sankhyataddhitam,1,1,0,0,16
108458,ekadviti,ekadviti,2,1,1,0,8
108459,vāratthe,varatthe,1,1,0,0,8
108460,sahassakkhattuṃ,sahassakkhattum,58,56,2,0,15
108461,vibhāgenā,vibhagena,1,1,0,0,9
108462,ekādisaṅkhyāto,ekadisankhyato,1,1,0,0,14
108463,dvito,dvito,3,3,0,0,5
108464,vibhāgehi,vibhagehi,5,5,0,0,9
108465,ikārassekāro,ikarassekaro,1,1,0,0,12
108466,katidhā,katidha,2,2,0,0,7
108467,jjhappaccaye,jjhappaccaye,1,1,0,0,12
108468,dvejjhaṃ,dvejjham,6,5,1,0,8
108469,hetuso,hetuso,50,49,1,0,6
108470,tassābhidhāneti,tassabhidhaneti,1,1,0,0,15
108471,ubhayathā,ubhayatha,31,30,1,0,9
108472,tathattā,tathatta,22,19,3,0,8
108473,yathattā,yathatta,1,1,0,0,8
108474,pakāroti,pakaroti,4,4,0,0,8
108475,kiṃima,kimima,1,0,1,0,6
108476,dāniha,daniha,1,1,0,0,6
108477,pariyosānappaccayantānaṃ,pariyosanappaccayantanam,1,1,0,0,24
108478,abyayataddhitattā,abyayataddhitatta,1,1,0,0,17
108479,nāmabyapadesaṃ,namabyapadesam,1,1,0,0,14
108480,ādippaccayantā,adippaccayanta,1,1,0,0,14
108481,byayataddhite,byayataddhite,1,1,0,0,13
108482,anupapannā,anupapanna,7,7,0,0,10
108483,niddiṭṭhalakkhaṇā,nidditthalakkhana,2,2,0,0,17
108484,akkharādito,akkharadito,1,1,0,0,11
108485,nāmopasagganipātato,namopasagganipatato,1,1,0,0,19
108486,samāsataddhitādito,samasataddhitadito,1,1,0,0,18
108487,taddhitato,taddhitato,2,2,0,0,10
108488,samānāparato,samanaparato,1,1,0,0,12
108489,aparasmiṃdivase,aparasmimdivase,1,1,0,0,15
108490,ajjatanaṃ,ajjatanam,5,4,1,0,9
108491,purātanaṃ,puratanam,7,7,0,0,9
108492,abyayataddhitaṃ,abyayataddhitam,1,1,0,0,15
108493,sāmaññavuttibhāvatthābyayato,samannavuttibhavatthabyayato,1,1,0,0,28
108494,tatrādi,tatradi,1,1,0,0,7
108495,catudhāpaccānekatthassatthisaṅkhyāto,catudhapaccanekatthassatthisankhyato,1,1,0,0,36
108496,taddhitakaṇḍo,taddhitakando,2,2,0,0,13
108497,ākhyātakaṇḍa,akhyatakanda,2,2,0,0,12
108498,vibhattividhāna,vibhattividhana,1,1,0,0,15
108499,kriyāvācīhi,kriyavacihi,2,2,0,0,11
108500,ācikkhatīti,acikkhatiti,20,9,11,0,11
108501,kriyālakkhaṇamākhyātikaṃ,kriyalakkhanamakhyatikam,1,1,0,0,24
108502,atītādayo,atitadayo,5,5,0,0,9
108503,paṭhamamajjhimuttamā,pathamamajjhimuttama,1,1,0,0,20
108504,gamanapacanādiko,gamanapacanadiko,3,3,0,0,16
108505,atiliṅgañca,atilinganca,1,1,0,0,11
108506,parokkhāhiyyattanī,parokkhahiyyattani,1,1,0,0,18
108507,khādidhātuppaccayantā,khadidhatuppaccayanta,1,1,0,0,21
108508,dhātavokammāpekkhaṃ,dhatavokammapekkham,1,1,0,0,19
108509,pacatītiādayo,pacatitiadayo,1,1,0,0,13
108510,kammanirapekkhaṃ,kammanirapekkham,3,3,0,0,16
108511,tiṭṭhatītiādayo,titthatitiadayo,1,1,0,0,15
108512,vikaraṇappaccayabhedena,vikaranappaccayabhedena,1,1,0,0,23
108513,vikaraṇā,vikarana,8,8,0,0,8
108514,niggahītapubbaka,niggahitapubbaka,1,1,0,0,16
108515,rudhādayo,rudhadayo,3,3,0,0,9
108516,divādayo,divadayo,2,2,0,0,8
108517,svādayo,svadayo,3,3,0,0,7
108518,kiyādayo,kiyadayo,3,3,0,0,8
108519,tanādayo,tanadayo,2,2,0,0,8
108520,curādayoti,curadayoti,1,1,0,0,10
108521,vikaraṇesu,vikaranesu,1,1,0,0,10
108522,bhūvādīsu,bhuvadisu,2,2,0,0,9
108523,paṭhamabhūtā,pathamabhuta,1,1,0,0,12
108524,sattāyamatthe,sattayamatthe,2,2,0,0,13
108525,kriyāsāmaññabhūte,kriyasamannabhute,1,1,0,0,17
108526,kriyāvācino,kriyavacino,1,1,0,0,11
108527,bhūvā,bhuva,2,1,1,0,5
108528,vakāroyaṃ,vakaroyam,1,1,0,0,9
108529,āgamasandhijo,agamasandhijo,2,2,0,0,13
108530,bhūvāppakārā,bhuvappakara,1,1,0,0,12
108531,sakammākammakatthato,sakammakammakatthato,1,1,0,0,20
108532,itiādito,itiadito,21,21,0,0,8
108533,loponekassarassa,loponekassarassa,1,0,1,0,16
108534,anekassarassa,anekassarassa,1,1,0,0,13
108535,anekassarattābhāvā,anekassarattabhava,1,1,0,0,18
108536,dhātvādhikāravihitānekappaccayappasaṅge,dhatvadhikaravihitanekappaccayappasange,1,1,0,0,39
108537,saddappaṭipattī,saddappatipatti,2,2,0,0,15
108538,vattamānavacanicchāyaṃ,vattamanavacanicchayam,1,1,0,0,22
108539,tianti,tianti,2,1,1,0,6
108540,teante,teante,1,0,1,0,6
108541,emhe,emhe,2,1,1,0,4
108542,vattamānāsaññā,vattamanasanna,1,1,0,0,14
108543,vattamānatthavisayattā,vattamanatthavisayatta,1,1,0,0,22
108544,divibhattividhāne,divibhattividhane,1,1,0,0,17
108545,gamyamānāya,gamyamanaya,3,3,0,0,11
108546,dhātūheva,dhatuheva,1,1,0,0,9
108547,atītānāgatapaccuppannāṇattiparikappakālābhipattivasena,atitanagatapaccuppannanattiparikappakalabhipattivasena,1,1,0,0,54
108548,paṭiladdhasabhāvo,patiladdhasabhavo,1,1,0,0,17
108549,atītoti,atitoti,32,32,0,0,7
108550,paccuppannasamīpepi,paccuppannasamipepi,1,1,0,0,19
108551,atītepi,atitepi,68,64,4,0,7
108552,taṃkālavacanicchayāti,tamkalavacanicchayati,1,1,0,0,21
108553,vattamānāvibhattiṃ,vattamanavibhattim,1,1,0,0,18
108554,ṭhānāniyame,thananiyame,1,1,0,0,11
108555,vattamānappaccaye,vattamanappaccaye,1,1,0,0,17
108556,tesamaniyamappasaṅgesati,tesamaniyamappasangesati,1,1,0,0,24
108557,parassapadavacanicchāyaṃ,parassapadavacanicchayam,1,1,0,0,24
108558,taddhitānantaraṃ,taddhitanantaram,1,1,0,0,16
108559,aṭṭhavidhānaṃ,atthavidhanam,3,3,0,0,13
108560,aṭṭhacattālīsamattāni,atthacattalisamattani,2,2,0,0,21
108561,hontītiādimhi,hontitiadimhi,1,1,0,0,13
108562,parassapadasaññā,parassapadasanna,1,1,0,0,16
108563,parassatthāni,parassatthani,1,1,0,0,13
108564,tabbāhullato,tabbahullato,1,1,0,0,12
108565,dhātūhī,dhatuhi,6,6,0,0,7
108566,tassāpyaniyamappasaṅge,tassapyaniyamappasange,3,3,0,0,22
108567,attanopadānaṃ,attanopadanam,1,1,0,0,13
108568,parassapadāna,parassapadana,1,1,0,0,13
108569,mattanopadānañca,mattanopadananca,1,1,0,0,16
108570,attanopadesupi,attanopadesupi,1,1,0,0,14
108571,vibhattīsupi,vibhattisupi,2,2,0,0,12
108572,yojetabbanti,yojetabbanti,41,41,0,0,12
108573,aṭṭhavibhattivasena,atthavibhattivasena,1,1,0,0,19
108574,channavutividhe,channavutividhe,1,1,0,0,15
108575,ākhyātapade,akhyatapade,4,4,0,0,11
108576,paṭhamamajjhimauttamapurisā,pathamamajjhimauttamapurisa,1,1,0,0,27
108577,vattamānaparassapadādimhi,vattamanaparassapadadimhi,1,1,0,0,25
108578,paṭhamapurisasaññā,pathamapurisasanna,1,1,0,0,18
108579,payujjamānepitulyādhikaraṇe,payujjamanepitulyadhikarane,1,0,1,0,27
108580,tumhāmha,tumhamha,2,1,1,0,8
108581,tulyādhikaraṇabhūte,tulyadhikaranabhute,5,5,0,0,19
108582,paṭhamapurisaṃ,pathamapurisam,1,1,0,0,14
108583,kriyāsādhakassa,kriyasadhakassa,1,1,0,0,15
108584,vattamānaparassapadapaṭhamapurisekavacanaṃti,vattamanaparassapadapathamapurisekavacanamti,1,1,0,0,44
108585,kattarī,kattari,19,19,0,0,7
108586,vikaraṇappaccayavidhāne,vikaranappaccayavidhane,1,1,0,0,23
108587,sabbadhātukamhiyevāyamissate,sabbadhatukamhiyevayamissate,1,1,0,0,28
108588,kāritato,karitato,1,1,0,0,8
108589,ppaccayassāpi,ppaccayassapi,1,1,0,0,13
108590,anuvattetabbo,anuvattetabbo,4,4,0,0,13
108591,ivaṇṇuvaṇṇantānañca,ivannuvannantananca,1,1,0,0,19
108592,lahūpantāna,lahupantana,1,1,0,0,11
108593,ivaṇṇuvaṇṇānameva,ivannuvannanameva,1,1,0,0,17
108594,yuvaṇṇānampi,yuvannanampi,1,1,0,0,12
108595,ṇānāniṭṭhādīsu,nananitthadisu,1,1,0,0,14
108596,tudādissāvikaraṇe,tudadissavikarane,1,1,0,0,17
108597,chetvādīsu,chetvadisu,1,1,0,0,10
108598,saralopādimhi,saralopadimhi,1,1,0,0,13
108599,kattunobhihitattāva,kattunobhihitattava,1,1,0,0,19
108600,panapekkhiya,panapekkhiya,1,1,0,0,12
108601,kriyāyekatte,kriyayekatte,2,2,0,0,12
108602,vattamānaparassapadapaṭhamapurisabahuvacanaṃ,vattamanaparassapadapathamapurisabahuvacanam,1,1,0,0,44
108603,appaccayavuddhiavādesā,appaccayavuddhiavadesa,1,1,0,0,22
108604,vattamānaparassapadamajjhimapurisekavacanaṃ,vattamanaparassapadamajjhimapurisekavacanam,1,1,0,0,43
108605,vattamānaparassapadauttamapurisekavacanaṃ,vattamanaparassapadauttamapurisekavacanam,1,1,0,0,41
108606,ppaccayavuddhi,ppaccayavuddhi,2,2,0,0,14
108607,attanopadasaññā,attanopadasanna,1,1,0,0,15
108608,attanopadānī,attanopadani,1,1,0,0,12
108609,dhātusaññāyaṃ,dhatusannayam,2,2,0,0,13
108610,ivaṇṇuvaṇṇānamabhāvā,ivannuvannanamabhava,1,1,0,0,20
108611,vuddhiabhāvovettha,vuddhiabhavovettha,1,1,0,0,18
108612,pacate,pacate,1,1,0,0,6
108613,pacante,pacante,5,5,0,0,7
108614,pacase,pacase,6,6,0,0,6
108615,pacavhe,pacavhe,3,3,0,0,7
108616,pacāmhe,pacamhe,2,2,0,0,7
108617,paṭhamapurisādīnamekajjhappavattippasaṅge,pathamapurisadinamekajjhappavattippasange,1,1,0,0,41
108618,paṭhamamajjhimānaṃ,pathamamajjhimanam,1,1,0,0,18
108619,paṭhamuttamānaṃ,pathamuttamanam,1,1,0,0,15
108620,majjhimuttamānaṃ,majjhimuttamanam,1,1,0,0,16
108621,ekatobhidhāne,ekatobhidhane,1,1,0,0,13
108622,kātabbe,katabbe,16,15,1,0,7
108623,ekakālānamevābhidhāne,ekakalanamevabhidhane,1,1,0,0,21
108624,pacasīti,pacasiti,1,1,0,0,8
108625,pariyāyappasaṅge,pariyayappasange,3,3,0,0,16
108626,pacathāti,pacathati,1,0,1,0,9
108627,pacāmīti,pacamiti,2,2,0,0,8
108628,ekābhidhāneti,ekabhidhaneti,1,0,1,0,13
108629,pacissasi,pacissasi,11,11,0,0,9
108630,paciṃ,pacim,5,5,0,0,5
108631,bhinnakālattā,bhinnakalatta,3,3,0,0,13
108632,pacimhā,pacimha,3,3,0,0,7
108633,mānanta,mananta,4,3,1,0,7
108634,kāritappaccayesu,karitappaccayesu,1,1,0,0,16
108635,ntesu,ntesu,1,1,0,0,5
108636,dīpetāniccamaññattha,dipetaniccamannattha,1,1,0,0,20
108637,parokkhāyamasantakaṃ,parokkhayamasantakam,1,1,0,0,20
108638,appaccayaparanayanāni,appaccayaparanayanani,1,1,0,0,21
108639,garupubbarassato,garupubbarassato,2,2,0,0,16
108640,paṭhamapurisabahuvacanassa,pathamapurisabahuvacanassa,2,2,0,0,26
108641,gamenti,gamenti,58,56,2,0,7
108642,gamesi,gamesi,12,12,0,0,6
108643,gametha,gametha,4,4,0,0,7
108644,gamemi,gamemi,6,6,0,0,6
108645,gamema,gamema,3,3,0,0,6
108646,attanopadepi,attanopadepi,1,1,0,0,12
108647,āgacchasi,agacchasi,47,46,1,0,9
108648,āgacchāmī,agacchami,37,37,0,0,9
108649,paccuppannasamīpe,paccuppannasamipe,2,2,0,0,17
108650,ghammanti,ghammanti,3,3,0,0,9
108651,kammakattaripi,kammakattaripi,1,1,0,0,14
108652,kārakantarena,karakantarena,1,1,0,0,13
108653,bhavanalavanādiko,bhavanalavanadiko,1,1,0,0,17
108654,sakammakāpi,sakammakapi,1,1,0,0,11
108655,anupubbā,anupubba,3,3,0,0,8
108656,vattamānattanopadapaṭhamapurisekavacanaṃ,vattamanattanopadapathamapurisekavacanam,1,1,0,0,40
108657,attanopadavisayevāyamissate,attanopadavisayevayamissate,1,1,0,0,27
108658,kammassābhihitattā,kammassabhihitatta,3,3,0,0,18
108659,paṭhamāvidha,pathamavidha,1,1,0,0,12
108660,anubhūyante,anubhuyante,3,3,0,0,11
108661,anubhūyase,anubhuyase,3,3,0,0,10
108662,anubhūyavhe,anubhuyavhe,2,2,0,0,11
108663,anubhūye,anubhuye,5,5,0,0,8
108664,anubhūyāmhe,anubhuyamhe,1,1,0,0,11
108665,akattariyevetaṃ,akattariyevetam,1,1,0,0,15
108666,anubhūyyati,anubhuyyati,1,1,0,0,11
108667,anubhūyyate,anubhuyyate,1,1,0,0,11
108668,anubhūyyanti,anubhuyyanti,1,1,0,0,12
108669,anubhūyyasi,anubhuyyasi,1,1,0,0,11
108670,anubhūyyatha,anubhuyyatha,1,1,0,0,12
108671,anubhūyyāmi,anubhuyyami,1,1,0,0,11
108672,anubhūyyāma,anubhuyyama,1,1,0,0,11
108673,anubhūyati,anubhuyati,6,6,0,0,10
108674,anubhūyanti,anubhuyanti,6,6,0,0,11
108675,kavacanameva,kavacanameva,1,1,0,0,12
108676,pacadhātuto,pacadhatuto,2,2,0,0,11
108677,yappaccaye,yappaccaye,2,2,0,0,10
108678,bhāvakammavisayassa,bhavakammavisayassa,1,1,0,0,19
108679,yavattanaṃ,yavattanam,1,1,0,0,10
108680,ravānañca,ravananca,1,1,0,0,9
108681,sayappaccayānaṃ,sayappaccayanam,1,1,0,0,15
108682,cavaggādittā,cavaggaditta,1,1,0,0,12
108683,paccare,paccare,8,7,1,0,7
108684,paccase,paccase,2,2,0,0,7
108685,paccavhe,paccavhe,2,2,0,0,8
108686,paccāmhe,paccamhe,1,1,0,0,8
108687,parassapadādese,parassapadadese,1,1,0,0,15
108688,paccasi,paccasi,9,9,0,0,7
108689,paccatha,paccatha,4,4,0,0,8
108690,paccāmi,paccami,4,4,0,0,7
108691,paccāma,paccama,5,5,0,0,7
108692,kammakattari,kammakattari,3,3,0,0,12
108693,bhāvakammavisaye,bhavakammavisaye,2,2,0,0,16
108694,gacchīyante,gacchiyante,1,1,0,0,11
108695,gacchīyase,gacchiyase,1,1,0,0,10
108696,gacchīyavhe,gacchiyavhe,1,1,0,0,11
108697,gacchīye,gacchiye,1,1,0,0,8
108698,gacchīyāmhe,gacchiyamhe,1,1,0,0,11
108699,heṭṭhānuttehi,hetthanuttehi,1,1,0,0,13
108700,parassevedaṃ,parassevedam,1,1,0,0,12
108701,kaṭapa,katapa,1,0,1,0,6
108702,nteheva,nteheva,1,1,0,0,7
108703,gammante,gammante,1,1,0,0,8
108704,gamīyante,gamiyante,1,1,0,0,9
108705,gammase,gammase,1,1,0,0,7
108706,gamīyase,gamiyase,1,1,0,0,8
108707,gammavhe,gammavhe,1,1,0,0,8
108708,gamīyavhe,gamiyavhe,1,1,0,0,9
108709,gamīye,gamiye,1,1,0,0,6
108710,gammāmhe,gammamhe,1,1,0,0,8
108711,gamīyāmhe,gamiyamhe,1,1,0,0,9
108712,parassapadatte,parassapadatte,15,0,15,0,14
108713,gacchīyyati,gacchiyyati,1,1,0,0,11
108714,gacchīyyanti,gacchiyyanti,1,1,0,0,12
108715,gacchīyanti,gacchiyanti,3,3,0,0,11
108716,gammanti,gammanti,4,4,0,0,8
108717,gamīyati,gamiyati,7,7,0,0,8
108718,gamīyanti,gamiyanti,2,2,0,0,9
108719,kārāgame,karagame,5,5,0,0,8
108720,gamiyyati,gamiyyati,2,2,0,0,9
108721,gamiyyanti,gamiyyanti,1,1,0,0,10
108722,ghammīyati,ghammiyati,2,2,0,0,10
108723,ghammīyanti,ghammiyanti,3,3,0,0,11
108724,ssuvho,ssuvho,1,0,1,0,6
108725,āṇatyāsiṭṭhenuttakāle,anatyasitthenuttakale,1,0,1,0,21
108726,kālādhikāre,kaladhikare,1,1,0,0,11
108727,vidhinimantanājjhesanānumatipatthanāpattakālā,vidhinimantanajjhesananumatipatthanapattakala,1,0,1,0,45
108728,āṇāpana,anapana,3,3,0,0,7
108729,māṇatti,manatti,1,0,1,0,7
108730,āsīsanamā,asisanama,1,1,0,0,9
108731,siṭṭho,sittho,1,0,1,0,6
108732,asampattassa,asampattassa,5,5,0,0,12
108733,uttakālo,uttakalo,1,1,0,0,8
108734,anuttakālo,anuttakalo,2,1,1,0,10
108735,paccuppannakāloti,paccuppannakaloti,1,1,0,0,17
108736,uttakāloti,uttakaloti,1,1,0,0,10
108737,kālamanāmasitvā,kalamanamasitva,1,1,0,0,15
108738,pañcamīparassapadapaṭhamapurisekavacanaṃ,pancamiparassapadapathamapurisekavacanam,1,1,0,0,40
108739,hilopaṃ,hilopam,1,0,1,0,7
108740,anubhūyataṃ,anubhuyatam,1,1,0,0,11
108741,anubhūyantaṃ,anubhuyantam,1,1,0,0,12
108742,anubhūyassu,anubhuyassu,1,1,0,0,11
108743,anubhūyavho,anubhuyavho,1,1,0,0,11
108744,anubhūyāmase,anubhuyamase,1,1,0,0,12
108745,anubhūyyatu,anubhuyyatu,1,1,0,0,11
108746,anubhūyyantu,anubhuyyantu,1,1,0,0,12
108747,anubhūyatu,anubhuyatu,4,4,0,0,10
108748,anubhūyantu,anubhuyantu,4,4,0,0,11
108749,anubhūyyāhi,anubhuyyahi,1,1,0,0,11
108750,bhūyataṃ,bhuyatam,2,2,0,0,8
108751,pacatu,pacatu,5,5,0,0,6
108752,pacantu,pacantu,17,17,0,0,7
108753,pacataṃ,pacatam,2,2,0,0,7
108754,pacassu,pacassu,2,2,0,0,7
108755,pacavho,pacavho,2,2,0,0,7
108756,pacāmase,pacamase,1,1,0,0,8
108757,ppaccayacavaggādi,ppaccayacavaggadi,1,1,0,0,17
108758,paccataṃ,paccatam,4,3,1,0,8
108759,paccassu,paccassu,1,1,0,0,8
108760,paccavho,paccavho,1,1,0,0,8
108761,paccāmase,paccamase,1,1,0,0,9
108762,paccatu,paccatu,7,7,0,0,7
108763,paccantu,paccantu,2,2,0,0,8
108764,paccāhi,paccahi,1,1,0,0,7
108765,gamentu,gamentu,2,2,0,0,7
108766,ghammantu,ghammantu,2,2,0,0,9
108767,gacchīyataṃ,gacchiyatam,1,1,0,0,11
108768,gacchīyatu,gacchiyatu,1,1,0,0,10
108769,gamīyataṃ,gamiyatam,1,1,0,0,9
108770,gamīyatu,gamiyatu,2,2,0,0,8
108771,gammataṃ,gammatam,2,2,0,0,8
108772,gammatu,gammatu,1,1,0,0,7
108773,hotūtiādi,hotutiadi,1,1,0,0,9
108774,nimantane,nimantane,31,29,2,0,9
108775,adhivāsetu,adhivasetu,95,90,5,0,10
108776,pucchatu,pucchatu,6,6,0,0,8
108777,pavisatu,pavisatu,16,16,0,0,8
108778,eyyāmieyyāma,eyyamieyyama,1,0,1,0,12
108779,eyyaṃeyyāmhe,eyyameyyamhe,1,0,1,0,12
108780,vidhinimantanā,vidhinimantana,1,0,1,0,14
108781,kattumicchato,kattumicchato,3,3,0,0,13
108782,anujānanaṃ,anujananam,6,5,1,0,10
108783,hetukriyāya,hetukriyaya,2,2,0,0,11
108784,phalakriyāya,phalakriyaya,1,1,0,0,12
108785,sambhavaparikappo,sambhavaparikappo,1,1,0,0,17
108786,parikappe,parikappe,10,7,3,0,9
108787,sattamīparassapadapaṭhamapurisekavacanaṃ,sattamiparassapadapathamapurisekavacanam,1,1,0,0,40
108788,appaccayavuddhādi,appaccayavuddhadi,1,1,0,0,17
108789,eyyaṃiccetesaṃ,eyyamiccetesam,1,1,0,0,14
108790,ekārādeso,ekaradeso,3,3,0,0,9
108791,pabbajeyya,pabbajeyya,16,16,0,0,10
108792,anubhūyetha,anubhuyetha,1,1,0,0,11
108793,anubhūyeraṃ,anubhuyeram,1,1,0,0,11
108794,anubhūyetho,anubhuyetho,1,1,0,0,11
108795,anubhūyeyyāvho,anubhuyeyyavho,1,1,0,0,14
108796,anubhūyeyyaṃ,anubhuyeyyam,1,1,0,0,12
108797,anubhūyeyyāmhe,anubhuyeyyamhe,1,1,0,0,14
108798,anubhūyeyya,anubhuyeyya,3,3,0,0,11
108799,anubhūyeyyuṃ,anubhuyeyyum,3,3,0,0,12
108800,anubhūyeyyāsi,anubhuyeyyasi,2,2,0,0,13
108801,bhūyetha,bhuyetha,2,2,0,0,8
108802,paceyyuṃ,paceyyum,5,5,0,0,8
108803,paceyyāsi,paceyyasi,3,3,0,0,9
108804,paceyyātha,paceyyatha,2,2,0,0,10
108805,paceyyāmi,paceyyami,2,2,0,0,9
108806,paceyyāma,paceyyama,1,1,0,0,9
108807,pacetha,pacetha,2,2,0,0,7
108808,paceraṃ,paceram,2,2,0,0,7
108809,pacetho,pacetho,2,2,0,0,7
108810,paceyyāvho,paceyyavho,1,1,0,0,10
108811,paceyyaṃ,paceyyam,2,2,0,0,8
108812,paceyyāmhe,paceyyamhe,1,1,0,0,10
108813,paccetha,paccetha,1,1,0,0,8
108814,pacceraṃ,pacceram,1,1,0,0,8
108815,paccetho,paccetho,1,1,0,0,8
108816,pacceyyāvho,pacceyyavho,1,1,0,0,11
108817,pacceyyaṃ,pacceyyam,1,1,0,0,9
108818,pacceyyāmhe,pacceyyamhe,1,1,0,0,11
108819,pacceyya,pacceyya,3,3,0,0,8
108820,pacceyyuṃ,pacceyyum,1,1,0,0,9
108821,pacceyyāsi,pacceyyasi,3,3,0,0,10
108822,eyyu,eyyu,2,1,1,0,4
108823,gamuṃ,gamum,10,10,0,0,5
108824,gameyyāsi,gameyyasi,1,1,0,0,9
108825,gameyyātha,gameyyatha,1,1,0,0,10
108826,gameyyāmi,gameyyami,1,1,0,0,9
108827,gameyyāma,gameyyama,1,1,0,0,9
108828,gameraṃ,gameram,1,1,0,0,7
108829,gacchīyetha,gacchiyetha,1,1,0,0,11
108830,gamīyetha,gamiyetha,1,1,0,0,9
108831,gacchīyeraṃ,gacchiyeram,1,1,0,0,11
108832,gamīyeraṃ,gamiyeram,1,1,0,0,9
108833,gacchīyeyya,gacchiyeyya,1,1,0,0,11
108834,gamīyeyya,gamiyeyya,1,1,0,0,9
108835,gammeyya,gammeyya,1,1,0,0,8
108836,gammeyyuṃ,gammeyyum,1,1,0,0,9
108837,ghammeyya,ghammeyya,2,2,0,0,9
108838,ghammeyyuṃ,ghammeyyum,1,1,0,0,10
108839,paccuppannāṇattiparikappakālikavibhattinayo,paccuppannanattiparikappakalikavibhattinayo,1,1,0,0,43
108840,iṃmhase,immhase,1,0,1,0,7
108841,hiyyattanīparassapadapaṭhamapurisekavacanaṃ,hiyyattaniparassapadapathamapurisekavacanam,1,1,0,0,43
108842,ajjatanīkālātipattīsu,ajjatanikalatipattisu,1,0,1,0,21
108843,dhātūnamādimhi,dhatunamadimhi,1,1,0,0,14
108844,hiyyattanīajjatanīkālātipatti,hiyyattaniajjatanikalatipatti,1,0,1,0,29
108845,kathamayamakārāgamo,kathamayamakaragamo,1,1,0,0,19
108846,dhātvādimhīti,dhatvadimhiti,1,1,0,0,13
108847,satissarepi,satissarepi,1,1,0,0,11
108848,dhātvante,dhatvante,1,1,0,0,9
108849,punakārāgamassidha,punakaragamassidha,1,1,0,0,18
108850,niratthattā,niratthatta,1,1,0,0,11
108851,payogānu,payoganu,2,2,0,0,8
108852,rodhā,rodha,1,1,0,0,5
108853,dhātvādito,dhatvadito,1,1,0,0,10
108854,ppaccayavuddhiavādesasaralopādi,ppaccayavuddhiavadesasaralopadi,1,1,0,0,31
108855,sukhamanvabhūyattha,sukhamanvabhuyattha,1,1,0,0,19
108856,kārāgamābhāve,karagamabhave,3,3,0,0,13
108857,anubhūyattha,anubhuyattha,2,2,0,0,12
108858,anvabhūyatha,anvabhuyatha,1,1,0,0,12
108859,anubhūyatha,anubhuyatha,3,3,0,0,11
108860,anvabhūyatthuṃ,anvabhuyatthum,1,1,0,0,14
108861,anubhūyatthuṃ,anubhuyatthum,1,1,0,0,13
108862,anvabhūyase,anvabhuyase,1,1,0,0,11
108863,anvabhūyavhaṃ,anvabhuyavham,1,1,0,0,13
108864,anubhūyavhaṃ,anubhuyavham,1,1,0,0,12
108865,anvabhūyiṃ,anvabhuyim,2,2,0,0,10
108866,anubhūyiṃ,anubhuyim,2,2,0,0,9
108867,anvabhūyamhase,anvabhuyamhase,1,1,0,0,14
108868,anubhūyamhase,anubhuyamhase,1,1,0,0,13
108869,anvabhūyā,anvabhuya,1,1,0,0,9
108870,anubhūyā,anubhuya,1,1,0,0,8
108871,anvabhūyattha,anvabhuyattha,1,1,0,0,13
108872,apacā,apaca,4,4,0,0,5
108873,apacū,apacu,2,2,0,0,5
108874,pacū,pacu,2,2,0,0,4
108875,apaco,apaco,4,4,0,0,5
108876,apacattha,apacattha,5,5,0,0,9
108877,pacattha,pacattha,8,8,0,0,8
108878,apacaṃ,apacam,3,3,0,0,6
108879,apacamhā,apacamha,4,4,0,0,8
108880,pacamhā,pacamha,3,3,0,0,7
108881,apacatthu,apacatthu,1,1,0,0,9
108882,pacatthuṃ,pacatthum,2,2,0,0,9
108883,apacase,apacase,3,3,0,0,7
108884,apacavhaṃ,apacavham,3,3,0,0,9
108885,pacavhaṃ,pacavham,2,2,0,0,8
108886,apaciṃ,apacim,4,4,0,0,6
108887,apacamhase,apacamhase,2,2,0,0,10
108888,pacamhase,pacamhase,1,1,0,0,9
108889,apaccatha,apaccatha,9,9,0,0,9
108890,apaccattha,apaccattha,4,4,0,0,10
108891,apaccatthuṃ,apaccatthum,1,1,0,0,11
108892,apaccase,apaccase,1,1,0,0,8
108893,apaccavhaṃ,apaccavham,1,1,0,0,10
108894,apacciṃ,apaccim,4,4,0,0,7
108895,apaccamhase,apaccamhase,1,1,0,0,11
108896,apaccā,apacca,9,8,1,0,6
108897,apaccū,apaccu,4,4,0,0,6
108898,agaccho,agaccho,2,2,0,0,7
108899,agaccha,agaccha,2,2,0,0,7
108900,agacchattha,agacchattha,3,3,0,0,11
108901,agacchavhaṃ,agacchavham,1,1,0,0,11
108902,agacchiṃ,agacchim,24,22,2,0,8
108903,agacchamhase,agacchamhase,1,1,0,0,12
108904,agamaṃ,agamam,28,25,3,0,6
108905,agacchīyattha,agacchiyattha,1,1,0,0,13
108906,gacchīyattha,gacchiyattha,1,1,0,0,12
108907,agamīyattha,agamiyattha,1,1,0,0,11
108908,gamīyattha,gamiyattha,1,1,0,0,10
108909,agacchīyatthuṃ,agacchiyatthum,1,1,0,0,14
108910,gacchīyatthuṃ,gacchiyatthum,1,1,0,0,13
108911,agamīyatthuṃ,agamiyatthum,1,1,0,0,12
108912,gamīyatthuṃ,gamiyatthum,1,1,0,0,11
108913,aghammā,aghamma,1,1,0,0,7
108914,aghammū,aghammu,1,1,0,0,7
108915,hiyyattanīvibhatti,hiyyattanivibhatti,1,1,0,0,18
108916,hiyyattanā,hiyyattana,1,0,1,0,10
108917,hiyyattanādīnaṃ,hiyyattanadinam,1,1,0,0,15
108918,sabbadhātukasaññattā,sabbadhatukasannatta,1,1,0,0,20
108919,asabbadhātukamhī,asabbadhatukamhi,1,1,0,0,16
108920,iṃmhe,immhe,1,0,1,0,5
108921,indriyāvisayabhūte,indriyavisayabhute,1,1,0,0,18
108922,itoti,itoti,113,24,89,0,5
108923,atikkantoti,atikkantoti,14,12,2,0,11
108924,parokkhāparassapadapaṭhamapurisekavacanaṃ,parokkhaparassapadapathamapurisekavacanam,1,1,0,0,41
108925,dhātūnamādibhūtānaṃ,dhatunamadibhutanam,1,1,0,0,19
108926,vaṇṇānamekassarānaṃ,vannanamekassaranam,1,1,0,0,19
108927,sabbadhātunaṃ,sabbadhatunam,2,2,0,0,13
108928,appaccaye,appaccaye,8,8,0,0,9
108929,juhotyādissapi,juhotyadissapi,1,1,0,0,14
108930,kiccādike,kiccadike,1,1,0,0,9
108931,pubbobbhāso,pubbobbhaso,4,3,1,0,11
108932,abbhāsasaññā,abbhasasanna,4,4,0,0,12
108933,avaṇṇassa,avannassa,9,9,0,0,9
108934,sagupussa,sagupussa,1,1,0,0,9
108935,vāssa,vassa,176,166,10,0,5
108936,nāparassimeti,naparassimeti,1,1,0,0,13
108937,vaggabyañjanānaṃ,vaggabyanjananam,1,1,0,0,16
108938,parokkhāvibhattiyanti,parokkhavibhattiyanti,1,1,0,0,21
108939,bhūva,bhuva,3,2,1,0,5
108940,mādesappaccayādimhī,madesappaccayadimhi,1,1,0,0,19
108941,byañjanādimhe,byanjanadimhe,1,1,0,0,13
108942,vāyamāgamo,vayamagamo,1,1,0,0,10
108943,kvacādhikārato,kvacadhikarato,1,1,0,0,14
108944,byañjanādopi,byanjanadopi,1,1,0,0,12
108945,asabbadhātuka,asabbadhatuka,1,1,0,0,13
108946,hiyyattanīādīnaṃ,hiyyattaniadinam,1,1,0,0,16
108947,sabbadhātukasaññāya,sabbadhatukasannaya,1,1,0,0,19
108948,tadaññā,tadanna,8,8,0,0,7
108949,asabbadhātukanti,asabbadhatukanti,1,1,0,0,16
108950,kārāgama,karagama,1,1,0,0,8
108951,ppacca,ppacca,1,1,0,0,6
108952,yi,yi,12,11,1,0,2
108953,kārāgamā,karagama,3,3,0,0,8
108954,anubabhūvīyittha,anubabhuviyittha,1,1,0,0,16
108955,anubabhūvittha,anubabhuvittha,2,2,0,0,14
108956,anubabhūvire,anubabhuvire,2,2,0,0,12
108957,babhūvīyittha,babhuviyittha,1,1,0,0,13
108958,papaca,papaca,4,4,0,0,6
108959,papacū,papacu,1,1,0,0,6
108960,papace,papace,3,3,0,0,6
108961,papacittha,papacittha,6,6,0,0,10
108962,papacaṃ,papacam,1,1,0,0,7
108963,papacimha,papacimha,3,3,0,0,9
108964,papacire,papacire,3,3,0,0,8
108965,papacittho,papacittho,3,3,0,0,10
108966,papacivho,papacivho,3,3,0,0,9
108967,papaciṃ,papacim,1,1,0,0,7
108968,papacimhe,papacimhe,2,2,0,0,9
108969,papaccittha,papaccittha,1,1,0,0,11
108970,papaccire,papaccire,1,1,0,0,9
108971,gamimhi,gamimhi,1,1,0,0,7
108972,kvacādivaṇṇānaṃ,kvacadivannanam,1,1,0,0,15
108973,anabbhāsassa,anabbhasassa,2,2,0,0,12
108974,paṭhamapurisekavacanamhi,pathamapurisekavacanamhi,1,1,0,0,24
108975,jagamaṃ,jagamam,2,2,0,0,7
108976,jagamiṃ,jagamim,2,2,0,0,7
108977,jagamīyittha,jagamiyittha,1,1,0,0,12
108978,parokkhāvibhatti,parokkhavibhatti,1,1,0,0,16
108979,samīpato,samipato,1,1,0,0,8
108980,ajjatanīparassapadapaṭhamapurisekavacanaṃ,ajjataniparassapadapathamapurisekavacanam,1,1,0,0,41
108981,dhātuvibhattī,dhatuvibhatti,1,1,0,0,13
108982,īmhā,imha,1,0,1,0,4
108983,divibhattīnaṃ,divibhattinam,2,2,0,0,13
108984,oāa,oaa,1,0,1,0,3
108985,itthaa,itthaa,1,0,1,0,6
108986,bhavi,bhavi,77,77,0,0,5
108987,iṃsvā,imsva,1,0,1,0,5
108988,abhaviṃsu,abhavimsu,6,6,0,0,9
108989,bhavuṃ,bhavum,23,23,0,0,6
108990,bhavittha,bhavittha,9,9,0,0,9
108991,bhaviṃ,bhavim,10,10,0,0,6
108992,bhavimha,bhavimha,3,3,0,0,8
108993,bhavimhā,bhavimha,4,4,0,0,8
108994,bhavū,bhavu,4,4,0,0,5
108995,abhavise,abhavise,3,3,0,0,8
108996,bhavise,bhavise,3,3,0,0,7
108997,bhavivhaṃ,bhavivham,3,3,0,0,9
108998,bhavimhe,bhavimhe,3,3,0,0,8
108999,ppaccayalope,ppaccayalope,3,3,0,0,12
109000,vuddhiavādesādi,vuddhiavadesadi,1,1,0,0,15
109001,anubhavittha,anubhavittha,2,2,0,0,12
109002,anvabhūyittha,anvabhuyittha,2,2,0,0,13
109003,anubhūyittha,anubhuyittha,3,3,0,0,12
109004,anvabhūyi,anvabhuyi,2,2,0,0,9
109005,anubhūyi,anubhuyi,3,3,0,0,8
109006,anvabhūyī,anvabhuyi,3,3,0,0,9
109007,anubhūyī,anubhuyi,3,3,0,0,8
109008,anvabhūyiṃsu,anvabhuyimsu,3,3,0,0,12
109009,anubhūyiṃsu,anubhuyimsu,3,3,0,0,11
109010,anvabhūyuṃ,anvabhuyum,3,3,0,0,10
109011,anubhūyuṃ,anubhuyum,3,3,0,0,9
109012,anvabhūyimha,anvabhuyimha,1,1,0,0,12
109013,anubhūyimha,anubhuyimha,1,1,0,0,11
109014,anvabhūyimhā,anvabhuyimha,1,1,0,0,12
109015,anubhūyimhā,anubhuyimha,1,1,0,0,11
109016,abhūyittha,abhuyittha,1,1,0,0,10
109017,apaci,apaci,6,6,0,0,5
109018,apacī,apaci,2,2,0,0,5
109019,apaciṃsu,apacimsu,2,2,0,0,8
109020,paciṃsu,pacimsu,8,8,0,0,7
109021,apacuṃ,apacum,1,1,0,0,6
109022,pacuṃ,pacum,2,2,0,0,5
109023,apacittha,apacittha,5,5,0,0,9
109024,pacittha,pacittha,6,6,0,0,8
109025,apacimha,apacimha,2,2,0,0,8
109026,pacimha,pacimha,2,2,0,0,7
109027,apacimhā,apacimha,2,2,0,0,8
109028,apacise,apacise,2,2,0,0,7
109029,apacivhaṃ,apacivham,2,2,0,0,9
109030,apaca,apaca,4,4,0,0,5
109031,apacimhe,apacimhe,2,2,0,0,8
109032,pacimhe,pacimhe,2,2,0,0,7
109033,apaccittha,apaccittha,2,2,0,0,10
109034,paccittha,paccittha,9,9,0,0,9
109035,pacci,pacci,10,10,0,0,5
109036,apaccī,apacci,2,2,0,0,6
109037,paccī,pacci,2,2,0,0,5
109038,apacciṃsu,apaccimsu,2,2,0,0,9
109039,pacciṃsu,paccimsu,4,4,0,0,8
109040,apaccuṃ,apaccum,3,3,0,0,7
109041,paccuṃ,paccum,3,3,0,0,6
109042,apacco,apacco,4,4,0,0,6
109043,pacco,pacco,1,1,0,0,5
109044,pacciṃ,paccim,3,3,0,0,6
109045,apaccimha,apaccimha,1,1,0,0,9
109046,paccimha,paccimha,1,1,0,0,8
109047,apaccimhā,apaccimha,1,1,0,0,9
109048,paccimhā,paccimha,1,1,0,0,8
109049,gacchī,gacchi,3,3,0,0,6
109050,agacchiṃsu,agacchimsu,2,2,0,0,10
109051,gacchiṃsu,gacchimsu,38,38,0,0,9
109052,agacchittha,agacchittha,5,5,0,0,11
109053,agacchimha,agacchimha,1,1,0,0,10
109054,agacchimhā,agacchimha,1,1,0,0,10
109055,gacchimhā,gacchimha,1,1,0,0,9
109056,ñchā,ncha,1,0,1,0,4
109057,gañchi,ganchi,15,15,0,0,6
109058,agañchī,aganchi,2,2,0,0,7
109059,gañchī,ganchi,2,2,0,0,6
109060,agañchiṃsu,aganchimsu,1,1,0,0,10
109061,gañchiṃsu,ganchimsu,3,3,0,0,9
109062,agañchuṃ,aganchum,2,2,0,0,8
109063,gañchuṃ,ganchum,7,7,0,0,7
109064,agañcho,agancho,1,1,0,0,7
109065,gañcho,gancho,1,1,0,0,6
109066,agañchittha,aganchittha,3,3,0,0,11
109067,agañchiṃ,aganchim,9,9,0,0,8
109068,agañchimha,aganchimha,1,1,0,0,10
109069,agañchimhā,aganchimha,1,1,0,0,10
109070,gañchimhā,ganchimha,1,1,0,0,9
109071,kāsattamajjatanimhī,kasattamajjatanimhi,2,2,0,0,19
109072,sattamajjatanimhī,sattamajjatanimhi,4,4,0,0,17
109073,uṃvacanassa,umvacanassa,2,2,0,0,11
109074,aṃsvā,amsva,1,0,1,0,5
109075,tthamhe,tthamhe,1,0,1,0,7
109076,gamiṃsu,gamimsu,29,29,0,0,7
109077,gamaṃsu,gamamsu,3,3,0,0,7
109078,gamittha,gamittha,15,15,0,0,8
109079,gamuttha,gamuttha,2,2,0,0,8
109080,gamiṃ,gamim,5,5,0,0,5
109081,agamimha,agamimha,6,5,1,0,8
109082,agamumha,agamumha,2,2,0,0,8
109083,gamumha,gamumha,2,2,0,0,7
109084,ajjhagā,ajjhaga,43,34,9,0,7
109085,ajjhaguṃ,ajjhagum,6,5,1,0,8
109086,ajjhago,ajjhago,2,2,0,0,7
109087,ajjhaguttha,ajjhaguttha,3,3,0,0,11
109088,ajjhagiṃ,ajjhagim,2,2,0,0,8
109089,ajjhagumha,ajjhagumha,1,1,0,0,10
109090,ajjhagū,ajjhagu,1,1,0,0,7
109091,agū,agu,3,3,0,0,3
109092,gamise,gamise,3,3,0,0,6
109093,gamivhaṃ,gamivham,2,2,0,0,8
109094,ajjhagaṃ,ajjhagam,7,6,1,0,8
109095,gamimhe,gamimhe,3,3,0,0,7
109096,agacchīyittha,agacchiyittha,2,2,0,0,13
109097,gacchīyittha,gacchiyittha,1,1,0,0,12
109098,agañchiyittha,aganchiyittha,1,1,0,0,13
109099,gañchiyittha,ganchiyittha,1,1,0,0,12
109100,agamīyittha,agamiyittha,1,1,0,0,11
109101,gamīyittha,gamiyittha,2,2,0,0,10
109102,agacchīyi,agacchiyi,1,1,0,0,9
109103,gacchīyi,gacchiyi,1,1,0,0,8
109104,agamīyi,agamiyi,2,2,0,0,7
109105,gamīyi,gamiyi,1,1,0,0,6
109106,agacchīyuṃ,agacchiyum,1,1,0,0,10
109107,agamīyuṃ,agamiyum,2,2,0,0,8
109108,aghammīyi,aghammiyi,1,1,0,0,9
109109,aghammīyiṃsu,aghammiyimsu,1,1,0,0,12
109110,hiyyattanajjatanī,hiyyattanajjatani,1,0,1,0,17
109111,sabbakālepi,sabbakalepi,5,5,0,0,11
109112,hiyyattanajjatanīpañcamī,hiyyattanajjatanipancami,1,1,0,0,24
109113,bhavī,bhavi,5,5,0,0,5
109114,bhavantvantarāyā,bhavantvantaraya,6,6,0,0,16
109115,kañci,kanci,756,693,63,0,5
109116,pāpamāgamā,papamagama,6,6,0,0,10
109117,atītakālikavibhatti,atitakalikavibhatti,1,1,0,0,19
109118,ssāmissāma,ssamissama,1,0,1,0,10
109119,ssaṃssāmhe,ssamssamhe,1,0,1,0,10
109120,ssatyādīnaṃ,ssatyadinam,6,5,1,0,11
109121,bhavissanto,bhavissanto,3,3,0,0,11
109122,taṃkāladīpakattā,tamkaladipakatta,1,1,0,0,16
109123,taṃkālavacanicchayā,tamkalavacanicchaya,1,1,0,0,19
109124,uppajjanārahoti,uppajjanarahoti,2,2,0,0,15
109125,ppaccayalopo,ppaccayalopo,9,9,0,0,12
109126,anubhavissate,anubhavissate,1,1,0,0,13
109127,anubhavissante,anubhavissante,1,1,0,0,14
109128,anubhavissase,anubhavissase,1,1,0,0,13
109129,anubhavissavhe,anubhavissavhe,1,1,0,0,14
109130,anubhavissaṃ,anubhavissam,2,2,0,0,12
109131,anubhavissāmhe,anubhavissamhe,1,1,0,0,14
109132,anubhavissanti,anubhavissanti,6,6,0,0,14
109133,ppaccayalopābhāve,ppaccayalopabhave,3,3,0,0,17
109134,anubhūyissate,anubhuyissate,1,1,0,0,13
109135,anubhūyissante,anubhuyissante,1,1,0,0,14
109136,bhūyissate,bhuyissate,2,2,0,0,10
109137,pacissanti,pacissanti,3,3,0,0,10
109138,pacissatha,pacissatha,6,6,0,0,10
109139,pacissāmi,pacissami,5,5,0,0,9
109140,pacissāma,pacissama,1,1,0,0,9
109141,pacissante,pacissante,2,2,0,0,10
109142,pacissase,pacissase,3,3,0,0,9
109143,pacissavhe,pacissavhe,3,3,0,0,10
109144,pacissaṃ,pacissam,6,6,0,0,8
109145,pacissāmhe,pacissamhe,1,1,0,0,10
109146,paccissante,paccissante,1,1,0,0,11
109147,paccissati,paccissati,3,3,0,0,10
109148,paccissanti,paccissanti,3,3,0,0,11
109149,paccissasi,paccissasi,1,1,0,0,10
109150,paccissatha,paccissatha,1,1,0,0,11
109151,paccissāmi,paccissami,1,1,0,0,10
109152,paccissāma,paccissama,1,1,0,0,10
109153,gacchīyissate,gacchiyissate,1,1,0,0,13
109154,gacchīyissante,gacchiyissante,1,1,0,0,14
109155,gacchīyissati,gacchiyissati,1,1,0,0,13
109156,gacchīyissanti,gacchiyissanti,1,1,0,0,14
109157,gamīyissate,gamiyissate,1,1,0,0,11
109158,gamīyissante,gamiyissante,1,1,0,0,12
109159,gamīyissati,gamiyissati,2,2,0,0,11
109160,gamīyissanti,gamiyissanti,1,1,0,0,12
109161,ghammissati,ghammissati,2,2,0,0,11
109162,ghammissanti,ghammissanti,2,2,0,0,12
109163,ssaṃssāmhā,ssamssamha,1,0,1,0,10
109164,ssiṃssāmhase,ssimssamhase,1,0,1,0,12
109165,viruddhapaccayūpanipātato,viruddhapaccayupanipatato,1,1,0,0,25
109166,anabhinibbatti,anabhinibbatti,2,2,0,0,14
109167,kriyātipannetīte,kriyatipannetite,1,0,1,0,16
109168,kriyātipannaṃ,kriyatipannam,1,0,1,0,13
109169,sādhakasattivirahena,sadhakasattivirahena,1,1,0,0,20
109170,accantānuppatti,accantanuppatti,1,1,0,0,15
109171,atītasaddena,atitasaddena,1,1,0,0,12
109172,voharitabbā,voharitabba,4,4,0,0,11
109173,takkiriyuppattippaṭibandhakarakriyāya,takkiriyuppattippatibandhakarakriyaya,1,1,0,0,37
109174,kālabhedena,kalabhedena,23,23,0,0,11
109175,atītavohāro,atitavoharo,3,3,0,0,11
109176,labbhatevāti,labbhatevati,38,38,0,0,12
109177,kālātipattiparassapadapaṭhamapurisekavacanaṃ,kalatipattiparassapadapathamapurisekavacanam,1,1,0,0,44
109178,kārikārāgamā,karikaragama,1,1,0,0,12
109179,alabhissa,alabhissa,10,10,0,0,9
109180,bhavissa,bhavissa,6,6,0,0,8
109181,bhavissāvā,bhavissava,1,1,0,0,10
109182,bhavissaṃsu,bhavissamsu,3,3,0,0,11
109183,abhavissamha,abhavissamha,2,2,0,0,12
109184,bhavissamha,bhavissamha,2,2,0,0,11
109185,bhavissāmhā,bhavissamha,2,2,0,0,11
109186,anvabhavissatha,anvabhavissatha,1,1,0,0,15
109187,anvabhavissisu,anvabhavissisu,1,1,0,0,14
109188,anvabhūyissatha,anvabhuyissatha,1,1,0,0,15
109189,anvabhavissa,anvabhavissa,2,2,0,0,12
109190,anvabhavissaṃsu,anvabhavissamsu,2,2,0,0,15
109191,anvabhūyissa,anvabhuyissa,2,2,0,0,12
109192,abhūyissatha,abhuyissatha,2,2,0,0,12
109193,apacissa,apacissa,4,4,0,0,8
109194,pacissa,pacissa,7,7,0,0,7
109195,apacissā,apacissa,4,4,0,0,8
109196,pacissā,pacissa,4,4,0,0,7
109197,apacissaṃsu,apacissamsu,2,2,0,0,11
109198,pacissaṃsu,pacissamsu,2,2,0,0,10
109199,apacisse,apacisse,2,2,0,0,8
109200,pacisse,pacisse,2,2,0,0,7
109201,apacissatha,apacissatha,5,5,0,0,11
109202,apacissaṃ,apacissam,2,2,0,0,9
109203,apacissamha,apacissamha,2,2,0,0,11
109204,pacissamha,pacissamha,2,2,0,0,10
109205,apacissāmhā,apacissamha,1,1,0,0,11
109206,pacissāmhā,pacissamha,1,1,0,0,10
109207,apacissisu,apacissisu,2,2,0,0,10
109208,pacissisu,pacissisu,1,1,0,0,9
109209,apacissase,apacissase,2,2,0,0,10
109210,apacissavhe,apacissavhe,2,2,0,0,11
109211,apacissiṃ,apacissim,1,1,0,0,9
109212,pacissiṃ,pacissim,1,1,0,0,8
109213,apacissāmhase,apacissamhase,1,1,0,0,13
109214,pacissāmhase,pacissamhase,1,1,0,0,12
109215,apacīyissatha,apaciyissatha,1,1,0,0,13
109216,apaccissa,apaccissa,3,3,0,0,9
109217,paccissa,paccissa,3,3,0,0,8
109218,apaccissā,apaccissa,2,2,0,0,9
109219,paccissā,paccissa,3,3,0,0,8
109220,apaccissaṃsu,apaccissamsu,2,2,0,0,12
109221,paccissaṃsu,paccissamsu,2,2,0,0,11
109222,agacchissa,agacchissa,4,4,0,0,10
109223,gacchissa,gacchissa,4,4,0,0,9
109224,gacchissāvā,gacchissava,1,1,0,0,11
109225,gacchissaṃsu,gacchissamsu,1,1,0,0,12
109226,gacchisse,gacchisse,1,1,0,0,9
109227,agacchissamha,agacchissamha,1,1,0,0,13
109228,gacchissamha,gacchissamha,1,1,0,0,12
109229,gacchissāmhā,gacchissamha,1,1,0,0,12
109230,agamissa,agamissa,11,11,0,0,8
109231,gamissaṃsu,gamissamsu,2,2,0,0,10
109232,agamissamha,agamissamha,1,1,0,0,11
109233,gamissāmhā,gamissamha,2,2,0,0,10
109234,agacchīyissatha,agacchiyissatha,1,1,0,0,15
109235,agamīyissatha,agamiyissatha,1,1,0,0,13
109236,agacchīyissa,agacchiyissa,2,2,0,0,12
109237,agamīyissaiccādi,agamiyissaiccadi,1,1,0,0,16
109238,aghammissā,aghammissa,1,1,0,0,10
109239,aghammissaṃsu,aghammissamsu,1,1,0,0,13
109240,sampatināgate,sampatinagate,1,1,0,0,13
109241,catassotītakālikā,catassotitakalika,1,1,0,0,17
109242,chakālikavibhattividhānaṃ,chakalikavibhattividhanam,1,1,0,0,25
109243,vikaraṇavidhāna,vikaranavidhana,1,1,0,0,15
109244,isuyamu,isuyamu,1,0,1,0,7
109245,asaṃyogantattā,asamyogantatta,1,1,0,0,14
109246,attanopadassa,attanopadassa,1,1,0,0,13
109247,parassapadattameva,parassapadattameva,1,1,0,0,18
109248,payojīyati,payojiyati,2,2,0,0,10
109249,saṅkhipissāma,sankhipissama,1,1,0,0,13
109250,icchīyati,icchiyati,7,7,0,0,9
109251,esīyati,esiyati,2,2,0,0,7
109252,pubbarūpattaṃ,pubbarupattam,22,22,0,0,13
109253,icchatu,icchatu,2,2,0,0,7
109254,esatu,esatu,3,3,0,0,5
109255,eseyya,eseyya,7,7,0,0,6
109256,parokkhāhiyyattanīsu,parokkhahiyyattanisu,1,1,0,0,20
109257,payogamanugamma,payogamanugamma,1,1,0,0,15
109258,payojetabbāni,payojetabbani,1,1,0,0,13
109259,icchi,icchi,92,92,0,0,5
109260,icchissati,icchissati,18,18,0,0,10
109261,esissati,esissati,2,2,0,0,8
109262,icchissā,icchissa,1,1,0,0,8
109263,esissā,esissa,1,1,0,0,6
109264,icchādi,icchadi,2,2,0,0,7
109265,niyacchanti,niyacchanti,4,4,0,0,11
109266,saññamati,sannamati,3,3,0,0,9
109267,saññamanti,sannamanti,3,3,0,0,10
109268,niyacchīyati,niyacchiyati,1,1,0,0,12
109269,niyamīyati,niyamiyati,3,3,0,0,10
109270,niyammati,niyammati,2,2,0,0,9
109271,saññamīyati,sannamiyati,2,2,0,0,11
109272,niyacchatu,niyacchatu,2,2,0,0,10
109273,saññamatu,sannamatu,2,2,0,0,9
109274,niyaccheyya,niyaccheyya,2,2,0,0,11
109275,saññameyya,sannameyya,1,1,0,0,10
109276,niyacchī,niyacchi,1,1,0,0,8
109277,saññamī,sannami,1,1,0,0,7
109278,niyacchissati,niyacchissati,2,2,0,0,13
109279,saññamissati,sannamissati,2,2,0,0,12
109280,niyacchissa,niyacchissa,2,2,0,0,11
109281,saññamissa,sannamissa,1,1,0,0,10
109282,acchanti,acchanti,25,24,1,0,8
109283,acchasi,acchasi,15,15,0,0,7
109284,acchatha,acchatha,5,5,0,0,8
109285,acchāmi,acchami,3,3,0,0,7
109286,acchāma,acchama,3,3,0,0,7
109287,upāsanti,upasanti,11,10,1,0,8
109288,acchīyati,acchiyati,1,1,0,0,9
109289,upāsīyati,upasiyati,1,1,0,0,9
109290,acchatu,acchatu,7,7,0,0,7
109291,upāsatu,upasatu,2,2,0,0,7
109292,accheyya,accheyya,7,7,0,0,8
109293,upāseyya,upaseyya,4,4,0,0,8
109294,acchī,acchi,1,1,0,0,5
109295,upāsī,upasi,1,1,0,0,5
109296,acchissati,acchissati,3,3,0,0,10
109297,upāsissati,upasissati,2,2,0,0,10
109298,acchissa,acchissa,2,2,0,0,8
109299,upāsissa,upasissa,2,2,0,0,8
109300,labhasi,labhasi,31,30,1,0,7
109301,labhatha,labhatha,9,9,0,0,8
109302,labhāmi,labhami,252,251,1,0,7
109303,labhase,labhase,7,6,1,0,7
109304,labhavhe,labhavhe,1,1,0,0,8
109305,labhāmhe,labhamhe,1,1,0,0,8
109306,pubbarūpatte,pubbarupatte,5,5,0,0,12
109307,purima,purima,19,17,2,0,6
109308,labbhataṃ,labbhatam,1,1,0,0,9
109309,labbhatu,labbhatu,5,5,0,0,8
109310,labbhe,labbhe,2,2,0,0,6
109311,īiṃnaṃ,iimnam,1,1,0,0,6
109312,labhi,labhi,257,256,1,0,5
109313,alabhiṃsu,alabhimsu,8,8,0,0,9
109314,labhiṃsu,labhimsu,113,113,0,0,8
109315,alabho,alabho,1,1,0,0,6
109316,labho,labho,10,7,3,0,5
109317,alabhittha,alabhittha,7,7,0,0,10
109318,labhiṃ,labhim,35,33,2,0,6
109319,alabhimha,alabhimha,2,2,0,0,9
109320,labhimha,labhimha,12,12,0,0,8
109321,sappaccaya,sappaccaya,6,1,5,0,10
109322,lacchanti,lacchanti,5,5,0,0,9
109323,lacchasi,lacchasi,45,45,0,0,8
109324,lacchatha,lacchatha,2,2,0,0,9
109325,lacchāmi,lacchami,30,30,0,0,8
109326,lacchāma,lacchama,28,25,3,0,8
109327,labhissanti,labhissanti,20,20,0,0,11
109328,labhissasi,labhissasi,55,55,0,0,10
109329,labhissatha,labhissatha,16,16,0,0,11
109330,labhissāmi,labhissami,121,117,4,0,10
109331,labhissāma,labhissama,50,49,1,0,10
109332,vacatha,vacatha,1,1,0,0,7
109333,vacāmi,vacami,1,1,0,0,6
109334,vacāma,vacama,1,1,0,0,6
109335,dutiyañcettha,dutiyancettha,3,3,0,0,13
109336,kārassapi,karassapi,2,2,0,0,9
109337,purimapakkhe,purimapakkhe,7,7,0,0,12
109338,vacatu,vacatu,2,2,0,0,6
109339,avaccā,avacca,1,1,0,0,6
109340,avaccū,avaccu,1,1,0,0,6
109341,avacaṃ,avacam,73,69,4,0,6
109342,avacamhā,avacamha,1,1,0,0,8
109343,avoci,avoci,4,4,0,0,5
109344,avuccittha,avuccittha,1,1,0,0,10
109345,byañjanantassā,byanjanantassa,2,2,0,0,14
109346,pubbarūpattañca,pubbarupattanca,1,1,0,0,15
109347,vussanti,vussanti,2,2,0,0,8
109348,vasatu,vasatu,17,17,0,0,6
109349,vaseyya,vaseyya,85,82,3,0,7
109350,bhavissantiyaṃ,bhavissantiyam,3,1,2,0,14
109351,vacchanti,vacchanti,2,2,0,0,9
109352,vacchasi,vacchasi,4,4,0,0,8
109353,vacchatha,vacchatha,1,1,0,0,9
109354,vasissanti,vasissanti,17,17,0,0,10
109355,avasissa,avasissa,1,1,0,0,8
109356,avasissaṃsu,avasissamsu,3,3,0,0,11
109357,rodissati,rodissati,10,10,0,0,9
109358,dvittarassattāni,dvittarassattani,4,4,0,0,16
109359,ppaccayavuddhiyo,ppaccayavuddhiyo,1,1,0,0,16
109360,akkosatu,akkosatu,1,1,0,0,8
109361,akkoseyya,akkoseyya,17,14,3,0,9
109362,īvibhattissa,ivibhattissa,2,2,0,0,12
109363,akkosissati,akkosissati,2,2,0,0,11
109364,akkosissa,akkosissa,1,1,0,0,9
109365,gayhatī,gayhati,9,8,1,0,7
109366,nimittabhūtassa,nimittabhutassa,5,5,0,0,15
109367,kārassevetaṃ,karassevetam,1,1,0,0,12
109368,vacavasa,vacavasa,1,1,0,0,8
109369,yhanti,yhanti,1,1,0,0,6
109370,vahatu,vahatu,2,2,0,0,6
109371,vuyhatu,vuyhatu,5,5,0,0,7
109372,vaheyya,vaheyya,18,18,0,0,7
109373,vuyheyya,vuyheyya,4,4,0,0,8
109374,avahī,avahi,1,1,0,0,5
109375,avuyhittha,avuyhittha,2,2,0,0,10
109376,avahittha,avahittha,1,1,0,0,9
109377,avahissati,avahissati,1,1,0,0,10
109378,vuyhissati,vuyhissati,2,2,0,0,10
109379,avahissa,avahissa,1,1,0,0,8
109380,avuyhissa,avuyhissa,1,1,0,0,9
109381,jīrajīyyamīyyā,jirajiyyamiyya,2,0,2,0,14
109382,jaramara,jaramara,1,0,1,0,8
109383,jīyyati,jiyyati,1,1,0,0,7
109384,jīyyanti,jiyyanti,1,1,0,0,8
109385,ekayakārassa,ekayakarassa,1,1,0,0,12
109386,jīrīyati,jiriyati,13,13,0,0,8
109387,jīrīyanti,jiriyanti,1,1,0,0,9
109388,jīyiyyati,jiyiyyati,1,1,0,0,9
109389,jīyiyyanti,jiyiyyanti,1,1,0,0,10
109390,jīratu,jiratu,8,8,0,0,6
109391,jīyyatu,jiyyatu,1,1,0,0,7
109392,jīreyya,jireyya,2,2,0,0,7
109393,jīyyeyya,jiyyeyya,1,1,0,0,8
109394,ajīrī,ajiri,1,1,0,0,5
109395,jīyyī,jiyyi,1,1,0,0,5
109396,jīrissati,jirissati,2,2,0,0,9
109397,jīyyissati,jiyyissati,1,1,0,0,10
109398,ajīrissa,ajirissa,1,1,0,0,8
109399,ajīyyissa,ajiyyissa,1,1,0,0,9
109400,mīyyati,miyyati,1,1,0,0,7
109401,mīyyanti,miyyanti,1,1,0,0,8
109402,mīyanti,miyanti,58,58,0,0,7
109403,pekkhaṇe,pekkhane,7,7,0,0,8
109404,dissā,dissa,1,0,1,0,5
109405,sabbadhātuke,sabbadhatuke,1,1,0,0,12
109406,vipassīyati,vipassiyati,2,2,0,0,11
109407,dakkhīyati,dakkhiyati,3,3,0,0,10
109408,hiyyattaniyaṃ,hiyyattaniyam,5,1,4,0,13
109409,dhātuikārassa,dhatuikarassa,1,1,0,0,13
109410,adissa,adissa,1,1,0,0,6
109411,apassiṃsu,apassimsu,3,3,0,0,9
109412,passittha,passittha,11,11,0,0,9
109413,apassiṃ,apassim,10,9,1,0,7
109414,passiṃ,passim,23,21,2,0,6
109415,apassimha,apassimha,2,2,0,0,9
109416,passimha,passimha,3,3,0,0,8
109417,addasi,addasi,2,2,0,0,6
109418,dasaṃsu,dasamsu,1,1,0,0,7
109419,adissaṃsu,adissamsu,1,1,0,0,9
109420,addakkhiṃsu,addakkhimsu,1,1,0,0,11
109421,dakkhiti,dakkhiti,12,12,0,0,8
109422,dakkhinti,dakkhinti,3,3,0,0,9
109423,dakkhissanti,dakkhissanti,17,17,0,0,12
109424,apassissa,apassissa,2,2,0,0,9
109425,adakkhissa,adakkhissa,1,1,0,0,10
109426,nisajjate,nisajjate,2,2,0,0,9
109427,kvacādhikārena,kvacadhikarena,1,1,0,0,14
109428,nisīde,niside,8,7,1,0,6
109429,nisīdissati,nisidissati,11,11,0,0,11
109430,nisīdissa,nisidissa,1,1,0,0,9
109431,devapūjāsaṅgatikaraṇadānesu,devapujasangatikaranadanesu,4,4,0,0,27
109432,yamhī,yamhi,5,3,2,0,5
109433,yajatu,yajatu,6,6,0,0,6
109434,ijjataṃ,ijjatam,1,1,0,0,7
109435,yaje,yaje,1,1,0,0,4
109436,ijjetha,ijjetha,1,1,0,0,7
109437,ijjittha,ijjittha,2,2,0,0,8
109438,yajissati,yajissati,2,2,0,0,9
109439,ijjissate,ijjissate,3,3,0,0,9
109440,yajissa,yajissa,1,1,0,0,7
109441,ijjissatha,ijjissatha,1,1,0,0,10
109442,vibhatyādhikārattā,vibhatyadhikaratta,1,1,0,0,18
109443,sabbāsūti,sabbasuti,2,2,0,0,9
109444,vikaraṇakāriyavidhippakaraṇato,vikaranakariyavidhippakaranato,2,2,0,0,30
109445,kāroti,karoti,16,10,6,0,6
109446,juhotyādito,juhotyadito,1,1,0,0,11
109447,vavatthitavibhāsatoti,vavatthitavibhasatoti,1,1,0,0,21
109448,dīghaviparītādesalopāgamā,dighaviparitadesalopagama,1,0,1,0,25
109449,dhātvādhikāre,dhatvadhikare,3,3,0,0,13
109450,tyādivibhattīnaṃ,tyadivibhattinam,1,1,0,0,16
109451,dhātuvihitappaccayānañca,dhatuvihitappaccayananca,1,1,0,0,24
109452,dīghatabbiparītaādesalopāgamaiccetāni,dighatabbiparitaadesalopagamaiccetani,1,1,0,0,37
109453,kiyādīnaṃ,kiyadinam,2,2,0,0,9
109454,caññadhātunaṃ,cannadhatunam,1,1,0,0,13
109455,ssāntassa,ssantassa,1,1,0,0,9
109456,cchassa,cchassa,1,1,0,0,7
109457,ñcho,ncho,1,1,0,0,4
109458,gamissajjatanimhi,gamissajjatanimhi,1,1,0,0,17
109459,ucāgamo,ucagamo,1,1,0,0,7
109460,tthamhesu,tthamhesu,1,1,0,0,9
109461,eyyeyyāseyyāmettañca,eyyeyyaseyyamettanca,1,1,0,0,20
109462,ssessettañca,ssessettanca,1,1,0,0,12
109463,attamittañca,attamittanca,1,1,0,0,12
109464,ātthā,attha,1,1,0,0,5
109465,tthathe,tthathe,1,1,0,0,7
109466,brūtoti,brutoti,1,1,0,0,7
109467,antīnaṃ,antinam,2,2,0,0,7
109468,akārettha,akarettha,1,1,0,0,9
109469,vibhattippaccayādi,vibhattippaccayadi,1,1,0,0,18
109470,niccamekārokārato,niccamekarokarato,1,1,0,0,17
109471,paroti,paroti,31,15,16,0,6
109472,antia,antia,1,0,1,0,5
109473,vajjenti,vajjenti,9,9,0,0,8
109474,vadenti,vadenti,12,12,0,0,7
109475,vajjetha,vajjetha,2,2,0,0,8
109476,vajjema,vajjema,2,2,0,0,7
109477,vadema,vadema,15,15,0,0,6
109478,vajjīyati,vajjiyati,2,2,0,0,9
109479,vajjīyanti,vajjiyanti,3,3,0,0,10
109480,vadīyati,vadiyati,7,7,0,0,8
109481,vajjetu,vajjetu,2,2,0,0,7
109482,vadetu,vadetu,8,7,1,0,6
109483,vajjeyyāsi,vajjeyyasi,2,2,0,0,10
109484,avadissa,avadissa,2,2,0,0,8
109485,ggahaṇamantaggahaṇaṃ,ggahanamantaggahanam,1,1,0,0,20
109486,dīnamevetaṃ,dinamevetam,1,1,0,0,11
109487,caṅkamanti,cankamanti,23,22,1,0,10
109488,dalane,dalane,1,1,0,0,6
109489,akāritepi,akaritepi,2,2,0,0,9
109490,visesavidhānaṃ,visesavidhanam,2,2,0,0,14
109491,avuddhikabhūvādinayo,avuddhikabhuvadinayo,1,1,0,0,20
109492,tthānuvattita,tthanuvattita,1,1,0,0,13
109493,tudā,tuda,1,0,1,0,4
109494,tudasi,tudasi,1,1,0,0,6
109495,tudatha,tudatha,1,1,0,0,7
109496,tudāmi,tudami,1,1,0,0,6
109497,tudāma,tudama,1,1,0,0,6
109498,sadakārassa,sadakarassa,1,1,0,0,11
109499,tujjante,tujjante,1,1,0,0,8
109500,tujjanti,tujjanti,2,2,0,0,8
109501,tujjare,tujjare,3,3,0,0,7
109502,tudatu,tudatu,2,2,0,0,6
109503,tudantu,tudantu,2,2,0,0,7
109504,tude,tude,1,1,0,0,4
109505,tudeyya,tudeyya,2,2,0,0,7
109506,tudeyyuṃ,tudeyyum,1,1,0,0,8
109507,atudi,atudi,3,3,0,0,5
109508,tudiṃsu,tudimsu,2,2,0,0,7
109509,atudittha,atudittha,1,1,0,0,9
109510,atudiṃ,atudim,1,1,0,0,6
109511,atudimha,atudimha,1,1,0,0,8
109512,atujjittha,atujjittha,1,1,0,0,10
109513,atujji,atujji,2,2,0,0,6
109514,tudissati,tudissati,2,2,0,0,9
109515,atudissa,atudissa,2,2,0,0,8
109516,pavisasi,pavisasi,3,3,0,0,8
109517,pavisatha,pavisatha,20,20,0,0,9
109518,pavisāmi,pavisami,28,28,0,0,8
109519,pavisāma,pavisama,5,5,0,0,8
109520,pavisiyyate,pavisiyyate,1,1,0,0,11
109521,pavisiyyante,pavisiyyante,1,1,0,0,12
109522,pavisiyyati,pavisiyyati,1,1,0,0,11
109523,pavisiyyanti,pavisiyyanti,1,1,0,0,12
109524,pavissate,pavissate,2,2,0,0,9
109525,pavisantu,pavisantu,5,5,0,0,9
109526,paviseyya,paviseyya,77,69,8,0,9
109527,pavisi,pavisi,9,9,0,0,6
109528,vekkhādeso,vekkhadeso,1,1,0,0,10
109529,pāvisiṃsu,pavisimsu,12,12,0,0,9
109530,pavisiṃsu,pavisimsu,149,149,0,0,9
109531,pāvisīyittha,pavisiyittha,1,1,0,0,12
109532,pavisīyittha,pavisiyittha,1,1,0,0,12
109533,pāvisīyi,pavisiyi,2,2,0,0,8
109534,pavisīyi,pavisiyi,1,1,0,0,8
109535,pavisissanti,pavisissanti,18,18,0,0,12
109536,pavisīyissate,pavisiyissate,1,1,0,0,13
109537,pavisissate,pavisissate,1,1,0,0,11
109538,pāvisissa,pavisissa,2,2,0,0,9
109539,pāvisīyissa,pavisiyissa,2,2,0,0,11
109540,tisajjane,tisajjane,1,1,0,0,9
109541,uddisanti,uddisanti,119,117,2,0,9
109542,tudādinayo,tudadinayo,2,2,0,0,10
109543,appaccayassa,appaccayassa,4,4,0,0,12
109544,anakāraparattā,anakaraparatta,1,1,0,0,14
109545,hūyataṃ,huyatam,2,2,0,0,7
109546,hūyetha,huyetha,2,2,0,0,7
109547,ahūyattha,ahuyattha,1,1,0,0,9
109548,ahosittha,ahosittha,2,2,0,0,9
109549,ahosimha,ahosimha,3,3,0,0,8
109550,ahūyittha,ahuyittha,2,2,0,0,9
109551,hohe,hohe,1,0,1,0,4
109552,eha,eha,1,0,1,0,3
109553,hehitha,hehitha,1,1,0,0,7
109554,hehāmi,hehami,1,1,0,0,6
109555,hehāma,hehama,1,1,0,0,6
109556,hehissatha,hehissatha,1,1,0,0,10
109557,hehissāmi,hehissami,1,1,0,0,9
109558,hehissāma,hehissama,1,1,0,0,9
109559,ohādese,ohadese,1,0,1,0,7
109560,hohitha,hohitha,1,1,0,0,7
109561,hohāmi,hohami,1,1,0,0,6
109562,hohāma,hohama,1,1,0,0,6
109563,hohissatha,hohissatha,1,1,0,0,10
109564,hohissāmi,hohissami,1,1,0,0,9
109565,hohissāma,hohissama,1,1,0,0,9
109566,ekārādese,ekaradese,1,0,1,0,9
109567,hemi,hemi,1,1,0,0,4
109568,hūyissate,huyissate,1,1,0,0,9
109569,ahavissa,ahavissa,1,1,0,0,8
109570,ahavissaṃsu,ahavissamsu,2,2,0,0,11
109571,ahuyissatha,ahuyissatha,2,2,0,0,11
109572,lopavuddhiyo,lopavuddhiyo,3,3,0,0,12
109573,anubhonti,anubhonti,37,35,2,0,9
109574,anubhotha,anubhotha,5,5,0,0,9
109575,anubhomi,anubhomi,102,100,2,0,8
109576,anubhoma,anubhoma,6,6,0,0,8
109577,anubhotu,anubhotu,2,2,0,0,8
109578,anubhontu,anubhontu,7,6,1,0,9
109579,anubhohi,anubhohi,6,6,0,0,8
109580,anubhave,anubhave,4,3,1,0,8
109581,anubhaveyya,anubhaveyya,5,5,0,0,11
109582,anubhavi,anubhavi,27,27,0,0,8
109583,anubhossanti,anubhossanti,2,2,0,0,12
109584,anubhossasi,anubhossasi,6,6,0,0,11
109585,anubhossatha,anubhossatha,1,1,0,0,12
109586,anubhossāmi,anubhossami,1,1,0,0,11
109587,anubhossāma,anubhossama,1,1,0,0,11
109588,anubhossa,anubhossa,1,1,0,0,9
109589,anubhavissa,anubhavissa,1,1,0,0,11
109590,setha,setha,2,2,0,0,5
109591,sema,sema,2,2,0,0,4
109592,sente,sente,1,1,0,0,5
109593,sayasi,sayasi,5,5,0,0,6
109594,sayatha,sayatha,2,2,0,0,7
109595,sayāma,sayama,3,3,0,0,6
109596,dhātvā,dhatva,6,6,0,0,6
109597,rassasarassa,rassasarassa,1,1,0,0,12
109598,atisīyate,atisiyate,1,1,0,0,9
109599,atisīyante,atisiyante,1,1,0,0,10
109600,atisīyati,atisiyati,2,2,0,0,9
109601,atisīyanti,atisiyanti,3,3,0,0,10
109602,sīyate,siyate,3,3,0,0,6
109603,sayatu,sayatu,7,7,0,0,6
109604,sayantu,sayantu,1,1,0,0,7
109605,saya,saya,15,13,2,0,4
109606,sayāhi,sayahi,2,2,0,0,6
109607,sayataṃ,sayatam,1,1,0,0,7
109608,sayassu,sayassu,1,1,0,0,7
109609,sayāmase,sayamase,1,1,0,0,8
109610,atisīyataṃ,atisiyatam,1,1,0,0,10
109611,atisīyantaṃ,atisiyantam,1,1,0,0,11
109612,atisīyatu,atisiyatu,1,1,0,0,9
109613,atisīyantu,atisiyantu,1,1,0,0,10
109614,sīyataṃ,siyatam,1,1,0,0,7
109615,sayeyya,sayeyya,32,32,0,0,7
109616,sayeyyuṃ,sayeyyum,4,4,0,0,8
109617,atisīyeyya,atisiyeyya,1,1,0,0,10
109618,sīyetha,siyetha,1,1,0,0,7
109619,asayi,asayi,2,2,0,0,5
109620,asayiṃsu,asayimsu,1,1,0,0,8
109621,sayiṃsu,sayimsu,15,15,0,0,7
109622,asayuṃ,asayum,1,1,0,0,6
109623,sāgame,sagame,3,3,0,0,6
109624,atisesi,atisesi,1,1,0,0,7
109625,atisesuṃ,atisesum,1,1,0,0,8
109626,accasīyittha,accasiyittha,1,1,0,0,12
109627,accasīyi,accasiyi,1,1,0,0,8
109628,atisīyi,atisiyi,1,1,0,0,7
109629,sīyittha,siyittha,1,1,0,0,8
109630,sayissati,sayissati,3,3,0,0,9
109631,sayissanti,sayissanti,2,2,0,0,10
109632,sessati,sessati,2,2,0,0,7
109633,sessanti,sessanti,1,1,0,0,8
109634,atisīyissatha,atisiyissatha,1,1,0,0,13
109635,atisīyissati,atisiyissati,1,1,0,0,12
109636,sīyissate,siyissate,1,1,0,0,9
109637,asayissā,asayissa,1,1,0,0,8
109638,asayissaṃsu,asayissamsu,1,1,0,0,11
109639,accasīyissatha,accasiyissatha,1,1,0,0,14
109640,nesi,nesi,43,43,0,0,4
109641,netha,netha,10,10,0,0,5
109642,nema,nema,1,1,0,0,4
109643,nīyare,niyare,5,5,0,0,6
109644,nīyante,niyante,1,1,0,0,7
109645,nīyanti,niyanti,50,47,3,0,7
109646,nayatu,nayatu,1,1,0,0,6
109647,nīyataṃ,niyatam,3,3,0,0,7
109648,nīyantaṃ,niyantam,5,5,0,0,8
109649,nīyetha,niyetha,8,7,1,0,7
109650,nīyeyya,niyeyya,2,2,0,0,7
109651,anayi,anayi,2,2,0,0,5
109652,nayi,nayi,11,11,0,0,4
109653,anayiṃsu,anayimsu,2,2,0,0,8
109654,vinesuṃ,vinesum,3,3,0,0,7
109655,anīyittha,aniyittha,2,2,0,0,9
109656,nīyittha,niyittha,1,1,0,0,8
109657,nayissati,nayissati,4,4,0,0,9
109658,nessati,nessati,6,6,0,0,7
109659,nayissate,nayissate,1,1,0,0,9
109660,nīyissate,niyissate,1,1,0,0,9
109661,nīyissati,niyissati,2,2,0,0,9
109662,anayissa,anayissa,1,1,0,0,8
109663,anīyissa,aniyissa,1,1,0,0,8
109664,adhiṭṭhenti,adhitthenti,5,5,0,0,11
109665,dādhā,dadha,4,2,2,0,5
109666,hāpā,hapa,1,0,1,0,4
109667,īkāramāpajjate,ikaramapajjate,1,1,0,0,14
109668,upaṭṭhīyanti,upatthiyanti,2,2,0,0,12
109669,patiṭṭhahīyati,patitthahiyati,2,2,0,0,14
109670,patiṭṭhahīyanti,patitthahiyanti,2,2,0,0,15
109671,ṭhantu,thantu,2,2,0,0,6
109672,saṇṭhahatu,santhahatu,2,2,0,0,10
109673,saṇṭhahantu,santhahantu,1,1,0,0,11
109674,saṇṭhe,santhe,2,2,0,0,6
109675,saṇṭheyya,santheyya,2,2,0,0,9
109676,saṇṭheyyuṃ,santheyyum,2,2,0,0,10
109677,saṇṭhahe,santhahe,2,2,0,0,8
109678,saṇṭhaheyyuṃ,santhaheyyum,2,2,0,0,12
109679,saṇṭhahi,santhahi,9,9,0,0,8
109680,pakiṭṭhissati,pakitthissati,1,1,0,0,13
109681,patiṭṭhissanti,patitthissanti,1,1,0,0,14
109682,ṭhassanti,thassanti,44,44,0,0,9
109683,patiṭṭhahissati,patitthahissati,24,24,0,0,15
109684,patiṭṭhahissanti,patitthahissanti,5,5,0,0,16
109685,patiṭṭhissa,patitthissa,2,2,0,0,11
109686,patiṭṭhissaṃsu,patitthissamsu,1,1,0,0,14
109687,patiṭṭhahissa,patitthahissa,5,5,0,0,13
109688,patiṭṭhahissaṃsu,patitthahissamsu,1,1,0,0,16
109689,pibo,pibo,2,1,1,0,4
109690,pibā,piba,2,0,2,0,4
109691,pibati,pibati,4,4,0,0,6
109692,pibatu,pibatu,1,1,0,0,6
109693,pibeyya,pibeyya,2,2,0,0,7
109694,pīyante,piyante,1,1,0,0,7
109695,pīyanti,piyanti,4,4,0,0,7
109696,apāyi,apayi,7,7,0,0,5
109697,pivi,pivi,58,58,0,0,4
109698,apivissa,apivissa,1,1,0,0,8
109699,vibhattuppatti,vibhattuppatti,11,11,0,0,14
109700,parassati,parassati,2,2,0,0,9
109701,sabbatthāsassādi,sabbatthasassadi,1,0,1,0,16
109702,mhimhāntalopo,mhimhantalopo,1,0,1,0,13
109703,iccetāsaṃ,iccetasam,1,1,0,0,9
109704,mhimha,mhimha,1,0,1,0,6
109705,ssādilopo,ssadilopo,2,2,0,0,9
109706,eyyaeyyuṃ,eyyaeyyum,1,0,1,0,9
109707,iyāiyu,iyaiyu,1,0,1,0,6
109708,sadhātvantānaṃ,sadhatvantanam,1,1,0,0,14
109709,vamassa,vamassa,1,1,0,0,7
109710,ajjataniyaṃ,ajjataniyam,3,0,3,0,11
109711,āsimha,asimha,2,2,0,0,6
109712,asassā,asassa,2,2,0,0,6
109713,suttānuvattitavāggahaṇena,suttanuvattitavaggahanena,1,1,0,0,25
109714,ūkārassa,ukarassa,4,4,0,0,8
109715,bruvavhe,bruvavhe,1,1,0,0,8
109716,brūmhe,brumhe,1,1,0,0,6
109717,abruvā,abruva,1,1,0,0,6
109718,abruvū,abruvu,1,1,0,0,6
109719,māha,maha,53,53,0,0,4
109720,abruvi,abruvi,4,4,0,0,6
109721,bravissati,bravissati,2,2,0,0,10
109722,abravissa,abravissa,2,2,0,0,9
109723,hanāmi,hanami,10,10,0,0,6
109724,hanāma,hanama,11,10,1,0,6
109725,haññare,hannare,15,15,0,0,7
109726,hanassā,hanassa,1,1,0,0,7
109727,vadhīyati,vadhiyati,3,3,0,0,9
109728,vadhetu,vadhetu,1,1,0,0,7
109729,vadhīyatu,vadhiyatu,1,1,0,0,9
109730,vadheyya,vadheyya,1,1,0,0,8
109731,avadhiṃsu,avadhimsu,5,4,1,0,9
109732,ahaniṃsu,ahanimsu,2,2,0,0,8
109733,vadhissati,vadhissati,8,8,0,0,10
109734,hanissati,hanissati,8,8,0,0,9
109735,avadhissa,avadhissa,1,1,0,0,9
109736,ahanissa,ahanissa,1,1,0,0,8
109737,hūvādinayo,huvadinayo,1,1,0,0,10
109738,lopañcetta,lopancetta,1,1,0,0,10
109739,saññānaṃ,sannanam,40,37,3,0,8
109740,kāravakārādesā,karavakaradesa,1,1,0,0,14
109741,apadantassa,apadantassa,2,2,0,0,11
109742,juhvanti,juhvanti,2,2,0,0,8
109743,juhonti,juhonti,3,3,0,0,7
109744,juhvasi,juhvasi,2,2,0,0,7
109745,juhosi,juhosi,2,2,0,0,6
109746,juhvatha,juhvatha,2,2,0,0,8
109747,juhotha,juhotha,2,2,0,0,7
109748,juhvāmi,juhvami,1,1,0,0,7
109749,juhomi,juhomi,1,1,0,0,6
109750,juhvāma,juhvama,1,1,0,0,7
109751,juhoma,juhoma,1,1,0,0,6
109752,hūyante,huyante,1,1,0,0,7
109753,hūyati,huyati,3,3,0,0,6
109754,hūyanti,huyanti,1,1,0,0,7
109755,juhotu,juhotu,2,2,0,0,6
109756,juhontu,juhontu,2,2,0,0,7
109757,juhvantu,juhvantu,1,1,0,0,8
109758,juhe,juhe,5,4,1,0,4
109759,juheyya,juheyya,2,2,0,0,7
109760,juheyyuṃ,juheyyum,1,1,0,0,8
109761,ajuhavi,ajuhavi,2,2,0,0,7
109762,ajuhavuṃ,ajuhavum,2,2,0,0,8
109763,ajuhosi,ajuhosi,2,2,0,0,7
109764,ajuhosuṃ,ajuhosum,2,2,0,0,8
109765,juhissati,juhissati,2,2,0,0,9
109766,juhissanti,juhissanti,2,2,0,0,10
109767,juhossati,juhossati,1,1,0,0,9
109768,juhossanti,juhossanti,1,1,0,0,10
109769,ajuhissa,ajuhissa,2,2,0,0,8
109770,ajuhissaṃsu,ajuhissamsu,1,1,0,0,11
109771,ppaccayalopā,ppaccayalopa,1,1,0,0,12
109772,jahāsi,jahasi,15,14,1,0,6
109773,jahātha,jahatha,3,3,0,0,7
109774,jahāmi,jahami,12,12,0,0,6
109775,dādhāmāṭhāhāpāmahamathādīnamī,dadhamathahapamahamathadinami,1,1,0,0,29
109776,hīyate,hiyate,2,2,0,0,6
109777,hīyante,hiyante,1,1,0,0,7
109778,hīyare,hiyare,3,3,0,0,6
109779,hīyanti,hiyanti,1,1,0,0,7
109780,jahātu,jahatu,2,2,0,0,6
109781,jaheyya,jaheyya,30,29,1,0,7
109782,jaheyyuṃ,jaheyyum,4,4,0,0,8
109783,hīyetha,hiyetha,2,2,0,0,7
109784,hīyeyya,hiyeyya,1,1,0,0,7
109785,ajahāsi,ajahasi,2,2,0,0,7
109786,ajahiṃsu,ajahimsu,2,2,0,0,8
109787,ajahāsuṃ,ajahasum,1,1,0,0,8
109788,pajahiṃsu,pajahimsu,30,29,1,0,9
109789,pajahaṃsu,pajahamsu,1,1,0,0,9
109790,pajahuṃ,pajahum,2,2,0,0,7
109791,pajahīyittha,pajahiyittha,1,1,0,0,12
109792,pajahīyi,pajahiyi,1,1,0,0,8
109793,pajahissati,pajahissati,13,13,0,0,11
109794,pajahissanti,pajahissanti,16,16,0,0,12
109795,hīyissati,hiyissati,1,1,0,0,9
109796,hīyissanti,hiyissanti,1,1,0,0,10
109797,pajahissa,pajahissa,1,1,0,0,9
109798,pajahissaṃsu,pajahissamsu,1,1,0,0,12
109799,dvebhāvarassattāni,dvebhavarassattani,1,1,0,0,18
109800,dajjasi,dajjasi,2,2,0,0,7
109801,dajjatha,dajjatha,2,2,0,0,8
109802,dīyanti,diyanti,5,5,0,0,7
109803,dīyyate,diyyate,1,1,0,0,7
109804,dīyyante,diyyante,1,1,0,0,8
109805,dīyyanti,diyyanti,1,1,0,0,8
109806,dadataṃ,dadatam,10,8,2,0,7
109807,dadassu,dadassu,1,1,0,0,7
109808,dadavho,dadavho,1,1,0,0,7
109809,dajjatu,dajjatu,2,2,0,0,7
109810,dajjantu,dajjantu,2,2,0,0,8
109811,dīyataṃ,diyatam,1,1,0,0,7
109812,dīyantaṃ,diyantam,1,1,0,0,8
109813,dīyantu,diyantu,1,1,0,0,7
109814,dajje,dajje,6,6,0,0,5
109815,eyyassāttañca,eyyassattanca,1,1,0,0,13
109816,dajjeyyuṃ,dajjeyyum,4,4,0,0,9
109817,dajjeyyāsi,dajjeyyasi,1,1,0,0,10
109818,dajjeyyātha,dajjeyyatha,3,3,0,0,11
109819,eyyāmissa,eyyamissa,1,1,0,0,9
109820,amādeso,amadeso,3,3,0,0,7
109821,dajjeyyāmi,dajjeyyami,1,1,0,0,10
109822,dajjeyyāma,dajjeyyama,3,3,0,0,10
109823,deyya,deyya,5,5,0,0,5
109824,deyyuṃ,deyyum,2,2,0,0,6
109825,deyyāsi,deyyasi,4,4,0,0,7
109826,deyyātha,deyyatha,3,3,0,0,8
109827,dīyetha,diyetha,1,1,0,0,7
109828,dīyeyya,diyeyya,1,1,0,0,7
109829,adīyittha,adiyittha,3,3,0,0,9
109830,adajji,adajji,4,4,0,0,6
109831,adajjiṃsu,adajjimsu,2,2,0,0,9
109832,adittha,adittha,1,1,0,0,7
109833,adāsimha,adasimha,5,5,0,0,8
109834,adamha,adamha,32,31,1,0,6
109835,adādānaṃ,adadanam,1,1,0,0,8
109836,adīyyi,adiyyi,1,1,0,0,6
109837,dajjissati,dajjissati,3,3,0,0,10
109838,dajjissanti,dajjissanti,3,3,0,0,11
109839,dassasi,dassasi,43,41,2,0,7
109840,dassatha,dassatha,23,23,0,0,8
109841,dassate,dassate,1,1,0,0,7
109842,dīyissate,diyissate,1,1,0,0,9
109843,dīyissati,diyissati,1,1,0,0,9
109844,adadissa,adadissa,1,1,0,0,8
109845,adajjissa,adajjissa,2,2,0,0,9
109846,adajjissā,adajjissa,1,1,0,0,9
109847,adassa,adassa,5,5,0,0,6
109848,adīyissatha,adiyissatha,1,1,0,0,11
109849,adīyissa,adiyissa,1,1,0,0,8
109850,appaccayalopo,appaccayalopo,1,1,0,0,13
109851,apipubbo,apipubbo,1,1,0,0,8
109852,dvebhāvābhāve,dvebhavabhave,1,1,0,0,13
109853,nidhenti,nidhenti,6,6,0,0,8
109854,dadhātu,dadhatu,1,1,0,0,7
109855,pidahatu,pidahatu,2,2,0,0,8
109856,nidhetu,nidhetu,2,2,0,0,7
109857,nidhentu,nidhentu,2,2,0,0,8
109858,dadhe,dadhe,2,2,0,0,5
109859,dadheyya,dadheyya,2,2,0,0,8
109860,pidahe,pidahe,2,2,0,0,6
109861,pidaheyya,pidaheyya,15,15,0,0,9
109862,nidhe,nidhe,1,1,0,0,5
109863,nidheyya,nidheyya,2,2,0,0,8
109864,dadhāsi,dadhasi,2,2,0,0,7
109865,pidahi,pidahi,34,34,0,0,6
109866,pidahissati,pidahissati,2,2,0,0,11
109867,paridahessati,paridahessati,5,5,0,0,13
109868,adhassa,adhassa,2,2,0,0,7
109869,pidahissa,pidahissa,2,2,0,0,9
109870,juhotyādinayo,juhotyadinayo,1,1,0,0,13
109871,tudādī,tudadi,1,1,0,0,6
109872,hūvādi,huvadi,1,1,0,0,6
109873,tathāparo,tathaparo,12,12,0,0,9
109874,juhotyādi,juhotyadi,1,1,0,0,9
109875,catuddhevaṃ,catuddhevam,4,4,0,0,11
109876,rudhādigaṇa,rudhadigana,3,3,0,0,11
109877,dhātusaññādimhi,dhatusannadimhi,1,1,0,0,15
109878,niggahītapubbañca,niggahitapubbanca,1,0,1,0,17
109879,sarānugatattā,saranugatatta,1,1,0,0,13
109880,dhātussarato,dhatussarato,1,1,0,0,12
109881,iīeo,iieo,1,0,1,0,4
109882,tadāgamassa,tadagamassa,1,1,0,0,11
109883,rundhasi,rundhasi,1,1,0,0,8
109884,rundhatha,rundhatha,3,3,0,0,9
109885,rundhāmi,rundhami,2,2,0,0,8
109886,rundhāma,rundhama,2,2,0,0,8
109887,rundhate,rundhate,1,1,0,0,8
109888,rundhante,rundhante,1,1,0,0,9
109889,kārādippaccayesu,karadippaccayesu,2,2,0,0,16
109890,rundhotītipi,rundhotitipi,1,1,0,0,12
109891,yappaccayassa,yappaccayassa,2,2,0,0,13
109892,jhakāre,jhakare,1,1,0,0,7
109893,nirujjhate,nirujjhate,1,1,0,0,10
109894,nirujjhante,nirujjhante,6,6,0,0,11
109895,nirujjhasi,nirujjhasi,1,1,0,0,10
109896,nirujjhatha,nirujjhatha,1,1,0,0,11
109897,nirujjhāmi,nirujjhami,1,1,0,0,10
109898,nirujjhāma,nirujjhama,1,1,0,0,10
109899,rundhatu,rundhatu,2,2,0,0,8
109900,rundhantu,rundhantu,2,2,0,0,9
109901,rundhāhi,rundhahi,2,2,0,0,8
109902,rundhataṃ,rundhatam,1,1,0,0,9
109903,rundhantaṃ,rundhantam,8,7,1,0,10
109904,rundhassu,rundhassu,1,1,0,0,9
109905,rundhavho,rundhavho,1,1,0,0,9
109906,rundhe,rundhe,4,4,0,0,6
109907,rundhāmase,rundhamase,1,1,0,0,10
109908,nirujjhataṃ,nirujjhatam,1,1,0,0,11
109909,nirujjhantaṃ,nirujjhantam,5,5,0,0,12
109910,nirujjhatu,nirujjhatu,4,4,0,0,10
109911,nirujjhantu,nirujjhantu,2,2,0,0,11
109912,rundheyya,rundheyya,4,4,0,0,9
109913,rundheyyuṃ,rundheyyum,1,1,0,0,10
109914,rundhetha,rundhetha,1,1,0,0,9
109915,rundheraṃ,rundheram,1,1,0,0,9
109916,nirujjhetha,nirujjhetha,1,1,0,0,11
109917,nirujjheyya,nirujjheyya,18,18,0,0,11
109918,rundhi,rundhi,4,4,0,0,6
109919,rundhiṃsu,rundhimsu,2,2,0,0,9
109920,arundhi,arundhi,2,2,0,0,7
109921,nirujjhittha,nirujjhittha,899,899,0,0,12
109922,nirujjhi,nirujjhi,7,7,0,0,8
109923,nirujjhiṃsu,nirujjhimsu,2,2,0,0,11
109924,rundhissati,rundhissati,2,2,0,0,11
109925,rundhissanti,rundhissanti,1,1,0,0,12
109926,nirujjhissate,nirujjhissate,1,1,0,0,13
109927,nirujjhissante,nirujjhissante,1,1,0,0,14
109928,nirujjhissati,nirujjhissati,1594,1590,4,0,13
109929,nirujjhissanti,nirujjhissanti,287,287,0,0,14
109930,arundhissa,arundhissa,2,2,0,0,10
109931,arundhissaṃsu,arundhissamsu,2,2,0,0,13
109932,nirujjhissatha,nirujjhissatha,1,1,0,0,14
109933,nirujjhissa,nirujjhissa,2,2,0,0,11
109934,chindanti,chindanti,139,138,1,0,9
109935,chijjate,chijjate,6,5,1,0,8
109936,chijjante,chijjante,5,5,0,0,9
109937,chijjanti,chijjanti,32,32,0,0,9
109938,chindatu,chindatu,6,6,0,0,8
109939,chindantu,chindantu,10,10,0,0,9
109940,chijjatu,chijjatu,4,4,0,0,8
109941,chijjantu,chijjantu,8,7,1,0,9
109942,chinde,chinde,30,25,5,0,6
109943,chindeyya,chindeyya,117,117,0,0,9
109944,chijjeyya,chijjeyya,6,6,0,0,9
109945,achindi,achindi,3,3,0,0,7
109946,chindiṃsu,chindimsu,21,21,0,0,9
109947,achijjittha,achijjittha,1,1,0,0,11
109948,chijji,chijji,24,24,0,0,6
109949,chindissanti,chindissanti,6,6,0,0,12
109950,chādese,chadese,1,1,0,0,7
109951,checchanti,checchanti,2,2,0,0,10
109952,checchiti,checchiti,1,1,0,0,9
109953,chijjissate,chijjissate,1,1,0,0,11
109954,chijjissante,chijjissante,1,1,0,0,12
109955,chijjissati,chijjissati,3,3,0,0,11
109956,chijjissanti,chijjissanti,3,3,0,0,12
109957,achindissa,achindissa,1,1,0,0,10
109958,achijjissa,achijjissa,1,1,0,0,10
109959,bhindanti,bhindanti,46,45,1,0,9
109960,yuñjatu,yunjatu,1,1,0,0,7
109961,yujjataṃ,yujjatam,1,1,0,0,8
109962,yuñje,yunje,1,1,0,0,5
109963,yujjetha,yujjetha,1,1,0,0,8
109964,ayuñji,ayunji,1,1,0,0,6
109965,ayuñjiṃsu,ayunjimsu,1,1,0,0,9
109966,ayujjittha,ayujjittha,2,2,0,0,10
109967,ayujji,ayujji,1,1,0,0,6
109968,yuñjissati,yunjissati,1,1,0,0,10
109969,yuñjissanti,yunjissanti,1,1,0,0,11
109970,yujjissate,yujjissate,1,1,0,0,10
109971,yujjissante,yujjissante,1,1,0,0,11
109972,yujjissanti,yujjissanti,1,1,0,0,11
109973,ayuñjissa,ayunjissa,1,1,0,0,9
109974,ayujjissatha,ayujjissatha,1,1,0,0,12
109975,ayujjissa,ayujjissa,1,1,0,0,9
109976,bhujato,bhujato,1,1,0,0,7
109977,khādeso,khadeso,2,2,0,0,7
109978,bhokkhanti,bhokkhanti,3,3,0,0,10
109979,bhokkhasi,bhokkhasi,2,2,0,0,9
109980,bhokkhatha,bhokkhatha,2,2,0,0,10
109981,bhokkhāmi,bhokkhami,2,2,0,0,9
109982,bhokkhāma,bhokkhama,4,4,0,0,9
109983,khādesābhāve,khadesabhave,1,1,0,0,12
109984,bhuñjissanti,bhunjissanti,28,28,0,0,12
109985,muccante,muccante,7,7,0,0,8
109986,muñcatu,muncatu,20,20,0,0,7
109987,muñcantu,muncantu,6,6,0,0,8
109988,muccataṃ,muccatam,1,1,0,0,8
109989,muccantaṃ,muccantam,2,2,0,0,9
109990,muñce,munce,6,6,0,0,5
109991,muñceyya,munceyya,29,28,1,0,8
109992,muñceyyuṃ,munceyyum,10,9,1,0,9
109993,muccetha,muccetha,1,1,0,0,8
109994,mucceraṃ,mucceram,1,1,0,0,8
109995,amuñci,amunci,3,3,0,0,6
109996,amuñciṃsu,amuncimsu,2,2,0,0,9
109997,amuccittha,amuccittha,1,1,0,0,10
109998,muñcissati,muncissati,5,5,0,0,10
109999,muñcissanti,muncissanti,2,2,0,0,11
