270000,V1.0012,V1.0012,34,34,0,0,7
270001,pariyantapārisuddhisīlādivasena,pariyantaparisuddhisiladivasena,1,1,0,0,31
270002,pariyantapārisuddhisīlaṃ,pariyantaparisuddhisilam,10,7,3,0,24
270003,apariyantapārisuddhisīlaṃ,apariyantaparisuddhisilam,9,7,2,0,25
270004,paripuṇṇapārisuddhisīlaṃ,paripunnaparisuddhisilam,7,6,1,0,24
270005,aparāmaṭṭhapārisuddhisīlaṃ,aparamatthaparisuddhisilam,7,6,1,0,26
270006,paṭippassaddhipārisuddhisīlaṃ,patippassaddhiparisuddhisilam,6,5,1,0,29
270007,pahānaveramaṇīcetanāsaṃvarāvītikkamavasena,pahanaveramanicetanasamvaravitikkamavasena,1,1,0,0,42
270008,ekavidhakoṭṭhāse,ekavidhakotthase,1,1,0,0,16
270009,duvidhakoṭṭhāse,duvidhakotthase,3,1,2,0,15
270010,paññattasikkhāpadapūraṇaṃ,pannattasikkhapadapuranam,2,1,1,0,25
270011,paṭikkhittassa,patikkhittassa,10,9,1,0,14
270012,paripūrakāritāya,paripurakaritaya,17,16,1,0,16
270013,saddhāvīriyasādhanaṃ,saddhaviriyasadhanam,2,1,1,0,20
270014,saddhāsādhanaṃ,saddhasadhanam,2,1,1,0,14
270015,dutiyaduke,dutiyaduke,5,5,0,0,10
270016,abhisamācāroti,abhisamacaroti,4,2,2,0,14
270017,uttamasamācāro,uttamasamacaro,4,3,1,0,14
270018,abhisamācāro,abhisamacaro,6,6,0,0,12
270019,abhisamācāraṃ,abhisamacaram,4,4,0,0,13
270020,ājīvaṭṭhamakato,ajivatthamakato,1,1,0,0,15
270021,avasesasīlassetaṃ,avasesasilassetam,1,1,0,0,17
270022,maggabrahmacariyassa,maggabrahmacariyassa,63,59,4,0,20
270023,ādibhāvabhūtanti,adibhavabhutanti,1,1,0,0,16
270024,ādibhāvabhūtaṃ,adibhavabhutam,3,2,1,0,14
270025,parisodhetabbato,parisodhetabbato,1,1,0,0,16
270026,suparisuddho,suparisuddho,26,24,2,0,12
270027,khuddānukhuddakānīti,khuddanukhuddakaniti,3,1,2,0,20
270028,ābhisamācārikasīlaṃ,abhisamacarikasilam,11,9,2,0,19
270029,khandhakavattapariyāpannaṃ,khandhakavattapariyapannam,4,4,0,0,26
270030,aparipūretvā,aparipuretva,20,20,0,0,12
270031,paripūressatīti,paripuressatiti,7,7,0,0,15
270032,veramaṇimattaṃ,veramanimattam,2,1,1,0,14
270033,viratisīlaṃ,viratisilam,3,1,2,0,11
270034,cetanādi,cetanadi,1,1,0,0,8
270035,aviratisīlaṃ,aviratisilam,1,0,1,0,12
270036,catutthaduke,catutthaduke,10,8,2,0,12
270037,taṇhānissayo,tanhanissayo,26,23,3,0,12
270038,diṭṭhinissayo,ditthinissayo,27,22,5,0,13
270039,V1.0013,V1.0013,34,34,0,0,7
270040,taṇhānissitaṃ,tanhanissitam,4,1,3,0,13
270041,suddhī,suddhi,68,55,13,0,6
270042,suddhidiṭṭhiyā,suddhiditthiya,2,2,0,0,14
270043,diṭṭhinissitaṃ,ditthinissitam,1,0,1,0,14
270044,lokiyañca,lokiyanca,36,31,5,0,9
270045,sambhārabhūtaṃ,sambharabhutam,4,4,0,0,14
270046,anissitaṃ,anissitam,19,14,5,0,9
270047,pañcamaduke,pancamaduke,3,3,0,0,11
270048,kālaparicchedaṃ,kalaparicchedam,34,32,2,0,15
270049,kālapariyantaṃ,kalapariyantam,3,0,3,0,14
270050,chaṭṭhaduke,chatthaduke,6,5,1,0,11
270051,lābhayasañātiaṅgajīvitavasena,labhayasanatiangajivitavasena,2,2,0,0,29
270052,diṭṭhapariyantaṃ,ditthapariyantam,1,1,0,0,16
270053,sapariyantaṃ,sapariyantam,5,4,1,0,12
270054,lābhapariyantaṃ,labhapariyantam,13,12,1,0,15
270055,yasapariyantaṃ,yasapariyantam,7,7,0,0,14
270056,ñātipariyantaṃ,natipariyantam,7,7,0,0,14
270057,aṅgapariyantaṃ,angapariyantam,7,7,0,0,14
270058,lābhahetu,labhahetu,23,23,0,0,9
270059,lābhapaccayā,labhapaccaya,11,11,0,0,12
270060,yathāsamādinnaṃ,yathasamadinnam,23,21,2,0,15
270061,apariyantavissajjanepi,apariyantavissajjanepi,1,1,0,0,22
270062,vītikkamāya,vitikkamaya,7,7,0,0,11
270063,vītikkamissati,vitikkamissati,6,6,0,0,14
270064,etenevupāyena,etenevupayena,24,23,1,0,13
270065,sattamaduke,sattamaduke,1,1,0,0,11
270066,bhavavisesāvahaṃ,bhavavisesavaham,1,1,0,0,16
270067,bhavanissaraṇassa,bhavanissaranassa,3,2,1,0,17
270068,anupādācittassa,anupadacittassa,38,37,1,0,15
270069,bhavanissaraṇāvahaṃ,bhavanissaranavaham,2,1,1,0,19
270070,paccavekkhaṇañāṇassa,paccavekkhanananassa,27,25,2,0,20
270071,V1.0014,V1.0014,34,34,0,0,7
270072,paṭhamattike,pathamattike,4,4,0,0,12
270073,yasakāmatāya,yasakamataya,2,2,0,0,12
270074,puññaphalakāmatāya,punnaphalakamataya,3,3,0,0,18
270075,attukkaṃsanaparavambhanādīhi,attukkamsanaparavambhanadihi,1,1,0,0,28
270076,pāramitāsīlaṃ,paramitasilam,2,1,1,0,13
270077,dutiyattike,dutiyattike,7,7,0,0,11
270078,pajahitukāmena,pajahitukamena,2,2,0,0,14
270079,attagarunā,attagaruna,1,1,0,0,10
270080,attanigāravena,attanigaravena,1,1,0,0,14
270081,lokāpavādaṃ,lokapavadam,1,1,0,0,11
270082,pariharitukāmena,pariharitukamena,3,3,0,0,16
270083,lokagarunā,lokagaruna,5,3,2,0,10
270084,dhammamahattaṃ,dhammamahattam,2,1,1,0,14
270085,pūjetukāmena,pujetukamena,2,1,1,0,12
270086,dhammagarunā,dhammagaruna,1,1,0,0,12
270087,attādhipateyyādivasena,attadhipateyyadivasena,1,1,0,0,22
270088,tatiyattike,tatiyattike,4,4,0,0,11
270089,puthujjanakalyāṇakassa,puthujjanakalyanakassa,15,11,4,0,22
270090,maggasambhārabhūtaṃ,maggasambharabhutam,1,1,0,0,19
270091,maggasampayuttaṃ,maggasampayuttam,5,5,0,0,16
270092,aparāmaṭṭhaṃ,aparamattham,18,14,4,0,12
270093,sekkhāsekkhānaṃ,sekkhasekkhanam,16,15,1,0,15
270094,phalasampayuttaṃ,phalasampayuttam,1,1,0,0,16
270095,paṭippassaddhaṃ,patippassaddham,48,44,4,0,15
270096,parāmaṭṭhādivasena,paramatthadivasena,1,1,0,0,18
270097,catutthattike,catutthattike,3,3,0,0,13
270098,anāpajjantena,anapajjantena,6,6,0,0,13
270099,katapaṭikammaṃ,katapatikammam,3,2,1,0,14
270100,āpannassa,apannassa,37,37,0,0,9
270101,akatapaṭikammaṃ,akatapatikammam,1,1,0,0,15
270102,avisuddhaṃ,avisuddham,5,4,1,0,10
270103,ajjhācāre,ajjhacare,50,43,7,0,9
270104,vematikassa,vematikassa,111,107,4,0,11
270105,vematikasīlaṃ,vematikasilam,1,0,1,0,13
270106,yoginā,yogina,260,260,0,0,6
270107,avisuddhasīlaṃ,avisuddhasilam,1,1,0,0,14
270108,visodhetabbaṃ,visodhetabbam,8,7,1,0,13
270109,vematike,vematike,5,4,1,0,8
270110,vatthujjhācāraṃ,vatthujjhacaram,1,1,0,0,15
270111,paṭivinetabbā,pativinetabba,1,1,0,0,13
270112,visuddhādivasena,visuddhadivasena,1,1,0,0,16
270113,pañcamattike,pancamattike,1,1,0,0,12
270114,ariyamaggehi,ariyamaggehi,29,29,0,0,12
270115,sekkhaṃ,sekkham,86,82,4,0,7
270116,arahattaphalasampayuttaṃ,arahattaphalasampayuttam,1,1,0,0,24
270117,asekkhaṃ,asekkham,58,54,4,0,8
270118,nevasekkhanāsekkhaṃ,nevasekkhanasekkham,79,77,2,0,19
270119,sekkhādivasena,sekkhadivasena,1,1,0,0,14
270120,V1.0015,V1.0015,34,34,0,0,7
270121,sukhasīlo,sukhasilo,18,17,1,0,9
270122,dukkhasīlo,dukkhasilo,3,3,0,0,10
270123,kalahasīlo,kalahasilo,2,2,0,0,10
270124,maṇḍanasīlo,mandanasilo,2,2,0,0,11
270125,kusalasīlaṃ,kusalasilam,8,5,3,0,11
270126,akusalasīlaṃ,akusalasilam,7,5,2,0,12
270127,abyākatasīlanti,abyakatasilanti,1,1,0,0,15
270128,kusalādivasenapi,kusaladivasenapi,1,1,0,0,16
270129,ekenapi,ekenapi,82,76,6,0,7
270130,vuttanayenevassa,vuttanayenevassa,2,2,0,0,16
270131,tividhatā,tividhata,6,5,1,0,9
270132,catukkesu,catukkesu,27,26,1,0,9
270133,paṭhamacatukke,pathamacatukke,14,14,0,0,14
270134,vatthuvītikkame,vatthuvitikkame,4,4,0,0,15
270135,micchāsaṅkappabahulo,micchasankappabahulo,1,1,0,0,20
270136,hānabhāgiyaṃ,hanabhagiyam,23,17,6,0,12
270137,panattamano,panattamano,1,1,0,0,11
270138,sīlasampattiyā,silasampattiya,35,33,2,0,14
270139,kammaṭṭhānānuyogamhi,kammatthananuyogamhi,1,1,0,0,20
270140,sīlamattena,silamattena,9,9,0,0,11
270141,aghaṭantassa,aghatantassa,2,1,1,0,12
270142,ṭhitibhāgiyaṃ,thitibhagiyam,8,6,2,0,13
270143,sampannasīlo,sampannasilo,8,8,0,0,12
270144,visesabhāgiyaṃ,visesabhagiyam,16,14,2,0,14
270145,nibbidaṃ,nibbidam,6,4,2,0,8
270146,yonuyuñjati,yonuyunjati,1,1,0,0,11
270147,nibbedhabhāgiyaṃ,nibbedhabhagiyam,107,91,16,0,16
270148,sīlametassa,silametassa,1,1,0,0,11
270149,hānabhāgiyādivasena,hanabhagiyadivasena,3,3,0,0,19
270150,dutiyacatukke,dutiyacatukke,14,14,0,0,13
270151,V1.0016,V1.0016,34,34,0,0,7
270152,sāmaṇerasāmaṇerīnaṃ,samanerasamanerinam,1,1,0,0,19
270153,anupasampannasīlaṃ,anupasampannasilam,1,0,1,0,18
270154,upāsakaupāsikānaṃ,upasakaupasikanam,6,6,0,0,17
270155,pañcasikkhāpadāni,pancasikkhapadani,1,1,0,0,17
270156,gahaṭṭhasīlaṃ,gahatthasilam,6,5,1,0,13
270157,bhikkhusīlādivasena,bhikkhusiladivasena,1,1,0,0,19
270158,tatiyacatukke,tatiyacatukke,9,9,0,0,13
270159,uttarakurukānaṃ,uttarakurukanam,16,15,1,0,15
270160,pakatisīlaṃ,pakatisilam,7,2,5,0,11
270161,kuladesapāsaṇḍānaṃ,kuladesapasandanam,1,1,0,0,18
270162,mariyādācārittaṃ,mariyadacarittam,2,1,1,0,16
270163,ācārasīlaṃ,acarasilam,5,4,1,0,10
270164,bodhisattamātu,bodhisattamatu,32,31,1,0,14
270165,kāmaguṇūpasaṃhitaṃ,kamagunupasamhitam,7,6,1,0,18
270166,bodhisattamātusīlaṃ,bodhisattamatusilam,2,2,0,0,19
270167,dhammatāsīlaṃ,dhammatasilam,3,1,2,0,13
270168,mahākassapādīnaṃ,mahakassapadinam,4,3,1,0,16
270169,pubbahetukasīlaṃ,pubbahetukasilam,2,0,2,0,16
270170,pakatisīlādivasena,pakatisiladivasena,2,2,0,0,18
270171,catutthacatukke,catutthacatukke,11,11,0,0,15
270172,sikkhāpadesū,sikkhapadesu,21,19,2,0,12
270173,nānubyañjanaggāhī,nanubyanjanaggahi,65,65,0,0,17
270174,ājīvahetupaññattānaṃ,ajivahetupannattanam,2,2,0,0,20
270175,vītikkamassa,vitikkamassa,29,29,0,0,12
270176,nemittikatā,nemittikata,19,13,6,0,11
270177,nippesikatā,nippesikata,22,17,5,0,11
270178,nijigīsanatā,nijigisanata,16,10,6,0,12
270179,evamādīnañca,evamadinanca,4,3,1,0,12
270180,micchājīvā,micchajiva,24,24,0,0,10
270181,ājīvapārisuddhisīlaṃ,ajivaparisuddhisilam,22,20,2,0,20
270182,paṭighātāyā,patighataya,36,34,2,0,11
270183,paṭisaṅkhānaparisuddho,patisankhanaparisuddho,2,1,1,0,22
270184,catupaccayaparibhogo,catupaccayaparibhogo,4,3,1,0,20
270185,paccayasannissitasīlaṃ,paccayasannissitasilam,22,19,3,0,22
270186,V1.0017,V1.0017,34,34,0,0,7
270187,anupubbapadavaṇṇanāya,anupubbapadavannanaya,1,1,0,0,21
270188,vinicchayakathā,vinicchayakatha,43,38,5,0,15
270189,ikkhaṇatāya,ikkhanataya,2,2,0,0,11
270190,bhinnapaṭadharāditāya,bhinnapatadharaditaya,1,1,0,0,21
270191,laddhavohāro,laddhavoharo,9,9,0,0,12
270192,pātimokkhasaṃvarasaṃvutoti,patimokkhasamvarasamvutoti,14,2,12,0,26
270193,kāyikavācasikassa,kayikavacasikassa,4,3,1,0,17
270194,avītikkamassetaṃ,avitikkamassetam,3,2,1,0,16
270195,pātimokkhameva,patimokkhameva,12,12,0,0,14
270196,iriyati,iriyati,131,123,8,0,7
270197,ācāragocarasampannotiādīnamattho,acaragocarasampannotiadinamattho,1,0,1,0,32
270198,dussīlyaṃ,dussilyam,102,87,15,0,9
270199,veḷudānena,veludanena,15,14,1,0,10
270200,pattadānena,pattadanena,9,9,0,0,11
270201,pupphaphalasinānadantakaṭṭhadānena,pupphaphalasinanadantakatthadanena,2,2,0,0,34
270202,cāṭukamyatāya,catukamyataya,10,10,0,0,13
270203,muggasūpyatāya,muggasupyataya,10,10,0,0,14
270204,pāribhaṭyatāya,paribhatyataya,5,5,0,0,14
270205,jaṅghapesanikena,janghapesanikena,13,13,0,0,16
270206,aññataraññatarena,annatarannatarena,124,118,6,0,17
270207,buddhapaṭikuṭṭhena,buddhapatikutthena,9,9,0,0,18
270208,micchāājīvena,micchaajivena,11,11,0,0,13
270209,sīlasaṃvaro,silasamvaro,75,67,8,0,11
270210,pattana,pattana,1,1,0,0,7
270211,pupphana,pupphana,1,1,0,0,8
270212,phalana,phalana,1,1,0,0,7
270213,sinānana,sinanana,1,1,0,0,8
270214,dantakaṭṭhadānena,dantakatthadanena,8,8,0,0,17
270215,V1.0018,V1.0018,34,34,0,0,7
270216,vesiyāgocaro,vesiyagocaro,26,19,7,0,12
270217,thullakumārikā,thullakumarika,6,6,0,0,14
270218,pānāgāragocaro,panagaragocaro,7,7,0,0,14
270219,rājamahāmattehi,rajamahamattehi,27,27,0,0,15
270220,titthiyasāvakehi,titthiyasavakehi,28,28,0,0,16
270221,anopānabhūtāni,anopanabhutani,6,6,0,0,14
270222,akkosakaparibhāsakāni,akkosakaparibhasakani,6,6,0,0,21
270223,anatthakāmāni,anatthakamani,7,6,1,0,13
270224,ahitakāmāni,ahitakamani,5,4,1,0,11
270225,aphāsukakāmāni,aphasukakamani,4,3,1,0,14
270226,ayogakkhemakāmāni,ayogakkhemakamani,5,4,1,0,17
270227,opānabhūtāni,opanabhutani,3,3,0,0,12
270228,kāsāvapajjotāni,kasavapajjotani,3,3,0,0,15
270229,isivātapaṭivātāni,isivatapativatani,3,3,0,0,17
270230,atthakāmāni,atthakamani,3,3,0,0,11
270231,yogakkhemakāmāni,yogakkhemakamani,3,3,0,0,16
270232,gocarena,gocarena,27,25,2,0,8
270233,ācāragocarā,acaragocara,2,2,0,0,11
270234,saṅghagatopi,sanghagatopi,6,6,0,0,12
270235,acittīkārakato,acittikarakato,18,18,0,0,14
270236,ghaṭṭayantopi,ghattayantopi,31,30,1,0,13
270237,uccepi,uccepi,11,11,0,0,6
270238,sasīsampi,sasisampi,1,1,0,0,9
270239,ṭhitakopi,thitakopi,15,14,1,0,9
270240,bāhāvikkhepakopi,bahavikkhepakopi,15,15,0,0,16
270241,anupāhanānaṃ,anupahananam,5,3,2,0,12
270242,caṅkamantānaṃ,cankamantanam,19,17,2,0,13
270243,saupāhano,saupahano,22,21,1,0,9
270244,anupakhajjāpi,anupakhajjapi,2,2,0,0,13
270245,navepi,navepi,8,7,1,0,6
270246,āsanena,asanena,130,125,5,0,7
270247,jantāgharepi,jantagharepi,7,7,0,0,12
270248,udakatitthepi,udakatitthepi,3,3,0,0,13
270249,pavisantopi,pavisantopi,6,6,0,0,11
270250,vokkamma,vokkamma,38,35,3,0,8
270251,ovarakāni,ovarakani,3,3,0,0,9
270252,gūḷhāni,gulhani,13,10,3,0,7
270253,V1.0019,V1.0019,34,34,0,0,7
270254,kulakumāriyo,kulakumariyo,12,11,1,0,12
270255,kumārakassapi,kumarakassapi,2,2,0,0,13
270256,paviṭṭhopi,pavitthopi,5,5,0,0,10
270257,itthannāme,itthanname,7,7,0,0,10
270258,itthaṃgotte,itthamgotte,3,3,0,0,11
270259,pivissāma,pivissama,10,10,0,0,9
270260,khādissāma,khadissama,10,10,0,0,10
270261,dassathā,dassatha,8,7,1,0,8
270262,ābhisamācārikesu,abhisamacarikesu,17,12,5,0,16
270263,sakkaccakārī,sakkaccakari,42,42,0,0,12
270264,garucittīkārabahulo,garucittikarabahulo,8,8,0,0,19
270265,upanissayagocaro,upanissayagocaro,22,13,9,0,16
270266,ārakkhagocaro,arakkhagocaro,20,11,9,0,13
270267,upanibandhagocaroti,upanibandhagocaroti,9,9,0,0,19
270268,dasakathāvatthuguṇasamannāgato,dasakathavatthugunasamannagato,10,9,1,0,30
270269,pariyodapeti,pariyodapeti,6,6,0,0,12
270270,anusikkhamāno,anusikkhamano,5,5,0,0,13
270271,yugamattadassāvī,yugamattadassavi,7,6,1,0,16
270272,ullokento,ullokento,25,25,0,0,9
270273,upanibandhagocaro,upanibandhagocaro,12,3,9,0,17
270274,upanibandhati,upanibandhati,25,25,0,0,13
270275,V1.0020,V1.0020,34,34,0,0,7
270276,ācāragocarasampannoti,acaragocarasampannoti,22,4,18,0,21
270277,bhayadassāvīti,bhayadassaviti,22,0,22,0,14
270278,aṇuppamāṇesu,anuppamanesu,7,7,0,0,12
270279,āpannasekhiyaakusalacittuppādādibhedesu,apannasekhiyaakusalacittuppadadibhedesu,6,6,0,0,39
270280,puggalādhiṭṭhānāya,puggaladhitthanaya,60,59,1,0,18
270281,yathāpaṭipannassa,yathapatipannassa,4,4,0,0,17
270282,pātimokkhasaṃvarasīle,patimokkhasamvarasile,13,11,2,0,21
270283,rūpadassanasamatthena,rupadassanasamatthena,8,8,0,0,21
270284,acittakattā,acittakatta,35,32,3,0,11
270285,acakkhukattā,acakkhukatta,8,7,1,0,12
270286,dvārārammaṇasaṅghaṭṭe,dvararammanasanghatte,2,2,0,0,21
270287,cakkhupasādavatthukena,cakkhupasadavatthukena,2,2,0,0,22
270288,sasambhārakathā,sasambharakatha,14,10,4,0,15
270289,nimittaggāhīti,nimittaggahiti,8,1,7,0,14
270290,itthipurisanimittaṃ,itthipurisanimittam,8,7,1,0,19
270291,subhanimittādikaṃ,subhanimittadikam,8,7,1,0,17
270292,kilesavatthubhūtaṃ,kilesavatthubhutam,8,7,1,0,18
270293,diṭṭhamatteyeva,ditthamatteyeva,14,13,1,0,15
270294,nānubyañjanaggāhīti,nanubyanjanaggahiti,4,1,3,0,19
270295,anuanubyañjanato,anuanubyanjanato,2,2,0,0,16
270296,anubyañjananti,anubyanjananti,7,7,0,0,14
270297,laddhavohāraṃ,laddhavoharam,22,20,2,0,13
270298,hatthapādasitahasitakathitavilokitādibhedaṃ,hatthapadasitahasitakathitavilokitadibhedam,2,2,0,0,43
270299,cetiyapabbatavāsī,cetiyapabbatavasi,3,2,1,0,17
270300,cetiyapabbatā,cetiyapabbata,2,2,0,0,13
270301,piṇḍacāratthāya,pindacaratthaya,1,1,0,0,15
270302,kulasuṇhā,kulasunha,5,4,1,0,9
270303,anurādhapurato,anuradhapurato,1,1,0,0,14
270304,V1.0021,V1.0021,34,34,0,0,7
270305,vipallatthacittā,vipallatthacitta,7,7,0,0,16
270306,dantaṭṭhike,dantatthike,4,4,0,0,11
270307,asubhasaññaṃ,asubhasannam,22,17,5,0,12
270308,dantaṭṭhikaṃ,dantatthikam,5,5,0,0,12
270309,pubbasaññaṃ,pubbasannam,6,5,1,0,11
270310,apāpuṇī,apapuni,2,2,0,0,7
270311,sāmikopi,samikopi,8,8,0,0,8
270312,anumaggaṃ,anumaggam,4,3,1,0,9
270313,passathā,passatha,31,28,3,0,8
270314,aṭṭhisaṅghāṭo,atthisanghato,8,8,0,0,13
270315,gacchatesa,gacchatesa,1,1,0,0,10
270316,cakkhundriyāsaṃvarassa,cakkhundriyasamvarassa,11,9,2,0,22
270317,satikavāṭena,satikavatena,26,24,2,0,12
270318,apihitacakkhudvāraṃ,apihitacakkhudvaram,5,5,0,0,19
270319,anubandheyyuṃ,anubandheyyum,3,3,0,0,13
270320,cakkhundriyassa,cakkhundriyassa,20,18,2,0,15
270321,paṭipajjantoyeva,patipajjantoyeva,2,2,0,0,16
270322,āpajjatītipi,apajjatitipi,1,1,0,0,12
270323,muṭṭhasaccaṃ,mutthasaccam,14,14,0,0,12
270324,kiriyamanodhātu,kiriyamanodhatu,27,26,1,0,15
270325,āvajjanakiccaṃ,avajjanakiccam,20,20,0,0,14
270326,sādhayamānā,sadhayamana,89,88,1,0,11
270327,dassanakiccaṃ,dassanakiccam,46,41,5,0,13
270328,vipākamanodhātu,vipakamanodhatu,33,33,0,0,15
270329,sampaṭicchanakiccaṃ,sampaticchanakiccam,16,16,0,0,19
270330,vipākāhetukamanoviññāṇadhātu,vipakahetukamanovinnanadhatu,8,8,0,0,28
270331,santīraṇakiccaṃ,santiranakiccam,24,24,0,0,15
270332,kiriyāhetukamanoviññāṇadhātu,kiriyahetukamanovinnanadhatu,21,21,0,0,28
270333,voṭṭhabbanakiccaṃ,votthabbanakiccam,15,15,0,0,17
270334,aññatarasamaye,annatarasamaye,8,8,0,0,14
270335,asaṃvaroti,asamvaroti,17,12,5,0,10
270336,aguttaṃ,aguttam,38,34,4,0,7
270337,āvajjanādīnipi,avajjanadinipi,14,14,0,0,14
270338,V1.0022,V1.0022,34,34,0,0,7
270339,asaṃvutesu,asamvutesu,7,7,0,0,10
270340,antogharadvārakoṭṭhakagabbhādayo,antogharadvarakotthakagabbhadayo,6,6,0,0,32
270341,agopitameva,agopitameva,7,7,0,0,11
270342,nagaradvārena,nagaradvarena,15,14,1,0,13
270343,yadicchanti,yadicchanti,5,5,0,0,11
270344,dussīlyādīsu,dussilyadisu,13,11,2,0,12
270345,asaṃvare,asamvare,47,43,4,0,8
270346,nagaradvāresu,nagaradvaresu,40,40,0,0,13
270347,saṃvutesu,samvutesu,5,5,0,0,9
270348,antogharādayo,antogharadayo,5,5,0,0,13
270349,asaṃvutā,asamvuta,35,35,0,0,8
270350,sugopitameva,sugopitameva,8,8,0,0,12
270351,pihitesu,pihitesu,10,10,0,0,8
270352,uppajjamānopi,uppajjamanopi,28,23,5,0,13
270353,sutvātiādīsupi,sutvatiadisupi,6,1,5,0,14
270354,kilesānubandhanimittādiggāhaparivajjanalakkhaṇaṃ,kilesanubandhanimittadiggahaparivajjanalakkhanam,4,3,1,0,48
270355,indriyasaṃvarasīlanti,indriyasamvarasilanti,2,2,0,0,21
270356,indriyasaṃvarasīlānantaraṃ,indriyasamvarasilanantaram,1,1,0,0,26
270357,ājīvapārisuddhisīle,ajivaparisuddhisile,3,3,0,0,19
270358,ājīvahetu,ajivahetu,74,71,3,0,9
270359,paññattānaṃ,pannattanam,10,7,3,0,11
270360,sikkhāpadānanti,sikkhapadananti,2,2,0,0,15
270361,ājīvakāraṇā,ajivakarana,42,42,0,0,11
270362,agilāno,agilano,126,107,19,0,7
270363,pācittiyassa,pacittiyassa,1015,1015,0,0,12
270364,pāṭidesanīyassa,patidesaniyassa,48,48,0,0,15
270365,V1.0023,V1.0023,33,33,0,0,7
270366,dukkaṭassā,dukkatassa,572,567,5,0,10
270367,kuhanātiādīsu,kuhanatiadisu,3,1,2,0,13
270368,lābhasakkārasilokasannissitassa,labhasakkarasilokasannissitassa,12,12,0,0,31
270369,pāpicchassa,papicchassa,22,22,0,0,11
270370,icchāpakatassa,icchapakatassa,12,12,0,0,14
270371,paccayapaṭisevanasaṅkhātena,paccayapatisevanasankhatena,4,3,1,0,27
270372,sāmantajappitena,samantajappitena,3,3,0,0,16
270373,aṭṭhapanā,atthapana,8,7,1,0,9
270374,saṇṭhapanā,santhapana,11,11,0,0,10
270375,bhākuṭikā,bhakutika,16,16,0,0,9
270376,bhākuṭiyaṃ,bhakutiyam,20,18,2,0,10
270377,kuhāyanā,kuhayana,25,19,6,0,8
270378,kuhitattaṃ,kuhitattam,19,17,2,0,10
270379,ālapanā,alapana,8,6,2,0,7
270380,sallapanā,sallapana,3,3,0,0,9
270381,ullapanā,ullapana,5,5,0,0,8
270382,unnahanā,unnahana,9,8,1,0,8
270383,samunnahanā,samunnahana,6,3,3,0,11
270384,ukkācanā,ukkacana,9,9,0,0,8
270385,samukkācanā,samukkacana,6,3,3,0,11
270386,anuppiyabhāṇitā,anuppiyabhanita,3,3,0,0,15
270387,cāṭukamyatā,catukamyata,8,6,2,0,11
270388,muggasūpyatā,muggasupyata,7,7,0,0,12
270389,nimittakammaṃ,nimittakammam,35,12,23,0,13
270390,obhāsakammaṃ,obhasakammam,5,3,2,0,12
270391,sāmantajappā,samantajappa,4,2,2,0,12
270392,akkosanā,akkosana,4,4,0,0,8
270393,garahanā,garahana,2,2,0,0,8
270394,ukkhepanā,ukkhepana,14,11,3,0,9
270395,samukkhepanā,samukkhepana,6,2,4,0,12
270396,khipanā,khipana,2,2,0,0,7
270397,saṃkhipanā,samkhipana,1,1,0,0,10
270398,avaṇṇahārikā,avannaharika,2,2,0,0,12
270399,parapiṭṭhimaṃsikatā,parapitthimamsikata,5,3,2,0,19
270400,lābhasakkārasilokasannissito,labhasakkarasilokasannissito,6,5,1,0,28
270401,āmisassa,amisassa,32,32,0,0,8
270402,kuhananiddese,kuhananiddese,1,1,0,0,13
270403,lābhasakkārasilokasannissitassāti,labhasakkarasilokasannissitassati,2,0,2,0,33
270404,lābhañca,labhanca,9,8,1,0,8
270405,kittisaddañca,kittisaddanca,7,6,1,0,13
270406,sannissitassa,sannissitassa,2,2,0,0,13
270407,patthayantassāti,patthayantassati,2,2,0,0,16
270408,V1.0024,V1.0024,34,34,0,0,7
270409,pāpicchassāti,papicchassati,2,0,2,0,13
270410,asantaguṇadīpanakāmassa,asantagunadipanakamassa,2,2,0,0,23
270411,icchāpakatassāti,icchapakatassati,2,0,2,0,16
270412,apakatassa,apakatassa,2,2,0,0,10
270413,upaddutassāti,upaddutassati,4,2,2,0,13
270414,paccayapaṭisevanasāmantajappanairiyāpathasannissitavasena,paccayapatisevanasamantajappanairiyapathasannissitavasena,1,1,0,0,57
270415,kuhanavatthu,kuhanavatthu,38,37,1,0,12
270416,cīvarādīhi,civaradihi,24,23,1,0,10
270417,nimantitassa,nimantitassa,28,26,2,0,12
270418,tadatthikasseva,tadatthikasseva,5,5,0,0,15
270419,pāpicchataṃ,papicchatam,23,23,0,0,11
270420,paṭikkhipanena,patikkhipanena,7,7,0,0,14
270421,suppatiṭṭhitasaddhe,suppatitthitasaddhe,4,4,0,0,19
270422,paṭiggaṇheyyā,patigganheyya,8,7,1,0,13
270423,upanentānaṃ,upanentanam,6,6,0,0,11
270424,tadanuggahakāmataṃyeva,tadanuggahakamatamyeva,4,4,0,0,22
270425,āvikatvā,avikatva,52,52,0,0,8
270426,paṭiggahaṇena,patiggahanena,18,17,1,0,13
270427,sakaṭabhārehi,sakatabharehi,3,3,0,0,13
270428,upanāmanahetubhūtaṃ,upanamanahetubhutam,5,5,0,0,19
270429,paccayapaṭisevanasaṅkhātaṃ,paccayapatisevanasankhatam,20,16,4,0,26
270430,kuhanavatthūti,kuhanavatthuti,9,6,3,0,14
270431,nimantenti,nimantenti,42,42,0,0,10
270432,cīvarapiṇḍapātasenāsanagilānapaccayabhesajjaparikkhārehi,civarapindapatasenasanagilanapaccayabhesajjaparikkharehi,11,11,0,0,56
270433,bhiyyokamyataṃ,bhiyyokamyatam,15,13,2,0,14
270434,saṅkārakūṭā,sankarakuta,12,12,0,0,11
270435,pāpaṇikā,papanika,8,7,1,0,8
270436,nantakāni,nantakani,25,24,1,0,9
270437,uccinitvā,uccinitva,69,68,1,0,9
270438,piṇḍiyālopena,pindiyalopena,9,9,0,0,13
270439,abbhokāsiko,abbhokasiko,13,12,1,0,11
270440,pūtimuttena,putimuttena,6,5,1,0,11
270441,hariṭakīkhaṇḍena,haritakikhandena,1,1,0,0,16
270442,pavivitto,pavivitto,75,74,1,0,9
270443,dhutavādo,dhutavado,45,44,1,0,9
270444,parikkhārehi,parikkharehi,11,11,0,0,12
270445,sammukhībhāvā,sammukhibhava,26,24,2,0,13
270446,V1.0025,V1.0025,34,34,0,0,7
270447,sammukhībhāvāsaddhokulaputto,sammukhibhavasaddhokulaputto,1,1,0,0,28
270448,tumhākañcevāyaṃ,tumhakancevayam,5,5,0,0,15
270449,sacehaṃ,saceham,3,3,0,0,7
270450,paṭiggahessāmi,patiggahessami,5,5,0,0,14
270451,tumhākaṃyeva,tumhakamyeva,42,42,0,0,12
270452,paṭiggaṇhāmī,patigganhami,10,10,0,0,12
270453,bhesajjaparikkhāraṃ,bhesajjaparikkharam,2,2,0,0,19
270454,kuhanavatthū,kuhanavatthu,6,6,0,0,12
270455,pāpicchasseva,papicchasseva,14,14,0,0,13
270456,uttarimanussadhammādhigamaparidīpanavācāya,uttarimanussadhammadhigamaparidipanavacaya,5,5,0,0,42
270457,sāmantajappanasaṅkhātaṃ,samantajappanasankhatam,17,15,2,0,23
270458,sambhāvanādhippāyo,sambhavanadhippayo,13,13,0,0,18
270459,sambhāvessatī,sambhavessati,15,15,0,0,13
270460,ariyadhammasannissitaṃ,ariyadhammasannissitam,5,4,1,0,22
270461,lohathālakaṃ,lohathalakam,7,7,0,0,12
270462,kuñcikaṃ,kuncikam,14,13,1,0,8
270463,samānupajjhāyako,samanupajjhayako,10,9,1,0,16
270464,samānācariyako,samanacariyako,11,10,1,0,14
270465,aḍḍhayoge,addhayoge,10,10,0,0,9
270466,hammiye,hammiye,8,8,0,0,7
270467,kūṭāgāre,kutagare,45,43,2,0,8
270468,māḷe,male,5,5,0,0,4
270469,uddaṇḍe,uddande,5,5,0,0,7
270470,korajikakorajiko,korajikakorajiko,7,5,2,0,16
270471,bhākuṭikabhākuṭiko,bhakutikabhakutiko,10,8,2,0,18
270472,kuhakakuhako,kuhakakuhako,6,5,1,0,12
270473,lapakalapako,lapakalapako,6,5,1,0,12
270474,mukhasambhāviko,mukhasambhaviko,3,3,0,0,15
270475,vihārasamāpattīnaṃ,viharasamapattinam,20,18,2,0,18
270476,suññatāpaṭisaṃyuttaṃ,sunnatapatisamyuttam,5,5,0,0,20
270477,sambhāvanādhippāyakatena,sambhavanadhippayakatena,4,4,0,0,24
270478,iriyāpathasannissitaṃ,iriyapathasannissitam,2,2,0,0,21
270479,iriyāpathasaṅkhātaṃ,iriyapathasankhatam,15,13,2,0,19
270480,saṇṭhapeti,santhapeti,41,40,1,0,10
270481,V1.0026,V1.0026,34,34,0,0,7
270482,āpāthakajjhāyī,apathakajjhayi,1,1,0,0,14
270483,paccayapaṭisevanasaṅkhātenāti,paccayapatisevanasankhatenati,3,0,3,0,29
270484,paccayapaṭisevananti,paccayapatisevananti,3,3,0,0,20
270485,paccayapaṭisevanena,paccayapatisevanena,3,3,0,0,19
270486,sāmantajappitenāti,samantajappitenati,2,0,2,0,18
270487,samīpabhaṇitena,samipabhanitena,1,1,0,0,15
270488,catuiriyāpathassa,catuiriyapathassa,3,3,0,0,17
270489,aṭṭhapanātiādi,atthapanatiadi,1,0,1,0,14
270490,ṭhapanāti,thapanati,15,2,13,0,9
270491,ṭhapanākāro,thapanakaro,3,3,0,0,11
270492,saṇṭhapanāti,santhapanati,4,0,4,0,12
270493,abhisaṅkharaṇā,abhisankharana,2,2,0,0,14
270494,pāsādikabhāvakaraṇanti,pasadikabhavakarananti,3,3,0,0,22
270495,bhākuṭikāti,bhakutikati,3,0,3,0,11
270496,padhānapurimaṭṭhitabhāvadassanena,padhanapurimatthitabhavadassanena,3,3,0,0,33
270497,bhākuṭikaraṇaṃ,bhakutikaranam,7,7,0,0,14
270498,mukhasaṅkocoti,mukhasankocoti,3,3,0,0,14
270499,bhākuṭiko,bhakutiko,3,2,1,0,9
270500,bhākuṭikassa,bhakutikassa,3,3,0,0,12
270501,kuhanāti,kuhanati,4,0,4,0,8
270502,vimhāpanā,vimhapana,3,3,0,0,9
270503,kuhassa,kuhassa,5,5,0,0,7
270504,āyanā,ayana,4,4,0,0,5
270505,kuhitassa,kuhitassa,3,3,0,0,9
270506,kuhitattanti,kuhitattanti,1,1,0,0,12
270507,lapanāniddese,lapananiddese,2,2,0,0,13
270508,ālapanāti,alapanati,3,0,3,0,9
270509,nimantituṃ,nimantitum,4,4,0,0,10
270510,rājamahāmatto,rajamahamatto,24,24,0,0,13
270511,attupanāyikā,attupanayika,5,5,0,0,12
270512,lapanāti,lapanati,5,1,4,0,8
270513,vuttappakārameva,vuttappakarameva,27,26,1,0,16
270514,sallapanāti,sallapanati,3,0,3,0,11
270515,gahapatikānaṃ,gahapatikanam,15,13,2,0,13
270516,ukkaṇṭhane,ukkanthane,3,3,0,0,10
270517,bhītassa,bhitassa,18,18,0,0,8
270518,ullapanāti,ullapanati,4,0,4,0,10
270519,mahākuṭumbiko,mahakutumbiko,7,7,0,0,13
270520,mahānāviko,mahanaviko,4,4,0,0,10
270521,mahādānapatīti,mahadanapatiti,2,2,0,0,14
270522,samullapanāti,samullapanati,3,0,3,0,13
270523,sabbatobhāgena,sabbatobhagena,30,30,0,0,14
270524,unnahanāti,unnahanati,4,0,4,0,10
270525,navadānaṃ,navadanam,2,2,0,0,9
270526,labhāmā,labhama,26,26,0,0,7
270527,nahanā,nahana,3,3,0,0,6
270528,veṭhanāti,vethanati,3,3,0,0,9
270529,ucchuhatthaṃ,ucchuhattham,3,3,0,0,12
270530,ucchukhettato,ucchukhettato,4,4,0,0,13
270531,nibbeṭhentassāpi,nibbethentassapi,2,2,0,0,16
270532,veṭhanakathā,vethanakatha,1,1,0,0,12
270533,ukkācanāti,ukkacanati,3,0,3,0,10
270534,V1.0027,V1.0027,34,34,0,0,7
270535,kācanā,kacana,3,3,0,0,6
270536,uddīpanāti,uddipanati,3,3,0,0,10
270537,telakandarikavatthu,telakandarikavatthu,3,2,1,0,19
270538,anuppiyabhāṇitāti,anuppiyabhanitati,4,0,4,0,17
270539,saccānurūpaṃ,saccanurupam,3,3,0,0,12
270540,dhammānurūpaṃ,dhammanurupam,20,17,3,0,13
270541,anapaloketvā,anapaloketva,52,48,4,0,12
270542,piyabhaṇanameva,piyabhananameva,2,2,0,0,15
270543,cāṭukamyatāti,catukamyatati,3,0,3,0,13
270544,nīcavuttitā,nicavuttita,7,7,0,0,11
270545,muggasūpyatāti,muggasupyatati,5,1,4,0,14
270546,muggasūpasadisatā,muggasupasadisata,3,3,0,0,17
270547,muggesu,muggesu,3,3,0,0,7
270548,paccamānesu,paccamanesu,7,7,0,0,11
270549,alīkaṃ,alikam,2,2,0,0,6
270550,muggasūpyoti,muggasupyoti,3,2,1,0,12
270551,pāribhaṭyatāti,paribhatyatati,3,2,1,0,14
270552,pāribhaṭyabhāvo,paribhatyabhavo,1,1,0,0,15
270553,kuladārake,kuladarake,10,10,0,0,10
270554,aṅkena,ankena,20,19,1,0,6
270555,paribhaṭati,paribhatati,5,5,0,0,11
270556,pāribhaṭyuṃ,paribhatyum,1,1,0,0,11
270557,nemittikatāniddese,nemittikataniddese,2,2,0,0,18
270558,paccayadānasaññājanakaṃ,paccayadanasannajanakam,2,2,0,0,23
270559,kāyavacīkammaṃ,kayavacikammam,18,16,2,0,14
270560,labhitthā,labhittha,13,13,0,0,9
270561,nimittakaraṇaṃ,nimittakaranam,7,7,0,0,14
270562,paccayapaṭisaṃyuttakathā,paccayapatisamyuttakatha,4,2,2,0,24
270563,vacchapālake,vacchapalake,1,1,0,0,12
270564,khīragovacchā,khiragovaccha,8,8,0,0,13
270565,takkagovacchā,takkagovaccha,2,2,0,0,13
270566,khīradāpanādikaṃ,khiradapanadikam,2,2,0,0,16
270567,obhāsakaraṇaṃ,obhasakaranam,6,4,2,0,13
270568,sāmantajappāti,samantajappati,4,2,2,0,14
270569,jappanaṃ,jappanam,22,15,7,0,8
270570,kulūpakabhikkhu,kulupakabhikkhu,1,1,0,0,15
270571,bhuñjitukāmo,bhunjitukamo,38,38,0,0,12
270572,āharitukāmā,aharitukama,3,3,0,0,11
270573,paṭivissakagharaṃ,pativissakagharam,4,4,0,0,17
270574,kavāṭakoṇe,kavatakone,4,4,0,0,10
270575,loṇamacchaphāle,lonamacchaphale,1,1,0,0,15
270576,kumbhiyaṃ,kumbhiyam,16,14,2,0,9
270577,upāsike,upasike,46,45,1,0,7
270578,sampajjissatī,sampajjissati,6,6,0,0,13
270579,paharissāmī,paharissami,17,17,0,0,11
270580,leḍḍukena,leddukena,2,2,0,0,9
270581,pahaṭena,pahatena,3,3,0,0,8
270582,nikkhittaloṇamacchaphālasadisaṃ,nikkhittalonamacchaphalasadisam,2,2,0,0,31
270583,leḍḍuṃ,leddum,35,31,4,0,6
270584,ḍaṃsitukāmassa,damsitukamassa,2,2,0,0,14
270585,V1.0028,V1.0028,34,34,0,0,7
270586,kumbhiyā,kumbhiya,47,46,1,0,8
270587,taṇḍulasadise,tandulasadise,2,2,0,0,13
270588,kupitassa,kupitassa,7,7,0,0,9
270589,pakkhittaghatasadisaṃ,pakkhittaghatasadisam,2,2,0,0,21
270590,visamissakaṃ,visamissakam,3,3,0,0,12
270591,kheḷanti,khelanti,1,1,0,0,8
270592,muṇḍakaṃ,mundakam,4,4,0,0,8
270593,ghataguḷamacchehi,ghatagulamacchehi,2,2,0,0,17
270594,parikathāti,parikathati,2,0,2,0,11
270595,nippesikatāniddese,nippesikataniddese,2,2,0,0,18
270596,akkosanāti,akkosanati,8,6,2,0,10
270597,akkosavatthūhi,akkosavatthuhi,53,50,3,0,14
270598,vambhanāti,vambhanati,2,0,2,0,10
270599,garahaṇāti,garahanati,1,0,1,0,10
270600,appasannotiādinā,appasannotiadina,1,1,0,0,16
270601,dosāropanā,dosaropana,2,2,0,0,10
270602,ukkhepanāti,ukkhepanati,2,0,2,0,11
270603,adentaṃ,adentam,6,6,0,0,7
270604,khipanāti,khipanati,3,0,3,0,9
270605,bījabhojinoti,bijabhojinoti,1,1,0,0,13
270606,uppaṇḍanā,uppandana,5,4,1,0,9
270607,saṃkhipanāti,samkhipanati,1,0,1,0,12
270608,adāyakoti,adayakoti,3,2,1,0,9
270609,pāpanāti,papanati,3,0,3,0,8
270610,adāyakattassa,adayakattassa,3,3,0,0,13
270611,avaṇṇahārikāti,avannaharikati,2,0,2,0,14
270612,avaṇṇabhayāpi,avannabhayapi,2,2,0,0,13
270613,avaṇṇaharaṇaṃ,avannaharanam,2,2,0,0,13
270614,parapiṭṭhimaṃsikatāti,parapitthimamsikatati,4,2,2,0,21
270615,bhaṇitvā,bhanitva,25,25,0,0,8
270616,avaṇṇabhāsitā,avannabhasita,2,2,0,0,13
270617,piṭṭhimaṃsaṃ,pitthimamsam,10,10,0,0,12
270618,khādanamiva,khadanamiva,1,1,0,0,11
270619,nippesikatāti,nippesikatati,4,2,2,0,13
270620,veḷupesikāya,velupesikaya,18,18,0,0,12
270621,abbhaṅgaṃ,abbhangam,7,6,1,0,9
270622,nippeseti,nippeseti,4,4,0,0,9
270623,nipuñchati,nipunchati,4,4,0,0,10
270624,nipisitvā,nipisitva,7,6,1,0,9
270625,gandhamagganā,gandhamaggana,5,4,1,0,13
270626,paraguṇe,paragune,5,5,0,0,8
270627,lābhamagganā,labhamaggana,5,5,0,0,12
270628,nijigīsanatāniddese,nijigisanataniddese,2,2,0,0,19
270629,nijigīsanatāti,nijigisanatati,7,4,3,0,14
270630,amutrāti,amutrati,9,2,7,0,8
270631,amukamhi,amukamhi,3,3,0,0,8
270632,eṭṭhīti,etthiti,4,1,3,0,7
270633,icchanā,icchana,2,2,0,0,7
270634,gaveṭṭhīti,gavetthiti,4,1,3,0,10
270635,pariyeṭṭhīti,pariyetthiti,5,1,4,0,12
270636,khīrayāguṃ,khirayagum,8,8,0,0,10
270637,gatabhikkhuvatthu,gatabhikkhuvatthu,2,2,0,0,17
270638,esanātiādīni,esanatiadini,2,1,1,0,12
270639,eṭṭhiādīnameva,etthiadinameva,1,1,0,0,14
270640,iccevamettha,iccevamettha,2,2,0,0,12
270641,kuhanādīnaṃ,kuhanadinam,2,2,0,0,11
270642,V1.0029,V1.0029,34,34,0,0,7
270643,uppātaṃ,uppatam,8,6,2,0,7
270644,mūsikacchinnaṃ,musikacchinnam,10,8,2,0,14
270645,aggihomaṃ,aggihomam,8,3,5,0,9
270646,dabbihomaṃ,dabbihomam,4,3,1,0,10
270647,vītikkamavasena,vitikkamavasena,8,8,0,0,15
270648,micchājīvo,micchajivo,22,18,4,0,10
270649,sabbappakārāpi,sabbappakarapi,2,2,0,0,14
270650,pārisuddhīti,parisuddhiti,11,6,5,0,12
270651,parisuddhatā,parisuddhata,10,8,2,0,12
270652,yonisoti,yonisoti,16,3,13,0,8
270653,paccavekkhitvāti,paccavekkhitvati,13,5,8,0,16
270654,paṭighātāyātiādinā,patighatayatiadina,2,2,0,0,18
270655,vuttapaccavekkhaṇameva,vuttapaccavekkhanameva,2,2,0,0,22
270656,antaravāsakādīsu,antaravasakadisu,6,5,1,0,16
270657,pārupati,parupati,38,38,0,0,8
270658,payojanāvadhiparicchedaniyamavacanaṃ,payojanavadhiparicchedaniyamavacanam,2,2,0,0,36
270659,cīvarapaṭisevane,civarapatisevane,6,6,0,0,16
270660,paṭighātāyātiādi,patighatayatiadi,2,2,0,0,16
270661,sītassāti,sitassati,6,0,6,0,9
270662,ajjhattadhātukkhobhavasena,ajjhattadhatukkhobhavasena,4,4,0,0,26
270663,bahiddhāutupariṇāmanavasena,bahiddhautuparinamanavasena,1,1,0,0,27
270664,paṭighātāyāti,patighatayati,12,1,11,0,13
270665,paṭihananatthaṃ,patihananattham,2,2,0,0,15
270666,sītabbhāhate,sitabbhahate,3,2,1,0,12
270667,padahituṃ,padahitum,8,8,0,0,9
270668,paṭisevitabbanti,patisevitabbanti,1,1,0,0,16
270669,kevalañhettha,kevalanhettha,18,18,0,0,13
270670,uṇhassāti,unhassati,6,1,5,0,9
270671,aggisantāpassa,aggisantapassa,4,4,0,0,14
270672,vanadāhādīsu,vanadahadisu,6,5,1,0,12
270673,ḍaṃsamakasavātātapasarīsapasamphassānanti,damsamakasavatatapasarisapasamphassananti,1,1,0,0,41
270674,ḍaṃsāti,damsati,15,0,15,0,7
270675,ḍaṃsanamakkhikā,damsanamakkhika,3,2,1,0,15
270676,andhamakkhikātipi,andhamakkhikatipi,1,1,0,0,17
270677,vātāti,vatati,39,0,39,0,6
270678,sarajaarajādibhedā,sarajaarajadibheda,2,2,0,0,18
270679,ātapoti,atapoti,6,1,5,0,7
270680,sarīsapāti,sarisapati,12,0,12,0,10
270681,dīghajātikā,dighajatika,17,17,0,0,11
270682,sappādayo,sappadayo,11,11,0,0,9
270683,daṭṭhasamphasso,datthasamphasso,2,2,0,0,15
270684,phuṭṭhasamphasso,phutthasamphasso,2,2,0,0,16
270685,paṭighātatthāya,patighatatthaya,25,25,0,0,15
270686,niyatapayojanāvadhiparicchedadassanatthaṃ,niyatapayojanavadhiparicchedadassanattham,2,2,0,0,41
270687,V1.0030,V1.0030,34,34,0,0,7
270688,hirikopīnapaṭicchādanañhi,hirikopinapaticchadananhi,1,1,0,0,25
270689,niyatapayojanaṃ,niyatapayojanam,5,4,1,0,15
270690,hirikopīnaṃ,hirikopinam,10,6,4,0,11
270691,sambādhaṭṭhānaṃ,sambadhatthanam,6,6,0,0,15
270692,vivariyamāne,vivariyamane,5,5,0,0,12
270693,kopanato,kopanato,5,5,0,0,8
270694,hirikopīnanti,hirikopinanti,2,2,0,0,13
270695,hirikopīnassa,hirikopinassa,2,2,0,0,13
270696,paṭicchādanatthanti,paticchadanatthanti,2,2,0,0,19
270697,hirikopīnapaṭicchādanatthaṃ,hirikopinapaticchadanattham,8,7,1,0,27
270698,paṭicchādanatthantipi,paticchadanatthantipi,1,1,0,0,21
270699,piṇḍolyena,pindolyena,6,5,1,0,10
270700,piṇḍapātoti,pindapatoti,12,7,5,0,11
270701,piṇḍānaṃ,pindanam,11,10,1,0,8
270702,laddhānaṃ,laddhanam,12,12,0,0,9
270703,davāyāti,davayati,9,2,7,0,8
270704,gāmadārakādayo,gamadarakadayo,1,1,0,0,14
270705,davatthaṃ,davattham,3,2,1,0,9
270706,kīḷānimittanti,kilanimittanti,2,1,1,0,14
270707,madāyāti,madayati,9,3,6,0,8
270708,muṭṭhikamallādayo,mutthikamalladayo,1,1,0,0,17
270709,madatthaṃ,madattham,1,1,0,0,9
270710,balamadanimittaṃ,balamadanimittam,2,1,1,0,16
270711,porisamadanimittañcāti,porisamadanimittancati,1,1,0,0,22
270712,maṇḍanāyāti,mandanayati,6,1,5,0,11
270713,antepurikavesiyādayo,antepurikavesiyadayo,1,1,0,0,20
270714,maṇḍanatthaṃ,mandanattham,4,3,1,0,12
270715,pīṇabhāvanimittanti,pinabhavanimittanti,1,1,0,0,19
270716,vibhūsanāyāti,vibhusanayati,8,3,5,0,13
270717,naṭanaccakādayo,natanaccakadayo,1,1,0,0,15
270718,vibhūsanatthaṃ,vibhusanattham,2,2,0,0,14
270719,pasannacchavivaṇṇatānimittanti,pasannacchavivannatanimittanti,1,1,0,0,30
270720,mohūpanissayappahānatthaṃ,mohupanissayappahanattham,2,1,1,0,25
270721,dosūpanissayappahānatthaṃ,dosupanissayappahanattham,2,1,1,0,25
270722,rāgūpanissayappahānatthaṃ,ragupanissayappahanattham,3,2,1,0,25
270723,saṃyojanuppattipaṭisedhanatthaṃ,samyojanuppattipatisedhanattham,4,2,2,0,31
270724,parassapi,parassapi,21,20,1,0,9
270725,kāmasukhallikānuyogassa,kamasukhallikanuyogassa,5,5,0,0,23
270726,kāyassāti,kayassati,21,3,18,0,9
270727,catumahābhūtikassa,catumahabhutikassa,2,2,0,0,18
270728,pabandhaṭṭhitatthaṃ,pabandhatthitattham,2,1,1,0,19
270729,yāpanāyāti,yapanayati,11,4,7,0,10
270730,avicchedatthaṃ,avicchedattham,1,1,0,0,14
270731,cirakālaṭṭhitatthaṃ,cirakalatthitattham,4,3,1,0,19
270732,gharūpatthambhamiva,gharupatthambhamiva,1,1,0,0,19
270733,jiṇṇagharasāmiko,jinnagharasamiko,2,2,0,0,16
270734,akkhabbhañjanamiva,akkhabbhanjanamiva,2,2,0,0,18
270735,ṭhitatthaṃ,thitattham,14,12,2,0,10
270736,yāpanatthañcesa,yapanatthancesa,1,1,0,0,15
270737,davamadamaṇḍanavibhūsanatthaṃ,davamadamandanavibhusanattham,2,1,1,0,29
270738,jīvitindriyassetaṃ,jivitindriyassetam,2,1,1,0,18
270739,jīvitindriyapavattāpanatthantipi,jivitindriyapavattapanatthantipi,1,1,0,0,32
270740,vihiṃsūparatiyāti,vihimsuparatiyati,7,2,5,0,17
270741,ābādhaṭṭhena,abadhatthena,7,7,0,0,12
270742,uparamatthampesa,uparamatthampesa,1,1,0,0,16
270743,vaṇālepanamiva,vanalepanamiva,2,1,1,0,14
270744,uṇhasītādīsu,unhasitadisu,2,2,0,0,12
270745,tappaṭikāraṃ,tappatikaram,2,2,0,0,12
270746,brahmacariyānuggahāyāti,brahmacariyanuggahayati,7,2,5,0,23
270747,sakalasāsanabrahmacariyassa,sakalasasanabrahmacariyassa,5,4,1,0,27
270748,anuggahatthaṃ,anuggahattham,22,22,0,0,13
270749,piṇḍapātapaṭisevanapaccayā,pindapatapatisevanapaccaya,1,1,0,0,26
270750,sikkhattayānuyogavasena,sikkhattayanuyogavasena,1,1,0,0,23
270751,V1.0031,V1.0031,34,34,0,0,7
270752,bhavakantāranittharaṇatthaṃ,bhavakantaranittharanattham,1,1,0,0,27
270753,brahmacariyānuggahāya,brahmacariyanuggahaya,30,30,0,0,21
270754,kantāranittharaṇatthikā,kantaranittharanatthika,2,2,0,0,23
270755,puttamaṃsaṃ,puttamamsam,14,14,0,0,11
270756,nadīnittharaṇatthikā,nadinittharanatthika,1,1,0,0,20
270757,kullaṃ,kullam,48,40,8,0,6
270758,samuddanittharaṇatthikā,samuddanittharanatthika,1,1,0,0,23
270759,nāvamiva,navamiva,1,1,0,0,8
270760,itipurāṇañca,itipurananca,1,0,1,0,12
270761,navañca,navanca,60,52,8,0,7
270762,piṇḍapātapaṭisevanena,pindapatapatisevanena,2,2,0,0,21
270763,jighacchāvedanaṃ,jighacchavedanam,2,2,0,0,16
270764,aparimitabhojanapaccayaṃ,aparimitabhojanapaccayam,3,2,1,0,24
270765,āharahatthakaalaṃsāṭakatatravaṭṭakakākamāsakabhuttavamitakabrāhmaṇānaṃ,aharahatthakaalamsatakatatravattakakakamasakabhuttavamitakabrahmananam,1,1,0,0,70
270766,uppādessāmītipi,uppadessamitipi,1,1,0,0,15
270767,bhesajjamiva,bhesajjamiva,9,8,1,0,12
270768,asappāyāparimitabhojanaṃ,asappayaparimitabhojanam,2,1,1,0,24
270769,purāṇakammapaccayavasena,puranakammapaccayavasena,1,1,0,0,24
270770,purāṇavedanāti,puranavedanati,1,1,0,0,14
270771,sappāyaparimitabhojanena,sappayaparimitabhojanena,1,1,0,0,24
270772,ayuttaparibhogakammūpacayaṃ,ayuttaparibhogakammupacayam,1,1,0,0,27
270773,navavedanāti,navavedanati,1,1,0,0,12
270774,yuttaparibhogavasena,yuttaparibhogavasena,2,2,0,0,20
270775,anibbattento,anibbattento,6,6,0,0,12
270776,yuttaparibhogasaṅgaho,yuttaparibhogasangaho,2,1,1,0,21
270777,attakilamathānuyogappahānaṃ,attakilamathanuyogappahanam,2,1,1,0,27
270778,dhammikasukhāpariccāgo,dhammikasukhapariccago,2,1,1,0,22
270779,parimitaparibhogena,parimitaparibhogena,5,4,1,0,19
270780,jīvitindriyupacchedakassa,jivitindriyupacchedakassa,2,2,0,0,25
270781,iriyāpathabhañjakassa,iriyapathabhanjakassa,1,1,0,0,21
270782,parissayassa,parissayassa,6,6,0,0,12
270783,cirakālagamanasaṅkhātā,cirakalagamanasankhata,1,1,0,0,22
270784,paccayāyattavuttino,paccayayattavuttino,1,1,0,0,19
270785,kāyassātipi,kayassatipi,1,1,0,0,11
270786,yāpyarogī,yapyarogi,2,1,1,0,9
270787,tappaccayaṃ,tappaccayam,24,20,4,0,11
270788,anavajjatā,anavajjata,54,47,7,0,10
270789,ayuttapariyesanapaṭiggahaṇaparibhogaparivajjanena,ayuttapariyesanapatiggahanaparibhogaparivajjanena,2,2,0,0,49
270790,asappāyāparimitaparibhogapaccayā,asappayaparimitaparibhogapaccaya,1,1,0,0,32
270791,aratitandīvijambhitā,aratitandivijambhita,1,1,0,0,20
270792,viññūgarahādidosābhāvena,vinnugarahadidosabhavena,1,1,0,0,24
270793,sappāyaparimitabhojanapaccayā,sappayaparimitabhojanapaccaya,3,3,0,0,29
270794,kāyabalasambhavena,kayabalasambhavena,3,3,0,0,18
270795,yāvadatthaudarāvadehakabhojanaparivajjanena,yavadatthaudaravadehakabhojanaparivajjanena,2,2,0,0,43
270796,seyyasukhapassasukhamiddhasukhānaṃ,seyyasukhapassasukhamiddhasukhanam,1,1,0,0,34
270797,catupañcālopamattaūnabhojanena,catupancalopamattaunabhojanena,2,2,0,0,30
270798,catuiriyāpathayogyabhāvapaṭipādanato,catuiriyapathayogyabhavapatipadanato,1,1,0,0,36
270799,bhavissatītipi,bhavissatitipi,5,5,0,0,14
270800,V1.0032,V1.0032,34,34,0,0,7
270801,payojanapariggaho,payojanapariggaho,3,3,0,0,17
270802,āsanañca,asananca,16,16,0,0,8
270803,aḍḍhayogādimhi,addhayogadimhi,3,3,0,0,14
270804,utuparissayavinodanapaṭisallānārāmatthaṃ,utuparissayavinodanapatisallanaramattham,6,3,3,0,40
270805,parisahanaṭṭhena,parisahanatthena,4,4,0,0,16
270806,utuyeva,utuyeva,12,9,3,0,7
270807,utuparissayo,utuparissayo,7,7,0,0,12
270808,utuparissayassa,utuparissayassa,3,3,0,0,15
270809,vinodanatthañca,vinodanatthanca,2,2,0,0,15
270810,paṭisallānārāmatthañca,patisallanaramatthanca,2,2,0,0,22
270811,sarīrābādhacittavikkhepakaro,sarirabadhacittavikkhepakaro,5,4,1,0,28
270812,senāsanapaṭisevanena,senasanapatisevanena,2,2,0,0,20
270813,vinodetabbo,vinodetabbo,3,3,0,0,11
270814,ekībhāvasukhatthañcāti,ekibhavasukhatthancati,2,2,0,0,22
270815,sītapaṭighātādināva,sitapatighatadinava,2,2,0,0,19
270816,utuparissayavinodanaṃ,utuparissayavinodanam,5,5,0,0,21
270817,hirikopīnapaṭicchādanaṃ,hirikopinapaticchadanam,4,4,0,0,23
270818,parissayo,parissayo,22,21,1,0,9
270819,pākaṭaparissayo,pakataparissayo,4,3,1,0,15
270820,paṭicchannaparissayo,paticchannaparissayo,4,3,1,0,20
270821,sīhabyagghādayo,sihabyagghadayo,19,19,0,0,15
270822,rāgadosādayo,ragadosadayo,2,2,0,0,12
270823,apariguttiyā,apariguttiya,3,3,0,0,12
270824,asappāyarūpadassanādinā,asappayarupadassanadina,3,3,0,0,23
270825,paṭisevanto,patisevanto,50,49,1,0,11
270826,utuparissayavinodanatthaṃ,utuparissayavinodanattham,2,2,0,0,25
270827,paṭiayanaṭṭhena,patiayanatthena,2,2,0,0,15
270828,paccanīkagamanaṭṭhenāti,paccanikagamanatthenati,4,3,1,0,23
270829,sappāyassetaṃ,sappayassetam,3,3,0,0,13
270830,bhisakkassa,bhisakkassa,13,12,1,0,11
270831,gilānapaccayova,gilanapaccayova,3,3,0,0,15
270832,gilānapaccayabhesajjaṃ,gilanapaccayabhesajjam,7,7,0,0,22
270833,bhisakkakammaṃ,bhisakkakammam,3,3,0,0,14
270834,telamadhuphāṇitādīti,telamadhuphanitaditi,3,3,0,0,20
270835,suparikkhataṃ,suparikkhatam,17,16,1,0,13
270836,sambhāropi,sambharopi,6,6,0,0,10
270837,parivāropi,parivaropi,10,9,1,0,10
270838,jīvitanāsakābādhuppattiyā,jivitanasakabadhuppattiya,2,2,0,0,25
270839,kāraṇabhāvato,karanabhavato,56,56,0,0,13
270840,gilānapaccayabhesajjañca,gilanapaccayabhesajjanca,3,3,0,0,24
270841,bhisakkānuññātaṃ,bhisakkanunnatam,2,2,0,0,16
270842,telamadhuphāṇitādi,telamadhuphanitadi,1,1,0,0,18
270843,V1.0033,V1.0033,34,34,0,0,7
270844,jīvitaparikkhāranti,jivitaparikkharanti,1,1,0,0,19
270845,veyyābādhikānaṃ,veyyabadhikanam,11,7,4,0,15
270846,byābādhoti,byabadhoti,2,2,0,0,10
270847,taṃsamuṭṭhānā,tamsamutthana,17,16,1,0,13
270848,kuṭṭhagaṇḍapīḷakādayo,kutthagandapilakadayo,2,2,0,0,21
270849,byābādhato,byabadhato,3,3,0,0,10
270850,veyyābādhikā,veyyabadhika,2,2,0,0,12
270851,akusalavipākavedanā,akusalavipakavedana,3,2,1,0,19
270852,abyābajjhaparamatāyāti,abyabajjhaparamatayati,4,0,4,0,22
270853,niddukkhaparamatāya,niddukkhaparamataya,2,2,0,0,19
270854,paccayaparibhogalakkhaṇaṃ,paccayaparibhogalakkhanam,1,1,0,0,25
270855,paribhuñjamānā,paribhunjamana,6,5,1,0,14
270856,sannissitanti,sannissitanti,2,2,0,0,13
270857,paccayasannissitaṃ,paccayasannissitam,6,6,0,0,18
270858,catupārisuddhisampādanavidhi,catuparisuddhisampadanavidhi,1,1,0,0,28
270859,evametasmiṃ,evametasmim,31,30,1,0,11
270860,sampādetabbo,sampadetabbo,7,7,0,0,12
270861,saddhāsādhano,saddhasadhano,3,1,2,0,13
270862,sāvakavisayātītattā,savakavisayatitatta,2,1,1,0,19
270863,sikkhāpadapaññattiyā,sikkhapadapannattiya,62,61,1,0,20
270864,sikkhāpadapaññattiyācanapaṭikkhepo,sikkhapadapannattiyacanapatikkhepo,2,1,1,0,34
270865,akarontena,akarontena,12,11,1,0,10
270866,camarīva,camariva,4,3,1,0,8
270867,piyaṃva,piyamva,4,3,1,0,7
270868,nayanaṃva,nayanamva,3,3,0,0,9
270869,anurakkhamānakā,anurakkhamanaka,1,1,0,0,15
270870,pahārāda,paharada,38,38,0,0,8
270871,nātikkamantī,natikkamanti,12,12,0,0,12
270872,aṭaviyaṃ,ataviyam,47,47,0,0,8
270873,baddhatherānaṃ,baddhatheranam,1,1,0,0,14
270874,mahāvattaniaṭaviyaṃ,mahavattaniataviyam,2,2,0,0,19
270875,kāḷavallīhi,kalavallihi,1,1,0,0,11
270876,yathānipannova,yathanipannova,1,1,0,0,14
270877,V1.0034,V1.0034,34,34,0,0,7
270878,pūtilatāya,putilataya,5,5,0,0,10
270879,vanadāhe,vanadahe,1,1,0,0,8
270880,valliṃ,vallim,28,23,5,0,6
270881,acchinditvāva,acchinditvava,1,1,0,0,13
270882,dīghabhāṇakaabhayatthero,dighabhanakaabhayatthero,6,4,2,0,24
270883,satisādhano,satisadhano,1,0,1,0,11
270884,adhiṭṭhitānaṃ,adhitthitanam,6,5,1,0,13
270885,ananvāssavanīyato,ananvassavaniyato,1,1,0,0,17
270886,cakkhudvārādipavattassa,cakkhudvaradipavattassa,1,1,0,0,23
270887,anvāssavanīyaṃ,anvassavaniyam,1,1,0,0,14
270888,nimittādiggāhaṃ,nimittadiggaham,2,2,0,0,15
270889,asammuṭṭhāya,asammutthaya,3,3,0,0,12
270890,nisedhentena,nisedhentena,2,2,0,0,12
270891,asampādite,asampadite,1,1,0,0,10
270892,pātimokkhasaṃvarasīlampi,patimokkhasamvarasilampi,4,4,0,0,24
270893,anaddhaniyaṃ,anaddhaniyam,11,7,4,0,12
270894,aciraṭṭhitikaṃ,aciratthitikam,3,3,0,0,14
270895,asaṃvihitasākhāparivāramiva,asamvihitasakhaparivaramiva,1,1,0,0,27
270896,kilesacorehi,kilesacorehi,12,12,0,0,12
270897,vivaṭadvāro,vivatadvaro,4,4,0,0,11
270898,hārīhi,harihi,2,2,0,0,6
270899,cittañcassa,cittancassa,20,18,2,0,11
270900,ducchannamagāraṃ,ducchannamagaram,1,1,0,0,16
270901,gāmaṃva,gamamva,2,2,0,0,7
270902,hārino,harino,2,2,0,0,6
270903,V1.0035,V1.0035,34,34,0,0,7
270904,samativijjhatī,samativijjhati,4,4,0,0,14
270905,susaṃvihitasākhāparivāramiva,susamvihitasakhaparivaramiva,1,1,0,0,28
270906,susaṃvutadvāro,susamvutadvaro,1,1,0,0,14
270907,succhannamagāraṃ,succhannamagaram,1,1,0,0,16
270908,succhannaṃ,succhannam,7,7,0,0,10
270909,atiukkaṭṭhadesanā,atiukkatthadesana,2,1,1,0,17
270910,lahuparivattaṃ,lahuparivattam,32,31,1,0,14
270911,asubhamanasikārena,asubhamanasikarena,2,2,0,0,18
270912,adhunāpabbajitena,adhunapabbajitena,1,1,0,0,17
270913,adhunāpabbajitassa,adhunapabbajitassa,1,1,0,0,18
270914,V1.0036,V1.0036,34,34,0,0,7
270915,rāgūpasañhitaṃ,ragupasanhitam,6,3,3,0,14
270916,indriyasaṃvarapūrakena,indriyasamvarapurakena,1,1,0,0,22
270917,kuraṇḍakamahāleṇavāsinā,kurandakamahalenavasina,1,1,0,0,23
270918,cittaguttattherena,cittaguttattherena,1,1,0,0,18
270919,corakamahāvihāravāsinā,corakamahaviharavasina,1,1,0,0,22
270920,mahāmittattherena,mahamittattherena,1,1,0,0,17
270921,kuraṇḍakamahāleṇe,kurandakamahalene,1,1,0,0,17
270922,abhinikkhamanacittakammaṃ,abhinikkhamanacittakammam,1,1,0,0,25
270923,senāsanacārikaṃ,senasanacarikam,26,23,3,0,15
270924,atirekasaṭṭhi,atirekasatthi,3,3,0,0,13
270925,cakkhumante,cakkhumante,1,1,0,0,11
270926,ullokitapubbaṃ,ullokitapubbam,2,1,1,0,14
270927,leṇadvāre,lenadvare,7,7,0,0,9
270928,mahānāgarukkhopi,mahanagarukkhopi,1,1,0,0,16
270929,ullokitapubbo,ullokitapubbo,1,1,0,0,13
270930,kesaranipātaṃ,kesaranipatam,1,1,0,0,13
270931,disvāvassa,disvavassa,1,1,0,0,10
270932,pupphitabhāvaṃ,pupphitabhavam,4,3,1,0,14
270933,guṇasampattiṃ,gunasampattim,4,4,0,0,13
270934,anāgacchante,anagacchante,11,11,0,0,12
270935,taruṇaputtānaṃ,tarunaputtanam,2,2,0,0,14
270936,thane,thane,27,27,0,0,5
270937,lañjāpesi,lanjapesi,2,2,0,0,9
270938,pavesetha,pavesetha,4,4,0,0,9
270939,gaṇhissāmī,ganhissami,213,209,4,0,10
270940,abhiharāpetvā,abhiharapetva,2,2,0,0,13
270941,vandatu,vandatu,1,1,0,0,7
270942,sattadivasā,sattadivasa,4,3,1,0,11
270943,V1.0037,V1.0037,34,34,0,0,7
270944,vandamānāya,vandamanaya,1,1,0,0,11
270945,kuraṇḍakamahāleṇaṃ,kurandakamahalenam,1,1,0,0,18
270946,ārūhi,aruhi,3,3,0,0,5
270947,daṇḍadīpikaṃ,dandadipikam,12,12,0,0,12
270948,majjhimayāmasamanantaraṃ,majjhimayamasamanantaram,1,1,0,0,24
270949,unnādayanto,unnadayanto,2,2,0,0,11
270950,attatthakāmo,attatthakamo,1,1,0,0,12
270951,lolalocano,lolalocano,1,1,0,0,10
270952,vanamakkaṭalolassa,vanamakkatalolassa,1,1,0,0,18
270953,mahāmittattherassāpi,mahamittattherassapi,1,1,0,0,20
270954,visagaṇḍakarogo,visagandakarogo,1,1,0,0,15
270955,dhītāpissā,dhitapissa,2,2,0,0,10
270956,aphāsukabhāvaṃ,aphasukabhavam,3,3,0,0,14
270957,bhesajjamāharā,bhesajjamahara,1,1,0,0,14
270958,ācikkhissaṃ,acikkhissam,6,5,1,0,11
270959,lobhasahagatena,lobhasahagatena,2,2,0,0,15
270960,visabhāgarūpaṃ,visabhagarupam,7,6,1,0,14
270961,olokitapubbaṃ,olokitapubbam,3,3,0,0,13
270962,saccavacanena,saccavacanena,14,14,0,0,13
270963,parimajjā,parimajja,2,2,0,0,9
270964,pheṇapiṇḍo,phenapindo,26,25,1,0,10
270965,dhareyya,dhareyya,7,7,0,0,8
270966,puttasadisassa,puttasadisassa,1,1,0,0,14
270967,jālavicitrena,jalavicitrena,1,1,0,0,13
270968,parāmaseyyā,paramaseyya,2,2,0,0,11
270969,attamanavācaṃ,attamanavacam,16,14,2,0,13
270970,kulaputtamāni,kulaputtamani,1,1,0,0,13
270971,mittattherova,mittattherova,1,1,0,0,13
270972,V1.0038,V1.0038,34,34,0,0,7
270973,sampādetabbā,sampadetabba,10,10,0,0,12
270974,vīriyasādhanā,viriyasadhana,1,0,1,0,13
270975,sammāraddhavīriyassa,sammaraddhaviriyassa,1,1,0,0,20
270976,micchājīvappahānasambhavato,micchajivappahanasambhavato,1,1,0,0,27
270977,piṇḍapātacariyādīhi,pindapatacariyadihi,10,10,0,0,19
270978,esanāhi,esanahi,1,1,0,0,7
270979,parisuddhuppādeyeva,parisuddhuppadeyeva,1,1,0,0,19
270980,paṭisevamānena,patisevamanena,2,2,0,0,14
270981,aparisuddhuppāde,aparisuddhuppade,1,1,0,0,16
270982,āsīvise,asivise,12,12,0,0,7
270983,parivajjayatā,parivajjayata,2,2,0,0,13
270984,apariggahitadhutaṅgassa,apariggahitadhutangassa,2,2,0,0,23
270985,dhammadesanādīhi,dhammadesanadihi,4,3,1,0,16
270986,parisuddhuppādā,parisuddhuppada,2,2,0,0,15
270987,atiparisuddhuppādāyeva,atiparisuddhuppadayeva,1,1,0,0,22
270988,pariggahitadhutaṅgassa,pariggahitadhutangassa,2,2,0,0,22
270989,dhutaguṇe,dhutagune,19,18,1,0,9
270990,dhutaṅganiyamānulomena,dhutanganiyamanulomena,1,1,0,0,22
270991,ekabyādhivūpasamatthañcassa,ekabyadhivupasamatthancassa,1,1,0,0,27
270992,pūtihariṭakīcatumadhuresu,putiharitakicatumadhuresu,1,1,0,0,25
270993,paribhuñjissantī,paribhunjissanti,13,13,0,0,16
270994,hariṭakīkhaṇḍameva,haritakikhandameva,1,1,0,0,18
270995,paribhuñjamānassa,paribhunjamanassa,1,1,0,0,17
270996,dhutaṅgasamādānaṃ,dhutangasamadanam,7,6,1,0,17
270997,uttamaariyavaṃsiko,uttamaariyavamsiko,2,1,1,0,18
270998,ājīvaṃ,ajivam,38,36,2,0,6
270999,parisodhentassa,parisodhentassa,2,2,0,0,15
271000,piṇḍapāte,pindapate,101,87,14,0,9
271001,nimittobhāsaparikathāviññattiyo,nimittobhasaparikathavinnattiyo,2,2,0,0,31
271002,nimittobhāsaparikathā,nimittobhasaparikatha,2,2,0,0,21
271003,senāsanatthaṃ,senasanattham,3,3,0,0,13
271004,bhūmiparikammādīni,bhumiparikammadini,2,2,0,0,18
271005,panaññāpi,panannapi,20,18,2,0,9
271006,pariyāyakathā,pariyayakatha,19,16,3,0,13
271007,vinayadharā,vinayadhara,86,82,4,0,11
271008,suttantikā,suttantika,22,19,3,0,10
271009,anuññātāpi,anunnatapi,1,1,0,0,10
271010,appicchatādiguṇeyeva,appicchatadiguneyeva,1,1,0,0,20
271011,jīvitakkhayepi,jivitakkhayepi,1,1,0,0,14
271012,uppannapaccaye,uppannapaccaye,3,3,0,0,14
271013,paramasallekhavuttī,paramasallekhavutti,2,2,0,0,19
271014,kirāyasmā,kirayasma,28,27,1,0,9
271015,brūhayamāno,bruhayamano,3,2,1,0,11
271016,V1.0039,V1.0039,34,34,0,0,7
271017,udaravātābādho,udaravatabadho,11,10,1,0,14
271018,tassāyasmato,tassayasmato,16,16,0,0,12
271019,gihikāle,gihikale,80,78,2,0,8
271020,sappimadhusakkarādīhi,sappimadhusakkaradihi,7,7,0,0,21
271021,asambhinnakhīrapāyāsaṃ,asambhinnakhirapayasam,5,4,1,0,22
271022,caṅkamanakoṭiyaṃ,cankamanakotiyam,44,44,0,0,16
271023,upaṭṭhākakulaṃ,upatthakakulam,31,31,0,0,14
271024,tikicchānimittaṃ,tikicchanimittam,1,1,0,0,16
271025,paṭiyādetha,patiyadetha,6,6,0,0,11
271026,muñcissāmī,muncissami,3,3,0,0,10
271027,paṭiyādiyiṃsu,patiyadiyimsu,2,2,0,0,13
271028,gamanākāraṃ,gamanakaram,15,15,0,0,11
271029,handāvuso,handavuso,9,8,1,0,9
271030,paribhuñjā,paribhunja,20,20,0,0,10
271031,uppattimūlaṃ,uppattimulam,2,1,1,0,12
271032,aparibhogāraho,aparibhogaraho,6,3,3,0,14
271033,sopāyasmā,sopayasma,4,4,0,0,9
271034,mādisena,madisena,15,15,0,0,8
271035,nikujjesi,nikujjesi,1,1,0,0,9
271036,carantesupi,carantesupi,1,1,0,0,11
271037,vacīviññattivipphārā,vacivinnattivipphara,2,2,0,0,20
271038,V1.0040,V1.0040,34,34,0,0,7
271039,bhindeyyaṃ,bhindeyyam,8,8,0,0,10
271040,cajamānopi,cajamanopi,6,6,0,0,10
271041,ārādhemi,aradhemi,9,8,1,0,8
271042,vivajjemi,vivajjemi,5,4,1,0,9
271043,buddhappaṭikuṭṭhaṃ,buddhappatikuttham,2,2,0,0,18
271044,ciragumbavāsikaambakhādakamahātissattheravatthupi,ciragumbavasikaambakhadakamahatissattheravatthupi,1,1,0,0,49
271045,anesanāya,anesanaya,35,35,0,0,9
271046,parisodheyya,parisodheyya,5,5,0,0,12
271047,paññāsādhanaṃ,pannasadhanam,1,0,1,0,13
271048,ādīnavānisaṃsadassanasamatthabhāvato,adinavanisamsadassanasamatthabhavato,1,1,0,0,36
271049,paccayagedhaṃ,paccayagedham,8,7,1,0,13
271050,paribhuñjantena,paribhunjantena,19,16,3,0,15
271051,paṭilābhakāle,patilabhakale,3,3,0,0,13
271052,paribhogakāle,paribhogakale,23,23,0,0,13
271053,paṭilābhakālepi,patilabhakalepi,1,1,0,0,15
271054,anavajjova,anavajjova,3,2,1,0,10
271055,paribhogakālepi,paribhogakalepi,5,5,0,0,15
271056,sanniṭṭhānakaro,sannitthanakaro,1,1,0,0,15
271057,paribhogā,paribhoga,27,24,3,0,9
271058,theyyaparibhogo,theyyaparibhogo,23,11,12,0,15
271059,iṇaparibhogo,inaparibhogo,24,14,10,0,12
271060,dāyajjaparibhogo,dayajjaparibhogo,23,17,6,0,16
271061,sāmiparibhogoti,samiparibhogoti,7,7,0,0,15
271062,purebhattapacchābhattapurimayāmamajjhimayāmapacchimayāmesu,purebhattapacchabhattapurimayamamajjhimayamapacchimayamesu,2,2,0,0,58
271063,sacassa,sacassa,81,76,5,0,7
271064,apaccavekkhatova,apaccavekkhatova,2,1,1,0,16
271065,iṇaparibhogaṭṭhāne,inaparibhogatthane,15,10,5,0,18
271066,senāsanampi,senasanampi,33,28,5,0,11
271067,bhesajjassa,bhesajjassa,23,22,1,0,11
271068,paṭiggahaṇepi,patiggahanepi,30,25,5,0,13
271069,paribhogepi,paribhogepi,23,18,5,0,11
271070,satipaccayatāva,satipaccayatava,1,1,0,0,15
271071,V1.0041,V1.0041,34,34,0,0,7
271072,akarontasseva,akarontasseva,8,6,2,0,13
271073,desanāsuddhi,desanasuddhi,16,5,11,0,12
271074,saṃvarasuddhi,samvarasuddhi,11,5,6,0,13
271075,pariyeṭṭhisuddhi,pariyetthisuddhi,11,5,6,0,16
271076,paccavekkhaṇasuddhīti,paccavekkhanasuddhiti,7,6,1,0,21
271077,sujjhanato,sujjhanato,11,9,2,0,10
271078,desanāsuddhīti,desanasuddhiti,2,1,1,0,14
271079,cittādhiṭṭhānasaṃvareneva,cittadhitthanasamvareneva,3,3,0,0,25
271080,saṃvarasuddhīti,samvarasuddhiti,3,2,1,0,15
271081,pariyeṭṭhisuddhīti,pariyetthisuddhiti,1,1,0,0,18
271082,paccavekkhaṇasuddhi,paccavekkhanasuddhi,7,0,7,0,19
271083,paccavekkhaṇena,paccavekkhanena,16,16,0,0,15
271084,anāpattī,anapatti,257,224,33,0,8
271085,paccayaparibhogo,paccayaparibhogo,6,6,0,0,16
271086,pitusantakānaṃ,pitusantakanam,4,4,0,0,14
271087,kiṃpanete,kimpanete,1,1,0,0,9
271088,dinnāpi,dinnapi,9,8,1,0,7
271089,dhammadāyādasuttañcettha,dhammadayadasuttancettha,3,1,2,0,24
271090,sāmiparibhogo,samiparibhogo,18,11,7,0,13
271091,theyyaparibhoge,theyyaparibhoge,4,4,0,0,15
271092,paccavekkhitaparibhogo,paccavekkhitaparibhogo,14,14,0,0,22
271093,iṇaparibhogassa,inaparibhogassa,4,4,0,0,15
271094,paccanīkattā,paccanikatta,6,6,0,0,12
271095,āṇaṇyaparibhogo,ananyaparibhogo,5,4,1,0,15
271096,dāyajjaparibhogeyeva,dayajjaparibhogeyeva,7,6,1,0,20
271097,sīlavāpi,silavapi,8,6,2,0,8
271098,sekkhotveva,sekkhotveva,3,3,0,0,11
271099,patthayamānena,patthayamanena,9,9,0,0,14
271100,vuttappakārāya,vuttappakaraya,44,42,2,0,14
271101,paccavekkhaṇāya,paccavekkhanaya,53,51,2,0,15
271102,V1.0042,V1.0042,34,34,0,0,7
271103,sayanāsanañca,sayanasananca,11,11,0,0,13
271104,āpañca,apanca,2,2,0,0,6
271105,saṅghāṭirajūpavāhanaṃ,sanghatirajupavahanam,4,2,2,0,21
271106,varapaññasāvako,varapannasavako,5,5,0,0,15
271107,saṅghāṭirajūpavāhane,sanghatirajupavahane,2,2,0,0,20
271108,vāribindu,varibindu,4,2,2,0,9
271109,anuggahā,anuggaha,6,6,0,0,8
271110,khajjesu,khajjesu,1,1,0,0,8
271111,bhojjesu,bhojjesu,1,1,0,0,8
271112,sāyanesu,sayanesu,1,1,0,0,8
271113,vaṇassa,vanassa,7,7,0,0,7
271114,ālepanarūhane,alepanaruhane,2,1,1,0,13
271115,kantāre,kantare,35,34,1,0,7
271116,puttamaṃsaṃva,puttamamsamva,4,4,0,0,13
271117,akkhassabbhañjanaṃ,akkhassabbhanjanam,3,3,0,0,18
271118,yāpanatthamamucchito,yapanatthamamucchito,3,3,0,0,20
271119,paccayasannissitasīlassa,paccayasannissitasilassa,10,10,0,0,24
271120,bhāgineyyasaṅgharakkhitasāmaṇerassa,bhagineyyasangharakkhitasamanerassa,1,1,0,0,35
271121,sālikūraṃ,salikuram,2,1,1,0,9
271122,sunibbutaṃ,sunibbutam,2,1,1,0,10
271123,saṃvegamalabhiṃ,samvegamalabhim,3,3,0,0,15
271124,V1.0043,V1.0043,34,34,0,0,7
271125,paṭisevetha,patisevetha,1,1,0,0,11
271126,pātimokkhasaṃvarasīlādivasena,patimokkhasamvarasiladivasena,1,1,0,0,29
271127,paṭhamasīlapañcakaṃ,pathamasilapancakam,1,1,0,0,19
271128,pañcavidhakoṭṭhāsassa,pancavidhakotthasassa,1,1,0,0,21
271129,paṭhamapañcake,pathamapancake,7,7,0,0,14
271130,anupasampannasīlādivasena,anupasampannasiladivasena,1,1,0,0,25
271131,pariyantasikkhāpadānaṃ,pariyantasikkhapadanam,5,3,2,0,22
271132,upasampannānaṃ,upasampannanam,17,16,1,0,14
271133,apariyantasikkhāpadānaṃ,apariyantasikkhapadanam,4,3,1,0,23
271134,puthujjanakalyāṇakānaṃ,puthujjanakalyanakanam,6,5,1,0,22
271135,sekkhapariyante,sekkhapariyante,6,4,2,0,15
271136,paripūrakārīnaṃ,paripurakarinam,6,4,2,0,15
271137,anapekkhānaṃ,anapekkhanam,6,4,2,0,12
271138,pariccattajīvitānaṃ,pariccattajivitanam,4,2,2,0,19
271139,tathāgatasāvakānaṃ,tathagatasavakanam,4,3,1,0,18
271140,sapariyantattā,sapariyantatta,2,1,1,0,14
271141,koṭisahassāni,kotisahassani,5,5,0,0,13
271142,asītisatakoṭiyo,asitisatakotiyo,3,3,0,0,15
271143,paññāsasatasahassāni,pannasasatasahassani,4,4,0,0,20
271144,punāpare,punapare,16,16,0,0,8
271145,V1.0044,V1.0044,34,34,0,0,7
271146,saṃvaravinayā,samvaravinaya,5,4,1,0,13
271147,vinayasaṃvare,vinayasamvare,3,3,0,0,13
271148,sapariyantampi,sapariyantampi,2,2,0,0,14
271149,anavasesavasena,anavasesavasena,2,1,1,0,15
271150,samādānabhāvañca,samadanabhavanca,1,1,0,0,16
271151,adiṭṭhapariyantabhāvañca,aditthapariyantabhavanca,1,1,0,0,24
271152,ciragumbavāsikaambakhādakamahātissattherassa,ciragumbavasikaambakhadakamahatissattherassa,1,1,0,0,44
271153,sīlamiva,silamiva,1,1,0,0,8
271154,jīvitañcāpi,jivitancapi,6,5,1,0,11
271155,dhammamanussaranto,dhammamanussaranto,5,4,1,0,18
271156,sappurisānussatiṃ,sappurisanussatim,2,1,1,0,17
271157,jīvitasaṃsayepi,jivitasamsayepi,1,1,0,0,15
271158,avītikkamma,avitikkamma,21,20,1,0,11
271159,piṭṭhigatova,pitthigatova,1,1,0,0,12
271160,karotetādisaṃ,karotetadisam,2,2,0,0,13
271161,sammasitvāna,sammasitvana,4,4,0,0,12
271162,piṭṭhigato,pitthigato,2,2,0,0,10
271163,upasampadato,upasampadato,17,17,0,0,12
271164,sudhotajātimaṇi,sudhotajatimani,3,2,1,0,15
271165,suparikammakatasuvaṇṇaṃ,suparikammakatasuvannam,4,4,0,0,23
271166,atiparisuddhattā,atiparisuddhatta,1,1,0,0,16
271167,cittuppādamattakenapi,cittuppadamattakenapi,1,1,0,0,21
271168,arahattasseva,arahattasseva,4,4,0,0,13
271169,paripuṇṇapārisuddhīti,paripunnaparisuddhiti,1,0,1,0,21
271170,mahāsaṅgharakkhitabhāgineyyasaṅgharakkhitattherānaṃ,mahasangharakkhitabhagineyyasangharakkhitattheranam,2,1,1,0,51
271171,atikkantasaṭṭhivassaṃ,atikkantasatthivassam,1,1,0,0,21
271172,lokuttarādhigamaṃ,lokuttaradhigamam,1,1,0,0,17
271173,parinibbutāti,parinibbutati,11,8,3,0,13
271174,dvādasayojanā,dvadasayojana,9,9,0,0,13
271175,puthujjanakālakiriyāya,puthujjanakalakiriyaya,2,2,0,0,22
271176,paṭṭhapesiṃ,patthapesim,3,3,0,0,11
271177,V1.0045,V1.0045,34,34,0,0,7
271178,nikkhamanāva,nikkhamanava,1,1,0,0,12
271179,accharikāya,accharikaya,1,1,0,0,11
271180,nibbattentā,nibbattenta,3,3,0,0,11
271181,karitthā,karittha,30,30,0,0,8
271182,pabbajitakālato,pabbajitakalato,71,68,3,0,15
271183,aññāṇapakataṃ,annanapakatam,2,1,1,0,13
271184,bhāgineyyopissa,bhagineyyopissa,1,1,0,0,15
271185,paññāsavassakāle,pannasavassakale,3,3,0,0,16
271186,dhammadharaṃ,dhammadharam,22,14,8,0,12
271187,buddhasāvakaṃ,buddhasavakam,9,9,0,0,13
271188,nekkhaṃ,nekkham,30,24,6,0,7
271189,jambonadasseva,jambonadasseva,12,11,1,0,14
271190,brahmunāpi,brahmunapi,15,13,2,0,10
271191,diṭṭhivasena,ditthivasena,78,75,3,0,12
271192,aparāmaṭṭhattā,aparamatthatta,16,15,1,0,14
271193,aparāmaṭṭhasīlaṃ,aparamatthasilam,1,1,0,0,16
271194,aparāmaṭṭhapārisuddhīti,aparamatthaparisuddhiti,1,0,1,0,23
271195,kuṭumbiyaputtatissattherassa,kutumbiyaputtatissattherassa,2,2,0,0,28
271196,patiṭṭhātukāmo,patitthatukamo,5,5,0,0,14
271197,V1.0046,V1.0046,34,34,0,0,7
271198,saññapessāmi,sannapessami,5,5,0,0,12
271199,sarāgamaraṇaṃ,saragamaranam,5,5,0,0,13
271200,aruṇuggamhi,arunuggamhi,4,4,0,0,11
271201,aññataropi,annataropi,49,49,0,0,10
271202,āhārampi,aharampi,5,5,0,0,8
271203,samparivattati,samparivattati,14,14,0,0,14
271204,jīvitasaṅkhārā,jivitasankhara,9,8,1,0,14
271205,miyyamāno,miyyamano,3,3,0,0,9
271206,saggasampattiṃ,saggasampattim,24,20,4,0,14
271207,paccakkhāya,paccakkhaya,195,194,1,0,11
271208,paṭiladdhagihibhāvasadisī,patiladdhagihibhavasadisi,1,1,0,0,25
271209,sīleneva,sileneva,3,2,1,0,8
271210,dukhitassa,dukhitassa,11,11,0,0,10
271211,ruppato,ruppato,8,8,0,0,7
271212,parisussati,parisussati,12,12,0,0,11
271213,khippamidaṃ,khippamidam,3,3,0,0,11
271214,jaññasaṅkhātaṃ,jannasankhatam,6,4,2,0,14
271215,sucisammataṃ,sucisammatam,4,4,0,0,12
271216,nānākuṇapaparipūraṃ,nanakunapaparipuram,5,4,1,0,19
271217,jaññarūpaṃ,jannarupam,6,4,2,0,10
271218,duggandhiyaṃ,duggandhiyam,2,1,1,0,12
271219,byādhidhammaṃ,byadhidhammam,24,23,1,0,13
271220,yatthappamattā,yatthappamatta,4,4,0,0,14
271221,adhimucchitā,adhimucchita,5,5,0,0,12
271222,sugatūpapattiyā,sugatupapattiya,4,4,0,0,15
271223,arahantādīnaṃ,arahantadinam,2,1,1,0,13
271224,sabbadarathappaṭippassaddhiyā,sabbadarathappatippassaddhiya,1,1,0,0,29
271225,paṭippassaddhipārisuddhīti,patippassaddhiparisuddhiti,1,0,1,0,26
271226,pariyantapārisuddhiādivasena,pariyantaparisuddhiadivasena,1,1,0,0,28
271227,dutiyasīlapañcakaṃ,dutiyasilapancakam,1,1,0,0,18
271228,dutiyapañcake,dutiyapancake,8,8,0,0,13
271229,V1.0047,V1.0047,34,34,0,0,7
271230,pahānādivasena,pahanadivasena,2,2,0,0,14
271231,adinnādānassa,adinnadanassa,37,34,3,0,13
271232,kāmesumicchācārassa,kamesumicchacarassa,13,13,0,0,19
271233,pisuṇāya,pisunaya,153,153,0,0,8
271234,samphappalāpassa,samphappalapassa,15,15,0,0,16
271235,abyāpādena,abyapadena,42,40,2,0,10
271236,ālokasaññāya,alokasannaya,36,36,0,0,12
271237,thinamiddhassa,thinamiddhassa,127,121,6,0,14
271238,avikkhepena,avikkhepena,48,48,0,0,11
271239,dhammavavatthānena,dhammavavatthanena,24,24,0,0,18
271240,ākāsānañcāyatanasamāpattiyā,akasanancayatanasamapattiya,35,34,1,0,27
271241,rūpasaññāya,rupasannaya,24,24,0,0,11
271242,paṭighasaññāya,patighasannaya,18,18,0,0,14
271243,nānattasaññāya,nanattasannaya,13,13,0,0,14
271244,viññāṇañcāyatanasamāpattiyā,vinnanancayatanasamapattiya,30,30,0,0,27
271245,ākāsānañcāyatanasaññāya,akasanancayatanasannaya,15,15,0,0,23
271246,ākiñcaññāyatanasamāpattiyā,akincannayatanasamapattiya,30,30,0,0,26
271247,viññāṇañcāyatanasaññāya,vinnanancayatanasannaya,13,13,0,0,23
271248,nevasaññānāsaññāyatanasamāpattiyā,nevasannanasannayatanasamapattiya,51,50,1,0,33
271249,ākiñcaññāyatanasaññāya,akincannayatanasannaya,16,16,0,0,22
271250,aniccānupassanāya,aniccanupassanaya,80,77,3,0,17
271251,niccasaññāya,niccasannaya,17,16,1,0,12
271252,dukkhānupassanāya,dukkhanupassanaya,58,58,0,0,17
271253,sukhasaññāya,sukhasannaya,37,33,4,0,12
271254,anattānupassanāya,anattanupassanaya,57,57,0,0,17
271255,attasaññāya,attasannaya,15,14,1,0,11
271256,nibbidānupassanāya,nibbidanupassanaya,29,28,1,0,18
271257,virāgānupassanāya,viraganupassanaya,21,21,0,0,17
271258,nirodhānupassanāya,nirodhanupassanaya,24,24,0,0,18
271259,paṭinissaggānupassanāya,patinissagganupassanaya,26,25,1,0,23
271260,khayānupassanāya,khayanupassanaya,10,10,0,0,16
271261,ghanasaññāya,ghanasannaya,8,6,2,0,12
271262,vayānupassanāya,vayanupassanaya,10,10,0,0,15
271263,āyūhanassa,ayuhanassa,14,14,0,0,10
271264,vipariṇāmānupassanāya,viparinamanupassanaya,10,10,0,0,21
271265,dhuvasaññāya,dhuvasannaya,5,5,0,0,12
271266,animittānupassanāya,animittanupassanaya,12,12,0,0,19
271267,appaṇihitānupassanāya,appanihitanupassanaya,11,11,0,0,21
271268,paṇidhiyā,panidhiya,34,33,1,0,9
271269,suññatānupassanāya,sunnatanupassanaya,15,15,0,0,18
271270,abhinivesassa,abhinivesassa,22,22,0,0,13
271271,sārādānābhinivesassa,saradanabhinivesassa,3,3,0,0,20
271272,yathābhūtañāṇadassanena,yathabhutananadassanena,8,8,0,0,23
271273,sammohābhinivesassa,sammohabhinivesassa,5,5,0,0,19
271274,ādīnavānupassanāya,adinavanupassanaya,13,13,0,0,18
271275,ālayābhinivesassa,alayabhinivesassa,4,4,0,0,17
271276,paṭisaṅkhānupassanāya,patisankhanupassanaya,19,18,1,0,21
271277,appaṭisaṅkhāya,appatisankhaya,15,14,1,0,14
271278,vivaṭṭanānupassanāya,vivattananupassanaya,10,10,0,0,20
271279,saññogābhinivesassa,sannogabhinivesassa,2,2,0,0,19
271280,diṭṭhekaṭṭhānaṃ,ditthekatthanam,9,8,1,0,15
271281,aṇusahagatānaṃ,anusahagatanam,2,1,1,0,14
271282,pāmojjāya,pamojjaya,6,4,2,0,9
271283,somanassāya,somanassaya,9,7,2,0,11
271284,āsevanāya,asevanaya,15,14,1,0,9
271285,bahulīkammāya,bahulikammaya,3,3,0,0,13
271286,alaṅkārāya,alankaraya,5,4,1,0,10
271287,parikkhārāya,parikkharaya,8,7,1,0,12
271288,parivārāya,parivaraya,5,4,1,0,10
271289,V1.0048,V1.0048,34,34,0,0,7
271290,kusaladhammassa,kusaladhammassa,5,5,0,0,15
271291,vikampābhāvakaraṇena,vikampabhavakaranena,2,1,1,0,20
271292,vutteneva,vutteneva,15,15,0,0,9
271293,upadhāraṇasamādhānasaṅkhātena,upadharanasamadhanasankhatena,2,2,0,0,29
271294,veramaṇivasena,veramanivasena,5,5,0,0,14
271295,saṃvaravasena,samvaravasena,4,4,0,0,13
271296,tadubhayasampayuttacetanāvasena,tadubhayasampayuttacetanavasena,2,2,0,0,31
271297,avītikkamanavasena,avitikkamanavasena,6,6,0,0,18
271298,pavattisabbhāvaṃ,pavattisabbhavam,2,1,1,0,16
271299,pakāsitoyevāti,pakasitoyevati,1,1,0,0,14
271300,pahānasīlādivasena,pahanasiladivasena,1,1,0,0,18
271301,sīlasaṃkilesavodānaṃ,silasamkilesavodanam,1,1,0,0,20
271302,akhaṇḍādibhāvo,akhandadibhavo,6,5,1,0,14
271303,lābhayasādihetukena,labhayasadihetukena,1,1,0,0,19
271304,āpattikkhandhesu,apattikkhandhesu,12,10,2,0,16
271305,chinnasāṭako,chinnasatako,15,9,6,0,12
271306,chiddasāṭako,chiddasatako,6,6,0,0,12
271307,kucchiyā,kucchiya,31,28,3,0,8
271308,uṭṭhitena,utthitena,24,23,1,0,9
271309,visabhāgavaṇṇena,visabhagavannena,19,18,1,0,16
271310,kāḷarattādīnaṃ,kalarattadinam,8,8,0,0,14
271311,aññatarasarīravaṇṇā,annatarasariravanna,4,4,0,0,19
271312,visabhāgavaṇṇabinduvicitrā,visabhagavannabinduvicitra,3,3,0,0,26
271313,V1.0049,V1.0049,34,34,0,0,7
271314,sattavidhamethunasaṃyogavasena,sattavidhamethunasamyogavasena,1,1,0,0,30
271315,methunena,methunena,12,12,0,0,9
271316,dvayasamāpattiṃ,dvayasamapattim,2,2,0,0,15
271317,saṃkelāyati,samkelayati,6,6,0,0,11
271318,tirokuṭṭā,tirokutta,3,2,1,0,9
271319,tiropākārā,tiropakara,3,2,1,0,10
271320,V1.0050,V1.0050,34,34,0,0,7
271321,yānissa,yanissa,33,32,1,0,7
271322,bhinnānañca,bhinnananca,1,1,0,0,11
271323,sappaṭikammānaṃ,sappatikammanam,1,1,0,0,15
271324,paṭikammakaraṇena,patikammakaranena,2,2,0,0,17
271325,sattavidhamethunasaṃyogābhāvena,sattavidhamethunasamyogabhavena,1,1,0,0,31
271326,paḷāso,palaso,98,87,11,0,6
271327,sātheyyaṃ,satheyyam,1,1,0,0,9
271328,appicchatāsantuṭṭhitāsallekhatādīnañca,appicchatasantutthitasallekhatadinanca,1,1,0,0,38
271329,lābhādīnampi,labhadinampi,1,1,0,0,12
271330,pamādadosena,pamadadosena,4,4,0,0,12
271331,bhinnānipi,bhinnanipi,1,1,0,0,10
271332,paṭikammakatāni,patikammakatani,1,1,0,0,15
271333,V1.0051,V1.0051,34,34,0,0,7
271334,methunasaṃyogehi,methunasamyogehi,1,1,0,0,16
271335,kodhupanāhādīhi,kodhupanahadihi,2,2,0,0,15
271336,anupahatāni,anupahatani,1,1,0,0,11
271337,akhaṇḍāni,akhandani,55,48,7,0,9
271338,acchiddāni,acchiddani,34,29,5,0,10
271339,asabalāni,asabalani,34,26,8,0,9
271340,akammāsānīti,akammasaniti,1,0,1,0,12
271341,bhujissabhāvakaraṇato,bhujissabhavakaranato,7,7,0,0,21
271342,bhujissāni,bhujissani,34,26,8,0,10
271343,viññupasatthāni,vinnupasatthani,6,2,4,0,15
271344,aparāmaṭṭhāni,aparamatthani,32,25,7,0,13
271345,upacārasamādhiṃ,upacarasamadhim,29,28,1,0,15
271346,appanāsamādhiṃ,appanasamadhim,21,20,1,0,14
271347,saṃvattayantīti,samvattayantiti,7,7,0,0,15
271348,samādhisaṃvattanikāni,samadhisamvattanikani,37,29,8,0,21
271349,ādīnavadassanena,adinavadassanena,44,44,0,0,16
271350,evamādisuttanayena,evamadisuttanayena,1,1,0,0,18
271351,dussīlyahetu,dussilyahetu,1,1,0,0,12
271352,ananusāsanīyo,ananusasaniyo,2,1,1,0,13
271353,dussīlyagarahāsu,dussilyagarahasu,1,1,0,0,16
271354,dussīlyatāya,dussilyataya,1,1,0,0,12
271355,sāṇasāṭako,sanasatako,1,1,0,0,10
271356,apāyadukkhāvahanato,apayadukkhavahanato,1,1,0,0,19
271357,namahapphalakaraṇato,namahapphalakaranato,1,1,0,0,20
271358,anekavassagaṇikagūthakūpo,anekavassaganikaguthakupo,2,1,1,0,25
271359,dubbisodhano,dubbisodhano,2,1,1,0,12
271360,chavālātamiva,chavalatamiva,1,1,0,0,13
271361,paṭijānantopi,patijanantopi,1,1,0,0,13
271362,abhikkhuyeva,abhikkhuyeva,1,1,0,0,12
271363,anubandhagadrabho,anubandhagadrabho,1,1,0,0,17
271364,satatubbiggo,satatubbiggo,1,1,0,0,12
271365,sabbaverikapuriso,sabbaverikapuriso,1,1,0,0,17
271366,asaṃvāsāraho,asamvasaraho,2,1,1,0,12
271367,sutādiguṇayuttopi,sutadigunayuttopi,1,1,0,0,17
271368,apūjāraho,apujaraho,1,1,0,0,9
271369,susānaggi,susanaggi,1,1,0,0,9
271370,visesādhigame,visesadhigame,4,4,0,0,13
271371,rūpadassane,rupadassane,9,9,0,0,11
271372,caṇḍālakumārako,candalakumarako,2,2,0,0,15
271373,sukhitosmīti,sukhitosmiti,2,2,0,0,12
271374,maññamānopi,mannamanopi,3,3,0,0,11
271375,dukkhitova,dukkhitova,8,8,0,0,10
271376,aggikkhandhapariyāye,aggikkhandhapariyaye,2,2,0,0,20
271377,vuttadukkhabhāgitāya,vuttadukkhabhagitaya,1,1,0,0,20
271378,dussīlānañhi,dussilananhi,1,1,0,0,12
271379,pañcakāmaguṇaparibhogavandanamānanādisukhassādagadhitacittānaṃ,pancakamagunaparibhogavandanamananadisukhassadagadhitacittanam,1,1,0,0,62
271380,anussaraṇamattenāpi,anussaranamattenapi,1,1,0,0,19
271381,hadayasantāpaṃ,hadayasantapam,1,1,0,0,14
271382,uṇhalohituggārappavattanasamatthaṃ,unhalohituggarappavattanasamattham,1,1,0,0,34
271383,atikaṭukaṃ,atikatukam,1,1,0,0,10
271384,paccakkhakammavipāko,paccakkhakammavipako,1,1,0,0,20
271385,aggikkhandhaṃ,aggikkhandham,64,62,2,0,13
271386,V1.0052,V1.0052,34,34,0,0,7
271387,khattiyakaññaṃ,khattiyakannam,8,8,0,0,14
271388,brāhmaṇakaññaṃ,brahmanakannam,7,7,0,0,14
271389,gahapatikaññaṃ,gahapatikannam,5,5,0,0,14
271390,mudutalunahatthapādaṃ,mudutalunahatthapadam,5,5,0,0,21
271391,pāpadhammassa,papadhammassa,11,11,0,0,13
271392,asucisaṅkassarasamācārassa,asucisankassarasamacarassa,2,2,0,0,26
271393,paṭicchannakammantassa,paticchannakammantassa,3,3,0,0,22
271394,assamaṇassa,assamanassa,3,3,0,0,11
271395,samaṇapaṭiññassa,samanapatinnassa,4,2,2,0,16
271396,abrahmacārissa,abrahmacarissa,6,4,2,0,14
271397,brahmacāripaṭiññassa,brahmacaripatinnassa,6,4,2,0,20
271398,antopūtikassa,antoputikassa,4,2,2,0,13
271399,kasambujātassa,kasambujatassa,10,8,2,0,14
271400,nigaccheyya,nigaccheyya,52,52,0,0,11
271401,maraṇamattaṃ,maranamattam,71,70,1,0,12
271402,upapajjeyyā,upapajjeyya,13,13,0,0,11
271403,aggikkhandhupamāya,aggikkhandhupamaya,1,1,0,0,18
271404,itthipaṭibaddhapañcakāmaguṇaparibhogapaccayaṃ,itthipatibaddhapancakamagunaparibhogapaccayam,1,1,0,0,45
271405,vāḷarajjuyā,valarajjuya,2,2,0,0,11
271406,ghaṃseyya,ghamseyya,12,12,0,0,9
271407,nhāruṃ,nharum,28,28,0,0,6
271408,sādiyeyyā,sadiyeyya,26,26,0,0,9
271409,tiṇhāya,tinhaya,10,10,0,0,7
271410,teladhotāya,teladhotaya,4,4,0,0,11
271411,pahareyya,pahareyya,21,21,0,0,9
271412,añjalikammaṃ,anjalikammam,82,78,4,0,12
271413,tattena,tattena,18,17,1,0,7
271414,ādittena,adittena,17,17,0,0,8
271415,sampajjalitena,sampajjalitena,13,13,0,0,14
271416,sajotibhūtena,sajotibhutena,13,13,0,0,13
271417,sampaliveṭheyya,sampalivetheyya,3,3,0,0,15
271418,V1.0053,V1.0053,34,34,0,0,7
271419,paribhuñjeyyā,paribhunjeyya,11,11,0,0,13
271420,ayosaṅkunā,ayosankuna,9,9,0,0,10
271421,lohaguḷaṃ,lohagulam,10,9,1,0,9
271422,oṭṭhampi,otthampi,6,6,0,0,8
271423,ḍaheyya,daheyya,29,29,0,0,7
271424,mukhampi,mukhampi,21,21,0,0,8
271425,jivhampi,jivhampi,6,6,0,0,8
271426,kaṇṭhampi,kanthampi,8,8,0,0,9
271427,udarampi,udarampi,6,6,0,0,8
271428,nikkhameyya,nikkhameyya,16,15,1,0,11
271429,ayomañcaṃ,ayomancam,4,4,0,0,9
271430,ayopīṭhaṃ,ayopitham,4,4,0,0,9
271431,abhinisīdāpeyya,abhinisidapeyya,4,4,0,0,15
271432,abhinipajjāpeyya,abhinipajjapeyya,4,4,0,0,16
271433,uddhaṃpādaṃ,uddhampadam,28,27,1,0,11
271434,adhosiraṃ,adhosiram,29,28,1,0,9
271435,ayokumbhiyā,ayokumbhiya,1,1,0,0,11
271436,pheṇuddehakaṃ,phenuddehakam,27,22,5,0,13
271437,vāḷarajjutiṇhasattiayopaṭṭaayoguḷaayomañcaayopīṭhaayokumbhīupamāhi,valarajjutinhasattiayopattaayogulaayomancaayopithaayokumbhiupamahi,1,1,0,0,66
271438,abhivādanaañjalikammacīvarapiṇḍapātamañcapīṭhavihāraparibhogapaccayaṃ,abhivadanaanjalikammacivarapindapatamancapithaviharaparibhogapaccayam,1,1,0,0,69
271439,aggikkhandhāliṅganadukkhādhikadukkhakaṭukaphalaṃ,aggikkhandhalinganadukkhadhikadukkhakatukaphalam,2,1,1,0,48
271440,avijahato,avijahato,2,2,0,0,9
271441,bhinnasīlassa,bhinnasilassa,5,4,1,0,13
271442,abhivādanasādiyane,abhivadanasadiyane,1,1,0,0,18
271443,V1.0054,V1.0054,34,34,0,0,7
271444,vipannasīlassa,vipannasilassa,2,2,0,0,14
271445,daḷhavāḷarajjughaṃsanadukkhādhikadukkhabhāgissa,dalhavalarajjughamsanadukkhadhikadukkhabhagissa,1,1,0,0,47
271446,saddhānamañjalikammasādiyane,saddhanamanjalikammasadiyane,1,1,0,0,28
271447,asīlassa,asilassa,4,4,0,0,8
271448,sattippahāradukkhādhimattadukkhassa,sattippaharadukkhadhimattadukkhassa,1,1,0,0,35
271449,yaṃhetu,yamhetu,2,2,0,0,7
271450,cīvaraparibhogasukhaṃ,civaraparibhogasukham,1,1,0,0,21
271451,asaṃyatassa,asamyatassa,2,2,0,0,11
271452,jalitaayopaṭṭasamphasso,jalitaayopattasamphasso,1,1,0,0,23
271453,halāhalavisūpamo,halahalavisupamo,4,4,0,0,16
271454,gilitabbā,gilitabba,1,1,0,0,9
271455,ayoguḷā,ayogula,1,1,0,0,7
271456,sukhasammatopi,sukhasammatopi,1,1,0,0,14
271457,mañcapīṭhaparibhogo,mancapithaparibhogo,1,1,0,0,19
271458,bādhissanti,badhissanti,1,1,0,0,11
271459,jalitaayomañcapīṭhāni,jalitaayomancapithani,1,1,0,0,21
271460,saddhādeyyamhi,saddhadeyyamhi,1,1,0,0,14
271461,jalitesu,jalitesu,3,3,0,0,8
271462,nivasitabbaṃ,nivasitabbam,2,2,0,0,12
271463,ayokumbhimajjhesu,ayokumbhimajjhesu,1,1,0,0,17
271464,saṅkasarasamācāro,sankasarasamacaro,1,1,0,0,17
271465,antopūtīti,antoputiti,6,1,5,0,10
271466,asaññatassa,asannatassa,3,3,0,0,11
271467,samaṇajanavesadhārissa,samanajanavesadharissa,1,1,0,0,22
271468,khatamattānaṃ,khatamattanam,1,1,0,0,13
271469,vahantassa,vahantassa,2,2,0,0,10
271470,maṇḍanakāmā,mandanakama,1,1,0,0,11
271471,vivajjayantīdha,vivajjayantidha,1,1,0,0,15
271472,V1.0055,V1.0055,34,34,0,0,7
271473,amutto,amutto,6,6,0,0,6
271474,adhigamasukhehi,adhigamasukhehi,2,1,1,0,15
271475,supihitasaggadvāro,supihitasaggadvaro,1,1,0,0,18
271476,kāruṇikajanassa,karunikajanassa,1,1,0,0,15
271477,dussīlasamo,dussilasamo,1,1,0,0,11
271478,dussī,dussi,8,8,0,0,5
271479,sīlavipattiyaṃ,silavipattiyam,2,2,0,0,14
271480,vuttappakāraviparītato,vuttappakaraviparitato,1,1,0,0,22
271481,ānisaṃsadassanañca,anisamsadassananca,2,2,0,0,18
271482,pattacīvaradhāraṇaṃ,pattacivaradharanam,1,1,0,0,19
271483,suddhasīlassa,suddhasilassa,1,1,0,0,13
271484,nāvagāhati,navagahati,2,2,0,0,10
271485,pabhāsampattiyā,pabhasampattiya,3,3,0,0,15
271486,kāyagandhopi,kayagandhopi,2,1,1,0,12
271487,sīlagandhe,silagandhe,1,1,0,0,10
271488,gandhajātānaṃ,gandhajatanam,8,8,0,0,13
271489,avighātī,avighati,1,1,0,0,8
271490,appakāpi,appakapi,9,9,0,0,8
271491,pūjāsakkārabhājanaṃ,pujasakkarabhajanam,2,2,0,0,19
271492,bādhanti,badhanti,3,3,0,0,8
271493,samparāyikadukkhānaṃ,samparayikadukkhanam,2,1,1,0,20
271494,sampannasīlassa,sampannasilassa,5,5,0,0,15
271495,V1.0056,V1.0056,34,34,0,0,7
271496,sabbasampattimūlamhi,sabbasampattimulamhi,1,1,0,0,20
271497,sīlamhi,silamhi,2,2,0,0,7
271498,anekākāravokāraṃ,anekakaravokaram,18,17,1,0,16
271499,vibhāvayeti,vibhavayeti,19,17,2,0,11
271500,vibhāvayato,vibhavayato,1,1,0,0,11
271501,sīlavipattito,silavipattito,2,2,0,0,13
271502,ubbijjitvā,ubbijjitva,1,1,0,0,10
271503,sīlasampattininnaṃ,silasampattininnam,1,1,0,0,18
271504,vodāpetabbanti,vodapetabbanti,1,1,0,0,14
271505,paridīpitaṃ,paridipitam,55,51,4,0,11
271506,sādhujanapāmojjatthāya,sadhujanapamojjatthaya,24,24,0,0,22
271507,dhutaṅganiddeso,dhutanganiddeso,3,3,0,0,15
271508,V1.0057,V1.0057,34,34,0,0,7
271509,appicchatāsantuṭṭhitādīhi,appicchatasantutthitadihi,2,2,0,0,25
271510,samādinnasīlena,samadinnasilena,1,1,0,0,15
271511,evañhissa,evanhissa,20,19,1,0,9
271512,appicchatāsantuṭṭhitāsallekhapavivekāpacayavīriyārambhasubharatādiguṇasalilavikkhālitamalaṃ,appicchatasantutthitasallekhapavivekapacayaviriyarambhasubharatadigunasalilavikkhalitamalam,1,1,0,0,91
271513,sīlañceva,silanceva,18,16,2,0,9
271514,vatāni,vatani,18,12,6,0,6
271515,sampajjissanti,sampajjissanti,3,2,1,0,14
271516,anavajjasīlabbataguṇaparisuddhasabbasamācāro,anavajjasilabbatagunaparisuddhasabbasamacaro,1,1,0,0,44
271517,ariyavaṃsattaye,ariyavamsattaye,4,3,1,0,15
271518,bhāvanārāmatāsaṅkhātassa,bhavanaramatasankhatassa,1,1,0,0,24
271519,ariyavaṃsassa,ariyavamsassa,5,5,0,0,13
271520,adhigamāraho,adhigamaraho,2,2,0,0,12
271521,dhutaṅgakathaṃ,dhutangakatham,1,1,0,0,14
271522,ārabhissāma,arabhissama,3,3,0,0,11
271523,pariccattalokāmisānaṃ,pariccattalokamisanam,1,1,0,0,21
271524,anulomapaṭipadaṃyeva,anulomapatipadamyeva,1,1,0,0,20
271525,ārādhetukāmānaṃ,aradhetukamanam,1,1,0,0,15
271526,khalupacchābhattikaṅgaṃ,khalupacchabhattikangam,13,10,3,0,23
271527,yathāsanthatikaṅgaṃ,yathasanthatikangam,10,8,2,0,19
271528,nesajjikaṅganti,nesajjikanganti,4,4,0,0,15
271529,lakkhaṇādīhi,lakkhanadihi,30,27,3,0,12
271530,samādānavidhānato,samadanavidhanato,1,1,0,0,17
271531,tassānisaṃsato,tassanisamsato,1,1,0,0,14
271532,kusalattikato,kusalattikato,4,4,0,0,13
271533,dhutādīnaṃ,dhutadinam,5,3,2,0,10
271534,rathikasusānasaṅkārakūṭādīnaṃ,rathikasusanasankarakutadinam,2,2,0,0,29
271535,abbhuggataṭṭhena,abbhuggatatthena,20,20,0,0,16
271536,paṃsukūlamivāti,pamsukulamivati,3,3,0,0,15
271537,kucchitabhāvaṃ,kucchitabhavam,15,14,1,0,14
271538,ulatīti,ulatiti,12,11,1,0,7
271539,laddhanibbacanassa,laddhanibbacanassa,2,2,0,0,18
271540,paṃsukūlassa,pamsukulassa,9,9,0,0,12
271541,V1.0058,V1.0058,34,34,0,0,7
271542,saṅghāṭiuttarāsaṅgaantaravāsakasaṅkhātaṃ,sanghatiuttarasangaantaravasakasankhatam,3,2,1,0,40
271543,tecīvarikassa,tecivarikassa,5,5,0,0,13
271544,bhikkhāsaṅkhātānaṃ,bhikkhasankhatanam,4,4,0,0,18
271545,āmisapiṇḍānaṃ,amisapindanam,2,2,0,0,13
271546,nipatananti,nipatananti,3,3,0,0,11
271547,vatametassāti,vatametassati,4,4,0,0,13
271548,piṇḍapātī,pindapati,7,7,0,0,9
271549,patitunti,patitunti,1,1,0,0,9
271550,piṇḍapātikassa,pindapatikassa,18,16,2,0,14
271551,avakhaṇḍanaṃ,avakhandanam,9,8,1,0,12
271552,dānatoti,danatoti,4,1,3,0,8
271553,anavakhaṇḍananti,anavakhandananti,3,3,0,0,16
271554,apadānena,apadanena,9,9,0,0,9
271555,avakhaṇḍanarahitaṃ,avakhandanarahitam,2,1,1,0,18
271556,anugharanti,anugharanti,4,3,1,0,11
271557,sapadānacārī,sapadanacari,20,17,3,0,12
271558,sapadānacāriko,sapadanacariko,11,10,1,0,14
271559,ekāsanaṃ,ekasanam,16,14,2,0,8
271560,dutiyabhājanassa,dutiyabhajanassa,1,1,0,0,16
271561,pattapiṇḍo,pattapindo,2,2,0,0,10
271562,pattapiṇḍagahaṇe,pattapindagahane,2,1,1,0,16
271563,pattapiṇḍasaññaṃ,pattapindasannam,2,1,1,0,16
271564,pattapiṇḍiko,pattapindiko,22,20,2,0,12
271565,khalūti,khaluti,15,1,14,0,7
271566,pavāritena,pavaritena,60,57,3,0,10
271567,pacchābhattassa,pacchabhattassa,3,3,0,0,15
271568,pacchābhattabhojanaṃ,pacchabhattabhojanam,2,2,0,0,20
271569,pacchābhattabhojane,pacchabhattabhojane,2,2,0,0,19
271570,pacchābhattasaññaṃ,pacchabhattasannam,2,2,0,0,18
271571,pacchābhattiko,pacchabhattiko,5,4,1,0,14
271572,khalupacchābhattiko,khalupacchabhattiko,12,10,2,0,19
271573,samādānavasena,samadanavasena,36,34,2,0,14
271574,paṭikkhittātirittabhojanassetaṃ,patikkhittatirittabhojanassetam,2,2,0,0,31
271575,V1.0059,V1.0059,34,34,0,0,7
271576,rukkhamūlikassa,rukkhamulikassa,5,5,0,0,15
271577,abbhokāsikasosānikaṅgesupi,abbhokasikasosanikangesupi,1,0,1,0,26
271578,yathāsanthataṃ,yathasanthatam,4,3,1,0,14
271579,uddiṭṭhasenāsanassetaṃ,udditthasenasanassetam,2,2,0,0,22
271580,yathāsanthate,yathasanthate,2,2,0,0,13
271581,yathāsanthatiko,yathasanthatiko,17,15,2,0,15
271582,nesajjiko,nesajjiko,23,20,3,0,9
271583,nesajjikaṅgaṃ,nesajjikangam,22,17,5,0,13
271584,dhutakilesattā,dhutakilesatta,3,3,0,0,14
271585,dhutassa,dhutassa,16,16,0,0,8
271586,kilesadhunanato,kilesadhunanato,4,4,0,0,15
271587,dhutanti,dhutanti,3,3,0,0,8
271588,dhutaṅgāni,dhutangani,95,81,14,0,10
271589,dhutāni,dhutani,3,3,0,0,7
271590,paṭipakkhaniddhunanato,patipakkhaniddhunanato,2,2,0,0,22
271591,paṭipattiyātipi,patipattiyatipi,3,3,0,0,15
271592,samādānacetanālakkhaṇāni,samadanacetanalakkhanani,3,2,1,0,24
271593,samādānacetanā,samadanacetana,6,5,1,0,14
271594,loluppaviddhaṃsanarasāni,loluppaviddhamsanarasani,3,2,1,0,24
271595,nilloluppabhāvapaccupaṭṭhānāni,nilloluppabhavapaccupatthanani,3,2,1,0,30
271596,appicchatādiariyadhammapadaṭṭhānāni,appicchatadiariyadhammapadatthanani,2,2,0,0,35
271597,samādānavidhānatotiādīsu,samadanavidhanatotiadisu,1,1,0,0,24
271598,mahāsāvakassa,mahasavakassa,8,6,2,0,13
271599,tipiṭakassa,tipitakassa,2,2,0,0,11
271600,dvipiṭakassa,dvipitakassa,1,1,0,0,12
271601,ekapiṭakassa,ekapitakassa,1,1,0,0,12
271602,ekasaṅgītikassa,ekasangitikassa,1,1,0,0,15
271603,aṭṭhakathācariyassa,atthakathacariyassa,2,2,0,0,19
271604,dhutaṅgadharassa,dhutangadharassa,7,7,0,0,16
271605,V1.0060,V1.0060,34,34,0,0,7
271606,bhātikattherānaṃ,bhatikattheranam,1,1,0,0,16
271607,jeṭṭhakabhātu,jetthakabhatu,2,1,1,0,13
271608,dhutaṅgappicchatāya,dhutangappicchataya,3,2,1,0,19
271609,sādhāraṇakathā,sadharanakatha,1,1,0,0,14
271610,paṃsukūlikaṅgakathā,pamsukulikangakatha,1,1,0,0,19
271611,samādānavidhānappabhedabhedānisaṃse,samadanavidhanappabhedabhedanisamse,1,1,0,0,35
271612,gahapatidānacīvaraṃ,gahapatidanacivaram,2,1,1,0,19
271613,samādiyāmī,samadiyami,58,58,0,0,10
271614,samādinnadhutaṅgena,samadinnadhutangena,1,1,0,0,19
271615,sosānikaṃ,sosanikam,14,8,6,0,9
271616,pāpaṇikaṃ,papanikam,13,8,5,0,9
271617,rathiyacoḷaṃ,rathiyacolam,2,1,1,0,12
271618,saṅkāracoḷaṃ,sankaracolam,12,10,2,0,12
271619,nhānacoḷaṃ,nhanacolam,3,2,1,0,10
271620,titthacoḷaṃ,titthacolam,3,2,1,0,11
271621,aggiḍaḍḍhaṃ,aggidaddham,3,2,1,0,11
271622,gokhāyitaṃ,gokhayitam,5,5,0,0,10
271623,upacikākhāyitaṃ,upacikakhayitam,2,2,0,0,15
271624,undūrakhāyitaṃ,undurakhayitam,6,6,0,0,14
271625,antacchinnaṃ,antacchinnam,5,5,0,0,12
271626,dasācchinnaṃ,dasacchinnam,2,2,0,0,12
271627,dhajāhaṭaṃ,dhajahatam,8,4,4,0,10
271628,thūpacīvaraṃ,thupacivaram,6,3,3,0,12
271629,ābhisekikaṃ,abhisekikam,5,2,3,0,11
271630,panthikaṃ,panthikam,8,4,4,0,9
271631,vātāhaṭaṃ,vatahatam,5,4,1,0,9
271632,sāmuddiyantietesu,samuddiyantietesu,1,1,0,0,17
271633,dubbalaṭṭhānaṃ,dubbalatthanam,13,12,1,0,14
271634,thiraṭṭhānāni,thiratthanani,1,1,0,0,13
271635,patitakaṃ,patitakam,10,9,1,0,9
271636,āpaṇadvāre,apanadvare,8,8,0,0,10
271637,vātapānantarena,vatapanantarena,7,7,0,0,15
271638,rathikāya,rathikaya,73,70,3,0,9
271639,chaḍḍitacoḷakaṃ,chadditacolakam,6,6,0,0,15
271640,saṅkāraṭṭhāne,sankaratthane,28,28,0,0,13
271641,gabbhamalaṃ,gabbhamalam,12,11,1,0,11
271642,chaḍḍitavatthaṃ,chadditavattham,1,1,0,0,15
271643,tissāmaccamātā,tissamaccamata,1,1,0,0,14
271644,satagghanakena,satagghanakena,7,7,0,0,14
271645,puñchāpetvā,punchapetva,1,1,0,0,11
271646,paṃsukūlikā,pamsukulika,39,38,1,0,11
271647,tālaveḷimagge,talavelimagge,1,1,0,0,13
271648,chaḍḍāpesi,chaddapesi,14,14,0,0,10
271649,jiṇṇakaṭṭhānatthameva,jinnakatthanatthameva,1,1,0,0,21
271650,bhūtavejjehi,bhutavejjehi,3,3,0,0,12
271651,sasīsaṃ,sasisam,89,85,4,0,7
271652,nhāpitā,nhapita,5,5,0,0,7
271653,kāḷakaṇṇicoḷanti,kalakannicolanti,1,1,0,0,16
271654,nhānatitthe,nhanatitthe,20,20,0,0,11
271655,chaḍḍitapilotikā,chadditapilotika,4,4,0,0,16
271656,paccāgatā,paccagata,4,4,0,0,9
271657,chaḍḍenti,chaddenti,32,32,0,0,9
271658,ḍaḍḍhappadesaṃ,daddhappadesam,2,1,1,0,14
271659,gokhāyitādī,gokhayitadi,1,0,1,0,11
271660,pākaṭāneva,pakataneva,22,22,0,0,10
271661,tādisānipi,tadisanipi,1,1,0,0,10
271662,ārohantā,arohanta,32,32,0,0,8
271663,ārūhanti,aruhanti,1,1,0,0,8
271664,dassanātikkame,dassanatikkame,1,1,0,0,14
271665,yuddhabhūmiyaṃ,yuddhabhumiyam,3,3,0,0,14
271666,V1.0061,V1.0061,34,34,0,0,7
271667,bhikkhusantakaṃ,bhikkhusantakam,10,8,2,0,15
271668,abhisekaṭṭhāne,abhisekatthane,2,2,0,0,14
271669,chaḍḍitacīvaraṃ,chadditacivaram,3,3,0,0,15
271670,ehibhikkhucīvaraṃ,ehibhikkhucivaram,4,4,0,0,17
271671,pātitaṃ,patitam,28,24,4,0,7
271672,apassantena,apassantena,11,10,1,0,11
271673,anuruddhattherassa,anuruddhattherassa,31,31,0,0,18
271674,sāmuddiyaṃ,samuddiyam,7,3,4,0,10
271675,samuddavīcīhi,samuddavicihi,5,5,0,0,13
271676,ussāritaṃ,ussaritam,2,2,0,0,9
271677,coḷakabhikkhāya,colakabhikkhaya,1,1,0,0,15
271678,caramānehi,caramanehi,1,1,0,0,10
271679,bhikkhudattiyepi,bhikkhudattiyepi,1,1,0,0,16
271680,vassaggena,vassaggena,93,88,5,0,10
271681,senāsanacīvaraṃ,senasanacivaram,4,3,1,0,15
271682,dāyakehi,dayakehi,53,53,0,0,8
271683,ekatosuddhikaṃ,ekatosuddhikam,2,2,0,0,14
271684,bhikkhunopi,bhikkhunopi,15,14,1,0,11
271685,ubhatosuddhikaṃ,ubhatosuddhikam,1,1,0,0,15
271686,hattheyeva,hattheyeva,6,6,0,0,10
271687,anukkaṭṭhacīvaraṃ,anukkatthacivaram,1,1,0,0,17
271688,paṃsukūlabhedaṃ,pamsukulabhedam,1,1,0,0,15
271689,paṃsukūlikena,pamsukulikena,8,8,0,0,13
271690,paribhuñjitabbanti,paribhunjitabbanti,29,29,0,0,18
271691,mudūti,muduti,25,6,19,0,6
271692,sosānikaṃyeva,sosanikamyeva,1,1,0,0,13
271693,ṭhapitakaṃ,thapitakam,2,2,0,0,10
271694,gihidinnakaṃ,gihidinnakam,1,1,0,0,12
271695,sāditakkhaṇe,saditakkhane,2,2,0,0,12
271696,panānisaṃso,pananisamso,13,0,13,0,11
271697,paṃsukūlacīvaraṃ,pamsukulacivaram,31,31,0,0,16
271698,nissayānurūpapaṭipattisabbhāvo,nissayanurupapatipattisabbhavo,3,3,0,0,30
271699,ārakkhadukkhābhāvo,arakkhadukkhabhavo,1,1,0,0,18
271700,aparāyattavuttitā,aparayattavuttita,2,2,0,0,17
271701,corabhayena,corabhayena,14,14,0,0,11
271702,abhayatā,abhayata,1,1,0,0,8
271703,paribhogataṇhāya,paribhogatanhaya,4,3,1,0,16
271704,samaṇasāruppaparikkhāratā,samanasaruppaparikkharata,1,1,0,0,25
271705,anavajjānī,anavajjani,6,6,0,0,10
271706,saṃvaṇṇitapaccayatā,samvannitapaccayata,3,3,0,0,19
271707,pāsādikatā,pasadikata,5,4,1,0,10
271708,appicchatādīnaṃ,appicchatadinam,15,14,1,0,15
271709,phalanipphatti,phalanipphatti,3,2,1,0,14
271710,anubrūhanaṃ,anubruhanam,5,1,4,0,11
271711,diṭṭhānugatiāpādananti,ditthanugatiapadananti,1,1,0,0,22
271712,mārasenavighātāya,marasenavighataya,1,1,0,0,17
271713,V1.0062,V1.0062,34,34,0,0,7
271714,paṃsukūladharo,pamsukuladharo,1,1,0,0,14
271715,sannaddhakavaco,sannaddhakavaco,1,1,0,0,15
271716,kāsikādīni,kasikadini,2,2,0,0,10
271717,varavatthāni,varavatthani,2,2,0,0,12
271718,yogācārānukūlamhi,yogacaranukulamhi,1,1,0,0,17
271719,paṃsukūle,pamsukule,11,10,1,0,9
271720,paṃsukūlikaṅge,pamsukulikange,2,2,0,0,14
271721,samādānavidhānappabhedabhedānisaṃsavaṇṇanā,samadanavidhanappabhedabhedanisamsavannana,12,12,0,0,42
271722,tecīvarikaṅgakathā,tecivarikangakatha,1,1,0,0,18
271723,catutthakacīvaraṃ,catutthakacivaram,3,2,1,0,17
271724,aññataravacanena,annataravacanena,12,12,0,0,16
271725,tecīvarikena,tecivarikena,3,3,0,0,12
271726,aphāsukabhāvena,aphasukabhavena,4,4,0,0,15
271727,vicārakaṃ,vicarakam,1,1,0,0,9
271728,sūciādīsu,suciadisu,1,1,0,0,9
271729,nikkhittapaccayā,nikkhittapaccaya,2,1,1,0,16
271730,rajitakālato,rajitakalato,3,3,0,0,12
271731,nikkhipituṃ,nikkhipitum,94,87,7,0,11
271732,dhutaṅgacoro,dhutangacoro,5,5,0,0,12
271733,rajanakāle,rajanakale,10,10,0,0,10
271734,rajitvā,rajitva,70,67,3,0,7
271735,rajitabbaṃ,rajitabbam,35,35,0,0,10
271736,rajitabbā,rajitabba,1,1,0,0,9
271737,nivāsetuṃ,nivasetum,55,53,2,0,9
271738,gāmantasenāsane,gamantasenasane,17,17,0,0,15
271739,rajituṃ,rajitum,7,7,0,0,7
271740,uparikātuṃ,uparikatum,1,1,0,0,10
271741,rajanasālāyaṃ,rajanasalayam,1,1,0,0,13
271742,rajanakāsāvaṃ,rajanakasavam,2,1,1,0,13
271743,rajanakammaṃ,rajanakammam,5,5,0,0,12
271744,mudukassa,mudukassa,7,3,4,0,9
271745,sabhāgabhikkhūnaṃ,sabhagabhikkhunam,14,13,1,0,17
271746,tatraṭṭhakapaccattharaṇampi,tatratthakapaccattharanampi,1,1,0,0,27
271747,V1.0063,V1.0063,34,34,0,0,7
271748,dhutaṅgatecīvarikassa,dhutangatecivarikassa,1,1,0,0,21
271749,aṃsakāsāvameva,amsakasavameva,3,3,0,0,14
271750,tihatthameva,tihatthameva,1,1,0,0,12
271751,sāditakkhaṇeyeva,saditakkhaneyeva,1,1,0,0,16
271752,samādāyeva,samadayeva,37,33,4,0,10
271753,appasamārambhatā,appasamarambhata,5,5,0,0,16
271754,vatthasannidhiparivajjanaṃ,vatthasannidhiparivajjanam,1,1,0,0,26
271755,sallahukavuttitā,sallahukavuttita,4,2,2,0,16
271756,atirekacīvaraloluppappahānaṃ,atirekacivaraloluppappahanam,1,1,0,0,28
271757,mattakāritāya,mattakaritaya,1,1,0,0,13
271758,sallekhavuttitā,sallekhavuttita,1,1,0,0,15
271759,phalanipphattīti,phalanipphattiti,1,1,0,0,16
271760,atirekavatthataṇhaṃ,atirekavatthatanham,1,1,0,0,19
271761,sannidhivivajjito,sannidhivivajjito,1,1,0,0,17
271762,santosasukharasaññū,santosasukharasannu,1,1,0,0,19
271763,ticīvaradharo,ticivaradharo,1,1,0,0,13
271764,sapattacaraṇo,sapattacarano,2,1,1,0,13
271765,pakkhīva,pakkhiva,15,14,1,0,8
271766,sacīvarova,sacivarova,1,1,0,0,10
271767,yogivaro,yogivaro,1,1,0,0,8
271768,sukhamanuvicaritukāmo,sukhamanuvicaritukamo,1,1,0,0,21
271769,cīvaraniyame,civaraniyame,1,1,0,0,12
271770,tecīvarikaṅge,tecivarikange,1,1,0,0,13
271771,piṇḍapātikaṅgakathā,pindapatikangakatha,1,1,0,0,19
271772,piṇḍapātikaṅgampi,pindapatikangampi,2,1,1,0,17
271773,atirekalābhaṃ,atirekalabham,8,7,1,0,13
271774,piṇḍapātikena,pindapatikena,5,5,0,0,13
271775,uddesabhattaṃ,uddesabhattam,70,56,14,0,13
271776,nimantanabhattaṃ,nimantanabhattam,12,10,2,0,16
271777,uposathikaṃ,uposathikam,33,20,13,0,11
271778,gilānupaṭṭhākabhattaṃ,gilanupatthakabhattam,26,26,0,0,21
271779,vihārabhattaṃ,viharabhattam,15,8,7,0,13
271780,dhurabhattaṃ,dhurabhattam,25,15,10,0,12
271781,vārakabhattaṃ,varakabhattam,4,2,2,0,13
271782,sāditabbāni,saditabbani,27,27,0,0,11
271783,V1.0064,V1.0064,34,34,0,0,7
271784,nirāmisasalākāpi,niramisasalakapi,3,3,0,0,16
271785,pakkabhattampi,pakkabhattampi,4,4,0,0,14
271786,vaṭṭatiyevāti,vattatiyevati,36,29,7,0,13
271787,pacchatopi,pacchatopi,27,26,1,0,10
271788,āhaṭabhikkhaṃ,ahatabhikkham,2,2,0,0,13
271789,pattadvāre,pattadvare,2,2,0,0,10
271790,gaṇhantānampi,ganhantanampi,1,1,0,0,13
271791,dinnabhikkhampi,dinnabhikkhampi,1,1,0,0,15
271792,nisīditvāpi,nisiditvapi,8,8,0,0,11
271793,nādhivāseti,nadhivaseti,103,97,6,0,11
271794,svātanāyapi,svatanayapi,4,4,0,0,11
271795,punadivasāyapi,punadivasayapi,1,1,0,0,14
271796,serivihārasukhaṃ,seriviharasukham,2,1,1,0,16
271797,ukkaṭṭhova,ukkatthova,4,4,0,0,10
271798,dhammasavanāyā,dhammasavanaya,2,2,0,0,14
271799,ekenamhi,ekenamhi,2,2,0,0,8
271800,nisīdāpitoti,nisidapitoti,1,1,0,0,12
271801,adhivāsitāti,adhivasitati,1,1,0,0,12
271802,parihīnā,parihina,47,46,1,0,8
271803,paṭisaṃvedesi,patisamvedesi,15,15,0,0,13
271804,saṅghabhattādiatirekalābhaṃ,sanghabhattadiatirekalabham,2,2,0,0,27
271805,sāditakkhaṇeva,saditakkhaneva,1,1,0,0,14
271806,piṇḍiyālopabhojanaṃ,pindiyalopabhojanam,19,15,4,0,19
271807,kosajjanimmaddanatā,kosajjanimmaddanata,2,1,1,0,19
271808,parisuddhājīvatā,parisuddhajivata,2,1,1,0,16
271809,sekhiyapaṭipattipūraṇaṃ,sekhiyapatipattipuranam,2,1,1,0,23
271810,aparapositā,aparaposita,2,1,1,0,11
271811,parānuggahakiriyā,paranuggahakiriya,2,1,1,0,17
271812,mānappahānaṃ,manappahanam,8,5,3,0,12
271813,rasataṇhānivāraṇaṃ,rasatanhanivaranam,2,1,1,0,18
271814,gaṇabhojanaparamparabhojanacārittasikkhāpadehi,ganabhojanaparamparabhojanacarittasikkhapadehi,1,1,0,0,46
271815,anāpattitā,anapattita,2,1,1,0,10
271816,anulomavuttitā,anulomavuttita,1,1,0,0,14
271817,sammāpaṭipattibrūhanaṃ,sammapatipattibruhanam,1,1,0,0,22
271818,pacchimajanatānukampananti,pacchimajanatanukampananti,1,1,0,0,26
271819,piṇḍiyālopasantuṭṭho,pindiyalopasantuttho,1,1,0,0,20
271820,aparāyattajīviko,aparayattajiviko,2,2,0,0,16
271821,pahīnāhāraloluppo,pahinaharaloluppo,2,2,0,0,17
271822,cātuddiso,catuddiso,49,34,15,0,9
271823,V1.0065,V1.0065,34,34,0,0,7
271824,attabharassa,attabharassa,6,6,0,0,12
271825,anaññaposino,anannaposino,7,6,1,0,12
271826,lābhasilokanissito,labhasilokanissito,1,1,0,0,18
271827,piṇḍapātikaṅge,pindapatikange,1,1,0,0,14
271828,sapadānacārikaṅgakathā,sapadanacarikangakatha,1,1,0,0,22
271829,sapadānacārikaṅgampi,sapadanacarikangampi,1,0,1,0,20
271830,loluppacāraṃ,loluppacaram,11,10,1,0,12
271831,sapadānacārikena,sapadanacarikena,3,3,0,0,16
271832,parissayābhāvo,parissayabhavo,1,1,0,0,14
271833,racchāya,racchaya,4,4,0,0,8
271834,agāmasaññaṃ,agamasannam,1,1,0,0,11
271835,kālataraṃ,kalataram,2,1,1,0,9
271836,aphāsukaṭṭhānaṃ,aphasukatthanam,2,1,1,0,15
271837,gacchantenāpi,gacchantenapi,7,7,0,0,13
271838,bhikkhācāravelāyaṃ,bhikkhacaravelayam,18,18,0,0,18
271839,sampattagāmaṃ,sampattagamam,1,1,0,0,13
271840,caritabbameva,caritabbameva,3,3,0,0,13
271841,gāmapaṭipāṭiyā,gamapatipatiya,1,1,0,0,14
271842,āhaṭabhikkhampi,ahatabhikkhampi,4,4,0,0,15
271843,diyyamānampi,diyyamanampi,9,9,0,0,12
271844,V1.0066,V1.0066,34,34,0,0,7
271845,pattavissaṭṭhaṭṭhānameva,pattavissatthatthanameva,1,1,0,0,24
271846,āhaṭampi,ahatampi,7,7,0,0,8
271847,pattadvārepi,pattadvarepi,1,1,0,0,12
271848,ukkaṭṭhapiṇḍapātikassa,ukkatthapindapatikassa,2,2,0,0,22
271849,loluppacāre,loluppacare,1,1,0,0,11
271850,uppannamatte,uppannamatte,18,17,1,0,12
271851,niccanavakatā,niccanavakata,2,1,1,0,13
271852,candūpamatā,candupamata,2,1,1,0,11
271853,kulamaccherappahānaṃ,kulamaccherappahanam,1,1,0,0,20
271854,samānukampitā,samanukampita,2,1,1,0,13
271855,kulūpakādīnavābhāvo,kulupakadinavabhavo,1,1,0,0,19
271856,avhānānabhinandanā,avhananabhinandana,1,1,0,0,18
271857,abhihārena,abhiharena,1,1,0,0,10
271858,anatthikatā,anatthikata,2,2,0,0,11
271859,anulomavuttitāti,anulomavuttitati,8,8,0,0,16
271860,candūpamo,candupamo,13,13,0,0,9
271861,niccanavo,niccanavo,5,4,1,0,9
271862,sabbasamānukampo,sabbasamanukampo,1,1,0,0,16
271863,kulūpakādīnavavippamutto,kulupakadinavavippamutto,1,1,0,0,24
271864,hotīdha,hotidha,3,3,0,0,7
271865,loluppacārañca,loluppacaranca,1,1,0,0,14
271866,yugamattadassī,yugamattadassi,2,2,0,0,14
271867,sericāraṃ,sericaram,2,1,1,0,9
271868,sapadānacāranti,sapadanacaranti,1,1,0,0,15
271869,sapadānacārikaṅge,sapadanacarikange,1,1,0,0,17
271870,ekāsanikaṅgakathā,ekasanikangakatha,1,1,0,0,17
271871,ekāsanikaṅgampi,ekasanikangampi,1,0,1,0,15
271872,nānāsanabhojanaṃ,nanasanabhojanam,4,3,1,0,16
271873,V1.0067,V1.0067,34,34,0,0,7
271874,ekāsanikena,ekasanikena,1,1,0,0,11
271875,nisīdantena,nisidantena,4,4,0,0,11
271876,anisīditvā,anisiditva,33,33,0,0,10
271877,pāpuṇissatī,papunissati,36,36,0,0,11
271878,tipiṭakacūḷābhayatthero,tipitakaculabhayatthero,20,13,7,0,23
271879,vippakatabhojano,vippakatabhojano,10,9,1,0,16
271880,bhuñjatū,bhunjatu,12,12,0,0,8
271881,sappiādīni,sappiadini,37,35,2,0,10
271882,bhesajjatthameva,bhesajjatthameva,1,1,0,0,16
271883,bhojanapariyantiko,bhojanapariyantiko,1,1,0,0,18
271884,udakapariyantiko,udakapariyantiko,1,1,0,0,16
271885,āsanapariyantiko,asanapariyantiko,1,1,0,0,16
271886,bhuttakkhaṇe,bhuttakkhane,3,3,0,0,12
271887,appābādhatā,appabadhata,7,6,1,0,11
271888,appātaṅkatā,appatankata,3,3,0,0,11
271889,anatirittapaccayā,anatirittapaccaya,10,10,0,0,17
271890,rasataṇhāvinodanaṃ,rasatanhavinodanam,1,1,0,0,18
271891,ekāsanabhojane,ekasanabhojane,2,2,0,0,14
271892,bhojanapaccayā,bhojanapaccaya,5,5,0,0,14
271893,kammamattano,kammamattano,1,1,0,0,12
271894,phāsuvihārakāraṇe,phasuviharakarane,1,1,0,0,17
271895,sucisallekharatūpasevite,sucisallekharatupasevite,1,1,0,0,24
271896,janayetha,janayetha,5,4,1,0,9
271897,ratimekāsanabhojane,ratimekasanabhojane,1,1,0,0,19
271898,ekāsanikaṅge,ekasanikange,1,1,0,0,12
271899,pattapiṇḍikaṅgakathā,pattapindikangakatha,1,1,0,0,20
271900,pattapiṇḍikaṅgampi,pattapindikangampi,1,0,1,0,18
271901,V1.0068,V1.0068,34,34,0,0,7
271902,dutiyakabhājanaṃ,dutiyakabhajanam,3,3,0,0,16
271903,pattapiṇḍikena,pattapindikena,1,1,0,0,14
271904,yāgupānakāle,yagupanakale,6,6,0,0,12
271905,khāditabbaṃ,khaditabbam,51,51,0,0,11
271906,pūtimacchakādimhi,putimacchakadimhi,1,1,0,0,17
271907,appaṭikūlameva,appatikulameva,1,1,0,0,14
271908,madhusakkarādikaṃ,madhusakkaradikam,2,2,0,0,17
271909,pakkhipitabbaṃ,pakkhipitabbam,29,28,1,0,14
271910,pamāṇayuttameva,pamanayuttameva,18,17,1,0,15
271911,āmakasākaṃ,amakasakam,1,1,0,0,10
271912,dutiyakabhājanassa,dutiyakabhajanassa,1,1,0,0,18
271913,rukkhapaṇṇampi,rukkhapannampi,1,1,0,0,14
271914,ukkaṭṭhassa,ukkatthassa,15,12,3,0,11
271915,ucchukhādanakālā,ucchukhadanakala,1,1,0,0,16
271916,kacavarampi,kacavarampi,1,1,0,0,11
271917,chaḍḍetuṃ,chaddetum,30,30,0,0,9
271918,odanapiṇḍamacchamaṃsapūvepi,odanapindamacchamamsapuvepi,1,1,0,0,27
271919,hatthayogī,hatthayogi,1,1,0,0,10
271920,pattayogī,pattayogi,1,1,0,0,9
271921,nānārasataṇhāvinodanaṃ,nanarasatanhavinodanam,2,1,1,0,22
271922,atricchatāya,atricchataya,8,7,1,0,12
271923,payojanamattadassitā,payojanamattadassita,1,1,0,0,20
271924,thālakādipariharaṇakhedābhāvo,thalakadipariharanakhedabhavo,1,1,0,0,29
271925,avikkhittabhojitā,avikkhittabhojita,2,1,1,0,17
271926,nānābhājanavikkhepaṃ,nanabhajanavikkhepam,1,1,0,0,20
271927,okkhittalocano,okkhittalocano,1,1,0,0,14
271928,rasataṇhāya,rasatanhaya,56,56,0,0,11
271929,V1.0069,V1.0069,34,34,0,0,7
271930,pattapiṇḍikoti,pattapindikoti,1,1,0,0,14
271931,pattapiṇḍikaṅge,pattapindikange,1,1,0,0,15
271932,khalupacchābhattikaṅgakathā,khalupacchabhattikangakatha,1,1,0,0,27
271933,khalupacchābhattikaṅgampi,khalupacchabhattikangampi,1,0,1,0,25
271934,atirittabhojanaṃ,atirittabhojanam,5,4,1,0,16
271935,khalupacchābhattikena,khalupacchabhattikena,2,2,0,0,21
271936,paṭhamapiṇḍe,pathamapinde,1,1,0,0,12
271937,ajjhohariyamāne,ajjhohariyamane,1,1,0,0,15
271938,paṭikkhipato,patikkhipato,63,60,3,0,12
271939,pavārito,pavarito,112,100,12,0,8
271940,paṭhamapiṇḍaṃ,pathamapindam,1,1,0,0,13
271941,dutiyapiṇḍaṃ,dutiyapindam,1,1,0,0,12
271942,pavāritānaṃ,pavaritanam,113,106,7,0,11
271943,anatirittabhojanāpattiyā,anatirittabhojanapattiya,1,1,0,0,24
271944,dūrabhāvo,durabhavo,5,5,0,0,9
271945,odarikattābhāvo,odarikattabhavo,1,1,0,0,15
271946,nirāmisasannidhitā,niramisasannidhita,2,1,1,0,18
271947,V1.0070,V1.0070,34,34,0,0,7
271948,sugatapasatthaṃ,sugatapasattham,1,1,0,0,15
271949,santosaguṇādivuḍḍhisañjananaṃ,santosagunadivuddhisanjananam,2,1,1,0,29
271950,vidhunitukāmo,vidhunitukamo,1,1,0,0,13
271951,dhutaṅgamidanti,dhutangamidanti,1,1,0,0,15
271952,khalupacchābhattikaṅge,khalupacchabhattikange,1,1,0,0,22
271953,āraññikaṅgakathā,arannikangakatha,1,1,0,0,16
271954,āraññikaṅgampi,arannikangampi,1,0,1,0,14
271955,gāmantasenāsanaṃ,gamantasenasanam,22,18,4,0,16
271956,āraññikena,arannikena,36,36,0,0,10
271957,uṭṭhāpetabbaṃ,utthapetabbam,16,15,1,0,13
271958,ekakuṭiko,ekakutiko,3,2,1,0,9
271959,anekakuṭiko,anekakutiko,1,1,0,0,11
271960,aparikkhitto,aparikkhitto,46,44,2,0,12
271961,atirekacātumāsaniviṭṭho,atirekacatumasanivittho,3,3,0,0,23
271962,satthopi,satthopi,4,4,0,0,8
271963,anurādhapurasseva,anuradhapurasseva,3,3,0,0,17
271964,indakhīlā,indakhila,30,28,2,0,9
271965,abbhantarime,abbhantarime,5,5,0,0,12
271966,leḍḍupāto,leddupato,46,46,0,0,9
271967,taruṇamanussā,tarunamanussa,5,4,1,0,13
271968,patanaṭṭhānabbhantaranti,patanatthanabbhantaranti,1,1,0,0,24
271969,kākanivāraṇaniyamena,kakanivarananiyamena,1,1,0,0,20
271970,khittassāti,khittassati,1,1,0,0,11
271971,aparikkhittagāme,aparikkhittagame,1,1,0,0,16
271972,sabbapaccantimassa,sabbapaccantimassa,1,1,0,0,18
271973,patanaṭṭhānaṃ,patanatthanam,8,8,0,0,13
271974,gharūpacāro,gharupacaro,24,19,5,0,11
271975,vinayapariyāye,vinayapariyaye,2,2,0,0,14
271976,gāmūpacārañca,gamupacaranca,44,43,1,0,13
271977,abhidhammapariyāye,abhidhammapariyaye,2,2,0,0,18
271978,suttantikapariyāye,suttantikapariyaye,3,3,0,0,18
271979,pañcadhanusatikaṃ,pancadhanusatikam,30,27,3,0,17
271980,āropitena,aropitena,9,8,1,0,9
271981,ācariyadhanunā,acariyadhanuna,7,6,1,0,14
271982,V1.0071,V1.0071,34,34,0,0,7
271983,indakhīlato,indakhilato,26,25,1,0,11
271984,aparikkhittassa,aparikkhittassa,149,141,8,0,15
271985,paṭhamaleḍḍupātato,pathamaleddupatato,4,4,0,0,18
271986,vihāraparikkhepā,viharaparikkhepa,2,2,0,0,16
271987,bhattasālā,bhattasala,3,3,0,0,10
271988,dhuvasannipātaṭṭhānaṃ,dhuvasannipatatthanam,3,3,0,0,21
271989,minitabbanti,minitabbanti,6,6,0,0,12
271990,vinayaṭṭhakathāsu,vinayatthakathasu,7,3,4,0,17
271991,vihārassapi,viharassapi,3,3,0,0,11
271992,gāmasseva,gamasseva,5,5,0,0,9
271993,leḍḍupātānaṃ,leddupatanam,23,22,1,0,12
271994,mānusakānaṃ,manusakanam,5,5,0,0,11
271995,pabbatanadīādīhi,pabbatanadiadihi,2,2,0,0,16
271996,antaritattā,antaritatta,13,13,0,0,11
271997,sañcaritabbo,sancaritabbo,3,3,0,0,12
271998,āsannagāmassa,asannagamassa,2,2,0,0,13
271999,aṅgasampādanatthaṃ,angasampadanattham,2,2,0,0,18
272000,āraññikassa,arannikassa,43,40,3,0,11
272001,upaṭṭhātabbo,upatthatabbo,44,44,0,0,12
272002,aṅgayuttaṭṭhāne,angayuttatthane,1,1,0,0,15
272003,aruṇuṭṭhānavelāyaṃ,arunutthanavelayam,3,3,0,0,18
272004,dhutaṅgasuddhikena,dhutangasuddhikena,2,1,1,0,18
272005,gāmante,gamante,21,21,0,0,7
272006,hemantikepi,hemantikepi,1,1,0,0,11
272007,uṭṭhitepi,utthitepi,9,9,0,0,9
272008,dhammakathike,dhammakathike,7,7,0,0,13
272009,niddāyantānaṃ,niddayantanam,1,1,0,0,13
272010,uṭṭhapenti,utthapenti,8,8,0,0,10
272011,araññasaññaṃ,arannasannam,17,15,2,0,12
272012,V1.0072,V1.0072,34,34,0,0,7
272013,satthāpissa,satthapissa,21,21,0,0,11
272014,nāgita,nagita,66,65,1,0,6
272015,araññavihārenā,arannaviharena,1,1,0,0,14
272016,pantasenāsanavāsino,pantasenasanavasino,2,2,0,0,19
272017,asappāyarūpādayo,asappayarupadayo,1,1,0,0,16
272018,vikkhipanti,vikkhipanti,6,5,1,0,11
272019,vigatasantāso,vigatasantaso,2,1,1,0,13
272020,jīvitanikantiṃ,jivitanikantim,6,4,2,0,14
272021,pavivekasukharasaṃ,pavivekasukharasam,2,1,1,0,18
272022,paṃsukūlikādibhāvopi,pamsukulikadibhavopi,1,1,0,0,20
272023,ārādhayanto,aradhayanto,1,1,0,0,11
272024,vanavāsena,vanavasena,1,1,0,0,10
272025,saindakā,saindaka,10,10,0,0,8
272026,paṃsukūlañca,pamsukulanca,13,12,1,0,12
272027,araññasaṅgāmagato,arannasangamagato,1,1,0,0,17
272028,avasesadhutāyudho,avasesadhutayudho,2,1,1,0,17
272029,araññavāsamhi,arannavasamhi,1,1,0,0,13
272030,āraññikaṅge,arannikange,1,1,0,0,11
272031,rukkhamūlikaṅgakathā,rukkhamulikangakatha,1,1,0,0,20
272032,rukkhamūlikaṅgampi,rukkhamulikangampi,1,0,1,0,18
272033,rukkhamūlikena,rukkhamulikena,2,2,0,0,14
272034,sīmantarikarukkhaṃ,simantarikarukkham,1,1,0,0,18
272035,niyyāsarukkhaṃ,niyyasarukkham,1,1,0,0,14
272036,phalarukkhaṃ,phalarukkham,6,6,0,0,12
272037,vaggulirukkhaṃ,vaggulirukkham,1,1,0,0,14
272038,susirarukkhaṃ,susirarukkham,4,4,0,0,13
272039,ṭhitarukkhanti,thitarukkhanti,1,1,0,0,14
272040,vihārapaccante,viharapaccante,40,39,1,0,14
272041,ṭhitarukkho,thitarukkho,6,6,0,0,11
272042,paṭijaggāpetuṃ,patijaggapetum,2,2,0,0,14
272043,paṇṇasaṭaṃ,pannasatam,4,2,2,0,10
272044,vasitabbaṃ,vasitabbam,172,151,21,0,10
272045,sampattehiyeva,sampattehiyeva,1,1,0,0,14
272046,mudukena,mudukena,16,15,1,0,8
272047,ārāmikasamaṇuddese,aramikasamanuddese,1,1,0,0,18
272048,V1.0073,V1.0073,33,33,0,0,7
272049,pākāraparikkhepaṃ,pakaraparikkhepam,10,10,0,0,17
272050,mahadivase,mahadivase,2,2,0,0,10
272051,kappitakkhaṇe,kappitakkhane,1,1,0,0,13
272052,uṭṭhāpitamatteti,utthapitamatteti,2,2,0,0,16
272053,aṅguttarabhāṇakā,anguttarabhanaka,6,4,2,0,16
272054,rukkhamūlasenāsanaṃ,rukkhamulasenasanam,15,13,2,0,19
272055,anavajjānīti,anavajjaniti,5,1,4,0,12
272056,tarupaṇṇavikāradassanena,tarupannavikaradassanena,2,2,0,0,24
272057,aniccasaññāsamuṭṭhāpanatā,aniccasannasamutthapanata,2,2,0,0,25
272058,senāsanamaccherakammārāmatānaṃ,senasanamaccherakammaramatanam,2,1,1,0,30
272059,sahavāsitā,sahavasita,2,1,1,0,10
272060,buddhaseṭṭhena,buddhasetthena,11,11,0,0,14
272061,rukkhamūlasamo,rukkhamulasamo,2,2,0,0,14
272062,āvāsamaccherahare,avasamaccherahare,2,2,0,0,17
272063,paripālite,paripalite,1,1,0,0,10
272064,pavivitte,pavivitte,10,10,0,0,9
272065,abhirattāni,abhirattani,3,2,1,0,11
272066,paṇḍūni,panduni,3,2,1,0,7
272067,tarupaṇṇāni,tarupannani,3,2,1,0,11
272068,niccasaññaṃ,niccasannam,80,63,17,0,11
272069,panūdati,panudati,3,2,1,0,8
272070,buddhadāyajjaṃ,buddhadayajjam,10,4,6,0,14
272071,bhāvanābhiratālayaṃ,bhavanabhiratalayam,2,2,0,0,19
272072,vicakkhaṇoti,vicakkhanoti,18,4,14,0,12
272073,rukkhamūlikaṅge,rukkhamulikange,1,1,0,0,15
272074,abbhokāsikaṅgakathā,abbhokasikangakatha,1,1,0,0,19
272075,abbhokāsikaṅgampi,abbhokasikangampi,1,0,1,0,17
272076,V1.0074,V1.0074,34,34,0,0,7
272077,rukkhamūlañca,rukkhamulanca,11,10,1,0,13
272078,abbhokāsikassa,abbhokasikassa,4,4,0,0,14
272079,uposathatthāya,uposathatthaya,3,3,0,0,14
272080,vassamāne,vassamane,3,3,0,0,9
272081,anikkhamitvā,anikkhamitva,12,12,0,0,12
272082,vassūparame,vassuparame,1,1,0,0,11
272083,nikkhamitabbaṃ,nikkhamitabbam,42,40,2,0,14
272084,bhojanasālaṃ,bhojanasalam,21,21,0,0,12
272085,aggisālaṃ,aggisalam,18,16,2,0,9
272086,bhojanasālāya,bhojanasalaya,22,21,1,0,13
272087,āpucchituṃ,apucchitum,22,21,1,0,10
272088,dunnikkhittāni,dunnikkhittani,5,5,0,0,14
272089,mañcapīṭhādīni,mancapithadini,33,30,3,0,14
272090,pavesetuñca,pavesetunca,1,1,0,0,11
272091,vuḍḍhatarānaṃ,vuddhataranam,12,12,0,0,13
272092,vassante,vassante,131,128,3,0,8
272093,maggamajjhe,maggamajjhe,5,4,1,0,11
272094,ṭhassāmīti,thassamiti,10,9,1,0,10
272095,pakatigatiyā,pakatigatiya,1,1,0,0,12
272096,paviṭṭhena,pavitthena,19,19,0,0,10
272097,vassūparamā,vassuparama,2,1,1,0,11
272098,rukkhamūlikassā,rukkhamulikassa,1,0,1,0,15
272099,abbhokāseyeva,abbhokaseyeva,4,4,0,0,13
272100,cīvarakuṭiṃ,civarakutim,11,11,0,0,11
272101,rukkhapabbatagehāni,rukkhapabbatagehani,1,1,0,0,19
272102,appavisitvā,appavisitva,14,14,0,0,11
272103,acchannamariyādaṃ,acchannamariyadam,2,1,1,0,17
272104,pabbhārampi,pabbharampi,1,1,0,0,11
272105,sākhāmaṇḍapopi,sakhamandapopi,1,1,0,0,14
272106,pīṭhapaṭopi,pithapatopi,1,1,0,0,11
272107,khettarakkhakādīhi,khettarakkhakadihi,1,1,0,0,18
272108,tatraṭṭhakakuṭikāpi,tatratthakakutikapi,1,1,0,0,19
272109,vāsatthāya,vasatthaya,49,48,1,0,10
272110,āvāsapalibodhupacchedo,avasapalibodhupacchedo,5,4,1,0,22
272111,thinamiddhapanūdanaṃ,thinamiddhapanudanam,1,1,0,0,20
272112,asaṅgacārino,asangacarino,2,2,0,0,12
272113,aniketā,aniketa,5,4,1,0,7
272114,anurūpatā,anurupata,3,3,0,0,9
272115,nissaṅgatā,nissangata,2,2,0,0,10
272116,cātuddisatā,catuddisata,1,1,0,0,11
272117,anagāriyabhāvassa,anagariyabhavassa,1,1,0,0,17
272118,V1.0075,V1.0075,34,34,0,0,7
272119,adullabhe,adullabhe,1,1,0,0,9
272120,tārāmaṇivitānamhi,taramanivitanamhi,1,1,0,0,17
272121,candadīpappabhāsite,candadipappabhasite,1,1,0,0,19
272122,bhāvanārāmataṃ,bhavanaramatam,4,4,0,0,14
272123,pavivekarasassādaṃ,pavivekarasassadam,2,2,0,0,18
272124,abbhokāsarato,abbhokasarato,1,1,0,0,13
272125,abbhokāsikaṅge,abbhokasikange,1,1,0,0,14
272126,sosānikaṅgakathā,sosanikangakatha,1,1,0,0,16
272127,sosānikaṅgampi,sosanikangampi,1,0,1,0,14
272128,sosānikena,sosanikena,2,2,0,0,10
272129,nivesantā,nivesanta,1,1,0,0,9
272130,vavatthapenti,vavatthapenti,4,4,0,0,13
272131,ajjhāpite,ajjhapite,1,1,0,0,9
272132,jhāpitakālato,jhapitakalato,3,2,1,0,13
272133,susānameva,susanameva,2,1,1,0,10
272134,caṅkamamaṇḍapādīni,cankamamandapadini,1,1,0,0,18
272135,pānīyaparibhojanīyaṃ,paniyaparibhojaniyam,14,14,0,0,20
272136,uppannaparissayavighātatthāya,uppannaparissayavighatatthaya,1,1,0,0,29
272137,rājayuttakaṃ,rajayuttakam,2,1,1,0,12
272138,caṅkamantena,cankamantena,7,7,0,0,12
272139,addhakkhikena,addhakkhikena,3,2,1,0,13
272140,caṅkamitabbaṃ,cankamitabbam,67,65,2,0,13
272141,mahāpathā,mahapatha,3,3,0,0,9
272142,ukkamma,ukkamma,8,8,0,0,7
272143,uppathamaggena,uppathamaggena,2,1,1,0,14
272144,divāyeva,divayeva,10,8,2,0,8
272145,āhiṇḍantāpi,ahindantapi,2,2,0,0,11
272146,paharitabbā,paharitabba,3,2,1,0,11
272147,ekadivasampi,ekadivasampi,83,79,4,0,12
272148,agantuṃ,agantum,6,6,0,0,7
272149,majjhimayāmaṃ,majjhimayamam,21,20,1,0,13
272150,V1.0076,V1.0076,34,34,0,0,7
272151,paṭikkamituṃ,patikkamitum,2,2,0,0,12
272152,tilapiṭṭhamāsabhattamacchamaṃsakhīratelaguḷādikhajjabhojjaṃ,tilapitthamasabhattamacchamamsakhiratelaguladikhajjabhojjam,1,1,0,0,59
272153,kulagehaṃ,kulageham,15,14,1,0,9
272154,dhuvaḍāhadhuvakuṇapadhuvarodanāni,dhuvadahadhuvakunapadhuvarodanani,1,1,0,0,33
272155,susānalakkhaṇaṃ,susanalakkhanam,6,6,0,0,15
272156,pattamatte,pattamatte,4,4,0,0,10
272157,susānamhi,susanamhi,2,2,0,0,9
272158,kappanena,kappanena,3,3,0,0,9
272159,agatadivaseti,agatadivaseti,1,1,0,0,13
272160,maraṇassatipaṭilābho,maranassatipatilabho,2,1,1,0,20
272161,appamādavihāritā,appamadaviharita,2,1,1,0,16
272162,asubhanimittādhigamo,asubhanimittadhigamo,2,1,1,0,20
272163,kāmarāgavinodanaṃ,kamaragavinodanam,2,1,1,0,17
272164,kāyasabhāvadassanaṃ,kayasabhavadassanam,2,1,1,0,19
272165,saṃvegabahulatā,samvegabahulata,2,1,1,0,15
272166,ārogyamadādippahānaṃ,arogyamadadippahanam,1,1,0,0,20
272167,bhayabheravasahanatā,bhayabheravasahanata,2,1,1,0,20
272168,garubhāvanīyatā,garubhavaniyata,2,1,1,0,15
272169,sosānikañhi,sosanikanhi,1,1,0,0,11
272170,maraṇānusatippabhāvā,marananusatippabhava,1,1,0,0,20
272171,niddāgatampi,niddagatampi,1,1,0,0,12
272172,pamādadosā,pamadadosa,2,2,0,0,10
272173,sampassato,sampassato,9,9,0,0,10
272174,kuṇapāni,kunapani,10,9,1,0,8
272175,kāmānubhāvavasagampi,kamanubhavavasagampi,1,1,0,0,20
272176,saṃvegameti,samvegameti,1,1,0,0,11
272177,nibbutimesamāno,nibbutimesamano,1,1,0,0,15
272178,sosānikaṅgamitinekaguṇāvahattā,sosanikangamitinekagunavahatta,1,1,0,0,30
272179,nibbānaninnahadayena,nibbananinnahadayena,1,1,0,0,20
272180,nisevitabbanti,nisevitabbanti,1,1,0,0,14
272181,sosānikaṅge,sosanikange,1,1,0,0,11
272182,yathāsanthatikaṅgakathā,yathasanthatikangakatha,1,1,0,0,23
272183,yathāsanthatikaṅgampi,yathasanthatikangampi,1,0,1,0,21
272184,V1.0077,V1.0077,34,34,0,0,7
272185,senāsanaloluppaṃ,senasanaloluppam,3,2,1,0,16
272186,yathāsanthatikena,yathasanthatikena,2,2,0,0,17
272187,yadassa,yadassa,10,8,2,0,7
272188,gāhitaṃ,gahitam,39,31,8,0,7
272189,uṭṭhāpetabbo,utthapetabbo,16,16,0,0,12
272190,pattasenāsanaṃ,pattasenasanam,7,4,3,0,14
272191,accāsanneti,accasanneti,2,1,1,0,11
272192,amanussadīghajātikādīhi,amanussadighajatikadihi,1,1,0,0,23
272193,upaddutanti,upaddutanti,2,2,0,0,11
272194,senāsanaloluppe,senasanaloluppe,1,1,0,0,15
272195,vuttovādakaraṇaṃ,vuttovadakaranam,1,1,0,0,16
272196,hitesitā,hitesita,27,24,3,0,8
272197,hīnapaṇītavikappapariccāgo,hinapanitavikappapariccago,2,1,1,0,26
272198,anurodhavirodhappahānaṃ,anurodhavirodhappahanam,2,1,1,0,23
272199,dvārapidahanaṃ,dvarapidahanam,2,1,1,0,14
272200,nibbikappo,nibbikappo,1,1,0,0,10
272201,tiṇasantharakesupi,tinasantharakesupi,1,1,0,0,18
272202,seṭṭhamhi,setthamhi,1,1,0,0,9
272203,sabrahmacārinavake,sabrahmacarinavake,1,1,0,0,18
272204,ariyasatāciṇṇaṃ,ariyasatacinnam,1,1,0,0,15
272205,munipuṅgavavaṇṇitaṃ,munipungavavannitam,1,1,0,0,19
272206,yathāsanthatarāmatanti,yathasanthataramatanti,1,1,0,0,22
272207,yathāsanthatikaṅge,yathasanthatikange,1,1,0,0,18
272208,nesajjikaṅgakathā,nesajjikangakatha,1,1,0,0,17
272209,nesajjikaṅgampi,nesajjikangampi,1,0,1,0,15
272210,V1.0078,V1.0078,34,34,0,0,7
272211,nesajjikena,nesajjikena,1,1,0,0,11
272212,yāmesu,yamesu,26,26,0,0,6
272213,nipajjitumeva,nipajjitumeva,1,1,0,0,13
272214,dussapallatthikā,dussapallatthika,4,4,0,0,16
272215,āyogapaṭṭo,ayogapatto,1,1,0,0,10
272216,dussapallatthikāpi,dussapallatthikapi,1,1,0,0,18
272217,āyogapaṭṭopi,ayogapattopi,1,1,0,0,12
272218,bibbohanampi,bibbohanampi,3,3,0,0,12
272219,pañcaṅgopi,pancangopi,1,1,0,0,10
272220,sattaṅgopi,sattangopi,1,1,0,0,10
272221,pañcaṅgo,pancango,5,3,2,0,8
272222,piṭṭhiapassayena,pitthiapassayena,5,5,0,0,16
272223,sattaṅgo,sattango,13,10,3,0,8
272224,ubhatopassesu,ubhatopassesu,5,5,0,0,13
272225,apassayehi,apassayehi,1,1,0,0,10
272226,miḷābhayattherassa,milabhayattherassa,1,1,0,0,18
272227,kappitamatte,kappitamatte,1,1,0,0,12
272228,seyyasukhaṃ,seyyasukham,45,37,8,0,11
272229,passasukhaṃ,passasukham,39,34,5,0,11
272230,middhasukhaṃ,middhasukham,47,41,6,0,12
272231,anuyutto,anuyutto,212,201,11,0,8
272232,vinibandhassa,vinibandhassa,6,5,1,0,13
272233,sabbakammaṭṭhānānuyogasappāyatā,sabbakammatthananuyogasappayata,2,1,1,0,31
272234,pāsādikairiyāpathatā,pasadikairiyapathata,2,1,1,0,20
272235,vīriyārambhānukūlatā,viriyarambhanukulata,2,1,1,0,20
272236,vikampeti,vikampeti,1,1,0,0,9
272237,nisajjābhirato,nisajjabhirato,1,1,0,0,14
272238,samanuyuñjeyya,samanuyunjeyya,1,1,0,0,14
272239,nesajjikaṃ,nesajjikam,2,2,0,0,10
272240,vatanti,vatanti,4,4,0,0,7
272241,nesajjikaṅge,nesajjikange,1,1,0,0,12
272242,vidhānappabheda,vidhanappabheda,1,1,0,0,15
272243,bhedānisaṃsavaṇṇanā,bhedanisamsavannana,1,1,0,0,19
272244,dhutaṅgapakiṇṇakakathā,dhutangapakinnakakatha,1,1,0,0,22
272245,V1.0079,V1.0079,34,34,0,0,7
272246,kusalattikatoti,kusalattikatoti,1,0,1,0,15
272247,sekkhaputhujjanakhīṇāsavānaṃ,sekkhaputhujjanakhinasavanam,4,4,0,0,28
272248,akusalampi,akusalampi,37,36,1,0,10
272249,akusalacittena,akusalacittena,20,20,0,0,14
272250,aṅgametesanti,angametesanti,1,1,0,0,13
272251,dhutaṅgānīti,dhutanganiti,6,3,3,0,12
272252,yassetāni,yassetani,5,5,0,0,9
272253,aṅgantikatvā,angantikatva,1,1,0,0,12
272254,cīvaraloluppādīni,civaraloluppadini,1,1,0,0,17
272255,niddhunāti,niddhunati,4,4,0,0,10
272256,suvuttamidaṃ,suvuttamidam,1,1,0,0,12
272257,yesampi,yesampi,6,6,0,0,7
272258,kusalattikavinimuttaṃ,kusalattikavinimuttam,5,4,1,0,21
272259,dhutaṅgameva,dhutangameva,5,4,1,0,12
272260,dhunanato,dhunanato,6,6,0,0,9
272261,vacanavirodhopi,vacanavirodhopi,2,2,0,0,15
272262,V1.0080,V1.0080,34,34,0,0,7
272263,vibhāgatoti,vibhagatoti,4,1,3,0,11
272264,dhutadhammā,dhutadhamma,24,19,5,0,11
272265,dhutaṅgasevanā,dhutangasevana,5,5,0,0,14
272266,dhutoti,dhutoti,3,1,2,0,7
272267,dhutakileso,dhutakileso,9,8,1,0,11
272268,kilesadhunano,kilesadhunano,5,3,2,0,13
272269,dhutavādoti,dhutavadoti,6,1,5,0,11
272270,dhuni,dhuni,7,6,1,0,5
272271,nānusāsati,nanusasati,2,2,0,0,10
272272,bākulatthero,bakulatthero,12,11,1,0,12
272273,bākulo,bakulo,36,35,1,0,6
272274,upanandatthero,upanandatthero,2,2,0,0,14
272275,ubhayavipanno,ubhayavipanno,4,4,0,0,13
272276,lāḷudāyī,laludayi,24,24,0,0,8
272277,ubhayasampanno,ubhayasampanno,5,5,0,0,14
272278,sallekhatā,sallekhata,12,10,2,0,10
272279,pavivekatā,pavivekata,7,5,2,0,10
272280,idamatthitāti,idamatthitati,1,1,0,0,13
272281,dhutaṅgacetanāya,dhutangacetanaya,5,5,0,0,16
272282,parivārakā,parivaraka,1,1,0,0,10
272283,appicchataṃyeva,appicchatamyeva,14,13,1,0,15
272284,alobhe,alobhe,3,3,0,0,6
272285,amohe,amohe,2,2,0,0,5
272286,alobhena,alobhena,40,38,2,0,8
272287,paṭikkhepavatthūsu,patikkhepavatthusu,3,3,0,0,18
272288,amohena,amohena,40,39,1,0,7
272289,ādīnavapaṭicchādakaṃ,adinavapaticchadakam,3,2,1,0,20
272290,anuññātānaṃ,anunnatanam,6,5,1,0,11
272291,paṭisevanamukhena,patisevanamukhena,2,2,0,0,17
272292,kāmasukhānuyogaṃ,kamasukhanuyogam,1,1,0,0,16
272293,dhutaṅgesu,dhutangesu,5,5,0,0,10
272294,atisallekhamukhena,atisallekhamukhena,2,2,0,0,18
272295,attakilamathānuyogaṃ,attakilamathanuyogam,28,24,4,0,20
272296,dhutadhammāti,dhutadhammati,7,2,5,0,13
272297,V1.0081,V1.0081,33,33,0,0,7
272298,sallekhavihāro,sallekhaviharo,2,2,0,0,14
272299,dukkhāpaṭipadañca,dukkhapatipadanca,2,1,1,0,17
272300,sallekhaṃ,sallekham,15,14,1,0,9
272301,āraññikaṅgarukkhamūlikaṅgapaṭisevanā,arannikangarukkhamulikangapatisevana,1,1,0,0,36
272302,dosacaritassāpi,dosacaritassapi,2,2,0,0,15
272303,asaṅghaṭṭiyamānassa,asanghattiyamanassa,1,1,0,0,19
272304,samāsabyāsatoti,samasabyasatoti,2,0,2,0,15
272305,sīsaṅgāni,sisangani,3,3,0,0,9
272306,asambhinnaṅgānīti,asambhinnanganiti,2,1,1,0,17
272307,abbhokāsikaṅganti,abbhokasikanganti,1,1,0,0,17
272308,sapadānacārikaṅgañhi,sapadanacarikanganhi,1,1,0,0,20
272309,rakkhissati,rakkhissati,9,5,4,0,11
272310,ekāsanikaṅgañca,ekasanikanganca,1,1,0,0,15
272311,pattapiṇḍikaṅgakhalupacchābhattikaṅgānipi,pattapindikangakhalupacchabhattikanganipi,1,1,0,0,41
272312,surakkhanīyāni,surakkhaniyani,1,1,0,0,14
272313,rakkhantassa,rakkhantassa,16,16,0,0,12
272314,rukkhamūlikaṅgayathāsanthatikaṅgesu,rukkhamulikangayathasanthatikangesu,1,1,0,0,35
272315,sosānikaṅganti,sosanikanganti,2,2,0,0,14
272316,asambhinnaṅgāni,asambhinnangani,1,1,0,0,15
272317,cīvarapaṭisaṃyuttāni,civarapatisamyuttani,8,5,3,0,20
272318,piṇḍapātapaṭisaṃyuttāni,pindapatapatisamyuttani,5,3,2,0,23
272319,senāsanapaṭisaṃyuttāni,senasanapatisamyuttani,5,3,2,0,22
272320,vīriyapaṭisaṃyuttanti,viriyapatisamyuttanti,1,1,0,0,21
272321,vīriyapaṭisaṃyuttaṃ,viriyapatisamyuttam,4,4,0,0,19
272322,paccayanissitāni,paccayanissitani,1,1,0,0,16
272323,vīriyanissitaṃ,viriyanissitam,1,1,0,0,14
272324,sevitabbāsevitabbavasenapi,sevitabbasevitabbavasenapi,1,1,0,0,26
272325,sevitabbāni,sevitabbani,3,3,0,0,11
272326,sevatopi,sevatopi,4,4,0,0,8
272327,asevatopi,asevatopi,2,2,0,0,9
272328,vaḍḍhateva,vaddhateva,17,16,1,0,10
272329,anukampantena,anukampantena,1,1,0,0,13
272330,yassāpi,yassapi,16,16,0,0,7
272331,sevitabbāniyeva,sevitabbaniyeva,1,1,0,0,15
272332,vāsanatthāyāti,vasanatthayati,1,1,0,0,14
272333,sevitabbāsevitabbavasena,sevitabbasevitabbavasena,1,1,0,0,24
272334,duvidhānipi,duvidhanipi,2,2,0,0,11
272335,cetanāvasena,cetanavasena,2,2,0,0,12
272336,ekavidhāni,ekavidhani,6,6,0,0,10
272337,samādānacetanāti,samadanacetanati,1,1,0,0,16
272338,dhutaṅganti,dhutanganti,2,2,0,0,11
272339,byāsato,byasato,2,1,1,0,7
272340,V1.0082,V1.0082,34,34,0,0,7
272341,sikkhamānasāmaṇerīnaṃ,sikkhamanasamanerinam,5,4,1,0,21
272342,dvācattālīsa,dvacattalisa,24,22,2,0,12
272343,āraññikaṅgasampannaṃ,arannikangasampannam,1,1,0,0,20
272344,sabbadhutaṅgāni,sabbadhutangani,2,1,1,0,15
272345,khalupacchābhattikaṅgañca,khalupacchabhattikanganca,1,1,0,0,25
272346,sikkhāpadeneva,sikkhapadeneva,9,9,0,0,14
272347,paṭikkhittāni,patikkhittani,23,22,1,0,13
272348,dupparihārāni,duppariharani,1,1,0,0,13
272349,dutiyikaṃ,dutiyikam,32,30,2,0,9
272350,samānacchandā,samanacchanda,4,4,0,0,13
272351,dutiyikā,dutiyika,16,15,1,0,8
272352,saṃsaṭṭhavihārato,samsatthaviharato,2,2,0,0,17
272353,svevassā,svevassa,1,1,0,0,8
272354,pattapiṇḍikaṅganti,pattapindikanganti,1,1,0,0,18
272355,patirūpāni,patirupani,2,2,0,0,10
272356,paribhuñjitunti,paribhunjitunti,13,13,0,0,15
272357,sampādanatthaṃ,sampadanattham,3,3,0,0,14
272358,samādātabbadhutaṅgakathā,samadatabbadhutangakatha,1,1,0,0,24
272359,kammaṭṭhānaggahaṇaniddeso,kammatthanaggahananiddeso,3,3,0,0,25
272360,V1.0083,V1.0083,34,34,0,0,7
272361,dhutaṅgapariharaṇasampāditehi,dhutangapariharanasampaditehi,1,1,0,0,29
272362,atisaṅkhepadesitattā,atisankhepadesitatta,5,3,2,0,20
272363,viññātumpi,vinnatumpi,3,2,1,0,10
272364,vitthārañca,vittharanca,4,4,0,0,11
272365,bhāvanānayañca,bhavananayanca,5,4,1,0,14
272366,katividho,katividho,10,8,2,0,9
272367,samādhibhāvanāya,samadhibhavanaya,24,24,0,0,16
272368,ānisaṃsoti,anisamsoti,26,18,8,0,10
272369,nānappakārako,nanappakarako,6,5,1,0,13
272370,vibhāvayituṃ,vibhavayitum,2,2,0,0,12
272371,ārabbhamānaṃ,arabbhamanam,2,2,0,0,12
272372,adhippetañceva,adhippetanceva,2,2,0,0,14
272373,vikkhepāya,vikkhepaya,6,4,2,0,10
272374,idhādhippetameva,idhadhippetameva,9,9,0,0,16
272375,kusalacittekaggatā,kusalacittekaggata,4,4,0,0,18
272376,samādhānaṭṭhena,samadhanatthena,6,6,0,0,15
272377,ṭhapananti,thapananti,18,17,1,0,10
272378,dhammassānubhāvena,dhammassanubhavena,3,3,0,0,18
272379,avikkhipamānā,avikkhipamana,2,2,0,0,13
272380,avippakiṇṇā,avippakinna,4,4,0,0,11
272381,samādhānanti,samadhananti,3,3,0,0,12
272382,avikkhepalakkhaṇo,avikkhepalakkhano,20,17,3,0,17
272383,vikkhepaviddhaṃsanaraso,vikkhepaviddhamsanaraso,3,2,1,0,23
272384,avikampanapaccupaṭṭhāno,avikampanapaccupatthano,2,1,1,0,23
272385,samādhiyatī,samadhiyati,26,23,3,0,11
272386,V1.0084,V1.0084,34,34,0,0,7
272387,avikkhepalakkhaṇena,avikkhepalakkhanena,2,1,1,0,19
272388,ekavidho,ekavidho,28,26,2,0,8
272389,upacāraappanāvasena,upacaraappanavasena,1,1,0,0,19
272390,sappītikanippītikavasena,sappitikanippitikavasena,2,2,0,0,24
272391,sukhasahagataupekkhāsahagatavasena,sukhasahagataupekkhasahagatavasena,2,2,0,0,34
272392,M1.0082,M1.0082,30,30,0,0,7
272393,savitakkasavicārādivasena,savitakkasavicaradivasena,2,2,0,0,25
272394,pītisahagatādivasena,pitisahagatadivasena,2,2,0,0,20
272395,parittamahaggatappamāṇavasena,parittamahaggatappamanavasena,2,2,0,0,29
272396,dukkhāpaṭipadādandhābhiññādivasena,dukkhapatipadadandhabhinnadivasena,2,2,0,0,34
272397,parittaparittārammaṇādivasena,parittaparittarammanadivasena,2,2,0,0,29
272398,catujhānaṅgavasena,catujhanangavasena,2,2,0,0,18
272399,kāmāvacarādivasena,kamavacaradivasena,9,9,0,0,18
272400,adhipativasena,adhipativasena,15,15,0,0,14
272401,pañcakanaye,pancakanaye,56,54,2,0,11
272402,pañcajhānaṅgavasenāti,pancajhanangavasenati,2,1,1,0,21
272403,samādhiekakadukavaṇṇanā,samadhiekakadukavannana,2,2,0,0,23
272404,ekavidhakoṭṭhāso,ekavidhakotthaso,2,0,2,0,16
272405,uttānatthoyeva,uttanatthoyeva,24,23,1,0,14
272406,anussatiṭṭhānānaṃ,anussatitthananam,2,1,1,0,17
272407,maraṇassatiyā,maranassatiya,9,9,0,0,13
272408,upasamānussatiyā,upasamanussatiya,6,6,0,0,16
272409,paṭikūlasaññāya,patikulasannaya,1,1,0,0,15
272410,catudhātuvavatthānassāti,catudhatuvavatthanassati,1,1,0,0,24
272411,laddhacittekaggatā,laddhacittekaggata,1,1,0,0,18
272412,appanāsamādhīnaṃ,appanasamadhinam,2,1,1,0,16
272413,upacārasamādhi,upacarasamadhi,36,33,3,0,14
272414,parikammānantarā,parikammanantara,1,1,0,0,16
272415,appanāsamādhīti,appanasamadhiti,2,1,1,0,15
272416,upacārappanāvasena,upacarappanavasena,16,15,1,0,18
272417,nippītiko,nippitiko,5,5,0,0,9
272418,nippītikoti,nippitikoti,2,1,1,0,11
272419,sukhasahagato,sukhasahagato,144,142,2,0,13
272420,avasesasmiṃ,avasesasmim,1,1,0,0,11
272421,upekkhāsahagato,upekkhasahagato,124,124,0,0,15
272422,upekkhāsahagatoti,upekkhasahagatoti,2,1,1,0,17
272423,samādhitikavaṇṇanā,samadhitikavannana,2,2,0,0,18
272424,V1.0085,V1.0085,34,34,0,0,7
272425,paṭiladdhamatto,patiladdhamatto,1,1,0,0,15
272426,paṭhamajjhānasamādhi,pathamajjhanasamadhi,23,23,0,0,20
272427,upacārasamādhinā,upacarasamadhina,29,29,0,0,16
272428,savitakkasavicāro,savitakkasavicaro,435,431,4,0,17
272429,dutiyajjhānasamādhi,dutiyajjhanasamadhi,9,9,0,0,19
272430,avitakkavicāramatto,avitakkavicaramatto,412,409,3,0,19
272431,vitakkamatteyeva,vitakkamatteyeva,2,1,1,0,16
272432,vitakkappahānamattaṃ,vitakkappahanamattam,1,1,0,0,20
272433,avitakkāvicāro,avitakkavicaro,4,3,1,0,14
272434,pītisahagato,pitisahagato,176,176,0,0,12
272435,pītisukhasahagato,pitisukhasahagato,2,1,1,0,17
272436,upacārabhūmiyaṃ,upacarabhumiyam,19,12,7,0,15
272437,rūpāvacarārūpāvacarakusale,rupavacararupavacarakusale,2,2,0,0,26
272438,samādhicatukkavaṇṇanā,samadhicatukkavannana,2,2,0,0,21
272439,dukkhāpaṭipado,dukkhapatipado,7,6,1,0,14
272440,dandhābhiñño,dandhabhinno,9,8,1,0,12
272441,khippābhiñño,khippabhinno,28,27,1,0,12
272442,sukhāpaṭipado,sukhapatipado,5,5,0,0,13
272443,khippābhiññoti,khippabhinnoti,4,3,1,0,14
272444,paṭhamasamannāhārato,pathamasamannaharato,7,7,0,0,20
272445,V1.0086,V1.0086,34,34,0,0,7
272446,abhiññāti,abhinnati,36,14,22,0,9
272447,nīvaraṇādipaccanīkadhammasamudācāragahaṇatāya,nivaranadipaccanikadhammasamudacaragahanataya,2,2,0,0,45
272448,asukhāsevanāti,asukhasevanati,2,1,1,0,14
272449,sappāyāsappāyāni,sappayasappayani,5,5,0,0,16
272450,palibodhupacchedādīni,palibodhupacchedadini,3,3,0,0,21
272451,appanākosallāni,appanakosallani,8,7,1,0,15
272452,asappāyasevī,asappayasevi,6,6,0,0,12
272453,sappāyasevino,sappayasevino,4,4,0,0,13
272454,sevitvā,sevitva,23,23,0,0,7
272455,sappāyasevī,sappayasevi,4,4,0,0,11
272456,vomissakatā,vomissakata,2,2,0,0,11
272457,palibodhupacchedādikaṃ,palibodhupacchedadikam,4,4,0,0,22
272458,asampādetvā,asampadetva,4,4,0,0,11
272459,bhāvanamanuyuttassa,bhavanamanuyuttassa,12,12,0,0,19
272460,asampādentassa,asampadentassa,5,5,0,0,14
272461,sampādentassa,sampadentassa,12,12,0,0,13
272462,taṇhāavijjāvasena,tanhaavijjavasena,2,2,0,0,17
272463,samathavipassanādhikāravasena,samathavipassanadhikaravasena,1,1,0,0,29
272464,taṇhābhibhūtassa,tanhabhibhutassa,4,3,1,0,16
272465,anabhibhūtassa,anabhibhutassa,8,7,1,0,14
272466,avijjābhibhūtassa,avijjabhibhutassa,3,3,0,0,17
272467,kilesindriyavasena,kilesindriyavasena,2,2,0,0,18
272468,tibbakilesassa,tibbakilesassa,5,5,0,0,14
272469,mudindriyassa,mudindriyassa,22,22,0,0,13
272470,tikkhindriyassa,tikkhindriyassa,26,25,1,0,15
272471,mandakilesassa,mandakilesassa,3,3,0,0,14
272472,paṭipadāabhiññāsu,patipadaabhinnasu,2,2,0,0,17
272473,dandhāya,dandhaya,2,2,0,0,8
272474,dandhābhiññoti,dandhabhinnoti,1,1,0,0,14
272475,sesattayepīti,sesattayepiti,1,1,0,0,13
272476,parittārammaṇo,parittarammano,82,82,0,0,14
272477,appamāṇārammaṇo,appamanarammano,68,68,0,0,15
272478,appamāṇārammaṇoti,appamanarammanoti,1,1,0,0,17
272479,appaguṇo,appaguno,3,3,0,0,8
272480,V1.0087,V1.0087,34,34,0,0,7
272481,uparijhānassa,uparijhanassa,15,14,1,0,13
272482,avaḍḍhite,avaddhite,5,5,0,0,9
272483,vuttalakkhaṇavomissatāya,vuttalakkhanavomissataya,1,1,0,0,24
272484,vomissakanayo,vomissakanayo,3,3,0,0,13
272485,vitakkavicārapītisukhasamādhīnaṃ,vitakkavicarapitisukhasamadhinam,1,1,0,0,32
272486,vūpasantavitakkavicāraṃ,vupasantavitakkavicaram,1,1,0,0,23
272487,virattapītikaṃ,virattapitikam,4,3,1,0,14
272488,pahīnasukhaṃ,pahinasukham,1,1,0,0,12
272489,upekkhāvedanāsahitassa,upekkhavedanasahitassa,1,1,0,0,22
272490,paccanīkasamudācāravasena,paccanikasamudacaravasena,2,2,0,0,25
272491,hānabhāgiyatā,hanabhagiyata,2,2,0,0,13
272492,tadanudhammatāya,tadanudhammataya,3,3,0,0,16
272493,saṇṭhānavasena,santhanavasena,18,16,2,0,14
272494,ṭhitibhāgiyatā,thitibhagiyata,1,1,0,0,14
272495,uparivisesādhigamavasena,uparivisesadhigamavasena,2,2,0,0,24
272496,visesabhāgiyatā,visesabhagiyata,3,3,0,0,15
272497,nibbidāsahagatasaññāmanasikārasamudācāravasena,nibbidasahagatasannamanasikarasamudacaravasena,1,1,0,0,46
272498,nibbedhabhāgiyatā,nibbedhabhagiyata,1,1,0,0,17
272499,lābhiṃ,labhim,32,27,5,0,6
272500,kāmasahagatā,kamasahagata,26,23,3,0,12
272501,saññāmanasikārā,sannamanasikara,138,129,9,0,15
272502,hānabhāginī,hanabhagini,20,17,3,0,11
272503,tadanudhammatā,tadanudhammata,36,32,4,0,14
272504,ṭhitibhāginī,thitibhagini,15,12,3,0,12
272505,avitakkasahagatā,avitakkasahagata,13,11,2,0,16
272506,visesabhāginī,visesabhagini,17,14,3,0,13
272507,nibbidāsahagatā,nibbidasahagata,18,18,0,0,15
272508,virāgūpasañhitā,viragupasanhita,11,11,0,0,15
272509,nibbedhabhāginī,nibbedhabhagini,14,12,2,0,15
272510,samādhīpi,samadhipi,2,1,1,0,9
272511,pañcamacatukke,pancamacatukke,1,1,0,0,14
272512,apariyāpanno,apariyapanno,59,59,0,0,12
272513,upacārekaggatā,upacarekaggata,2,2,0,0,14
272514,rūpāvacarādikusalacittekaggatā,rupavacaradikusalacittekaggata,1,1,0,0,30
272515,chaṭṭhacatukke,chatthacatukke,1,1,0,0,14
272516,adhipatiṃ,adhipatim,96,89,7,0,9
272517,cittassekaggataṃ,cittassekaggatam,19,19,0,0,16
272518,chandasamādhi,chandasamadhi,53,38,15,0,13
272519,vīmaṃsaṃ,vimamsam,48,45,3,0,8
272520,V1.0088,V1.0088,34,34,0,0,7
272521,vīmaṃsāsamādhī,vimamsasamadhi,2,2,0,0,14
272522,catukkabhede,catukkabhede,2,2,0,0,12
272523,vitakkamattātikkamena,vitakkamattatikkamena,1,1,0,0,21
272524,vitakkavicārātikkamena,vitakkavicaratikkamena,2,1,1,0,22
272525,pañcajhānaṅgavasena,pancajhanangavasena,1,1,0,0,19
272526,pañcavidhatā,pancavidhata,5,5,0,0,12
272527,hānabhāgiyadhammo,hanabhagiyadhammo,2,2,0,0,17
272528,visesabhāgiyadhammo,visesabhagiyadhammo,2,2,0,0,19
272529,dasapalibodhavaṇṇanā,dasapalibodhavannana,2,2,0,0,20
272530,bhāvetabboti,bhavetabboti,15,11,4,0,12
272531,duvidhotiādīsu,duvidhotiadisu,1,1,0,0,14
272532,ariyamaggasampayutto,ariyamaggasampayutto,2,2,0,0,20
272533,bhāvanānayo,bhavananayo,29,29,0,0,11
272534,paññābhāvanānayeneva,pannabhavananayeneva,1,1,0,0,20
272535,suparisuddhe,suparisuddhe,6,6,0,0,12
272536,yvāssa,yvassa,27,27,0,0,6
272537,palibodhesu,palibodhesu,8,8,0,0,11
272538,kammaṭṭhānadāyakaṃ,kammatthanadayakam,11,10,1,0,18
272539,khuddakapalibodhupacchedaṃ,khuddakapalibodhupacchedam,7,6,1,0,26
272540,aparihāpentena,aparihapentena,8,7,1,0,14
272541,V1.0089,V1.0089,34,34,0,0,7
272542,āvāsoyeva,avasoyeva,2,2,0,0,9
272543,āvāsapalibodho,avasapalibodho,39,37,2,0,14
272544,kulādīsu,kuladisu,3,3,0,0,8
272545,navakammādīsu,navakammadisu,2,2,0,0,13
272546,bahubhaṇḍasannicayo,bahubhandasannicayo,4,4,0,0,19
272547,apekkhavā,apekkhava,46,45,1,0,9
272548,anurādhapurā,anuradhapura,5,5,0,0,12
272549,pācinakhaṇḍarājiṃ,pacinakhandarajim,1,1,0,0,17
272550,pācinakhaṇḍarājigato,pacinakhandarajigato,1,1,0,0,20
272551,paṭisallānasāruppamidaṃ,patisallanasaruppamidam,1,1,0,0,23
272552,sahāyakassāpi,sahayakassapi,1,1,0,0,13
272553,ārocemī,arocemi,16,16,0,0,7
272554,pavisantaṃyeva,pavisantamyeva,1,1,0,0,14
272555,samānavassikatthero,samanavassikatthero,1,1,0,0,19
272556,āgantukatthero,agantukatthero,3,3,0,0,14
272557,pānakaṃ,panakam,40,37,3,0,7
272558,pesessati,pesessati,12,12,0,0,9
272559,ciranivāsī,ciranivasi,14,14,0,0,10
272560,yāgukhajjakaṃ,yagukhajjakam,19,19,0,0,13
272561,pesessatī,pesessati,6,6,0,0,9
272562,pahiṇantā,pahinanta,2,2,0,0,9
272563,dassatī,dassati,74,74,0,0,7
272564,nibaddhayāgu,nibaddhayagu,1,1,0,0,12
272565,dassantī,dassanti,33,33,0,0,8
272566,bhattakālepi,bhattakalepi,3,3,0,0,12
272567,laddhameva,laddhameva,11,11,0,0,10
272568,yāpethā,yapetha,4,4,0,0,7
272569,āmāvusoti,amavusoti,5,5,0,0,9
272570,pācinakhaṇḍarāji,pacinakhandaraji,1,1,0,0,16
272571,V1.0090,V1.0090,33,33,0,0,7
272572,kumbhakāragāmamaggaṃ,kumbhakaragamamaggam,1,1,0,0,20
272573,paṭipannatthā,patipannattha,1,1,0,0,13
272574,tvamāvuso,tvamavuso,2,2,0,0,9
272575,pācinakhaṇḍarājiyā,pacinakhandarajiya,1,1,0,0,18
272576,abhāsīti,abhasiti,38,24,14,0,8
272577,vasitaṭṭhāne,vasitatthane,8,8,0,0,12
272578,atirekaparikkhāro,atirekaparikkharo,2,2,0,0,17
272579,paṭisāmitameva,patisamitameva,1,1,0,0,14
272580,telanāḷi,telanali,3,2,1,0,8
272581,tatthevāti,tatthevati,148,3,145,0,10
272582,tayāvuso,tayavuso,1,1,0,0,8
272583,araññavāsoyeva,arannavasoyeva,2,2,0,0,14
272584,thūpārāmo,thuparamo,11,11,0,0,9
272585,mahācetiyadassanaṃ,mahacetiyadassanam,1,1,0,0,18
272586,theradassanañca,theradassananca,1,1,0,0,15
272587,buddhakālo,buddhakalo,2,2,0,0,10
272588,ñātikulaṃ,natikulam,34,33,1,0,9
272589,upaṭṭhākakulampi,upatthakakulampi,4,4,0,0,16
272590,sukhitesu,sukhitesu,24,22,2,0,9
272591,saṃsaṭṭhassa,samsatthassa,14,14,0,0,12
272592,kulamānusakehi,kulamanusakehi,2,2,0,0,14
272593,sāmantavihārampi,samantaviharampi,2,2,0,0,16
272594,koraṇḍakavihāravāsittherassa,korandakaviharavasittherassa,2,2,0,0,28
272595,bhāgineyyadaharabhikkhuno,bhagineyyadaharabhikkhuno,2,2,0,0,25
272596,uddesatthaṃ,uddesattham,3,2,1,0,11
272597,therabhaginīpi,therabhaginipi,1,1,0,0,14
272598,rohaṇābhimukho,rohanabhimukho,2,2,0,0,14
272599,daharopi,daharopi,20,20,0,0,8
272600,rohaṇato,rohanato,1,1,0,0,8
272601,samāgacchiṃsu,samagacchimsu,15,14,1,0,13
272602,yāsī,yasi,4,4,0,0,4
272603,upāsikāpi,upasikapi,4,4,0,0,9
272604,vassūpanāyikadivaseyeva,vassupanayikadivaseyeva,3,3,0,0,23
272605,senāsanampissa,senasanampissa,1,1,0,0,14
272606,kāritameva,karitameva,2,2,0,0,10
272607,daharassā,daharassa,1,1,0,0,9
272608,V1.0091,V1.0091,34,34,0,0,7
272609,upagatassa,upagatassa,49,49,0,0,10
272610,amhākaṃyeva,amhakamyeva,24,24,0,0,11
272611,āpucchitabbanti,apucchitabbanti,5,5,0,0,15
272612,paṭiyādesi,patiyadesi,15,15,0,0,10
272613,ghareyeva,ghareyeva,12,12,0,0,9
272614,telanāḷiṃ,telanalim,7,7,0,0,9
272615,navahatthañca,navahatthanca,1,1,0,0,13
272616,upajjhāyopissa,upajjhayopissa,2,2,0,0,14
272617,diṭṭhaṭṭhāneyeva,ditthatthaneyeva,2,2,0,0,16
272618,bhaddamukha,bhaddamukha,4,4,0,0,11
272619,rohaṇaṃyeva,rohanamyeva,1,1,0,0,11
272620,koraṇḍakagāmaṃ,korandakagamam,1,1,0,0,14
272621,olokayamānāva,olokayamanava,7,7,0,0,13
272622,ekakameva,ekakameva,9,9,0,0,9
272623,ajānāpetvāva,ajanapetvava,13,13,0,0,12
272624,pattatthavikato,pattatthavikato,5,5,0,0,15
272625,gatadisābhimukhā,gatadisabhimukha,1,1,0,0,16
272626,puttasadisaṃ,puttasadisam,1,1,0,0,12
272627,rathavinītapaṭipadaṃ,rathavinitapatipadam,5,4,1,0,20
272628,nālakapaṭipadaṃ,nalakapatipadam,14,10,4,0,15
272629,tuvaṭṭakapaṭipadaṃ,tuvattakapatipadam,4,3,1,0,18
272630,catupaccayasantosabhāvanārāmatādīpakaṃ,catupaccayasantosabhavanaramatadipakam,2,1,1,0,38
272631,mahāariyavaṃsapaṭipadañca,mahaariyavamsapatipadanca,1,1,0,0,25
272632,V1.0092,V1.0092,34,34,0,0,7
272633,vijātamātuyā,vijatamatuya,3,3,0,0,12
272634,bhuñjamānopi,bhunjamanopi,19,17,2,0,12
272635,puññavantassa,punnavantassa,3,3,0,0,13
272636,mahāparivāre,mahaparivare,2,2,0,0,12
272637,anumodento,anumodento,4,4,0,0,10
272638,aruṇuggamanato,arunuggamanato,29,29,0,0,14
272639,paṭhamayāmo,pathamayamo,9,9,0,0,11
272640,manussasaṃsaggo,manussasamsaggo,2,2,0,0,15
272641,balavapaccūseyeva,balavapaccuseyeva,4,4,0,0,17
272642,bāhullikapiṇḍapātikā,bahullikapindapatika,2,2,0,0,20
272643,amaccadhītā,amaccadhita,3,3,0,0,11
272644,pattacīvaranti,pattacivaranti,3,3,0,0,14
272645,gamanasajjova,gamanasajjova,2,2,0,0,13
272646,niccabyāvaṭo,niccabyavato,5,4,1,0,12
272647,upacchijjatīti,upacchijjatiti,4,4,0,0,14
272648,suttantikagaṇo,suttantikagano,3,3,0,0,14
272649,ābhidhammikagaṇo,abhidhammikagano,3,3,0,0,16
272650,paripucchaṃ,paripuccham,52,44,8,0,11
272651,samaṇadhammassa,samanadhammassa,27,25,2,0,15
272652,upacchinditabbo,upacchinditabbo,14,14,0,0,15
272653,antoyojanaparicchede,antoyojanaparicchede,2,2,0,0,20
272654,gaṇavācakaṃ,ganavacakam,4,4,0,0,11
272655,uddesādīhi,uddesadihi,11,11,0,0,10
272656,saṅgaṇhatū,sanganhatu,2,2,0,0,10
272657,alabhamānena,alabhamanena,21,20,1,0,12
272658,mayhamāvuso,mayhamavuso,1,1,0,0,11
272659,yathāphāsukaṭṭhānāni,yathaphasukatthanani,2,2,0,0,20
272660,vaḍḍhakīādīhi,vaddhakiadihi,2,2,0,0,13
272661,laddhāladdhaṃ,laddhaladdham,8,8,0,0,13
272662,katākate,katakate,4,4,0,0,8
272663,āpajjitabbanti,apajjitabbanti,3,3,0,0,14
272664,niṭṭhapetabbaṃ,nitthapetabbam,6,6,0,0,14
272665,saṅghikañce,sanghikance,1,1,0,0,11
272666,saṅghabhārahārakabhikkhūnaṃ,sanghabharaharakabhikkhunam,1,1,0,0,27
272667,niyyādetabbaṃ,niyyadetabbam,5,5,0,0,13
272668,santakañce,santakance,1,1,0,0,10
272669,bhārahārakānaṃ,bharaharakanam,2,2,0,0,14
272670,pabbajjāpekkho,pabbajjapekkho,17,17,0,0,14
272671,paccayajātaṃ,paccayajatam,14,14,0,0,12
272672,V1.0093,V1.0093,34,34,0,0,7
272673,gamikacittaṃ,gamikacittam,3,3,0,0,12
272674,duppaṭivinodanīyaṃ,duppativinodaniyam,2,2,0,0,18
272675,tīretvāva,tiretvava,2,2,0,0,9
272676,ācariyupajjhāyasaddhivihārikaantevāsikasamānupajjhāyakasamānācariyakā,acariyupajjhayasaddhiviharikaantevasikasamanupajjhayakasamanacariyaka,3,3,0,0,69
272677,pākatikakaraṇena,pakatikakaranena,4,4,0,0,16
272678,paṭijaggitabbo,patijaggitabbo,10,10,0,0,14
272679,pabbajjācariyo,pabbajjacariyo,14,11,3,0,14
272680,upasampadācariyo,upasampadacariyo,14,11,3,0,16
272681,upasampāditapabbājitaantevāsikasamānupajjhāyakā,upasampaditapabbajitaantevasikasamanupajjhayaka,3,3,0,0,47
272682,nissayācariyauddesācariyanissayantevāsikauddesantevāsikasamānācariyakā,nissayacariyauddesacariyanissayantevasikauddesantevasikasamanacariyaka,2,2,0,0,70
272683,nissayauddesā,nissayauddesa,4,4,0,0,13
272684,anupacchinnā,anupacchinna,8,8,0,0,12
272685,paṭijaggitabbā,patijaggitabba,9,9,0,0,14
272686,pahontena,pahontena,4,4,0,0,9
272687,uddhampi,uddhampi,35,33,2,0,8
272688,upajjhāye,upajjhaye,37,36,1,0,9
272689,pariyesitvāpi,pariyesitvapi,11,11,0,0,13
272690,bhātubhaginīnaṃ,bhatubhagininam,3,3,0,0,15
272691,labhantena,labhantena,11,11,0,0,10
272692,codetabbā,codetabba,15,15,0,0,9
272693,bhaginisāmikassa,bhaginisamikassa,1,1,0,0,16
272694,bhātujāyāyapi,bhatujayayapi,1,1,0,0,13
272695,bādhayamāno,badhayamano,3,3,0,0,11
272696,bhesajjakaraṇena,bhesajjakaranena,4,4,0,0,16
272697,samaṇadhammo,samanadhammo,56,51,5,0,12
272698,V1.0094,V1.0094,34,34,0,0,7
272699,pariyattiharaṇaṃ,pariyattiharanam,2,1,1,0,16
272700,sajjhāyādīhi,sajjhayadihi,5,5,0,0,12
272701,niccabyāvaṭassa,niccabyavatassa,1,1,0,0,15
272702,majjhimabhāṇakadevatthero,majjhimabhanakadevatthero,1,1,0,0,25
272703,malayavāsidevattherassa,malayavasidevattherassa,1,1,0,0,23
272704,kīdisosi,kidisosi,1,1,0,0,8
272705,pariyattiyanti,pariyattiyanti,1,1,0,0,14
272706,paguṇoti,pagunoti,2,1,1,0,8
272707,nāmeso,nameso,46,46,0,0,6
272708,dupparihāro,duppariharo,2,2,0,0,11
272709,mūlapaṇṇāsaṃ,mulapannasam,1,1,0,0,12
272710,kammaṭṭhānanti,kammatthananti,8,8,0,0,14
272711,olokessāmīti,olokessamiti,7,4,3,0,12
272712,ekūnavīsativassāni,ekunavisativassani,7,7,0,0,18
272713,sajjhāyatthāya,sajjhayatthaya,1,1,0,0,14
272714,anolokentassa,anolokentassa,2,2,0,0,13
272715,kataparicayo,kataparicayo,18,18,0,0,12
272716,ārabhathā,arabhatha,2,2,0,0,9
272717,ekabyañjanepissa,ekabyanjanepissa,1,1,0,0,16
272718,karuḷiyagirivāsīnāgattheropi,karuliyagirivasinagattheropi,1,1,0,0,28
272719,uddisi,uddisi,71,71,0,0,6
272720,gāmavāsikattherehi,gamavasikattherehi,1,1,0,0,18
272721,saṃsandentānaṃ,samsandentanam,1,1,0,0,14
272722,ekapañhopi,ekapanhopi,1,1,0,0,10
272723,mahāvihārepi,mahaviharepi,4,4,0,0,12
272724,anuggahetvāva,anuggahetvava,1,1,0,0,13
272725,pañcanikāyamaṇḍale,pancanikayamandale,3,3,0,0,18
272726,parivattessāmīti,parivattessamiti,3,2,1,0,16
272727,suvaṇṇabheriṃ,suvannabherim,5,4,1,0,13
272728,paharāpesi,paharapesi,5,5,0,0,10
272729,katamācariyānaṃ,katamacariyanam,2,1,1,0,15
272730,ācariyuggahaññeva,acariyuggahanneva,1,1,0,0,17
272731,upajjhāyopi,upajjhayopi,4,4,0,0,11
272732,upaṭṭhānamāgataṃ,upatthanamagatam,1,1,0,0,16
272733,paharāpesī,paharapesi,1,1,0,0,10
272734,hunti,hunti,4,4,0,0,5
272735,ācariyamaggo,acariyamaggo,1,1,0,0,12
272736,ācariyamukhato,acariyamukhato,5,5,0,0,14
272737,anuggahitattā,anuggahitatta,7,7,0,0,13
272738,suṇāhī,sunahi,39,39,0,0,6
272739,rohaṇajanapade,rohanajanapade,4,4,0,0,14
272740,tulādhārapabbatavihāre,tuladharapabbatavihare,1,1,0,0,22
272741,sabbapariyattiko,sabbapariyattiko,4,3,1,0,16
272742,V1.0095,V1.0095,34,34,0,0,7
272743,dīghamajjhimesu,dighamajjhimesu,2,2,0,0,15
272744,pariveṇadvāre,parivenadvare,4,4,0,0,13
272745,dhammassavanatthāya,dhammassavanatthaya,42,42,0,0,19
272746,abhayattherassa,abhayattherassa,5,5,0,0,15
272747,taṭṭikāya,tattikaya,6,5,1,0,9
272748,tumhākameva,tumhakameva,25,25,0,0,11
272749,gatakassa,gatakassa,1,1,0,0,9
272750,abhayathero,abhayathero,1,1,0,0,11
272751,parivattento,parivattento,41,40,1,0,12
272752,āharathāvuso,aharathavuso,1,1,0,0,12
272753,dhammantevāsikassa,dhammantevasikassa,1,1,0,0,18
272754,pothujjanikā,pothujjanika,20,19,1,0,12
272755,uttānaseyyakadārako,uttanaseyyakadarako,4,3,1,0,19
272756,taruṇasassaṃ,tarunasassam,9,9,0,0,12
272757,dupparihārā,dupparihara,5,4,1,0,11
272758,appamattakeneva,appamattakeneva,10,10,0,0,15
272759,pattabbato,pattabbato,20,19,1,0,10
272760,vipassanatthikena,vipassanatthikena,1,1,0,0,17
272761,iddhipalibodho,iddhipalibodho,2,2,0,0,14
272762,avasesāti,avasesati,19,2,17,0,9
272763,palibodhakathāya,palibodhakathaya,1,1,0,0,16
272764,kammaṭṭhānadāyakavaṇṇanā,kammatthanadayakavannana,2,2,0,0,24
272765,upasaṅkamitvāti,upasankamitvati,28,3,25,0,15
272766,sabbatthakakammaṭṭhānaṃ,sabbatthakakammatthanam,14,10,4,0,23
272767,pārihāriyakammaṭṭhānañca,parihariyakammatthananca,3,3,0,0,24
272768,bhikkhusaṅghādīsu,bhikkhusanghadisu,3,3,0,0,17
272769,asubhasaññātipi,asubhasannatipi,2,2,0,0,15
272770,kammaṭṭhānikena,kammatthanikena,9,8,1,0,15
272771,sīmaṭṭhakabhikkhusaṅghe,simatthakabhikkhusanghe,2,2,0,0,23
272772,abyāpajjāti,abyapajjati,5,2,3,0,11
272773,sīmaṭṭhakadevatāsu,simatthakadevatasu,5,5,0,0,18
272774,gocaragāmamhi,gocaragamamhi,6,6,0,0,13
272775,issarajane,issarajane,5,5,0,0,10
272776,V1.0096,V1.0096,34,34,0,0,7
272777,sahavāsīnaṃ,sahavasinam,11,9,2,0,11
272778,muducittataṃ,muducittatam,13,11,2,0,12
272779,sukhasaṃvāsā,sukhasamvasa,1,1,0,0,12
272780,mudukatacittāhi,mudukatacittahi,3,3,0,0,15
272781,susaṃvihitarakkho,susamvihitarakkho,2,2,0,0,17
272782,mudukatacittasantānehi,mudukatacittasantanehi,3,3,0,0,22
272783,surakkhitaparikkhāro,surakkhitaparikkharo,3,3,0,0,20
272784,pasāditacittehi,pasaditacittehi,3,3,0,0,15
272785,aparibhūto,aparibhuto,4,4,0,0,10
272786,appaṭihatacāro,appatihatacaro,7,7,0,0,14
272787,maritabbanti,maritabbanti,2,2,0,0,12
272788,vaḍḍhamānasaṃvego,vaddhamanasamvego,1,1,0,0,17
272789,anolīnavuttiko,anolinavuttiko,19,17,2,0,14
272790,asubhasaññāparicitacittassa,asubhasannaparicitacittassa,1,1,0,0,27
272791,pariyādiyanti,pariyadiyanti,35,34,1,0,13
272792,bahūpakārattā,bahupakaratta,20,19,1,0,13
272793,atthayitabbaṃ,atthayitabbam,7,5,2,0,13
272794,yogānuyogakammassa,yoganuyogakammassa,8,6,2,0,18
272795,pariharitabbattā,pariharitabbatta,7,7,0,0,16
272796,bhāvanākammassa,bhavanakammassa,5,5,0,0,15
272797,padaṭṭhānattā,padatthanatta,12,12,0,0,13
272798,pārihāriyakammaṭṭhānaṃ,parihariyakammatthanam,9,6,3,0,22
272799,kammaṭṭhānadāyako,kammatthanadayako,2,1,1,0,17
272800,kalyāṇamittanti,kalyanamittanti,1,1,0,0,15
272801,evamādiguṇasamannāgataṃ,evamadigunasamannagatam,4,3,1,0,23
272802,hitesiṃ,hitesim,1,1,0,0,7
272803,parimuccantī,parimuccanti,12,12,0,0,12
272804,gahitakammaṭṭhānaṃ,gahitakammatthanam,1,1,0,0,18
272805,sugahitaṃ,sugahitam,3,2,1,0,9
272806,mahāsāvakesu,mahasavakesu,12,12,0,0,12
272807,V1.0097,V1.0097,34,34,0,0,7
272808,gahetukāmo,gahetukamo,27,24,3,0,10
272809,catukkapañcakajjhānāni,catukkapancakajjhanani,17,17,0,0,22
272810,jhānapadaṭṭhānaṃ,jhanapadatthanam,9,9,0,0,16
272811,āsavakkhayappattassa,asavakkhayappattassa,2,2,0,0,20
272812,kārakabhāvaṃ,karakabhavam,10,7,3,0,12
272813,assaguttatthero,assaguttatthero,4,1,3,0,15
272814,āraddhakammaṭṭhānassa,araddhakammatthanassa,2,2,0,0,21
272815,kammaṭṭhānakārako,kammatthanakarako,1,1,0,0,17
272816,anāgāmisakadāgāmisotāpannajhānalābhīputhujjanatipiṭakadharadvipiṭakadharaekapiṭakadharesu,anagamisakadagamisotapannajhanalabhiputhujjanatipitakadharadvipitakadharaekapitakadharesu,1,1,0,0,89
272817,ekapiṭakadharepi,ekapitakadharepi,1,1,0,0,16
272818,ekasaṅgītipi,ekasangitipi,1,1,0,0,12
272819,tantidharo,tantidharo,1,1,0,0,10
272820,vaṃsānurakkhako,vamsanurakkhako,10,10,0,0,15
272821,paveṇīpālako,pavenipalako,5,5,0,0,12
272822,ācariyamatikova,acariyamatikova,1,1,0,0,15
272823,attanomatiko,attanomatiko,2,1,1,0,12
272824,porāṇakattherā,poranakatthera,20,20,0,0,14
272825,rakkhissatī,rakkhissati,12,10,2,0,11
272826,vuttakhīṇāsavādayo,vuttakhinasavadayo,2,2,0,0,18
272827,adhigatamaggameva,adhigatamaggameva,7,6,1,0,17
272828,uggahaparipucchānaṃ,uggahaparipucchanam,5,4,1,0,19
272829,visodhitattā,visodhitatta,17,16,1,0,12
272830,kāraṇañca,karananca,49,43,6,0,9
272831,sappāyāsappāyaṃ,sappayasappayam,26,24,2,0,15
272832,gahanaṭṭhāne,gahanatthane,9,9,0,0,12
272833,mahāhatthī,mahahatthi,15,15,0,0,10
272834,ekavihāreyeva,ekavihareyeva,3,3,0,0,13
272835,dhotamakkhitehi,dhotamakkhitehi,2,2,0,0,15
272836,telanāḷimadhuphāṇitādīni,telanalimadhuphanitadini,2,2,0,0,24
272837,antevāsikaparivutena,antevasikaparivutena,2,2,0,0,20
272838,gamikavattaṃ,gamikavattam,17,16,1,0,12
272839,kurumānena,kurumanena,6,6,0,0,10
272840,sallahukaparikkhārena,sallahukaparikkharena,2,2,0,0,21
272841,paramasallekhavuttinā,paramasallekhavuttina,2,2,0,0,21
272842,V1.0098,V1.0098,34,34,0,0,7
272843,pavisantena,pavisantena,32,32,0,0,11
272844,vissametvā,vissametva,1,1,0,0,10
272845,pādadhovanamakkhanādīni,padadhovanamakkhanadini,2,2,0,0,23
272846,āgamanakāraṇaṃ,agamanakaranam,28,26,2,0,14
272847,naṭṭhosi,natthosi,2,2,0,0,8
272848,vippaṭisāraṃ,vippatisaram,36,34,2,0,12
272849,uppādeyyuṃ,uppadeyyum,12,11,1,0,10
272850,daharataro,daharataro,16,15,1,0,10
272851,pattacīvarapaṭiggahaṇādīni,pattacivarapatiggahanadini,2,2,0,0,26
272852,vuḍḍhataro,vuddhataro,100,94,6,0,10
272853,nikkhipāvuso,nikkhipavuso,2,2,0,0,12
272854,dhovāhī,dhovahi,1,1,0,0,7
272855,dhovitabbā,dhovitabba,28,26,2,0,10
272856,dhovāhāvuso,dhovahavuso,1,1,0,0,11
272857,vihārassāpi,viharassapi,5,5,0,0,11
272858,makkhetabbā,makkhetabba,9,9,0,0,11
272859,gattabbhañjanatelaṃ,gattabbhanjanatelam,2,2,0,0,19
272860,khandhādīni,khandhadini,11,10,1,0,11
272861,sabbapārihāriyatelamidaṃ,sabbaparihariyatelamidam,2,2,0,0,24
272862,pādepi,padepi,7,7,0,0,6
272863,makkhehī,makkhehi,2,2,0,0,8
272864,ṭhapemi,thapemi,39,38,1,0,7
272865,pakatiupaṭṭhāko,pakatiupatthako,2,2,0,0,15
272866,yācitopi,yacitopi,13,13,0,0,8
272867,laddheyeva,laddheyeva,4,4,0,0,10
272868,khuddakamajjhimamahantāni,khuddakamajjhimamahantani,2,2,0,0,25
272869,dantakaṭṭhāni,dantakatthani,17,17,0,0,13
272870,upanāmetabbāni,upanametabbani,2,2,0,0,14
272871,mukhadhovanaudakañca,mukhadhovanaudakanca,3,3,0,0,20
272872,nhānodakañca,nhanodakanca,3,3,0,0,12
272873,paṭiyādetabbaṃ,patiyadetabbam,31,31,0,0,14
272874,upanāmetabbaṃ,upanametabbam,9,7,2,0,13
272875,yathāladdhaṃ,yathaladdham,40,38,2,0,12
272876,V1.0099,V1.0099,34,34,0,0,7
272877,antevāsikena,antevasikena,59,58,1,0,12
272878,ācariyamhi,acariyamhi,20,20,0,0,10
272879,vattanā,vattana,39,37,2,0,7
272880,mukhodakaṃ,mukhodakam,30,28,2,0,10
272881,upanāmetabbā,upanametabba,12,12,0,0,12
272882,sammāvattaṃ,sammavattam,5,5,0,0,11
272883,ārādhayamānena,aradhayamanena,1,1,0,0,14
272884,vissajjitena,vissajjitena,1,1,0,0,12
272885,kissāgatosīti,kissagatositi,1,1,0,0,13
272886,dasāhe,dasahe,25,23,2,0,6
272887,vissajjitenāpi,vissajjitenapi,1,1,0,0,14
272888,ārocetabbaṃ,arocetabbam,203,197,6,0,11
272889,kimatthamāgatosīti,kimatthamagatositi,1,1,0,0,18
272890,pittābādhena,pittabadhena,3,3,0,0,12
272891,aggimandatāya,aggimandataya,1,1,0,0,13
272892,sappāyavelaṃ,sappayavelam,1,1,0,0,12
272893,upasaṅkamitabbaṃ,upasankamitabbam,30,28,2,0,16
272894,asappāyavelāya,asappayavelaya,1,1,0,0,14
272895,manasikātunti,manasikatunti,1,1,0,0,13
272896,cariyāvaṇṇanā,cariyavannana,2,2,0,0,13
272897,cariyānukūlanti,cariyanukulanti,3,3,0,0,15
272898,cariyāti,cariyati,38,20,18,0,8
272899,dosacariyā,dosacariya,3,2,1,0,10
272900,mohacariyā,mohacariya,2,2,0,0,10
272901,saddhācariyā,saddhacariya,1,1,0,0,12
272902,buddhicariyā,buddhicariya,6,2,4,0,12
272903,vitakkacariyāti,vitakkacariyati,1,1,0,0,15
272904,saṃsaggasannipātavasena,samsaggasannipatavasena,4,3,1,0,23
272905,saddhādīnanti,saddhadinanti,1,1,0,0,13
272906,saddhādīhipi,saddhadihipi,2,2,0,0,12
272907,ussannatāti,ussannatati,2,2,0,0,11
272908,dosacarito,dosacarito,40,36,4,0,10
272909,saddhācarito,saddhacarito,8,6,2,0,12
272910,buddhicarito,buddhicarito,5,4,1,0,12
272911,vitakkacaritoti,vitakkacaritoti,1,1,0,0,15
272912,V1.0100,V1.0100,34,34,0,0,7
272913,kusalappavattisamaye,kusalappavattisamaye,2,2,0,0,20
272914,āsannaguṇattā,asannagunatta,4,2,2,0,13
272915,nātilūkho,natilukho,1,1,0,0,9
272916,vatthukāme,vatthukame,61,57,4,0,10
272917,sabhāgo,sabhago,58,46,12,0,7
272918,dosacaritassa,dosacaritassa,40,37,3,0,13
272919,nissineho,nissineho,6,6,0,0,9
272920,abhūtampi,abhutampi,2,2,0,0,9
272921,dosameva,dosameva,11,11,0,0,8
272922,sattaparivajjanākārena,sattaparivajjanakarena,1,1,0,0,22
272923,saṅkhāraparivajjanākārena,sankharaparivajjanakarena,1,1,0,0,25
272924,vāyamamānassa,vayamamanassa,3,3,0,0,13
272925,antarāyakarā,antarayakara,23,21,2,0,12
272926,āsannalakkhaṇattā,asannalakkhanatta,2,1,1,0,17
272927,paribyākulatāya,paribyakulataya,1,1,0,0,15
272928,nānappakāravitakkanatāya,nanappakaravitakkanataya,1,1,0,0,24
272929,apariyogāhaṇatāya,apariyogahanataya,1,1,0,0,17
272930,lahuparikappanatāya,lahuparikappanataya,1,1,0,0,19
272931,vitakkacarito,vitakkacarito,7,5,2,0,13
272932,sabhāgoti,sabhagoti,1,1,0,0,9
272933,taṇhāmānadiṭṭhivasena,tanhamanaditthivasena,28,26,2,0,21
272934,rāgoyeva,ragoyeva,4,3,1,0,8
272935,taṃsampayuttoti,tamsampayuttoti,8,2,6,0,15
272936,rāgacariyaṃ,ragacariyam,1,1,0,0,11
272937,mohanidānattā,mohanidanatta,3,2,1,0,13
272938,diṭṭhicariyā,ditthicariya,2,2,0,0,12
272939,mohacariyameva,mohacariyameva,1,1,0,0,14
272940,kinnidānā,kinnidana,5,5,0,0,9
272941,dosādīsu,dosadisu,2,2,0,0,8
272942,aññataracarito,annataracarito,1,1,0,0,14
272943,sappāyanti,sappayanti,14,14,0,0,10
272944,pubbāciṇṇanidānā,pubbacinnanidana,2,2,0,0,16
272945,dhātudosanidānā,dhatudosanidana,2,2,0,0,15
272946,iṭṭhappayogasubhakammabahulo,itthappayogasubhakammabahulo,2,2,0,0,28
272947,idhūpapanno,idhupapanno,55,54,1,0,11
272948,chedanavadhabandhanaverakammabahulo,chedanavadhabandhanaverakammabahulo,2,2,0,0,35
272949,nirayanāgayonīhi,nirayanagayonihi,2,2,0,0,16
272950,majjapānabahulo,majjapanabahulo,2,2,0,0,15
272951,sutaparipucchāvihīno,sutaparipucchavihino,2,2,0,0,20
272952,V1.0101,V1.0101,34,34,0,0,7
272953,idhūpapannoti,idhupapannoti,24,12,12,0,13
272954,pubbāciṇṇanidānāti,pubbacinnanidanati,2,2,0,0,18
272955,semhādhiko,semhadhiko,8,8,0,0,10
272956,vātādhiko,vatadhiko,9,9,0,0,9
272957,dhātudosanidānāti,dhatudosanidanati,2,2,0,0,17
272958,iṭṭhappayogasubhakammabahulāpi,itthappayogasubhakammabahulapi,2,2,0,0,30
272959,idhūpapannāpi,idhupapannapi,2,2,0,0,13
272960,rāgacaritāyeva,ragacaritayeva,1,1,0,0,14
272961,dosamohacaritā,dosamohacarita,8,7,1,0,14
272962,yathāvutteneva,yathavutteneva,28,23,5,0,14
272963,ussadaniyamo,ussadaniyamo,4,3,1,0,12
272964,dosaniyame,dosaniyame,2,2,0,0,10
272965,rāgamohadvayameva,ragamohadvayameva,2,2,0,0,17
272966,pubbāparaviruddhameva,pubbaparaviruddhameva,3,2,1,0,21
272967,saddhācariyādīsu,saddhacariyadisu,1,1,0,0,16
272968,ekissāpi,ekissapi,32,27,5,0,8
272969,aparicchinnavacanaṃ,aparicchinnavacanam,3,2,1,0,19
272970,matānusārena,matanusarena,4,4,0,0,12
272971,ussadakittane,ussadakittane,2,2,0,0,13
272972,pubbahetuniyāmena,pubbahetuniyamena,3,3,0,0,17
272973,lobhussadā,lobhussada,2,1,1,0,10
272974,dosussadā,dosussada,1,1,0,0,9
272975,mohussadā,mohussada,1,1,0,0,9
272976,alobhussadā,alobhussada,1,1,0,0,11
272977,adosussadā,adosussada,1,1,0,0,10
272978,amohussadā,amohussada,2,1,1,0,10
272979,kammāyūhanakkhaṇe,kammayuhanakkhane,28,28,0,0,17
272980,adosāmohā,adosamoha,11,9,2,0,9
272981,dosamohā,dosamoha,7,7,0,0,8
272982,dosamohe,dosamohe,3,3,0,0,8
272983,dinnapaṭisandhivasena,dinnapatisandhivasena,4,4,0,0,21
272984,vajirūpamañāṇo,vajirupamanano,6,6,0,0,14
272985,lobhadosā,lobhadosa,11,11,0,0,9
272986,alobhādosā,alobhadosa,10,9,1,0,10
272987,dattābhayatthero,dattabhayatthero,3,3,0,0,16
272988,lobhādosamohā,lobhadosamoha,6,6,0,0,13
272989,sīlako,silako,2,2,0,0,6
272990,V1.0102,V1.0102,34,34,0,0,7
272991,lobhadosamohā,lobhadosamoha,16,15,1,0,13
272992,alobhadosamohā,alobhadosamoha,5,5,0,0,14
272993,appakileso,appakileso,6,5,1,0,10
272994,dibbārammaṇampi,dibbarammanampi,3,3,0,0,15
272995,alobhādosamohā,alobhadosamoha,6,6,0,0,14
272996,alobhadosāmohā,alobhadosamoha,7,7,0,0,14
272997,alobhādosāmohā,alobhadosamoha,3,3,0,0,14
272998,luddhoti,luddhoti,2,1,1,0,8
272999,duṭṭhadandhā,dutthadandha,1,1,0,0,12
273000,aluddhaaduṭṭhā,aluddhaaduttha,2,1,1,0,14
273001,pasannapakatitāya,pasannapakatitaya,2,1,1,0,17
273002,saddhācaritā,saddhacarita,4,3,1,0,12
273003,amohaparivārena,amohaparivarena,1,1,0,0,15
273004,balavasaddhāparivārena,balavasaddhaparivarena,1,1,0,0,22
273005,kāmavitakkādiparivārena,kamavitakkadiparivarena,1,1,0,0,23
273006,lobhādinā,lobhadina,4,3,1,0,9
273007,vomissaparivārena,vomissaparivarena,1,1,0,0,17
273008,vomissacaritoti,vomissacaritoti,1,1,0,0,15
273009,aññataraññataraparivāraṃ,annatarannataraparivaram,1,1,0,0,24
273010,nidānanti,nidananti,14,14,0,0,9
273011,rāgacaritotiādi,ragacaritotiadi,1,1,0,0,15
273012,dhammappavattito,dhammappavattito,3,2,1,0,16
273013,cariyāyo,cariyayo,43,42,1,0,8
273014,V1.0103,V1.0103,34,34,0,0,7
273015,iriyāpathatoti,iriyapathatoti,1,0,1,0,14
273016,pakatigamanena,pakatigamanena,3,3,0,0,14
273017,cāturiyena,caturiyena,4,4,0,0,10
273018,ukkuṭikañcassa,ukkutikancassa,1,1,0,0,14
273019,pādaggehi,padaggehi,1,1,0,0,9
273020,anukaḍḍhitañcassa,anukaddhitancassa,1,1,0,0,17
273021,paribyākulāya,paribyakulaya,1,1,0,0,13
273022,chambhito,chambhito,5,4,1,0,9
273023,sahasānupīḷitañcassa,sahasanupilitancassa,1,1,0,0,20
273024,māgaṇḍiyasuttuppattiyaṃ,magandiyasuttuppattiyam,1,1,0,0,23
273025,anukaḍḍhitaṃ,anukaddhitam,4,3,1,0,12
273026,sahasānupīḷitaṃ,sahasanupilitam,6,5,1,0,15
273027,vivaṭṭacchadassa,vivattacchadassa,5,5,0,0,16
273028,idamīdisaṃ,idamidisam,12,11,1,0,10
273029,ṭhānampi,thanampi,13,13,0,0,8
273030,madhurākāraṃ,madhurakaram,2,1,1,0,12
273031,thaddhākāraṃ,thaddhakaram,5,4,1,0,12
273032,ākulākāraṃ,akulakaram,1,1,0,0,10
273033,nisajjāyapi,nisajjayapi,12,12,0,0,11
273034,ataramāno,ataramano,19,19,0,0,9
273035,vuṭṭhāpiyamāno,vutthapiyamano,3,3,0,0,14
273036,avuṭṭhāya,avutthaya,1,1,0,0,9
273037,pakkhittakāyo,pakkhittakayo,1,1,0,0,13
273038,bhākuṭiṃ,bhakutim,3,3,0,0,8
273039,dussaṇṭhānaṃ,dussanthanam,9,8,1,0,12
273040,vikkhittakāyo,vikkhittakayo,1,1,0,0,13
273041,huṅkāraṃ,hunkaram,1,1,0,0,8
273042,saddhācaritādayo,saddhacaritadayo,3,3,0,0,16
273043,rāgacaritādīnaṃ,ragacaritadinam,7,7,0,0,15
273044,tādisova,tadisova,45,45,0,0,8
273045,iriyāpatho,iriyapatho,78,63,15,0,10
273046,kiccāti,kiccati,3,0,3,0,7
273047,sammajjanādīsu,sammajjanadisu,1,1,0,0,14
273048,sammajjaniṃ,sammajjanim,26,26,0,0,11
273049,avippakiranto,avippakiranto,1,1,0,0,13
273050,sinduvārakusumasantharamiva,sinduvarakusumasantharamiva,1,1,0,0,27
273051,santharanto,santharanto,1,1,0,0,11
273052,taramānarūpo,taramanarupo,35,35,0,0,12
273053,ussārento,ussarento,4,4,0,0,9
273054,āḷolayamāno,alolayamano,1,1,0,0,11
273055,sammajjane,sammajjane,4,4,0,0,10
273056,cīvaradhovanarajanādīsupi,civaradhovanarajanadisupi,1,1,0,0,25
273057,nipuṇamadhurasamasakkaccakārī,nipunamadhurasamasakkaccakari,1,1,0,0,29
273058,V1.0104,V1.0104,34,34,0,0,7
273059,gāḷhathaddhavisamakārī,galhathaddhavisamakari,1,1,0,0,22
273060,anipuṇabyākulavisamāparicchinnakārī,anipunabyakulavisamaparicchinnakari,1,1,0,0,35
273061,cīvaradhāraṇampi,civaradharanampi,1,1,0,0,16
273062,nātigāḷhaṃ,natigalham,1,1,0,0,10
273063,nātisithilaṃ,natisithilam,1,1,0,0,12
273064,atigāḷhaṃ,atigalham,6,5,1,0,9
273065,aparimaṇḍalaṃ,aparimandalam,10,9,1,0,13
273066,paribyākulaṃ,paribyakulam,2,2,0,0,12
273067,tesaṃyevānusārena,tesamyevanusarena,3,3,0,0,17
273068,sabhāgattāti,sabhagattati,2,1,1,0,12
273069,bhojanāti,bhojanati,2,1,1,0,9
273070,siniddhamadhurabhojanappiyo,siniddhamadhurabhojanappiyo,1,1,0,0,27
273071,nātimahantaṃ,natimahantam,15,13,2,0,12
273072,rasapaṭisaṃvedī,rasapatisamvedi,4,4,0,0,15
273073,lūkhaambilabhojanappiyo,lukhaambilabhojanappiyo,1,1,0,0,23
273074,mukhapūrakaṃ,mukhapurakam,2,1,1,0,12
273075,arasapaṭisaṃvedī,arasapatisamvedi,1,1,0,0,16
273076,asāduṃ,asadum,10,10,0,0,6
273077,aniyataruciko,aniyataruciko,1,1,0,0,13
273078,chaḍḍento,chaddento,23,22,1,0,9
273079,makkhento,makkhento,4,4,0,0,9
273080,saddhācaritādayopi,saddhacaritadayopi,1,1,0,0,18
273081,taṃsabhāgattāti,tamsabhagattati,2,2,0,0,15
273082,bhojanato,bhojanato,12,12,0,0,9
273083,dassanāditoti,dassanaditoti,1,0,1,0,13
273084,vimhayajāto,vimhayajato,2,2,0,0,11
273085,parittepi,parittepi,8,7,1,0,9
273086,bhūtampi,bhutampi,3,3,0,0,8
273087,pakkamantopi,pakkamantopi,4,4,0,0,12
273088,amuñcitukāmova,amuncitukamova,1,1,0,0,14
273089,sāpekkho,sapekkho,42,39,3,0,8
273090,amanoramaṃ,amanoramam,7,7,0,0,10
273091,muñcitukāmova,muncitukamova,8,8,0,0,13
273092,parapaccayiko,parapaccayiko,1,1,0,0,13
273093,nindantaṃ,nindantam,2,2,0,0,9
273094,pasaṃsantaṃ,pasamsantam,1,1,0,0,11
273095,aññāṇupekkhāya,annanupekkhaya,6,6,0,0,14
273096,upekkhakova,upekkhakova,7,7,0,0,11
273097,saddasavanādīsupi,saddasavanadisupi,1,1,0,0,17
273098,pāpicchatā,papicchata,48,36,12,0,10
273099,mahicchatā,mahicchata,46,35,11,0,10
273100,cāpalyanti,capalyanti,1,1,0,0,10
273101,macchariyanti,macchariyanti,19,18,1,0,13
273102,ādhānaggāhitā,adhanaggahita,2,1,1,0,13
273103,duppaṭinissaggitāti,duppatinissaggitati,1,1,0,0,19
273104,saddhācaritassa,saddhacaritassa,20,18,2,0,15
273105,V1.0105,V1.0105,34,34,0,0,7
273106,muttacāgatā,muttacagata,3,3,0,0,11
273107,dassanakāmatā,dassanakamata,2,1,1,0,13
273108,pāmojjabahulatā,pamojjabahulata,1,1,0,0,15
273109,asaṭhatā,asathata,2,2,0,0,8
273110,amāyāvitā,amayavita,3,3,0,0,9
273111,saṃvejanīyesu,samvejaniyesu,8,6,2,0,13
273112,saṃviggassa,samviggassa,15,11,4,0,11
273113,bhassabahulatā,bhassabahulata,1,1,0,0,14
273114,gaṇārāmatā,ganaramata,1,1,0,0,10
273115,kusalānuyoge,kusalanuyoge,2,2,0,0,12
273116,anavaṭṭhitakiccatā,anavatthitakiccata,1,1,0,0,18
273117,dhūmāyanā,dhumayana,9,8,1,0,9
273118,pajjalanā,pajjalana,5,4,1,0,9
273119,hurāhuraṃ,hurahuram,2,1,1,0,9
273120,dhāvanāti,dhavanati,2,1,1,0,9
273121,cariyāvibhāvanavidhānaṃ,cariyavibhavanavidhanam,2,2,0,0,23
273122,ācariyamatānusārena,acariyamatanusarena,1,1,0,0,19
273123,iriyāpathādīni,iriyapathadini,1,1,0,0,14
273124,dosacaritādayopi,dosacaritadayopi,1,1,0,0,16
273125,appamādavihārino,appamadaviharino,8,8,0,0,16
273126,saṃsaṭṭhacaritassa,samsatthacaritassa,1,1,0,0,18
273127,iriyāpathādayo,iriyapathadayo,1,1,0,0,14
273128,aññataracaritoti,annataracaritoti,1,1,0,0,16
273129,adhotavedikaṃ,adhotavedikam,2,1,1,0,13
273130,bhūmaṭṭhakaṃ,bhumatthakam,2,1,1,0,12
273131,akatapabbhārakaṃ,akatapabbharakam,1,1,0,0,16
273132,tiṇakuṭikaṃ,tinakutikam,15,15,0,0,11
273133,paṇṇasālādīnaṃ,pannasaladinam,1,1,0,0,14
273134,rajokiṇṇaṃ,rajokinnam,2,2,0,0,10
273135,jatukābharitaṃ,jatukabharitam,2,1,1,0,14
273136,oluggaviluggaṃ,oluggaviluggam,12,10,2,0,14
273137,atiuccaṃ,atiuccam,6,6,0,0,8
273138,atinīcaṃ,atinicam,7,5,2,0,8
273139,ujjaṅgalaṃ,ujjangalam,8,6,2,0,10
273140,asucivisamamaggaṃ,asucivisamamaggam,1,1,0,0,17
273141,mañcapīṭhampi,mancapithampi,3,3,0,0,13
273142,maṅkuṇabharitaṃ,mankunabharitam,1,1,0,0,15
273143,olambavilambasuttakākiṇṇaṃ,olambavilambasuttakakinnam,1,1,0,0,26
273144,jālapūvasadisaṃ,jalapuvasadisam,2,2,0,0,15
273145,kharasamphassaṃ,kharasamphassam,9,8,1,0,15
273146,bhārikaṃ,bharikam,8,7,1,0,8
273147,kicchapariharaṇaṃ,kicchapariharanam,2,1,1,0,17
273148,āṇigaṇṭhikāhato,aniganthikahato,4,4,0,0,15
273149,dussaṇṭhāno,dussanthano,4,4,0,0,11
273150,sīsakapālamiva,sisakapalamiva,1,1,0,0,14
273151,bhikkhācāramaggopi,bhikkhacaramaggopi,1,1,0,0,18
273152,anāsannagāmo,anasannagamo,1,1,0,0,12
273153,bhikkhācāragāmopi,bhikkhacaragamopi,2,2,0,0,17
273154,ekakulepi,ekakulepi,1,1,0,0,9
273155,anapalokentā,anapalokenta,1,1,0,0,12
273156,V1.0106,V1.0106,34,34,0,0,7
273157,parivisakamanussāpi,parivisakamanussapi,1,1,0,0,19
273158,duddasikā,duddasika,5,5,0,0,9
273159,kiliṭṭhavasanā,kilitthavasana,1,1,0,0,14
273160,acittīkārena,acittikarena,10,10,0,0,12
273161,parivisanti,parivisanti,7,7,0,0,11
273162,yāgubhattakhajjakampi,yagubhattakhajjakampi,2,2,0,0,21
273163,sāmākakudrūsakakaṇājakādimayaṃ,samakakudrusakakanajakadimayam,1,1,0,0,30
273164,pūtitakkaṃ,putitakkam,1,1,0,0,10
273165,bilaṅgaṃ,bilangam,8,7,1,0,8
273166,jiṇṇasākasūpeyyaṃ,jinnasakasupeyyam,1,1,0,0,17
273167,yaṃkiñcideva,yamkincideva,12,11,1,0,12
273168,udarapūramattaṃ,udarapuramattam,1,1,0,0,15
273169,iriyāpathopissa,iriyapathopissa,2,2,0,0,15
273170,nīlādīsu,niladisu,27,27,0,0,8
273171,vaṇṇakasiṇesu,vannakasinesu,19,19,0,0,13
273172,aparisuddhavaṇṇanti,aparisuddhavannanti,1,1,0,0,19
273173,nātiuccaṃ,natiuccam,6,6,0,0,9
273174,nātinīcaṃ,natinicam,5,5,0,0,9
273175,chāyūdakasampannaṃ,chayudakasampannam,11,10,1,0,18
273176,suvibhattabhittithambhasopānaṃ,suvibhattabhittithambhasopanam,4,3,1,0,30
273177,supariniṭṭhitamālākammalatākammanānāvidhacittakammasamujjalasamasiniddhamudubhūmitalaṃ,suparinitthitamalakammalatakammananavidhacittakammasamujjalasamasiniddhamudubhumitalam,1,1,0,0,86
273178,brahmavimānamiva,brahmavimanamiva,1,1,0,0,16
273179,kusumadāmavicitravaṇṇacelavitānasamalaṅkataṃ,kusumadamavicitravannacelavitanasamalankatam,1,1,0,0,44
273180,supaññattasucimanoramattharaṇamañcapīṭhaṃ,supannattasucimanoramattharanamancapitham,1,1,0,0,41
273181,nikkhittakusumavāsagandhasugandhaṃ,nikkhittakusumavasagandhasugandham,1,1,0,0,34
273182,dassanamatteneva,dassanamatteneva,4,4,0,0,16
273183,senāsanassa,senasanassa,48,48,0,0,11
273184,sabbaparissayavimutto,sabbaparissayavimutto,1,1,0,0,21
273185,sucisamatalo,sucisamatalo,3,3,0,0,12
273186,alaṅkatapaṭiyattova,alankatapatiyattova,2,2,0,0,19
273187,senāsanaparikkhāropettha,senasanaparikkharopettha,1,1,0,0,24
273188,kīṭamaṅkuṇadīghajātimūsikānaṃ,kitamankunadighajatimusikanam,1,1,0,0,29
273189,nissayaparicchindanatthaṃ,nissayaparicchindanattham,1,1,0,0,25
273190,nātibahuko,natibahuko,1,1,0,0,10
273191,ekamañcapīṭhamattameva,ekamancapithamattameva,1,1,0,0,22
273192,nivāsanapārupanampissa,nivasanaparupanampissa,1,1,0,0,22
273193,cīnapaṭṭasomārapaṭṭakoseyyakappāsikasukhumakhomādīnaṃ,cinapattasomarapattakoseyyakappasikasukhumakhomadinam,1,1,0,0,53
273194,ekapaṭṭaṃ,ekapattam,9,9,0,0,9
273195,samaṇasāruppena,samanasaruppena,11,9,2,0,15
273196,suddhavaṇṇaṃ,suddhavannam,1,1,0,0,12
273197,udakapupphuḷamiva,udakapupphulamiva,1,1,0,0,17
273198,susaṇṭhāno,susanthano,5,5,0,0,10
273199,sumaṭṭho,sumattho,6,5,1,0,8
273200,suparisuddhavaṇṇo,suparisuddhavanno,1,1,0,0,17
273201,bhikkhācāramaggo,bhikkhacaramaggo,2,2,0,0,16
273202,parissayavimutto,parissayavimutto,1,1,0,0,16
273203,nātidūranāccāsannagāmo,natiduranaccasannagamo,1,1,0,0,22
273204,sittasammaṭṭhe,sittasammatthe,4,4,0,0,14
273205,paññattāsane,pannattasane,89,89,0,0,12
273206,parivesakā,parivesaka,1,1,0,0,10
273207,sunhātā,sunhata,19,19,0,0,7
273208,suvilittā,suvilitta,18,18,0,0,9
273209,dhūpavāsakusumagandhasurabhino,dhupavasakusumagandhasurabhino,1,1,0,0,30
273210,nānāvirāgasucimanuññavatthābharaṇapaṭimaṇḍitā,nanaviragasucimanunnavatthabharanapatimandita,1,1,0,0,45
273211,sakkaccakārino,sakkaccakarino,5,5,0,0,14
273212,vaṇṇagandharasasampannaṃ,vannagandharasasampannam,5,5,0,0,24
273213,sabbākārapaṇītaṃ,sabbakarapanitam,1,1,0,0,16
273214,suparisuddhavaṇṇanti,suparisuddhavannanti,1,1,0,0,20
273215,disāmukhaṃ,disamukham,4,3,1,0,10
273216,V1.0107,V1.0107,34,34,0,0,7
273217,suppamattaṃ,suppamattam,6,5,1,0,11
273218,sarāvamattaṃ,saravamattam,13,9,4,0,12
273219,sammohamāpajjati,sammohamapajjati,14,13,1,0,16
273220,mahākasiṇaṃ,mahakasinam,2,1,1,0,11
273221,vuttasadisamevāti,vuttasadisamevati,27,23,4,0,17
273222,dosacaritamhi,dosacaritamhi,1,1,0,0,13
273223,anussatiṭṭhānampi,anussatitthanampi,1,1,0,0,17
273224,senāsanādīsu,senasanadisu,2,2,0,0,12
273225,asappāyanti,asappayanti,5,5,0,0,11
273226,ārāmavanapokkharaṇīrāmaṇeyyakāni,aramavanapokkharaniramaneyyakani,1,1,0,0,32
273227,gāmanigamajanapadapaṭipāṭiyo,gamanigamajanapadapatipatiyo,1,1,0,0,28
273228,vitakkavidhāvanasseva,vitakkavidhavanasseva,2,1,1,0,21
273229,darīmukhe,darimukhe,1,1,0,0,9
273230,vanappaṭicchanne,vanappaticchanne,1,1,0,0,16
273231,hatthikucchipabbhāramahindaguhāsadise,hatthikucchipabbharamahindaguhasadise,1,1,0,0,37
273232,ārammaṇampissa,arammanampissa,2,2,0,0,14
273233,vitakkavasena,vitakkavasena,6,6,0,0,13
273234,sandhāvanassa,sandhavanassa,2,2,0,0,13
273235,āgatacariyānaṃ,agatacariyanam,1,1,0,0,14
273236,pabhedanidānavibhāvanasappāyaparicchedato,pabhedanidanavibhavanasappayaparicchedato,1,1,0,0,41
273237,āvikataṃ,avikatam,8,7,1,0,8
273238,cattālīsakammaṭṭhānavaṇṇanā,cattalisakammatthanavannana,2,2,0,0,27
273239,saṅkhātaniddesato,sankhataniddesato,2,2,0,0,17
273240,upacārappanāvahato,upacarappanavahato,4,3,1,0,18
273241,jhānappabhedato,jhanappabhedato,5,4,1,0,15
273242,samatikkamato,samatikkamato,7,6,1,0,13
273243,vaḍḍhanāvaḍḍhanato,vaddhanavaddhanato,5,4,1,0,18
273244,cariyānukūlatoti,cariyanukulatoti,4,1,3,0,16
273245,dasahākārehi,dasahakarehi,49,48,1,0,12
273246,kammaṭṭhānavinicchayo,kammatthanavinicchayo,1,1,0,0,21
273247,saṅkhātaniddesatoti,sankhataniddesatoti,2,0,2,0,19
273248,kammaṭṭhānesūti,kammatthanesuti,4,1,3,0,15
273249,V1.0108,V1.0108,34,34,0,0,7
273250,anussatiyo,anussatiyo,34,28,6,0,10
273251,vavatthānanti,vavatthananti,13,12,1,0,13
273252,pītakasiṇaṃ,pitakasinam,24,24,0,0,11
273253,lohitakasiṇaṃ,lohitakasinam,21,21,0,0,13
273254,odātakasiṇaṃ,odatakasinam,43,43,0,0,12
273255,paricchinnākāsakasiṇanti,paricchinnakasakasinanti,2,2,0,0,24
273256,vicchiddakaṃ,vicchiddakam,22,15,7,0,12
273257,vikkhittakaṃ,vikkhittakam,18,12,6,0,12
273258,aṭṭhikanti,atthikanti,9,9,0,0,10
273259,saṅghānussati,sanghanussati,20,15,5,0,13
273260,sīlānussati,silanussati,22,15,7,0,11
273261,cāgānussati,caganussati,21,15,6,0,11
273262,devatānussati,devatanussati,24,18,6,0,13
273263,maraṇānussati,marananussati,13,11,2,0,13
273264,upasamānussatīti,upasamanussatiti,8,7,1,0,16
273265,nevasaññānāsaññāyatananti,nevasannanasannayatananti,22,22,0,0,25
273266,paṭikūlasaññā,patikulasanna,31,30,1,0,13
273267,upacārappanāvahatoti,upacarappanavahatoti,1,0,1,0,20
273268,kāyagatāsatiñca,kayagatasatinca,3,3,0,0,15
273269,ānāpānassatiñca,anapanassatinca,2,2,0,0,15
273270,dasakammaṭṭhānāni,dasakammatthanani,1,1,0,0,17
273271,upacāravahāni,upacaravahani,1,1,0,0,13
273272,appanāvahāni,appanavahani,1,1,0,0,12
273273,jhānappabhedatoti,jhanappabhedatoti,1,0,1,0,17
273274,appanāvahesu,appanavahesu,1,1,0,0,12
273275,ānāpānassatiyā,anapanassatiya,30,29,1,0,14
273276,catukkajjhānikā,catukkajjhanika,7,5,2,0,15
273277,kāyagatāsatiyā,kayagatasatiya,13,13,0,0,14
273278,paṭhamajjhānikā,pathamajjhanika,23,22,1,0,15
273279,tikajjhānikā,tikajjhanika,2,2,0,0,12
273280,catutthabrahmavihāro,catutthabrahmaviharo,3,3,0,0,20
273281,catutthajjhānikāti,catutthajjhanikati,2,1,1,0,18
273282,samatikkamatoti,samatikkamatoti,1,0,1,0,15
273283,aṅgasamatikkamo,angasamatikkamo,3,3,0,0,15
273284,ārammaṇasamatikkamo,arammanasamatikkamo,4,4,0,0,19
273285,V1.0109,V1.0109,34,34,0,0,7
273286,tikacatukkajjhānikesu,tikacatukkajjhanikesu,1,1,0,0,21
273287,vitakkavicārādīni,vitakkavicaradini,1,1,0,0,17
273288,tesvevārammaṇesu,tesvevarammanesu,1,1,0,0,16
273289,dutiyajjhānādīnaṃ,dutiyajjhanadinam,21,21,0,0,17
273290,catutthabrahmavihāre,catutthabrahmavihare,2,2,0,0,20
273291,mettādīnaṃyeva,mettadinamyeva,1,1,0,0,14
273292,pattabboti,pattabboti,3,2,1,0,10
273293,kasiṇesu,kasinesu,53,52,1,0,8
273294,ākāsādīni,akasadini,1,1,0,0,9
273295,viññāṇañcāyatanādīni,vinnanancayatanadini,2,2,0,0,20
273296,vaḍḍhanāvaḍḍhanatoti,vaddhanavaddhanatoti,1,0,1,0,20
273297,kasiṇāneva,kasinaneva,2,2,0,0,10
273298,vaḍḍhetabbāni,vaddhetabbani,11,11,0,0,13
273299,yattakañhi,yattakanhi,8,8,0,0,10
273300,tadabbhantare,tadabbhantare,3,3,0,0,13
273301,parasattānañca,parasattananca,3,2,1,0,14
273302,cittamaññātuṃ,cittamannatum,2,1,1,0,13
273303,asubhāni,asubhani,16,16,0,0,8
273304,ānisaṃsābhāvā,anisamsabhava,3,2,1,0,13
273305,paricchinnatā,paricchinnata,4,4,0,0,13
273306,bhāvanānaye,bhavananaye,8,8,0,0,11
273307,vaḍḍhitesu,vaddhitesu,3,3,0,0,10
273308,kuṇaparāsiyeva,kunaparasiyeva,2,2,0,0,14
273309,sopākapañhābyākaraṇe,sopakapanhabyakarane,1,1,0,0,20
273310,aṭṭhikasaññā,atthikasanna,22,22,0,0,12
273311,nimittavaḍḍhanavasena,nimittavaddhanavasena,3,3,0,0,21
273312,vibhūtāti,vibhutati,4,2,2,0,9
273313,avaḍḍhanavasena,avaddhanavasena,1,1,0,0,15
273314,avibhūtāti,avibhutati,1,1,0,0,10
273315,aṭṭhisaññāya,atthisannaya,3,2,1,0,12
273316,apharī,aphari,3,2,1,0,6
273317,lābhissa,labhissa,4,4,0,0,8
273318,upaṭṭhānākāravasena,upatthanakaravasena,2,2,0,0,19
273319,dhammāsokakāle,dhammasokakale,2,2,0,0,14
273320,karavīkasakuṇo,karavikasakuno,1,1,0,0,14
273321,karavīkasaññī,karavikasanni,1,1,0,0,13
273322,aṭṭhikasaññāya,atthikasannaya,5,5,0,0,14
273323,lābhittā,labhitta,1,1,0,0,8
273324,kevalāpi,kevalapi,3,3,0,0,8
273325,aṭṭhikabharitāti,atthikabharitati,1,1,0,0,16
273326,asubhajjhānānaṃ,asubhajjhananam,3,3,0,0,15
273327,appamāṇārammaṇatā,appamanarammanata,14,13,1,0,17
273328,uddhumātake,uddhumatake,7,6,1,0,11
273329,aṭṭhike,atthike,9,8,1,0,7
273330,appamāṇārammaṇanti,appamanarammananti,6,6,0,0,18
273331,appamāṇārammaṇaṃ,appamanarammanam,120,117,3,0,16
273332,vaḍḍhetabbānīti,vaddhetabbaniti,3,1,2,0,15
273333,V1.0110,V1.0110,34,34,0,0,7
273334,ānāpānanimittaṃ,anapananimittam,2,2,0,0,15
273335,vātarāsiyeva,vatarasiyeva,3,2,1,0,12
273336,sādīnavattā,sadinavatta,4,3,1,0,11
273337,vaḍḍhetabbaṃ,vaddhetabbam,46,42,4,0,12
273338,sattārammaṇā,sattarammana,4,4,0,0,12
273339,sattarāsiyeva,sattarasiyeva,2,2,0,0,13
273340,pariggahavaseneva,pariggahavaseneva,3,3,0,0,17
273341,ekāvāsadviāvāsādinā,ekavasadviavasadina,2,1,1,0,19
273342,paṭibhāganimittameva,patibhaganimittameva,2,2,0,0,20
273343,yadayaṃ,yadayam,3,2,1,0,7
273344,parittaappamāṇārammaṇatāpettha,parittaappamanarammanatapettha,2,1,1,0,30
273345,āruppārammaṇesupi,arupparammanesupi,1,1,0,0,17
273346,kasiṇugghāṭimattā,kasinugghatimatta,2,1,1,0,17
273347,kasiṇāpagamavaseneva,kasinapagamavaseneva,2,2,0,0,20
273348,vaḍḍhayatopi,vaddhayatopi,2,2,0,0,12
273349,sabhāvadhammattā,sabhavadhammatta,7,6,1,0,16
273350,viññāṇāpagamo,vinnanapagamo,2,2,0,0,13
273351,abhāvamattattā,abhavamattatta,3,3,0,0,14
273352,nevasaññānāsaññāyatanārammaṇaṃ,nevasannanasannayatanarammanam,1,1,0,0,30
273353,sabhāvadhammattāyeva,sabhavadhammattayeva,2,2,0,0,20
273354,animittattā,animittatta,4,4,0,0,11
273355,paṭibhāganimittañhi,patibhaganimittanhi,2,2,0,0,19
273356,buddhānussatiādīnañca,buddhanussatiadinanca,1,1,0,0,21
273357,vaḍḍhetabbanti,vaddhetabbanti,4,4,0,0,14
273358,ārammaṇatoti,arammanatoti,37,7,30,0,12
273359,dasakasiṇā,dasakasina,2,2,0,0,10
273360,kāyagatāsatīti,kayagatasatiti,21,11,10,0,14
273361,dvāvīsatipaṭibhāganimittārammaṇāni,dvavisatipatibhaganimittarammanani,1,1,0,0,34
273362,paṭibhāganimittārammaṇāni,patibhaganimittarammanani,1,1,0,0,25
273363,anussatīsu,anussatisu,9,9,0,0,10
273364,sabhāvadhammārammaṇāni,sabhavadhammarammanani,1,1,0,0,22
273365,nimittārammaṇāni,nimittarammanani,1,1,0,0,16
273366,vattabbārammaṇāni,vattabbarammanani,1,1,0,0,17
273367,ālokakasiṇe,alokakasine,6,6,0,0,11
273368,obhāsamaṇḍalārammaṇanti,obhasamandalarammananti,1,1,0,0,23
273369,calitārammaṇāni,calitarammanani,1,1,0,0,15
273370,paṭibhāgaṃ,patibhagam,14,13,1,0,10
273371,sannisinnameva,sannisinnameva,5,4,1,0,14
273372,calitārammaṇānīti,calitarammananiti,1,1,0,0,17
273373,bhūmitoti,bhumitoti,3,0,3,0,9
273374,nappavattanti,nappavattanti,55,52,3,0,13
273375,V1.0111,V1.0111,33,33,0,0,7
273376,diṭṭhaphuṭṭhasutaggahaṇatopettha,ditthaphutthasutaggahanatopettha,1,1,0,0,32
273377,asubhāti,asubhati,11,2,9,0,8
273378,kāyagatāsatiyaṃ,kayagatasatiyam,6,6,0,0,15
273379,tacapañcakaṃ,tacapancakam,8,7,1,0,12
273380,sutenāti,sutenati,12,1,11,0,8
273381,diṭṭhasutena,ditthasutena,2,2,0,0,12
273382,phuṭṭhena,phutthena,4,3,1,0,9
273383,diṭṭhaphuṭṭhena,ditthaphutthena,6,5,1,0,15
273384,upekkhābrahmavihāro,upekkhabrahmaviharo,7,7,0,0,19
273385,āruppāti,aruppati,12,5,7,0,8
273386,ādikammikena,adikammikena,27,26,1,0,12
273387,paccayatoti,paccayatoti,10,1,9,0,11
273388,āruppānaṃ,aruppanam,6,6,0,0,9
273389,catutthabrahmavihārassa,catutthabrahmaviharassa,1,1,0,0,23
273390,sukhavihāravipassanābhavasampattīnanti,sukhaviharavipassanabhavasampattinanti,1,1,0,0,38
273391,anukūlatopettha,anukulatopettha,1,1,0,0,15
273392,vaṇṇakasiṇānīti,vannakasinaniti,2,2,0,0,15
273393,kammaṭṭhānameva,kammatthanameva,20,20,0,0,15
273394,upasamānussati,upasamanussati,25,20,5,0,14
273395,sesakasiṇāni,sesakasinani,3,3,0,0,12
273396,sabbacaritānaṃ,sabbacaritanam,4,2,2,0,14
273397,mohacaritassāti,mohacaritassati,1,1,0,0,15
273398,cariyānukūlato,cariyanukulato,2,2,0,0,14
273399,atisappāyavasena,atisappayavasena,6,6,0,0,16
273400,anupakārā,anupakara,8,8,0,0,9
273401,kusalabhāvanā,kusalabhavana,12,11,1,0,13
273402,meghiyasutte,meghiyasutte,3,2,1,0,12
273403,V1.0112,V1.0112,34,34,0,0,7
273404,vitakkupacchedāya,vitakkupacchedaya,6,6,0,0,17
273405,asmimānasamugghātāyā,asmimanasamugghataya,2,2,0,0,20
273406,rāhulasuttepi,rahulasuttepi,1,1,0,0,13
273407,vacanamatte,vacanamatte,9,9,0,0,11
273408,pariyesitabboti,pariyesitabboti,5,5,0,0,15
273409,kammaṭṭhānakathā,kammatthanakatha,4,4,0,0,16
273410,ayamatthadīpanā,ayamatthadipana,1,1,0,0,15
273411,sampannajjhāsayena,sampannajjhasayena,4,3,1,0,18
273412,sampannādhimuttinā,sampannadhimuttina,2,1,1,0,18
273413,imāhaṃ,imaham,114,112,2,0,6
273414,pariccajāmī,pariccajami,2,2,0,0,11
273415,niyyātetabbo,niyyatetabbo,4,4,0,0,12
273416,aniyyātetvā,aniyyatetva,6,6,0,0,11
273417,pantesu,pantesu,20,20,0,0,7
273418,senāsanesu,senasanesu,103,99,4,0,10
273419,bheravārammaṇe,bheravarammane,3,3,0,0,14
273420,āpāthamāgate,apathamagate,15,14,1,0,12
273421,santhambhituṃ,santhambhitum,10,8,2,0,13
273422,gāmantaṃ,gamantam,45,40,5,0,8
273423,niyyātitattabhāvassa,niyyatitattabhavassa,1,1,0,0,20
273424,āpāthamāgatepi,apathamagatepi,1,1,0,0,14
273425,niyyātito,niyyatito,8,8,0,0,9
273426,somanassameva,somanassameva,17,15,2,0,13
273427,kāsikavatthaṃ,kasikavattham,21,20,1,0,13
273428,mūsikāya,musikaya,6,6,0,0,8
273429,kīṭehi,kitehi,1,1,0,0,6
273430,khādite,khadite,13,13,0,0,7
273431,acīvarakassa,acivarakassa,1,1,0,0,12
273432,evaṃsampadamidaṃ,evamsampadamidam,99,93,6,0,16
273433,niyyātentenāpi,niyyatentenapi,2,2,0,0,14
273434,aniyyātitattabhāvo,aniyyatitattabhavo,1,1,0,0,18
273435,atajjanīyo,atajjaniyo,3,3,0,0,10
273436,anovādakaro,anovadakaro,1,1,0,0,11
273437,yenakāmaṃgamo,yenakamamgamo,17,17,0,0,13
273438,anāpucchāva,anapucchava,13,12,1,0,11
273439,yatthicchati,yatthicchati,4,4,0,0,12
273440,sikkhāpeti,sikkhapeti,18,18,0,0,10
273441,gihibhāvaṃ,gihibhavam,72,65,7,0,10
273442,niyyātitattabhāvo,niyyatitattabhavo,1,1,0,0,17
273443,ācariyāyattavuttiyeva,acariyayattavuttiyeva,1,1,0,0,21
273444,V1.0113,V1.0113,34,34,0,0,7
273445,cūḷapiṇḍapātikatissattherassa,culapindapatikatissattherassa,2,2,0,0,29
273446,tumhākamatthāyā,tumhakamatthaya,3,3,0,0,15
273447,sataporise,sataporise,9,9,0,0,10
273448,papāte,papate,82,81,1,0,6
273449,ussaheyyanti,ussaheyyanti,3,3,0,0,12
273450,paṇhito,panhito,3,3,0,0,7
273451,ghaṃsento,ghamsento,3,3,0,0,9
273452,assāsapassāse,assasapassase,97,92,5,0,13
273453,uparundhitvā,uparundhitva,10,10,0,0,12
273454,bhabbāvatime,bhabbavatime,1,1,0,0,12
273455,ayamānisaṃso,ayamanisamso,15,14,1,0,12
273456,attaniyyātane,attaniyyatane,1,1,0,0,13
273457,alobhādīnaṃ,alobhadinam,14,12,2,0,11
273458,chahākārehi,chahakarehi,62,56,6,0,11
273459,sampannajjhāsayo,sampannajjhasayo,4,4,0,0,16
273460,ajjhāsayā,ajjhasaya,13,11,2,0,9
273461,bodhiparipākāya,bodhiparipakaya,4,3,1,0,15
273462,alobhajjhāsayā,alobhajjhasaya,6,6,0,0,14
273463,dosadassāvino,dosadassavino,31,31,0,0,13
273464,adosajjhāsayā,adosajjhasaya,4,4,0,0,13
273465,amohajjhāsayā,amohajjhasaya,4,4,0,0,13
273466,nekkhammajjhāsayā,nekkhammajjhasaya,6,6,0,0,17
273467,pavivekajjhāsayā,pavivekajjhasaya,5,5,0,0,16
273468,saṅgaṇikāya,sanganikaya,24,24,0,0,11
273469,nissaraṇajjhāsayā,nissaranajjhasaya,5,5,0,0,17
273470,sabbabhavagatīsu,sabbabhavagatisu,1,1,0,0,16
273471,sotāpannasakadāgāmianāgāmikhīṇāsavapaccekabuddhasammāsambuddhā,sotapannasakadagamianagamikhinasavapaccekabuddhasammasambuddha,1,1,0,0,62
273472,tadadhimuttatāya,tadadhimuttataya,12,12,0,0,16
273473,adhimuttisampannena,adhimuttisampannena,1,1,0,0,19
273474,samādhādhimuttena,samadhadhimuttena,1,1,0,0,17
273475,samādhigarukena,samadhigarukena,1,1,0,0,15
273476,samādhipabbhārena,samadhipabbharena,1,1,0,0,17
273477,nibbānādhimuttena,nibbanadhimuttena,1,1,0,0,17
273478,nibbānagarukena,nibbanagarukena,1,1,0,0,15
273479,nibbānapabbhārena,nibbanapabbharena,1,1,0,0,17
273480,sampannajjhāsayādhimuttino,sampannajjhasayadhimuttino,1,1,0,0,26
273481,yācato,yacato,7,7,0,0,6
273482,cetopariyañāṇalābhinā,cetopariyananalabhina,2,2,0,0,21
273483,caritosi,caritosi,1,1,0,0,8
273484,V1.0114,V1.0114,34,34,0,0,7
273485,uggahitakammaṭṭhānassa,uggahitakammatthanassa,2,2,0,0,22
273486,nisajjāni,nisajjani,1,1,0,0,9
273487,āgatāgatakkhaṇe,agatagatakkhane,2,1,1,0,15
273488,gantukāmassa,gantukamassa,14,14,0,0,12
273489,nātisaṃkhittaṃ,natisamkhittam,1,1,0,0,14
273490,nātivitthārikaṃ,nativittharikam,1,1,0,0,15
273491,kasiṇadosā,kasinadosa,6,6,0,0,10
273492,kasiṇakaraṇaṃ,kasinakaranam,1,1,0,0,13
273493,appanākosallaṃ,appanakosallam,21,20,1,0,14
273494,vīriyasamatā,viriyasamata,3,3,0,0,12
273495,appanāvidhānanti,appanavidhananti,1,1,0,0,16
273496,sesakammaṭṭhānesupi,sesakammatthanesupi,1,1,0,0,19
273497,bhāvanāvidhāne,bhavanavidhane,2,2,0,0,14
273498,heṭṭhimapadaṃ,hetthimapadam,3,3,0,0,13
273499,uparimapadaṃ,uparimapadam,3,3,0,0,12
273500,idamopammanti,idamopammanti,1,1,0,0,13
273501,upanibandhitvāti,upanibandhitvati,7,1,6,0,16
273502,suṇantena,sunantena,4,3,1,0,9
273503,atthaparidīpanā,atthaparidipana,1,1,0,0,15
273504,vitthāritāni,vittharitani,21,21,0,0,12
273505,samādhibhāvanādhikāre,samadhibhavanadhikare,8,8,0,0,21
273506,pathavīkasiṇaniddeso,pathavikasinaniddeso,3,3,0,0,20
273507,V1.0115,V1.0115,34,34,0,0,7
273508,viharantenā,viharantena,4,4,0,0,11
273509,tāvācariyena,tavacariyena,1,1,0,0,12
273510,ekavihāre,ekavihare,42,42,0,0,9
273511,parisodhentena,parisodhentena,1,1,0,0,14
273512,gāvute,gavute,8,8,0,0,6
273513,aḍḍhayojane,addhayojane,12,12,0,0,11
273514,yojanamattepi,yojanamattepi,1,1,0,0,13
273515,satisammose,satisammose,3,3,0,0,11
273516,bhattakiccapariyosāneyeva,bhattakiccapariyosaneyeva,2,2,0,0,25
273517,taṃdivasamācariyassa,tamdivasamacariyassa,1,1,0,0,20
273518,akilamantoyeva,akilamantoyeva,2,2,0,0,14
273519,yojanappamāṇepi,yojanappamanepi,2,2,0,0,15
273520,phāsukaṭṭhānaṃ,phasukatthanam,22,21,1,0,14
273521,gaṇṭhiṭṭhānaṃ,ganthitthanam,12,10,2,0,13
273522,āvajjanapaṭibaddhaṃ,avajjanapatibaddham,10,10,0,0,19
273523,ananurūpavihāro,ananurupaviharo,1,1,0,0,15
273524,ananurūpo,ananurupo,6,5,1,0,9
273525,navattaṃ,navattam,3,3,0,0,8
273526,jiṇṇattaṃ,jinnattam,3,3,0,0,9
273527,panthanissitattaṃ,panthanissitattam,3,3,0,0,17
273528,patthanīyatā,patthaniyata,3,3,0,0,12
273529,nagarasannissitatā,nagarasannissitata,2,2,0,0,18
273530,dārusannissitatā,darusannissitata,2,2,0,0,16
273531,khettasannissitatā,khettasannissitata,2,2,0,0,18
273532,visabhāgānaṃ,visabhaganam,11,10,1,0,12
273533,paṭṭanasannissitatā,pattanasannissitata,3,3,0,0,19
273534,paccantasannissitatā,paccantasannissitata,3,3,0,0,20
273535,rajjasīmasannissitatā,rajjasimasannissitata,3,3,0,0,21
273536,asappāyatā,asappayata,5,5,0,0,10
273537,kalyāṇamittānaṃ,kalyanamittanam,19,17,2,0,15
273538,alābhoti,alabhoti,12,8,4,0,8
273539,paṭiviruddhatāya,pativiruddhataya,2,2,0,0,16
273540,V1.0116,V1.0116,34,34,0,0,7
273541,bodhiyaṅgaṇādīni,bodhiyanganadini,2,2,0,0,16
273542,asammaṭṭhāneva,asammatthaneva,2,2,0,0,14
273543,anupaṭṭhāpitaṃ,anupatthapitam,2,2,0,0,14
273544,gocaragāme,gocaragame,45,43,2,0,10
273545,pānīyaghaṭaṃ,paniyaghatam,43,42,1,0,12
273546,vattabhede,vattabhede,51,48,3,0,10
273547,atidivā,atidiva,26,25,1,0,7
273548,paṭisallānagatopi,patisallanagatopi,2,2,0,0,17
273549,sāmaṇeradaharabhikkhūnaṃ,samaneradaharabhikkhunam,4,4,0,0,24
273550,saṅghakammehi,sanghakammehi,2,2,0,0,13
273551,saṅghaṭṭanā,sanghattana,11,11,0,0,11
273552,navavihāre,navavihare,4,1,3,0,10
273553,jiṇṇavihāre,jinnavihare,3,1,2,0,11
273554,paṭijaggitabbaṃ,patijaggitabbam,8,8,0,0,15
273555,senāsanamattampi,senasanamattampi,2,2,0,0,16
273556,appaṭijaggantaṃ,appatijaggantam,2,2,0,0,15
273557,paṭijaggantassa,patijaggantassa,7,7,0,0,15
273558,panthanissite,panthanissite,2,0,2,0,13
273559,mahāpathavihāre,mahapathavihare,2,2,0,0,15
273560,āgantukasambādho,agantukasambadho,2,2,0,0,16
273561,pāsāṇapokkharaṇī,pasanapokkharani,3,3,0,0,16
273562,pānīyatthaṃ,paniyattham,2,2,0,0,11
273563,rājakulūpakattherānaṃ,rajakulupakattheranam,2,2,0,0,21
273564,rajanakammatthāya,rajanakammatthaya,2,2,0,0,17
273565,bhājanadārudoṇikādīni,bhajanadarudonikadini,2,2,0,0,21
273566,pucchantānaṃ,pucchantanam,17,16,1,0,12
273567,sākapaṇṇaṃ,sakapannam,7,6,1,0,10
273568,tatthassa,tatthassa,62,59,3,0,9
273569,nisinnassāpi,nisinnassapi,11,10,1,0,12
273570,sākahārikā,sakaharika,2,2,0,0,10
273571,uccinantiyo,uccinantiyo,2,2,0,0,11
273572,visabhāgasaddasaṅghaṭṭanena,visabhagasaddasanghattanena,2,2,0,0,27
273573,kammaṭṭhānantarāyaṃ,kammatthanantarayam,2,2,0,0,19
273574,V1.0117,V1.0117,34,34,0,0,7
273575,mālāgacchā,malagaccha,2,1,1,0,10
273576,tādisoyeva,tadisoyeva,14,13,1,0,10
273577,ambajambupanasādiphalaṃ,ambajambupanasadiphalam,2,1,1,0,23
273578,phalatthikā,phalatthika,6,6,0,0,11
273579,avāsāyapissa,avasayapissa,4,4,0,0,12
273580,parakkamanti,parakkamanti,6,6,0,0,12
273581,patthanīye,patthaniye,3,0,3,0,10
273582,leṇasammate,lenasammate,2,1,1,0,11
273583,dakkhiṇagirihatthikucchicetiyagiricittalapabbatasadise,dakkhinagirihatthikucchicetiyagiricittalapabbatasadise,2,2,0,0,54
273584,ayamarahāti,ayamarahati,1,1,0,0,11
273585,nagarasannissite,nagarasannissite,2,0,2,0,16
273586,visabhāgārammaṇāni,visabhagarammanani,3,2,1,0,18
273587,āpāthamāgacchanti,apathamagacchanti,20,20,0,0,17
273588,kumbhadāsiyopi,kumbhadasiyopi,2,2,0,0,14
273589,nighaṃsantiyo,nighamsantiyo,4,3,1,0,13
273590,issaramanussāpi,issaramanussapi,2,2,0,0,15
273591,sāṇiṃ,sanim,26,26,0,0,5
273592,dārusannissaye,darusannissaye,2,0,2,0,14
273593,dabbupakaraṇarukkhā,dabbupakaranarukkha,2,2,0,0,19
273594,kaṭṭhahārikā,katthaharika,4,4,0,0,12
273595,vuttasākapupphahārikā,vuttasakapupphaharika,2,2,0,0,21
273596,padhānagharā,padhanaghara,2,2,0,0,12
273597,khettasannissito,khettasannissito,2,0,2,0,16
273598,vihāramajjheyeva,viharamajjheyeva,11,10,1,0,16
273599,pamukhesu,pamukhesu,3,3,0,0,9
273600,mahāsaṅghabhogo,mahasanghabhogo,2,2,0,0,15
273601,ārāmikā,aramika,15,15,0,0,7
273602,udakavāraṃ,udakavaram,6,5,1,0,10
273603,khettasannissiteneva,khettasannissiteneva,2,2,0,0,20
273604,atthitāti,atthitati,7,0,7,0,9
273605,visabhāgaverī,visabhagaveri,1,1,0,0,13
273606,V1.0118,V1.0118,34,34,0,0,7
273607,vāriyamānā,variyamana,3,2,1,0,10
273608,naṭṭhāmhāti,natthamhati,1,1,0,0,11
273609,udakapaṭṭanaṃ,udakapattanam,3,1,2,0,13
273610,thalapaṭṭanaṃ,thalapattanam,3,1,2,0,13
273611,āgatamanussā,agatamanussa,10,10,0,0,12
273612,paccantasannissite,paccantasannissite,2,0,2,0,18
273613,rajjasīmasannissite,rajjasimasannissite,3,0,3,0,19
273614,carapuriso,carapuriso,5,5,0,0,10
273615,asappāyatāti,asappayatati,2,0,2,0,12
273616,visabhāgarūpādiārammaṇasamosaraṇena,visabhagarupadiarammanasamosaranena,2,2,0,0,35
273617,amanussapariggahitatāya,amanussapariggahitataya,2,2,0,0,23
273618,paṇṇasāladvāre,pannasaladvare,40,40,0,0,14
273619,gāyi,gayi,25,24,1,0,4
273620,caṅkamanasīse,cankamanasise,5,5,0,0,13
273621,caṅkamanasīsaṃ,cankamanasisam,2,2,0,0,14
273622,khāditā,khadita,25,25,0,0,7
273623,ācariyasamaṃ,acariyasamam,2,2,0,0,12
273624,upajjhāyasamaṃ,upajjhayasamam,2,2,0,0,14
273625,mahādosoyevāti,mahadosoyevati,2,2,0,0,14
273626,ananurūpoti,ananurupoti,2,2,0,0,11
273627,mahāvāsaṃ,mahavasam,8,8,0,0,9
273628,navāvāsaṃ,navavasam,7,7,0,0,9
273629,jarāvāsañca,jaravasanca,7,7,0,0,11
273630,panthaniṃ,panthanim,9,8,1,0,9
273631,patthitameva,patthitameva,11,11,0,0,12
273632,dārunā,daruna,21,21,0,0,6
273633,visabhāgena,visabhagena,11,11,0,0,11
273634,paccantasīmāsappāyaṃ,paccantasimasappayam,7,6,1,0,20
273635,aṭṭhārasetāni,attharasetani,7,7,0,0,13
273636,V1.0119,V1.0119,34,34,0,0,7
273637,sappaṭibhayaṃ,sappatibhayam,45,38,7,0,13
273638,anurūpavihāro,anurupaviharo,1,1,0,0,13
273639,gocaragāmato,gocaragamato,11,10,1,0,12
273640,nātidūranāccāsannatādīhi,natiduranaccasannatadihi,3,3,0,0,24
273641,pañcaṅgasamannāgataṃ,pancangasamannagatam,50,45,5,0,20
273642,nātidūraṃ,natiduram,26,23,3,0,9
273643,nāccāsannaṃ,naccasannam,12,9,3,0,11
273644,gamanāgamanasampannaṃ,gamanagamanasampannam,25,23,2,0,21
273645,appākiṇṇaṃ,appakinnam,22,18,4,0,10
273646,appanigghosaṃ,appanigghosam,47,36,11,0,13
273647,appaḍaṃsamakasavātātapasarīsapasamphassaṃ,appadamsamakasavatatapasarisapasamphassam,11,11,0,0,41
273648,appakasireneva,appakasireneva,70,68,2,0,14
273649,cīvarapiṇḍapātasenāsanagilānapaccayabhesajjaparikkhārā,civarapindapatasenasanagilanapaccayabhesajjaparikkhara,17,17,0,0,54
273650,mātikādharā,matikadhara,31,28,3,0,11
273651,avivaṭañceva,avivatanceva,24,22,2,0,12
273652,anuttānīkatañca,anuttanikatanca,25,22,3,0,15
273653,uttānīkaronti,uttanikaronti,29,27,2,0,13
273654,anekavihitesu,anekavihitesu,24,22,2,0,13
273655,kaṅkhaṭṭhāniyesu,kankhatthaniyesu,3,2,1,0,16
273656,paṭivinodenti,pativinodenti,26,23,3,0,13
273657,khuddakapalibodhā,khuddakapalibodha,3,2,1,0,17
273658,yepissa,yepissa,25,25,0,0,7
273659,upacchinditabbā,upacchinditabba,3,3,0,0,15
273660,kesanakhalomāni,kesanakhalomani,7,7,0,0,15
273661,chinditabbāni,chinditabbani,9,9,0,0,13
273662,jiṇṇacīvaresu,jinnacivaresu,3,3,0,0,13
273663,daḷhīkammaṃ,dalhikammam,40,33,7,0,11
273664,tunnakammaṃ,tunnakammam,5,4,1,0,11
273665,rajitabbāni,rajitabbani,3,3,0,0,11
273666,pacitabbo,pacitabbo,9,9,0,0,9
273667,sodhetabbānīti,sodhetabbaniti,2,2,0,0,14
273668,V1.0120,V1.0120,34,34,0,0,7
273669,sabbakammaṭṭhānavasena,sabbakammatthanavasena,1,1,0,0,22
273670,vitthārakathā,vittharakatha,104,103,1,0,13
273671,upacchinnakhuddakapalibodhena,upacchinnakhuddakapalibodhena,4,4,0,0,29
273672,piṇḍapātapaṭikkantena,pindapatapatikkantena,7,7,0,0,21
273673,bhattasammadaṃ,bhattasammadam,15,12,3,0,14
273674,paṭivinodetvā,pativinodetva,50,50,0,0,13
273675,sukhanisinnena,sukhanisinnena,12,12,0,0,14
273676,akatāya,akataya,25,25,0,0,7
273677,sāntake,santake,3,3,0,0,7
273678,anantake,anantake,6,5,1,0,8
273679,sakoṭiye,sakotiye,1,1,0,0,8
273680,akoṭiye,akotiye,1,1,0,0,7
273681,savaṭṭume,savattume,1,1,0,0,9
273682,avaṭṭume,avattume,1,1,0,0,8
273683,sapariyante,sapariyante,1,1,0,0,11
273684,suppamatte,suppamatte,12,9,3,0,10
273685,sarāvamatte,saravamatte,10,9,1,0,11
273686,suvavatthitaṃ,suvavatthitam,13,12,1,0,13
273687,vavatthapeti,vavatthapeti,224,219,5,0,12
273688,ānisaṃsadassāvī,anisamsadassavi,12,9,3,0,15
273689,ratanasaññī,ratanasanni,4,3,1,0,11
273690,sampiyāyamāno,sampiyayamano,17,15,2,0,13
273691,muccissāmī,muccissami,23,23,0,0,10
273692,atītabhavepi,atitabhavepi,1,1,0,0,12
273693,isipabbajjāya,isipabbajjaya,1,1,0,0,13
273694,pathavīkasiṇe,pathavikasine,50,47,3,0,13
273695,nibbattitapubbāni,nibbattitapubbani,1,1,0,0,17
273696,upanissayasampannassa,upanissayasampannassa,10,10,0,0,21
273697,khalamaṇḍale,khalamandale,1,1,0,0,12
273698,mallakattherassa,mallakattherassa,2,1,1,0,16
273699,kirāyasmato,kirayasmato,5,5,0,0,11
273700,kasitaṭṭhānaṃ,kasitatthanam,17,17,0,0,13
273701,taṃṭhānappamāṇameva,tamthanappamanameva,1,1,0,0,19
273702,pañcakajjhānāni,pancakajjhanani,1,1,0,0,15
273703,ācariyasantike,acariyasantike,19,18,1,0,14
273704,uggahitakammaṭṭhānavidhānaṃ,uggahitakammatthanavidhanam,1,1,0,0,27
273705,kasiṇadose,kasinadose,3,3,0,0,10
273706,pariharantena,pariharantena,10,10,0,0,13
273707,nīlapītalohitaodātasambhedavasena,nilapitalohitaodatasambhedavasena,1,1,0,0,33
273708,pathavīkasiṇadosā,pathavikasinadosa,1,1,0,0,17
273709,gaṅgāvahe,gangavahe,4,3,1,0,9
273710,mattikāsadisāya,mattikasadisaya,2,1,1,0,15
273711,aruṇavaṇṇāya,arunavannaya,3,2,1,0,12
273712,sāmaṇerādīnaṃ,samaneradinam,12,12,0,0,13
273713,V1.0121,V1.0121,34,34,0,0,7
273714,sañcaraṇaṭṭhāne,sancaranatthane,7,7,0,0,15
273715,paṭicchannaṭṭhāne,paticchannatthane,43,43,0,0,17
273716,pabbhāre,pabbhare,26,26,0,0,8
273717,tatraṭṭhakaṃ,tatratthakam,8,4,4,0,12
273718,daṇḍakesu,dandakesu,20,20,0,0,9
273719,kaṭasārakaṃ,katasarakam,9,9,0,0,11
273720,apanītatiṇamūlasakkharakathalikāya,apanitatinamulasakkharakathalikaya,1,1,0,0,34
273721,sumadditāya,sumadditaya,2,2,0,0,11
273722,vuttappamāṇaṃ,vuttappamanam,15,13,2,0,13
273723,parikammakāle,parikammakale,14,14,0,0,13
273724,padumakaṇṇikākārena,padumakannikakarena,2,2,0,0,19
273725,khāṇuke,khanuke,44,42,2,0,7
273726,vinandhitvā,vinandhitva,23,21,2,0,11
273727,suparisodhitāya,suparisodhitaya,1,1,0,0,15
273728,vidatthicaturaṅgulavitthāraṃ,vidatthicaturangulavittharam,3,3,0,0,28
273729,paricchedatthāya,paricchedatthaya,3,3,0,0,16
273730,vuttappamāṇaparicchedaṃ,vuttappamanaparicchedam,1,1,0,0,23
273731,rukkhapāṇikā,rukkhapanika,1,1,0,0,12
273732,visabhāgavaṇṇaṃ,visabhagavannam,2,1,1,0,15
273733,samuṭṭhapeti,samutthapeti,11,9,2,0,12
273734,pāsāṇapāṇikāya,pasanapanikaya,1,1,0,0,14
273735,ghaṃsetvā,ghamsetva,5,5,0,0,9
273736,bherītalasadisaṃ,bheritalasadisam,2,1,1,0,16
273737,kasiṇamaṇḍalato,kasinamandalato,3,3,0,0,15
273738,aḍḍhateyyahatthantare,addhateyyahatthantare,3,3,0,0,21
273739,vidatthicaturaṅgulapādake,vidatthicaturangulapadake,3,3,0,0,25
273740,suatthate,suatthate,2,2,0,0,9
273741,kāmanissaraṇe,kamanissarane,2,2,0,0,13
273742,sabbadukkhasamatikkamupāyabhūte,sabbadukkhasamatikkamupayabhute,1,1,0,0,31
273743,jātābhilāsena,jatabhilasena,2,1,1,0,13
273744,buddhadhammasaṅghaguṇānussaraṇena,buddhadhammasanghagunanussaranena,5,4,1,0,33
273745,sabbabuddha,sabbabuddha,1,1,0,0,11
273746,nekkhammapaṭipadā,nekkhammapatipada,2,1,1,0,17
273747,sañjātagāravena,sanjatagaravena,1,1,0,0,15
273748,pavivekasukharasassa,pavivekasukharasassa,1,1,0,0,20
273749,atiummīlayato,atiummilayato,2,2,0,0,13
273750,ativibhūtaṃ,ativibhutam,3,2,1,0,11
273751,ummīlayato,ummilayato,2,2,0,0,10
273752,maṇḍalamavibhūtaṃ,mandalamavibhutam,1,1,0,0,17
273753,ādāsatale,adasatale,13,12,1,0,9
273754,mukhanimittadassinā,mukhanimittadassina,2,1,1,0,19
273755,samenākārena,samenakarena,4,4,0,0,12
273756,paccavekkhitabbo,paccavekkhitabbo,13,11,2,0,16
273757,manasikātabbaṃ,manasikatabbam,66,62,4,0,14
273758,nissayasavaṇṇaṃ,nissayasavannam,2,1,1,0,15
273759,ussadavasena,ussadavasena,21,17,4,0,12
273760,paṇṇattidhamme,pannattidhamme,7,7,0,0,14
273761,V1.0122,V1.0122,34,34,0,0,7
273762,vasundharātiādīsu,vasundharatiadisu,1,1,0,0,17
273763,pathavīnāmesu,pathavinamesu,1,1,0,0,13
273764,saññānukūlaṃ,sannanukulam,2,1,1,0,12
273765,pākaṭavaseneva,pakatavaseneva,2,2,0,0,14
273766,nimīletvā,nimiletva,22,20,2,0,9
273767,āvajjitabbaṃ,avajjitabbam,38,37,1,0,12
273768,uggahanimittaṃ,uggahanimittam,55,53,2,0,14
273769,kālasatampi,kalasatampi,5,5,0,0,11
273770,kālasahassampi,kalasahassampi,5,5,0,0,14
273771,ummīlitakāle,ummilitakale,1,1,0,0,12
273772,āpāthamāgacchati,apathamagacchati,56,54,2,0,16
273773,pādadhovanapapañcaparihāratthaṃ,padadhovanapapancapariharattham,1,1,0,0,31
273774,ekapaṭalikupāhanā,ekapatalikupahana,1,1,0,0,17
273775,asappāyakāraṇena,asappayakaranena,1,1,0,0,16
273776,kattaradaṇḍaṃ,kattaradandam,18,18,0,0,13
273777,samannāharitabbaṃ,samannaharitabbam,7,4,3,0,17
273778,takkāhataṃ,takkahatam,17,15,2,0,10
273779,vitakkāhataṃ,vitakkahatam,21,19,2,0,12
273780,vikkhambhanti,vikkhambhanti,20,18,2,0,13
273781,sannisīdanti,sannisidanti,6,6,0,0,12
273782,uggahanimittassa,uggahanimittassa,7,7,0,0,16
273783,uggahanimitte,uggahanimitte,8,8,0,0,13
273784,kasiṇadoso,kasinadoso,6,4,2,0,10
273785,thavikato,thavikato,3,3,0,0,9
273786,nihatādāsamaṇḍalaṃ,nihatadasamandalam,1,1,0,0,18
273787,sudhotasaṅkhathālaṃ,sudhotasankhathalam,1,1,0,0,19
273788,meghamukhe,meghamukhe,5,5,0,0,10
273789,nikkhantamiva,nikkhantamiva,1,1,0,0,13
273790,sahassaguṇaṃ,sahassagunam,6,6,0,0,12
273791,saṇṭhānavantaṃ,santhanavantam,5,4,1,0,14
273792,sammasanupagaṃ,sammasanupagam,2,2,0,0,14
273793,tilakkhaṇabbhāhataṃ,tilakkhanabbhahatam,4,2,2,0,19
273794,samādhilābhino,samadhilabhino,4,4,0,0,14
273795,upaṭṭhānākāramattaṃ,upatthanakaramattam,3,1,2,0,19
273796,saññajametanti,sannajametanti,1,1,0,0,14
273797,uppannakālato,uppannakalato,19,19,0,0,13
273798,vikkhambhitāneva,vikkhambhitaneva,13,10,3,0,16
273799,sannisinnāva,sannisinnava,9,8,1,0,12
273800,samāhitamevāti,samahitamevati,1,1,0,0,14
273801,appanāsamādhi,appanasamadhi,20,18,2,0,13
273802,V1.0123,V1.0123,34,34,0,0,7
273803,paṭilābhabhūmiyaṃ,patilabhabhumiyam,5,3,2,0,17
273804,nīvaraṇappahānena,nivaranappahanena,14,12,2,0,17
273805,thāmajātāni,thamajatani,8,8,0,0,11
273806,athāmajātattā,athamajatatta,3,3,0,0,13
273807,ṭhapiyamāno,thapiyamano,3,3,0,0,11
273808,nimittamārammaṇaṃ,nimittamarammanam,1,1,0,0,17
273809,bhavaṅgamotarati,bhavangamotarati,1,1,0,0,16
273810,appanāyaṃ,appanayam,14,12,2,0,9
273811,thāmajātattā,thamajatatta,2,2,0,0,12
273812,divasampi,divasampi,103,102,1,0,9
273813,appanāsamādhimhi,appanasamadhimhi,3,3,0,0,16
273814,bhavaṅgavāraṃ,bhavangavaram,4,4,0,0,13
273815,kusalajavanapaṭipāṭivaseneva,kusalajavanapatipativaseneva,3,3,0,0,28
273816,cakkavattigabbho,cakkavattigabbho,4,4,0,0,16
273817,laddhaparihāni,laddhaparihani,1,1,0,0,14
273818,sattasappāyā,sattasappaya,1,1,0,0,12
273819,rakkhaṇavidhi,rakkhanavidhi,1,1,0,0,13
273820,tatrassa,tatrassa,47,46,1,0,8
273821,V1.0124,V1.0124,34,34,0,0,7
273822,anuppannaṃ,anuppannam,86,79,7,0,10
273823,anupaṭṭhitā,anupatthita,35,35,0,0,11
273824,asamāhitañca,asamahitanca,23,23,0,0,12
273825,thāvarañca,thavaranca,7,7,0,0,10
273826,nāgapabbatavāsīpadhāniyatissattherassa,nagapabbatavasipadhaniyatissattherassa,1,1,0,0,38
273827,āvāsasappāyatāya,avasasappayataya,1,1,0,0,16
273828,tambapaṇṇidīpamhi,tambapannidipamhi,4,4,0,0,17
273829,cūḷanāgaleṇe,culanagalene,1,1,0,0,12
273830,sotāpannādīnaṃ,sotapannadinam,31,30,1,0,14
273831,arahattappattānañca,arahattappattananca,1,1,0,0,19
273832,evamaññesupi,evamannesupi,6,6,0,0,12
273833,cittalapabbatavihārādīsu,cittalapabbataviharadisu,1,1,0,0,24
273834,gocaragāmo,gocaragamo,26,22,4,0,10
273835,diyaḍḍhakosabbhantare,diyaddhakosabbhantare,2,2,0,0,21
273836,sulabhasampannabhikkho,sulabhasampannabhikkho,2,2,0,0,22
273837,dvattiṃsatiracchānakathāpariyāpannaṃ,dvattimsatiracchanakathapariyapannam,2,2,0,0,36
273838,nimittantaradhānāya,nimittantaradhanaya,3,3,0,0,19
273839,dasakathāvatthunissitaṃ,dasakathavatthunissitam,9,8,1,0,23
273840,atiracchānakathiko,atiracchanakathiko,4,4,0,0,18
273841,sīlādiguṇasampanno,siladigunasampanno,16,15,1,0,18
273842,asamāhitaṃ,asamahitam,82,72,10,0,10
273843,kāyadaḷhībahulo,kayadalhibahulo,7,7,0,0,15
273844,tiracchānakathiko,tiracchanakathiko,3,3,0,0,17
273845,kaddamodakamiva,kaddamodakamiva,3,3,0,0,15
273846,malīnameva,malinameva,3,3,0,0,10
273847,tādisañca,tadisanca,21,21,0,0,9
273848,koṭapabbatavāsīdaharasseva,kotapabbatavasidaharasseva,2,2,0,0,26
273849,samāpattipi,samapattipi,2,2,0,0,11
273850,sayanaṭṭhānanisajjānaṃ,sayanatthananisajjanam,2,2,0,0,22
273851,V1.0125,V1.0125,34,34,0,0,7
273852,nimittāsevanabahulassa,nimittasevanabahulassa,3,3,0,0,22
273853,dasavidhaappanākosallaṃ,dasavidhaappanakosallam,1,1,0,0,23
273854,dasāhākārehi,dasahakarehi,1,1,0,0,12
273855,vatthuvisadakiriyato,vatthuvisadakiriyato,1,1,0,0,20
273856,indriyasamattapaṭipādanato,indriyasamattapatipadanato,1,1,0,0,26
273857,nimittakusalato,nimittakusalato,1,1,0,0,15
273858,sampahaṃsitabbaṃ,sampahamsitabbam,9,8,1,0,16
273859,sampahaṃseti,sampahamseti,51,47,4,0,12
273860,ajjhupekkhitabbaṃ,ajjhupekkhitabbam,12,11,1,0,17
273861,ajjhupekkhati,ajjhupekkhati,91,83,8,0,13
273862,asamāhitapuggalaparivajjanato,asamahitapuggalaparivajjanato,1,1,0,0,29
273863,samāhitapuggalasevanato,samahitapuggalasevanato,1,1,0,0,23
273864,tadadhimuttatoti,tadadhimuttatoti,1,1,0,0,16
273865,vatthuvisadakiriyā,vatthuvisadakiriya,31,25,6,0,18
273866,ajjhattikabāhirānaṃ,ajjhattikabahiranam,19,13,6,0,19
273867,visadabhāvakaraṇaṃ,visadabhavakaranam,14,12,2,0,18
273868,sedamalaggahitaṃ,sedamalaggahitam,3,3,0,0,16
273869,ajjhattikavatthu,ajjhattikavatthu,8,8,0,0,16
273870,uklāpaṃ,uklapam,35,34,1,0,7
273871,bāhiravatthu,bahiravatthu,9,9,0,0,12
273872,ajjhattikabāhire,ajjhattikabahire,16,16,0,0,16
273873,avisade,avisade,13,9,4,0,7
273874,aparisuddhāni,aparisuddhani,11,11,0,0,13
273875,dīpakapallikavaṭṭitelāni,dipakapallikavattitelani,5,4,1,0,24
273876,uppannadīpasikhāya,uppannadipasikhaya,15,15,0,0,18
273877,aparisuddhena,aparisuddhena,14,12,2,0,13
273878,kammaṭṭhānamanuyuñjato,kammatthanamanuyunjato,4,4,0,0,22
273879,kammaṭṭhānampi,kammatthanampi,7,7,0,0,14
273880,visade,visade,13,12,1,0,6
273881,parisuddhāni,parisuddhani,26,25,1,0,12
273882,indriyasamattapaṭipādanaṃ,indriyasamattapatipadanam,1,0,1,0,25
273883,V1.0126,V1.0126,34,34,0,0,7
273884,samabhāvakaraṇaṃ,samabhavakaranam,14,9,5,0,16
273885,paggahakiccaṃ,paggahakiccam,19,14,5,0,13
273886,upaṭṭhānakiccaṃ,upatthanakiccam,7,7,0,0,15
273887,avikkhepakiccaṃ,avikkhepakiccam,7,7,0,0,15
273888,dhammasabhāvapaccavekkhaṇena,dhammasabhavapaccavekkhanena,17,13,4,0,28
273889,amanasikārena,amanasikarena,22,21,1,0,13
273890,hāpetabbaṃ,hapetabbam,36,23,13,0,10
273891,vakkalittheravatthu,vakkalittheravatthu,16,10,6,0,19
273892,adhimokkhakiccaṃ,adhimokkhakiccam,7,7,0,0,16
273893,itarakiccabhedaṃ,itarakiccabhedam,12,7,5,0,16
273894,passaddhādibhāvanāya,passaddhadibhavanaya,11,8,3,0,20
273895,soṇattheravatthu,sonattheravatthu,3,2,1,0,16
273896,saddhāpaññānaṃ,saddhapannanam,29,29,0,0,14
273897,samādhivīriyānañca,samadhiviriyananca,13,13,0,0,18
273898,balavasaddho,balavasaddho,9,7,2,0,12
273899,muddhappasanno,muddhappasanno,4,4,0,0,14
273900,balavapañño,balavapanno,7,7,0,0,11
273901,mandasaddho,mandasaddho,7,7,0,0,11
273902,kerāṭikapakkhaṃ,keratikapakkham,13,8,5,0,15
273903,bhesajjasamuṭṭhito,bhesajjasamutthito,12,7,5,0,18
273904,samatāya,samataya,15,15,0,0,8
273905,vatthusmiṃyeva,vatthusmimyeva,8,8,0,0,14
273906,balavasamādhiṃ,balavasamadhim,7,7,0,0,14
273907,mandavīriyaṃ,mandaviriyam,8,8,0,0,12
273908,kosajjapakkhattā,kosajjapakkhatta,8,8,0,0,16
273909,balavavīriyaṃ,balavaviriyam,9,9,0,0,13
273910,mandasamādhiṃ,mandasamadhim,7,7,0,0,13
273911,uddhaccapakkhattā,uddhaccapakkhatta,8,8,0,0,17
273912,saṃyojito,samyojito,11,10,1,0,9
273913,ubhayasamatāya,ubhayasamataya,8,8,0,0,14
273914,samādhikammikassa,samadhikammikassa,25,25,0,0,17
273915,balavatīpi,balavatipi,8,8,0,0,10
273916,okappento,okappento,12,12,0,0,9
273917,samādhipaññāsu,samadhipannasu,15,11,4,0,14
273918,vipassanākammikassa,vipassanakammikassa,11,11,0,0,19
273919,lakkhaṇapaṭivedhaṃ,lakkhanapativedham,18,15,3,0,18
273920,samatāyapi,samatayapi,6,6,0,0,10
273921,uddhaccapakkhikānaṃ,uddhaccapakkhikanam,11,11,0,0,19
273922,saddhāvīriyapaññānaṃ,saddhaviriyapannanam,12,7,5,0,20
273923,uddhaccapātato,uddhaccapatato,16,16,0,0,14
273924,kosajjapakkhena,kosajjapakkhena,3,2,1,0,15
273925,kosajjapātato,kosajjapatato,19,19,0,0,13
273926,loṇadhūpanaṃ,lonadhupanam,14,13,1,0,12
273927,sabbabyañjanesu,sabbabyanjanesu,11,11,0,0,15
273928,sabbakammikaamacco,sabbakammikaamacco,8,8,0,0,18
273929,sabbarājakiccesu,sabbarajakiccesu,11,11,0,0,16
273930,satipaṭisaraṇaṃ,satipatisaranam,7,5,2,0,15
273931,ārakkhapaccupaṭṭhānā,arakkhapaccupatthana,29,20,9,0,20
273932,paggahaniggaho,paggahaniggaho,6,6,0,0,14
273933,nimittakosallaṃ,nimittakosallam,2,1,1,0,15
273934,pathavīkasiṇādikassa,pathavikasinadikassa,2,2,0,0,20
273935,cittekaggatānimittassa,cittekaggatanimittassa,2,2,0,0,22
273936,karaṇakosallaṃ,karanakosallam,3,3,0,0,14
273937,bhāvanākosallaṃ,bhavanakosallam,5,4,1,0,15
273938,rakkhaṇakosallañca,rakkhanakosallanca,2,2,0,0,18
273939,V1.0127,V1.0127,34,34,0,0,7
273940,atisithilavīriyatādīhi,atisithilaviriyatadihi,14,14,0,0,22
273941,passaddhisambojjhaṅgādayo,passaddhisambojjhangadayo,8,8,0,0,25
273942,abhāvetvā,abhavetva,10,9,1,0,9
273943,dhammavicayasambojjhaṅgādayo,dhammavicayasambojjhangadayo,11,10,1,0,28
273944,ujjāletukāmo,ujjaletukamo,10,10,0,0,12
273945,allāni,allani,36,36,0,0,6
273946,gomayāni,gomayani,25,25,0,0,8
273947,udakavātañca,udakavatanca,4,4,0,0,12
273948,paṃsukena,pamsukena,21,21,0,0,9
273949,okireyya,okireyya,20,20,0,0,8
273950,ujjāletunti,ujjaletunti,7,7,0,0,11
273951,passaddhisambojjhaṅgassa,passaddhisambojjhangassa,70,63,7,0,24
273952,upekkhāsambojjhaṅgassa,upekkhasambojjhangassa,79,77,2,0,22
273953,dusamuṭṭhāpayaṃ,dusamutthapayam,3,2,1,0,15
273954,dhammavicayasambojjhaṅgassa,dhammavicayasambojjhangassa,70,64,6,0,27
273955,susamuṭṭhāpayaṃ,susamutthapayam,8,8,0,0,15
273956,sukkhāni,sukkhani,41,40,1,0,8
273957,mukhavātañca,mukhavatanca,9,9,0,0,12
273958,yathāsakamāhāravasena,yathasakamaharavasena,1,1,0,0,21
273959,dhammavicayasambojjhaṅgādīnaṃ,dhammavicayasambojjhangadinam,7,7,0,0,29
273960,kaṇhasukkasappaṭibhāgā,kanhasukkasappatibhaga,35,32,3,0,22
273961,manasikārabahulīkāro,manasikarabahulikaro,8,8,0,0,20
273962,ayamāhāro,ayamaharo,98,97,1,0,9
273963,V1.0128,V1.0128,34,34,0,0,7
273964,ārambhadhātu,arambhadhatu,25,18,7,0,12
273965,nikkamadhātu,nikkamadhatu,25,20,5,0,12
273966,parakkamadhātu,parakkamadhatu,26,21,5,0,14
273967,pītisambojjhaṅgaṭṭhāniyā,pitisambojjhangatthaniya,5,2,3,0,24
273968,sabhāvasāmaññalakkhaṇapaṭivedhavasena,sabhavasamannalakkhanapativedhavasena,2,2,0,0,37
273969,pavattamanasikāro,pavattamanasikaro,11,11,0,0,17
273970,ārambhadhātuādīnaṃ,arambhadhatuadinam,2,2,0,0,18
273971,ārambhadhātuādīsu,arambhadhatuadisu,6,6,0,0,17
273972,ārambhadhātūti,arambhadhatuti,7,0,7,0,14
273973,paṭhamavīriyaṃ,pathamaviriyam,3,2,1,0,14
273974,nikkamadhātūti,nikkamadhatuti,6,0,6,0,14
273975,kosajjato,kosajjato,20,14,6,0,9
273976,parakkamadhātūti,parakkamadhatuti,5,0,5,0,16
273977,akkamanato,akkamanato,15,11,4,0,10
273978,uppādakamanasikārova,uppadakamanasikarova,1,1,0,0,20
273979,paripucchakatā,paripucchakata,27,27,0,0,14
273980,indriyasamattapaṭipādanā,indriyasamattapatipadana,24,18,6,0,24
273981,duppaññapuggalaparivajjanā,duppannapuggalaparivajjana,18,12,6,0,26
273982,gambhīrañāṇacariyapaccavekkhaṇā,gambhirananacariyapaccavekkhana,15,9,6,0,31
273983,tadadhimuttatāti,tadadhimuttatati,69,66,3,0,16
273984,ekādasadhammā,ekadasadhamma,3,3,0,0,13
273985,apāyādibhayapaccavekkhaṇatā,apayadibhayapaccavekkhanata,2,2,0,0,27
273986,vīriyāyattalokiyalokuttaravisesādhigamānisaṃsadassitā,viriyayattalokiyalokuttaravisesadhigamanisamsadassita,2,2,0,0,53
273987,buddhapaccekabuddhamahāsāvakehi,buddhapaccekabuddhamahasavakehi,1,1,0,0,31
273988,gatamaggo,gatamaggo,62,60,2,0,9
273989,kusītena,kusitena,40,39,1,0,8
273990,gamanavīthipaccavekkhaṇatā,gamanavithipaccavekkhanata,7,7,0,0,26
273991,piṇḍāpacāyanatā,pindapacayanata,2,2,0,0,15
273992,vīriyārambhassa,viriyarambhassa,44,43,1,0,15
273993,anatikkamanīyasāsano,anatikkamaniyasasano,2,2,0,0,20
273994,mahattapaccavekkhaṇatā,mahattapaccavekkhanata,2,2,0,0,22
273995,mahādāyajjaṃ,mahadayajjam,2,2,0,0,12
273996,dāyajjamahattapaccavekkhaṇatā,dayajjamahattapaccavekkhanata,7,7,0,0,29
273997,ālokasaññāmanasikārairiyāpathaparivattanaabbhokāsasevanādīhi,alokasannamanasikarairiyapathaparivattanaabbhokasasevanadihi,2,2,0,0,60
273998,V1.0129,V1.0129,34,34,0,0,7
273999,thinamiddhavinodanatā,thinamiddhavinodanata,6,6,0,0,21
274000,kusītapuggalaparivajjanatā,kusitapuggalaparivajjanata,8,8,0,0,26
274001,āraddhavīriyapuggalasevanatā,araddhaviriyapuggalasevanata,8,8,0,0,28
274002,sammappadhānapaccavekkhaṇatā,sammappadhanapaccavekkhanata,2,2,0,0,28
274003,lūkhapuggalaparivajjanatā,lukhapuggalaparivajjanata,9,9,0,0,25
274004,siniddhapuggalasevanatā,siniddhapuggalasevanata,9,9,0,0,23
274005,pasādaniyasuttantapaccavekkhaṇatā,pasadaniyasuttantapaccavekkhanata,1,1,0,0,33
274006,accāraddhavīriyatādīhi,accaraddhaviriyatadihi,12,12,0,0,22
274007,nibbāpetukāmo,nibbapetukamo,11,11,0,0,13
274008,nibbāpetunti,nibbapetunti,8,8,0,0,12
274009,duvūpasamayaṃ,duvupasamayam,6,5,1,0,13
274010,samādhisambojjhaṅgassa,samadhisambojjhangassa,59,56,3,0,22
274011,suvūpasamayaṃ,suvupasamayam,8,8,0,0,13
274012,V1.0130,V1.0130,34,34,0,0,7
274013,āhāravasena,aharavasena,22,22,0,0,11
274014,passaddhisambojjhaṅgādīnaṃ,passaddhisambojjhangadinam,7,7,0,0,26
274015,samathanimittaṃ,samathanimittam,74,57,17,0,15
274016,abyagganimittaṃ,abyagganimittam,13,8,5,0,15
274017,upekkhāsambojjhaṅgaṭṭhāniyā,upekkhasambojjhangatthaniya,1,1,0,0,27
274018,passaddhiādayo,passaddhiadayo,6,6,0,0,14
274019,pavattamanasikārova,pavattamanasikarova,2,2,0,0,19
274020,samathassevetamadhivacanaṃ,samathassevetamadhivacanam,2,1,1,0,26
274021,avikkhepaṭṭhena,avikkhepatthena,115,108,7,0,15
274022,paṇītabhojanasevanatā,panitabhojanasevanata,10,9,1,0,21
274023,utusukhasevanatā,utusukhasevanata,8,8,0,0,16
274024,iriyāpathasukhasevanatā,iriyapathasukhasevanata,8,8,0,0,23
274025,majjhattapayogatā,majjhattapayogata,11,7,4,0,17
274026,sāraddhakāyapuggalaparivajjanatā,saraddhakayapuggalaparivajjanata,9,9,0,0,32
274027,passaddhakāyapuggalasevanatā,passaddhakayapuggalasevanata,7,7,0,0,28
274028,vatthuvisadatā,vatthuvisadata,2,2,0,0,14
274029,nimittakusalatā,nimittakusalata,26,14,12,0,15
274030,indriyasamattapaṭipādanatā,indriyasamattapatipadanata,16,8,8,0,26
274031,niggahaṇatā,niggahanata,3,3,0,0,11
274032,paggahaṇatā,paggahanata,3,3,0,0,11
274033,V1.0131,V1.0131,34,34,0,0,7
274034,nirassādassa,nirassadassa,2,2,0,0,12
274035,saddhāsaṃvegavasena,saddhasamvegavasena,2,2,0,0,19
274036,sampahaṃsanatā,sampahamsanata,11,11,0,0,14
274037,sammāpavattassa,sammapavattassa,1,1,0,0,15
274038,ajjhupekkhanatā,ajjhupekkhanata,17,12,5,0,15
274039,asamāhitapuggalaparivajjanatā,asamahitapuggalaparivajjanata,13,7,6,0,29
274040,samāhitapuggalasevanatā,samahitapuggalasevanata,12,7,5,0,23
274041,jhānavimokkhapaccavekkhaṇatā,jhanavimokkhapaccavekkhanata,7,7,0,0,28
274042,sattamajjhattatā,sattamajjhattata,16,9,7,0,16
274043,saṅkhāramajjhattatā,sankharamajjhattata,12,8,4,0,19
274044,sattasaṅkhārakelāyanapuggalaparivajjanatā,sattasankharakelayanapuggalaparivajjanata,10,7,3,0,41
274045,sattasaṅkhāramajjhattapuggalasevanatā,sattasankharamajjhattapuggalasevanata,7,7,0,0,37
274046,imehākārehi,imehakarehi,6,6,0,0,11
274047,paññāpayogamandatāya,pannapayogamandataya,12,12,0,0,20
274048,upasamasukhānadhigamena,upasamasukhanadhigamena,8,8,0,0,23
274049,nirassādaṃ,nirassadam,34,27,7,0,10
274050,aṭṭhasaṃvegavatthupaccavekkhaṇena,atthasamvegavatthupaccavekkhanena,10,10,0,0,33
274051,saṃvejeti,samvejeti,16,16,0,0,9
274052,jātijarābyādhimaraṇāni,jatijarabyadhimaranani,16,15,1,0,22
274053,vaṭṭamūlakaṃ,vattamulakam,33,33,0,0,12
274054,āhārapariyeṭṭhimūlakaṃ,aharapariyetthimulakam,13,13,0,0,22
274055,anuddhataṃ,anuddhatam,28,20,8,0,10
274056,anirassādaṃ,anirassadam,18,10,8,0,11
274057,samappavattaṃ,samappavattam,25,18,7,0,13
274058,samathavīthipaṭipannaṃ,samathavithipatipannam,14,11,3,0,22
274059,paggahaniggahasampahaṃsanesu,paggahaniggahasampahamsanesu,24,24,0,0,28
274060,samappavattesu,samappavattesu,20,20,0,0,14
274061,nekkhammapaṭipadaṃ,nekkhammapatipadam,8,6,2,0,18
274062,anāruḷhapubbānaṃ,anarulhapubbanam,2,2,0,0,16
274063,anekakiccapasutānaṃ,anekakiccapasutanam,1,1,0,0,19
274064,vikkhittahadayānaṃ,vikkhittahadayanam,2,2,0,0,18
274065,paṭipannānaṃ,patipannanam,21,17,4,0,12
274066,samādhilābhīnaṃ,samadhilabhinam,2,2,0,0,15
274067,upasaṅkamanaṃ,upasankamanam,54,51,3,0,13
274068,tadadhimuttatā,tadadhimuttata,32,18,14,0,14
274069,samādhiadhimuttatā,samadhiadhimuttata,2,2,0,0,18
274070,samādhigarusamādhininnasamādhipoṇasamādhipabbhāratāti,samadhigarusamadhininnasamadhiponasamadhipabbharatati,2,2,0,0,53
274071,V1.0132,V1.0132,34,34,0,0,7
274072,sampādayato,sampadayato,7,7,0,0,11
274073,nimittasmiṃ,nimittasmim,9,8,1,0,11
274074,adhigacche,adhigacche,22,21,1,0,10
274075,parittampi,parittampi,10,10,0,0,10
274076,cittappavattiākāraṃ,cittappavattiakaram,5,3,2,0,19
274077,sallakkhayaṃ,sallakkhayam,6,4,2,0,12
274078,vīriyasseva,viriyasseva,9,6,3,0,11
274079,yojayetha,yojayetha,5,3,2,0,9
274080,paggaṇhetheva,pagganhetheva,5,3,2,0,13
274081,accāraddhaṃ,accaraddham,12,6,6,0,11
274082,samameva,samameva,36,32,4,0,8
274083,pavattaye,pavattaye,5,3,2,0,9
274084,uppaladale,uppaladale,4,4,0,0,10
274085,madhukarādīnaṃ,madhukaradinam,6,6,0,0,14
274086,sammavaṇṇitā,sammavannita,4,3,1,0,12
274087,līnauddhatabhāvehi,linauddhatabhavehi,3,3,0,0,18
274088,mocayitvāna,mocayitvana,9,9,0,0,11
274089,nimittābhimukhaṃ,nimittabhimukham,10,8,2,0,16
274090,paṭipādayeti,patipadayeti,2,2,0,0,12
274091,nimittābhimukhapaṭipādanaṃ,nimittabhimukhapatipadanam,1,1,0,0,26
274092,tatrāyamatthadīpanā,tatrayamatthadipana,2,2,0,0,19
274093,pupphitanti,pupphitanti,2,2,0,0,11
274094,pakkhando,pakkhando,36,36,0,0,9
274095,paṭinivattento,patinivattento,10,10,0,0,14
274096,khīṇeyeva,khineyeva,2,2,0,0,9
274097,puppharāsiṃ,puppharasim,3,2,1,0,11
274098,reṇuṃ,renum,26,25,1,0,5
274099,madhurasamanubhavati,madhurasamanubhavati,1,1,0,0,20
274100,V1.0133,V1.0133,34,34,0,0,7
274101,sallakattaantevāsikesu,sallakattaantevasikesu,2,2,0,0,22
274102,udakathālagate,udakathalagate,2,2,0,0,14
274103,uppalapatte,uppalapatte,3,3,0,0,11
274104,satthakammaṃ,satthakammam,33,27,6,0,12
274105,sikkhantesu,sikkhantesu,3,3,0,0,11
274106,uppalapattaṃ,uppalapattam,4,4,0,0,12
274107,chijjanapavesanabhayā,chijjanapavesanabhaya,2,2,0,0,21
274108,satthakena,satthakena,37,37,0,0,10
274109,phusitumpi,phusitumpi,8,7,1,0,10
274110,visahati,visahati,16,16,0,0,8
274111,satthapahāraṃ,satthapaharam,1,1,0,0,13
274112,pariyodātasippo,pariyodatasippo,6,6,0,0,15
274113,tathārūpesu,tatharupesu,50,41,9,0,11
274114,catubyāmappamāṇaṃ,catubyamappamanam,2,2,0,0,17
274115,makkaṭasuttamāharati,makkatasuttamaharati,1,1,0,0,20
274116,achekapuriso,achekapuriso,2,2,0,0,12
274117,makkaṭasuttamākaḍḍhanto,makkatasuttamakaddhanto,1,1,0,0,23
274118,chindatiyeva,chindatiyeva,2,2,0,0,12
274119,chedanabhayā,chedanabhaya,2,2,0,0,12
274120,vedhetvā,vedhetva,4,4,0,0,8
274121,balavavāte,balavavate,5,5,0,0,10
274122,laṅkāraṃ,lankaram,6,5,1,0,8
274123,pakkhandāpeti,pakkhandapeti,2,2,0,0,13
274124,mandavāte,mandavate,4,4,0,0,9
274125,oropento,oropento,2,2,0,0,8
274126,aḍḍhalaṅkāraṃ,addhalankaram,2,2,0,0,13
274127,sotthinā,sotthina,134,133,1,0,8
274128,achaḍḍento,achaddento,5,4,1,0,10
274129,lābhaluddho,labhaluddho,2,2,0,0,11
274130,telachaḍḍanabhayā,telachaddanabhaya,2,2,0,0,17
274131,āsiñcitumpi,asincitumpi,2,2,0,0,11
274132,pāpuṇissāmīti,papunissamiti,8,8,0,0,13
274133,accāraddhavīriyattā,accaraddhaviriyatta,3,3,0,0,19
274134,accāraddhavīriyatāya,accaraddhaviriyataya,12,12,0,0,20
274135,appanāyāti,appanayati,3,2,1,0,10
274136,atilīnavīriyattā,atilinaviriyatta,2,2,0,0,16
274137,līnabhāvato,linabhavato,2,2,0,0,11
274138,uddhaccato,uddhaccato,5,5,0,0,10
274139,V1.0134,V1.0134,34,34,0,0,7
274140,paṭhamajjhānakathā,pathamajjhanakatha,6,6,0,0,18
274141,paṭipādayato,patipadayato,4,3,1,0,12
274142,ijjhissatīti,ijjhissatiti,2,1,1,0,12
274143,manodvārāvajjanamuppajjati,manodvaravajjanamuppajjati,1,1,0,0,26
274144,tasmiṃyevārammaṇe,tasmimyevarammane,8,8,0,0,17
274145,kāmāvacarāni,kamavacarani,41,40,1,0,12
274146,pakaticittehi,pakaticittehi,1,1,0,0,13
274147,balavataravitakkavicārapītisukhacittekaggatāni,balavataravitakkavicarapitisukhacittekaggatani,1,1,0,0,46
274148,parikammattā,parikammatta,6,6,0,0,12
274149,parikammānī,parikammani,2,0,2,0,11
274150,āsannapadeso,asannapadeso,1,1,0,0,12
274151,nagarūpacāroti,nagarupacaroti,1,1,0,0,14
274152,samīpacārattā,samipacaratta,1,1,0,0,13
274153,upacārānī,upacarani,2,0,2,0,9
274154,parikammānaṃ,parikammanam,8,7,1,0,12
274155,anulomānī,anulomani,4,2,2,0,9
274156,sabbantimaṃ,sabbantimam,10,8,2,0,11
274157,parittagottābhibhavanato,parittagottabhibhavanato,2,2,0,0,24
274158,mahaggatagottabhāvanato,mahaggatagottabhavanato,2,2,0,0,23
274159,agahitaggahaṇena,agahitaggahanena,7,7,0,0,16
274160,appanācittaṃ,appanacittam,19,15,4,0,12
274161,catutthameva,catutthameva,7,5,2,0,12
274162,khippābhiññadandhābhiññavasena,khippabhinnadandhabhinnavasena,2,2,0,0,30
274163,ābhidhammikagodattatthero,abhidhammikagodattatthero,6,3,3,0,25
274164,matimattaṃ,matimattam,64,64,0,0,10
274165,therassetaṃ,therassetam,3,3,0,0,11
274166,catutthapañcamesuyeva,catutthapancamesuyeva,3,3,0,0,21
274167,chinnapapātābhimukho,chinnapapatabhimukho,2,2,0,0,20
274168,ṭhātukāmopi,thatukamopi,6,6,0,0,11
274169,V1.0135,V1.0135,34,34,0,0,7
274170,ekacittakkhaṇikāyeva,ekacittakkhanikayeva,5,5,0,0,20
274171,paṭhamappanāyaṃ,pathamappanayam,2,2,0,0,15
274172,lokiyābhiññāsu,lokiyabhinnasu,10,10,0,0,14
274173,maggānantaraphale,magganantaraphale,2,2,0,0,17
274174,rūpārūpabhavesu,ruparupabhavesu,76,73,3,0,15
274175,bhavaṅgajjhāne,bhavangajjhane,1,1,0,0,14
274176,nevasaññānāsaññāyatane,nevasannanasannayatane,66,65,1,0,22
274177,phalasamāpattiyanti,phalasamapattiyanti,2,2,0,0,19
274178,maggānantaraphalaṃ,magganantaraphalam,4,3,1,0,18
274179,dvinnamupari,dvinnamupari,1,1,0,0,12
274180,rūpārūpesu,ruparupesu,13,12,1,0,10
274181,vocchinditvā,vocchinditva,4,4,0,0,12
274182,jhānapaccavekkhaṇatthāya,jhanapaccavekkhanatthaya,1,1,0,0,24
274183,jhānapaccavekkhaṇanti,jhanapaccavekkhananti,2,2,0,0,21
274184,evamanena,evamanena,7,7,0,0,9
274185,pañcaṅgavippahīnaṃ,pancangavippahinam,16,10,6,0,18
274186,dasalakkhaṇasampannaṃ,dasalakkhanasampannam,21,17,4,0,21
274187,kāmehīti,kamehiti,32,18,14,0,8
274188,panāyamettha,panayamettha,8,8,0,0,12
274189,niyamatthoti,niyamatthoti,6,5,1,0,12
274190,viharaṇasamaye,viharanasamaye,8,8,0,0,14
274191,paṭhamajjhānassa,pathamajjhanassa,49,48,1,0,16
274192,paṭipakkhabhāvaṃ,patipakkhabhavam,7,7,0,0,16
274193,kāmapariccāgeneva,kamapariccageneva,5,5,0,0,17
274194,adhigamaṃ,adhigamam,27,26,1,0,9
274195,kāmehī,kamehi,45,45,0,0,6
274196,paṭipakkhabhūtā,patipakkhabhuta,23,23,0,0,15
274197,padīpobhāso,padipobhaso,5,4,1,0,11
274198,pariccāgeneva,pariccageneva,6,6,0,0,13
274199,orimatīrapariccāgena,orimatirapariccagena,5,5,0,0,20
274200,pārimatīrasseva,parimatirasseva,4,4,0,0,15
274201,pubbapadeyeva,pubbapadeyeva,8,8,0,0,13
274202,aviviccāpi,aviviccapi,6,6,0,0,10
274203,vihareyyāti,vihareyyati,58,52,6,0,11
274204,taṃnissaraṇato,tamnissaranato,5,5,0,0,14
274205,kāmadhātusamatikkamanato,kamadhatusamatikkamanato,6,6,0,0,24
274206,kāmarāgapaṭipakkhato,kamaragapatipakkhato,5,5,0,0,20
274207,kāmānameva,kamanameva,54,49,5,0,10
274208,kāmānametaṃ,kamanametam,54,50,4,0,11
274209,uttarapadepi,uttarapadepi,8,8,0,0,12
274210,V1.0136,V1.0136,34,34,0,0,7
274211,nīvaraṇasaṅkhātehi,nivaranasankhatehi,6,6,0,0,18
274212,avivicca,avivicca,5,5,0,0,8
274213,padadvayepi,padadvayepi,29,28,1,0,11
274214,viviccāti,viviccati,12,9,3,0,9
274215,sādhāraṇavacanena,sadharanavacanena,9,9,0,0,17
274216,tadaṅgavivekādayo,tadangavivekadayo,7,4,3,0,17
274217,vivekā,viveka,67,56,11,0,6
274218,kāyaviveko,kayaviveko,73,62,11,0,10
274219,cittaviveko,cittaviveko,65,57,8,0,11
274220,vikkhambhanavivekoti,vikkhambhanavivekoti,5,3,2,0,20
274221,saṅkapparāgo,sankapparago,27,25,2,0,12
274222,kilesakāmā,kilesakama,90,85,5,0,10
274223,saṅgahitāicceva,sangahitaicceva,2,2,0,0,15
274224,vatthukāmehipi,vatthukamehipi,8,8,0,0,14
274225,viviccevāti,viviccevati,7,5,2,0,11
274226,kilesakāmehi,kilesakamehi,41,38,3,0,12
274227,sabbākusalehi,sabbakusalehi,12,12,0,0,13
274228,vatthukāmehi,vatthukamehi,25,25,0,0,12
274229,vivekavacanato,vivekavacanato,13,10,3,0,14
274230,kāmasukhapariccāgo,kamasukhapariccago,5,5,0,0,18
274231,nekkhammasukhapariggaho,nekkhammasukhapariggaho,5,5,0,0,23
274232,vatthukāmakilesakāmavivekavacanatoyeva,vatthukamakilesakamavivekavacanatoyeva,5,5,0,0,38
274233,saṃkilesavatthuppahānaṃ,samkilesavatthuppahanam,7,5,2,0,23
274234,saṃkilesappahānaṃ,samkilesappahanam,13,13,0,0,17
274235,lolabhāvassa,lolabhavassa,5,5,0,0,12
274236,hetupariccāgo,hetupariccago,5,5,0,0,13
274237,bālabhāvassa,balabhavassa,12,11,1,0,12
274238,payogasuddhi,payogasuddhi,15,13,2,0,12
274239,āsayaposanaṃ,asayaposanam,11,5,6,0,12
274240,vuttakāmesu,vuttakamesu,5,5,0,0,11
274241,vatthukāmapakkhe,vatthukamapakkhe,8,8,0,0,16
274242,kilesakāmapakkhe,kilesakamapakkhe,8,8,0,0,16
274243,anekabhedo,anekabhedo,7,7,0,0,10
274244,kāmacchandoyeva,kamacchandoyeva,3,3,0,0,15
274245,akusalapariyāpannopi,akusalapariyapannopi,5,5,0,0,20
274246,jhānapaṭipakkhato,jhanapatipakkhato,4,4,0,0,17
274247,kilesakāmattā,kilesakamatta,7,7,0,0,13
274248,purimapade,purimapade,47,46,1,0,10
274249,akusalapariyāpannattā,akusalapariyapannatta,5,5,0,0,21
274250,anekabhedato,anekabhedato,12,10,2,0,12
274251,kāmatoti,kamatoti,7,4,3,0,8
274252,akusalabhāve,akusalabhave,6,6,0,0,12
274253,V1.0137,V1.0137,34,34,0,0,7
274254,paccanīkapaṭipakkhabhāvadassanato,paccanikapatipakkhabhavadassanato,3,3,0,0,33
274255,nīvaraṇāneva,nivarananeva,8,8,0,0,12
274256,jhānaṅgapaccanīkāni,jhanangapaccanikani,7,6,1,0,19
274257,jhānaṅgāneva,jhananganeva,9,9,0,0,12
274258,paṭipakkhāni,patipakkhani,5,5,0,0,12
274259,viddhaṃsakāni,viddhamsakani,4,4,0,0,13
274260,vighātakānīti,vighatakaniti,3,3,0,0,13
274261,uddhaccakukkuccassa,uddhaccakukkuccassa,82,77,5,0,19
274262,vicikicchāyāti,vicikicchayati,4,1,3,0,14
274263,vikkhambhanaviveko,vikkhambhanaviveko,28,27,1,0,18
274264,sesanīvaraṇānaṃ,sesanivarananam,5,5,0,0,15
274265,pañcakāmaguṇabhedavisayassa,pancakamagunabhedavisayassa,5,5,0,0,27
274266,āghātavatthubhedādivisayānaṃ,aghatavatthubhedadivisayanam,7,5,2,0,28
274267,dosamohānaṃ,dosamohanam,13,13,0,0,11
274268,oghādīsu,oghadisu,5,5,0,0,8
274269,kāmoghakāmayogakāmāsavakāmupādānaabhijjhākāyaganthakāmarāgasaṃyojanānaṃ,kamoghakamayogakamasavakamupadanaabhijjhakayaganthakamaragasamyojananam,4,4,0,0,71
274270,avasesaoghayogāsavaupādānaganthasaṃyojanānaṃ,avasesaoghayogasavaupadanaganthasamyojananam,5,5,0,0,44
274271,lobhasampayuttānaṃ,lobhasampayuttanam,1,1,0,0,18
274272,akusalacittuppādānaṃ,akusalacittuppadanam,7,7,0,0,20
274273,pahānaṅgaṃ,pahanangam,25,22,3,0,10
274274,sampayogaṅgaṃ,sampayogangam,7,7,0,0,13
274275,savicārantiādi,savicarantiadi,1,1,0,0,14
274276,abhiniropanalakkhaṇo,abhiniropanalakkhano,18,16,2,0,20
274277,āhananapariyāhananaraso,ahananapariyahananaraso,9,7,2,0,23
274278,vitakkapariyāhataṃ,vitakkapariyahatam,8,8,0,0,18
274279,ānayanapaccupaṭṭhāno,anayanapaccupatthano,8,7,1,0,20
274280,anusañcaraṇanti,anusancarananti,6,6,0,0,15
274281,sahajātānuyojanaraso,sahajatanuyojanaraso,5,5,0,0,20
274282,anuppabandhanapaccupaṭṭhāno,anuppabandhanapaccupatthano,3,3,0,0,27
274283,oḷārikaṭṭhena,olarikatthena,11,10,1,0,13
274284,pubbaṅgamaṭṭhena,pubbangamatthena,21,19,2,0,16
274285,paṭhamābhinipāto,pathamabhinipato,31,29,2,0,16
274286,anumajjanasabhāvena,anumajjanasabhavena,4,4,0,0,19
274287,V1.0138,V1.0138,34,34,0,0,7
274288,anuppabandho,anuppabandho,9,9,0,0,12
274289,vipphāravā,vippharava,9,9,0,0,10
274290,paṭhamuppattikāle,pathamuppattikale,6,6,0,0,17
274291,paripphandanabhūto,paripphandanabhuto,5,5,0,0,18
274292,uppatitukāmassa,uppatitukamassa,7,7,0,0,15
274293,pakkhavikkhepo,pakkhavikkhepo,8,8,0,0,14
274294,padumābhimukhapāto,padumabhimukhapato,7,7,0,0,18
274295,gandhānubandhacetaso,gandhanubandhacetaso,5,5,0,0,20
274296,nātiparipphandanabhāvo,natiparipphandanabhavo,5,5,0,0,22
274297,pakkhappasāraṇaṃ,pakkhappasaranam,7,7,0,0,16
274298,paribbhamanaṃ,paribbhamanam,18,16,2,0,13
274299,padumābhimukhapatitassa,padumabhimukhapatitassa,7,7,0,0,23
274300,dukanipātaṭṭhakathāyaṃ,dukanipatatthakathayam,6,4,2,0,22
274301,mahāsakuṇassa,mahasakunassa,6,6,0,0,13
274302,sannisīdāpetvā,sannisidapetva,8,8,0,0,14
274303,abhiniropanabhāvena,abhiniropanabhavena,7,7,0,0,19
274304,vātaggahaṇatthaṃ,vataggahanattham,6,6,0,0,16
274305,phandāpayamānassa,phandapayamanassa,6,6,0,0,17
274306,anumajjanabhāvena,anumajjanabhavena,5,5,0,0,17
274307,anuppabandhena,anuppabandhena,11,9,2,0,14
274308,paṭhamadutiyajjhānesu,pathamadutiyajjhanesu,8,7,1,0,21
274309,malaggahitaṃ,malaggahitam,14,13,1,0,12
274310,kaṃsabhājanaṃ,kamsabhajanam,6,6,0,0,13
274311,cuṇṇatelavālaṇḍupakena,cunnatelavalandupakena,4,4,0,0,22
274312,daḷhagahaṇahattho,dalhagahanahattho,1,1,0,0,17
274313,parimajjanahattho,parimajjanahattho,8,8,0,0,17
274314,daṇḍappahārena,dandappaharena,5,5,0,0,14
274315,bhamayitvā,bhamayitva,5,5,0,0,10
274316,uppīḷanahattho,uppilanahattho,6,6,0,0,14
274317,sañcaraṇahattho,sancaranahattho,7,6,1,0,15
274318,ṭhitakaṇṭako,thitakantako,6,6,0,0,12
274319,abhiniropano,abhiniropano,5,5,0,0,12
274320,paribbhamanakaṇṭako,paribbhamanakantako,4,4,0,0,19
274321,anumajjano,anumajjano,3,3,0,0,10
274322,vicārena,vicarena,39,38,1,0,8
274323,nīvaraṇavigamoti,nivaranavigamoti,6,6,0,0,16
274324,vivittoti,vivittoti,8,6,2,0,9
274325,nīvaraṇavivitto,nivaranavivitto,6,6,0,0,15
274326,jhānasampayuttadhammarāsīti,jhanasampayuttadhammarasiti,6,6,0,0,27
274327,pīṇayatīti,pinayatiti,7,4,3,0,10
274328,sampiyāyanalakkhaṇā,sampiyayanalakkhana,10,10,0,0,19
274329,kāyacittapīnanarasā,kayacittapinanarasa,2,2,0,0,19
274330,pharaṇarasā,pharanarasa,7,6,1,0,11
274331,odagyapaccupaṭṭhānā,odagyapaccupatthana,10,8,2,0,19
274332,khuddikāpīti,khuddikapiti,5,4,1,0,12
274333,lomahaṃsamattameva,lomahamsamattameva,3,3,0,0,18
274334,V1.0139,V1.0139,34,34,0,0,7
274335,laṅghāpanappamāṇappattā,langhapanappamanappatta,5,5,0,0,23
274336,puṇṇavallikavāsī,punnavallikavasi,2,2,0,0,16
274337,puṇṇamadivase,punnamadivase,18,18,0,0,13
274338,candālokaṃ,candalokam,7,6,1,0,10
274339,mahācetiyābhimukho,mahacetiyabhimukho,4,4,0,0,18
274340,diṭṭhārammaṇavasena,dittharammanavasena,2,2,0,0,19
274341,ubbegāpītiṃ,ubbegapitim,1,1,0,0,11
274342,sudhātale,sudhatale,2,2,0,0,9
274343,pahaṭacitrageṇḍuko,pahatacitragenduko,2,2,0,0,18
274344,mahācetiyaṅgaṇeyeva,mahacetiyanganeyeva,2,2,0,0,19
274345,girikaṇḍakavihārassa,girikandakaviharassa,2,2,0,0,20
274346,vattakālakagāme,vattakalakagame,2,2,0,0,15
274347,kuladhītā,kuladhita,26,25,1,0,9
274348,balavabuddhārammaṇāya,balavabuddharammanaya,2,2,0,0,21
274349,ubbegāpītiyā,ubbegapitiya,1,1,0,0,12
274350,garubhārā,garubhara,8,8,0,0,9
274351,vicarituṃ,vicaritum,36,34,2,0,9
274352,ohīyitvā,ohiyitva,10,9,1,0,8
274353,gharājire,gharajire,1,1,0,0,9
274354,candālokena,candalokena,13,13,0,0,11
274355,girikaṇḍake,girikandake,2,2,0,0,11
274356,ākāsacetiyaṅgaṇaṃ,akasacetiyanganam,2,2,0,0,17
274357,dīpapūjaṃ,dipapujam,12,12,0,0,9
274358,cetiyapūjaṃ,cetiyapujam,9,9,0,0,11
274359,dhaññāvatime,dhannavatime,1,1,0,0,12
274360,anusañcarituṃ,anusancaritum,3,3,0,0,13
274361,evarūpañca,evarupanca,11,11,0,0,10
274362,madhuradhammakathaṃ,madhuradhammakatham,18,18,0,0,19
274363,muttarāsisadisaṃ,muttarasisadisam,3,3,0,0,16
274364,passantiyā,passantiya,34,33,1,0,10
274365,purimataraṃyeva,purimataramyeva,2,2,0,0,15
274366,āgatāsī,agatasi,20,20,0,0,7
274367,āgatāmhi,agatamhi,5,5,0,0,8
274368,maggenā,maggena,12,7,5,0,7
274369,ālokentiyā,alokentiya,1,1,0,0,10
274370,buddhārammaṇā,buddharammana,4,4,0,0,13
274371,balavapīti,balavapiti,19,18,1,0,10
274372,nisinnabhāvaṃ,nisinnabhavam,24,24,0,0,13
274373,gahitanimitteneva,gahitanimitteneva,5,5,0,0,17
274374,patiṭṭhitāmhī,patitthitamhi,2,2,0,0,13
274375,anuparipphuṭaṃ,anuparipphutam,5,4,1,0,14
274376,V1.0140,V1.0140,34,34,0,0,7
274377,passaddhiṃ,passaddhim,8,8,0,0,10
274378,kāyapassaddhiñca,kayapassaddhinca,4,4,0,0,16
274379,cittapassaddhiñca,cittapassaddhinca,4,4,0,0,17
274380,kāyikañca,kayikanca,20,19,1,0,9
274381,khaṇikasamādhiṃ,khanikasamadhim,8,8,0,0,15
274382,samādhinti,samadhinti,6,5,1,0,10
274383,appanāsamādhissa,appanasamadhissa,13,13,0,0,16
274384,samādhisampayogaṃ,samadhisampayogam,4,3,1,0,17
274385,pharaṇāpīti,pharanapiti,7,7,0,0,11
274386,kāyacittābādhanti,kayacittabadhanti,9,9,0,0,17
274387,sātalakkhaṇaṃ,satalakkhanam,18,15,3,0,13
274388,upabrūhanarasaṃ,upabruhanarasam,8,6,2,0,15
274389,anuggahapaccupaṭṭhānaṃ,anuggahapaccupatthanam,2,2,0,0,22
274390,iṭṭhārammaṇapaṭilābhatuṭṭhi,ittharammanapatilabhatutthi,6,6,0,0,27
274391,paṭiladdharasānubhavanaṃ,patiladdharasanubhavanam,9,7,2,0,24
274392,saṅkhārakkhandhasaṅgahitā,sankharakkhandhasangahita,9,9,0,0,25
274393,vedanākkhandhasaṅgahitaṃ,vedanakkhandhasangahitam,6,6,0,0,24
274394,kantārakhinnassa,kantarakhinnassa,7,7,0,0,16
274395,vanantudakadassanasavanesu,vanantudakadassanasavanesu,2,2,0,0,26
274396,vanacchāyāpavesanaudakaparibhogesu,vanacchayapavesanaudakaparibhogesu,4,4,0,0,34
274397,pākaṭabhāvato,pakatabhavato,35,35,0,0,13
274398,dhammavinayādayo,dhammavinayadayo,6,6,0,0,16
274399,pītisukhamassa,pitisukhamassa,3,3,0,0,14
274400,vivekajaṃpītisukhaṃ,vivekajampitisukham,8,6,2,0,19
274401,pītisukhampettha,pitisukhampettha,4,4,0,0,16
274402,vivekajameva,vivekajameva,6,6,0,0,12
274403,ekapadeneva,ekapadeneva,25,24,1,0,11
274404,upasampajjāti,upasampajjati,22,3,19,0,13
274405,upasampādayitvā,upasampadayitva,7,5,2,0,15
274406,nipphādetvāti,nipphadetvati,5,5,0,0,13
274407,evamevattho,evamevattho,3,3,0,0,11
274408,iriyāpathavihārena,iriyapathaviharena,25,25,0,0,18
274409,itivuttappakārajhānasamaṅgī,itivuttappakarajhanasamangi,2,2,0,0,27
274410,iriyaṃ,iriyam,37,26,11,0,6
274411,yapanaṃ,yapanam,3,3,0,0,7
274412,cāraṃ,caram,7,6,1,0,5
274413,abhinipphādeti,abhinipphadeti,25,24,1,0,14
274414,V1.0141,V1.0141,34,34,0,0,7
274415,yapeti,yapeti,55,49,6,0,6
274416,pañcaṅgavippahīnādi,pancangavippahinadi,1,1,0,0,19
274417,pañcaṅgavippahīnatā,pancangavippahinata,6,6,0,0,19
274418,appahīnesu,appahinesu,9,9,0,0,10
274419,tenassetāni,tenassetani,4,4,0,0,11
274420,pahānaṅgānīti,pahananganiti,8,7,1,0,13
274421,jhānakkhaṇe,jhanakkhane,36,35,1,0,11
274422,etāneva,etaneva,31,29,2,0,7
274423,jhānantarāyakarāni,jhanantarayakarani,3,3,0,0,18
274424,kāmacchandena,kamacchandena,21,19,2,0,13
274425,nānāvisayappalobhitaṃ,nanavisayappalobhitam,2,2,0,0,21
274426,ekattārammaṇe,ekattarammane,19,19,0,0,13
274427,kāmacchandābhibhūtaṃ,kamacchandabhibhutam,4,4,0,0,20
274428,kāmadhātuppahānāya,kamadhatuppahanaya,3,3,0,0,18
274429,byāpādena,byapadena,47,46,1,0,9
274430,cārammaṇe,carammane,2,2,0,0,9
274431,paṭihaññamānaṃ,patihannamanam,4,4,0,0,14
274432,thinamiddhābhibhūtaṃ,thinamiddhabhibhutam,7,7,0,0,20
274433,akammaññaṃ,akammannam,12,11,1,0,10
274434,uddhaccakukkuccaparetaṃ,uddhaccakukkuccaparetam,5,4,1,0,23
274435,avūpasantameva,avupasantameva,4,4,0,0,14
274436,jhānādhigamasādhikaṃ,jhanadhigamasadhikam,3,3,0,0,20
274437,nārohati,narohati,26,20,6,0,8
274438,jhānantarāyakarattā,jhanantarayakaratta,4,4,0,0,19
274439,abhiniropeti,abhiniropeti,21,21,0,0,12
274440,anuppabandhati,anuppabandhati,2,2,0,0,14
274441,avikkhepāya,avikkhepaya,5,4,1,0,11
274442,sampāditappayogassa,sampaditappayogassa,1,1,0,0,19
274443,payogasampattisambhavā,payogasampattisambhava,3,3,0,0,22
274444,sasesasampayuttadhammaṃ,sasesasampayuttadhammam,2,1,1,0,23
274445,abhiniropanānuppabandhanapīṇanaupabrūhanehi,abhiniropananuppabandhanapinanaupabruhanehi,1,1,0,0,43
274446,cittekaggatāti,cittekaggatati,14,13,1,0,14
274447,pañcaṅgasamannāgatatā,pancangasamannagatata,4,4,0,0,21
274448,samannāgataṅgānīti,samannagatanganiti,2,1,1,0,18
274449,aṅgamattavaseneva,angamattavaseneva,6,6,0,0,17
274450,pañcaṅgikanti,pancangikanti,4,4,0,0,13
274451,pañcaṅgasamannāgatanti,pancangasamannagatanti,2,2,0,0,22
274452,upacārakkhaṇepi,upacarakkhanepi,3,3,0,0,15
274453,pakaticittato,pakaticittato,3,3,0,0,13
274454,V1.0142,V1.0142,34,34,0,0,7
274455,balavatarāni,balavatarani,8,8,0,0,12
274456,upacāratopi,upacaratopi,3,3,0,0,11
274457,rūpāvacaralakkhaṇappattāni,rupavacaralakkhanappattani,2,2,0,0,26
274458,suvisadena,suvisadena,3,3,0,0,10
274459,abhiniropayamāno,abhiniropayamano,3,3,0,0,16
274460,anumajjamāno,anumajjamano,5,5,0,0,12
274461,sabbāvantampi,sabbavantampi,3,3,0,0,13
274462,sabbāvato,sabbavato,71,66,5,0,9
274463,cittekaggatāpi,cittekaggatapi,6,6,0,0,14
274464,heṭṭhimamhi,hetthimamhi,3,3,0,0,11
274465,samuggapaṭale,samuggapatale,3,3,0,0,13
274466,samuggapaṭalaṃ,samuggapatalam,17,17,0,0,14
274467,phusitā,phusita,7,6,1,0,7
274468,savicāranti,savicaranti,5,5,0,0,11
274469,ādimajjhapariyosānavasena,adimajjhapariyosanavasena,14,14,0,0,25
274470,tividhakalyāṇatā,tividhakalyanata,5,5,0,0,16
274471,ādimajjhapariyosānānaṃ,adimajjhapariyosananam,7,7,0,0,22
274472,dasalakkhaṇasampannatā,dasalakkhanasampannata,4,4,0,0,22
274473,paṭipadāvisuddhi,patipadavisuddhi,43,35,8,0,16
274474,upekkhānubrūhanā,upekkhanubruhana,42,33,9,0,16
274475,paribandho,paribandho,4,4,0,0,10
274476,paribandhato,paribandhato,1,1,0,0,12
274477,ādikalyāṇañceva,adikalyananceva,7,5,2,0,15
274478,tilakkhaṇasampannañca,tilakkhanasampannanca,6,4,2,0,21
274479,V1.0143,V1.0143,34,34,0,0,7
274480,samathapaṭipannaṃ,samathapatipannam,17,15,2,0,17
274481,ekattupaṭṭhānaṃ,ekattupatthanam,30,27,3,0,15
274482,majjhekalyāṇañceva,majjhekalyananceva,5,5,0,0,18
274483,pariyosānassa,pariyosanassa,20,20,0,0,13
274484,anativattanaṭṭhena,anativattanatthena,77,75,2,0,18
274485,ekarasaṭṭhena,ekarasatthena,79,79,0,0,13
274486,tadupagavīriyavāhanaṭṭhena,tadupagaviriyavahanatthena,26,25,1,0,26
274487,pariyosānakalyāṇañceva,pariyosanakalyananceva,5,5,0,0,22
274488,catulakkhaṇasampannañcā,catulakkhanasampannanca,2,2,0,0,23
274489,sasambhāriko,sasambhariko,7,6,1,0,12
274490,paccavekkhaṇāti,paccavekkhanati,10,10,0,0,15
274491,evameke,evameke,34,30,4,0,7
274492,ekattagataṃ,ekattagatam,19,13,6,0,11
274493,paṭipadāvisuddhipakkhandañceva,patipadavisuddhipakkhandanceva,6,6,0,0,30
274494,upekkhānubrūhitañca,upekkhanubruhitanca,6,6,0,0,19
274495,sampahaṃsitaṃ,sampahamsitam,10,9,1,0,13
274496,antoappanāyameva,antoappanayameva,5,5,0,0,16
274497,āgamanavasena,agamanavasena,49,46,3,0,13
274498,tatramajjhattupekkhāya,tatramajjhattupekkhaya,27,26,1,0,22
274499,anativattanādibhāvasādhanena,anativattanadibhavasadhanena,9,9,0,0,28
274500,pariyodāpakassa,pariyodapakassa,9,9,0,0,15
274501,kiccanipphattivasena,kiccanipphattivasena,18,18,0,0,20
274502,nīvaraṇasaṅkhāto,nivaranasankhato,4,4,0,0,16
274503,kilesagaṇo,kilesagano,14,14,0,0,10
274504,āvaraṇavirahitaṃ,avaranavirahitam,9,8,1,0,16
274505,appanāsamādhiyeva,appanasamadhiyeva,7,7,0,0,17
274506,ekasantatipariṇāmanayena,ekasantatiparinamanayena,5,5,0,0,24
274507,tathattamupagacchamānaṃ,tathattamupagacchamanam,1,1,0,0,23
274508,tathattupagamanena,tathattupagamanena,6,5,1,0,18
274509,vijjamānākāranipphādikā,vijjamanakaranipphadika,3,3,0,0,23
274510,uppādakkhaṇeyeva,uppadakkhaneyeva,22,22,0,0,16
274511,V1.0144,V1.0144,34,34,0,0,7
274512,visuddhassa,visuddhassa,10,9,1,0,11
274513,visodhetabbābhāvato,visodhetabbabhavato,4,4,0,0,19
274514,visodhane,visodhane,8,8,0,0,9
274515,samathabhāvupagamanena,samathabhavupagamanena,1,1,0,0,22
274516,samathapaṭipannassa,samathapatipannassa,4,4,0,0,19
274517,samathapaṭipannabhāvato,samathapatipannabhavato,4,4,0,0,23
274518,kilesasaṃsaggaṃ,kilesasamsaggam,10,9,1,0,15
274519,ekattupaṭṭhāne,ekattupatthane,7,7,0,0,14
274520,upekkhānubrūhite,upekkhanubruhite,5,5,0,0,16
274521,samādhipaññāsaṅkhātā,samadhipannasankhata,6,6,0,0,20
274522,yuganaddhadhammā,yuganaddhadhamma,6,6,0,0,16
274523,anativattamānā,anativattamana,11,10,1,0,14
274524,vimuttirasena,vimuttirasena,15,15,0,0,13
274525,ekarasāni,ekarasani,6,6,0,0,9
274526,yañcesa,yancesa,4,4,0,0,7
274527,tadupagaṃ,tadupagam,15,15,0,0,9
274528,anativattanaekarasabhāvānaṃ,anativattanaekarasabhavanam,6,6,0,0,27
274529,saṃkilesavodānesu,samkilesavodanesu,8,8,0,0,17
274530,sampahaṃsitattā,sampahamsitatta,6,5,1,0,15
274531,pariyodāpitattā,pariyodapitatta,4,4,0,0,15
274532,nipphannāva,nipphannava,3,3,0,0,11
274533,upekkhāvasena,upekkhavasena,23,21,2,0,13
274534,tathāpaggahitaṃ,tathapaggahitam,5,4,1,0,15
274535,nānattakilesehi,nanattakilesehi,8,7,1,0,15
274536,vimokkhavasena,vimokkhavasena,8,6,2,0,14
274537,ekarasā,ekarasa,103,98,5,0,7
274538,ñāṇakiccabhūtā,nanakiccabhuta,6,5,1,0,14
274539,gaṇanānupubbatā,ganananupubbata,25,25,0,0,15
274540,uppannantipi,uppannantipi,15,15,0,0,12
274541,ārammaṇūpanijjhānato,arammanupanijjhanato,9,8,1,0,20
274542,paccanīkajhāpanato,paccanikajhapanato,8,8,0,0,18
274543,sakalaṭṭhena,sakalatthena,8,8,0,0,12
274544,paṭiladdhanimittampi,patiladdhanimittampi,1,1,0,0,20
274545,pathavīkasiṇanimitte,pathavikasinanimitte,1,1,0,0,20
274546,paṭiladdhajhānampi,patiladdhajhanampi,1,1,0,0,18
274547,ciraṭṭhitisampādanaṃ,ciratthitisampadanam,1,1,0,0,20
274548,evamadhigate,evamadhigate,4,4,0,0,12
274549,V1.0145,V1.0145,34,34,0,0,7
274550,vālavedhinā,valavedhina,3,2,1,0,11
274551,sukusalo,sukusalo,23,22,1,0,8
274552,vālavedhāya,valavedhaya,1,1,0,0,11
274553,akkantapadānañca,akkantapadananca,1,1,0,0,16
274554,dhanudaṇḍassa,dhanudandassa,4,4,0,0,13
274555,pariggaṇheyya,parigganheyya,5,5,0,0,13
274556,dhanudaṇḍaṃ,dhanudandam,3,3,0,0,11
274557,vijjheyya,vijjheyya,14,14,0,0,9
274558,yogināpi,yoginapi,2,2,0,0,8
274559,sevamānena,sevamanena,4,3,1,0,10
274560,bhojanasappāyādayo,bhojanasappayadayo,1,1,0,0,18
274561,appaguṇaṃ,appagunam,10,8,2,0,9
274562,parivisanto,parivisanto,5,5,0,0,11
274563,evamayampi,evamayampi,42,42,0,0,10
274564,adhigatakkhaṇe,adhigatakkhane,3,2,1,0,14
274565,rājamahāmattaṃ,rajamahamattam,5,5,0,0,14
274566,nānaccayehi,nanaccayehi,5,5,0,0,11
274567,ambilaggehipi,ambilaggehipi,4,4,0,0,13
274568,tittakaggehipi,tittakaggehipi,4,4,0,0,14
274569,kaṭukaggehipi,katukaggehipi,4,4,0,0,13
274570,madhuraggehipi,madhuraggehipi,4,4,0,0,14
274571,khārikehipi,kharikehipi,4,4,0,0,11
274572,akhārikehipi,akharikehipi,4,4,0,0,12
274573,loṇikehipi,lonikehipi,4,4,0,0,10
274574,aloṇikehipi,alonikehipi,4,4,0,0,11
274575,sūpeyyaṃ,supeyyam,20,16,4,0,8
274576,ambilaggaṃ,ambilaggam,13,11,2,0,10
274577,ambilaggassa,ambilaggassa,12,12,0,0,12
274578,aloṇikassa,alonikassa,8,8,0,0,10
274579,acchādanassa,acchadanassa,4,4,0,0,12
274580,vetanassa,vetanassa,5,5,0,0,9
274581,abhihārānaṃ,abhiharanam,6,4,2,0,11
274582,V1.0146,V1.0146,34,34,0,0,7
274583,dhammānupassino,dhammanupassino,13,13,0,0,15
274584,satisampajaññassa,satisampajannassa,20,20,0,0,17
274585,uggaṇhātī,ugganhati,8,4,4,0,9
274586,nimittaggahaṇena,nimittaggahanena,3,3,0,0,16
274587,appanāmattameva,appanamattameva,3,3,0,0,15
274588,ciraṭṭhānaṃ,ciratthanam,6,6,0,0,11
274589,samādhiparibandhānaṃ,samadhiparibandhanam,2,2,0,0,20
274590,suvisodhitattā,suvisodhitatta,2,2,0,0,14
274591,kāmādīnavapaccavekkhaṇādīhi,kamadinavapaccavekkhanadihi,6,6,0,0,27
274592,kāyapassaddhivasena,kayapassaddhivasena,2,2,0,0,19
274593,kāyaduṭṭhullaṃ,kayadutthullam,15,10,5,0,14
274594,suppaṭipassaddhaṃ,suppatipassaddham,1,1,0,0,17
274595,ārambhadhātumanasikārādivasena,arambhadhatumanasikaradivasena,3,3,0,0,30
274596,samathanimittamanasikārādivasena,samathanimittamanasikaradivasena,3,3,0,0,32
274597,susamūhataṃ,susamuhatam,5,5,0,0,11
274598,samādhiparibandhe,samadhiparibandhe,2,2,0,0,17
274599,avisodhitaṃ,avisodhitam,2,2,0,0,11
274600,āsayaṃ,asayam,111,99,12,0,6
274601,paviṭṭhabhamaro,pavitthabhamaro,7,7,0,0,15
274602,paviṭṭharājā,pavittharaja,6,6,0,0,12
274603,suvisodhitaṃ,suvisodhitam,29,28,1,0,12
274604,antosamāpattiyaṃyeva,antosamapattiyamyeva,7,7,0,0,20
274605,vinodaye,vinodaye,17,14,3,0,8
274606,uddhaccamiddhaṃ,uddhaccamiddham,1,1,0,0,15
274607,vicikicchapañcamaṃ,vicikicchapancamam,2,2,0,0,18
274608,vivekapāmojjakarena,vivekapamojjakarena,2,2,0,0,19
274609,suddhantagato,suddhantagato,2,2,0,0,13
274610,rame,rame,23,23,0,0,4
274611,ciraṭṭhitikāmena,ciratthitikamena,2,2,0,0,16
274612,paribandhakadhamme,paribandhakadhamme,1,1,0,0,18
274613,samāpajjitabbaṃ,samapajjitabbam,45,44,1,0,15
274614,cittabhāvanāvepullatthañca,cittabhavanavepullatthanca,2,1,1,0,26
274615,vaḍḍhanābhūmiyo,vaddhanabhumiyo,3,2,1,0,15
274616,V1.0147,V1.0147,34,34,0,0,7
274617,nimittavaḍḍhananayo,nimittavaddhananayo,1,1,0,0,19
274618,vaḍḍhananayo,vaddhananayo,1,1,0,0,12
274619,pattavaḍḍhanapūvavaḍḍhanabhattavaḍḍhanalatāvaḍḍhanadussavaḍḍhanayogena,pattavaddhanapuvavaddhanabhattavaddhanalatavaddhanadussavaddhanayogena,1,1,0,0,70
274620,avaḍḍhetvā,avaddhetva,12,11,1,0,10
274621,kasitabbaṭṭhānaṃ,kasitabbatthanam,5,5,0,0,16
274622,naṅgalena,nangalena,23,23,0,0,9
274623,bandhantā,bandhanta,23,23,0,0,9
274624,ekaṅguladvaṅgulativaṅgulacaturaṅgulamattaṃ,ekanguladvangulativangulacaturangulamattam,2,2,0,0,42
274625,aparicchinditvā,aparicchinditva,11,10,1,0,15
274626,vidatthiratanapamukhapariveṇavihārasīmānaṃ,vidatthiratanapamukhaparivenaviharasimanam,1,1,0,0,42
274627,gāmanigamajanapadarajjasamuddasīmānañca,gamanigamajanapadarajjasamuddasimananca,2,2,0,0,39
274628,vaḍḍhayantena,vaddhayantena,2,2,0,0,13
274629,cakkavāḷaparicchedena,cakkavalaparicchedena,2,2,0,0,21
274630,haṃsapotakā,hamsapotaka,13,13,0,0,11
274631,uṭṭhitakālato,utthitakalato,1,1,0,0,13
274632,paricayaṃ,paricayam,16,16,0,0,9
274633,candimasūriyasantikaṃ,candimasuriyasantikam,1,1,0,0,21
274634,cakkavāḷaparicchedā,cakkavalapariccheda,1,1,0,0,19
274635,vaḍḍhitavaḍḍhitaṭṭhāne,vaddhitavaddhitatthane,2,2,0,0,22
274636,ukkūlavikūlanadīviduggapabbatavisamesu,ukkulavikulanadividuggapabbatavisamesu,2,2,0,0,38
274637,saṅkusatasamabbhāhataṃ,sankusatasamabbhahatam,3,3,0,0,22
274638,usabhacammaṃ,usabhacammam,4,4,0,0,12
274639,pattapaṭhamajjhānena,pattapathamajjhanena,2,2,0,0,20
274640,samāpajjanabahulena,samapajjanabahulena,1,1,0,0,19
274641,paccavekkhaṇabahulena,paccavekkhanabahulena,2,2,0,0,21
274642,paccavekkhaṇabahulassa,paccavekkhanabahulassa,2,2,0,0,22
274643,ussukkanāya,ussukkanaya,2,2,0,0,11
274644,paccayataṃ,paccayatam,11,11,0,0,10
274645,appaguṇe,appagune,14,14,0,0,8
274646,ussukkamāno,ussukkamano,2,2,0,0,11
274647,pattapaṭhamajjhānā,pattapathamajjhana,1,1,0,0,18
274648,akhettaññū,akhettannu,14,10,4,0,10
274649,agatapubbañceva,agatapubbanceva,7,7,0,0,15
274650,akhāditapubbāni,akhaditapubbani,10,10,0,0,15
274651,khādeyyaṃ,khadeyyam,15,15,0,0,9
274652,apītapubbāni,apitapubbani,9,9,0,0,12
274653,piveyyaṃ,piveyyam,10,10,0,0,8
274654,V1.0148,V1.0148,34,34,0,0,7
274655,supatiṭṭhitaṃ,supatitthitam,5,4,1,0,13
274656,agatapubbaṃ,agatapubbam,31,29,2,0,11
274657,khādeyya,khadeyya,79,63,16,0,8
274658,yasmiñcassā,yasmincassa,1,1,0,0,11
274659,paccāgaccheyya,paccagaccheyya,9,9,0,0,14
274660,nāsevati,nasevati,2,2,0,0,8
274661,svādhiṭṭhitaṃ,svadhitthitam,43,38,5,0,13
274662,pañcahākārehi,pancahakarehi,192,188,4,0,13
274663,ciṇṇavasinā,cinnavasina,6,6,0,0,11
274664,pañcavasīkathā,pancavasikatha,1,1,0,0,14
274665,āvajjanavasī,avajjanavasi,23,14,9,0,12
274666,samāpajjanavasī,samapajjanavasi,18,10,8,0,15
274667,adhiṭṭhānavasī,adhitthanavasi,13,6,7,0,14
274668,vuṭṭhānavasī,vutthanavasi,13,7,6,0,12
274669,paccavekkhaṇavasīti,paccavekkhanavasiti,2,2,0,0,19
274670,samāpajjanāya,samapajjanaya,6,6,0,0,13
274671,paṭhamajjhānato,pathamajjhanato,34,34,0,0,15
274672,āvajjayato,avajjayato,22,21,1,0,10
274673,uppannāvajjanānantaraṃ,uppannavajjananantaram,11,11,0,0,22
274674,vitakkārammaṇāneva,vitakkarammananeva,5,4,1,0,18
274675,vicārārammaṇaṃ,vicararammanam,5,5,0,0,14
274676,vuttanayāneva,vuttanayaneva,45,45,0,0,13
274677,V1.0149,V1.0149,34,34,0,0,7
274678,nandopanandanāgarājadamane,nandopanandanagarajadamane,2,2,0,0,26
274679,accharāmattaṃ,accharamattam,8,7,1,0,13
274680,dasaccharāmattaṃ,dasaccharamattam,6,6,0,0,16
274681,tadubhayadassanatthaṃ,tadubhayadassanattham,2,1,1,0,21
274682,buddharakkhitattherassa,buddharakkhitattherassa,8,8,0,0,23
274683,hāyasmā,hayasma,13,12,1,0,7
274684,therambatthale,therambatthale,3,3,0,0,14
274685,mahārohaṇaguttattherassa,maharohanaguttattherassa,2,2,0,0,24
274686,gilānupaṭṭhānaṃ,gilanupatthanam,12,12,0,0,15
274687,iddhimantasahassānaṃ,iddhimantasahassanam,1,1,0,0,20
274688,paṭiggāhayamānaṃ,patiggahayamanam,1,1,0,0,16
274689,upaṭṭhākanāgarājānaṃ,upatthakanagarajanam,1,1,0,0,20
274690,gahessāmīti,gahessamiti,9,7,2,0,11
274691,pakkhandantaṃ,pakkhandantam,3,3,0,0,13
274692,supaṇṇarājānaṃ,supannarajanam,3,3,0,0,14
274693,bāhāyaṃ,bahayam,41,32,9,0,7
274694,nābhavissa,nabhavissa,58,57,1,0,10
274695,assāmā,assama,9,9,0,0,6
274696,paccavekkhaṇavasī,paccavekkhanavasi,13,8,5,0,17
274697,paccavekkhaṇajavanāneva,paccavekkhanajavananeva,6,6,0,0,23
274698,āvajjanānantarānīti,avajjananantaraniti,4,3,1,0,19
274699,dutiyajjhānakathā,dutiyajjhanakatha,6,6,0,0,17
274700,vasīsu,vasisu,2,2,0,0,6
274701,paguṇapaṭhamajjhānato,pagunapathamajjhanato,5,5,0,0,21
274702,āsannanīvaraṇapaccatthikā,asannanivaranapaccatthika,4,3,1,0,25
274703,aṅgadubbalā,angadubbala,12,10,2,0,11
274704,dutiyādhigamāya,dutiyadhigamaya,2,2,0,0,15
274705,paṭhamajjhānā,pathamajjhana,24,22,2,0,13
274706,sampajānassa,sampajanassa,55,54,1,0,12
274707,pītisukhañceva,pitisukhanceva,1,1,0,0,14
274708,santaaṅgapaṭilābhāya,santaangapatilabhaya,3,3,0,0,20
274709,V1.0150,V1.0150,34,34,0,0,7
274710,yesamavasāne,yesamavasane,1,1,0,0,12
274711,dutiyajjhānikaṃ,dutiyajjhanikam,5,5,0,0,15
274712,vuttappakārāneva,vuttappakaraneva,6,6,0,0,16
274713,kāmāvacarānīti,kamavacaraniti,2,2,0,0,14
274714,dvaṅgavippahīnaṃ,dvangavippahinam,2,2,0,0,16
274715,tivaṅgasamannāgataṃ,tivangasamannagatam,3,3,0,0,19
274716,vūpasamāti,vupasamati,29,19,10,0,10
274717,vicārassa,vicarassa,153,153,0,0,9
274718,dutiyajjhānakkhaṇe,dutiyajjhanakkhane,12,11,1,0,18
274719,apātubhāvāti,apatubhavati,6,6,0,0,12
274720,dutiyajjhāne,dutiyajjhane,48,45,3,0,12
274721,paṭhamajjhānadhammā,pathamajjhanadhamma,9,9,0,0,19
274722,niyakajjhattamadhippetaṃ,niyakajjhattamadhippetam,5,4,1,0,24
274723,sampasādanayogato,sampasadanayogato,9,9,0,0,17
274724,jhānampi,jhanampi,39,38,1,0,8
274725,sampasādanasamannāgatattā,sampasadanasamannagatatta,5,5,0,0,25
274726,vitakkavicārakkhobhavūpasamanena,vitakkavicarakkhobhavupasamanena,5,5,0,0,32
274727,sampasādayati,sampasadayati,5,5,0,0,13
274728,sampasādananti,sampasadananti,11,11,0,0,14
274729,atthavikappe,atthavikappe,94,94,0,0,12
274730,cetasoti,cetasoti,33,12,21,0,8
274731,ekodibhāvena,ekodibhavena,15,15,0,0,12
274732,tatrāyamatthayojanā,tatrayamatthayojana,4,4,0,0,19
274733,udetīti,udetiti,29,26,3,0,7
274734,vitakkavicārehi,vitakkavicarehi,58,57,1,0,15
274735,anajjhārūḷhattā,anajjharulhatta,4,4,0,0,15
274736,seṭṭhopi,setthopi,12,10,2,0,8
274737,vitakkavicāravirahato,vitakkavicaravirahato,3,3,0,0,21
274738,udāyatīti,udayatiti,5,5,0,0,9
274739,V1.0151,V1.0151,34,34,0,0,7
274740,samādhissetaṃ,samadhissetam,11,11,0,0,13
274741,ekodiṃ,ekodim,33,32,1,0,6
274742,ekodibhāvanti,ekodibhavanti,8,8,0,0,13
274743,paṭhamajjhānepi,pathamajjhanepi,12,12,0,0,15
274744,ekodināmako,ekodinamako,6,6,0,0,11
274745,ekodibhāvañcā,ekodibhavanca,2,2,0,0,13
274746,vitakkavicārakkhobhena,vitakkavicarakkhobhena,9,7,2,0,22
274747,vīcitaraṅgasamākulamiva,vicitarangasamakulamiva,6,6,0,0,23
274748,suppasannaṃ,suppasannam,12,10,2,0,11
274749,satiyāpi,satiyapi,18,16,2,0,8
274750,suppasannattāyeva,suppasannattayeva,4,4,0,0,17
274751,samādhipi,samadhipi,27,23,4,0,9
274752,vitakkavicārapalibodhābhāvena,vitakkavicarapalibodhabhavena,5,5,0,0,29
274753,balavasaddhāsahāyapaṭilābheneva,balavasaddhasahayapatilabheneva,4,4,0,0,31
274754,ayamatthavaṇṇanā,ayamatthavannana,7,6,1,0,16
274755,vibhaṅgepi,vibhangepi,15,12,3,0,10
274756,atthaṅgatā,atthangata,35,33,2,0,10
274757,abbhatthaṅgatā,abbhatthangata,26,25,1,0,14
274758,byappitā,byappita,21,21,0,0,8
274759,sositā,sosita,26,25,1,0,6
274760,byantikatā,byantikata,7,7,0,0,10
274761,siddhovāyamattho,siddhovayamattho,9,8,1,0,16
274762,tadatthadīpakaṃ,tadatthadipakam,15,11,4,0,15
274763,samadhigamo,samadhigamo,19,19,0,0,11
274764,kilesakālussiyassa,kilesakalussiyassa,3,3,0,0,18
274765,vitakkavicārānañca,vitakkavicarananca,25,25,0,0,18
274766,upacārajjhānamiva,upacarajjhanamiva,5,5,0,0,17
274767,nīvaraṇappahānā,nivaranappahana,7,6,1,0,15
274768,paṭhamajjhānamiva,pathamajjhanamiva,5,5,0,0,17
274769,V1.0152,V1.0152,34,34,0,0,7
274770,aṅgapātubhāvāti,angapatubhavati,5,5,0,0,15
274771,sampasādanaekodibhāvānaṃ,sampasadanaekodibhavanam,5,5,0,0,24
274772,hetuparidīpakamidaṃ,hetuparidipakamidam,5,5,0,0,19
274773,tatiyacatutthajjhānāni,tatiyacatutthajjhanani,5,5,0,0,22
274774,avitakkaavicārabhāvassa,avitakkaavicarabhavassa,5,5,0,0,23
274775,hetuparidīpakañca,hetuparidipakanca,5,5,0,0,17
274776,vitakkavicārābhāvamattaparidīpakaṃ,vitakkavicarabhavamattaparidipakam,5,5,0,0,34
274777,vitakkavicārābhāvamattaparidīpakameva,vitakkavicarabhavamattaparidipakameva,5,5,0,0,37
274778,paṭhamajjhānasamādhito,pathamajjhanasamadhito,9,8,1,0,22
274779,sampayuttasamādhito,sampayuttasamadhito,11,11,0,0,19
274780,vitakkavicārakkhobhavirahena,vitakkavicarakkhobhavirahena,6,6,0,0,28
274781,acalattā,acalatta,5,5,0,0,8
274782,suppasannattā,suppasannatta,7,7,0,0,13
274783,vaṇṇabhaṇanatthaṃ,vannabhananattham,29,28,1,0,17
274784,samāpajjatītipi,samapajjatitipi,10,10,0,0,15
274785,dvaṅgavippahīnatā,dvangavippahinata,1,1,0,0,17
274786,upacārakkhaṇe,upacarakkhane,35,31,4,0,13
274787,appanākkhaṇeyeva,appanakkhaneyeva,3,3,0,0,16
274788,tivaṅgasamannāgatatā,tivangasamannagatata,1,1,0,0,20
274789,sampasādo,sampasado,16,15,1,0,9
274790,saparikkhāraṃ,saparikkharam,21,16,5,0,13
274791,upanijjhānalakkhaṇappattānaṃ,upanijjhanalakkhanappattanam,3,3,0,0,28
274792,tivaṅgikameva,tivangikameva,1,1,0,0,13
274793,tatiyajjhānakathā,tatiyajjhanakatha,8,8,0,0,17
274794,paguṇadutiyajjhānato,pagunadutiyajjhanato,2,2,0,0,20
274795,āsannavitakkavicārapaccatthikā,asannavitakkavicarapaccatthika,1,1,0,0,30
274796,pītigataṃ,pitigatam,7,5,2,0,9
274797,uppilāvitaṃ,uppilavitam,9,5,4,0,11
274798,etenetaṃ,etenetam,7,6,1,0,8
274799,akkhāyatī,akkhayati,13,12,1,0,9
274800,V1.0153,V1.0153,34,34,0,0,7
274801,tatiyādhigamāya,tatiyadhigamaya,2,2,0,0,15
274802,dutiyajjhānato,dutiyajjhanato,11,11,0,0,14
274803,sukhañceva,sukhanceva,2,2,0,0,10
274804,oḷārikaṅgappahānāya,olarikangappahanaya,4,4,0,0,19
274805,tatiyajjhānikaṃ,tatiyajjhanikam,3,3,0,0,15
274806,sukhavihārīti,sukhavihariti,12,7,5,0,13
274807,ekaṅgavippahīnaṃ,ekangavippahinam,9,8,1,0,16
274808,duvaṅgasamannāgataṃ,duvangasamannagatam,6,6,0,0,19
274809,virāgāti,viragati,10,1,9,0,8
274810,vūpasamameva,vupasamameva,5,5,0,0,12
274811,yojanāya,yojanaya,58,57,1,0,8
274812,jigucchanattho,jigucchanattho,5,5,0,0,14
274813,jigucchanā,jigucchana,6,6,0,0,10
274814,vitakkavicāravūpasamaṃ,vitakkavicaravupasamam,8,8,0,0,22
274815,samatikkamanattho,samatikkamanattho,5,5,0,0,17
274816,kāmañcete,kamancete,7,7,0,0,9
274817,dutiyajjhāneyeva,dutiyajjhaneyeva,9,8,1,0,16
274818,maggaparidīpanatthaṃ,maggaparidipanattham,5,5,0,0,20
274819,vaṇṇabhaṇanatthañcetaṃ,vannabhananatthancetam,5,5,0,0,22
274820,vitakkavicāravūpasamo,vitakkavicaravupasamo,5,5,0,0,21
274821,jhānassāti,jhanassati,8,7,1,0,10
274822,appahīnānampi,appahinanampi,5,5,0,0,13
274823,sakkāyadiṭṭhādīnaṃ,sakkayaditthadinam,16,15,1,0,18
274824,pahānā,pahana,418,408,10,0,6
274825,V1.0154,V1.0154,34,34,0,0,7
274826,vaṇṇabhaṇanaṃ,vannabhananam,34,29,5,0,13
274827,tadadhigamāya,tadadhigamaya,33,33,0,0,13
274828,ussukkānaṃ,ussukkanam,4,4,0,0,10
274829,ussāhajanakaṃ,ussahajanakam,5,5,0,0,13
274830,avūpasantānampi,avupasantanampi,5,5,0,0,15
274831,tenāyamattho,tenayamattho,12,12,0,0,12
274832,apakkhapatitā,apakkhapatita,6,6,0,0,13
274833,thāmagatāya,thamagataya,7,7,0,0,11
274834,tatiyajjhānasamaṅgī,tatiyajjhanasamangi,7,7,0,0,19
274835,upekkhakoti,upekkhakoti,15,6,9,0,11
274836,chaḷaṅgupekkhā,chalangupekkha,64,57,7,0,14
274837,brahmavihārupekkhā,brahmaviharupekkha,37,32,5,0,18
274838,bojjhaṅgupekkhā,bojjhangupekkha,24,19,5,0,15
274839,vīriyupekkhā,viriyupekkha,16,11,5,0,12
274840,vipassanupekkhā,vipassanupekkha,32,20,12,0,15
274841,jhānupekkhā,jhanupekkha,22,18,4,0,11
274842,pārisuddhupekkhāti,parisuddhupekkhati,5,5,0,0,18
274843,evamāgatā,evamagata,72,72,0,0,9
274844,iṭṭhāniṭṭhachaḷārammaṇāpāthe,itthanitthachalarammanapathe,10,10,0,0,28
274845,parisuddhapakatibhāvāvijahanākārabhūtā,parisuddhapakatibhavavijahanakarabhuta,6,6,0,0,38
274846,upekkhāsahagatena,upekkhasahagatena,123,123,0,0,17
274847,majjhattākārabhūtā,majjhattakarabhuta,19,19,0,0,18
274848,upekkhāsambojjhaṅgaṃ,upekkhasambojjhangam,83,83,0,0,20
274849,vivekanissitaṃ,vivekanissitam,216,197,19,0,14
274850,upekkhānimittaṃ,upekkhanimittam,29,26,3,0,15
274851,anaccāraddhanātisithilavīriyasaṅkhātā,anaccaraddhanatisithilaviriyasankhata,5,5,0,0,37
274852,samathavasena,samathavasena,70,68,2,0,13
274853,vipassanāvasena,vipassanavasena,151,141,10,0,15
274854,V1.0155,V1.0155,34,34,0,0,7
274855,nīvaraṇādipaṭisaṅkhāsantiṭṭhanā,nivaranadipatisankhasantitthana,2,1,1,0,31
274856,majjhattabhūtā,majjhattabhuta,20,18,2,0,14
274857,adukkhamasukhasaññitā,adukkhamasukhasannita,3,3,0,0,21
274858,paṭilabhatī,patilabhati,40,31,9,0,11
274859,vicinane,vicinane,15,15,0,0,8
274860,chandādīsu,chandadisu,15,14,1,0,10
274861,yevāpanakesu,yevapanakesu,21,21,0,0,12
274862,samavāhitabhūtā,samavahitabhuta,5,4,1,0,15
274863,aggasukhepi,aggasukhepi,6,6,0,0,11
274864,apakkhapātajananī,apakkhapatajanani,5,5,0,0,17
274865,upekkhāsatipārisuddhiṃ,upekkhasatiparisuddhim,116,106,10,0,22
274866,sabbapaccanīkaparisuddhā,sabbapaccanikaparisuddha,6,5,1,0,24
274867,paccanīkavūpasamanepi,paccanikavupasamanepi,6,5,1,0,21
274868,abyāpārabhūtā,abyaparabhuta,7,6,1,0,13
274869,pārisuddhupekkhā,parisuddhupekkha,13,9,4,0,16
274870,tatramajjhattupekkhāva,tatramajjhattupekkhava,14,14,0,0,22
274871,kumārayuvatherasenāpatirājādivasena,kumarayuvatherasenapatirajadivasena,3,3,0,0,35
274872,bojjhaṅgupekkhādayo,bojjhangupekkhadayo,5,5,0,0,19
274873,chaḷaṅgupekkhādayo,chalangupekkhadayo,5,5,0,0,18
274874,cetāsamatthato,cetasamatthato,1,1,0,0,14
274875,vipassanupekkhānampi,vipassanupekkhanampi,1,1,0,0,20
274876,ajapadadaṇḍaṃ,ajapadadandam,5,5,0,0,13
274877,V1.0156,V1.0156,34,34,0,0,7
274878,pariyesamānassa,pariyesamanassa,10,10,0,0,15
274879,thusakoṭṭhake,thusakotthake,6,6,0,0,13
274880,avalokentassa,avalokentassa,5,5,0,0,13
274881,sovattikattayaṃ,sovattikattayam,2,2,0,0,15
274882,nibbematikassa,nibbematikassa,6,6,0,0,14
274883,āraddhavipassakassa,araddhavipassakassa,40,40,0,0,19
274884,vipassanāñāṇena,vipassanananena,48,47,1,0,15
274885,lakkhaṇattaye,lakkhanattaye,10,10,0,0,13
274886,aniccabhāvādivicinane,aniccabhavadivicinane,6,6,0,0,21
274887,ajapadadaṇḍena,ajapadadandena,2,2,0,0,14
274888,aviheṭhento,avihethento,11,11,0,0,11
274889,aḍaṃsāpento,adamsapento,5,5,0,0,11
274890,muñcanākārameva,muncanakarameva,5,5,0,0,15
274891,pariyesato,pariyesato,10,10,0,0,10
274892,saṅkhāraggahaṇe,sankharaggahane,5,5,0,0,15
274893,vipassanupekkhāya,vipassanupekkhaya,11,10,1,0,17
274894,saṅkhārupekkhāpi,sankharupekkhapi,5,5,0,0,16
274895,vicinanaggahaṇesu,vicinanaggahanesu,3,3,0,0,17
274896,majjhattasaṅkhātena,majjhattasankhatena,4,4,0,0,19
274897,avasesāhi,avasesahi,14,12,2,0,9
274898,upekkhāsu,upekkhasu,4,4,0,0,9
274899,majjhattalakkhaṇā,majjhattalakkhana,6,6,0,0,17
274900,anābhogarasā,anabhogarasa,4,4,0,0,12
274901,abyāpārapaccupaṭṭhānā,abyaparapaccupatthana,4,4,0,0,21
274902,pītivirāgapadaṭṭhānāti,pitiviragapadatthanati,4,4,0,0,22
274903,cāyamatthato,cayamatthato,1,1,0,0,12
274904,paṭhamadutiyajjhānesupi,pathamadutiyajjhanesupi,5,5,0,0,23
274905,aparibyattakiccato,aparibyattakiccato,6,5,1,0,18
274906,aparibyattañhi,aparibyattanhi,5,5,0,0,14
274907,vitakkavicārapītīhi,vitakkavicarapitihi,6,6,0,0,19
274908,anabhibhūtattā,anabhibhutatta,15,15,0,0,14
274909,paribyattakiccā,paribyattakicca,6,6,0,0,15
274910,sampajānoti,sampajanoti,72,16,56,0,11
274911,saraṇalakkhaṇā,saranalakkhana,10,8,2,0,14
274912,asammussanarasā,asammussanarasa,7,5,2,0,15
274913,asammohalakkhaṇaṃ,asammohalakkhanam,6,5,1,0,17
274914,tīraṇarasaṃ,tiranarasam,4,4,0,0,11
274915,pavicayapaccupaṭṭhānaṃ,pavicayapaccupatthanam,4,4,0,0,22
274916,purimajjhānesupi,purimajjhanesupi,6,6,0,0,16
274917,muṭṭhasatissa,mutthasatissa,3,3,0,0,13
274918,asampajānassa,asampajanassa,27,27,0,0,13
274919,upacāramattampi,upacaramattampi,5,5,0,0,15
274920,satisampajaññakiccaṃ,satisampajannakiccam,7,5,2,0,20
274921,oḷārikaṅgappahānena,olarikangappahanena,7,5,2,0,19
274922,khuradhārāyaṃ,khuradharayam,7,7,0,0,13
274923,satisampajaññakiccapariggahitā,satisampajannakiccapariggahita,4,4,0,0,30
274924,V1.0157,V1.0157,34,34,0,0,7
274925,dhenupago,dhenupago,6,5,1,0,9
274926,arakkhiyamāno,arakkhiyamano,5,5,0,0,13
274927,tatiyajjhānasukhaṃ,tatiyajjhanasukham,15,13,2,0,18
274928,pītito,pitito,7,7,0,0,6
274929,satisampajaññārakkhena,satisampajannarakkhena,5,5,0,0,22
274930,arakkhiyamānaṃ,arakkhiyamanam,5,5,0,0,14
274931,pītisampayuttameva,pitisampayuttameva,7,5,2,0,18
274932,sārajjanti,sarajjanti,25,25,0,0,10
274933,atimadhuraṃ,atimadhuram,26,22,4,0,11
274934,sukhābhāvā,sukhabhava,5,5,0,0,10
274935,satisampajaññānubhāvena,satisampajannanubhavena,5,5,0,0,23
274936,asārajjanā,asarajjana,14,14,0,0,10
274937,imampi,imampi,111,110,1,0,6
274938,idamidheva,idamidheva,3,3,0,0,10
274939,tatiyajjhānasamaṅgino,tatiyajjhanasamangino,6,6,0,0,21
274940,sukhapaṭisaṃvedanābhogo,sukhapatisamvedanabhogo,5,5,0,0,23
274941,nāmakāyasampayuttaṃ,namakayasampayuttam,7,6,1,0,19
274942,taṃsamuṭṭhānenassa,tamsamutthanenassa,5,5,0,0,18
274943,atipaṇītena,atipanitena,9,8,1,0,11
274944,phuṭattā,phutatta,8,6,2,0,8
274945,paṭisaṃvedeyya,patisamvedeyya,13,12,1,0,14
274946,yaṃjhānahetu,yamjhanahetu,5,5,0,0,12
274947,yaṃjhānakāraṇā,yamjhanakarana,5,5,0,0,14
274948,tatiyajjhānasamaṅgipuggalaṃ,tatiyajjhanasamangipuggalam,3,3,0,0,27
274949,pasaṃsantīti,pasamsantiti,39,20,19,0,12
274950,pasaṃsārahato,pasamsarahato,10,10,0,0,13
274951,atimadhurasukhe,atimadhurasukhe,5,5,0,0,15
274952,sukhapāramippattepi,sukhaparamippattepi,5,5,0,0,19
274953,tatiyajjhāne,tatiyajjhane,44,44,0,0,12
274954,sukhābhisaṅgena,sukhabhisangena,6,6,0,0,15
274955,ākaḍḍhiyati,akaddhiyati,4,4,0,0,11
274956,upaṭṭhitasatitāya,upatthitasatitaya,11,11,0,0,17
274957,ariyajanasevitameva,ariyajanasevitameva,5,5,0,0,19
274958,asaṃkiliṭṭhaṃ,asamkilittham,83,81,2,0,13
274959,pasaṃsāhetubhūte,pasamsahetubhute,4,4,0,0,16
274960,sukhavihārī,sukhavihari,82,81,1,0,11
274961,ekaṅgavippahīnatā,ekangavippahinata,2,2,0,0,17
274962,V1.0158,V1.0158,34,34,0,0,7
274963,dutiyajjhānassa,dutiyajjhanassa,22,22,0,0,15
274964,pahānaṅganti,pahananganti,2,2,0,0,12
274965,duvaṅgasamannāgatatā,duvangasamannagatata,2,2,0,0,20
274966,upekkhāsatisampajaññāni,upekkhasatisampajannani,2,2,0,0,23
274967,duvaṅgikamevetaṃ,duvangikamevetam,4,4,0,0,16
274968,catutthajjhānakathā,catutthajjhanakatha,6,6,0,0,19
274969,paguṇatatiyajjhānato,pagunatatiyajjhanato,1,1,0,0,20
274970,āsannapītipaccatthikā,asannapitipaccatthika,2,2,0,0,21
274971,sukhamiti,sukhamiti,7,7,0,0,9
274972,catutthādhigamāya,catutthadhigamaya,2,2,0,0,17
274973,tatiyajjhānato,tatiyajjhanato,9,8,1,0,14
274974,cetasikasomanassasaṅkhātaṃ,cetasikasomanassasankhatam,1,1,0,0,26
274975,catutthajjhāne,catutthajjhane,66,64,2,0,14
274976,upekkhāvedanāsampayuttāni,upekkhavedanasampayuttani,1,1,0,0,25
274977,upekkhāsampayuttattāyeva,upekkhasampayuttattayeva,1,1,0,0,24
274978,pītipi,pitipi,3,3,0,0,6
274979,somanassadomanassānaṃ,somanassadomanassanam,92,86,6,0,21
274980,atthaṅgamā,atthangama,187,184,3,0,10
274981,V1.0159,V1.0159,34,34,0,0,7
274982,pahānāti,pahanati,11,0,11,0,8
274983,kāyikasukhassa,kayikasukhassa,7,7,0,0,14
274984,kāyikadukkhassa,kayikadukkhassa,15,15,0,0,15
274985,pubbevāti,pubbevati,11,1,10,0,9
274986,catutthajjhānakkhaṇe,catutthajjhanakkhane,6,6,0,0,20
274987,atthaṅgamāti,atthangamati,13,1,12,0,12
274988,cetasikasukhassa,cetasikasukhassa,7,7,0,0,16
274989,cetasikadukkhassa,cetasikadukkhassa,9,9,0,0,17
274990,somanassañhi,somanassanhi,6,6,0,0,12
274991,catutthajjhānassa,catutthajjhanassa,23,23,0,0,17
274992,upacārakkhaṇeyeva,upacarakkhaneyeva,14,14,0,0,17
274993,dukkhadomanassasukhāni,dukkhadomanassasukhani,8,8,0,0,22
274994,paṭhamadutiyatatiyajjhānānaṃ,pathamadutiyatatiyajjhananam,3,3,0,0,28
274995,upacārakkhaṇesu,upacarakkhanesu,6,6,0,0,15
274996,pahānakkamena,pahanakkamena,9,8,1,0,13
274997,uddesakkameneva,uddesakkameneva,6,6,0,0,15
274998,sukhadukkhasomanassadomanassānaṃ,sukhadukkhasomanassadomanassanam,5,5,0,0,32
274999,cuppannaṃ,cuppannam,36,32,4,0,9
275000,kāmehipi,kamehipi,1,1,0,0,8
275001,jhānesveva,jhanesveva,9,9,0,0,10
275002,atisayanirodhattā,atisayanirodhatta,6,6,0,0,17
275003,atisayanirodho,atisayanirodho,8,6,2,0,14
275004,nirodhoyeva,nirodhoyeva,12,12,0,0,11
275005,nātisayanirodho,natisayanirodho,7,7,0,0,15
275006,nānāvajjane,nanavajjane,9,9,0,0,11
275007,paṭhamajjhānupacāre,pathamajjhanupacare,5,5,0,0,19
275008,niruddhassāpi,niruddhassapi,10,9,1,0,13
275009,dukkhindriyassa,dukkhindriyassa,10,10,0,0,15
275010,ḍaṃsamakasādisamphassena,damsamakasadisamphassena,6,6,0,0,24
275011,visamāsanupatāpena,visamasanupatapena,5,5,0,0,18
275012,antoappanāyaṃ,antoappanayam,21,19,2,0,13
275013,niruddhampetaṃ,niruddhampetam,6,6,0,0,14
275014,avihatattā,avihatatta,19,18,1,0,10
275015,pītipharaṇena,pitipharanena,12,12,0,0,13
275016,sukhokkanto,sukhokkanto,9,6,3,0,11
275017,sukhokkantakāyassa,sukhokkantakayassa,6,6,0,0,18
275018,vihatattā,vihatatta,19,19,0,0,9
275019,nānāvajjaneyeva,nanavajjaneyeva,5,5,0,0,15
275020,dutiyajjhānupacāre,dutiyajjhanupacare,9,9,0,0,18
275021,pahīnassa,pahinassa,48,48,0,0,9
275022,domanassindriyassa,domanassindriyassa,15,15,0,0,18
275023,vitakkavicārapaccayepi,vitakkavicarapaccayepi,5,5,0,0,22
275024,kāyakilamathe,kayakilamathe,7,7,0,0,13
275025,cittupaghāte,cittupaghate,5,5,0,0,12
275026,vitakkavicārābhāve,vitakkavicarabhave,6,6,0,0,18
275027,vitakkavicārabhāve,vitakkavicarabhave,8,8,0,0,18
275028,vitakkavicārāti,vitakkavicarati,12,10,2,0,15
275029,pahīnapaccayattā,pahinapaccayatta,6,5,1,0,16
275030,tatiyajjhānupacāre,tatiyajjhanupacare,4,4,0,0,18
275031,pahīnassāpi,pahinassapi,18,18,0,0,11
275032,sukhindriyassa,sukhindriyassa,12,12,0,0,14
275033,pītisamuṭṭhānapaṇītarūpaphuṭakāyassa,pitisamutthanapanitarupaphutakayassa,4,4,0,0,36
275034,V1.0160,V1.0160,34,34,0,0,7
275035,niruddhāti,niruddhati,18,15,3,0,10
275036,catutthajjhānupacāre,catutthajjhanupacare,7,7,0,0,20
275037,somanassindriyassa,somanassindriyassa,10,10,0,0,18
275038,appanāppattāya,appanappattaya,14,13,1,0,14
275039,anatikkantattā,anatikkantatta,9,9,0,0,14
275040,etthuppannaṃ,etthuppannam,49,49,0,0,12
275041,aparisesaggahaṇaṃ,aparisesaggahanam,7,7,0,0,17
275042,jhānassupacāre,jhanassupacare,3,3,0,0,14
275043,pahīnāpi,pahinapi,13,13,0,0,8
275044,adukkhamasukhanti,adukkhamasukhanti,6,5,1,0,17
275045,duviññeyyā,duvinneyya,14,13,1,0,10
275046,asakkuṇeyyassa,asakkuneyyassa,16,16,0,0,14
275047,athekekaṃ,athekekam,5,5,0,0,9
275048,samāhari,samahari,7,7,0,0,8
275049,gāhayituṃ,gahayitum,9,7,2,0,9
275050,cetovimuttiyā,cetovimuttiya,162,159,3,0,13
275051,paccayadassanatthañcāpi,paccayadassanatthancapi,5,5,0,0,23
275052,dukkhappahānādayo,dukkhappahanadayo,4,2,2,0,17
275053,khvāvuso,khvavuso,7,7,0,0,8
275054,sakkāyadiṭṭhiādayo,sakkayaditthiadayo,10,10,0,0,18
275055,tatiyamaggassa,tatiyamaggassa,9,9,0,0,14
275056,pahīnāti,pahinati,98,78,20,0,8
275057,vaṇṇabhaṇanatthampetassa,vannabhananatthampetassa,5,5,0,0,24
275058,jhānassetā,jhanasseta,5,5,0,0,10
275059,paccayaghātena,paccayaghatena,14,14,0,0,14
275060,rāgadosānamatidūrabhāvaṃ,ragadosanamatidurabhavam,1,1,0,0,24
275061,dassetumpetā,dassetumpeta,5,5,0,0,12
275062,sukhādighātena,sukhadighatena,5,5,0,0,14
275063,hatāti,hatati,23,18,5,0,6
275064,dukkhābhāvena,dukkhabhavena,7,7,0,0,13
275065,adukkhaṃ,adukkham,14,11,3,0,8
275066,sukhābhāvena,sukhabhavena,7,7,0,0,12
275067,etenettha,etenettha,8,8,0,0,9
275068,dukkhasukhapaṭipakkhabhūtaṃ,dukkhasukhapatipakkhabhutam,3,3,0,0,27
275069,tatiyavedanaṃ,tatiyavedanam,5,5,0,0,13
275070,dukkhasukhābhāvamattaṃ,dukkhasukhabhavamattam,5,5,0,0,22
275071,tatiyavedanā,tatiyavedana,5,5,0,0,12
275072,V1.0161,V1.0161,34,34,0,0,7
275073,upekkhātipi,upekkhatipi,5,5,0,0,11
275074,iṭṭhāniṭṭhaviparītānubhavanalakkhaṇā,itthanitthaviparitanubhavanalakkhana,7,6,1,0,36
275075,majjhattarasā,majjhattarasa,6,4,2,0,13
275076,avibhūtapaccupaṭṭhānā,avibhutapaccupatthana,4,4,0,0,21
275077,sukhadukkhanirodhapadaṭṭhānāti,sukhadukkhanirodhapadatthanati,1,1,0,0,30
275078,janitasatiyā,janitasatiya,2,2,0,0,12
275079,pārisuddhiṃ,parisuddhim,121,110,11,0,11
275080,suparisuddhā,suparisuddha,18,16,2,0,12
275081,pariyodātā,pariyodata,36,35,1,0,10
275082,upekkhāsatipārisuddhī,upekkhasatiparisuddhi,5,5,0,0,21
275083,tatramajjhattatātiveditabbā,tatramajjhattatativeditabba,1,1,0,0,27
275084,satisīsena,satisisena,27,27,0,0,10
275085,sūriyappabhābhibhavā,suriyappabhabhibhava,6,6,0,0,20
275086,sommabhāvena,sommabhavena,12,10,2,0,12
275087,sabhāgāya,sabhagaya,31,29,2,0,9
275088,vijjamānāpi,vijjamanapi,34,34,0,0,11
275089,apariyodātā,apariyodata,6,6,0,0,11
275090,tatramajjhattupekkhācandalekhā,tatramajjhattupekkhacandalekha,10,10,0,0,30
275091,vitakkādipaccanīkadhammatejābhibhavā,vitakkadipaccanikadhammatejabhibhava,4,4,0,0,36
275092,upekkhāvedanārattiyā,upekkhavedanarattiya,9,9,0,0,20
275093,appaṭilābhā,appatilabha,2,2,0,0,11
275094,paṭhamādijjhānabhedesu,pathamadijjhanabhedesu,3,3,0,0,22
275095,aparisuddhāya,aparisuddhaya,24,23,1,0,13
275096,aparisuddhacandalekhāya,aparisuddhacandalekhaya,5,5,0,0,23
275097,satiādayo,satiadayo,18,18,0,0,9
275098,aparisuddhāva,aparisuddhava,6,6,0,0,13
275099,vitakkādipaccanīkadhammatejābhibhavābhāvā,vitakkadipaccanikadhammatejabhibhavabhava,4,4,0,0,41
275100,parisuddhacandalekhāya,parisuddhacandalekhaya,5,5,0,0,22
275101,purimajavanesuyeva,purimajavanesuyeva,2,2,0,0,18
275102,cittassekaggatāti,cittassekaggatati,3,2,1,0,17
275103,catukkajjhāne,catukkajjhane,1,1,0,0,13
275104,pañcakajjhānakathā,pancakajjhanakatha,1,1,0,0,18
275105,pañcakajjhānaṃ,pancakajjhanam,1,1,0,0,14
275106,V1.0162,V1.0162,34,34,0,0,7
275107,nibbattentena,nibbattentena,8,8,0,0,13
275108,vitakkamattaṃ,vitakkamattam,2,2,0,0,13
275109,vicārādayo,vicaradayo,2,2,0,0,10
275110,santaṅgapaṭilābhāya,santangapatilabhaya,4,4,0,0,19
275111,vitakkamattameva,vitakkamattameva,1,1,0,0,16
275112,vicārādīni,vicaradini,1,1,0,0,10
275113,samannāgataṅgāni,samannagatangani,2,2,0,0,16
275114,āsannavitakkapaccatthikā,asannavitakkapaccatthika,1,1,0,0,24
275115,vicāramattaṃ,vicaramattam,19,18,1,0,12
275116,pītiādīni,pitiadini,2,2,0,0,9
275117,vicāramattameva,vicaramattameva,1,1,0,0,15
275118,catukkanayassa,catukkanayassa,5,4,1,0,14
275119,dutiyañceva,dutiyanceva,2,1,1,0,11
275120,tatiyacatutthāni,tatiyacatutthani,19,18,1,0,16
275121,catutthapañcamāni,catutthapancamani,14,14,0,0,17
275122,paṭhamamevāti,pathamamevati,11,2,9,0,13
275123,sesakasiṇaniddeso,sesakasinaniddeso,3,3,0,0,17
275124,āpokasiṇakathā,apokasinakatha,1,1,0,0,14
275125,V1.0163,V1.0163,34,34,0,0,7
275126,pathavīkasiṇānantare,pathavikasinanantare,1,1,0,0,20
275127,āpokasiṇampi,apokasinampi,1,1,0,0,12
275128,bhāvetukāmena,bhavetukamena,26,25,1,0,13
275129,parañhi,paranhi,12,11,1,0,7
275130,visesamattameva,visesamattameva,24,24,0,0,15
275131,pubbekatādhikārassa,pubbekatadhikarassa,1,1,0,0,19
275132,loṇiyaṃ,loniyam,2,2,0,0,7
275133,cūḷasivattherassa,culasivattherassa,1,1,0,0,17
275134,vivittavāsaṃ,vivittavasam,3,3,0,0,12
275135,nāvamārūhitvā,navamaruhitva,1,1,0,0,13
275136,olokayato,olokayato,26,26,0,0,9
275137,akatādhikārena,akatadhikarena,2,2,0,0,14
275138,nīlapītalohitodātavaṇṇānamaññataravaṇṇaṃ,nilapitalohitodatavannanamannataravannam,1,1,0,0,40
275139,kuṇḍikaṃ,kundikam,15,14,1,0,8
275140,samatittikaṃ,samatittikam,27,19,8,0,12
275141,nissayasavaṇṇameva,nissayasavannameva,2,2,0,0,18
275142,salilantiādīsu,salilantiadisu,1,1,0,0,14
275143,āponāmesu,aponamesu,1,1,0,0,9
275144,pākaṭanāmavaseneva,pakatanamavaseneva,3,3,0,0,18
275145,nimittadvayaṃ,nimittadvayam,2,2,0,0,13
275146,calamānaṃ,calamanam,8,8,0,0,9
275147,pheṇapupphuḷakamissaṃ,phenapupphulakamissam,1,1,0,0,21
275148,V1.0164,V1.0164,34,34,0,0,7
275149,nipparipphandaṃ,nipparipphandam,3,2,1,0,15
275150,ṭhapitamaṇitālavaṇṭaṃ,thapitamanitalavantam,1,1,0,0,21
275151,maṇimayādāsamaṇḍalamiva,manimayadasamandalamiva,1,1,0,0,23
275152,upaṭṭhāneneva,upatthaneneva,2,2,0,0,13
275153,tejokasiṇakathā,tejokasinakatha,1,1,0,0,15
275154,bhāvetukāmenāpi,bhavetukamenapi,4,4,0,0,15
275155,tejasmiṃ,tejasmim,19,19,0,0,8
275156,dīpasikhāya,dipasikhaya,9,9,0,0,11
275157,pattapacanaṭṭhāne,pattapacanatthane,2,2,0,0,17
275158,davadāhe,davadahe,1,1,0,0,8
275159,cittaguttattherassa,cittaguttattherassa,2,2,0,0,19
275160,hāyasmato,hayasmato,3,3,0,0,9
275161,dhammassavanadivase,dhammassavanadivase,5,5,0,0,19
275162,dīpasikhaṃ,dipasikham,5,5,0,0,10
275163,karaṇavidhānaṃ,karanavidhanam,5,5,0,0,14
275164,siniddhāni,siniddhani,11,10,1,0,10
275165,sāradārūni,saradaruni,6,5,1,0,10
275166,sukkhāpetvā,sukkhapetva,41,40,1,0,11
275167,ghaṭikaṃ,ghatikam,32,27,5,0,8
275168,pattapacanākārena,pattapacanakarena,1,1,0,0,17
275169,ālimpetvā,alimpetva,8,8,0,0,9
275170,kaṭasārake,katasarake,11,9,2,0,10
275171,vidatthicaturaṅgulappamāṇaṃ,vidatthicaturangulappamanam,2,2,0,0,27
275172,tiṇakaṭṭhaṃ,tinakattham,6,5,1,0,11
275173,dhūmasikhaṃ,dhumasikham,1,1,0,0,11
275174,ghanajālāya,ghanajalaya,1,1,0,0,11
275175,vātiādivasena,vatiadivasena,1,1,0,0,13
275176,uṇhattavasena,unhattavasena,1,1,0,0,13
275177,hutāsanotiādīsu,hutasanotiadisu,1,1,0,0,15
275178,aggināmesu,agginamesu,1,1,0,0,10
275179,patanasadisaṃ,patanasadisam,2,1,1,0,13
275180,alātakhaṇḍaṃ,alatakhandam,1,1,0,0,12
275181,aṅgārapiṇḍo,angarapindo,1,1,0,0,11
275182,ṭhapitarattakambalakkhaṇḍaṃ,thapitarattakambalakkhandam,1,1,0,0,27
275183,suvaṇṇatālavaṇṭaṃ,suvannatalavantam,1,1,0,0,17
275184,kañcanatthambho,kancanatthambho,1,1,0,0,15
275185,vāyokasiṇakathā,vayokasinakatha,1,1,0,0,15
275186,V1.0165,V1.0165,34,34,0,0,7
275187,vāyusmiṃ,vayusmim,2,2,0,0,8
275188,diṭṭhavasena,ditthavasena,4,4,0,0,12
275189,phuṭṭhavasena,phutthavasena,3,3,0,0,13
275190,ucchaggaṃ,ucchaggam,10,8,2,0,9
275191,sameritaṃ,sameritam,3,2,1,0,9
275192,rukkhaggaṃ,rukkhaggam,1,1,0,0,10
275193,kesaggaṃ,kesaggam,2,2,0,0,8
275194,samasīsaṭṭhitaṃ,samasisatthitam,2,1,1,0,15
275195,ghanapattaṃ,ghanapattam,1,1,0,0,11
275196,ghanakesassa,ghanakesassa,1,1,0,0,12
275197,paharatī,paharati,2,2,0,0,8
275198,vātapānantarikāya,vatapanantarikaya,4,4,0,0,17
275199,bhittichiddena,bhittichiddena,3,3,0,0,14
275200,kāyappadesaṃ,kayappadesam,2,2,0,0,12
275201,vātamālutaanilādīsu,vatamalutaaniladisu,1,1,0,0,19
275202,vāyunāmesu,vayunamesu,1,1,0,0,10
275203,uggahanimittavaḍḍhanato,uggahanimittavaddhanato,1,1,0,0,23
275204,otāritamattassa,otaritamattassa,1,1,0,0,15
275205,usumavaṭṭisadisaṃ,usumavattisadisam,2,2,0,0,17
275206,nīlakasiṇakathā,nilakasinakatha,1,1,0,0,15
275207,nīlakasmiṃ,nilakasmim,1,1,0,0,10
275208,pupphasmiṃ,pupphasmim,18,17,1,0,10
275209,vatthasmiṃ,vatthasmim,9,9,0,0,10
275210,vaṇṇadhātuyā,vannadhatuya,16,14,2,0,12
275211,mālāgacchaṃ,malagaccham,8,4,4,0,11
275212,pūjāṭhānesu,pujathanesu,1,1,0,0,11
275213,pupphasantharaṃ,pupphasantharam,7,7,0,0,15
275214,nīlavatthamaṇīnaṃ,nilavatthamaninam,1,1,0,0,17
275215,nīluppalagirikaṇṇikādīni,niluppalagirikannikadini,1,1,0,0,24
275216,karaṇḍapaṭalaṃ,karandapatalam,3,1,2,0,14
275217,pattehiyeva,pattehiyeva,2,2,0,0,11
275218,santharitabbaṃ,santharitabbam,10,10,0,0,14
275219,bandhitabbaṃ,bandhitabbam,73,65,8,0,12
275220,kaṃsanīlapalāsanīlaañjananīlānaṃ,kamsanilapalasanilaanjananilanam,1,1,0,0,32
275221,kasiṇamaṇḍalaṃ,kasinamandalam,20,20,0,0,14
275222,paricchinditabbaṃ,paricchinditabbam,17,16,1,0,17
275223,pavattetabbo,pavattetabbo,43,41,2,0,12
275224,kesaradaṇḍakapattantarikādīni,kesaradandakapattantarikadini,1,1,0,0,29
275225,maṇitālavaṇṭasadisaṃ,manitalavantasadisam,1,1,0,0,20
275226,pītakasiṇakathā,pitakasinakatha,1,1,0,0,15
275227,pītakasiṇepi,pitakasinepi,1,1,0,0,12
275228,V1.0166,V1.0166,34,34,0,0,7
275229,pītakasmiṃ,pitakasmim,1,1,0,0,10
275230,pītavatthadhātūnaṃ,pitavatthadhatunam,1,1,0,0,18
275231,cittalapabbate,cittalapabbate,19,18,1,0,14
275232,pattaṅgapupphehi,pattangapupphehi,1,1,0,0,16
275233,āsanapūjaṃ,asanapujam,5,4,1,0,10
275234,āsanappamāṇaṃ,asanappamanam,1,1,0,0,13
275235,kaṇikārapupphādinā,kanikarapupphadina,1,1,0,0,18
275236,pītavatthena,pitavatthena,1,1,0,0,12
275237,nīlakasiṇe,nilakasine,6,6,0,0,10
275238,tādisamevāti,tadisamevati,61,49,12,0,12
275239,lohitakasiṇakathā,lohitakasinakatha,1,1,0,0,17
275240,lohitakasiṇepi,lohitakasinepi,1,1,0,0,14
275241,lohitakasmiṃ,lohitakasmim,1,1,0,0,12
275242,bandhujīvakādimālāgacchaṃ,bandhujivakadimalagaccham,1,1,0,0,25
275243,lohitakavatthamaṇidhātūnaṃ,lohitakavatthamanidhatunam,1,1,0,0,26
275244,jayasumanabandhujīvakarattakoraṇḍakādipupphehi,jayasumanabandhujivakarattakorandakadipupphehi,1,1,0,0,46
275245,rattavatthena,rattavatthena,1,1,0,0,13
275246,odātakasiṇakathā,odatakasinakatha,1,1,0,0,16
275247,odātakasiṇepi,odatakasinepi,1,1,0,0,13
275248,odātasmiṃ,odatasmim,1,1,0,0,9
275249,vassikasumanādipupphasantharaṃ,vassikasumanadipupphasantharam,1,1,0,0,30
275250,kumudapadumarāsiṃ,kumudapadumarasim,1,1,0,0,17
275251,odātavatthadhātūnaṃ,odatavatthadhatunam,1,1,0,0,19
275252,tipumaṇḍalarajatamaṇḍalacandamaṇḍalesupi,tipumandalarajatamandalacandamandalesupi,1,1,0,0,40
275253,odātapupphehi,odatapupphehi,1,1,0,0,13
275254,odātavatthena,odatavatthena,4,4,0,0,13
275255,ālokakasiṇakathā,alokakasinakatha,1,1,0,0,16
275256,V1.0167,V1.0167,34,34,0,0,7
275257,bhittichidde,bhittichidde,2,2,0,0,12
275258,tāḷacchidde,talacchidde,2,2,0,0,11
275259,bhittichiddādīnaṃ,bhittichiddadinam,1,1,0,0,17
275260,sūriyāloko,suriyaloko,5,5,0,0,10
275261,candāloko,candaloko,6,5,1,0,9
275262,ghanapaṇṇarukkhasākhantarena,ghanapannarukkhasakhantarena,1,1,0,0,28
275263,ghanasākhāmaṇḍapantarena,ghanasakhamandapantarena,1,1,0,0,24
275264,bhūmiyameva,bhumiyameva,2,2,0,0,11
275265,itarenāpi,itarenapi,4,4,0,0,9
275266,vuttappakāramobhāsamaṇḍalaṃ,vuttappakaramobhasamandalam,1,1,0,0,27
275267,ghaṭamukhaṃ,ghatamukham,2,1,1,0,11
275268,bhittimukhaṃ,bhittimukham,2,1,1,0,12
275269,dīpāloko,dipaloko,2,2,0,0,8
275270,idamitarehi,idamitarehi,1,1,0,0,11
275271,uṭṭhitamaṇḍalasadisameva,utthitamandalasadisameva,1,1,0,0,24
275272,ghanavippasannaālokapuñjasadisaṃ,ghanavippasannaalokapunjasadisam,1,1,0,0,32
275273,paricchinnākāsakasiṇakathā,paricchinnakasakasinakatha,1,1,0,0,26
275274,paricchinnākāsakasiṇepi,paricchinnakasakasinepi,1,1,0,0,23
275275,ākāsasmiṃ,akasasmim,1,1,0,0,9
275276,bhittichiddādīsu,bhittichiddadisu,1,1,0,0,16
275277,succhannamaṇḍape,succhannamandape,1,1,0,0,16
275278,cammakaṭasārakādīnaṃ,cammakatasarakadinam,1,1,0,0,20
275279,bhittichiddādibhedaṃ,bhittichiddadibhedam,1,1,0,0,20
275280,bhittipariyantādīhi,bhittipariyantadihi,2,2,0,0,19
275281,chiddasadisameva,chiddasadisameva,2,1,1,0,16
275282,vaḍḍhiyamānampi,vaddhiyamanampi,2,1,1,0,15
275283,paṭibhāganimittamākāsamaṇḍalameva,patibhaganimittamakasamandalameva,1,1,0,0,33
275284,vaḍḍhiyamānañca,vaddhiyamananca,1,1,0,0,15
275285,paricchinnākāsakasiṇaṃ,paricchinnakasakasinam,9,8,1,0,22
275286,sabbadhammadaso,sabbadhammadaso,1,1,0,0,15
275287,rūpāvacaramhi,rupavacaramhi,1,1,0,0,13
275288,catukkapañcakajjhānahetūni,catukkapancakajjhanahetuni,1,1,0,0,26
275289,V1.0168,V1.0168,34,34,0,0,7
275290,bhāvanānayamimaṃ,bhavananayamimam,2,2,0,0,16
275291,pakiṇṇakakathāpi,pakinnakakathapi,14,11,3,0,16
275292,pathavīkasiṇavasena,pathavikasinavasena,13,12,1,0,19
275293,hotītiādibhāvo,hotitiadibhavo,2,2,0,0,14
275294,ṭhānanisajjādikappanaṃ,thananisajjadikappanam,2,1,1,0,22
275295,parittaappamāṇanayena,parittaappamananayena,1,1,0,0,21
275296,abhibhāyatanapaṭilābhoti,abhibhayatanapatilabhoti,1,1,0,0,24
275297,āpokasiṇavasena,apokasinavasena,5,4,1,0,15
275298,ummujjananimmujjanaṃ,ummujjananimmujjanam,1,1,0,0,20
275299,udakavuṭṭhisamuppādanaṃ,udakavutthisamuppadanam,1,1,0,0,23
275300,nadīsamuddādinimmānaṃ,nadisamuddadinimmanam,1,1,0,0,21
275301,pathavīpabbatapāsādādīnaṃ,pathavipabbatapasadadinam,1,1,0,0,25
275302,kampananti,kampananti,3,3,0,0,10
275303,tejokasiṇavasena,tejokasinavasena,5,4,1,0,16
275304,aṅgāravuṭṭhisamuppādanaṃ,angaravutthisamuppadanam,1,1,0,0,24
275305,tejopariyādānaṃ,tejopariyadanam,1,1,0,0,15
275306,ḍahanasamatthatā,dahanasamatthata,2,2,0,0,16
275307,rūpadassanatthāya,rupadassanatthaya,4,4,0,0,17
275308,ālokakaraṇaṃ,alokakaranam,5,5,0,0,12
275309,parinibbānasamaye,parinibbanasamaye,23,23,0,0,17
275310,sarīrajjhāpananti,sarirajjhapananti,1,1,0,0,17
275311,vāyokasiṇavasena,vayokasinavasena,6,5,1,0,16
275312,vāyugatigamanaṃ,vayugatigamanam,2,1,1,0,15
275313,vātavuṭṭhisamuppādananti,vatavutthisamuppadananti,1,1,0,0,24
275314,nīlakasiṇavasena,nilakasinavasena,5,4,1,0,16
275315,nīlarūpanimmānaṃ,nilarupanimmanam,1,1,0,0,16
275316,andhakārakaraṇaṃ,andhakarakaranam,1,1,0,0,16
275317,suvaṇṇadubbaṇṇanayena,suvannadubbannanayena,2,2,0,0,21
275318,abhibhāyatanapaṭilābho,abhibhayatanapatilabho,3,3,0,0,22
275319,subhavimokkhādhigamoti,subhavimokkhadhigamoti,2,2,0,0,22
275320,pītakasiṇavasena,pitakasinavasena,4,3,1,0,16
275321,pītakarūpanimmānaṃ,pitakarupanimmanam,1,1,0,0,18
275322,adhimuccanā,adhimuccana,16,14,2,0,11
275323,subhavimokkhādhigamo,subhavimokkhadhigamo,1,1,0,0,20
275324,lohitakasiṇavasena,lohitakasinavasena,3,2,1,0,18
275325,lohitakarūpanimmānaṃ,lohitakarupanimmanam,1,1,0,0,20
275326,odātakasiṇavasena,odatakasinavasena,4,3,1,0,17
275327,V1.0169,V1.0169,34,34,0,0,7
275328,odātarūpanimmānaṃ,odatarupanimmanam,1,1,0,0,17
275329,dūrabhāvakaraṇaṃ,durabhavakaranam,2,2,0,0,16
275330,andhakāravidhamanaṃ,andhakaravidhamanam,4,4,0,0,19
275331,ālokakaraṇanti,alokakarananti,2,2,0,0,14
275332,ālokakasiṇavasena,alokakasinavasena,2,1,1,0,17
275333,sappabhārūpanimmānaṃ,sappabharupanimmanam,1,1,0,0,20
275334,rūpadassanatthaṃ,rupadassanattham,2,2,0,0,16
275335,ākāsakasiṇavasena,akasakasinavasena,4,3,1,0,17
275336,paṭicchannānaṃ,paticchannanam,3,3,0,0,14
275337,vivaṭakaraṇaṃ,vivatakaranam,3,3,0,0,13
275338,antopathavīpabbatādīsupi,antopathavipabbatadisupi,1,1,0,0,24
275339,iriyāpathakappanaṃ,iriyapathakappanam,4,3,1,0,18
275340,tirokuḍḍādīsu,tirokuddadisu,1,1,0,0,13
275341,asajjamānagamananti,asajjamanagamananti,1,1,0,0,19
275342,pathavīkasiṇameko,pathavikasinameko,18,18,0,0,17
275343,uddhamadhotiriyaṃ,uddhamadhotiriyam,2,2,0,0,17
275344,advayamappamāṇaṃ,advayamappamanam,1,1,0,0,16
275345,uparigaganatalābhimukhaṃ,uparigaganatalabhimukham,3,2,1,0,24
275346,adhoti,adhoti,53,7,46,0,6
275347,heṭṭhābhūmitalābhimukhaṃ,hetthabhumitalabhimukham,3,2,1,0,24
275348,khettamaṇḍalamiva,khettamandalamiva,4,4,0,0,17
275349,paricchinditaṃ,paricchinditam,1,1,0,0,14
275350,uddhameva,uddhameva,10,9,1,0,9
275351,ālokamiva,alokamiva,9,5,4,0,9
275352,rūpadassanakāmo,rupadassanakamo,9,5,4,0,15
275353,uddhamadhotiriyanti,uddhamadhotiriyanti,1,1,0,0,19
275354,aññabhāvānupagamanatthaṃ,annabhavanupagamanattham,9,5,4,0,24
275355,udakameva,udakameva,39,38,1,0,9
275356,pathavīkasiṇameva,pathavikasinameva,6,6,0,0,17
275357,kasiṇasambhedoti,kasinasambhedoti,5,3,2,0,16
275358,pharaṇaappamāṇavasena,pharanaappamanavasena,15,15,0,0,21
275359,sakalameva,sakalameva,44,42,2,0,10
275360,kammāvaraṇena,kammavaranena,29,28,1,0,13
275361,kilesāvaraṇena,kilesavaranena,22,21,1,0,14
275362,vipākāvaraṇena,vipakavaranena,25,23,2,0,14
275363,sammattanti,sammattanti,1,1,0,0,11
275364,tesamekassāpekakasiṇepi,tesamekassapekakasinepi,1,1,0,0,23
275365,ānantariyakammasamaṅgino,anantariyakammasamangino,1,1,0,0,24
275366,ubhatobyañjanakapaṇḍakā,ubhatobyanjanakapandaka,1,1,0,0,23
275367,ahetukadvihetukapaṭisandhikā,ahetukadvihetukapatisandhika,1,1,0,0,28
275368,saddhāvirahitā,saddhavirahita,5,4,1,0,14
275369,acchandikāti,acchandikati,9,1,8,0,12
275370,apaccanīkapaṭipadāyaṃ,apaccanikapatipadayam,2,1,1,0,21
275371,chandavirahitā,chandavirahita,1,1,0,0,14
275372,duppaññāti,duppannati,14,1,13,0,10
275373,lokiyalokuttarasammādiṭṭhiyā,lokiyalokuttarasammaditthiya,1,1,0,0,28
275374,V1.0170,V1.0170,34,34,0,0,7
275375,niyāmasaṅkhātaṃ,niyamasankhatam,1,1,0,0,15
275376,sammattasaṅkhātañca,sammattasankhatanca,1,1,0,0,19
275377,abhabbāti,abhabbati,9,7,2,0,9
275378,kasiṇeyeva,kasineyeva,1,1,0,0,10
275379,etesamekassapi,etesamekassapi,1,1,0,0,14
275380,vigatavipākāvaraṇenapi,vigatavipakavaranenapi,1,1,0,0,22
275381,kammāvaraṇañca,kammavarananca,1,1,0,0,14
275382,kilesāvaraṇañca,kilesavarananca,1,1,0,0,15
275383,saddhammassavanasappurisūpanissayādīhi,saddhammassavanasappurisupanissayadihi,1,1,0,0,38
275384,chandañca,chandanca,25,24,1,0,9
275385,kammaṭṭhānānuyoge,kammatthananuyoge,6,6,0,0,17
275386,asubhakammaṭṭhānaniddeso,asubhakammatthananiddeso,2,2,0,0,24
275387,uddhumātakādipadatthavaṇṇanā,uddhumatakadipadatthavannana,2,2,0,0,28
275388,kasiṇānantaramuddiṭṭhesu,kasinanantaramudditthesu,1,1,0,0,24
275389,V1.0171,V1.0171,34,34,0,0,7
275390,puḷavakaṃ,pulavakam,15,9,6,0,9
275391,aviññāṇakāsubhesu,avinnanakasubhesu,2,2,0,0,17
275392,yathānukkamaṃ,yathanukkamam,9,9,0,0,13
275393,uddhumātattā,uddhumatatta,6,6,0,0,12
275394,uddhumātameva,uddhumatameva,7,6,1,0,13
275395,paṭikkūlattā,patikkulatta,7,7,0,0,12
275396,uddhumātanti,uddhumatanti,6,6,0,0,12
275397,vinīlaṃ,vinilam,18,11,7,0,7
275398,viparibhinnanīlavaṇṇaṃ,viparibhinnanilavannam,3,3,0,0,22
275399,vinīlameva,vinilameva,9,8,1,0,10
275400,vinīlanti,vinilanti,9,8,1,0,9
275401,maṃsussadaṭṭhānesu,mamsussadatthanesu,7,7,0,0,18
275402,rattavaṇṇassa,rattavannassa,7,7,0,0,13
275403,pubbasannicayaṭṭhānesu,pubbasannicayatthanesu,7,7,0,0,22
275404,setavaṇṇassa,setavannassa,7,7,0,0,12
275405,nīlavaṇṇassa,nilavannassa,7,7,0,0,12
275406,nīlaṭṭhāne,nilatthane,4,4,0,0,10
275407,nīlasāṭakapārutasseva,nilasatakaparutasseva,7,7,0,0,21
275408,chavasarīrassetamadhivacanaṃ,chavasarirassetamadhivacanam,8,8,0,0,28
275409,paribhinnaṭṭhānesu,paribhinnatthanesu,5,4,1,0,18
275410,vipubbaṃ,vipubbam,7,7,0,0,8
275411,vipubbameva,vipubbameva,7,7,0,0,11
275412,vipubbanti,vipubbanti,7,7,0,0,10
275413,vicchiddaṃ,vicchiddam,4,4,0,0,10
275414,chindanena,chindanena,7,7,0,0,10
275415,apadhāritaṃ,apadharitam,5,4,1,0,11
275416,vicchiddameva,vicchiddameva,4,4,0,0,13
275417,vicchiddanti,vicchiddanti,4,4,0,0,12
275418,khāditanti,khaditanti,1,1,0,0,10
275419,vikkhāyitaṃ,vikkhayitam,4,4,0,0,11
275420,vikkhāyitameva,vikkhayitameva,4,4,0,0,14
275421,vikkhāyitanti,vikkhayitanti,5,5,0,0,13
275422,V1.0172,V1.0172,34,34,0,0,7
275423,vikkhittameva,vikkhittameva,4,4,0,0,13
275424,vikkhittanti,vikkhittanti,5,5,0,0,12
275425,hatañca,hatanca,4,4,0,0,7
275426,vikkhittakañcāti,vikkhittakancati,4,4,0,0,16
275427,kākapadākārena,kakapadakarena,5,5,0,0,14
275428,vikkhittassa,vikkhittassa,6,6,0,0,12
275429,paggharitalohitamakkhitassa,paggharitalohitamakkhitassa,4,4,0,0,27
275430,puḷavā,pulava,8,8,0,0,6
275431,kimayo,kimayo,23,23,0,0,6
275432,puḷave,pulave,5,5,0,0,6
275433,kimiparipuṇṇassa,kimiparipunnassa,4,4,0,0,16
275434,aṭṭhiyeva,atthiyeva,5,5,0,0,9
275435,aṭṭhisaṅkhalikāyapi,atthisankhalikayapi,4,4,0,0,19
275436,ekaṭṭhikassapetamadhivacanaṃ,ekatthikassapetamadhivacanam,1,1,0,0,28
275437,uppannanimittānampi,uppannanimittanampi,3,3,0,0,19
275438,nimittesu,nimittesu,24,23,1,0,9
275439,paṭiladdhajjhānānampetāneva,patiladdhajjhananampetaneva,1,1,0,0,27
275440,uddhumātakakammaṭṭhānaṃ,uddhumatakakammatthanam,2,2,0,0,23
275441,uddhumātakasarīre,uddhumatakasarire,2,2,0,0,17
275442,uddhumātakanimittaṃ,uddhumatakanimittam,2,2,0,0,19
275443,uddhumātakasaṅkhātaṃ,uddhumatakasankhatam,1,1,0,0,20
275444,asubhanimittatthāya,asubhanimittatthaya,1,1,0,0,19
275445,gamanavidhānaṃ,gamanavidhanam,4,3,1,0,14
275446,nimittupalakkhaṇaṃ,nimittupalakkhanam,2,2,0,0,18
275447,ekādasavidhena,ekadasavidhena,23,23,0,0,14
275448,gatāgatamaggapaccavekkhaṇanti,gatagatamaggapaccavekkhananti,1,1,0,0,29
275449,appanāvidhānapariyosānaṃ,appanavidhanapariyosanam,2,1,1,0,24
275450,pariyesantena,pariyesantena,12,12,0,0,13
275451,aṭavimukhe,atavimukhe,16,16,0,0,10
275452,uddhumātakasarīraṃ,uddhumatakasariram,2,2,0,0,18
275453,V1.0173,V1.0173,34,34,0,0,7
275454,pakkhandantena,pakkhandantena,2,1,1,0,14
275455,asubhaṃ,asubham,89,79,10,0,7
275456,vāḷamigādhiṭṭhitampi,valamigadhitthitampi,1,1,0,0,20
275457,amanussādhiṭṭhitampi,amanussadhitthitampi,1,1,0,0,20
275458,jīvitantarāyopi,jivitantarayopi,3,3,0,0,15
275459,gamanamaggo,gamanamaggo,14,14,0,0,11
275460,gāmadvārena,gamadvarena,12,12,0,0,11
275461,nahānatitthena,nahanatitthena,1,1,0,0,14
275462,kedārakoṭiyā,kedarakotiya,1,1,0,0,12
275463,visabhāgaṃ,visabhagam,11,7,4,0,10
275464,itthisarīraṃ,itthisariram,3,3,0,0,12
275465,purisasarīraṃ,purisasariram,2,2,0,0,13
275466,adhunāmataṃ,adhunamatam,2,1,1,0,11
275467,subhatopi,subhatopi,1,1,0,0,9
275468,brahmacariyantarāyopi,brahmacariyantarayopi,1,1,0,0,21
275469,takkayamānena,takkayamanena,1,1,0,0,13
275470,abhiññātassa,abhinnatassa,5,5,0,0,12
275471,amanussasīhabyagghādīnaṃ,amanussasihabyagghadinam,1,1,0,0,24
275472,rūpasaddādianiṭṭhārammaṇābhibhūtassa,rupasaddadianittharammanabhibhutassa,1,1,0,0,36
275473,pavedhenti,pavedhenti,7,7,0,0,10
275474,parisaṇṭhāti,parisanthati,1,1,0,0,12
275475,paṭijaggissati,patijaggissati,3,3,0,0,14
275476,nirāsaṅkaṭṭhānanti,nirasankatthananti,1,1,0,0,18
275477,katakammāpi,katakammapi,2,2,0,0,11
275478,akatakammāpi,akatakammapi,2,2,0,0,12
275479,anubaddhā,anubaddha,14,14,0,0,9
275480,sahoḍḍhaṃ,sahoddham,11,10,1,0,9
275481,addasāmā,addasama,4,4,0,0,8
275482,viheṭhenti,vihethenti,17,17,0,0,10
275483,viheṭhayittha,vihethayittha,4,4,0,0,13
275484,mamāyaṃ,mamayam,9,8,1,0,7
275485,sotthibhāvaṃ,sotthibhavam,35,35,0,0,12
275486,asubhanimittadassane,asubhanimittadassane,1,1,0,0,20
275487,sañjātābhilāsena,sanjatabhilasena,1,1,0,0,16
275488,abhisekaṭṭhānaṃ,abhisekatthanam,3,3,0,0,15
275489,yaññasālaṃ,yannasalam,6,6,0,0,10
275490,nidhiṭṭhānaṃ,nidhitthanam,15,15,0,0,12
275491,upaṭṭhitāya,upatthitaya,29,28,1,0,11
275492,antogatehi,antogatehi,8,7,1,0,10
275493,abahigatena,abahigatena,5,5,0,0,11
275494,gatāgatamaggaṃ,gatagatamaggam,2,2,0,0,14
275495,paccavekkhamāno,paccavekkhamano,196,194,2,0,15
275496,sārammaṇaṃ,sarammanam,132,126,6,0,10
275497,sabhāvabhāvato,sabhavabhavato,4,4,0,0,14
275498,liṅgatopi,lingatopi,3,3,0,0,9
275499,disatopi,disatopi,2,2,0,0,8
275500,okāsatopi,okasatopi,15,15,0,0,9
275501,paricchedatopi,paricchedatopi,1,1,0,0,14
275502,sandhito,sandhito,14,13,1,0,8
275503,vivarato,vivarato,4,3,1,0,8
275504,ninnato,ninnato,3,2,1,0,7
275505,thalato,thalato,6,5,1,0,7
275506,V1.0174,V1.0174,34,34,0,0,7
275507,caṅkamantopi,cankamantopi,13,13,0,0,12
275508,tabbhāgiyaññeva,tabbhagiyanneva,2,2,0,0,15
275509,nisīdantopi,nisidantopi,9,9,0,0,11
275510,nimittupalakkhaṇā,nimittupalakkhana,4,4,0,0,17
275511,kimānisaṃsāti,kimanisamsati,2,2,0,0,13
275512,asammohatthā,asammohattha,3,3,0,0,12
275513,asammohānisaṃsā,asammohanisamsa,1,1,0,0,15
275514,kimatthiyo,kimatthiyo,17,15,2,0,10
275515,kimānisaṃsoti,kimanisamsoti,1,1,0,0,13
275516,upanibandhanattho,upanibandhanattho,2,2,0,0,17
275517,upanibandhanānisaṃso,upanibandhananisamso,1,1,0,0,20
275518,gatāgatamaggapaccavekkhaṇā,gatagatamaggapaccavekkhana,4,3,1,0,26
275519,vīthisampaṭipādanatthā,vithisampatipadanattha,3,2,1,0,22
275520,vīthisampaṭipādanānisaṃsā,vithisampatipadananisamsa,1,1,0,0,25
275521,parimuccissāmī,parimuccissami,4,4,0,0,14
275522,tassādhigataṃ,tassadhigatam,1,1,0,0,13
275523,bhāvanāmayañca,bhavanamayanca,1,1,0,0,14
275524,puññakiriyavatthuṃ,punnakiriyavatthum,28,28,0,0,18
275525,cittasaññattatthāya,cittasannattatthaya,1,1,0,0,19
275526,sivathikadassanaṃ,sivathikadassanam,4,4,0,0,17
275527,ghaṇḍiṃ,ghandim,8,8,0,0,7
275528,sannipātetvāpi,sannipatetvapi,1,1,0,0,14
275529,kammaṭṭhānasīsena,kammatthanasisena,26,23,3,0,17
275530,adutiyena,adutiyena,7,7,0,0,9
275531,avissajjetvā,avissajjetva,40,36,4,0,12
275532,manasikaronteneva,manasikaronteneva,3,3,0,0,17
275533,soṇādiparissayavinodanatthaṃ,sonadiparissayavinodanattham,1,1,0,0,28
275534,sūpaṭṭhita,supatthita,1,1,0,0,10
275535,bhāvasampādanena,bhavasampadanena,1,1,0,0,16
275536,asammuṭṭhaṃ,asammuttham,3,3,0,0,11
275537,manacchaṭṭhānañca,manacchatthananca,1,1,0,0,17
275538,antogatabhāvasampādanato,antogatabhavasampadanato,1,1,0,0,24
275539,abahigatamanena,abahigatamanena,1,1,0,0,15
275540,nikkhamanteneva,nikkhamanteneva,2,2,0,0,15
275541,asukadisāya,asukadisaya,9,8,1,0,11
275542,asukadvārena,asukadvarena,3,3,0,0,12
275543,nikkhantomhīti,nikkhantomhiti,3,3,0,0,14
275544,vavatthapetabbo,vavatthapetabbo,20,19,1,0,15
275545,pācinadisābhimukho,pacinadisabhimukho,1,1,0,0,18
275546,pacchimauttaradakkhiṇadisābhimukho,pacchimauttaradakkhinadisabhimukho,2,2,0,0,34
275547,vidisābhimukhovāti,vidisabhimukhovati,1,1,0,0,18
275548,V1.0175,V1.0175,34,34,0,0,7
275549,latāti,latati,13,5,8,0,6
275550,gamanamaggaṃ,gamanamaggam,22,21,1,0,12
275551,vavatthapentena,vavatthapentena,4,4,0,0,15
275552,nimittaṭṭhānaṃ,nimittatthanam,3,2,1,0,14
275553,kuṇapagandho,kunapagandho,6,5,1,0,12
275554,saṅkhobheyya,sankhobheyya,1,1,0,0,12
275555,chaḍḍāpeyya,chaddapeyya,13,10,3,0,11
275556,kuṇapaṭṭhānaṃ,kunapatthanam,1,1,0,0,13
275557,anuvātamaggena,anuvatamaggena,1,1,0,0,14
275558,kaṇṭakaṭṭhānaṃ,kantakatthanam,8,3,5,0,14
275559,cīvarakaṇṇena,civarakannena,8,8,0,0,13
275560,gamanavattaṃ,gamanavattam,1,1,0,0,12
275561,paṭivātānuvātañca,pativatanuvatanca,1,1,0,0,17
275562,kuṇapagandhena,kunapagandhena,4,4,0,0,14
275563,ubbāḷhassa,ubbalhassa,1,1,0,0,10
275564,nātianuvāte,natianuvate,1,1,0,0,11
275565,tiṭṭhamānenāpi,titthamanenapi,1,1,0,0,14
275566,nānupādaṃ,nanupadam,1,1,0,0,9
275567,nānusīsaṃ,nanusisam,1,1,0,0,9
275568,bhayamuppajjati,bhayamuppajjati,1,1,0,0,15
275569,anupādaṃ,anupadam,2,1,1,0,8
275570,anusīsaṃ,anusisam,1,1,0,0,8
275571,sarīravemajjhabhāge,sariravemajjhabhage,1,1,0,0,19
275572,upalakkhetabbāni,upalakkhetabbani,1,1,0,0,16
275573,upalakkhaṇavidhānaṃ,upalakkhanavidhanam,1,1,0,0,19
275574,kacchako,kacchako,5,5,0,0,8
275575,V1.0176,V1.0176,34,34,0,0,7
275576,sindivā,sindiva,1,1,0,0,7
275577,kaṇavīro,kanaviro,1,1,0,0,8
275578,kuraṇḍako,kurandako,2,2,0,0,9
275579,kāḷavalli,kalavalli,2,2,0,0,9
275580,vavatthapento,vavatthapento,11,10,1,0,13
275581,pāsāṇoti,pasanoti,9,4,5,0,8
275582,samāsetvā,samasetva,15,14,1,0,9
275583,sārammaṇañca,sarammananca,19,19,0,0,12
275584,sabhāvabhāvo,sabhavabhavo,1,1,0,0,12
275585,uddhumātakabhāvo,uddhumatakabhavo,1,1,0,0,16
275586,vaṇitaṃ,vanitam,2,1,1,0,7
275587,uddhumātakanti,uddhumatakanti,2,2,0,0,14
275588,vavatthapetabbanti,vavatthapetabbanti,3,3,0,0,18
275589,paricchedatopīti,paricchedatopiti,1,1,0,0,16
275590,chabbidhena,chabbidhena,51,49,2,0,11
275591,odātassa,odatassa,7,7,0,0,8
275592,maṅguracchavino,manguracchavino,1,1,0,0,15
275593,avavatthapetvā,avavatthapetva,4,4,0,0,14
275594,uddhumātakassa,uddhumatakassa,3,3,0,0,14
275595,saṇṭhānavaseneva,santhanavaseneva,2,2,0,0,16
275596,sīsasaṇṭhānaṃ,sisasanthanam,1,1,0,0,13
275597,gīvāsaṇṭhānaṃ,givasanthanam,1,1,0,0,13
275598,hatthasaṇṭhānaṃ,hatthasanthanam,1,1,0,0,15
275599,udarasaṇṭhānaṃ,udarasanthanam,1,1,0,0,14
275600,nābhisaṇṭhānaṃ,nabhisanthanam,1,1,0,0,14
275601,kaṭisaṇṭhānaṃ,katisanthanam,1,1,0,0,13
275602,ūrusaṇṭhānaṃ,urusanthanam,1,1,0,0,12
275603,jaṅghāsaṇṭhānaṃ,janghasanthanam,1,1,0,0,15
275604,pādasaṇṭhānanti,padasanthananti,1,1,0,0,15
275605,heṭṭhimadisā,hetthimadisa,2,2,0,0,12
275606,uparimadisāti,uparimadisati,1,1,0,0,13
275607,imissāti,imissati,9,7,2,0,8
275608,okāsato,okasato,141,134,7,0,7
275609,majjhimakāyo,majjhimakayo,8,7,1,0,12
275610,V1.0177,V1.0177,34,34,0,0,7
275611,pādatalena,padatalena,5,5,0,0,10
275612,kesamatthakena,kesamatthakena,1,1,0,0,14
275613,yathāparicchinne,yathaparicchinne,15,14,1,0,16
275614,dvattiṃsakuṇapabharitamevāti,dvattimsakunapabharitamevati,1,1,0,0,28
275615,hatthaparicchedo,hatthaparicchedo,2,1,1,0,16
275616,pādaparicchedo,padaparicchedo,2,2,0,0,14
275617,sīsaparicchedo,sisaparicchedo,1,1,0,0,14
275618,majjhimakāyaparicchedoti,majjhimakayaparicchedoti,1,1,0,0,24
275619,tattakameva,tattakameva,30,26,4,0,11
275620,visabhāge,visabhage,14,12,2,0,9
275621,vipphandanasseva,vipphandanasseva,2,1,1,0,16
275622,ugghāṭitāpi,ugghatitapi,1,1,0,0,11
275623,sabhāgasarīreyeva,sabhagasarireyeva,1,1,0,0,17
275624,āsevitakammaṭṭhāno,asevitakammatthano,1,1,0,0,18
275625,parihatadhutaṅgo,parihatadhutango,2,1,1,0,16
275626,parimadditamahābhūto,parimadditamahabhuto,2,1,1,0,20
275627,pariggahitasaṅkhāro,pariggahitasankharo,3,2,1,0,19
275628,vavatthāpitanāmarūpo,vavatthapitanamarupo,2,1,1,0,20
275629,ugghāṭitasattasañño,ugghatitasattasanno,2,1,1,0,19
275630,katasamaṇadhammo,katasamanadhammo,2,1,1,0,16
275631,vāsitavāsano,vasitavasano,2,1,1,0,12
275632,sabījo,sabijo,2,1,1,0,6
275633,ñāṇuttaro,nanuttaro,13,12,1,0,9
275634,olokitolokitaṭṭhāneyeva,olokitolokitatthaneyeva,1,1,0,0,23
275635,sandhitoti,sandhitoti,2,0,2,0,10
275636,asītisatasandhito,asitisatasandhito,1,1,0,0,17
275637,asītisatasandhayo,asitisatasandhayo,5,5,0,0,17
275638,vavatthapessati,vavatthapessati,5,5,0,0,15
275639,dakkhiṇahatthasandhī,dakkhinahatthasandhi,1,1,0,0,20
275640,vāmahatthasandhī,vamahatthasandhi,1,1,0,0,16
275641,dakkhiṇapādasandhī,dakkhinapadasandhi,1,1,0,0,18
275642,vāmapādasandhī,vamapadasandhi,1,1,0,0,14
275643,gīvasandhi,givasandhi,1,1,0,0,10
275644,kaṭisandhīti,katisandhiti,2,1,1,0,12
275645,cuddasamahāsandhivasena,cuddasamahasandhivasena,1,1,0,0,23
275646,vivaratoti,vivaratoti,1,0,1,0,10
275647,hatthantaraṃ,hatthantaram,2,1,1,0,12
275648,pādantaraṃ,padantaram,2,1,1,0,10
275649,udarantaraṃ,udarantaram,3,2,1,0,11
275650,kaṇṇantaranti,kannantaranti,1,1,0,0,13
275651,akkhīnampi,akkhinampi,1,1,0,0,10
275652,nimmīlitabhāvo,nimmilitabhavo,1,1,0,0,14
275653,ummīlitabhāvo,ummilitabhavo,1,1,0,0,13
275654,pihitabhāvo,pihitabhavo,1,1,0,0,11
275655,vivaṭabhāvo,vivatabhavo,1,1,0,0,11
275656,ninnatoti,ninnatoti,1,0,1,0,9
275657,akkhikūpo,akkhikupo,1,1,0,0,9
275658,antomukhaṃ,antomukham,5,5,0,0,10
275659,galavāṭako,galavatako,5,5,0,0,10
275660,unnateti,unnateti,1,1,0,0,8
275661,thalatoti,thalatoti,1,0,1,0,9
275662,unnataṭṭhānaṃ,unnatatthanam,4,3,1,0,13
275663,ninneti,ninneti,2,1,1,0,7
275664,udarapariyosānaṃ,udarapariyosanam,2,1,1,0,16
275665,V1.0178,V1.0178,34,34,0,0,7
275666,yathāvuttanimittaggāhavasena,yathavuttanimittaggahavasena,1,1,0,0,28
275667,upadhāretabbañceva,upadharetabbanceva,2,1,1,0,18
275668,vavatthapetabbañca,vavatthapetabbanca,1,1,0,0,18
275669,uddhumātakapaṭikkūlaṃ,uddhumatakapatikkulam,5,5,0,0,21
275670,nimmīletvā,nimmiletva,14,14,0,0,10
275671,āvajjentassa,avajjentassa,34,34,0,0,12
275672,bhāvanāpariyosānaṃ,bhavanapariyosanam,2,2,0,0,18
275673,senāsanameva,senasanameva,8,8,0,0,12
275674,āgamanamaggo,agamanamaggo,8,8,0,0,12
275675,nikkhantosmi,nikkhantosmi,4,4,0,0,12
275676,vidisābhimukho,vidisabhimukho,1,1,0,0,14
275677,caṅkamantenāpi,cankamantenapi,1,1,0,0,14
275678,tabbhāgiyova,tabbhagiyova,1,1,0,0,12
275679,adhiṭṭhātabbo,adhitthatabbo,34,33,1,0,13
275680,asubhanimittadisābhimukhe,asubhanimittadisabhimukhe,2,2,0,0,25
275681,caṅkamitabbanti,cankamitabbanti,1,1,0,0,15
275682,tabbhāgiyameva,tabbhagiyameva,1,1,0,0,14
275683,taṃdisābhimukhe,tamdisabhimukhe,1,1,0,0,15
275684,caṅkamituṃ,cankamitum,17,16,1,0,10
275685,anapalokentenāpi,anapalokentenapi,1,1,0,0,16
275686,okāsānurūpe,okasanurupe,1,1,0,0,11
275687,caṅkamitabbañceva,cankamitabbanceva,1,1,0,0,17
275688,nisīditabbañca,nisiditabbanca,5,5,0,0,14
275689,taṃdisābhimukhaṃyeva,tamdisabhimukhamyeva,1,1,0,0,20
275690,itiādipañhānaṃ,itiadipanhanam,3,3,0,0,14
275691,itiādivissajjane,itiadivissajjane,1,1,0,0,16
275692,V1.0179,V1.0179,34,34,0,0,7
275693,avelāyaṃ,avelayam,5,4,1,0,8
275694,uddhumātakanimittaṭṭhānaṃ,uddhumatakanimittatthanam,1,1,0,0,25
275695,nimittaggahaṇatthaṃ,nimittaggahanattham,1,1,0,0,19
275696,bheravārammaṇaṃ,bheravarammanam,17,16,1,0,15
275697,vibhattaaṭṭhatiṃsārammaṇesu,vibhattaatthatimsarammanesu,1,1,0,0,27
275698,jhānavibbhantako,jhanavibbhantako,3,3,0,0,16
275699,atibheravattā,atibheravatta,1,1,0,0,13
275700,santhambhetvā,santhambhetva,2,2,0,0,13
275701,anubandhanakaṃ,anubandhanakam,2,1,1,0,14
275702,upaṭṭhānākāro,upatthanakaro,11,11,0,0,13
275703,saññajo,sannajo,1,1,0,0,7
275704,saññāsambhavo,sannasambhavo,2,1,1,0,13
275705,sañcarāpetabbaṃ,sancarapetabbam,3,2,1,0,15
275706,visesamadhigacchati,visesamadhigacchati,13,13,0,0,19
275707,nimittaggāhaṃ,nimittaggaham,5,4,1,0,13
275708,olokanapaccayā,olokanapaccaya,1,1,0,0,14
275709,cārentassa,carentassa,9,9,0,0,10
275710,cārento,carento,7,7,0,0,7
275711,vīthisampaṭipādanatthāti,vithisampatipadanatthati,2,0,2,0,24
275712,gatamaggassa,gatamaggassa,5,5,0,0,12
275713,āgatamaggassa,agatamaggassa,2,2,0,0,13
275714,kammaṭṭhānavīthiyā,kammatthanavithiya,3,3,0,0,18
275715,sampaṭipādanatthāti,sampatipadanatthati,1,1,0,0,19
275716,katimīti,katimiti,5,2,3,0,8
275717,kammaṭṭhānikoti,kammatthanikoti,1,1,0,0,15
275718,tuṇhībhūtena,tunhibhutena,30,26,4,0,12
275719,vissajjetabbo,vissajjetabbo,22,21,1,0,13
275720,paṭisanthāro,patisantharo,42,31,11,0,12
275721,taruṇanimittaṃ,tarunanimittam,2,2,0,0,14
275722,nassantepi,nassantepi,2,2,0,0,10
275723,paṭisanthāropi,patisantharopi,1,1,0,0,14
275724,V1.0180,V1.0180,34,34,0,0,7
275725,āgantukapaṭisanthāro,agantukapatisantharo,2,1,1,0,20
275726,kātabbova,katabbova,9,9,0,0,9
275727,avasesānipi,avasesanipi,2,2,0,0,11
275728,cetiyaṅgaṇavattabodhiyaṅgaṇavattauposathāgāravattabhojanasālājantāgharaācariyupajjhāyaāgantukagamikavattādīni,cetiyanganavattabodhiyanganavattauposathagaravattabhojanasalajantagharaacariyupajjhayaagantukagamikavattadini,1,1,0,0,109
275729,pūretabbāneva,puretabbaneva,1,1,0,0,13
275730,pūrentassāpi,purentassapi,1,1,0,0,12
275731,gantukāmassāpi,gantukamassapi,1,1,0,0,14
275732,adhiṭṭhitattā,adhitthitatta,11,10,1,0,13
275733,susānampi,susanampi,5,5,0,0,9
275734,vinīlakādibhāvaṃ,vinilakadibhavam,2,2,0,0,16
275735,sabbakammaṭṭhānesu,sabbakammatthanesu,1,1,0,0,18
275736,rattiṭṭhāne,rattitthane,18,17,1,0,11
275737,divāṭhāne,divathane,4,4,0,0,9
275738,asukadisābhimukhaṃ,asukadisabhimukham,1,1,0,0,18
275739,vammikarukkhagacchalatānamaññataraṃ,vammikarukkhagacchalatanamannataram,1,1,0,0,35
275740,asukadisābhimukho,asukadisabhimukho,1,1,0,0,17
275741,susānato,susanato,8,8,0,0,8
275742,gatāgatamaggo,gatagatamaggo,1,1,0,0,13
275743,purimākāreneva,purimakareneva,4,4,0,0,14
275744,upanibandhatīti,upanibandhatiti,4,0,4,0,15
275745,uddhumātakapaṭikkūle,uddhumatakapatikkule,1,1,0,0,20
275746,ānisaṃsadassāvinā,anisamsadassavina,2,2,0,0,17
275747,mahagghamaṇiratanasadisaṃ,mahagghamaniratanasadisam,1,1,0,0,25
275748,catudhātukammaṭṭhāniko,catudhatukammatthaniko,1,1,0,0,22
275749,ānāpānakammaṭṭhāniko,anapanakammatthaniko,1,1,0,0,20
275750,kasiṇakammaṭṭhāniko,kasinakammatthaniko,1,1,0,0,19
275751,V1.0181,V1.0181,34,34,0,0,7
275752,ratanasaññinā,ratanasannina,1,1,0,0,13
275753,sampiyāyamānena,sampiyayamanena,2,2,0,0,15
275754,upanibandhitabbaṃ,upanibandhitabbam,2,2,0,0,17
275755,nimittadvayassa,nimittadvayassa,1,1,0,0,15
275756,bheravadassanaṃ,bheravadassanam,2,1,1,0,15
275757,thūlaṅgapaccaṅgapuriso,thulangapaccangapuriso,2,2,0,0,22
275758,paṭibhāganimittapaṭilābhasamakālameva,patibhaganimittapatilabhasamakalameva,3,3,0,0,37
275759,amanasikārā,amanasikara,151,147,4,0,11
275760,vikkhambhanavasena,vikkhambhanavasena,104,100,4,0,18
275761,anunayappahāneneva,anunayappahaneneva,1,1,0,0,18
275762,lohitappahānena,lohitappahanena,1,1,0,0,15
275763,byāpādopi,byapadopi,5,5,0,0,9
275764,āraddhavīriyatāya,araddhaviriyataya,6,6,0,0,17
275765,avippaṭisārakarasantadhammānuyogavasena,avippatisarakarasantadhammanuyogavasena,2,1,1,0,39
275766,adhigatavisesassa,adhigatavisesassa,5,5,0,0,17
275767,paccakkhatāya,paccakkhataya,7,7,0,0,13
275768,paṭipattidesake,patipattidesake,4,3,1,0,15
275769,paṭipattiphale,patipattiphale,7,7,0,0,14
275770,tasmiññeva,tasminneva,49,47,2,0,10
275771,nimittānumajjanakiccaṃ,nimittanumajjanakiccam,1,1,0,0,22
275772,sādhayamāno,sadhayamano,8,8,0,0,11
275773,paṭiladdhavisesādhigamapaccayā,patiladdhavisesadhigamapaccaya,2,1,1,0,30
275774,passaddhisambhavato,passaddhisambhavato,1,1,0,0,19
275775,sukhitassa,sukhitassa,9,9,0,0,10
275776,cittasamādhisambhavato,cittasamadhisambhavato,1,1,0,0,22
275777,sukhanimittā,sukhanimitta,2,1,1,0,12
275778,paṭhamajjhānapaṭibimbabhūtaṃ,pathamajjhanapatibimbabhutam,2,1,1,0,28
275779,upacārajjhānampi,upacarajjhanampi,5,5,0,0,16
275780,vasippatti,vasippatti,1,1,0,0,10
275781,vinīlakādikammaṭṭhānāni,vinilakadikammatthanani,1,1,0,0,23
275782,vinīlakādīsupi,vinilakadisupi,1,1,0,0,14
275783,uddhumātakapadamattaṃ,uddhumatakapadamattam,1,1,0,0,21
275784,savinicchayādhippāyaṃ,savinicchayadhippayam,2,1,1,0,21
275785,V1.0182,V1.0182,34,34,0,0,7
275786,vinīlake,vinilake,1,0,1,0,8
275787,vinīlakapaṭikkūlaṃ,vinilakapatikkulam,2,2,0,0,18
275788,uggahanimittañcettha,uggahanimittancettha,2,2,0,0,20
275789,kabarakabaravaṇṇaṃ,kabarakabaravannam,2,1,1,0,18
275790,vipubbake,vipubbake,1,0,1,0,9
275791,vipubbakapaṭikkūlaṃ,vipubbakapatikkulam,2,2,0,0,19
275792,paggharantamiva,paggharantamiva,1,1,0,0,15
275793,corāṭaviyaṃ,corataviyam,3,2,1,0,11
275794,chindāpenti,chindapenti,2,2,0,0,11
275795,sīhabyagghehi,sihabyagghehi,4,4,0,0,13
275796,chinnapurisaṭṭhāne,chinnapurisatthane,1,1,0,0,18
275797,nānādisāyaṃ,nanadisayam,2,1,1,0,11
275798,patitampi,patitampi,2,2,0,0,9
275799,parāmasitabbaṃ,paramasitabbam,5,5,0,0,14
275800,ārāmikena,aramikena,3,3,0,0,9
275801,ekaṅgulantaraṃ,ekangulantaram,1,1,0,0,14
275802,upanāmetvā,upanametva,31,31,0,0,10
275803,vicchiddakapaṭikkūlaṃ,vicchiddakapatikkulam,2,2,0,0,21
275804,vikkhāyitake,vikkhayitake,1,0,1,0,12
275805,vikkhāyitakapaṭikkūlaṃ,vikkhayitakapatikkulam,1,1,0,0,22
275806,vikkhāyitakapaṭikkūlanti,vikkhayitakapatikkulanti,1,1,0,0,24
275807,khāyitasadisameva,khayitasadisameva,1,1,0,0,17
275808,paripuṇṇaṃva,paripunnamva,2,2,0,0,12
275809,vikkhittaka,vikkhittaka,1,0,1,0,11
275810,vicchiddake,vicchiddake,2,2,0,0,11
275811,aṅgulaṅgulantaraṃ,angulangulantaram,3,2,1,0,17
275812,vikkhittakapaṭikkūlaṃ,vikkhittakapatikkulam,2,2,0,0,21
275813,pākaṭantaraṃ,pakatantaram,1,1,0,0,12
275814,hatavikkhittaka,hatavikkhittaka,1,0,1,0,15
275815,vuttappakāresuyeva,vuttappakaresuyeva,1,1,0,0,18
275816,hatavikkhittakapaṭikkūlaṃ,hatavikkhittakapatikkulam,2,2,0,0,25
275817,paññāyamānaṃ,pannayamanam,11,11,0,0,12
275818,pahāramukhaṃ,paharamukham,3,3,0,0,12
275819,V1.0183,V1.0183,34,34,0,0,7
275820,yuddhamaṇḍalādīsu,yuddhamandaladisu,1,1,0,0,17
275821,laddhappahārānaṃ,laddhappaharanam,3,2,1,0,16
275822,bhinnagaṇḍapīḷakādīnaṃ,bhinnagandapilakadinam,1,1,0,0,22
275823,paggharamānakāle,paggharamanakale,2,2,0,0,16
275824,lohitakapaṭikkūlaṃ,lohitakapatikkulam,2,2,0,0,18
275825,vātappahatā,vatappahata,2,2,0,0,11
275826,rattapaṭākā,rattapataka,1,1,0,0,11
275827,calamānākāraṃ,calamanakaram,1,1,0,0,13
275828,dvīhatīhaccayena,dvihatihaccayena,17,17,0,0,16
275829,kuṇapassa,kunapassa,5,5,0,0,9
275830,kimirāsipaggharaṇakāle,kimirasipaggharanakale,1,1,0,0,22
275831,soṇasiṅgālamanussagomahiṃsahatthiassaajagarādīnaṃ,sonasingalamanussagomahimsahatthiassaajagaradinam,1,1,0,0,49
275832,sarīrappamāṇameva,sarirappamanameva,1,1,0,0,17
275833,sālibhattarāsi,salibhattarasi,1,1,0,0,14
275834,puḷavakapaṭikkūlaṃ,pulavakapatikkulam,2,2,0,0,18
275835,kāḷadīghavāpiyā,kaladighavapiya,1,1,0,0,15
275836,hatthikuṇape,hatthikunape,4,4,0,0,12
275837,sālibhattapiṇḍo,salibhattapindo,1,1,0,0,15
275838,aṭṭhisaṅkhalikaṃ,atthisankhalikam,2,1,1,0,16
275839,nahārusambandhaṃ,naharusambandham,1,1,0,0,16
275840,pāsāṇādīnaṃ,pasanadinam,2,2,0,0,11
275841,upalakkhetvā,upalakkhetva,13,13,0,0,12
275842,vaṇṇādivasena,vannadivasena,23,23,0,0,13
275843,ekādasahākārehi,ekadasahakarehi,3,3,0,0,15
275844,setanti,setanti,2,2,0,0,7
275845,odātakasiṇasambhedo,odatakasinasambhedo,2,1,1,0,19
275846,paṭikkūlavaseneva,patikkulavaseneva,5,4,1,0,17
275847,hatthapādasīsaurabāhukaṭiūrujaṅghānaṃ,hatthapadasisaurabahukatiurujanghanam,1,1,0,0,37
275848,dīgharassavaṭṭacaturassakhuddakamahantavasena,digharassavattacaturassakhuddakamahantavasena,1,1,0,0,45
275849,disokāsā,disokasa,1,0,1,0,8
275850,pariyantavasena,pariyantavasena,2,2,0,0,15
275851,yadevettha,yadevettha,3,3,0,0,10
275852,pāpuṇitabbā,papunitabba,3,3,0,0,11
275853,ninnaṭṭhānathalaṭṭhānavasena,ninnatthanathalatthanavasena,1,1,0,0,28
275854,padesavasenāpi,padesavasenapi,1,1,0,0,14
275855,ninnetipi,ninnetipi,1,1,0,0,9
275856,aṭṭhikānaṃ,atthikanam,2,2,0,0,10
275857,ghaṭitaghaṭitaṭṭhānavasena,ghatitaghatitatthanavasena,1,1,0,0,26
275858,aṭṭhikānaṃyeva,atthikanamyeva,1,1,0,0,14
275859,antaravasena,antaravasena,2,2,0,0,12
275860,idamaṭṭhīti,idamatthiti,1,1,0,0,11
275861,anupaṭṭhahante,anupatthahante,12,12,0,0,14
275862,nalāṭaṭṭhimhi,nalatatthimhi,1,1,0,0,13
275863,saṇṭhapetabbaṃ,santhapetabbam,15,12,3,0,14
275864,V1.0184,V1.0184,34,34,0,0,7
275865,nimittaggahaṇaṃ,nimittaggahanam,7,7,0,0,15
275866,puḷavakādīsupi,pulavakadisupi,1,1,0,0,14
275867,aṭṭhikasaṅkhalikāya,atthikasankhalikaya,2,2,0,0,19
275868,aṭṭhikapaṭikkūlaṃ,atthikapatikkulam,2,2,0,0,17
275869,uggahanimittampi,uggahanimittampi,1,1,0,0,16
275870,paṭibhāganimittampi,patibhaganimittampi,6,6,0,0,19
275871,ekasadisameva,ekasadisameva,16,16,0,0,13
275872,paññāyamāne,pannayamane,10,10,0,0,11
275873,vivaratā,vivarata,1,1,0,0,8
275874,paripuṇṇabhāvo,paripunnabhavo,5,5,0,0,14
275875,ekaṭṭhikepi,ekatthikepi,2,1,1,0,11
275876,bībhacchena,bibhacchena,1,1,0,0,11
275877,paṭibhāganimittena,patibhaganimittena,1,1,0,0,18
275878,pītisomanassajanakena,pitisomanassajanakena,1,1,0,0,21
275879,upacārāvahattā,upacaravahatta,2,1,1,0,14
275880,sīmasambhedoyeva,simasambhedoyeva,1,1,0,0,16
275881,nibbikappaṃ,nibbikappam,3,2,1,0,11
275882,paṭikkūlabhāveyeva,patikkulabhaveyeva,6,5,1,0,18
275883,mahātissattherassa,mahatissattherassa,5,4,1,0,18
275884,dantaṭṭhikamattāvalokanena,dantatthikamattavalokanena,1,1,0,0,26
275885,sakalitthisarīrassa,sakalitthisarirassa,1,1,0,0,19
275886,aṭṭhisaṅghātabhāvena,atthisanghatabhavena,2,1,1,0,20
275887,upaṭṭhānādīni,upatthanadini,6,5,1,0,13
275888,subhaguṇo,subhaguno,2,2,0,0,9
275889,dasasatalocanena,dasasatalocanena,2,2,0,0,16
275890,thutakitti,thutakitti,2,2,0,0,10
275891,ekekajjhānahetunīti,ekekajjhanahetuniti,1,1,0,0,19
275892,adhigatajjhāno,adhigatajjhano,2,2,0,0,14
275893,suvikkhambhitarāgattā,suvikkhambhitaragatta,3,2,1,0,21
275894,nilloluppacāro,nilloluppacaro,2,2,0,0,14
275895,V1.0185,V1.0185,34,34,0,0,7
275896,asubhappabhedo,asubhappabhedo,5,5,0,0,14
275897,sarīrasabhāvappattivasena,sarirasabhavappattivasena,5,5,0,0,25
275898,rāgacaritabhedavasena,ragacaritabhedavasena,3,3,0,0,21
275899,chavasarīraṃ,chavasariram,7,7,0,0,12
275900,paṭikkūlabhāvaṃ,patikkulabhavam,5,5,0,0,15
275901,uddhumātakasabhāvappattaṃ,uddhumatakasabhavappattam,2,2,0,0,25
275902,vinīlakādīnaṃ,vinilakadinam,2,2,0,0,13
275903,aññatarasabhāvappattaṃ,annatarasabhavappattam,2,2,0,0,22
275904,vinīlakapaṭikkūlanti,vinilakapatikkulanti,1,1,0,0,20
275905,gaṇhitabbamevāti,ganhitabbamevati,2,2,0,0,16
275906,sarīrasaṇṭhānavipattippakāsanato,sarirasanthanavipattippakasanato,3,2,1,0,32
275907,saṇṭhānarāgino,santhanaragino,1,1,0,0,14
275908,chavirāgavipattippakāsanato,chaviragavipattippakasanato,2,2,0,0,27
275909,sarīravaṇṇarāgino,sariravannaragino,2,2,0,0,17
275910,kāyavaṇapaṭibaddhassa,kayavanapatibaddhassa,2,2,0,0,21
275911,duggandhabhāvassa,duggandhabhavassa,2,2,0,0,17
275912,mālāgandhādivasena,malagandhadivasena,2,2,0,0,18
275913,samuṭṭhāpitasarīragandharāgino,samutthapitasariragandharagino,2,2,0,0,30
275914,antosusirabhāvappakāsanato,antosusirabhavappakasanato,2,2,0,0,26
275915,ghanabhāvarāgino,ghanabhavaragino,2,2,0,0,16
275916,maṃsupacayasampattivināsappakāsanato,mamsupacayasampattivinasappakasanato,1,1,0,0,36
275917,thanādīsu,thanadisu,2,2,0,0,9
275918,sarīrappadesesu,sarirappadesesu,2,2,0,0,15
275919,maṃsupacayarāgino,mamsupacayaragino,1,1,0,0,17
275920,vikkhepappakāsanato,vikkhepappakasanato,2,2,0,0,19
275921,aṅgapaccaṅgalīlārāgino,angapaccangalilaragino,3,2,1,0,22
275922,sarīrasaṅghātabhedavikārappakāsanato,sarirasanghatabhedavikarappakasanato,1,1,0,0,36
275923,sarīrasaṅghātasampattirāgino,sarirasanghatasampattiragino,1,1,0,0,28
275924,lohitamakkhitapaṭikkūlabhāvappakāsanato,lohitamakkhitapatikkulabhavappakasanato,1,1,0,0,39
275925,alaṅkārajanitasobharāgino,alankarajanitasobharagino,2,2,0,0,25
275926,anekakimikulasādhāraṇabhāvappakāsanato,anekakimikulasadharanabhavappakasanato,2,2,0,0,38
275927,mamattarāgino,mamattaragino,2,2,0,0,13
275928,sarīraṭṭhīnaṃ,sariratthinam,2,2,0,0,13
275929,paṭikkūlabhāvappakāsanato,patikkulabhavappakasanato,1,1,0,0,25
275930,dantasampattirāgino,dantasampattiragino,2,2,0,0,19
275931,rāgacaritabhedavasenāpi,ragacaritabhedavasenapi,1,1,0,0,23
275932,dasavidhepi,dasavidhepi,3,3,0,0,11
275933,aparisaṇṭhitajalāya,aparisanthitajalaya,3,3,0,0,19
275934,sīghasotāya,sighasotaya,21,21,0,0,11
275935,arittabaleneva,arittabaleneva,4,4,0,0,14
275936,arittena,arittena,14,14,0,0,8
275937,paṭhamajjhānamevettha,pathamajjhanamevettha,4,4,0,0,21
275938,dutiyādīni,dutiyadini,34,33,1,0,10
275939,paṭikkūlepi,patikkulepi,5,4,1,0,11
275940,evamānisaṃsadassāvitāya,evamanisamsadassavitaya,1,1,0,0,23
275941,nīvaraṇasantāpappahānena,nivaranasantapappahanena,2,2,0,0,24
275942,labhissāmī,labhissami,150,150,0,0,10
275943,pupphachaḍḍakassa,pupphachaddakassa,3,3,0,0,17
275944,gūtharāsimhi,gutharasimhi,13,13,0,0,12
275945,ussannabyādhidukkhassa,ussannabyadhidukkhassa,2,2,0,0,22
275946,vamanavirecanappavattiyaṃ,vamanavirecanappavattiyam,3,3,0,0,25
275947,dasavidhampi,dasavidhampi,28,26,2,0,12
275948,V1.0186,V1.0186,34,34,0,0,7
275949,dasavidhassāpi,dasavidhassapi,5,5,0,0,14
275950,hetassa,hetassa,5,5,0,0,7
275951,asuciduggandhajegucchapaṭikkūlabhāvo,asuciduggandhajegucchapatikkulabhavo,1,1,0,0,36
275952,dantaṭṭhikadassāvino,dantatthikadassavino,2,2,0,0,20
275953,cetiyapabbatavāsino,cetiyapabbatavasino,3,3,0,0,19
275954,saṅgharakkhitattherūpaṭṭhākasāmaṇerassa,sangharakkhitattherupatthakasamanerassa,1,1,0,0,39
275955,jīvamānakasarīrepi,jivamanakasarirepi,5,5,0,0,18
275956,jīvamānakampi,jivamanakampi,2,2,0,0,13
275957,asubhameva,asubhameva,3,3,0,0,10
275958,asubhalakkhaṇaṃ,asubhalakkhanam,4,3,1,0,15
275959,atirekatisataaṭṭhikasamussayaṃ,atirekatisataatthikasamussayam,4,3,1,0,30
275960,asītisatasandhisaṅghaṭitaṃ,asitisatasandhisanghatitam,2,2,0,0,26
275961,navanhārusatanibandhanaṃ,navanharusatanibandhanam,1,1,0,0,24
275962,navamaṃsapesisatānulittaṃ,navamamsapesisatanulittam,1,1,0,0,25
275963,allacammapariyonaddhaṃ,allacammapariyonaddham,1,1,0,0,22
275964,medakathālikā,medakathalika,8,7,1,0,13
275965,niccuggharitapaggharitaṃ,niccuggharitapaggharitam,2,1,1,0,24
275966,kimisaṅghanisevitaṃ,kimisanghanisevitam,3,2,1,0,19
275967,paribhinnapurāṇagaṇḍo,paribhinnapuranagando,1,1,0,0,21
275968,satatavissandanaṃ,satatavissandanam,1,1,0,0,17
275969,kaṇṇabilehi,kannabilehi,1,1,0,0,11
275970,nāsāpuṭehi,nasaputehi,1,1,0,0,10
275971,āhārapittasemharudhirāni,aharapittasemharudhirani,1,1,0,0,24
275972,adhodvārehi,adhodvarehi,1,1,0,0,11
275973,uccārapassāvā,uccarapassava,6,5,1,0,13
275974,navanavutiyā,navanavutiya,8,6,2,0,12
275975,lomakūpasahassehi,lomakupasahassehi,1,1,0,0,17
275976,asucisedayūso,asucisedayuso,1,1,0,0,13
275977,nīlamakkhikādayo,nilamakkhikadayo,1,1,0,0,16
275978,dantakaṭṭhamukhadhovanasīsamakkhananahānanivāsanapārupanādīhi,dantakatthamukhadhovanasisamakkhananahananivasanaparupanadihi,1,1,0,0,61
275979,appaṭijaggitvā,appatijaggitva,2,2,0,0,14
275980,yathājātova,yathajatova,1,1,0,0,11
275981,pharusavippakiṇṇakeso,pharusavippakinnakeso,1,1,0,0,21
275982,pupphachaḍḍakacaṇḍālādīsu,pupphachaddakacandaladisu,1,1,0,0,25
275983,samasarīrapaṭikkūlatāya,samasarirapatikkulataya,1,1,0,0,23
275984,nibbiseso,nibbiseso,6,6,0,0,9
275985,asuciduggandhajegucchapaṭikkūlatāya,asuciduggandhajegucchapatikkulataya,1,1,0,0,35
275986,dantakaṭṭhamukhadhovanādīhi,dantakatthamukhadhovanadihi,1,1,0,0,27
275987,dantamalādīni,dantamaladini,1,1,0,0,13
275988,nānāvatthehi,nanavatthehi,1,1,0,0,12
275989,nānāvaṇṇena,nanavannena,8,8,0,0,11
275990,surabhivilepanena,surabhivilepanena,2,2,0,0,17
275991,vilimpitvā,vilimpitva,22,22,0,0,10
275992,pupphābharaṇādīhi,pupphabharanadihi,1,1,0,0,17
275993,gahetabbākārappattaṃ,gahetabbakarappattam,1,1,0,0,20
275994,yāthāvasarasaṃ,yathavasarasam,4,3,1,0,14
275995,asañjānantā,asanjananta,2,2,0,0,11
275996,rajjitabbakayuttaṭṭhānaṃ,rajjitabbakayuttatthanam,1,1,0,0,24
275997,kesalomanakhadantakheḷasiṅghāṇikauccārapassāvādīsu,kesalomanakhadantakhelasinghanikauccarapassavadisu,1,1,0,0,50
275998,ekakoṭṭhāsampi,ekakotthasampi,7,7,0,0,14
275999,chupitumpi,chupitumpi,1,1,0,0,10
276000,aṭṭīyanti,attiyanti,6,6,0,0,9
276001,paṭikkūlampi,patikkulampi,1,1,0,0,12
276002,avijjandhakārapariyonaddhā,avijjandhakarapariyonaddha,1,1,0,0,26
276003,attasineharāgarattā,attasineharagaratta,2,1,1,0,19
276004,kiṃsukarukkhaṃ,kimsukarukkham,5,5,0,0,14
276005,apatitapupphaṃ,apatitapuppham,1,1,0,0,14
276006,maṃsapesī,mamsapesi,13,12,1,0,9
276007,vihaññamānena,vihannamanena,1,1,0,0,13
276008,jarasiṅgālena,jarasingalena,2,2,0,0,13
276009,V1.0187,V1.0187,34,34,0,0,7
276010,kiṃsukaṃ,kimsukam,23,21,2,0,8
276011,maṃsarukkho,mamsarukkho,1,1,0,0,11
276012,atilolupo,atilolupo,1,1,0,0,9
276013,rukkhasminti,rukkhasminti,1,1,0,0,12
276014,patitaṃyeva,patitamyeva,1,1,0,0,11
276015,asubhanti,asubhanti,28,28,0,0,9
276016,aggahetvāna,aggahetvana,2,2,0,0,11
276017,sarīraṭṭhampi,sariratthampi,1,1,0,0,13
276018,parimuccare,parimuccare,2,2,0,0,11
276019,pūtikāyassa,putikayassa,10,10,0,0,11
276020,subhabhāvena,subhabhavena,4,4,0,0,12
276021,ukkarūpamo,ukkarupamo,2,2,0,0,10
276022,cakkhubhūtehi,cakkhubhutehi,4,4,0,0,13
276023,bālābhinandito,balabhinandito,2,2,0,0,14
276024,allacammapaṭicchanno,allacammapaticchanno,4,4,0,0,20
276025,pūtigandhiyo,putigandhiyo,2,2,0,0,12
276026,soṇe,sone,6,6,0,0,4
276027,dabbajātikena,dabbajatikena,1,1,0,0,13
276028,jīvamānasarīraṃ,jivamanasariram,1,1,0,0,15
276029,V1.0188,V1.0188,34,34,0,0,7
276030,asubhākāro,asubhakaro,2,2,0,0,10
276031,pāpetabbanti,papetabbanti,2,2,0,0,12
276032,chaanussatiniddeso,chaanussatiniddeso,3,3,0,0,18
276033,buddhānussatikathā,buddhanussatikatha,1,1,0,0,18
276034,asubhānantaraṃ,asubhanantaram,2,1,1,0,14
276035,V1.0189,V1.0189,34,34,0,0,7
276036,uddiṭṭhāsu,udditthasu,1,1,0,0,10
276037,pavattitabbaṭṭhānamhiyeva,pavattitabbatthanamhiyeva,5,5,0,0,25
276038,saddhāpabbajitassa,saddhapabbajitassa,17,17,0,0,18
276039,satītipi,satitipi,4,4,0,0,8
276040,buddhaguṇārammaṇāya,buddhagunarammanaya,5,4,1,0,19
276041,etamadhivacanaṃ,etamadhivacanam,14,13,1,0,15
276042,svākkhātatādidhammaguṇārammaṇāya,svakkhatatadidhammagunarammanaya,4,4,0,0,32
276043,suppaṭipannatādisaṅghaguṇārammaṇāya,suppatipannatadisanghagunarammanaya,4,4,0,0,35
276044,akhaṇḍatādisīlaguṇārammaṇāya,akhandatadisilagunarammanaya,5,5,0,0,28
276045,muttacāgatādicāgaguṇārammaṇāya,muttacagatadicagagunarammanaya,5,5,0,0,30
276046,sakkhiṭṭhāne,sakkhitthane,19,15,4,0,12
276047,saddhādiguṇārammaṇāya,saddhadigunarammanaya,5,5,0,0,21
276048,jīvitindriyupacchedārammaṇāya,jivitindriyupacchedarammanaya,2,2,0,0,29
276049,kesādibhedaṃ,kesadibhedam,3,3,0,0,12
276050,kāyagatasatīti,kayagatasatiti,1,1,0,0,14
276051,kesādikāyakoṭṭhāsanimittārammaṇāya,kesadikayakotthasanimittarammanaya,2,2,0,0,34
276052,ānāpāne,anapane,26,25,1,0,7
276053,assāsapassāsanimittārammaṇāya,assasapassasanimittarammanaya,2,2,0,0,29
276054,upasamaṃ,upasamam,40,31,9,0,8
276055,sabbadukkhūpasamārammaṇāya,sabbadukkhupasamarammanaya,4,4,0,0,26
276056,aveccappasādasamannāgatena,aveccappasadasamannagatena,1,1,0,0,26
276057,patirūpasenāsane,patirupasenasane,1,1,0,0,16
276058,rahogatena,rahogatena,21,20,1,0,10
276059,paṭisallīnena,patisallinena,20,20,0,0,13
276060,V1.0190,V1.0190,34,34,0,0,7
276061,anussaritabbā,anussaritabba,8,7,1,0,13
276062,anussaraṇanayo,anussarananayo,1,1,0,0,14
276063,arānañca,arananca,19,19,0,0,8
276064,rahābhāvāti,rahabhavati,13,12,1,0,11
276065,suvidūravidūre,suviduravidure,18,16,2,0,14
276066,viddhaṃsitattāti,viddhamsitattati,5,4,1,0,16
276067,yenāsamaṅgitā,yenasamangita,5,5,0,0,13
276068,asamaṅgī,asamangi,5,5,0,0,8
276069,hatattāpi,hatattapi,9,7,2,0,9
276070,avijjābhavataṇhāmayanābhi,avijjabhavatanhamayanabhi,3,3,0,0,25
276071,jarāmaraṇanemi,jaramarananemi,6,6,0,0,14
276072,arānaṃ,aranam,42,32,10,0,6
276073,saṃsāracakkanti,samsaracakkanti,5,5,0,0,15
276074,anamataggaṃ,anamataggam,6,4,2,0,11
276075,saṃsāravaṭṭaṃ,samsaravattam,15,14,1,0,13
276076,pariyosānattā,pariyosanatta,11,11,0,0,13
276077,avijjāmūlakattā,avijjamulakatta,6,3,3,0,15
276078,jarāmaraṇapariyantattā,jaramaranapariyantatta,4,2,2,0,22
276079,dukkhādīsu,dukkhadisu,66,62,4,0,10
276080,V1.0191,V1.0191,34,34,0,0,7
276081,nāmasseva,namasseva,8,7,1,0,9
276082,chabbidhassa,chabbidhassa,11,9,2,0,12
276083,phassānaṃ,phassanam,56,47,9,0,9
276084,taṇhākāyassa,tanhakayassa,2,2,0,0,12
276085,upādānassa,upadanassa,147,143,4,0,10
276086,upādānādayo,upadanadayo,3,3,0,0,11
276087,bhavādīnaṃ,bhavadinam,8,7,1,0,10
276088,paribhuñjissāmīti,paribhunjissamiti,10,8,2,0,17
276089,kāmupādānapaccayā,kamupadanapaccaya,22,17,5,0,17
276090,duccaritapāripūriyā,duccaritaparipuriya,7,7,0,0,19
276091,upapattihetubhūtaṃ,upapattihetubhutam,11,11,0,0,18
276092,anubhavissāmīti,anubhavissamiti,4,4,0,0,15
276093,sucaritapāripūriyā,sucaritaparipuriya,7,7,0,0,18
276094,brahmalokasampattiṃ,brahmalokasampattim,6,3,3,0,19
276095,kāmupādānapaccayāeva,kamupadanapaccayaeva,1,1,0,0,20
276096,bhāvanāpāripūriyā,bhavanaparipuriya,24,24,0,0,17
276097,nibbattihetubhūtaṃ,nibbattihetubhutam,5,5,0,0,18
276098,ākāsānañcāyatanādisamāpattiyo,akasanancayatanadisamapattiyo,2,2,0,0,29
276099,V1.0192,V1.0192,34,34,0,0,7
276100,sesupādānamūlikāsupi,sesupadanamulikasupi,2,2,0,0,20
276101,yojanāsu,yojanasu,9,9,0,0,8
276102,hetusamuppannā,hetusamuppanna,20,17,3,0,14
276103,ubhopete,ubhopete,84,75,9,0,8
276104,hetusamuppannāti,hetusamuppannati,10,9,1,0,16
276105,paccayapariggahe,paccayapariggahe,56,51,5,0,16
276106,atītampi,atitampi,74,63,11,0,8
276107,dhammaṭṭhitiñāṇanti,dhammatthitinananti,6,5,1,0,19
276108,avijjāsaṅkhārā,avijjasankhara,27,24,3,0,14
276109,viññāṇanāmarūpasaḷāyatanaphassavedanā,vinnananamarupasalayatanaphassavedana,10,10,0,0,37
276110,taṇhupādānabhavā,tanhupadanabhava,16,13,3,0,16
276111,purimasaṅkhepo,purimasankhepo,4,2,2,0,14
276112,avijjāsaṅkhāraggahaṇena,avijjasankharaggahanena,3,3,0,0,23
276113,viññāṇādayo,vinnanadayo,29,28,1,0,11
276114,vipākavaṭṭaṃ,vipakavattam,18,15,3,0,12
276115,taṇhupādānabhavaggahaṇena,tanhupadanabhavaggahanena,5,5,0,0,25
276116,jātijarāmaraṇāpadesena,jatijaramaranapadesena,4,2,2,0,22
276117,saṅkhāraviññāṇānañcettha,sankharavinnananancettha,3,2,1,0,24
276118,vedanātaṇhānamantarā,vedanatanhanamantara,6,5,1,0,20
276119,bhavajātīnamantarā,bhavajatinamantara,6,5,1,0,18
276120,catusaṅkhepaṃ,catusankhepam,14,7,7,0,13
276121,vīsatākāraṃ,visatakaram,7,4,3,0,11
276122,tisandhiṃ,tisandhim,10,7,3,0,9
276123,ñātaṭṭhena,natatthena,84,83,1,0,10
276124,dhammaṭṭhitiñāṇena,dhammatthitinanena,8,7,1,0,18
276125,virajjanto,virajjanto,44,38,6,0,10
276126,vimuccanto,vimuccanto,15,10,5,0,10
276127,vihani,vihani,4,3,1,0,6
276128,pūjāvisesañca,pujavisesanca,5,5,0,0,13
276129,ratanadāmena,ratanadamena,6,6,0,0,12
276130,V1.0193,V1.0193,33,33,0,0,7
276131,parinibbutampi,parinibbutampi,8,8,0,0,14
276132,pūjāvisesānanti,pujavisesananti,4,4,0,0,15
276133,arahattāpi,arahattapi,6,3,3,0,10
276134,asilokabhayena,asilokabhayena,6,6,0,0,14
276135,rahābhāvatopi,rahabhavatopi,6,4,2,0,13
276136,rahābhāvena,rahabhavena,6,6,0,0,11
276137,abhiññeyyato,abhinneyyato,11,9,2,0,12
276138,pariññeyye,parinneyye,14,12,2,0,10
276139,pariññeyyato,parinneyyato,9,9,0,0,12
276140,pahātabbato,pahatabbato,16,16,0,0,11
276141,sacchikātabbe,sacchikatabbe,11,11,0,0,13
276142,sacchikātabbato,sacchikatabbato,8,8,0,0,15
276143,bhāvetabbato,bhavetabbato,17,17,0,0,12
276144,abhiññātaṃ,abhinnatam,47,45,2,0,10
276145,brāhmaṇāti,brahmanati,86,34,52,0,10
276146,V1.0194,V1.0194,33,33,0,0,7
276147,mūlakāraṇabhāvena,mulakaranabhavena,8,7,1,0,17
276148,purimataṇhā,purimatanha,20,18,2,0,11
276149,nirodhapajānanā,nirodhapajanana,14,14,0,0,15
276150,ekekapaduddhārenāpi,ekekapaduddharenapi,4,4,0,0,19
276151,sotaghānajivhākāyamanesu,sotaghanajivhakayamanesu,3,3,0,0,24
276152,cakkhuviññāṇādayo,cakkhuvinnanadayo,14,14,0,0,17
276153,chaviññāṇakāyā,chavinnanakaya,4,4,0,0,14
276154,cakkhusamphassādayo,cakkhusamphassadayo,22,22,0,0,19
276155,cakkhusamphassajādayo,cakkhusamphassajadayo,3,3,0,0,21
276156,rūpasaññādayo,rupasannadayo,5,5,0,0,13
276157,rūpasañcetanādayo,rupasancetanadayo,4,4,0,0,17
276158,rūpataṇhādayo,rupatanhadayo,11,9,2,0,13
276159,taṇhākāyā,tanhakaya,32,24,8,0,9
276160,rūpavitakkādayo,rupavitakkadayo,4,4,0,0,15
276161,rūpavicārādayo,rupavicaradayo,5,5,0,0,14
276162,vicārā,vicara,10,9,1,0,6
276163,rūpakkhandhādayo,rupakkhandhadayo,15,15,0,0,16
276164,uddhumātakasaññādivasena,uddhumatakasannadivasena,4,4,0,0,24
276165,dvattiṃsākārā,dvattimsakara,12,11,1,0,13
276166,kāmabhavādayo,kamabhavadayo,16,16,0,0,13
276167,mettābhāvanādayo,mettabhavanadayo,4,4,0,0,16
276168,jarāmaraṇādīni,jaramaranadini,5,5,0,0,14
276169,avijjādīni,avijjadini,7,7,0,0,10
276170,ekapadayojanā,ekapadayojana,6,6,0,0,13
276171,evamekekapaduddhārena,evamekekapaduddharena,1,1,0,0,21
276172,bhayabheravasutte,bhayabheravasutte,8,4,4,0,17
276173,manomayiddhiyā,manomayiddhiya,8,8,0,0,14
276174,rūpāvacarajjhānānīti,rupavacarajjhananiti,6,6,0,0,20
276175,majjhimapaṇṇāsake,majjhimapannasake,12,8,4,0,17
276176,vijjācaraṇasampannoti,vijjacaranasampannoti,11,4,7,0,21
276177,V1.0195,V1.0195,33,33,0,0,7
276178,vijjāsampadā,vijjasampada,9,6,3,0,12
276179,caraṇasampadā,caranasampada,8,6,2,0,13
276180,mahākāruṇikataṃ,mahakarunikatam,6,4,2,0,15
276181,mahākāruṇikatāya,mahakarunikataya,43,43,0,0,16
276182,duppaṭipannā,duppatipanna,10,10,0,0,12
276183,vijjācaraṇavipannānaṃ,vijjacaranavipannanam,1,1,0,0,21
276184,attantapādayo,attantapadayo,3,3,0,0,13
276185,sundarañcesa,sundarancesa,5,3,2,0,12
276186,gatattāpi,gatattapi,6,1,5,0,9
276187,apaccāgacchanto,apaccagacchanto,6,4,2,0,15
276188,samatiṃsapāramīpūrikāya,samatimsaparamipurikaya,2,2,0,0,23
276189,attakilamathanti,attakilamathanti,6,4,2,0,16
276190,gadattāpi,gadattapi,7,1,6,0,9
276191,sādhakasuttaṃ,sadhakasuttam,7,7,0,0,13
276192,anatthasañhitaṃ,anatthasanhitam,19,14,5,0,15
276193,atthasañhitaṃ,atthasanhitam,18,13,5,0,13
276194,viditalokattā,viditalokatta,13,8,5,0,13
276195,samudayato,samudayato,52,47,5,0,10
276196,V1.0196,V1.0196,34,34,0,0,7
276197,nirodhūpāyatoti,nirodhupayatoti,7,5,2,0,15
276198,apatvāva,apatvava,6,5,1,0,8
276199,antakiriyaṃ,antakiriyam,21,18,3,0,11
276200,imasmiññeva,imasminneva,34,33,1,0,11
276201,byāmamatte,byamamatte,23,21,2,0,10
276202,sasaññimhi,sasannimhi,17,13,4,0,10
276203,samanake,samanake,14,13,1,0,8
276204,lokasamudayañca,lokasamudayanca,12,12,0,0,15
276205,lokanirodhagāminiñca,lokanirodhagamininca,7,7,0,0,20
276206,lokassanto,lokassanto,7,7,0,0,10
276207,lokantaṃ,lokantam,11,11,0,0,8
276208,vūsitabrahmacariyo,vusitabrahmacariyo,7,6,1,0,18
276209,samitāvi,samitavi,8,8,0,0,8
276210,nāsīsati,nasisati,22,19,3,0,8
276211,parañcāti,parancati,7,5,2,0,9
276212,ajjhattikāni,ajjhattikani,95,85,10,0,12
276213,viññāṇaṭṭhitiyo,vinnanatthitiyo,81,67,14,0,15
276214,V1.0197,V1.0197,34,34,0,0,7
276215,sattāvāsā,sattavasa,47,40,7,0,9
276216,dasāyatanāni,dasayatanani,49,49,0,0,12
276217,saṅkhāralokopi,sankharalokopi,7,5,2,0,14
276218,adhimuttiṃ,adhimuttim,35,30,5,0,10
276219,apparajakkhe,apparajakkhe,42,38,4,0,12
276220,mahārajakkhe,maharajakkhe,34,34,0,0,12
276221,tikkhindriye,tikkhindriye,38,34,4,0,12
276222,mudindriye,mudindriye,33,33,0,0,10
276223,svākāre,svakare,34,30,4,0,7
276224,dvākāre,dvakare,30,30,0,0,7
276225,suviññāpaye,suvinnapaye,34,30,4,0,11
276226,duviññāpaye,duvinnapaye,32,32,0,0,11
276227,sattalokopi,sattalokopi,5,5,0,0,11
276228,okāsalokopi,okasalokopi,9,8,1,0,11
276229,catutiṃsasatāni,catutimsasatani,2,1,1,0,15
276230,sandhārako,sandharako,8,7,1,0,10
276231,saṭṭhiñceva,satthinceva,1,1,0,0,11
276232,V1.0198,V1.0198,34,34,0,0,7
276233,pabbatuttamo,pabbatuttamo,7,7,0,0,12
276234,upaḍḍhupaḍḍhena,upaddhupaddhena,6,6,0,0,15
276235,ajjhogāḷhuggatā,ajjhogalhuggata,5,5,0,0,15
276236,nānāratanacittitā,nanaratanacittita,5,5,0,0,17
276237,mahāselā,mahasela,5,5,0,0,8
276238,mahārājānamāvāsā,maharajanamavasa,8,8,0,0,16
276239,devayakkhanisevitā,devayakkhanisevita,5,5,0,0,18
276240,āyatavitthato,ayatavitthato,5,5,0,0,13
276241,tipañcayojanakkhandhaparikkhepā,tipancayojanakkhandhaparikkhepa,4,4,0,0,31
276242,nagavhayā,nagavhaya,6,6,0,0,9
276243,paññāsayojanakkhandhasākhāyāmā,pannasayojanakkhandhasakhayama,4,4,0,0,30
276244,satayojanavitthiṇṇā,satayojanavitthinna,6,4,2,0,19
276245,citrapāṭaliyā,citrapataliya,3,3,0,0,13
276246,simbalirukkhassa,simbalirukkhassa,4,4,0,0,16
276247,kadambassa,kadambassa,5,5,0,0,10
276248,pubbavidehe,pubbavidehe,13,13,0,0,11
276249,sirīsassa,sirisassa,7,7,0,0,9
276250,pāricchattakassāti,paricchattakassati,4,4,0,0,18
276251,sattamanti,sattamanti,4,4,0,0,10
276252,V1.0199,V1.0199,34,34,0,0,7
276253,cakkavāḷasiluccayo,cakkavalasiluccayo,9,8,1,0,18
276254,lokadhātumayaṃ,lokadhatumayam,6,4,2,0,14
276255,paññāsayojanaṃ,pannasayojanam,9,8,1,0,14
276256,dasasahassayojanaṃ,dasasahassayojanam,8,6,2,0,18
276257,asurabhavanaṃ,asurabhavanam,20,15,5,0,13
276258,avīcimahānirayo,avicimahanirayo,13,12,1,0,15
276259,aparagoyānaṃ,aparagoyanam,12,10,2,0,12
276260,sattasahassayojanaṃ,sattasahassayojanam,5,4,1,0,19
276261,pubbavidehaṃ,pubbavideham,9,9,0,0,12
276262,aṭṭhasahassayojanaṃ,atthasahassayojanam,1,1,0,0,19
276263,pañcasatapañcasataparittadīpaparivāro,pancasatapancasataparittadipaparivaro,4,4,0,0,37
276264,tadantaresu,tadantaresu,3,3,0,0,11
276265,lokantarikanirayā,lokantarikaniraya,8,8,0,0,17
276266,lokadhātuyo,lokadhatuyo,43,43,0,0,11
276267,buddhañāṇena,buddhananena,23,21,2,0,12
276268,visiṭṭhatarassa,visitthatarassa,5,5,0,0,15
276269,sīlaguṇenāpi,silagunenapi,5,4,1,0,12
276270,lokamabhibhavati,lokamabhibhavati,2,2,0,0,16
276271,samādhipaññāvimuttivimuttiñāṇadassanaguṇenāpi,samadhipannavimuttivimuttinanadassanagunenapi,1,1,0,0,45
276272,appaṭibhāgo,appatibhago,19,18,1,0,11
276273,vimuttiñāṇadassanaguṇenāpi,vimuttinanadassanagunenapi,3,3,0,0,26
276274,aggapasādasuttādīni,aggapasadasuttadini,2,2,0,0,19
276275,purisadammāti,purisadammati,4,1,3,0,13
276276,adantā,adanta,18,18,0,0,6
276277,tiracchānapurisāpi,tiracchanapurisapi,6,6,0,0,18
276278,manussapurisāpi,manussapurisapi,6,6,0,0,15
276279,amanussapurisāpi,amanussapurisapi,6,6,0,0,16
276280,apalālo,apalalo,4,3,1,0,7
276281,aggisikho,aggisikho,3,3,0,0,9
276282,dhanapālako,dhanapalako,8,8,0,0,11
276283,nibbisā,nibbisa,8,6,2,0,7
276284,saccakanigaṇṭhaputtaambaṭṭhamāṇavapokkharasāti,saccakaniganthaputtaambatthamanavapokkharasati,1,1,0,0,46
276285,soṇadantakūṭadantādayo,sonadantakutadantadayo,1,1,0,0,22
276286,āḷavakasūcilomakharalomayakkhasakkadevarājādayo,alavakasucilomakharalomayakkhasakkadevarajadayo,3,3,0,0,47
276287,V1.0200,V1.0200,33,33,0,0,7
276288,vicitrehi,vicitrehi,11,9,2,0,9
276289,vinayanūpāyehi,vinayanupayehi,5,5,0,0,14
276290,vinemī,vinemi,6,6,0,0,6
276291,visuddhasīlādīnaṃ,visuddhasiladinam,5,4,1,0,17
276292,paṭhamajjhānādīni,pathamajjhanadini,25,25,0,0,17
276293,sotāpannādīnañca,sotapannadinanca,6,6,0,0,16
276294,maggapaṭipadaṃ,maggapatipadam,1,1,0,0,14
276295,dantepi,dantepi,7,6,1,0,7
276296,dametiyeva,dametiyeva,3,3,0,0,10
276297,ekamevidaṃ,ekamevidam,10,9,1,0,10
276298,ekapallaṅkeneva,ekapallankeneva,5,3,2,0,15
276299,asajjamānā,asajjamana,29,29,0,0,10
276300,hatthidammo,hatthidammo,5,5,0,0,11
276301,corakantāraṃ,corakantaram,19,14,5,0,12
276302,vāḷakantāraṃ,valakantaram,16,13,3,0,12
276303,dubbhikkhakantāraṃ,dubbhikkhakantaram,6,4,2,0,18
276304,nirudakakantāraṃ,nirudakakantaram,8,7,1,0,16
276305,uttāreti,uttareti,9,9,0,0,8
276306,nittāreti,nittareti,7,7,0,0,9
276307,patāreti,patareti,9,9,0,0,8
276308,khemantabhūmiṃ,khemantabhumim,35,29,6,0,14
276309,jātikantāraṃ,jatikantaram,8,6,2,0,12
276310,tāretītiādinā,taretitiadina,1,1,0,0,13
276311,niddesanayenapettha,niddesanayenapettha,3,3,0,0,19
276312,bhabbapuggalaparicchedavasena,bhabbapuggalaparicchedavasena,2,2,0,0,29
276313,tiracchānagatānampi,tiracchanagatanampi,19,19,0,0,19
276314,anusāsanippadānena,anusasanippadanena,2,2,0,0,18
276315,satthāyeva,satthayeva,4,4,0,0,10
276316,dhammassavanena,dhammassavanena,19,19,0,0,15
276317,upanissayasampattiṃ,upanissayasampattim,34,32,2,0,19
276318,upanissayasampattiyā,upanissayasampattiya,28,28,0,0,20
276319,maṇḍūkadevaputtādayo,mandukadevaputtadayo,2,2,0,0,20
276320,campānagaravāsīnaṃ,campanagaravasinam,2,2,0,0,18
276321,vacchapālako,vacchapalako,5,5,0,0,12
276322,accharāsaṅghaparivutaṃ,accharasanghaparivutam,4,4,0,0,22
276323,kammamakāsiṃ,kammamakasim,3,3,0,0,12
276324,V1.0201,V1.0201,32,32,0,0,7
276325,nimittaggāhā,nimittaggaha,3,3,0,0,12
276326,jānantova,janantova,38,35,3,0,9
276327,maṇḍūkohaṃ,mandukoham,7,4,3,0,10
276328,vārigocaro,varigocaro,14,11,3,0,10
276329,vacchapālakoti,vacchapalakoti,4,1,3,0,14
276330,vimokkhantikaññāṇavasena,vimokkhantikannanavasena,1,1,0,0,24
276331,viññāpanatthaṃ,vinnapanattham,17,17,0,0,14
276332,niddesanayo,niddesanayo,5,5,0,0,11
276333,paṭisambhidānayo,patisambhidanayo,4,2,2,0,16
276334,guṇavisiṭṭhasabbasattuttamagarugāravādhivacanaṃ,gunavisitthasabbasattuttamagarugaravadhivacanam,3,2,1,0,47
276335,vacanamuttamaṃ,vacanamuttamam,20,14,6,0,14
276336,garugāravayutto,garugaravayutto,4,4,0,0,15
276337,āvatthikaṃ,avatthikam,12,7,5,0,10
276338,liṅgikaṃ,lingikam,13,8,5,0,8
276339,nemittikaṃ,nemittikam,16,11,5,0,10
276340,adhiccasamuppannanti,adhiccasamuppannanti,6,6,0,0,20
276341,adhiccasamuppannaṃ,adhiccasamuppannam,80,68,12,0,18
276342,lokiyavohārena,lokiyavoharena,6,6,0,0,14
276343,yadicchakanti,yadicchakanti,1,1,0,0,13
276344,balībaddoti,balibaddoti,1,1,0,0,11
276345,dhanavaḍḍhakoti,dhanavaddhakoti,4,4,0,0,15
276346,V1.0202,V1.0202,32,32,0,0,7
276347,suddhodanamahārājena,suddhodanamaharajena,9,9,0,0,20
276348,ñātisahassehi,natisahassehi,4,4,0,0,13
276349,sakkasantusitādīhi,sakkasantusitadihi,4,4,0,0,18
276350,bhagī,bhagi,12,8,4,0,5
276351,bhagganti,bhagganti,5,5,0,0,9
276352,ñāyehi,nayehi,7,7,0,0,6
276353,subhāvitattano,subhavitattano,6,6,0,0,14
276354,bhavantago,bhavantago,8,5,3,0,10
276355,bhagehi,bhagehi,20,19,1,0,7
276356,vaṇṇavipariyayotiādikaṃ,vannavipariyayotiadikam,1,1,0,0,23
276357,pisodarādipakkhepalakkhaṇaṃ,pisodaradipakkhepalakkhanam,7,4,3,0,27
276358,lokiyalokuttarasukhābhinibbattakaṃ,lokiyalokuttarasukhabhinibbattakam,4,4,0,0,34
276359,dānasīlādipārappattaṃ,danasiladiparappattam,4,4,0,0,21
276360,bhāgyamassa,bhagyamassa,6,6,0,0,11
276361,bhāgyavāti,bhagyavati,2,2,0,0,10
276362,ahirikānottappakodhūpanāhamakkhapaḷāsaissāmacchariyamāyāsāṭheyyathambhasārambhamānātimānamadapamādataṇhāavijjā,ahirikanottappakodhupanahamakkhapalasaissamacchariyamayasatheyyathambhasarambhamanatimanamadapamadatanhaavijja,1,1,0,0,110
276363,tividhākusalamūladuccaritasaṃkilesamalavisamasaññāvitakkapapañcacatubbidhavipariyesa,tividhakusalamuladuccaritasamkilesamalavisamasannavitakkapapancacatubbidhavipariyesa,1,1,0,0,84
276364,āsavaganthaoghayogaagatitaṇhuppādupādānapañcacetokhīlavinibandhanīvaraṇābhinandanā,asavaganthaoghayogaagatitanhuppadupadanapancacetokhilavinibandhanivaranabhinandana,1,1,0,0,82
276365,chavivādamūlataṇhākāyasattānusayaaṭṭhamicchattanavataṇhāmūlakadasākusalakammapathadvāsaṭṭhidiṭṭhigata,chavivadamulatanhakayasattanusayaatthamicchattanavatanhamulakadasakusalakammapathadvasatthiditthigata,1,1,0,0,101
276366,aṭṭhasatataṇhāvicaritappabhedasabbadarathapariḷāhakilesasatasahassāni,atthasatatanhavicaritappabhedasabbadarathaparilahakilesasatasahassani,2,2,0,0,69
276367,V1.0203,V1.0203,33,33,0,0,7
276368,kilesakhandhaabhisaṅkhāradevaputtamaccumāre,kilesakhandhaabhisankharadevaputtamaccumare,2,2,0,0,43
276369,bhaggattā,bhaggatta,8,6,2,0,9
276370,bhaggavāti,bhaggavati,7,4,3,0,10
276371,bhaggāssa,bhaggassa,4,4,0,0,9
276372,bhāgyavatāya,bhagyavataya,3,3,0,0,12
276373,satapuññalakkhaṇadharassa,satapunnalakkhanadharassa,3,3,0,0,25
276374,rūpakāyasampatti,rupakayasampatti,7,5,2,0,16
276375,bhaggadosatāya,bhaggadosataya,8,8,0,0,14
276376,dhammakāyasampatti,dhammakayasampatti,6,5,1,0,18
276377,lokiyasarikkhakānaṃ,lokiyasarikkhakanam,5,4,1,0,19
276378,bahumatabhāvo,bahumatabhavo,11,10,1,0,13
276379,gahaṭṭhapabbajitehi,gahatthapabbajitehi,11,10,1,0,19
276380,abhigamanīyatā,abhigamaniyata,6,5,1,0,14
276381,abhigatānañca,abhigatananca,7,6,1,0,13
276382,kāyacittadukkhāpanayane,kayacittadukkhapanayane,6,5,1,0,23
276383,paṭibalabhāvo,patibalabhavo,7,6,1,0,13
276384,āmisadānadhammadānehi,amisadanadhammadanehi,11,9,2,0,21
276385,upakāritā,upakarita,11,9,2,0,9
276386,lokiyalokuttarasukhehi,lokiyalokuttarasukhehi,7,5,2,0,22
276387,saṃyojanasamatthatā,samyojanasamatthata,6,4,2,0,19
276388,issariyadhammayasasirikāmapayattesu,issariyadhammayasasirikamapayattesu,3,3,0,0,35
276389,bhagasaddo,bhagasaddo,5,5,0,0,10
276390,paramañcassa,paramancassa,4,4,0,0,12
276391,aṇimālaṅghimādikaṃ,animalanghimadikam,2,2,0,0,18
276392,lokiyasammataṃ,lokiyasammatam,6,5,1,0,14
276393,lokattayabyāpako,lokattayabyapako,8,6,2,0,16
276394,rūpakāyadassanabyāvaṭajananayanappasādajananasamatthā,rupakayadassanabyavatajananayanappasadajananasamattha,3,3,0,0,53
276395,sabbākāraparipūrā,sabbakaraparipura,7,6,1,0,17
276396,sabbaṅgapaccaṅgasirī,sabbangapaccangasiri,4,3,1,0,20
276397,abhinipphannattā,abhinipphannatta,5,5,0,0,16
276398,icchitatthanibbattisaññito,icchitatthanibbattisannito,1,1,0,0,26
276399,sabbalokagarubhāvappattihetubhūto,sabbalokagarubhavappattihetubhuto,4,4,0,0,33
276400,sammāvāyāmasaṅkhāto,sammavayamasankhato,7,5,2,0,19
276401,payatto,payatto,6,4,2,0,7
276402,yuttattāpi,yuttattapi,4,4,0,0,10
276403,kusalādīhi,kusaladihi,13,12,1,0,10
276404,khandhāyatanadhātusaccaindriyapaṭiccasamuppādādīhi,khandhayatanadhatusaccaindriyapaticcasamuppadadihi,4,4,0,0,50
276405,kusalādidhamme,kusaladidhamme,23,22,1,0,14
276406,pīḷanasaṅkhatasantāpavipariṇāmaṭṭhena,pilanasankhatasantapaviparinamatthena,6,4,2,0,37
276407,āyūhananidānasaṃyogapalibodhaṭṭhena,ayuhananidanasamyogapalibodhatthena,4,4,0,0,35
276408,nissaraṇavivekāsaṅkhataamataṭṭhena,nissaranavivekasankhataamatatthena,4,4,0,0,34
276409,niyyānikahetudassanādhipateyyaṭṭhena,niyyanikahetudassanadhipateyyatthena,3,3,0,0,36
276410,desitavāti,desitavati,4,4,0,0,10
276411,vibhattavāti,vibhattavati,3,1,2,0,12
276412,dibbabrahmaariyavihāre,dibbabrahmaariyavihare,5,5,0,0,22
276413,kāyacittaupadhiviveke,kayacittaupadhiviveke,7,7,0,0,21
276414,suññatappaṇihitānimittavimokkhe,sunnatappanihitanimittavimokkhe,3,3,0,0,31
276415,lokiyalokuttare,lokiyalokuttare,10,10,0,0,15
276416,uttarimanussadhamme,uttarimanussadhamme,39,38,1,0,19
276417,sevi,sevi,44,44,0,0,4
276418,bhattavāti,bhattavati,18,12,6,0,10
276419,V1.0204,V1.0204,33,33,0,0,7
276420,vantagamanoti,vantagamanoti,3,1,2,0,13
276421,bhavasaddato,bhavasaddato,5,5,0,0,12
276422,bhakāraṃ,bhakaram,7,7,0,0,8
276423,gamanasaddato,gamanasaddato,5,5,0,0,13
276424,gakāraṃ,gakaram,17,17,0,0,7
276425,vantasaddato,vantasaddato,5,5,0,0,12
276426,vakārañca,vakaranca,4,4,0,0,9
276427,rāgapariyuṭṭhitaṃ,ragapariyutthitam,57,54,3,0,17
276428,dosapariyuṭṭhitaṃ,dosapariyutthitam,36,36,0,0,17
276429,mohapariyuṭṭhitaṃ,mohapariyutthitam,49,49,0,0,17
276430,ujugatamevassa,ujugatamevassa,45,45,0,0,14
276431,tathāgatamārabbha,tathagatamarabbha,1,1,0,0,17
276432,rāgādipariyuṭṭhānābhāvena,ragadipariyutthanabhavena,3,3,0,0,25
276433,vikkhambhitanīvaraṇassa,vikkhambhitanivaranassa,8,8,0,0,23
276434,kammaṭṭhānābhimukhatāya,kammatthanabhimukhataya,1,1,0,0,23
276435,ujugatacittassa,ujugatacittassa,3,3,0,0,15
276436,buddhaguṇapoṇā,buddhagunapona,1,1,0,0,14
276437,anuvitakkayato,anuvitakkayato,8,8,0,0,14
276438,anuvicārayato,anuvicarayato,8,8,0,0,13
276439,pītipadaṭṭhānāya,pitipadatthanaya,1,1,0,0,16
276440,kāyacittadarathā,kayacittadaratha,2,2,0,0,16
276441,paṭippassambhanti,patippassambhanti,55,55,0,0,17
276442,passaddhadarathassa,passaddhadarathassa,2,2,0,0,19
276443,kāyikampi,kayikampi,15,13,2,0,9
276444,buddhaguṇārammaṇaṃ,buddhagunarammanam,4,4,0,0,18
276445,nānappakāraguṇānussaraṇādhimuttatāya,nanappakaragunanussaranadhimuttataya,6,6,0,0,36
276446,upacārappattameva,upacarappattameva,11,11,0,0,17
276447,buddhānussaticceva,buddhanussaticceva,1,1,0,0,18
276448,saddhāvepullaṃ,saddhavepullam,2,1,1,0,14
276449,sativepullaṃ,sativepullam,2,1,1,0,12
276450,paññāvepullaṃ,pannavepullam,7,6,1,0,13
276451,puññavepullañca,punnavepullanca,2,1,1,0,15
276452,pītipāmojjabahulo,pitipamojjabahulo,8,7,1,0,17
276453,bhayabheravasaho,bhayabheravasaho,14,12,2,0,16
276454,dukkhādhivāsanasamattho,dukkhadhivasanasamattho,4,3,1,0,23
276455,saṃvāsasaññaṃ,samvasasannam,4,3,1,0,13
276456,buddhaguṇānussatiyā,buddhagunanussatiya,1,1,0,0,19
276457,ajjhāvutthañcassa,ajjhavutthancassa,3,3,0,0,17
276458,cetiyagharamiva,cetiyagharamiva,2,2,0,0,15
276459,pūjārahaṃ,pujaraham,5,5,0,0,9
276460,buddhabhūmiyaṃ,buddhabhumiyam,8,7,1,0,14
276461,vītikkamitabbavatthusamāyoge,vitikkamitabbavatthusamayoge,3,3,0,0,28
276462,appaṭivijjhanto,appativijjhanto,23,23,0,0,15
276463,sugatiparāyano,sugatiparayano,11,11,0,0,14
276464,mahānubhāvāya,mahanubhavaya,8,8,0,0,13
276465,buddhānussatiyā,buddhanussatiya,28,28,0,0,15
276466,buddhānussatiyaṃ,buddhanussatiyam,10,8,2,0,16
276467,vitthārakathāmukhaṃ,vittharakathamukham,21,21,0,0,19
276468,dhammānussatikathā,dhammanussatikatha,1,1,0,0,18
276469,dhammānussatiṃ,dhammanussatim,10,8,2,0,14
276470,V1.0205,V1.0205,33,33,0,0,7
276471,navavidhassa,navavidhassa,14,14,0,0,12
276472,lokuttaradhammassa,lokuttaradhammassa,27,27,0,0,18
276473,svākkhātoti,svakkhatoti,7,1,6,0,11
276474,pariyattidhammopi,pariyattidhammopi,17,17,0,0,17
276475,lokuttaradhammova,lokuttaradhammova,1,1,0,0,17
276476,ādimajjhapariyosānakalyāṇattā,adimajjhapariyosanakalyanatta,3,3,0,0,29
276477,sātthasabyañjanakevalaparipuṇṇaparisuddhabrahmacariyappakāsanattā,satthasabyanjanakevalaparipunnaparisuddhabrahmacariyappakasanatta,1,1,0,0,65
276478,samantabhaddakattā,samantabhaddakatta,8,8,0,0,18
276479,paṭhamapādena,pathamapadena,13,11,2,0,13
276480,dutiyatatiyapādehi,dutiyatatiyapadehi,4,4,0,0,18
276481,pacchimapādena,pacchimapadena,4,4,0,0,14
276482,ekānusandhikaṃ,ekanusandhikam,19,14,5,0,14
276483,nidānena,nidanena,32,30,2,0,8
276484,ādikalyāṇaṃ,adikalyanam,155,135,20,0,11
276485,nānānusandhikaṃ,nananusandhikam,7,7,0,0,15
276486,paṭhamānusandhinā,pathamanusandhina,4,4,0,0,17
276487,sanidānasauppattikattā,sanidanasauppattikatta,2,1,1,0,22
276488,aviparītatāya,aviparitataya,8,8,0,0,13
276489,hetudāharaṇayuttato,hetudaharanayuttato,4,3,1,0,19
276490,saddhāpaṭilābhajananena,saddhapatilabhajananena,2,2,0,0,23
276491,sāsanadhammo,sasanadhammo,19,17,2,0,12
276492,atthabhūtena,atthabhutena,6,6,0,0,12
276493,ādikalyāṇo,adikalyano,39,33,6,0,10
276494,samathavipassanāmaggaphalehi,samathavipassanamaggaphalehi,6,5,1,0,28
276495,majjhekalyāṇo,majjhekalyano,39,32,7,0,13
276496,pariyosānakalyāṇo,pariyosanakalyano,38,31,7,0,17
276497,sīlasamādhīhi,silasamadhihi,11,9,2,0,13
276498,vipassanāmaggehi,vipassanamaggehi,9,7,2,0,16
276499,phalanibbānehi,phalanibbanehi,12,9,3,0,14
276500,buddhasubodhitāya,buddhasubodhitaya,6,5,1,0,17
276501,dhammasudhammatāya,dhammasudhammataya,18,18,0,0,18
276502,saṅghasuppaṭippattiyā,sanghasuppatippattiya,1,1,0,0,21
276503,tathatthāya,tathatthaya,8,8,0,0,11
276504,paṭipannena,patipannena,32,32,0,0,11
276505,adhigantabbāya,adhigantabbaya,5,5,0,0,14
276506,abhisambodhiyā,abhisambodhiya,13,13,0,0,14
276507,paccekabodhiyā,paccekabodhiya,19,19,0,0,14
276508,nīvaraṇavikkhambhanato,nivaranavikkhambhanato,7,7,0,0,22
276509,savanenapi,savanenapi,28,25,3,0,10
276510,kalyāṇameva,kalyanameva,14,14,0,0,11
276511,paṭipajjiyamāno,patipajjiyamano,5,5,0,0,15
276512,samathavipassanāsukhāvahanato,samathavipassanasukhavahanato,5,5,0,0,29
276513,paṭipattiyāpi,patipattiyapi,5,5,0,0,13
276514,tathāpaṭipanno,tathapatipanno,4,4,0,0,14
276515,paṭipattiphalenapi,patipattiphalenapi,5,5,0,0,18
276516,V1.0206,V1.0206,33,33,0,0,7
276517,pariyosānakalyāṇoti,pariyosanakalyanoti,4,2,2,0,19
276518,maggabrahmacariyañca,maggabrahmacariyanca,14,13,1,0,20
276519,saṅkāsanapakāsanavivaraṇavibhajanauttānīkaraṇapaññattiatthapadasamāyogato,sankasanapakasanavivaranavibhajanauttanikaranapannattiatthapadasamayogato,4,4,0,0,73
276520,akkharapadabyañjanākāraniruttiniddesasampattiyā,akkharapadabyanjanakaraniruttiniddesasampattiya,5,5,0,0,47
276521,atthagambhīratāpaṭivedhagambhīratāhi,atthagambhiratapativedhagambhiratahi,9,6,3,0,36
276522,dhammagambhīratādesanāgambhīratāhi,dhammagambhiratadesanagambhiratahi,8,6,2,0,34
276523,atthapaṭibhānapaṭisambhidāvisayato,atthapatibhanapatisambhidavisayato,7,5,2,0,34
276524,dhammaniruttipaṭisambhidāvisayato,dhammaniruttipatisambhidavisayato,7,5,2,0,33
276525,paṇḍitavedanīyato,panditavedaniyato,7,5,2,0,17
276526,parikkhakajanappasādakanti,parikkhakajanappasadakanti,3,3,0,0,26
276527,saddheyyato,saddheyyato,7,5,2,0,11
276528,lokiyajanappasādakanti,lokiyajanappasadakanti,8,6,2,0,22
276529,gambhīrādhippāyato,gambhiradhippayato,7,5,2,0,18
276530,uttānapadato,uttanapadato,18,11,7,0,12
276531,upanetabbassa,upanetabbassa,8,7,1,0,13
276532,sakalaparipuṇṇabhāvena,sakalaparipunnabhavena,5,5,0,0,22
276533,apanetabbassa,apanetabbassa,9,9,0,0,13
276534,niddosabhāvena,niddosabhavena,17,17,0,0,14
276535,adhigamabyattito,adhigamabyattito,5,5,0,0,16
276536,āgamabyattito,agamabyattito,5,5,0,0,13
276537,sīlādipañcadhammakkhandhayuttato,siladipancadhammakkhandhayuttato,4,4,0,0,32
276538,nirupakkilesato,nirupakkilesato,7,7,0,0,15
276539,nittaraṇatthāya,nittaranatthaya,1,1,0,0,15
276540,lokāmisanirapekkhato,lokamisanirapekkhato,5,5,0,0,20
276541,parisuddhanti,parisuddhanti,8,6,2,0,13
276542,sātthasabyañjanakevalaparipuṇṇaparisuddhabrahmacariyappakāsanato,satthasabyanjanakevalaparipunnaparisuddhabrahmacariyappakasanato,1,1,0,0,64
276543,atthavipallāsābhāvato,atthavipallasabhavato,3,2,1,0,21
276544,akkhātoti,akkhatoti,17,9,8,0,9
276545,vipallāsamāpajjati,vipallasamapajjati,2,2,0,0,18
276546,antarāyikāti,antarayikati,12,5,7,0,12
276547,vuttadhammānaṃ,vuttadhammanam,23,22,1,0,14
276548,antarāyikattābhāvato,antarayikattabhavato,3,3,0,0,20
276549,niyyānikāti,niyyanikati,12,9,3,0,11
276550,niyyānikattābhāvato,niyyanikattabhavato,3,3,0,0,19
276551,durakkhātadhammāyeva,durakkhatadhammayeva,2,2,0,0,20
276552,tathābhāvānatikkamanatoti,tathabhavanatikkamanatoti,3,2,1,0,25
276553,nibbānānurūpāya,nibbananurupaya,3,2,1,0,15
276554,paṭipadānurūpassa,patipadanurupassa,2,2,0,0,17
276555,akkhātattā,akkhatatta,10,9,1,0,10
276556,nibbānagāminī,nibbanagamini,25,25,0,0,13
276557,yamunodakena,yamunodakena,12,12,0,0,12
276558,V1.0207,V1.0207,33,33,0,0,7
276559,antadvayaṃ,antadvayam,24,19,5,0,10
276560,paṭipadābhūtova,patipadabhutova,1,1,0,0,15
276561,paṭipassaddhakilesāneva,patipassaddhakilesaneva,1,1,0,0,23
276562,paṭipassaddhakilesānī,patipassaddhakilesani,1,1,0,0,21
276563,svākkhātāni,svakkhatani,2,2,0,0,11
276564,sassatāmatatāṇaleṇādisabhāvameva,sassatamatatanalenadisabhavameva,2,2,0,0,32
276565,sassatādisabhāvavasena,sassatadisabhavavasena,2,2,0,0,22
276566,svākkhātanti,svakkhatanti,2,2,0,0,12
276567,lokuttaradhammopi,lokuttaradhammopi,4,4,0,0,17
276568,sandiṭṭhikoti,sanditthikoti,4,0,4,0,13
276569,ariyapuggalena,ariyapuggalena,8,7,1,0,14
276570,pariyādiṇṇacitto,pariyadinnacitto,13,13,0,0,16
276571,attabyābādhāya,attabyabadhaya,13,10,3,0,14
276572,parabyābādhāya,parabyabadhaya,15,15,0,0,14
276573,ubhayabyābādhāya,ubhayabyabadhaya,16,16,0,0,16
276574,navavidhopi,navavidhopi,13,13,0,0,11
276575,parasaddhāya,parasaddhaya,6,5,1,0,12
276576,gantabbataṃ,gantabbatam,6,5,1,0,11
276577,paccavekkhaṇañāṇena,paccavekkhanananena,28,27,1,0,19
276578,sandiṭṭhiyā,sanditthiya,20,16,4,0,11
276579,sampayuttāya,sampayuttaya,41,38,3,0,12
276580,visayibhūtāya,visayibhutaya,2,2,0,0,13
276581,dissamānoyeva,dissamanoyeva,3,3,0,0,13
276582,phaladānaṃ,phaladanam,20,19,1,0,10
276583,akāloyeva,akaloyeva,4,4,0,0,9
276584,pañcāhasattāhādibhedaṃ,pancahasattahadibhedam,2,2,0,0,22
276585,pavattisamanantarameva,pavattisamanantarameva,4,4,0,0,22
276586,phaladoti,phaladoti,2,2,0,0,9
276587,phaladāne,phaladane,22,20,2,0,9
276588,V1.0208,V1.0208,33,33,0,0,7
276589,kusaladhammo,kusaladhammo,19,18,1,0,12
276590,samanantaraphalattā,samanantaraphalatta,2,2,0,0,19
276591,kālikoti,kalikoti,2,2,0,0,8
276592,rittamuṭṭhiyaṃ,rittamutthiyam,1,1,0,0,14
276593,manuññabhāvappakāsanena,manunnabhavappakasanena,2,2,0,0,23
276594,cittasampahaṃsanatthaṃ,cittasampahamsanattham,9,7,2,0,22
276595,paṭicchādetabbameva,paticchadetabbameva,2,2,0,0,19
276596,aparisuddhattā,aparisuddhatta,13,12,1,0,14
276597,sampuṇṇacandamaṇḍalaṃ,sampunnacandamandalam,3,3,0,0,21
276598,nikkhittajātimaṇi,nikkhittajatimani,4,4,0,0,17
276599,upanetabboti,upanetabboti,8,6,2,0,12
276600,upanayanaṃ,upanayanam,18,16,2,0,10
276601,upanayo,upanayo,5,3,2,0,7
276602,ajjhupekkhitvāpi,ajjhupekkhitvapi,7,7,0,0,16
276603,opanayikova,opanayikova,1,1,0,0,11
276604,sacchikiriyāvasena,sacchikiriyavasena,6,6,0,0,18
276605,upanetīti,upanetiti,25,18,7,0,9
276606,upaneyyo,upaneyyo,8,8,0,0,8
276607,sacchikātabbataṃ,sacchikatabbatam,2,2,0,0,16
276608,phalanibbānadhammo,phalanibbanadhammo,2,2,0,0,18
276609,ugghaṭitaññūādīhi,ugghatitannuadihi,4,4,0,0,17
276610,bhāvitena,bhavitena,28,27,1,0,9
276611,phāsuviharati,phasuviharati,1,1,0,0,13
276612,citteyeva,citteyeva,7,7,0,0,9
276613,V1.0209,V1.0209,33,33,0,0,7
276614,sandiṭṭhikattā,sanditthikatta,1,1,0,0,14
276615,akālikattā,akalikatta,2,2,0,0,10
276616,ehipassikattā,ehipassikatta,1,1,0,0,13
276617,svākkhātatādibhede,svakkhatatadibhede,1,1,0,0,18
276618,dhammaguṇānaṃ,dhammagunanam,2,1,1,0,13
276619,dhammaguṇānussaraṇavasena,dhammagunanussaranavasena,1,1,0,0,25
276620,dhammānussaticceva,dhammanussaticceva,1,1,0,0,18
276621,opaneyyikassa,opaneyyikassa,3,3,0,0,13
276622,desetāraṃ,desetaram,3,3,0,0,9
276623,imināpaṅgena,iminapangena,48,48,0,0,12
276624,atītaṃse,atitamse,43,40,3,0,8
276625,panetarahi,panetarahi,29,28,1,0,10
276626,dhammaguṇadassaneneva,dhammagunadassaneneva,1,1,0,0,21
276627,garucittīkāro,garucittikaro,2,2,0,0,13
276628,saddhādivepullaṃ,saddhadivepullam,4,4,0,0,16
276629,dhammaguṇānussatiyā,dhammagunanussatiya,1,1,0,0,19
276630,anuttaradhammādhigamāya,anuttaradhammadhigamaya,1,1,0,0,23
276631,dhammasudhammataṃ,dhammasudhammatam,45,39,6,0,17
276632,samanussarato,samanussarato,15,14,1,0,13
276633,dhammānussatiyā,dhammanussatiya,6,6,0,0,15
276634,dhammānussatiyaṃ,dhammanussatiyam,5,4,1,0,16
276635,saṅghānussatikathā,sanghanussatikatha,1,1,0,0,18
276636,saṅghānussatiṃ,sanghanussatim,8,8,0,0,14
276637,ujuppaṭipanno,ujuppatipanno,25,22,3,0,13
276638,ñāyappaṭipanno,nayappatipanno,25,22,3,0,14
276639,V1.0210,V1.0210,34,34,0,0,7
276640,añjalikaraṇīyo,anjalikaraniyo,64,57,7,0,14
276641,ariyasaṅghaguṇā,ariyasanghaguna,13,13,0,0,15
276642,suppaṭipannoti,suppatipannoti,4,2,2,0,14
276643,sammāpaṭipadaṃ,sammapatipadam,25,25,0,0,14
276644,anivattipaṭipadaṃ,anivattipatipadam,3,2,1,0,17
276645,anulomapaṭipadaṃ,anulomapatipadam,26,22,4,0,16
276646,apaccanīkapaṭipadaṃ,apaccanikapatipadam,11,10,1,0,19
276647,dhammānudhammapaṭipadaṃ,dhammanudhammapatipadam,13,12,1,0,23
276648,sīladiṭṭhisāmaññatāya,siladitthisamannataya,1,1,0,0,21
276649,saṅghātabhāvamāpanno,sanghatabhavamapanno,2,1,1,0,20
276650,sāvakasamūhoti,savakasamuhoti,1,1,0,0,14
276651,sammāpaṭipadā,sammapatipada,38,37,1,0,13
276652,avaṅkā,avanka,5,4,1,0,6
276653,akuṭilā,akutila,6,5,1,0,7
276654,ajimhā,ajimha,3,2,1,0,6
276655,ñāyotipi,nayotipi,1,1,0,0,8
276656,anucchavikattā,anucchavikatta,8,7,1,0,14
276657,sāmīcītipi,samicitipi,1,1,0,0,10
276658,tampaṭipanno,tampatipanno,1,1,0,0,12
276659,sammāpaṭipattisamaṅgitāya,sammapatipattisamangitaya,1,1,0,0,25
276660,sammāpaṭipadāya,sammapatipadaya,12,12,0,0,15
276661,adhigantabbassa,adhigantabbassa,14,14,0,0,15
276662,suppaṭipannāti,suppatipannati,1,1,0,0,14
276663,paṭipannattāpi,patipannattapi,2,2,0,0,14
276664,antadvayamanupagamma,antadvayamanupagamma,2,2,0,0,20
276665,kāyavacīmanovaṅkakuṭilajimhadosappahānāya,kayavacimanovankakutilajimhadosappahanaya,2,2,0,0,41
276666,ujuppaṭipannattā,ujuppatipannatta,1,1,0,0,16
276667,sāmīcippaṭipannārahā,samicippatipannaraha,1,1,0,0,20
276668,purisayugānīti,purisayuganiti,3,0,3,0,14
276669,paṭhamamaggaṭṭho,pathamamaggattho,13,13,0,0,16
276670,yugaḷanti,yugalanti,4,4,0,0,9
276671,purisayugaḷāni,purisayugalani,2,1,1,0,14
276672,purisapuggalavasena,purisapuggalavasena,4,4,0,0,19
276673,V1.0211,V1.0211,34,34,0,0,7
276674,pāṭiekkato,patiekkato,1,1,0,0,10
276675,āhuneyyotiādīsu,ahuneyyotiadisu,2,1,1,0,15
276676,hunitabbanti,hunitabbanti,10,10,0,0,12
276677,dūratopi,duratopi,46,44,2,0,8
276678,paccayānametamadhivacanaṃ,paccayanametamadhivacanam,1,1,0,0,25
276679,mahapphalakaraṇatoti,mahapphalakaranatoti,1,1,0,0,20
276680,sabbasāpateyyampi,sabbasapateyyampi,2,2,0,0,17
276681,sakkādīnampi,sakkadinampi,5,4,1,0,12
276682,āhavanaṃ,ahavanam,5,4,1,0,8
276683,hutassa,hutassa,4,4,0,0,7
276684,mahapphalatāya,mahapphalataya,6,6,0,0,14
276685,saṅghova,sanghova,31,30,1,0,8
276686,hutañhi,hutanhi,3,3,0,0,7
276687,paricare,paricare,11,9,2,0,8
276688,bhāvitattānaṃ,bhavitattanam,33,26,7,0,13
276689,nikāyantare,nikayantare,5,5,0,0,11
276690,āhavanīyoti,ahavaniyoti,1,1,0,0,11
276691,āhuneyyoti,ahuneyyoti,3,1,2,0,10
276692,kiñcimattameva,kincimattameva,5,5,0,0,14
276693,pāhuneyyoti,pahuneyyoti,6,2,4,0,11
276694,disāvidisato,disavidisato,3,3,0,0,12
276695,piyamanāpānaṃ,piyamanapanam,12,11,1,0,13
276696,ñātimittānamatthāya,natimittanamatthaya,1,1,0,0,19
276697,āgantukadānaṃ,agantukadanam,9,9,0,0,13
276698,pāhunake,pahunake,5,5,0,0,8
276699,saṅghasadiso,sanghasadiso,3,3,0,0,12
276700,pāhunako,pahunako,6,6,0,0,8
276701,ekabuddhantare,ekabuddhantare,3,2,1,0,14
276702,abbokiṇṇañca,abbokinnanca,4,4,0,0,12
276703,piyamanāpattakarehi,piyamanapattakarehi,3,3,0,0,19
276704,pāhunamassa,pahunamassa,4,4,0,0,11
276705,pāhunañca,pahunanca,4,4,0,0,9
276706,pāhavanīyoti,pahavaniyoti,2,2,0,0,12
276707,pubbakāramarahati,pubbakaramarahati,1,1,0,0,17
276708,pāhavanīyo,pahavaniyo,4,4,0,0,10
276709,āhavanamarahatīti,ahavanamarahatiti,1,1,0,0,17
276710,dakkhiṇāti,dakkhinati,16,6,10,0,10
276711,V1.0212,V1.0212,34,34,0,0,7
276712,puññavirūhanaṭṭhānaṃ,punnaviruhanatthanam,3,3,0,0,20
276713,sālikkhettaṃ,salikkhettam,11,10,1,0,12
276714,yavakkhettanti,yavakkhettanti,2,2,0,0,14
276715,nānappakārahitasukhasaṃvattanikāni,nanappakarahitasukhasamvattanikani,3,3,0,0,34
276716,suppaṭipannatādibhede,suppatipannatadibhede,1,1,0,0,21
276717,saṅghaguṇe,sanghagune,10,10,0,0,10
276718,saṅghaguṇānaṃ,sanghagunanam,1,1,0,0,13
276719,saṅghaguṇānussaraṇavasena,sanghagunanussaranavasena,1,1,0,0,25
276720,saṅghānussaticceva,sanghanussaticceva,1,1,0,0,18
276721,saṅghaguṇānussatiyā,sanghagunanussatiya,1,1,0,0,19
276722,sannipatitasaṅghamiva,sannipatitasanghamiva,1,1,0,0,21
276723,saṅghaguṇādhigamāya,sanghagunadhigamaya,1,1,0,0,19
276724,saṅghānussatiyā,sanghanussatiya,5,5,0,0,15
276725,saṅghānussatiyaṃ,sanghanussatiyam,3,3,0,0,16
276726,sīlānussatikathā,silanussatikatha,1,1,0,0,16
276727,sīlānussatiṃ,silanussatim,6,6,0,0,12
276728,V1.0213,V1.0213,34,34,0,0,7
276729,akammāsāni,akammasani,33,26,7,0,10
276730,viññuppasatthāni,vinnuppasatthani,34,28,6,0,16
276731,samādhisaṃvattanikānī,samadhisamvattanikani,6,4,2,0,21
276732,akhaṇḍatādiguṇavasena,akhandatadigunavasena,3,3,0,0,21
276733,anussaritabbāni,anussaritabbani,7,7,0,0,15
276734,gahaṭṭhasīlāni,gahatthasilani,4,4,0,0,14
276735,pabbajitasīlāni,pabbajitasilani,4,4,0,0,15
276736,khaṇḍānīti,khandaniti,5,2,3,0,10
276737,vinividdhasāṭako,vinividdhasatako,3,2,1,0,16
276738,chiddānīti,chiddaniti,1,1,0,0,10
276739,dīghavaṭṭādisaṇṭhānena,dighavattadisanthanena,2,2,0,0,22
276740,sabalānīti,sabalaniti,2,2,0,0,10
276741,visabhāgabinduvicitrā,visabhagabinduvicitra,2,2,0,0,21
276742,kammāsānīti,kammasaniti,2,2,0,0,11
276743,anupahatattā,anupahatatta,1,1,0,0,12
276744,taṇhādāsabyato,tanhadasabyato,20,17,3,0,14
276745,bhujissabhāvakaraṇena,bhujissabhavakaranena,2,1,1,0,21
276746,aparāmaṭṭhatāya,aparamatthataya,2,2,0,0,15
276747,maggasamādhiṃ,maggasamadhim,7,6,1,0,13
276748,phalasamādhiñcāpi,phalasamadhincapi,1,1,0,0,17
276749,saṃvattentīti,samvattentiti,1,1,0,0,13
276750,sīlaguṇānaṃ,silagunanam,1,1,0,0,11
276751,sīlaguṇānussaraṇavasena,silagunanussaranavasena,1,1,0,0,23
276752,sīlānussaticceva,silanussaticceva,1,1,0,0,16
276753,V1.0214,V1.0214,34,34,0,0,7
276754,sabhāgavutti,sabhagavutti,2,2,0,0,12
276755,paṭisanthāre,patisanthare,27,23,4,0,12
276756,attānuvādādibhayavirahito,attanuvadadibhayavirahito,2,1,1,0,25
276757,sīlānussatiyā,silanussatiya,5,5,0,0,13
276758,sīlānussatiyaṃ,silanussatiyam,2,2,0,0,14
276759,cāgānussatikathā,caganussatikatha,1,1,0,0,16
276760,cāgānussatiṃ,caganussatim,6,6,0,0,12
276761,cāgādhimuttena,cagadhimuttena,1,1,0,0,14
276762,niccappavattadānasaṃvibhāgena,niccappavattadanasamvibhagena,1,1,0,0,29
276763,ārabhantena,arabhantena,6,6,0,0,11
276764,paṭiggāhake,patiggahake,12,12,0,0,11
276765,ekālopamattampi,ekalopamattampi,1,1,0,0,15
276766,taṃdivasaṃ,tamdivasam,73,66,7,0,10
276767,guṇavisiṭṭhesu,gunavisitthesu,3,3,0,0,14
276768,maccheramalapariyuṭṭhitāya,maccheramalapariyutthitaya,5,5,0,0,26
276769,vigatamalamaccherena,vigatamalamaccherena,43,42,1,0,20
276770,muttacāgo,muttacago,43,41,2,0,9
276771,payatapāṇi,payatapani,32,32,0,0,10
276772,vossaggarato,vossaggarato,28,28,0,0,12
276773,dānasaṃvibhāgarato,danasamvibhagarato,38,38,0,0,18
276774,vigatamalamaccheratādiguṇavasena,vigatamalamaccheratadigunavasena,2,2,0,0,32
276775,anussaritabbo,anussaritabbo,14,14,0,0,13
276776,anukkamaṃ,anukkamam,15,10,5,0,9
276777,saṃvaṇṇitā,samvannita,24,23,1,0,10
276778,bhāginoti,bhaginoti,4,3,1,0,9
276779,dānasaṃvibhāgaratoti,danasamvibhagaratoti,8,2,6,0,20
276780,V1.0215,V1.0215,34,34,0,0,7
276781,maccheramalapariyuṭṭhitāyāti,maccheramalapariyutthitayati,1,0,1,0,28
276782,maccheramalena,maccheramalena,3,3,0,0,14
276783,abhibhūtāya,abhibhutaya,2,2,0,0,11
276784,pajāyanavasena,pajayanavasena,1,1,0,0,14
276785,parasādhāraṇabhāvamasahanalakkhaṇena,parasadharanabhavamasahanalakkhanena,1,1,0,0,36
276786,pabhassarabhāvadūsakānaṃ,pabhassarabhavadusakanam,2,2,0,0,24
276787,kaṇhadhammānaṃ,kanhadhammanam,4,3,1,0,14
276788,abhibhūtesu,abhibhutesu,1,1,0,0,11
276789,sattesūti,sattesuti,4,2,2,0,9
276790,vigatamalamaccherenāti,vigatamalamaccherenati,2,0,2,0,22
276791,rāgadosādimalānañceva,ragadosadimalananceva,2,2,0,0,21
276792,maccherassa,maccherassa,6,6,0,0,11
276793,yathāvuttappakāracitto,yathavuttappakaracitto,1,1,0,0,22
276794,vasāmīti,vasamiti,11,10,1,0,8
276795,mahānāmasakkassa,mahanamasakkassa,7,7,0,0,16
276796,nissayavihāraṃ,nissayaviharam,5,4,1,0,14
276797,nissayavihāravasena,nissayaviharavasena,1,1,0,0,19
276798,ajjhāvasāmīti,ajjhavasamiti,3,1,2,0,13
276799,muttacāgoti,muttacagoti,5,0,5,0,11
276800,vissaṭṭhacāgo,vissatthacago,6,5,1,0,13
276801,payatapāṇīti,payatapaniti,8,0,8,0,12
276802,parisuddhahattho,parisuddhahattho,2,2,0,0,16
276803,dhotahatthoyevāti,dhotahatthoyevati,1,1,0,0,17
276804,vossaggaratoti,vossaggaratoti,5,0,5,0,14
276805,vossagge,vossagge,2,2,0,0,8
276806,satatābhiyogavasena,satatabhiyogavasena,1,1,0,0,19
276807,yācayogoti,yacayogoti,12,1,11,0,10
276808,yācanayogoti,yacanayogoti,1,1,0,0,12
276809,yājayogotipi,yajayogotipi,1,1,0,0,12
276810,yajanasaṅkhātena,yajanasankhatena,1,1,0,0,16
276811,yājena,yajena,4,3,1,0,6
276812,paribhuñjitabbatopi,paribhunjitabbatopi,1,1,0,0,19
276813,cāgaguṇānaṃ,cagagunanam,1,1,0,0,11
276814,nānappakāracāgaguṇānussaraṇādhimuttatāya,nanappakaracagagunanussaranadhimuttataya,1,1,0,0,40
276815,cāgaguṇānussaraṇavasena,cagagunanussaranavasena,1,1,0,0,23
276816,cāgānussaticceva,caganussaticceva,1,1,0,0,16
276817,cāgādhimutto,cagadhimutto,3,3,0,0,12
276818,alobhajjhāsayo,alobhajjhasayo,6,5,1,0,14
276819,anulomakārī,anulomakari,2,1,1,0,11
276820,V1.0216,V1.0216,34,34,0,0,7
276821,cāgānussatiyā,caganussatiya,5,5,0,0,13
276822,cāgānussatiyaṃ,caganussatiyam,2,2,0,0,14
276823,devatānussatikathā,devatanussatikatha,1,1,0,0,18
276824,devatānussatiṃ,devatanussatim,9,8,1,0,14
276825,ariyamaggavasena,ariyamaggavasena,4,4,0,0,16
276826,samudāgatehi,samudagatehi,1,1,0,0,12
276827,paranimmitavasavattino,paranimmitavasavattino,14,11,3,0,22
276828,yathārūpāya,yatharupaya,43,43,0,0,11
276829,yathārūpena,yatharupena,55,55,0,0,11
276830,saṃvijjatī,samvijjati,24,23,1,0,10
276831,cāgañca,caganca,24,24,0,0,7
276832,ṭhapetabbadevatānaṃ,thapetabbadevatanam,1,1,0,0,19
276833,samānaguṇadīpanatthaṃ,samanagunadipanattham,1,1,0,0,21
276834,saṃvijjamāne,samvijjamane,6,6,0,0,12
276835,saddhādiguṇe,saddhadigune,3,3,0,0,12
276836,saddhādiguṇānaṃ,saddhadigunanam,1,1,0,0,15
276837,V1.0217,V1.0217,34,34,0,0,7
276838,guṇasadisasaddhādiguṇānussaraṇavasena,gunasadisasaddhadigunanussaranavasena,1,1,0,0,37
276839,devatānussaticceva,devatanussaticceva,1,1,0,0,18
276840,devatānussatiyā,devatanussatiya,5,5,0,0,15
276841,devatānussatiyaṃ,devatanussatiyam,2,2,0,0,16
276842,vitthāradesanāyaṃ,vittharadesanayam,4,3,1,0,17
276843,ujugatacitto,ujugatacitto,25,25,0,0,12
276844,dhammūpasaṃhitaṃ,dhammupasamhitam,60,52,8,0,16
276845,bhagavātiādīnaṃ,bhagavatiadinam,5,2,3,0,15
276846,pavattacittavasena,pavattacittavasena,2,2,0,0,18
276847,devatāguṇasadise,devatagunasadise,1,1,0,0,16
276848,devatābhāvanipphādake,devatabhavanipphadake,1,1,0,0,21
276849,ariyasāvakānaññeva,ariyasavakananneva,2,1,1,0,18
276850,buddhadhammasaṅghaguṇā,buddhadhammasanghaguna,1,1,0,0,22
276851,akhaṇḍatādiguṇehi,akhandatadigunehi,1,1,0,0,17
276852,guṇasadisehi,gunasadisehi,1,1,0,0,12
276853,saddhādiguṇehi,saddhadigunehi,1,1,0,0,14
276854,mahānāmasutte,mahanamasutte,2,1,1,0,13
276855,V1.0218,V1.0218,34,34,0,0,7
276856,nissayavihāradassanatthameva,nissayaviharadassanatthameva,1,1,0,0,28
276857,gedhasuttepi,gedhasuttepi,1,1,0,0,12
276858,vuṭṭhitaṃ,vutthitam,56,53,3,0,9
276859,gedhamhā,gedhamha,12,12,0,0,8
276860,kāmaguṇānamadhivacanaṃ,kamagunanamadhivacanam,1,1,0,0,22
276861,anussativasena,anussativasena,8,8,0,0,14
276862,paramatthavisuddhiadhigamatthāya,paramatthavisuddhiadhigamatthaya,1,1,0,0,32
276863,sambādhokāsasuttepi,sambadhokasasuttepi,1,1,0,0,19
276864,okāsādhigamo,okasadhigamo,35,26,9,0,12
276865,ariyasāvakasseva,ariyasavakasseva,7,6,1,0,16
276866,paramatthavisuddhidhammatāya,paramatthavisuddhidhammataya,1,1,0,0,28
276867,okāsādhigamavasena,okasadhigamavasena,1,1,0,0,18
276868,uposathasuttepi,uposathasuttepi,1,1,0,0,15
276869,ariyūposatho,ariyuposatho,1,1,0,0,12
276870,anussaratī,anussarati,8,4,4,0,10
276871,upavasato,upavasato,1,1,0,0,9
276872,cittavisodhanakammaṭṭhānavasena,cittavisodhanakammatthanavasena,1,1,0,0,31
276873,mahapphalabhāvadassanatthaṃ,mahapphalabhavadassanattham,3,3,0,0,27
276874,ekādasanipātepi,ekadasanipatepi,1,1,0,0,15
276875,upaṭṭhitasati,upatthitasati,3,3,0,0,13
276876,anussareyyāsi,anussareyyasi,18,18,0,0,13
276877,nānāvihārena,nanaviharena,2,2,0,0,12
276878,viharataṃ,viharatam,91,87,4,0,9
276879,kenassa,kenassa,15,14,1,0,7
276880,viharitabbaṃ,viharitabbam,14,14,0,0,12
276881,vihāradassanatthaṃ,viharadassanattham,1,1,0,0,18
276882,V1.0219,V1.0219,34,34,0,0,7
276883,parisuddhasīlādiguṇasamannāgatena,parisuddhasiladigunasamannagatena,1,1,0,0,33
276884,puthujjanenāpi,puthujjanenapi,2,2,0,0,14
276885,anussavavasenāpi,anussavavasenapi,2,2,0,0,16
276886,pasīdatiyeva,pasidatiyeva,1,1,0,0,12
276887,uḷārapāmojjo,ularapamojjo,19,18,1,0,12
276888,arahattaṃyeva,arahattamyeva,3,3,0,0,13
276889,sacchikareyya,sacchikareyya,8,7,1,0,13
276890,kaṭaandhakāravāsī,kataandhakaravasi,2,2,0,0,17
276891,phussadevatthero,phussadevatthero,16,6,10,0,16
276892,sarāgadosamoho,saragadosamoho,2,2,0,0,14
276893,vītarāgadosamoho,vitaragadosamoho,3,3,0,0,16
276894,anussatikammaṭṭhānaniddeso,anussatikammatthananiddeso,2,2,0,0,26
276895,maraṇassatikathā,maranassatikatha,1,1,0,0,16
276896,V1.0220,V1.0220,34,34,0,0,7
276897,anantarāya,anantaraya,11,11,0,0,10
276898,bhāvanāniddeso,bhavananiddeso,10,8,2,0,14
276899,upacchedo,upacchedo,19,17,2,0,9
276900,vaṭṭadukkhasamucchedasaṅkhātaṃ,vattadukkhasamucchedasankhatam,2,2,0,0,30
276901,samucchedamaraṇaṃ,samucchedamaranam,12,3,9,0,17
276902,khaṇabhaṅgasaṅkhātaṃ,khanabhangasankhatam,4,3,1,0,20
276903,matantiādīsu,matantiadisu,1,1,0,0,12
276904,sammutimaraṇañca,sammutimarananca,4,3,1,0,16
276905,kālamaraṇaṃ,kalamaranam,9,7,2,0,11
276906,akālamaraṇanti,akalamarananti,2,2,0,0,14
276907,puññakkhayena,punnakkhayena,11,9,2,0,13
276908,ubhayakkhayena,ubhayakkhayena,3,3,0,0,14
276909,kammupacchedakakammavasena,kammupacchedakakammavasena,1,1,0,0,26
276910,āyusantānajanakapaccayasampattiyā,ayusantanajanakapaccayasampattiya,1,1,0,0,33
276911,vipakkavipākattā,vipakkavipakatta,3,3,0,0,16
276912,gatikālāhārādisampattiyā,gatikalaharadisampattiya,2,1,1,0,24
276913,ajjatanakālapurisānaṃ,ajjatanakalapurisanam,3,2,1,0,21
276914,vassasatamattaparimāṇassa,vassasatamattaparimanassa,2,2,0,0,25
276915,khayavasena,khayavasena,2,2,0,0,11
276916,dūsīmārakalāburājādīnaṃ,dusimarakalaburajadinam,1,1,0,0,23
276917,ṭhānācāvanasamatthena,thanacavanasamatthena,1,1,0,0,21
276918,upacchinnasantānānaṃ,upacchinnasantananam,1,1,0,0,20
276919,purimakammavasena,purimakammavasena,1,1,0,0,17
276920,satthaharaṇādīhi,satthaharanadihi,2,2,0,0,16
276921,upakkamehi,upakkamehi,3,3,0,0,10
276922,upacchijjamānasantānānaṃ,upacchijjamanasantananam,2,2,0,0,24
276923,jīvitindriyupacchedena,jivitindriyupacchedena,2,2,0,0,22
276924,jīvitindriyupacchedasaṅkhātassa,jivitindriyupacchedasankhatassa,1,1,0,0,31
276925,upacchijjissatī,upacchijjissati,1,1,0,0,15
276926,V1.0221,V1.0221,34,34,0,0,7
276927,pavattayato,pavattayato,41,40,1,0,11
276928,iṭṭhajanamaraṇānussaraṇe,itthajanamarananussarane,1,1,0,0,24
276929,piyaputtamaraṇānussaraṇe,piyaputtamarananussarane,1,1,0,0,24
276930,aniṭṭhajanamaraṇānussaraṇe,anitthajanamarananussarane,1,1,0,0,26
276931,verimaraṇānussaraṇe,verimarananussarane,1,1,0,0,19
276932,majjhattajanamaraṇānussaraṇe,majjhattajanamarananussarane,1,1,0,0,28
276933,matakaḷevaradassane,matakalevaradassane,1,1,0,0,19
276934,chavaḍāhakassa,chavadahakassa,1,1,0,0,14
276935,maraṇānussaraṇe,marananussarane,1,1,0,0,15
276936,santāso,santaso,25,25,0,0,7
276937,ukkhittāsikaṃ,ukkhittasikam,2,2,0,0,13
276938,vadhakaṃ,vadhakam,23,23,0,0,8
276939,bhīrukajātikassa,bhirukajatikassa,2,2,0,0,16
276940,satisaṃvegañāṇavirahato,satisamvegananavirahato,1,1,0,0,23
276941,hatamatasatte,hatamatasatte,1,1,0,0,13
276942,diṭṭhapubbasampattīnaṃ,ditthapubbasampattinam,2,1,1,0,22
276943,satiñca,satinca,44,40,4,0,7
276944,pavattayatoyeva,pavattayatoyeva,2,2,0,0,15
276945,maraṇārammaṇā,maranarammana,4,3,1,0,13
276946,vadhakapaccupaṭṭhānato,vadhakapaccupatthanato,3,3,0,0,22
276947,sampattivipattito,sampattivipattito,4,4,0,0,17
276948,upasaṃharaṇato,upasamharanato,8,7,1,0,14
276949,āyudubbalato,ayudubbalato,5,4,1,0,12
276950,animittato,animittato,4,4,0,0,10
276951,addhānaparicchedato,addhanaparicchedato,6,4,2,0,19
276952,khaṇaparittatoti,khanaparittatoti,4,2,2,0,16
276953,aṭṭhahākārehi,atthahakarehi,49,44,5,0,13
276954,anussaritabbaṃ,anussaritabbam,24,24,0,0,14
276955,vadhakapaccupaṭṭhānatoti,vadhakapaccupatthanatoti,3,0,3,0,24
276956,vadhakassa,vadhakassa,28,26,2,0,10
276957,paccupaṭṭhānato,paccupatthanato,7,6,1,0,15
276958,cārayamāno,carayamano,4,3,1,0,10
276959,paccupaṭṭhitova,paccupatthitova,3,2,1,0,15
276960,paccupaṭṭhitamevāti,paccupatthitamevati,3,3,0,0,19
276961,āgatato,agatato,6,5,1,0,7
276962,ahicchattakamakuḷaṃ,ahicchattakamakulam,3,3,0,0,19
276963,uppādānantarameva,uppadanantarameva,1,1,0,0,17
276964,pabbatasikharato,pabbatasikharato,1,1,0,0,16
276965,patitasilā,patitasila,1,1,0,0,10
276966,sampayuttakhandhehi,sampayuttakhandhehi,1,1,0,0,19
276967,idhādhippetamaraṇampi,idhadhippetamaranampi,1,1,0,0,21
276968,atthābhimukho,atthabhimukho,1,1,0,0,13
276969,gacchateva,gacchateva,22,22,0,0,10
276970,sīghasotā,sighasota,20,20,0,0,9
276971,hārahārinī,haraharini,8,8,0,0,10
276972,sandateva,sandateva,2,2,0,0,9
276973,maraṇābhimukhova,maranabhimukhova,1,1,0,0,16
276974,V1.0222,V1.0222,34,34,0,0,7
276975,gimhābhitattānaṃ,gimhabhitattanam,1,1,0,0,16
276976,āporasānugatabandhanānaṃ,aporasanugatabandhananam,3,2,1,0,24
276977,dumapphalānaṃ,dumapphalanam,1,1,0,0,13
276978,muggarābhitāḷitānaṃ,muggarabhitalitanam,1,1,0,0,19
276979,mattikabhājanānaṃ,mattikabhajananam,1,1,0,0,17
276980,sūriyarasmisamphuṭṭhānaṃ,suriyarasmisamphutthanam,1,1,0,0,24
276981,ussāvabindūnaṃ,ussavabindunam,2,2,0,0,14
276982,jīvitamuparujjhati,jivitamuparujjhati,1,1,0,0,18
276983,phalānamiva,phalanamiva,9,7,2,0,11
276984,papatato,papatato,3,3,0,0,8
276985,mattikabhājanaṃ,mattikabhajanam,9,8,1,0,15
276986,khuddakañca,khuddakanca,8,8,0,0,11
276987,bhedanapariyantaṃ,bhedanapariyantam,6,5,1,0,17
276988,ussāvova,ussavova,4,4,0,0,8
276989,tiṇaggamhi,tinaggamhi,4,4,0,0,10
276990,evamāyu,evamayu,6,6,0,0,7
276991,nivārayā,nivaraya,4,4,0,0,8
276992,ukkhittāsiko,ukkhittasiko,9,9,0,0,12
276993,aharitvā,aharitva,1,1,0,0,8
276994,sampattivipattitoti,sampattivipattitoti,2,0,2,0,19
276995,nābhibhavati,nabhibhavati,6,6,0,0,12
276996,V1.0223,V1.0223,34,34,0,0,7
276997,issarataṃ,issaratam,1,1,0,0,9
276998,dehabandhena,dehabandhena,1,1,0,0,12
276999,puññamhi,punnamhi,3,3,0,0,8
277000,sokamāgato,sokamagato,1,1,0,0,10
277001,byādhipariyosānaṃ,byadhipariyosanam,4,4,0,0,17
277002,jarāpariyosānaṃ,jarapariyosanam,4,4,0,0,15
277003,maraṇapariyosānaṃ,maranapariyosanam,5,5,0,0,17
277004,caṇḍālapukkuse,candalapukkuse,4,4,0,0,14
277005,sabbamevābhimaddati,sabbamevabhimaddati,2,2,0,0,19
277006,jīvitasampattiyā,jivitasampattiya,3,3,0,0,16
277007,maraṇavipattipariyosānataṃ,maranavipattipariyosanatam,1,1,0,0,26
277008,upasaṃharaṇatoti,upasamharanatoti,3,0,3,0,16
277009,sattahākārehi,sattahakarehi,58,58,0,0,13
277010,yasamahattato,yasamahattato,5,4,1,0,13
277011,puññamahattato,punnamahattato,6,5,1,0,14
277012,thāmamahattato,thamamahattato,6,5,1,0,14
277013,iddhimahattato,iddhimahattato,6,5,1,0,14
277014,paññāmahattato,pannamahattato,6,5,1,0,14
277015,sammāsambuddhatoti,sammasambuddhatoti,3,3,0,0,18
277016,mahāparivārānaṃ,mahaparivaranam,7,7,0,0,15
277017,V1.0224,V1.0224,34,34,0,0,7
277018,sampannadhanavāhanānaṃ,sampannadhanavahananam,1,1,0,0,22
277019,mahāsammatamandhātumahāsudassana,mahasammatamandhatumahasudassana,1,1,0,0,32
277020,daḷhanemi,dalhanemi,8,8,0,0,9
277021,nimippabhutīnampi,nimippabhutinampi,1,1,0,0,17
277022,mahāsammataādayo,mahasammataadayo,1,1,0,0,16
277023,kāti,kati,10,9,1,0,4
277024,jotiko,jotiko,11,10,1,0,6
277025,mahāpuññāti,mahapunnati,6,6,0,0,11
277026,maraṇamāpannā,maranamapanna,2,2,0,0,13
277027,yudhiṭṭhilo,yudhitthilo,23,22,1,0,11
277028,cānuro,canuro,2,1,1,0,6
277029,mahāmallo,mahamallo,1,1,0,0,9
277030,thāmabalūpetā,thamabalupeta,1,1,0,0,13
277031,pādaṅguṭṭhakamattena,padangutthakamattena,1,1,0,0,20
277032,V1.0225,V1.0225,34,34,0,0,7
277033,vejayantamakampayi,vejayantamakampayi,1,1,0,0,18
277034,nāmiddhimataṃ,namiddhimatam,1,1,0,0,13
277035,sīhamukhaṃ,sihamukham,6,6,0,0,10
277036,ñāṇavīriyabalena,nanaviriyabalena,1,1,0,0,16
277037,sabbakilesasattunimmathanaṃ,sabbakilesasattunimmathanam,1,1,0,0,27
277038,paccekabodhiṃ,paccekabodhim,134,130,4,0,13
277039,khaggavisāṇakappā,khaggavisanakappa,6,4,2,0,17
277040,muccissāmīti,muccissamiti,3,3,0,0,12
277041,nimittamāgamma,nimittamagamma,2,2,0,0,14
277042,vīmaṃsantā,vimamsanta,10,10,0,0,10
277043,sayambhuññāṇatejena,sayambhunnanatejena,1,1,0,0,19
277044,ekacariyanivāsena,ekacariyanivasena,1,1,0,0,17
277045,khaggasiṅgasamūpamā,khaggasingasamupama,2,1,1,0,19
277046,nātigatā,natigata,1,1,0,0,8
277047,V1.0226,V1.0226,34,34,0,0,7
277048,sammāsambuddhato,sammasambuddhato,9,8,1,0,16
277049,asītianubyañjanapaṭimaṇḍitadvattiṃsamahāpurisalakkhaṇavicitrarūpakāyo,asitianubyanjanapatimanditadvattimsamahapurisalakkhanavicitrarupakayo,1,1,0,0,69
277050,sabbākāraparisuddhasīlakkhandhādiguṇaratanasamiddhadhammakāyo,sabbakaraparisuddhasilakkhandhadigunaratanasamiddhadhammakayo,1,1,0,0,61
277051,yasamahattapuññamahattathāmamahattaiddhimahattapaññāmahattānaṃ,yasamahattapunnamahattathamamahattaiddhimahattapannamahattanam,1,1,0,0,62
277052,salilavuṭṭhinipātena,salilavutthinipatena,2,2,0,0,20
277053,mahāaggikkhandho,mahaaggikkhandho,30,30,0,0,16
277054,maraṇavuṭṭhinipātena,maranavutthinipatena,1,1,0,0,20
277055,vasamāgataṃ,vasamagatam,3,3,0,0,11
277056,nillajjaṃ,nillajjam,3,3,0,0,9
277057,vītasārajjaṃ,vitasarajjam,1,1,0,0,12
277058,sabbasattābhimaddanaṃ,sabbasattabhimaddanam,1,1,0,0,21
277059,nābhibhavissatīti,nabhibhavissatiti,1,1,0,0,17
277060,yasamahattatādisampannehi,yasamahattatadisampannehi,1,1,0,0,25
277061,maraṇasāmaññatāya,maranasamannataya,1,1,0,0,17
277062,upacārappattaṃ,upacarappattam,5,5,0,0,14
277063,kāyabahusādhāraṇatoti,kayabahusadharanatoti,2,0,2,0,21
277064,bahusādhāraṇo,bahusadharano,5,5,0,0,13
277065,kimikulānaṃ,kimikulanam,9,8,1,0,11
277066,chavinissitā,chavinissita,3,3,0,0,12
277067,cammanissitā,cammanissita,3,3,0,0,12
277068,maṃsanissitā,mamsanissita,3,3,0,0,12
277069,nhārunissitā,nharunissita,2,2,0,0,12
277070,aṭṭhinissitā,atthinissita,3,3,0,0,12
277071,miñjanissitā,minjanissita,1,1,0,0,12
277072,uccārapassāvaṃ,uccarapassavam,32,32,0,0,14
277073,kāyova,kayova,16,13,3,0,6
277074,sūtigharañceva,sutigharanceva,1,1,0,0,14
277075,susānañca,susananca,9,9,0,0,9
277076,passāvadoṇikā,passavadonika,1,1,0,0,13
277077,pakopena,pakopena,6,6,0,0,8
277078,ajjhattikānaṃyeva,ajjhattikanamyeva,2,2,0,0,17
277079,bāhirānañca,bahirananca,20,20,0,0,11
277080,ahivicchikādīnaṃ,ahivicchikadinam,2,2,0,0,16
277081,V1.0227,V1.0227,34,34,0,0,7
277082,paṭihitāya,patihitaya,2,2,0,0,10
277083,upakkhalitvā,upakkhalitva,13,13,0,0,12
277084,papateyyaṃ,papateyyam,7,7,0,0,10
277085,byāpajjeyya,byapajjeyya,6,6,0,0,11
277086,kuppeyya,kuppeyya,23,22,1,0,8
277087,āyudubbalatoti,ayudubbalatoti,3,0,3,0,14
277088,assāsapassāsūpanibaddhañceva,assasapassasupanibaddhanceva,1,1,0,0,28
277089,iriyāpathūpanibaddhañca,iriyapathupanibaddhanca,1,1,0,0,23
277090,sītuṇhūpanibaddhañca,situnhupanibaddhanca,1,1,0,0,20
277091,mahābhūtūpanibaddhañca,mahabhutupanibaddhanca,1,1,0,0,22
277092,āhārūpanibaddhañca,aharupanibaddhanca,1,1,0,0,18
277093,samavuttitaṃ,samavuttitam,7,7,0,0,12
277094,labhamānameva,labhamanameva,8,8,0,0,13
277095,nikkhantanāsikavāte,nikkhantanasikavate,2,1,1,0,19
277096,apavisante,apavisante,2,1,1,0,10
277097,anikkhamante,anikkhamante,3,3,0,0,12
277098,iriyāpathānampi,iriyapathanampi,1,1,0,0,15
277099,aññataraññatarassa,annatarannatarassa,2,2,0,0,18
277100,adhimattatāya,adhimattataya,13,12,1,0,13
277101,āyusaṅkhārā,ayusankhara,29,28,1,0,11
277102,upacchijjanti,upacchijjanti,6,6,0,0,13
277103,sītuṇhānampi,situnhanampi,2,2,0,0,12
277104,atisītena,atisitena,3,2,1,0,9
277105,atiuṇhena,atiunhena,3,2,1,0,9
277106,abhibhūtassa,abhibhutassa,37,36,1,0,12
277107,mahābhūtānampi,mahabhutanampi,4,4,0,0,14
277108,āpodhātuādīnaṃ,apodhatuadinam,7,7,0,0,14
277109,balasampannopi,balasampannopi,4,4,0,0,14
277110,patthaddhakāyo,patthaddhakayo,2,2,0,0,14
277111,atisārādivasena,atisaradivasena,2,2,0,0,15
277112,kilinnapūtikāyo,kilinnaputikayo,2,2,0,0,15
277113,mahāḍāhapareto,mahadahapareto,2,2,0,0,14
277114,sambhijjamānasandhibandhano,sambhijjamanasandhibandhano,1,1,0,0,27
277115,kabaḷīkārāhārampi,kabalikaraharampi,2,2,0,0,17
277116,yuttakāle,yuttakale,25,25,0,0,9
277117,labhantasseva,labhantasseva,2,2,0,0,13
277118,alabhamānassa,alabhamanassa,7,7,0,0,13
277119,avavatthānato,avavatthanato,1,1,0,0,13
277120,paricchedābhāvatoti,paricchedabhavatoti,1,1,0,0,19
277121,dehanikkhepanaṃ,dehanikkhepanam,5,4,1,0,15
277122,jīvalokasmiṃ,jivalokasmim,17,16,1,0,12
277123,jīvitabbaṃ,jivitabbam,10,10,0,0,10
277124,vavatthānābhāvato,vavatthanabhavato,21,20,1,0,17
277125,V1.0228,V1.0228,33,33,0,0,7
277126,kalalakālepi,kalalakalepi,8,8,0,0,12
277127,abbudapesighanamāsikadvemāsatemāsacatumāsapañcamāsadasamāsakālepi,abbudapesighanamasikadvemasatemasacatumasapancamasadasamasakalepi,1,1,0,0,65
277128,nikkhantasamayepi,nikkhantasamayepi,2,2,0,0,17
277129,antopi,antopi,44,42,2,0,6
277130,marantiyeva,marantiyeva,4,4,0,0,11
277131,cakkhurogenāpi,cakkhurogenapi,1,1,0,0,14
277132,sotarogādīnaṃ,sotarogadinam,3,3,0,0,13
277133,aññatarenāpi,annatarenapi,5,5,0,0,12
277134,maritabbaṃ,maritabbam,11,11,0,0,10
277135,nāññasmiṃ,nannasmim,3,3,0,0,9
277136,pubbaṇhepi,pubbanhepi,6,4,2,0,10
277137,majjhanhikādīnaṃ,majjhanhikadinam,2,2,0,0,16
277138,aññatarasmimpi,annatarasmimpi,5,5,0,0,14
277139,dehanikkhepana,dehanikkhepana,2,0,2,0,14
277140,mīyamānānaṃ,miyamananam,2,2,0,0,11
277141,patitabbaṃ,patitabbam,5,5,0,0,10
277142,nāññatrā,nannatra,2,1,1,0,8
277143,antogāme,antogame,115,109,6,0,8
277144,bahigāmepi,bahigamepi,5,5,0,0,10
277145,jātānampi,jatanampi,8,8,0,0,9
277146,thaleti,thaleti,4,2,2,0,7
277147,cutena,cutena,5,5,0,0,6
277148,nibbattitabbaṃ,nibbattitabbam,6,5,1,0,14
277149,manussalokato,manussalokato,30,30,0,0,13
277150,devalokādīnampi,devalokadinampi,1,1,0,0,15
277151,yantayuttagoṇo,yantayuttagono,3,2,1,0,14
277152,gatipañcake,gatipancake,2,2,0,0,11
277153,samparivattatīti,samparivattatiti,3,1,2,0,16
277154,addhānaparicchedatoti,addhanaparicchedatoti,3,0,3,0,21
277155,appamidaṃ,appamidam,5,5,0,0,9
277156,appamāyumanussānaṃ,appamayumanussanam,1,1,0,0,18
277157,hīḷeyya,hileyya,9,7,2,0,7
277158,nāgamoti,nagamoti,2,2,0,0,8
277159,arako,arako,10,10,0,0,5
277160,yocāyaṃ,yocayam,8,8,0,0,7
277161,maraṇassatiṃ,maranassatim,89,86,3,0,12
277162,jīveyyaṃ,jiveyyam,42,42,0,0,8
277163,manasikareyyaṃ,manasikareyyam,6,6,0,0,14
277164,V1.0229,V1.0229,33,33,0,0,7
277165,ajjhoharāmi,ajjhoharami,10,10,0,0,11
277166,assasitvā,assasitva,9,8,1,0,9
277167,passasāmi,passasami,8,8,0,0,9
277168,passasitvā,passasitva,7,7,0,0,10
277169,assasāmi,assasami,11,10,1,0,8
277170,khayāyā,khayaya,17,16,1,0,7
277171,catupañcālopasaṅkhādanamattaṃ,catupancalopasankhadanamattam,1,1,0,0,29
277172,avissāsiyo,avissasiyo,2,1,1,0,10
277173,atiparitto,atiparitto,7,6,1,0,10
277174,jīvitakkhaṇo,jivitakkhano,4,4,0,0,12
277175,ekacittappavattimattoyeva,ekacittappavattimattoyeva,3,2,1,0,25
277176,pavattamānampi,pavattamanampi,20,20,0,0,14
277177,nemippadesena,nemippadesena,4,4,0,0,13
277178,tiṭṭhamānampi,titthamanampi,4,4,0,0,13
277179,niruddhamatte,niruddhamatte,5,5,0,0,13
277180,niruddhoti,niruddhoti,11,8,3,0,10
277181,cittakkhaṇe,cittakkhane,34,33,1,0,11
277182,jīvittha,jivittha,30,30,0,0,8
277183,ekacittasamāyuttā,ekacittasamayutta,10,10,0,0,17
277184,marantassa,marantassa,9,9,0,0,10
277185,appaṭisandhikā,appatisandhika,25,22,3,0,14
277186,anibbattena,anibbattena,11,6,5,0,11
277187,V1.0230,V1.0230,33,33,0,0,7
277188,cittabhaṅgā,cittabhanga,8,5,3,0,11
277189,paramatthiyā,paramatthiya,13,9,4,0,12
277190,khaṇaparittato,khanaparittato,3,3,0,0,14
277191,anussaratopi,anussaratopi,1,1,0,0,12
277192,manasikāravasena,manasikaravasena,24,21,3,0,16
277193,saṃvejanīyattā,samvejaniyatta,1,1,0,0,14
277194,dutiyacatutthāni,dutiyacatutthani,7,6,1,0,16
277195,āruppajjhānāni,aruppajjhanani,4,4,0,0,14
277196,bhāvanāvisesena,bhavanavisesena,18,18,0,0,15
277197,visuddhibhāvanānukkamavasena,visuddhibhavananukkamavasena,3,3,0,0,28
277198,ārammaṇātikkamabhāvanāvasena,arammanatikkamabhavanavasena,3,3,0,0,28
277199,ārammaṇasamatikkamanamattaṃ,arammanasamatikkamanamattam,4,3,1,0,27
277200,maraṇassatibalena,maranassatibalena,1,1,0,0,17
277201,maraṇassaticceva,maranassaticceva,1,1,0,0,16
277202,sabbabhavesu,sabbabhavesu,31,30,1,0,12
277203,anabhiratisaññaṃ,anabhiratisannam,5,4,1,0,16
277204,pāpagarahī,papagarahi,18,16,2,0,10
277205,asannidhibahulo,asannidhibahulo,1,1,0,0,15
277206,vigatamalamacchero,vigatamalamacchero,4,4,0,0,18
277207,dukkhasaññā,dukkhasanna,50,48,2,0,11
277208,abhāvitamaraṇā,abhavitamarana,1,1,0,0,14
277209,vāḷamigayakkhasappacoravadhakābhibhūtā,valamigayakkhasappacoravadhakabhibhuta,1,1,0,0,38
277210,nārādheti,naradheti,15,15,0,0,9
277211,maraṇassatiyaṃ,maranassatiyam,2,2,0,0,14
277212,kāyagatāsatikathā,kayagatasatikatha,1,1,0,0,17
277213,V1.0231,V1.0231,33,33,0,0,7
277214,buddhuppādā,buddhuppada,16,15,1,0,11
277215,appavattapubbaṃ,appavattapubbam,2,2,0,0,15
277216,sabbatitthiyānaṃ,sabbatitthiyanam,7,6,1,0,16
277217,avisayabhūtaṃ,avisayabhutam,8,7,1,0,13
277218,saṃvegāya,samvegaya,13,11,2,0,9
277219,yogakkhemāya,yogakkhemaya,12,11,1,0,12
277220,ñāṇadassanapaṭilābhāya,nanadassanapatilabhaya,4,4,0,0,22
277221,vijjāvimuttiphalasacchikiriyāya,vijjavimuttiphalasacchikiriyaya,20,20,0,0,31
277222,aparihīnaṃ,aparihinam,4,4,0,0,10
277223,āraddhāti,araddhati,24,18,6,0,9
277224,ānāpānapabbaṃ,anapanapabbam,18,17,1,0,13
277225,iriyāpathapabbaṃ,iriyapathapabbam,12,12,0,0,16
277226,catusampajaññapabbaṃ,catusampajannapabbam,9,9,0,0,20
277227,paṭikkūlamanasikārapabbaṃ,patikkulamanasikarapabbam,2,2,0,0,25
277228,dhātumanasikārapabbaṃ,dhatumanasikarapabbam,10,10,0,0,21
277229,navasivathikapabbānīti,navasivathikapabbaniti,3,3,0,0,22
277230,kāyagatāsatikammaṭṭhānaṃ,kayagatasatikammatthanam,9,9,0,0,24
277231,dhātumanasikārapabbanti,dhatumanasikarapabbanti,2,2,0,0,23
277232,sivathikapabbāni,sivathikapabbani,3,3,0,0,16
277233,vipassanāñāṇesuyeva,vipassanananesuyeva,2,2,0,0,19
277234,ādīnavānupassanāvasena,adinavanupassanavasena,10,8,2,0,22
277235,ijjheyya,ijjheyya,12,12,0,0,8
277236,asubhaniddese,asubhaniddese,1,1,0,0,13
277237,pakāsitāyeva,pakasitayeva,4,4,0,0,12
277238,paṭikkūlamanasikārapabbañca,patikkulamanasikarapabbanca,1,1,0,0,27
277239,ānāpānassativasena,anapanassativasena,4,4,0,0,18
277240,kammaṭṭhānaṃyeva,kammatthanamyeva,10,10,0,0,16
277241,aṭṭhimiñjena,atthiminjena,6,4,2,0,12
277242,paṭikkūlamanasikāravasena,patikkulamanasikaravasena,3,3,0,0,25
277243,dvattiṃsākārakammaṭṭhānaṃ,dvattimsakarakammatthanam,14,13,1,0,25
277244,idamidha,idamidha,14,14,0,0,8
277245,pāḷivaṇṇanāpubbaṅgamo,palivannanapubbangamo,2,2,0,0,21
277246,catumahābhūtikaṃ,catumahabhutikam,4,2,2,0,16
277247,V1.0232,V1.0232,33,33,0,0,7
277248,pādatalāti,padatalati,4,1,3,0,10
277249,pādatalato,padatalato,18,18,0,0,10
277250,kesamatthakāti,kesamatthakati,3,0,3,0,14
277251,kesaggato,kesaggato,2,2,0,0,9
277252,tacaparicchinnaṃ,tacaparicchinnam,4,2,2,0,16
277253,paccavekkhatīti,paccavekkhatiti,19,7,12,0,15
277254,nānappakārakesādiasucibharito,nanappakarakesadiasucibharito,2,2,0,0,29
277255,tacapariyanto,tacapariyanto,5,5,0,0,13
277256,asucinoti,asucinoti,4,3,1,0,9
277257,asucisañcayato,asucisancayato,6,6,0,0,14
277258,kesādīnañceva,kesadinanceva,4,4,0,0,13
277259,cakkhurogādīnañca,cakkhurogadinanca,4,4,0,0,17
277260,rogasatānaṃ,rogasatanam,4,4,0,0,11
277261,āyabhūtato,ayabhutato,4,4,0,0,10
277262,paritoti,paritoti,3,2,1,0,8
277263,sabbākārenapi,sabbakarenapi,12,11,1,0,13
277264,vāsacuṇṇādiṃ,vasacunnadim,4,4,0,0,12
277265,paramaduggandhajegucchaṃ,paramaduggandhajeguccham,7,7,0,0,24
277266,asirikadassanaṃ,asirikadassanam,1,1,0,0,15
277267,kesalomādibhedaṃ,kesalomadibhedam,3,3,0,0,16
277268,asuciṃyeva,asucimyeva,4,4,0,0,10
277269,padasambandhato,padasambandhato,3,3,0,0,15
277270,tenāpissa,tenapissa,3,3,0,0,9
277271,manasikārakosallaṃ,manasikarakosallam,15,14,1,0,18
277272,ācikkhitabbaṃ,acikkhitabbam,180,165,15,0,13
277273,paricchedatoti,paricchedatoti,8,4,4,0,14
277274,paṭikkūlamanasikārakammaṭṭhāne,patikkulamanasikarakammatthane,2,2,0,0,30
277275,tipiṭako,tipitako,2,2,0,0,8
277276,manasikārakāle,manasikarakale,3,3,0,0,14
277277,sajjhāyo,sajjhayo,43,42,1,0,8
277278,malayavāsī,malayavasi,1,1,0,0,10
277279,uggahitakammaṭṭhānānaṃ,uggahitakammatthananam,2,2,0,0,22
277280,imaṃyeva,imamyeva,28,27,1,0,8
277281,dvattiṃsākārapāḷiṃ,dvattimsakarapalim,1,1,0,0,18
277282,padakkhiṇaggāhitāya,padakkhinaggahitaya,5,5,0,0,19
277283,V1.0233,V1.0233,33,33,0,0,7
277284,dvattiṃsākāraṃ,dvattimsakaram,39,36,3,0,14
277285,sajjhāyantāva,sajjhayantava,2,2,0,0,13
277286,tacapañcakādī,tacapancakadi,1,0,1,0,13
277287,anulomapaṭilomavasena,anulomapatilomavasena,25,25,0,0,21
277288,tacoti,tacoti,6,4,2,0,6
277289,kesāti,kesati,24,16,8,0,6
277290,vakkapañcake,vakkapancake,2,1,1,0,12
277291,vakkanti,vakkanti,1,1,0,0,8
277292,papphāsapañcake,papphasapancake,2,1,1,0,15
277293,yakanaṃ,yakanam,55,50,5,0,7
277294,kilomakaṃ,kilomakam,44,40,4,0,9
277295,pihakaṃ,pihakam,49,43,6,0,7
277296,papphāsanti,papphasanti,2,2,0,0,11
277297,matthaluṅgapañcake,matthalungapancake,2,1,1,0,18
277298,matthaluṅganti,matthalunganti,7,7,0,0,14
277299,medachakke,medachakke,2,1,1,0,10
277300,medoti,medoti,3,1,2,0,6
277301,muttachakke,muttachakke,2,1,1,0,11
277302,V1.0234,V1.0234,33,33,0,0,7
277303,kālasataṃ,kalasatam,1,1,0,0,9
277304,kālasahassaṃ,kalasahassam,1,1,0,0,12
277305,kālasatasahassampi,kalasatasahassampi,2,2,0,0,18
277306,sajjhāyena,sajjhayena,5,5,0,0,10
277307,kammaṭṭhānatanti,kammatthanatanti,4,4,0,0,16
277308,hatthasaṅkhalikā,hatthasankhalika,3,2,1,0,16
277309,vatipādapanti,vatipadapanti,2,2,0,0,13
277310,sajjhāyassa,sajjhayassa,8,8,0,0,11
277311,lakkhaṇapaṭivedhassa,lakkhanapativedhassa,3,3,0,0,20
277312,vaṇṇatoti,vannatoti,4,0,4,0,9
277313,disatoti,disatoti,2,0,2,0,8
277314,uparimadisā,uparimadisa,2,2,0,0,11
277315,disāyāti,disayati,6,2,4,0,8
277316,okāsatoti,okasatoti,3,1,2,0,9
277317,sabhāgaparicchedo,sabhagaparicchedo,104,102,2,0,17
277318,visabhāgaparicchedoti,visabhagaparicchedoti,2,2,0,0,21
277319,paricchinnoti,paricchinnoti,13,12,1,0,13
277320,lomāpi,lomapi,4,3,1,0,6
277321,amissakatāvasena,amissakatavasena,2,2,0,0,16
277322,visabhāgaparicchedo,visabhagaparicchedo,100,100,0,0,19
277323,ācikkhantena,acikkhantena,13,13,0,0,12
277324,paṭikkūlavasena,patikkulavasena,15,15,0,0,15
277325,mahāsatipaṭṭhāne,mahasatipatthane,26,17,9,0,16
277326,mahārāhulovāda,maharahulovada,4,2,2,0,14
277327,dhātuvibhaṅgesu,dhatuvibhangesu,3,2,1,0,15
277328,kāyagatāsatisutte,kayagatasatisutte,8,4,4,0,17
277329,V1.0235,V1.0235,33,33,0,0,7
277330,samathakammaṭṭhānaṃ,samathakammatthanam,11,11,0,0,19
277331,samathakammaṭṭhānamevāti,samathakammatthanamevati,1,1,0,0,24
277332,anupubbato,anupubbato,41,36,5,0,10
277333,nātisīghato,natisighato,20,16,4,0,11
277334,nātisaṇikato,natisanikato,13,9,4,0,12
277335,vikkhepapaṭibāhanato,vikkhepapatibahanato,7,6,1,0,20
277336,paṇṇattisamatikkamanato,pannattisamatikkamanato,6,5,1,0,23
277337,anupubbamuñcanato,anupubbamuncanato,11,10,1,0,17
277338,appanāto,appanato,6,5,1,0,8
277339,suttantāti,suttantati,10,7,3,0,10
277340,anupubbatoti,anupubbatoti,5,0,5,0,12
277341,sajjhāyakaraṇato,sajjhayakaranato,3,3,0,0,16
277342,anupaṭipāṭiyā,anupatipatiya,59,55,4,0,13
277343,ekantarikāya,ekantarikaya,14,12,2,0,12
277344,dvattiṃsapadaṃ,dvattimsapadam,4,4,0,0,14
277345,kilantakāyo,kilantakayo,13,13,0,0,11
277346,bhāvanāsampattivasena,bhavanasampattivasena,3,3,0,0,21
277347,assādassa,assadassa,10,10,0,0,9
277348,anadhigamā,anadhigama,4,4,0,0,10
277349,kilantacitto,kilantacitto,3,3,0,0,12
277350,manasikarontenāpi,manasikarontenapi,3,3,0,0,17
277351,atisīghato,atisighato,5,5,0,0,10
277352,tiyojanamaggaṃ,tiyojanamaggam,4,4,0,0,14
277353,okkamanavissajjanaṃ,okkamanavissajjanam,4,2,2,0,19
277354,sīghena,sighena,13,13,0,0,7
277355,satakkhattumpi,satakkhattumpi,27,24,3,0,14
277356,pucchitvāva,pucchitvava,23,22,1,0,11
277357,atisaṇikato,atisanikato,5,5,0,0,11
277358,rukkhapabbatataḷākādīsu,rukkhapabbatatalakadisu,2,2,0,0,23
277359,vilambamānassa,vilambamanassa,2,2,0,0,14
277360,dvīhatīhena,dvihatihena,4,4,0,0,11
277361,pariyosāpetabbo,pariyosapetabbo,2,2,0,0,15
277362,visesādhigamassa,visesadhigamassa,33,32,1,0,16
277363,vikkhepapaṭibāhanatoti,vikkhepapatibahanatoti,2,0,2,0,22
277364,puthuttārammaṇe,puthuttarammane,20,17,3,0,15
277365,paṭibāhitabbo,patibahitabbo,11,10,1,0,13
277366,appaṭibāhato,appatibahato,2,2,0,0,12
277367,papātamaggaṃ,papatamaggam,2,2,0,0,12
277368,akkamanapadaṃ,akkamanapadam,4,4,0,0,13
277369,vilokayato,vilokayato,2,2,0,0,10
277370,padavāro,padavaro,2,2,0,0,8
277371,paridhaṃsati,paridhamsati,8,7,1,0,12
277372,paṇṇattisamatikkamanatoti,pannattisamatikkamanatoti,3,0,3,0,25
277373,V1.0236,V1.0236,33,33,0,0,7
277374,lomātiādikā,lomatiadika,2,1,1,0,11
277375,paṭikkūlanti,patikkulanti,5,5,0,0,12
277376,udakadullabhakāle,udakadullabhakale,3,3,0,0,17
277377,tālapaṇṇādikaṃ,talapannadikam,3,3,0,0,14
277378,abhiṇhasañcārena,abhinhasancarena,3,3,0,0,16
277379,āgatāgatapadaṃ,agatagatapadam,2,2,0,0,14
277380,lomātipaṇṇattivasena,lomatipannattivasena,1,1,0,0,20
277381,paṭikkūlabhāvo,patikkulabhavo,5,5,0,0,14
277382,lomātipaṇṇattiṃ,lomatipannattim,1,1,0,0,15
277383,anupubbamuñcanatoti,anupubbamuncanatoti,2,0,2,0,19
277384,muñcantena,muncantena,2,2,0,0,10
277385,pariyosānakoṭṭhāsameva,pariyosanakotthasameva,5,4,1,0,22
277386,ādikoṭṭhāsameva,adikotthasameva,2,2,0,0,15
277387,upaṭṭhitesu,upatthitesu,23,22,1,0,11
277388,dvattiṃsatālake,dvattimsatalake,5,5,0,0,15
277389,tālavane,talavane,14,14,0,0,8
277390,ṭhitatālassa,thitatalassa,4,4,0,0,12
277391,pariyantatālameva,pariyantatalameva,2,2,0,0,17
277392,āditālaṃ,aditalam,2,2,0,0,8
277393,paripātiyamāno,paripatiyamano,4,4,0,0,14
277394,ukkuṭṭhukkuṭṭhiṭṭhāneyeva,ukkutthukkutthitthaneyeva,3,2,1,0,25
277395,makuḷatālapaṇṇasūciṃ,makulatalapannasucim,4,4,0,0,20
277396,vijjhiyamānopi,vijjhiyamanopi,3,3,0,0,14
277397,uṭṭhaheyya,utthaheyya,2,2,0,0,10
277398,dvattiṃsatālā,dvattimsatala,2,2,0,0,13
277399,dvattiṃsakoṭṭhāsā,dvattimsakotthasa,2,2,0,0,17
277400,makkaṭassa,makkatassa,32,31,1,0,10
277401,dvattiṃsakoṭṭhāsake,dvattimsakotthasake,3,3,0,0,19
277402,anusañcaraṇaṃ,anusancaranam,8,5,3,0,13
277403,ukkuṭṭhiyā,ukkutthiya,8,8,0,0,10
277404,pariyantatālagamanaṃ,pariyantatalagamanam,2,2,0,0,20
277405,V1.0237,V1.0237,32,32,0,0,7
277406,pariyosānakoṭṭhāseyeva,pariyosanakotthaseyeva,1,1,0,0,22
277407,paccāgamanepi,paccagamanepi,2,2,0,0,13
277408,paripātiyamānassa,paripatiyamanassa,3,3,0,0,17
277409,ukkuṭṭhukkuṭṭhiṭṭhāne,ukkutthukkutthitthane,3,3,0,0,21
277410,parikammakaraṇaṃ,parikammakaranam,18,18,0,0,16
277411,vijjhiyamānassapi,vijjhiyamanassapi,1,1,0,0,17
277412,dvattiṃsakulaṃ,dvattimsakulam,2,2,0,0,14
277413,paṭhamageheyeva,pathamageheyeva,3,3,0,0,15
277414,vissajjeyya,vissajjeyya,39,38,1,0,11
277415,dvattiṃsakulagāmo,dvattimsakulagamo,2,2,0,0,17
277416,dvattiṃsākāro,dvattimsakaro,9,9,0,0,13
277417,dvattiṃsākāre,dvattimsakare,33,31,2,0,13
277418,paṭhamagehe,pathamagehe,3,3,0,0,11
277419,koṭṭhāsadvaye,kotthasadvaye,2,2,0,0,13
277420,appanātoti,appanatoti,2,0,2,0,10
277421,appanākoṭṭhāsato,appanakotthasato,4,3,1,0,16
277422,kesādīsu,kesadisu,65,64,1,0,8
277423,bojjhaṅgakosallanti,bojjhangakosallanti,2,2,0,0,19
277424,vīriyasamādhiyojanatthaṃ,viriyasamadhiyojanattham,2,2,0,0,24
277425,adhicittamanuyuttena,adhicittamanuyuttena,12,12,0,0,20
277426,manasikātabbāni,manasikatabbani,4,4,0,0,15
277427,samādhinimittaṃ,samadhinimittam,62,44,18,0,15
277428,paggahanimittaṃ,paggahanimittam,19,19,0,0,15
277429,adhicittamanuyutto,adhicittamanuyutto,23,23,0,0,18
277430,samādhinimittaññeva,samadhinimittanneva,1,1,0,0,19
277431,manasikareyya,manasikareyya,6,6,0,0,13
277432,V1.0238,V1.0238,33,33,0,0,7
277433,kosajjāya,kosajjaya,30,25,5,0,9
277434,paggahanimittaññeva,paggahanimittanneva,1,1,0,0,19
277435,uddhaccāya,uddhaccaya,18,16,2,0,10
277436,upekkhānimittaññeva,upekkhanimittanneva,1,1,0,0,19
277437,samādhiyeyya,samadhiyeyya,4,4,0,0,12
277438,muduñca,mudunca,18,18,0,0,7
277439,kammaññañca,kammannanca,6,6,0,0,11
277440,pabhassarañca,pabhassaranca,13,13,0,0,13
277441,suvaṇṇakārantevāsī,suvannakarantevasi,26,26,0,0,18
277442,ālimpeti,alimpeti,4,4,0,0,8
277443,abhidhamati,abhidhamati,8,8,0,0,11
277444,paripphoseti,paripphoseti,8,8,0,0,12
277445,abhidhameyya,abhidhameyya,5,5,0,0,12
277446,paripphoseyya,paripphoseyya,5,5,0,0,13
277447,nibbāyeyya,nibbayeyya,32,32,0,0,10
277448,ajjhupekkheyya,ajjhupekkheyya,7,6,1,0,14
277449,piḷandhanavikatiyā,pilandhanavikatiya,6,6,0,0,18
277450,paṭikāya,patikaya,3,2,1,0,8
277451,kuṇḍalāya,kundalaya,7,7,0,0,9
277452,gīveyyāya,giveyyaya,1,1,0,0,9
277453,suvaṇṇamālāya,suvannamalaya,15,15,0,0,13
277454,V1.0239,V1.0239,33,33,0,0,7
277455,sacchikātuṃ,sacchikatum,74,74,0,0,11
277456,paṇītādhimuttiko,panitadhimuttiko,7,6,1,0,16
277457,nibbānābhirato,nibbanabhirato,10,10,0,0,14
277458,sītibhāvoti,sitibhavoti,3,2,1,0,11
277459,bojjhaṅgakosallaṃ,bojjhangakosallam,2,1,1,0,17
277460,appanākosallakathāyaṃ,appanakosallakathayam,2,2,0,0,21
277461,ubhayakosallavasena,ubhayakosallavasena,2,2,0,0,19
277462,akathāpetvā,akathapetva,2,2,0,0,11
277463,anuyujjantena,anuyujjantena,1,1,0,0,13
277464,kathāpetabbaṃ,kathapetabbam,2,2,0,0,13
277465,vasitukāmena,vasitukamena,5,5,0,0,12
277466,pathavīkasiṇaniddese,pathavikasinaniddese,6,3,3,0,20
277467,paṭikkūlamanasikāre,patikkulamanasikare,3,3,0,0,19
277468,chinnaṭṭhānepi,chinnatthanepi,2,2,0,0,14
277469,yāgupatte,yagupatte,7,7,0,0,9
277470,oloketumpi,oloketumpi,25,25,0,0,10
277471,kāḷakakāle,kalakakale,3,3,0,0,10
277472,kāḷakāti,kalakati,8,7,1,0,8
277473,V1.0240,V1.0240,33,33,0,0,7
277474,setakāle,setakale,2,2,0,0,8
277475,setāti,setati,5,3,2,0,6
277476,missakakāle,missakakale,2,2,0,0,11
277477,tacapañcake,tacapancake,6,6,0,0,11
277478,koṭṭhāsavavatthāpanakathā,kotthasavavatthapanakatha,1,1,0,0,25
277479,sabbakoṭṭhāse,sabbakotthase,4,4,0,0,13
277480,vaṇṇasaṇṭhānadisokāsaparicchedavasena,vannasanthanadisokasaparicchedavasena,13,13,0,0,37
277481,vaṇṇasaṇṭhānagandhaāsayokāsavasena,vannasanthanagandhaasayokasavasena,2,2,0,0,34
277482,paṭikkūlato,patikkulato,12,12,0,0,11
277483,sabbakoṭṭhāsesu,sabbakotthasesu,13,12,1,0,15
277484,pakativaṇṇena,pakativannena,5,5,0,0,13
277485,addāriṭṭhakavaṇṇā,addaritthakavanna,7,7,0,0,17
277486,dīghavaṭṭalikā,dighavattalika,3,3,0,0,14
277487,tulādaṇḍasaṇṭhānā,tuladandasanthana,2,2,0,0,17
277488,uparimadisāya,uparimadisaya,6,6,0,0,13
277489,nalāṭantena,nalatantena,3,3,0,0,11
277490,galavāṭakena,galavatakena,3,3,0,0,12
277491,sīsakaṭāhaveṭhanaṃ,sisakatahavethanam,2,2,0,0,18
277492,allacammaṃ,allacammam,4,4,0,0,10
277493,sīsaveṭhanacamme,sisavethanacamme,3,3,0,0,16
277494,vīhaggamattaṃ,vihaggamattam,5,5,0,0,13
277495,mūlatalena,mulatalena,9,9,0,0,10
277496,avasesaekatiṃsakoṭṭhāsehi,avasesaekatimsakotthasehi,1,1,0,0,25
277497,amissīkatā,amissikata,3,3,0,0,10
277498,pāṭiyekko,patiyekko,138,119,19,0,9
277499,ekakoṭṭhāsoti,ekakotthasoti,2,2,0,0,13
277500,vaṇṇādito,vannadito,44,44,0,0,9
277501,vavatthāpanaṃ,vavatthapanam,17,16,1,0,13
277502,gandhatopi,gandhatopi,10,10,0,0,10
277503,āsayatopi,asayatopi,11,10,1,0,9
277504,bhattapatte,bhattapatte,5,5,0,0,11
277505,kesavaṇṇaṃ,kesavannam,7,7,0,0,10
277506,kesamissakamidaṃ,kesamissakamidam,5,5,0,0,16
277507,bhuñjantāpi,bhunjantapi,7,7,0,0,11
277508,kesasaṇṭhānaṃ,kesasanthanam,7,7,0,0,13
277509,akkavākaṃ,akkavakam,5,5,0,0,9
277510,makacivākaṃ,makacivakam,5,5,0,0,11
277511,chupitvāpi,chupitvapi,2,2,0,0,10
277512,telamakkhanapupphadhūpādi,telamakkhanapupphadhupadi,1,1,0,0,25
277513,saṅkhāravirahitānañca,sankharavirahitananca,1,1,0,0,21
277514,paramajeguccho,paramajeguccho,9,9,0,0,14
277515,jegucchataro,jegucchataro,5,5,0,0,12
277516,vaṇṇasaṇṭhānato,vannasanthanato,19,18,1,0,15
277517,appaṭikkūlāpi,appatikkulapi,2,2,0,0,13
277518,paṭikkūlāyeva,patikkulayeva,2,2,0,0,13
277519,daharassa,daharassa,67,65,2,0,9
277520,haliddivaṇṇaṃ,haliddivannam,6,6,0,0,13
277521,haliddipiṇḍasaṇṭhānaṃ,haliddipindasanthanam,3,3,0,0,21
277522,chaḍḍitañca,chadditanca,5,5,0,0,11
277523,uddhumātakakāḷasunakhasarīraṃ,uddhumatakakalasunakhasariram,5,5,0,0,29
277524,tālapakkavaṇṇaṃ,talapakkavannam,5,5,0,0,15
277525,V1.0241,V1.0241,33,33,0,0,7
277526,vissaṭṭhamudiṅgasaṇṭhānaṃ,vissatthamudingasanthanam,5,5,0,0,25
277527,dāṭhāpissa,dathapissa,5,5,0,0,10
277528,sumanamakuḷasadisāti,sumanamakulasadisati,3,3,0,0,20
277529,appaṭikkūlaṃ,appatikkulam,6,6,0,0,12
277530,paṭikkūlameva,patikkulameva,2,2,0,0,13
277531,kesāpi,kesapi,14,14,0,0,6
277532,appaṭikkūlā,appatikkula,7,7,0,0,11
277533,paṭikkūlāyevāti,patikkulayevati,1,1,0,0,15
277534,asuciṭṭhāne,asucitthane,13,13,0,0,11
277535,gāmanissandena,gamanissandena,5,5,0,0,14
277536,sūpeyyapaṇṇāni,supeyyapannani,5,5,0,0,14
277537,nāgarikamanussānaṃ,nagarikamanussanam,5,5,0,0,18
277538,jegucchāni,jegucchani,5,5,0,0,10
277539,aparibhogāni,aparibhogani,8,8,0,0,12
277540,pubbalohitamuttakarīsapittasemhādinissandena,pubbalohitamuttakarisapittasemhadinissandena,6,6,0,0,44
277541,jegucchāti,jegucchati,2,2,0,0,10
277542,pāṭikkulyaṃ,patikkulyam,2,2,0,0,11
277543,uṭṭhitakaṇṇikaṃ,utthitakannikam,3,3,0,0,15
277544,ekatiṃsakoṭṭhāsarāsimhi,ekatimsakotthasarasimhi,5,5,0,0,23
277545,susānasaṅkāraṭṭhānādīsu,susanasankaratthanadisu,5,5,0,0,23
277546,jātasākaṃ,jatasakam,5,5,0,0,9
277547,parikkhādīsu,parikkhadisu,1,1,0,0,12
277548,jātakamalakuvalayādipupphaṃ,jatakamalakuvalayadipuppham,5,5,0,0,27
277549,paramajegucchāti,paramajegucchati,7,7,0,0,16
277550,sabbakoṭṭhāsānaṃ,sabbakotthasanam,2,2,0,0,16
277551,vaṇṇasaṇṭhānagandhāsayokāsavasena,vannasanthanagandhasayokasavasena,11,11,0,0,33
277552,paṭikkūlatā,patikkulata,26,26,0,0,11
277553,pakativaṇṇato,pakativannato,3,3,0,0,13
277554,asambhinnakāḷakā,asambhinnakalaka,3,2,1,0,16
277555,kāḷapiṅgalā,kalapingala,2,2,0,0,11
277556,tālamūlasaṇṭhānā,talamulasanthana,1,1,0,0,16
277557,patiṭṭhitokāsañca,patitthitokasanca,2,2,0,0,17
277558,avasesasarīraveṭhanacamme,avasesasariravethanacamme,2,2,0,0,25
277559,sarīraveṭhanacamme,sariravethanacamme,6,6,0,0,18
277560,likhāmattaṃ,likhamattam,2,2,0,0,11
277561,kesasadisoyeva,kesasadisoyeva,32,32,0,0,14
277562,nakhapattānaṃ,nakhapattanam,1,1,0,0,13
277563,macchasakalikasaṇṭhānā,macchasakalikasanthana,3,3,0,0,22
277564,heṭṭhimadisāya,hetthimadisaya,3,3,0,0,14
277565,hatthanakhā,hatthanakha,2,2,0,0,11
277566,uparimadisāyāti,uparimadisayati,2,2,0,0,15
277567,aggapiṭṭhesu,aggapitthesu,3,3,0,0,12
277568,aṅgulikoṭimaṃsehi,angulikotimamsehi,2,2,0,0,17
277569,aṅgulipiṭṭhimaṃsena,angulipitthimamsena,2,2,0,0,19
277570,V1.0242,V1.0242,33,33,0,0,7
277571,dantaṭṭhikāni,dantatthikani,2,2,0,0,13
277572,ṭhapitaalābubījasaṇṭhānā,thapitaalabubijasanthana,2,2,0,0,24
277573,yānakaupatthambhinisaṇṭhāno,yanakaupatthambhinisanthano,1,1,0,0,27
277574,timūlā,timula,7,7,0,0,6
277575,catumūlā,catumula,2,2,0,0,8
277576,uparimapāḷiyāpi,uparimapaliyapi,2,2,0,0,15
277577,hanukaṭṭhikesu,hanukatthikesu,5,5,0,0,14
277578,hanukaṭṭhike,hanukatthike,4,4,0,0,12
277579,ṭhitacammaṃ,thitacammam,4,4,0,0,11
277580,kāḷasāmapītādivaṇṇā,kalasamapitadivanna,2,2,0,0,19
277581,sakalasarīratopi,sakalasariratopi,3,3,0,0,16
277582,saṅkaḍḍhiyamānā,sankaddhiyamana,2,2,0,0,15
277583,badaraṭṭhimattā,badaratthimatta,3,3,0,0,15
277584,setoyeva,setoyeva,3,3,0,0,8
277585,setabhāvo,setabhavo,3,3,0,0,9
277586,aggijālābhighātapaharaṇappahārādīhi,aggijalabhighatapaharanappaharadihi,1,1,0,0,35
277587,viddhaṃsitāya,viddhamsitaya,4,4,0,0,13
277588,sarīrasaṇṭhānova,sarirasanthanova,2,2,0,0,16
277589,pādaṅgulittaco,padangulittaco,3,3,0,0,14
277590,kosakārakakosasaṇṭhāno,kosakarakakosasanthano,3,3,0,0,22
277591,piṭṭhipādattaco,pitthipadattaco,3,3,0,0,15
277592,puṭabandhaupāhanasaṇṭhāno,putabandhaupahanasanthano,2,2,0,0,25
277593,jaṅghattaco,janghattaco,3,3,0,0,11
277594,bhattapuṭakatālapaṇṇasaṇṭhāno,bhattaputakatalapannasanthano,3,3,0,0,29
277595,ūruttaco,uruttaco,3,3,0,0,8
277596,taṇḍulabharitadīghatthavikasaṇṭhāno,tandulabharitadighatthavikasanthano,3,3,0,0,35
277597,ānisadattaco,anisadattaco,4,4,0,0,12
277598,udakapūritapaṭaparissāvanasaṇṭhāno,udakapuritapataparissavanasanthano,3,3,0,0,34
277599,piṭṭhittaco,pitthittaco,4,4,0,0,11
277600,phalakonaddhacammasaṇṭhāno,phalakonaddhacammasanthano,3,3,0,0,26
277601,kucchittaco,kucchittaco,3,3,0,0,11
277602,vīṇādoṇikonaddhacammasaṇṭhāno,vinadonikonaddhacammasanthano,3,3,0,0,29
277603,urattaco,urattaco,3,3,0,0,8
277604,caturassasaṇṭhāno,caturassasanthano,5,5,0,0,17
277605,ubhayabāhuttaco,ubhayabahuttaco,2,2,0,0,15
277606,tūṇironaddhacammasaṇṭhāno,tunironaddhacammasanthano,1,1,0,0,25
277607,piṭṭhihatthattaco,pitthihatthattaco,3,3,0,0,17
277608,khurakosasaṇṭhāno,khurakosasanthano,2,2,0,0,17
277609,phaṇakatthavikasaṇṭhāno,phanakatthavikasanthano,3,3,0,0,23
277610,hatthaṅgulittaco,hatthangulittaco,3,3,0,0,16
277611,kuñcikākosakasaṇṭhāno,kuncikakosakasanthano,2,2,0,0,21
277612,gīvattaco,givattaco,3,3,0,0,9
277613,galakañcukasaṇṭhāno,galakancukasanthano,3,3,0,0,19
277614,mukhattaco,mukhattaco,4,4,0,0,10
277615,chiddāvachiddo,chiddavachiddo,6,6,0,0,14
277616,kīṭakulāvakasaṇṭhāno,kitakulavakasanthano,2,2,0,0,20
277617,sīsattaco,sisattaco,4,4,0,0,9
277618,pattatthavikasaṇṭhānoti,pattatthavikasanthanoti,3,3,0,0,23
277619,tacapariggaṇhakena,tacaparigganhakena,3,3,0,0,18
277620,yogāvacarena,yogavacarena,206,206,0,0,12
277621,uttaroṭṭhato,uttarotthato,3,3,0,0,12
277622,V1.0243,V1.0243,33,33,0,0,7
277623,pariyonandhitvā,pariyonandhitva,52,52,0,0,15
277624,nalāṭaṭṭhicammaṃ,nalatatthicammam,2,2,0,0,16
277625,pakkhittapattassa,pakkhittapattassa,2,2,0,0,17
277626,hatthamiva,hatthamiva,2,2,0,0,10
277627,sīsaṭṭhikassa,sisatthikassa,2,2,0,0,13
277628,sīsacammassa,sisacammassa,2,2,0,0,12
277629,aṭṭhikena,atthikena,2,2,0,0,9
277630,ekābaddhabhāvaṃ,ekabaddhabhavam,4,4,0,0,15
277631,viyojentena,viyojentena,2,2,0,0,11
277632,sīsacammaṃ,sisacammam,5,5,0,0,10
277633,khandhacammaṃ,khandhacammam,2,2,0,0,13
277634,anulomena,anulomena,27,24,3,0,9
277635,dakkhiṇahatthacammaṃ,dakkhinahatthacammam,2,2,0,0,20
277636,vāmahatthacammaṃ,vamahatthacammam,2,2,0,0,16
277637,piṭṭhicammaṃ,pitthicammam,4,4,0,0,12
277638,dakkhiṇapādacammaṃ,dakkhinapadacammam,2,2,0,0,18
277639,vāmapādacammaṃ,vamapadacammam,2,2,0,0,14
277640,anukkameneva,anukkameneva,27,27,0,0,12
277641,vatthiudarahadayagīvacammāni,vatthiudarahadayagivacammani,2,2,0,0,28
277642,vavatthapetabbāni,vavatthapetabbani,3,3,0,0,17
277643,gīvacammānantaraṃ,givacammanantaram,1,1,0,0,17
277644,heṭṭhimahanucammaṃ,hetthimahanucammam,2,2,0,0,18
277645,adharoṭṭhapariyosānaṃ,adharotthapariyosanam,2,2,0,0,21
277646,oḷārikoḷārikaṃ,olarikolarikam,9,9,0,0,14
277647,patiṭṭhitatalena,patitthitatalena,7,7,0,0,16
277648,maṃsapesisatāni,mamsapesisatani,3,3,0,0,15
277649,kiṃsukapupphasadisaṃ,kimsukapupphasadisam,2,2,0,0,20
277650,jaṅghapiṇḍikamaṃsaṃ,janghapindikamamsam,2,2,0,0,19
277651,tālapaṇṇapuṭabhattasaṇṭhānaṃ,talapannaputabhattasanthanam,2,2,0,0,28
277652,ūrumaṃsaṃ,urumamsam,11,10,1,0,9
277653,nisadapotasaṇṭhānaṃ,nisadapotasanthanam,1,1,0,0,19
277654,ānisadamaṃsaṃ,anisadamamsam,5,5,0,0,13
277655,uddhanakoṭisaṇṭhānaṃ,uddhanakotisanthanam,3,3,0,0,20
277656,tālaguḷapaṭalasaṇṭhānaṃ,talagulapatalasanthanam,3,3,0,0,23
277657,phāsukadvayamaṃsaṃ,phasukadvayamamsam,3,3,0,0,18
277658,koṭṭhalikāya,kotthalikaya,2,2,0,0,12
277659,tanumattikālepasaṇṭhānaṃ,tanumattikalepasanthanam,2,2,0,0,24
277660,thanamaṃsaṃ,thanamamsam,3,3,0,0,11
277661,avakkhittamattikāpiṇḍasaṇṭhānaṃ,avakkhittamattikapindasanthanam,2,2,0,0,31
277662,bāhudvayamaṃsaṃ,bahudvayamamsam,2,2,0,0,15
277663,ṭhapitaniccammamahāmūsikasaṇṭhānaṃ,thapitaniccammamahamusikasanthanam,2,2,0,0,34
277664,vīsādhikāni,visadhikani,12,11,1,0,11
277665,aṭṭhisatāni,atthisatani,18,18,0,0,11
277666,anulimpitvā,anulimpitva,12,11,1,0,11
277667,aṭṭhisaṅghāte,atthisanghate,2,2,0,0,13
277668,nhārūti,nharuti,4,2,2,0,7
277669,nhārusatāni,nharusatani,4,4,0,0,11
277670,nānāsaṇṭhānā,nanasanthana,8,8,0,0,12
277671,mahānhārū,mahanharu,10,10,0,0,9
277672,vinandhamānā,vinandhamana,10,10,0,0,12
277673,purimapassena,purimapassena,6,6,0,0,13
277674,pacchimapassena,pacchimapassena,6,6,0,0,15
277675,vinandhamānāpi,vinandhamanapi,2,2,0,0,14
277676,dakkhiṇapādaṃ,dakkhinapadam,8,8,0,0,13
277677,vāmapādaṃ,vamapadam,12,12,0,0,9
277678,vinandhamānāpīti,vinandhamanapiti,1,1,0,0,16
277679,sarīradhārakā,sariradharaka,3,3,0,0,13
277680,saṭṭhimahānhārū,satthimahanharu,1,1,0,0,15
277681,V1.0244,V1.0244,33,33,0,0,7
277682,kandalamakuḷasaṇṭhānā,kandalamakulasanthana,3,3,0,0,21
277683,suttarajjukasaṇṭhānā,suttarajjukasanthana,2,2,0,0,20
277684,pūtilatāsaṇṭhānā,putilatasanthana,3,3,0,0,16
277685,mahāvīṇātantisaṇṭhānā,mahavinatantisanthana,2,2,0,0,21
277686,thūlasuttakasaṇṭhānā,thulasuttakasanthana,3,3,0,0,20
277687,sakuṇapādasaṇṭhānā,sakunapadasanthana,3,3,0,0,18
277688,sīsajālakasaṇṭhānā,sisajalakasanthana,2,2,0,0,18
277689,pasāritaallajālasaṇṭhānā,pasaritaallajalasanthana,2,2,0,0,24
277690,taṃtaṃaṅgapaccaṅgānugatā,tamtamangapaccanganugata,3,3,0,0,24
277691,paṭimukkajālakañcukasaṇṭhānā,patimukkajalakancukasanthana,2,2,0,0,28
277692,ābandhitvā,abandhitva,46,40,6,0,10
277693,aṭṭhisatānaṃ,atthisatanam,2,2,0,0,12
277694,patiṭṭhitatalehi,patitthitatalehi,3,3,0,0,16
277695,ṭhitappadesehi,thitappadesehi,1,1,0,0,14
277696,dantaṭṭhīni,dantatthini,2,2,0,0,11
277697,hatthaṭṭhīni,hatthatthini,2,2,0,0,12
277698,pādaṭṭhīni,padatthini,2,2,0,0,10
277699,maṃsanissitāni,mamsanissitani,3,3,0,0,14
277700,muduaṭṭhīni,muduatthini,2,2,0,0,11
277701,paṇhikaṭṭhīni,panhikatthini,4,4,0,0,13
277702,gopphakaṭṭhīni,gopphakatthini,11,11,0,0,14
277703,jaṅghaṭṭhīni,janghatthini,7,7,0,0,12
277704,jaṇṇukaṭṭhi,jannukatthi,6,5,1,0,11
277705,ūruṭṭhi,urutthi,15,15,0,0,7
277706,kaṭiṭṭhīni,katitthini,9,9,0,0,10
277707,piṭṭhikaṇṭakaṭṭhīni,pitthikantakatthini,9,9,0,0,19
277708,phāsukaṭṭhīni,phasukatthini,3,3,0,0,13
277709,uraṭṭhīni,uratthini,6,6,0,0,9
277710,M1.0246,M1.0246,30,30,0,0,7
277711,hadayaṭṭhi,hadayatthi,6,6,0,0,10
277712,akkhakaṭṭhīni,akkhakatthini,6,6,0,0,13
277713,koṭṭaṭṭhīni,kottatthini,2,2,0,0,11
277714,bāhuṭṭhīni,bahutthini,3,3,0,0,10
277715,aggabāhuṭṭhīni,aggabahutthini,3,3,0,0,14
277716,gīvaṭṭhīni,givatthini,12,12,0,0,10
277717,hanukaṭṭhīni,hanukatthini,7,7,0,0,12
277718,nāsikaṭṭhi,nasikatthi,3,3,0,0,10
277719,akkhiṭṭhīni,akkhitthini,3,3,0,0,11
277720,kaṇṇaṭṭhīni,kannatthini,3,3,0,0,11
277721,muddhaṭṭhi,muddhatthi,5,5,0,0,10
277722,sīsakapālaṭṭhīnīti,sisakapalatthiniti,3,3,0,0,18
277723,timattāni,timattani,4,4,0,0,9
277724,nānāsaṇṭhānāni,nanasanthanani,3,3,0,0,14
277725,aggapādaṅguliaṭṭhīni,aggapadanguliatthini,1,1,0,0,20
277726,katakabījasaṇṭhānāni,katakabijasanthanani,6,6,0,0,20
277727,tadanantarāni,tadanantarani,5,5,0,0,13
277728,majjhapabbaṭṭhīni,majjhapabbatthini,6,6,0,0,17
277729,panasaṭṭhisaṇṭhānāni,panasatthisanthanani,2,2,0,0,20
277730,mūlapabbaṭṭhīni,mulapabbatthini,5,5,0,0,15
277731,paṇavasaṇṭhānāni,panavasanthanani,6,6,0,0,16
277732,piṭṭhipādaṭṭhīni,pitthipadatthini,3,3,0,0,16
277733,koṭṭitakandalakandarāsisaṇṭhānāni,kottitakandalakandarasisanthanani,5,5,0,0,33
277734,paṇhikaṭṭhi,panhikatthi,6,6,0,0,11
277735,ekaṭṭhitālaphalabījasaṇṭhānaṃ,ekatthitalaphalabijasanthanam,2,2,0,0,29
277736,baddhakīḷāgoḷakasaṇṭhānāni,baddhakilagolakasanthanani,1,1,0,0,26
277737,jaṅghaṭṭhīnaṃ,janghatthinam,2,2,0,0,13
277738,gopphakaṭṭhīsu,gopphakatthisu,4,4,0,0,14
277739,apanītatacasindikaḷīrasaṇṭhānaṃ,apanitatacasindikalirasanthanam,1,1,0,0,31
277740,khuddakajaṅghaṭṭhikaṃ,khuddakajanghatthikam,2,2,0,0,21
277741,dhanukadaṇḍasaṇṭhānaṃ,dhanukadandasanthanam,2,2,0,0,21
277742,milātasappapiṭṭhisaṇṭhānaṃ,milatasappapitthisanthanam,2,2,0,0,26
277743,parikkhīṇapheṇakasaṇṭhānaṃ,parikkhinaphenakasanthanam,2,2,0,0,26
277744,jaṅghaṭṭhikassa,janghatthikassa,6,4,2,0,15
277745,atikhiṇaggagosiṅgasaṇṭhānaṃ,atikhinaggagosingasanthanam,2,2,0,0,27
277746,duttacchitavāsiparasudaṇḍasaṇṭhānaṃ,duttacchitavasiparasudandasanthanam,1,1,0,0,35
277747,kaṭiṭṭhimhi,katitthimhi,6,6,0,0,11
277748,kīḷāgoḷakasaṇṭhānaṃ,kilagolakasanthanam,2,2,0,0,19
277749,kaṭiṭṭhino,katitthino,4,2,2,0,10
277750,aggacchinnamahāpunnāgaphalasaṇṭhānaṃ,aggacchinnamahapunnagaphalasanthanam,2,2,0,0,36
277751,V1.0245,V1.0245,33,33,0,0,7
277752,kumbhakārikauddhanasaṇṭhānāni,kumbhakarikauddhanasanthanani,1,1,0,0,29
277753,kammārakūṭayottakasaṇṭhānāni,kammarakutayottakasanthanani,2,2,0,0,28
277754,ānisadaṭṭhi,anisadatthi,1,1,0,0,11
277755,gahitasappaphaṇasaṇṭhānaṃ,gahitasappaphanasanthanam,2,2,0,0,25
277756,sattaṭṭhaṭṭhānesu,sattatthatthanesu,2,2,0,0,17
277757,abbhantarato,abbhantarato,32,32,0,0,12
277758,ṭhapitasīsapaṭṭaveṭhakasaṇṭhānāni,thapitasisapattavethakasanthanani,1,1,0,0,33
277759,bāhirato,bahirato,33,31,2,0,8
277760,vaṭṭanāvaḷisaṇṭhānāni,vattanavalisanthanani,2,2,0,0,21
277761,kakacadantasadisā,kakacadantasadisa,2,2,0,0,17
277762,phāsukaṭṭhīsu,phasukatthisu,3,3,0,0,13
277763,aparipuṇṇāni,aparipunnani,5,5,0,0,12
277764,aparipuṇṇaasisaṇṭhānāni,aparipunnaasisanthanani,1,1,0,0,23
277765,paripuṇṇaasisaṇṭhānāni,paripunnaasisanthanani,1,1,0,0,22
277766,odātakukkuṭassa,odatakukkutassa,3,3,0,0,15
277767,pasāritapakkhasaṇṭhānāni,pasaritapakkhasanthanani,2,2,0,0,24
277768,jiṇṇasandamānikapañjarasaṇṭhānāni,jinnasandamanikapanjarasanthanani,2,2,0,0,33
277769,dabbiphaṇasaṇṭhānaṃ,dabbiphanasanthanam,3,3,0,0,19
277770,khuddakalohavāsidaṇḍasaṇṭhānāni,khuddakalohavasidandasanthanani,3,3,0,0,31
277771,parikkhīṇasīhaḷakuddālasaṇṭhānāni,parikkhinasihalakuddalasanthanani,1,1,0,0,33
277772,ādāsadaṇḍakasaṇṭhānāni,adasadandakasanthanani,2,2,0,0,22
277773,yamakatālakandasaṇṭhānāni,yamakatalakandasanthanani,3,3,0,0,25
277774,maṇibandhaṭṭhīni,manibandhatthini,3,3,0,0,16
277775,alliyāpetvā,alliyapetva,7,7,0,0,11
277776,ṭhapitasīsakapaṭṭaveṭhakasaṇṭhānāni,thapitasisakapattavethakasanthanani,5,5,0,0,35
277777,piṭṭhihatthaṭṭhīni,pitthihatthatthini,3,3,0,0,18
277778,hatthaṅgulīsu,hatthangulisu,2,2,0,0,13
277779,aparipuṇṇapanasaṭṭhisaṇṭhānāni,aparipunnapanasatthisanthanani,4,4,0,0,30
277780,aggapabbaṭṭhīni,aggapabbatthini,4,4,0,0,15
277781,ṭhapitavaṃsakaḷīracakkalakasaṇṭhānāni,thapitavamsakaliracakkalakasanthanani,1,1,0,0,37
277782,heṭṭhimahanukaṭṭhi,hetthimahanukatthi,3,3,0,0,18
277783,ayokūṭayottakasaṇṭhānaṃ,ayokutayottakasanthanam,3,3,0,0,23
277784,avalekhanasatthakasaṇṭhānaṃ,avalekhanasatthakasanthanam,3,3,0,0,27
277785,akkhikūpanāsakūpaṭṭhīni,akkhikupanasakupatthini,1,1,0,0,23
277786,apanītamiñjataruṇatālaṭṭhisaṇṭhānāni,apanitaminjatarunatalatthisanthanani,3,3,0,0,36
277787,adhomukhaṭṭhapitasaṅkhathālakakapālasaṇṭhānaṃ,adhomukhatthapitasankhathalakakapalasanthanam,1,1,0,0,45
277788,kaṇṇacūḷikaṭṭhīni,kannaculikatthini,3,3,0,0,17
277789,nhāpitakhurakosasaṇṭhānāni,nhapitakhurakosasanthanani,2,2,0,0,26
277790,nalāṭakaṇṇacūḷikānaṃ,nalatakannaculikanam,3,3,0,0,20
277791,paṭṭabandhanokāse,pattabandhanokase,3,3,0,0,17
277792,aṭṭhisaṅkuṭitaghaṭapuṇṇapaṭalakhaṇḍasaṇṭhānaṃ,atthisankutitaghatapunnapatalakhandasanthanam,1,1,0,0,45
277793,mukhacchinnavaṅkanāḷikerasaṇṭhānaṃ,mukhacchinnavankanalikerasanthanam,3,3,0,0,34
277794,sīsaṭṭhīni,sisatthini,8,8,0,0,10
277795,sibbetvā,sibbetva,31,31,0,0,8
277796,ṭhapitajajjaralābukaṭāhasaṇṭhānāni,thapitajajjaralabukatahasanthanani,2,2,0,0,34
277797,givaṭṭhīsu,givatthisu,1,1,0,0,10
277798,piṭṭhikaṇṭakaṭṭhīsu,pitthikantakatthisu,3,3,0,0,19
277799,kaṭiṭṭhīsu,katitthisu,3,3,0,0,10
277800,ūruṭṭhīsu,urutthisu,2,2,0,0,9
277801,ūruṭṭhīni,urutthini,7,7,0,0,9
277802,jaṇṇukaṭṭhīsu,jannukatthisu,2,2,0,0,13
277803,jaṇṇukaṭṭhīni,jannukatthini,4,4,0,0,13
277804,jaṅghaṭṭhīsu,janghatthisu,2,2,0,0,12
277805,piṭṭhipādaṭṭhīsu,pitthipadatthisu,2,2,0,0,16
277806,paricchinnāni,paricchinnani,6,6,0,0,13
277807,V1.0246,V1.0246,33,33,0,0,7
277808,abbhantaragataṃ,abbhantaragatam,14,14,0,0,15
277809,mahantamahantānaṃ,mahantamahantanam,4,4,0,0,17
277810,veḷunāḷiyaṃ,velunaliyam,2,2,0,0,11
277811,pakkhittaseditamahāvettaggasaṇṭhānaṃ,pakkhittaseditamahavettaggasanthanam,2,2,0,0,36
277812,khuddānukhuddakānaṃ,khuddanukhuddakanam,5,5,0,0,19
277813,veḷuyaṭṭhipabbesu,veluyatthipabbesu,2,2,0,0,17
277814,pakkhittaseditatanuvettaggasaṇṭhānaṃ,pakkhittaseditatanuvettaggasanthanam,2,2,0,0,36
277815,abbhantaratalehi,abbhantaratalehi,5,5,0,0,16
277816,ekabandhanā,ekabandhana,2,2,0,0,11
277817,maṃsapiṇḍikā,mamsapindika,2,2,0,0,12
277818,mandarattaṃ,mandarattam,5,5,0,0,11
277819,pāḷibhaddakaṭṭhivaṇṇaṃ,palibhaddakatthivannam,2,2,0,0,22
277820,yamakakīḷāgoḷakasaṇṭhānaṃ,yamakakilagolakasanthanam,2,2,0,0,25
277821,ekavaṇṭapaṭibaddhaambaphaladvayasaṇṭhānaṃ,ekavantapatibaddhaambaphaladvayasanthanam,2,2,0,0,41
277822,galavāṭakā,galavataka,7,7,0,0,10
277823,ekamūlena,ekamulena,7,7,0,0,9
277824,thūlanhārunā,thulanharuna,9,9,0,0,12
277825,vinibaddhaṃ,vinibaddham,13,11,2,0,11
277826,vakkabhāgena,vakkabhagena,5,3,2,0,12
277827,rattapadumapattapiṭṭhivaṇṇaṃ,rattapadumapattapitthivannam,1,1,0,0,28
277828,bāhirapattāni,bahirapattani,8,8,0,0,13
277829,ṭhapitapadumamakuḷasaṇṭhānaṃ,thapitapadumamakulasanthanam,1,1,0,0,28
277830,maṭṭhaṃ,mattham,65,63,2,0,7
277831,kosātakīphalassa,kosatakiphalassa,4,4,0,0,16
277832,abbhantarasadisaṃ,abbhantarasadisam,4,4,0,0,17
277833,mandapaññānaṃ,mandapannanam,7,7,0,0,13
277834,makuḷitameva,makulitameva,4,4,0,0,12
277835,punnāgaṭṭhipatiṭṭhānamatto,punnagatthipatitthanamatto,2,2,0,0,26
277836,āvāṭako,avatako,4,3,1,0,7
277837,addhapasatamattaṃ,addhapasatamattam,2,2,0,0,17
277838,maṃsadhovanaudakasadisaṃ,mamsadhovanaudakasadisam,2,2,0,0,24
277839,kulatthayūsavaṇṇaṃ,kulatthayusavannam,4,4,0,0,18
277840,kaṇikārapupphavaṇṇaṃ,kanikarapupphavannam,8,8,0,0,20
277841,paññācaritassa,pannacaritassa,4,4,0,0,14
277842,niddhotajātimaṇi,niddhotajatimani,4,4,0,0,16
277843,jutimantaṃ,jutimantam,6,5,1,0,10
277844,hadayabhāgena,hadayabhagena,3,3,0,0,13
277845,yamakamaṃsapaṭalaṃ,yamakamamsapatalam,3,3,0,0,18
277846,paṇḍukadhātukaṃ,pandukadhatukam,2,1,1,0,15
277847,nātirattakumudassa,natirattakumudassa,2,2,0,0,18
277848,pattapiṭṭhivaṇṇaṃ,pattapitthivannam,2,2,0,0,17
277849,koviḷārapattasaṇṭhānaṃ,kovilarapattasanthanam,3,3,0,0,22
277850,dandhānaṃ,dandhanam,3,3,0,0,9
277851,V1.0247,V1.0247,33,33,0,0,7
277852,yakanabhāgena,yakanabhagena,3,3,0,0,13
277853,paṭicchannāpaṭicchannabhedato,paticchannapaticchannabhedato,3,3,0,0,29
277854,pariyonahanamaṃsaṃ,pariyonahanamamsam,4,3,1,0,18
277855,dukūlapilotikavaṇṇaṃ,dukulapilotikavannam,2,2,0,0,20
277856,okāsasaṇṭhānaṃ,okasasanthanam,21,21,0,0,14
277857,paṭicchannakilomakaṃ,paticchannakilomakam,7,7,0,0,20
277858,M1.0249,M1.0249,30,30,0,0,7
277859,appaṭicchannakilomakaṃ,appaticchannakilomakam,3,3,0,0,22
277860,kilomakabhāgena,kilomakabhagena,3,3,0,0,15
277861,udarajivhāmaṃsaṃ,udarajivhamamsam,4,3,1,0,16
277862,nigguṇḍipupphavaṇṇaṃ,niggundipupphavannam,2,1,1,0,20
277863,sattaṅgulappamāṇaṃ,sattangulappamanam,3,3,0,0,18
277864,abandhanaṃ,abandhanam,23,23,0,0,10
277865,kāḷavacchakajivhāsaṇṭhānaṃ,kalavacchakajivhasanthanam,3,3,0,0,26
277866,udarapaṭalassa,udarapatalassa,16,16,0,0,14
277867,matthakapassaṃ,matthakapassam,15,15,0,0,14
277868,paharaṇappahārena,paharanappaharena,2,2,0,0,17
277869,bahinikkhante,bahinikkhante,1,1,0,0,13
277870,jīvitakkhayo,jivitakkhayo,14,14,0,0,12
277871,pihakabhāgena,pihakabhagena,3,3,0,0,13
277872,dvattiṃsamaṃsakhaṇḍappabhedaṃ,dvattimsamamsakhandappabhedam,4,4,0,0,29
277873,papphāsamaṃsaṃ,papphasamamsam,4,3,1,0,14
277874,nātipakkaudumbaraphalavaṇṇaṃ,natipakkaudumbaraphalavannam,2,2,0,0,28
277875,visamacchinnabahalapūvakhaṇḍasaṇṭhānaṃ,visamacchinnabahalapuvakhandasanthanam,2,2,0,0,38
277876,asitapītānaṃ,asitapitanam,2,2,0,0,12
277877,kammajatejusmānā,kammajatejusmana,1,1,0,0,16
277878,abbhāhatattā,abbhahatatta,3,3,0,0,12
277879,saṃkhāditapalālapiṇḍamiva,samkhaditapalalapindamiva,1,1,0,0,25
277880,nirasaṃ,nirasam,10,8,2,0,7
277881,yakanañca,yakananca,5,5,0,0,9
277882,olambantaṃ,olambantam,19,19,0,0,10
277883,papphāsabhāgena,papphasabhagena,2,2,0,0,15
277884,dvattiṃsahatthā,dvattimsahattha,2,2,0,0,15
277885,aṭṭhavīsatihatthā,atthavisatihattha,3,3,0,0,17
277886,obhaggā,obhagga,3,3,0,0,7
277887,antavaṭṭi,antavatti,3,3,0,0,9
277888,sakkharasudhāvaṇṇaṃ,sakkharasudhavannam,4,2,2,0,19
277889,lohitadoṇiyaṃ,lohitadoniyam,6,6,0,0,13
277890,ṭhapitasīsacchinnasappasaṇṭhānaṃ,thapitasisacchinnasappasanthanam,2,2,0,0,32
277891,galavāṭake,galavatake,6,6,0,0,10
277892,karīsamagge,karisamagge,5,5,0,0,11
277893,vinibandhattā,vinibandhatta,4,4,0,0,13
277894,galavāṭakakarīsamaggapariyante,galavatakakarisamaggapariyante,5,5,0,0,30
277895,V1.0248,V1.0248,33,33,0,0,7
277896,antabhāgena,antabhagena,3,3,0,0,11
277897,antabhogaṭṭhānesu,antabhogatthanesu,3,2,1,0,17
277898,dakasītalikamūlavaṇṇaṃ,dakasitalikamulavannam,2,2,0,0,22
277899,dakasītalikamūlasaṇṭhānameva,dakasitalikamulasanthanameva,2,2,0,0,28
277900,kuddālapharasukammādīni,kuddalapharasukammadini,2,1,1,0,23
277901,yantākaḍḍhanakāle,yantakaddhanakale,3,3,0,0,17
277902,yantasuttakamiva,yantasuttakamiva,3,3,0,0,16
277903,yantaphalakāni,yantaphalakani,3,3,0,0,14
277904,antabhoge,antabhoge,6,5,1,0,9
277905,agaḷante,agalante,3,2,1,0,8
277906,pādapuñchanarajjumaṇḍalakassa,padapunchanarajjumandalakassa,3,3,0,0,29
277907,saṃsibbitvā,samsibbitva,22,21,1,0,11
277908,ṭhitarajjukā,thitarajjuka,4,4,0,0,12
277909,antabhogānaṃ,antabhoganam,4,4,0,0,12
277910,antaguṇabhāgena,antagunabhagena,3,3,0,0,15
277911,asitapītakhāyitasāyitaṃ,asitapitakhayitasayitam,30,24,6,0,23
277912,ajjhohaṭāhāravaṇṇaṃ,ajjhohataharavannam,2,2,0,0,19
277913,parissāvane,parissavane,21,20,1,0,11
277914,sithilabaddhataṇḍulasaṇṭhānaṃ,sithilabaddhatandulasanthanam,2,2,0,0,29
277915,nippīḷiyamānassa,nippiliyamanassa,3,3,0,0,16
277916,allasāṭakassa,allasatakassa,3,3,0,0,13
277917,sañjātaphoṭakasadisaṃ,sanjataphotakasadisam,3,3,0,0,21
277918,antapaṭalaṃ,antapatalam,3,3,0,0,11
277919,maṃsakasambupaliveṭhanakiliṭṭhapāvārakapupphakasadisaṃ,mamsakasambupalivethanakilitthapavarakapupphakasadisam,1,1,0,0,54
277920,kuthitapanasatacassa,kuthitapanasatacassa,2,2,0,0,20
277921,abbhantarasadisantipi,abbhantarasadisantipi,3,3,0,0,21
277922,takkoṭakā,takkotaka,2,2,0,0,9
277923,gaṇḍuppādakā,ganduppadaka,2,2,0,0,12
277924,tālahīrakā,talahiraka,2,2,0,0,10
277925,sūcimukhakā,sucimukhaka,2,2,0,0,11
277926,paṭatantasuttakā,patatantasuttaka,2,2,0,0,16
277927,iccevamādidvattiṃsakulappabhedā,iccevamadidvattimsakulappabheda,2,2,0,0,31
277928,ākulabyākulā,akulabyakula,6,6,0,0,12
277929,saṇḍasaṇḍacārino,sandasandacarino,4,4,0,0,16
277930,pānabhojanādimhi,panabhojanadimhi,6,6,0,0,16
277931,viravantā,viravanta,19,19,0,0,9
277932,abhihananti,abhihananti,9,9,0,0,11
277933,pānabhojanādiajjhoharaṇavelāyañca,panabhojanadiajjhoharanavelayanca,1,1,0,0,33
277934,uddhaṃmukhā,uddhammukha,6,6,0,0,11
277935,paṭhamajjhohaṭe,pathamajjhohate,3,3,0,0,15
277936,sūtigharaṃ,sutigharam,13,13,0,0,10
277937,caṇḍālagāmadvāre,candalagamadvare,6,6,0,0,16
277938,candanikāya,candanikaya,17,17,0,0,11
277939,nidāghasamaye,nidaghasamaye,14,14,0,0,13
277940,thūlaphusitake,thulaphusitake,5,5,0,0,14
277941,muttakarīsacammaaṭṭhinhārukhaṇḍakheḷasiṅghāṇikālohitappabhutinānākuṇapajātaṃ,muttakarisacammaatthinharukhandakhelasinghanikalohitappabhutinanakunapajatam,1,1,0,0,76
277942,kaddamodakāluḷitaṃ,kaddamodakalulitam,4,4,0,0,18
277943,sañjātakimikulaṃ,sanjatakimikulam,3,3,0,0,16
277944,sūriyātapasantāpavegakuthitaṃ,suriyatapasantapavegakuthitam,2,2,0,0,29
277945,pheṇapupphuḷake,phenapupphulake,3,3,0,0,15
277946,abhinīlavaṇṇaṃ,abhinilavannam,4,4,0,0,14
277947,upagantuṃ,upagantum,118,111,7,0,9
277948,araharūpataṃ,araharupatam,2,2,0,0,12
277949,pānabhojanādidantamusalasañcuṇṇitaṃ,panabhojanadidantamusalasancunnitam,1,1,0,0,35
277950,jivhāhatthaparivattitakheḷalālāpalibuddhaṃ,jivhahatthaparivattitakhelalalapalibuddham,2,2,0,0,42
277951,V1.0249,V1.0249,33,33,0,0,7
277952,taṅkhaṇavigatavaṇṇagandharasādisampadaṃ,tankhanavigatavannagandharasadisampadam,3,3,0,0,39
277953,tantavāyakhalisuvānavamathusadisaṃ,tantavayakhalisuvanavamathusadisam,3,3,0,0,34
277954,pittasemhavātapaliveṭhitaṃ,pittasemhavatapalivethitam,4,4,0,0,26
277955,udaraggisantāpavegakuthitaṃ,udaraggisantapavegakuthitam,4,4,0,0,27
277956,kimikulākulaṃ,kimikulakulam,7,7,0,0,13
277957,pheṇapupphuḷakāni,phenapupphulakani,2,2,0,0,17
277958,paramakasambuduggandhajegucchabhāvaṃ,paramakasambuduggandhajegucchabhavam,2,2,0,0,36
277959,pānabhojanādīsu,panabhojanadisu,3,3,0,0,15
277960,amanuññatā,amanunnata,3,3,0,0,10
277961,pānabhojanādi,panabhojanadi,7,7,0,0,13
277962,upabrūhayati,upabruhayati,2,2,0,0,12
277963,udarapaṭalena,udarapatalena,5,5,0,0,13
277964,udariyabhāgena,udariyabhagena,3,3,0,0,14
277965,ajjhohaṭāhāravaṇṇameva,ajjhohataharavannameva,2,2,0,0,22
277966,pakkāsaye,pakkasaye,6,6,0,0,9
277967,pakkāsayo,pakkasayo,6,5,1,0,9
277968,heṭṭhānābhipiṭṭhikaṇṭakamūlānaṃ,hetthanabhipitthikantakamulanam,3,2,1,0,31
277969,antāvasāne,antavasane,5,5,0,0,10
277970,aṭṭhaṅgulamatto,atthangulamatto,8,8,0,0,15
277971,veḷunāḷikasadiso,velunalikasadiso,3,2,1,0,16
277972,ogaḷitvā,ogalitva,8,8,0,0,8
277973,pānabhojanādikaṃ,panabhojanadikam,3,3,0,0,16
277974,pisitamiva,pisitamiva,2,2,0,0,10
277975,saṇhabhāvaṃ,sanhabhavam,3,3,0,0,11
277976,antabilena,antabilena,3,3,0,0,10
277977,veḷupabbe,velupabbe,12,12,0,0,9
277978,pakkhipamānapaṇḍumattikā,pakkhipamanapandumattika,2,2,0,0,24
277979,pakkāsayapaṭalena,pakkasayapatalena,2,2,0,0,17
277980,karīsabhāgena,karisabhagena,3,3,0,0,13
277981,sīsakaṭāhabbhantare,sisakatahabbhantare,11,11,0,0,19
277982,ṭhitamiñjarāsi,thitaminjarasi,2,2,0,0,14
277983,ahicchattakapiṇḍavaṇṇaṃ,ahicchattakapindavannam,1,1,0,0,23
277984,dadhibhāvaṃ,dadhibhavam,10,10,0,0,11
277985,duṭṭhakhīravaṇṇantipi,dutthakhiravannantipi,1,1,0,0,21
277986,sibbinimagge,sibbinimagge,5,5,0,0,12
277987,piṭṭhapiṇḍā,pitthapinda,2,2,0,0,11
277988,samohitaṃ,samohitam,18,16,2,0,9
277989,sīsakaṭāhassa,sisakatahassa,4,4,0,0,13
277990,matthaluṅgabhāgena,matthalungabhagena,3,3,0,0,18
277991,V1.0250,V1.0250,33,33,0,0,7
277992,pittāni,pittani,2,2,0,0,7
277993,baddhapittañca,baddhapittanca,2,2,0,0,14
277994,abaddhapittañca,abaddhapittanca,2,2,0,0,15
277995,baddhapittaṃ,baddhapittam,17,17,0,0,12
277996,bahalamadhukatelavaṇṇaṃ,bahalamadhukatelavannam,2,2,0,0,23
277997,abaddhapittaṃ,abaddhapittam,22,22,0,0,13
277998,milātaākulipupphavaṇṇaṃ,milataakulipupphavannam,1,1,0,0,23
277999,kesalomadantanakhānaṃ,kesalomadantanakhanam,5,5,0,0,21
278000,maṃsavinimuttaṭṭhānañceva,mamsavinimuttatthananceva,8,8,0,0,25
278001,thaddhasukkhacammañca,thaddhasukkhacammanca,10,10,0,0,21
278002,udakamiva,udakamiva,11,10,1,0,9
278003,telabindu,telabindu,4,4,0,0,9
278004,avasesasarīraṃ,avasesasariram,4,4,0,0,14
278005,pītakāni,pitakani,11,11,0,0,8
278006,kaṇḍūyati,kanduyati,2,2,0,0,9
278007,hadayapapphāsānaṃ,hadayapapphasanam,2,2,0,0,17
278008,yakanamaṃsaṃ,yakanamamsam,5,5,0,0,12
278009,mahākosātakīkosakasadise,mahakosatakikosakasadise,3,3,0,0,24
278010,pittakosake,pittakosake,14,13,1,0,11
278011,abhāsitabbaṃ,abhasitabbam,6,6,0,0,12
278012,acintitabbaṃ,acintitabbam,2,2,0,0,12
278013,pittabhāgena,pittabhagena,3,3,0,0,12
278014,ekapatthapūrappamāṇaṃ,ekapatthapurappamanam,5,5,0,0,21
278015,nāgabalāpaṇṇarasavaṇṇaṃ,nagabalapannarasavannam,1,1,0,0,23
278016,udarapaṭale,udarapatale,11,11,0,0,11
278017,pānabhojanādiajjhoharaṇakāle,panabhojanadiajjhoharanakale,2,2,0,0,28
278018,sevālapaṇakaṃ,sevalapanakam,8,8,0,0,13
278019,kathale,kathale,2,2,0,0,7
278020,nipatante,nipatante,3,3,0,0,9
278021,mandībhūte,mandibhute,8,8,0,0,10
278022,pakkagaṇḍo,pakkagando,2,2,0,0,10
278023,pūtikukkuṭaṇḍamiva,putikukkutandamiva,3,3,0,0,18
278024,paramajegucchaṃ,paramajeguccham,4,4,0,0,15
278025,kuṇapagandhaṃ,kunapagandham,8,8,0,0,13
278026,pūtikuṇapasadisaṃ,putikunapasadisam,3,3,0,0,17
278027,vāyasīti,vayasiti,4,3,1,0,8
278028,bahalattamāpannaṃ,bahalattamapannam,3,3,0,0,17
278029,pidhānaphalakamiva,pidhanaphalakamiva,2,2,0,0,18
278030,vaccakuṭiyaṃ,vaccakutiyam,11,11,0,0,12
278031,abbhantareyeva,abbhantareyeva,13,13,0,0,14
278032,semhabhāgena,semhabhagena,3,3,0,0,12
278033,pubboti,pubboti,2,0,2,0,7
278034,M1.0253,M1.0253,30,30,0,0,7
278035,pūtilohitavasena,putilohitavasena,2,2,0,0,16
278036,pavattapubbaṃ,pavattapubbam,1,1,0,0,13
278037,paṇḍupalāsavaṇṇo,pandupalasavanno,3,3,0,0,16
278038,pūtibahalācāmavaṇṇo,putibahalacamavanno,2,2,0,0,19
278039,okāsasaṇṭhāno,okasasanthano,9,9,0,0,13
278040,sannicito,sannicito,13,13,0,0,9
278041,khāṇukaṇṭakapaharaṇaggijālādīhi,khanukantakapaharanaggijaladihi,2,2,0,0,31
278042,abhihate,abhihate,5,5,0,0,8
278043,sarīrappadese,sarirappadese,12,12,0,0,13
278044,gaṇḍapīḷakādayo,gandapilakadayo,3,3,0,0,15
278045,pubbabhāgena,pubbabhagena,30,24,6,0,12
278046,V1.0251,V1.0251,33,33,0,0,7
278047,sannicitalohitañca,sannicitalohitanca,2,2,0,0,18
278048,saṃsaraṇalohitañca,samsaranalohitanca,2,2,0,0,18
278049,sannicitalohitaṃ,sannicitalohitam,13,13,0,0,16
278050,nipakkabahalalākhārasavaṇṇaṃ,nipakkabahalalakharasavannam,2,2,0,0,28
278051,saṃsaraṇalohitaṃ,samsaranalohitam,10,10,0,0,16
278052,acchalākhārasavaṇṇaṃ,acchalakharasavannam,2,2,0,0,20
278053,dhamanijālānusārena,dhamanijalanusarena,7,7,0,0,19
278054,upādiṇṇasarīraṃ,upadinnasariram,2,2,0,0,15
278055,yakanaṭṭhānassa,yakanatthanassa,4,4,0,0,15
278056,heṭṭhābhāgaṃ,hetthabhagam,16,16,0,0,12
278057,ekapatthapūramattaṃ,ekapatthapuramattam,3,3,0,0,19
278058,hadayavakkapapphāsānaṃ,hadayavakkapapphasanam,4,4,0,0,22
278059,vakkahadayayakanapapphāse,vakkahadayayakanapapphase,6,5,1,0,25
278060,temayamānaṃ,temayamanam,11,10,1,0,11
278061,vakkahadayādīni,vakkahadayadini,6,6,0,0,15
278062,atemente,atemente,3,3,0,0,8
278063,lohitabhāgena,lohitabhagena,3,3,0,0,13
278064,sedoti,sedoti,2,0,2,0,6
278065,lomakūpādīhi,lomakupadihi,2,2,0,0,12
278066,paggharaṇakaāpodhātu,paggharanakaapodhatu,4,4,0,0,20
278067,vippasannatilatelavaṇṇo,vippasannatilatelavanno,2,2,0,0,23
278068,sedassokāso,sedassokaso,2,2,0,0,11
278069,aggisantāpasūriyasantāpautuvikārādīhi,aggisantapasuriyasantapautuvikaradihi,4,4,0,0,37
278070,santapati,santapati,6,6,0,0,9
278071,abbūḷhamattavisamacchinnabhisamuḷālakumudanāḷakalāpo,abbulhamattavisamacchinnabhisamulalakumudanalakalapo,1,1,0,0,52
278072,sabbakesalomakūpavivarehi,sabbakesalomakupavivarehi,4,4,0,0,25
278073,saṇṭhānampi,santhanampi,5,5,0,0,11
278074,kesalomakūpavivarānaññeva,kesalomakupavivarananneva,1,1,0,0,25
278075,sedapariggaṇhakena,sedaparigganhakena,3,3,0,0,18
278076,kesalomakūpavivare,kesalomakupavivare,3,3,0,0,18
278077,ṭhitavaseneva,thitavaseneva,8,8,0,0,13
278078,M1.0254,M1.0254,30,30,0,0,7
278079,sedabhāgena,sedabhagena,3,3,0,0,11
278080,thinasineho,thinasineho,3,3,0,0,11
278081,phālitahaliddivaṇṇo,phalitahaliddivanno,2,2,0,0,19
278082,thūlasarīrassa,thulasarirassa,5,5,0,0,14
278083,cammamaṃsantare,cammamamsantare,5,5,0,0,15
278084,ṭhapitahaliddivaṇṇadukūlapilotikasaṇṭhāno,thapitahaliddivannadukulapilotikasanthano,4,4,0,0,41
278085,kisasarīrassa,kisasarirassa,3,3,0,0,13
278086,jaṅghamaṃsaṃ,janghamamsam,4,4,0,0,12
278087,piṭṭhikaṇṭakanissitaṃ,pitthikantakanissitam,2,2,0,0,21
278088,udaravaṭṭimaṃsanti,udaravattimamsanti,2,2,0,0,18
278089,diguṇatiguṇaṃ,digunatigunam,3,3,0,0,13
278090,sinehasaṅkhaṃ,sinehasankham,2,2,0,0,13
278091,paramajegucchattā,paramajegucchatta,3,3,0,0,17
278092,telatthāya,telatthaya,8,8,0,0,10
278093,nāsatelādīnamatthāya,nasateladinamatthaya,1,1,0,0,20
278094,medabhāgena,medabhagena,3,3,0,0,11
278095,V1.0252,V1.0252,33,33,0,0,7
278096,vippasannatilatelavaṇṇaṃ,vippasannatilatelavannam,2,2,0,0,24
278097,akkhikūpakesu,akkhikupakesu,10,10,0,0,13
278098,pittamiva,pittamiva,3,3,0,0,9
278099,domanassajātā,domanassajata,3,3,0,0,13
278100,visamāhāraṃ,visamaharam,3,2,1,0,11
278101,āhārenti,aharenti,17,17,0,0,8
278102,dhūmarajapaṃsukādīhi,dhumarajapamsukadihi,3,3,0,0,20
278103,abhihaññanti,abhihannanti,3,3,0,0,12
278104,somanassadomanassavisabhāgāhārautūhi,somanassadomanassavisabhagaharautuhi,3,3,0,0,36
278105,akkhikūpake,akkhikupake,19,18,1,0,11
278106,assupariggaṇhakena,assuparigganhakena,3,3,0,0,18
278107,pariggaṇhitabbaṃ,parigganhitabbam,2,2,0,0,16
278108,assubhāgena,assubhagena,3,3,0,0,11
278109,nhānakāle,nhanakale,19,17,2,0,9
278110,pasannaudakassa,pasannaudakassa,2,2,0,0,15
278111,paribbhamantasinehabinduvisaṭasaṇṭhānā,paribbhamantasinehabinduvisatasanthana,2,2,0,0,38
278112,hatthatalahatthapiṭṭhipādatalapādapiṭṭhināsapuṭanalāṭaaṃsakūṭesu,hatthatalahatthapitthipadatalapadapitthinasaputanalataamsakutesu,2,2,0,0,64
278113,okāsesu,okasesu,25,25,0,0,7
278114,vilīnāva,vilinava,3,3,0,0,8
278115,aggisantāpasūriyasantāpautuvisabhāgadhātuvisabhāgehi,aggisantapasuriyasantapautuvisabhagadhatuvisabhagehi,3,3,0,0,52
278116,usmājātā,usmajata,2,2,0,0,8
278117,pasannaudakūpari,pasannaudakupari,2,2,0,0,16
278118,sinehabinduvisaṭo,sinehabinduvisato,2,2,0,0,17
278119,vasābhāgena,vasabhagena,3,3,0,0,11
278120,kheḷoti,kheloti,2,0,2,0,7
278121,pheṇamissā,phenamissa,3,3,0,0,10
278122,pheṇavaṇṇo,phenavanno,2,2,0,0,10
278123,pheṇasaṇṭhānotipi,phenasanthanotipi,1,1,0,0,17
278124,kapolapassehi,kapolapassehi,15,15,0,0,13
278125,tathārūpamāhāraṃ,tatharupamaharam,1,1,0,0,16
278126,uṇhatittakaṭukaloṇambilānaṃ,unhatittakatukalonambilanam,3,3,0,0,27
278127,aggajivhāya,aggajivhaya,7,7,0,0,11
278128,mūlajivhāya,mulajivhaya,7,7,0,0,11
278129,bahalo,bahalo,14,14,0,0,6
278130,pakkhittañca,pakkhittanca,3,3,0,0,12
278131,puthukaṃ,puthukam,8,8,0,0,8
278132,nadīpuline,nadipuline,1,1,0,0,10
278133,khatakūpakasalilaṃ,khatakupakasalilam,2,2,0,0,18
278134,V1.0253,V1.0253,33,33,0,0,7
278135,agacchantova,agacchantova,2,2,0,0,12
278136,kheḷabhāgena,khelabhagena,3,3,0,0,12
278137,kesasadisova,kesasadisova,30,30,0,0,12
278138,siṅghāṇikāti,singhanikati,8,5,3,0,12
278139,matthaluṅgato,matthalungato,5,5,0,0,13
278140,paggharaṇakaasuci,paggharanakaasuci,2,2,0,0,17
278141,taruṇatālaṭṭhimiñjavaṇṇā,tarunatalatthiminjavanna,2,2,0,0,24
278142,okāsasaṇṭhānā,okasasanthana,7,7,0,0,13
278143,nāsāpuṭe,nasapute,19,19,0,0,8
278144,sannicitā,sannicita,10,9,1,0,9
278145,dadhimuttaṃ,dadhimuttam,2,1,1,0,11
278146,gaḷitvā,galitva,17,17,0,0,7
278147,visabhāgāhārautuvasena,visabhagaharautuvasena,4,4,0,0,22
278148,sañjātadhātukhobhā,sanjatadhatukhobha,1,1,0,0,18
278149,pūtisemhabhāvamāpannaṃ,putisemhabhavamapannam,1,1,0,0,22
278150,tālumatthakavivarena,talumatthakavivarena,6,5,1,0,20
278151,pariggaṇhakena,parigganhakena,2,2,0,0,14
278152,pariggaṇhitabbā,parigganhitabba,3,3,0,0,15
278153,siṅghāṇikābhāgena,singhanikabhagena,2,2,0,0,17
278154,ayamassā,ayamassa,35,35,0,0,8
278155,lasikāti,lasikati,5,2,3,0,8
278156,sarīrasandhīnaṃ,sarirasandhinam,3,3,0,0,15
278157,picchilakuṇapaṃ,picchilakunapam,4,4,0,0,15
278158,kaṇikāraniyyāsavaṇṇā,kanikaraniyyasavanna,2,2,0,0,20
278159,aṭṭhisandhīnaṃ,atthisandhinam,5,4,1,0,14
278160,abbhañjanakiccaṃ,abbhanjanakiccam,7,6,1,0,16
278161,asītisatasandhīnaṃ,asitisatasandhinam,4,4,0,0,18
278162,uṭṭhahantassa,utthahantassa,8,8,0,0,13
278163,pasārentassa,pasarentassa,14,13,1,0,12
278164,kaṭakaṭāyanti,katakatayanti,6,6,0,0,13
278165,accharāsaddaṃ,accharasaddam,3,3,0,0,13
278166,ekayojanadviyojanamattaṃ,ekayojanadviyojanamattam,1,1,0,0,24
278167,uṭṭhānanisajjādīsu,utthananisajjadisu,4,4,0,0,18
278168,dīghampi,dighampi,12,11,1,0,8
278169,lasikābhāgena,lasikabhagena,2,2,0,0,13
278170,muttarasaṃ,muttarasam,1,1,0,0,10
278171,māsakhārodakavaṇṇaṃ,masakharodakavannam,2,2,0,0,19
278172,adhomukhaṭṭhapitaudakakumbhaabbhantaragataudakasaṇṭhānaṃ,adhomukhatthapitaudakakumbhaabbhantaragataudakasanthanam,1,1,0,0,56
278173,vatthissa,vatthissa,4,4,0,0,9
278174,amukhe,amukhe,7,6,1,0,6
278175,ravaṇaghaṭe,ravanaghate,7,6,1,0,11
278176,candanikāraso,candanikaraso,8,8,0,0,13
278177,pavisanamaggo,pavisanamaggo,15,15,0,0,13
278178,V1.0254,V1.0254,33,33,0,0,7
278179,vatthiabbhantarena,vatthiabbhantarena,3,3,0,0,18
278180,muttabhāgena,muttabhagena,3,3,0,0,12
278181,kesādike,kesadike,13,13,0,0,8
278182,nātisīghatotiādinā,natisighatotiadina,1,1,0,0,18
278183,paṭikkūlāti,patikkulati,6,6,0,0,11
278184,paṇṇattisamatikkamāvasāne,pannattisamatikkamavasane,1,1,0,0,25
278185,dvattiṃsavaṇṇānaṃ,dvattimsavannanam,4,4,0,0,17
278186,ekasuttakaganthitaṃ,ekasuttakaganthitam,1,1,0,0,19
278187,sabbapupphāni,sabbapupphani,8,8,0,0,13
278188,apubbāpariyamiva,apubbapariyamiva,5,5,0,0,16
278189,apubbāpariyāva,apubbapariyava,1,1,0,0,14
278190,manasikārakosallakathāyaṃ,manasikarakosallakathayam,2,2,0,0,25
278191,manasikāraṃ,manasikaram,107,97,10,0,11
278192,pākaṭībhūtesu,pakatibhutesu,2,2,0,0,13
278193,manussatiracchānādayo,manussatiracchanadayo,4,4,0,0,21
278194,sattākāraṃ,sattakaram,4,4,0,0,10
278195,koṭṭhāsarāsivaseneva,kotthasarasivaseneva,3,3,0,0,20
278196,ajjhohariyamānaṃ,ajjhohariyamanam,6,6,0,0,16
278197,koṭṭhāsarāsimhi,kotthasarasimhi,3,3,0,0,15
278198,pakkhipamānamiva,pakkhipamanamiva,1,1,0,0,16
278199,anupubbamuñcanādivasena,anupubbamuncanadivasena,2,2,0,0,23
278200,āsevato,asevato,24,22,2,0,7
278201,asubhakammaṭṭhānesu,asubhakammatthanesu,4,4,0,0,19
278202,paṭhamajjhānavaseneva,pathamajjhanavaseneva,1,1,0,0,21
278203,koṭṭhāsagaṇanāya,kotthasagananaya,2,2,0,0,16
278204,paṭhamajjhānāni,pathamajjhanani,2,2,0,0,15
278205,V1.0255,V1.0255,33,33,0,0,7
278206,dīghabhāṇakaabhayattheraṃ,dighabhanakaabhayattheram,2,2,0,0,25
278207,uggaṇhāhī,ugganhahi,9,9,0,0,9
278208,mallakatthero,mallakatthero,1,1,0,0,13
278209,dvattiṃsakoṭṭhāsesu,dvattimsakotthasesu,2,2,0,0,19
278210,paṭhamajjhānānaṃ,pathamajjhananam,1,1,0,0,16
278211,atirekaddhamāsena,atirekaddhamasena,1,1,0,0,17
278212,atirekamāsena,atirekamasena,2,2,0,0,13
278213,paṭhamajjhānavasena,pathamajjhanavasena,28,28,0,0,19
278214,ijjhamānampi,ijjhamanampi,1,1,0,0,12
278215,ijjhanato,ijjhanato,39,38,1,0,9
278216,kāyagatāsatimanuyutto,kayagatasatimanuyutto,1,1,0,0,21
278217,aratiratisaho,aratiratisaho,21,18,3,0,13
278218,pāṇaharānaṃ,panaharanam,34,31,3,0,11
278219,adhivāsakajātiko,adhivasakajatiko,19,17,2,0,16
278220,vaṇṇabhedaṃ,vannabhedam,9,7,2,0,11
278221,anekānisaṃsaṃ,anekanisamsam,4,4,0,0,13
278222,kāyagatāsatinti,kayagatasatinti,1,1,0,0,15
278223,ānāpānassatikathā,anapanassatikatha,4,4,0,0,17
278224,ānāpānassatisamādhi,anapanassatisamadhi,63,63,0,0,19
278225,asecanako,asecanako,28,21,7,0,9
278226,vūpasametī,vupasameti,9,8,1,0,10
278227,V1.0256,V1.0256,33,33,0,0,7
278228,assasāmīti,assasamiti,13,13,0,0,10
278229,passasāmīti,passasamiti,11,9,2,0,11
278230,sabbakāyapaṭisaṃvedī,sabbakayapatisamvedi,50,46,4,0,20
278231,assasissāmīti,assasissamiti,26,24,2,0,13
278232,passasissāmīti,passasissamiti,67,62,5,0,14
278233,passambhayaṃ,passambhayam,142,122,20,0,12
278234,kāyasaṅkhāraṃ,kayasankharam,171,153,18,0,13
278235,pītipaṭisaṃvedī,pitipatisamvedi,18,17,1,0,15
278236,sukhapaṭisaṃvedī,sukhapatisamvedi,28,26,2,0,16
278237,cittasaṅkhārapaṭisaṃvedī,cittasankharapatisamvedi,25,24,1,0,24
278238,cittasaṅkhāraṃ,cittasankharam,41,37,4,0,14
278239,cittapaṭisaṃvedī,cittapatisamvedi,21,20,1,0,16
278240,abhippamodayaṃ,abhippamodayam,32,27,5,0,14
278241,vimocayaṃ,vimocayam,57,48,9,0,9
278242,aniccānupassī,aniccanupassi,94,87,7,0,13
278243,virāgānupassī,viraganupassi,54,54,0,0,13
278244,nirodhānupassī,nirodhanupassi,52,48,4,0,14
278245,paṭinissaggānupassī,patinissagganupassi,111,108,3,0,19
278246,soḷasavatthukaṃ,solasavatthukam,19,15,4,0,15
278247,ānāpānassatikammaṭṭhānaṃ,anapanassatikammatthanam,24,23,1,0,24
278248,pāḷivaṇṇanānusāreneva,palivannananusareneva,1,1,0,0,21
278249,sabbākāraparipūro,sabbakaraparipuro,11,11,0,0,17
278250,ānāpānassatisamādhibhāvanaṃ,anapanassatisamadhibhavanam,5,5,0,0,27
278251,vitthāretukamyatāpucchā,vittharetukamyatapuccha,6,5,1,0,23
278252,ānāpānassatisamādhīti,anapanassatisamadhiti,9,2,7,0,21
278253,vitthāretukamyatāya,vittharetukamyataya,2,2,0,0,19
278254,puṭṭhadhammanidassanaṃ,putthadhammanidassanam,2,2,0,0,22
278255,vūpasametīti,vupasametiti,15,6,9,0,12
278256,ānāpānapariggāhikāya,anapanapariggahikaya,3,3,0,0,20
278257,ānāpānassatiyaṃ,anapanassatiyam,9,7,2,0,15
278258,bahulīkatoti,bahulikatoti,9,0,9,0,12
278259,santoceva,santoceva,1,0,1,0,9
278260,asubhakammaṭṭhānaṃ,asubhakammatthanam,36,29,7,0,18
278261,paṭivedhavasena,pativedhavasena,23,23,0,0,15
278262,oḷārikārammaṇattā,olarikarammanatta,4,3,1,0,17
278263,paṭikkūlārammaṇattā,patikkularammanatta,2,2,0,0,19
278264,apaṇīto,apanito,1,1,0,0,7
278265,ārammaṇasantatāyapi,arammanasantatayapi,7,7,0,0,19
278266,paṭivedhasaṅkhātaaṅgasantatāyapi,pativedhasankhataangasantatayapi,2,2,0,0,32
278267,ārammaṇapaṇītatāyapi,arammanapanitatayapi,1,1,0,0,20
278268,atittikaro,atittikaro,6,6,0,0,10
278269,aṅgapaṇītatāyapīti,angapanitatayapiti,2,2,0,0,18
278270,V1.0257,V1.0257,33,33,0,0,7
278271,secananti,secananti,7,7,0,0,9
278272,anāsittako,anasittako,11,8,3,0,10
278273,abbokiṇṇo,abbokinno,6,3,3,0,9
278274,āveṇiko,aveniko,25,22,3,0,7
278275,ādisamannāhārato,adisamannaharato,3,2,1,0,16
278276,asecanakoti,asecanakoti,3,1,2,0,11
278277,ojavanto,ojavanto,7,3,4,0,8
278278,M1.0260,M1.0260,30,30,0,0,7
278279,appitappitakkhaṇe,appitappitakkhane,21,15,6,0,17
278280,kāyikacetasikasukhapaṭilābhāya,kayikacetasikasukhapatilabhaya,1,1,0,0,30
278281,uppannuppanneti,uppannuppanneti,7,0,7,0,15
278282,avikkhambhite,avikkhambhite,9,8,1,0,13
278283,pāpaketi,papaketi,9,0,9,0,8
278284,akosallasambhūte,akosallasambhute,5,5,0,0,16
278285,nibbedhabhāgiyattā,nibbedhabhagiyatta,9,5,4,0,18
278286,ariyamaggavuddhippatto,ariyamaggavuddhippatto,3,2,1,0,22
278287,paṭippassambhetīti,patippassambhetiti,4,3,1,0,18
278288,sabbappakāraānāpānassatisamādhinibbattakassa,sabbappakaraanapanassatisamadhinibbattakassa,3,3,0,0,44
278289,sannissayabhūtasāsanaparidīpano,sannissayabhutasasanaparidipano,8,8,0,0,31
278290,aññasāsanassa,annasasanassa,14,12,2,0,13
278291,tathābhāvapaṭisedhano,tathabhavapatisedhano,9,7,2,0,21
278292,samaṇebhi,samanebhi,24,24,0,0,9
278293,ānāpānassatisamādhibhāvanānurūpasenāsanapariggahaparidīpanaṃ,anapanassatisamadhibhavananurupasenasanapariggahaparidipanam,3,3,0,0,60
278294,anuvisaṭaṃ,anuvisatam,7,7,0,0,10
278295,ānāpānassatisamādhiārammaṇaṃ,anapanassatisamadhiarammanam,3,3,0,0,28
278296,kūṭagoṇayuttaratho,kutagonayuttaratho,5,5,0,0,18
278297,uppathameva,uppathameva,6,6,0,0,11
278298,kūṭadhenuyā,kutadhenuya,5,5,0,0,11
278299,kūṭavacchaṃ,kutavaccham,5,5,0,0,11
278300,dametukāmo,dametukamo,8,8,0,0,10
278301,nikhaṇitvā,nikhanitva,67,66,1,0,10
278302,yottena,yottena,34,34,0,0,7
278303,vipphanditvā,vipphanditva,5,5,0,0,12
278304,rūpārammaṇādirasapānavaḍḍhitaṃ,ruparammanadirasapanavaddhitam,5,5,0,0,30
278305,duṭṭhacittaṃ,dutthacittam,18,17,1,0,12
278306,dametukāmena,dametukamena,5,5,0,0,12
278307,rūpādiārammaṇato,rupadiarammanato,6,6,0,0,16
278308,assāsapassāsathambhe,assasapassasathambhe,3,3,0,0,20
278309,satiyottena,satiyottena,7,7,0,0,11
278310,V1.0258,V1.0258,33,33,0,0,7
278311,vipphanditvāpi,vipphanditvapi,6,6,0,0,14
278312,āciṇṇārammaṇaṃ,acinnarammanam,9,5,4,0,14
278313,satiyottaṃ,satiyottam,5,5,0,0,10
278314,upanipajjati,upanipajjati,8,8,0,0,12
278315,satiyārammaṇe,satiyarammane,6,6,0,0,13
278316,evamassetaṃ,evamassetam,4,3,1,0,11
278317,bhāvanānurūpaṃ,bhavananurupam,11,11,0,0,14
278318,kammaṭṭhānappabhede,kammatthanappabhede,3,3,0,0,19
278319,sabbaññubuddhapaccekabuddhabuddhasāvakānaṃ,sabbannubuddhapaccekabuddhabuddhasavakanam,2,2,0,0,42
278320,visesādhigamadiṭṭhadhammasukhavihārapadaṭṭhānaṃ,visesadhigamaditthadhammasukhaviharapadatthanam,9,5,4,0,47
278321,itthipurisahatthiassādisaddasamākulaṃ,itthipurisahatthiassadisaddasamakulam,5,5,0,0,37
278322,saddakaṇṭakattā,saddakantakatta,8,8,0,0,15
278323,anurūpasenāsanaṃ,anurupasenasanam,6,6,0,0,16
278324,vatthuvijjācariyo,vatthuvijjacariyo,16,11,5,0,17
278325,māpethā,mapetha,8,8,0,0,7
278326,anuyuñjitabbaṃ,anuyunjitabbam,21,21,0,0,14
278327,anuyuttena,anuyuttena,11,11,0,0,10
278328,dīpisadisoti,dipisadisoti,3,3,0,0,12
278329,mahādīpirājā,mahadipiraja,5,5,0,0,12
278330,tiṇagahanaṃ,tinagahanam,16,15,1,0,11
278331,pabbatagahanaṃ,pabbatagahanam,15,14,1,0,14
278332,vanamahiṃsagokaṇṇasūkarādayo,vanamahimsagokannasukaradayo,5,5,0,0,28
278333,araññādīsu,arannadisu,16,15,1,0,10
278334,sotāpattisakadāgāmianāgāmiarahattamagge,sotapattisakadagamianagamiarahattamagge,3,3,0,0,39
278335,ariyaphalañca,ariyaphalanca,7,7,0,0,13
278336,V1.0259,V1.0259,32,32,0,0,7
278337,dīpiko,dipiko,16,16,0,0,6
278338,gaṇhatī,ganhati,6,6,0,0,7
278339,yuttayogo,yuttayogo,16,12,4,0,9
278340,parakkamajavayoggabhūmiṃ,parakkamajavayoggabhumim,9,5,4,0,24
278341,araññasenāsanaṃ,arannasenasanam,5,5,0,0,15
278342,araññagatoti,arannagatoti,2,0,2,0,12
278343,vuttalakkhaṇesu,vuttalakkhanesu,4,4,0,0,15
278344,araññesu,arannesu,9,9,0,0,8
278345,rukkhamūlagatoti,rukkhamulagatoti,2,0,2,0,16
278346,rukkhasamīpaṃ,rukkhasamipam,11,9,2,0,13
278347,suññāgāragatoti,sunnagaragatoti,6,2,4,0,15
278348,vivittokāsaṃ,vivittokasam,3,3,0,0,12
278349,araññañca,arannanca,6,6,0,0,9
278350,avasesasattavidhasenāsanagatopi,avasesasattavidhasenasanagatopi,2,2,0,0,31
278351,ututtayānukūlaṃ,ututtayanukulam,7,3,4,0,15
278352,dhātucariyānukūlañca,dhatucariyanukulanca,3,3,0,0,20
278353,ānāpānassatibhāvanānurūpaṃ,anapanassatibhavananurupam,3,3,0,0,26
278354,alīnānuddhaccapakkhikaṃ,alinanuddhaccapakkhikam,5,3,2,0,23
278355,daḷhabhāvaṃ,dalhabhavam,10,8,2,0,11
278356,pavattanasukhataṃ,pavattanasukhatam,5,3,2,0,17
278357,ārammaṇapariggahūpāyañca,arammanapariggahupayanca,3,3,0,0,24
278358,ābhujitvātiādimāha,abhujitvatiadimaha,2,1,1,0,18
278359,ābhujitvāti,abhujitvati,21,1,20,0,11
278360,uparimasarīraṃ,uparimasariram,6,4,2,0,14
278361,aṭṭhārasapiṭṭhikaṇṭake,attharasapitthikantake,2,2,0,0,22
278362,cammamaṃsanhārūni,cammamamsanharuni,12,12,0,0,17
278363,paṇamanappaccayā,panamanappaccaya,2,2,0,0,16
278364,anuppajjamānāsu,anuppajjamanasu,6,6,0,0,15
278365,paripatati,paripatati,53,52,1,0,10
278366,upaṭṭhapetvāti,upatthapetvati,28,14,14,0,14
278367,kammaṭṭhānābhimukhaṃ,kammatthanabhimukham,24,16,8,0,20
278368,parīti,pariti,20,4,16,0,6
278369,pariggahaṭṭho,pariggahattho,29,21,8,0,13
278370,upaṭṭhānaṭṭho,upatthanattho,30,28,2,0,13
278371,vuttanayenapettha,vuttanayenapettha,8,8,0,0,17
278372,pariggahitaniyyānaṃ,pariggahitaniyyanam,17,9,8,0,19
278373,passasatīti,passasatiti,7,2,5,0,11
278374,V1.0260,V1.0260,32,32,0,0,7
278375,yehākārehi,yehakarehi,6,6,0,0,10
278376,assasantotiādimāha,assasantotiadimaha,2,1,1,0,18
278377,passasatī,passasati,8,8,0,0,9
278378,bāttiṃsāya,battimsaya,12,9,3,0,10
278379,assāsavasena,assasavasena,72,70,2,0,12
278380,avikkhepaṃ,avikkhepam,100,82,18,0,10
278381,pajānato,pajanato,111,110,1,0,8
278382,passāsavasena,passasavasena,62,62,0,0,13
278383,assasantoti,assasantoti,4,1,3,0,11
278384,pavisanavātoti,pavisanavatoti,1,1,0,0,14
278385,dīgharassatā,digharassata,7,7,0,0,12
278386,addhānavasena,addhanavasena,13,13,0,0,13
278387,okāsaddhānaṃ,okasaddhanam,4,2,2,0,12
278388,dīghamudakaṃ,dighamudakam,2,2,0,0,12
278389,rassamudakaṃ,rassamudakam,2,2,0,0,12
278390,cuṇṇavicuṇṇāpi,cunnavicunnapi,7,5,2,0,14
278391,hatthisarīre,hatthisarire,2,2,0,0,12
278392,ahisarīre,ahisarire,2,2,0,0,9
278393,sunakhasasādīnaṃ,sunakhasasadinam,2,2,0,0,16
278394,hatthiahiādayo,hatthiahiadayo,3,3,0,0,14
278395,kāladdhānavasena,kaladdhanavasena,6,6,0,0,16
278396,assasanti,assasanti,8,8,0,0,9
278397,passasanti,passasanti,5,5,0,0,10
278398,sunakhasasādayo,sunakhasasadayo,5,5,0,0,15
278399,nikkhamantā,nikkhamanta,33,32,1,0,11
278400,ittaramaddhānaṃ,ittaramaddhanam,5,2,3,0,15
278401,V1.0261,V1.0261,32,32,0,0,7
278402,navahākārehi,navahakarehi,37,36,1,0,12
278403,ekenākārena,ekenakarena,32,31,1,0,11
278404,kāyānupassanāsatipaṭṭhānabhāvanā,kayanupassanasatipatthanabhavana,15,12,3,0,32
278405,addhānasaṅkhāte,addhanasankhate,36,36,0,0,15
278406,passāsaṃ,passasam,37,36,1,0,8
278407,assasatipi,assasatipi,16,16,0,0,10
278408,passasatipi,passasatipi,12,12,0,0,11
278409,assasatopi,assasatopi,12,12,0,0,10
278410,passasatopi,passasatopi,12,12,0,0,11
278411,pāmojjavasena,pamojjavasena,21,21,0,0,13
278412,vivattati,vivattati,9,8,1,0,9
278413,upaṭṭhānañceva,upatthananceva,33,32,1,0,14
278414,anupassati,anupassati,180,175,5,0,10
278415,rassapadepi,rassapadepi,2,2,0,0,11
278416,ittarasaṅkhāte,ittarasankhate,14,14,0,0,14
278417,assasatī,assasati,9,9,0,0,8
278418,ittaravasena,ittaravasena,4,4,0,0,12
278419,pajānanto,pajananto,115,112,3,0,9
278420,V1.0262,V1.0262,32,32,0,0,7
278421,passāsopi,passasopi,6,6,0,0,9
278422,nāsikaggeva,nasikaggeva,6,4,2,0,11
278423,assasissāmi,assasissami,45,42,3,0,11
278424,sikkhatīti,sikkhatiti,103,76,27,0,10
278425,assāsakāyassa,assasakayassa,2,2,0,0,13
278426,ādimajjhapariyosānaṃ,adimajjhapariyosanam,45,35,10,0,20
278427,passāsakāyassa,passasakayassa,2,2,0,0,14
278428,passasissāmī,passasissami,141,141,0,0,12
278429,cuṇṇavicuṇṇavisaṭe,cunnavicunnavisate,3,3,0,0,18
278430,assāsakāye,assasakaye,3,3,0,0,10
278431,passāsakāye,passasakaye,3,3,0,0,11
278432,majjhapariyosānaṃ,majjhapariyosanam,3,3,0,0,17
278433,majjhapariyosāne,majjhapariyosane,3,3,0,0,16
278434,ādipariyosānaṃ,adipariyosanam,3,3,0,0,14
278435,ādimajjhaṃ,adimajjham,4,4,0,0,10
278436,pariyosānaṃyeva,pariyosanamyeva,3,3,0,0,15
278437,ādimajjhe,adimajjhe,3,3,0,0,9
278438,adhipaññāsikkhāti,adhipannasikkhati,11,11,0,0,17
278439,sikkhāyo,sikkhayo,44,42,2,0,8
278440,bahulīkarotīti,bahulikarotiti,13,7,6,0,14
278441,purimanaye,purimanaye,34,34,0,0,10
278442,assasitabbaṃ,assasitabbam,3,3,0,0,12
278443,passasitabbameva,passasitabbameva,3,3,0,0,16
278444,ñāṇuppādanādīsu,nanuppadanadisu,3,3,0,0,15
278445,pajānāticceva,pajanaticceva,1,1,0,0,13
278446,vattamānakālavasena,vattamanakalavasena,12,11,1,0,19
278447,ñāṇuppādanādino,nanuppadanadino,3,3,0,0,15
278448,assasissāmītiādinā,assasissamitiadina,3,3,0,0,18
278449,anāgatavacanavasena,anagatavacanavasena,3,3,0,0,19
278450,V1.0263,V1.0263,32,32,0,0,7
278451,paṭippassambhento,patippassambhento,8,8,0,0,17
278452,nirodhento,nirodhento,37,35,2,0,10
278453,oḷārikasukhumatā,olarikasukhumata,38,37,1,0,16
278454,apariggahitakāle,apariggahitakale,21,19,2,0,16
278455,sadarathā,sadaratha,8,7,1,0,9
278456,oḷārikatte,olarikatte,3,3,0,0,10
278457,avūpasante,avupasante,9,9,0,0,10
278458,assāsapassāsāpi,assasapassasapi,8,7,1,0,15
278459,balavatarā,balavatara,33,30,3,0,10
278460,assasantopi,assasantopi,6,6,0,0,11
278461,passasantopi,passasantopi,6,6,0,0,12
278462,vūpasantesu,vupasantesu,5,5,0,0,11
278463,vicetabbatākārappattā,vicetabbatakarappatta,3,3,0,0,21
278464,mahābhāraṃ,mahabharam,3,3,0,0,10
278465,allasāṭakaṃ,allasatakam,3,3,0,0,11
278466,oḷārikoḷārike,olarikolarike,5,5,0,0,13
278467,passambhemī,passambhemi,4,4,0,0,11
278468,ābhogasamannāhāramanasikārapaccavekkhaṇā,abhogasamannaharamanasikarapaccavekkhana,7,7,0,0,40
278469,pariggahitakāle,pariggahitakale,14,12,2,0,15
278470,apariggahitakālato,apariggahitakalato,3,3,0,0,18
278471,sāraddhe,saraddhe,3,3,0,0,8
278472,asāraddhamhi,asaraddhamhi,3,3,0,0,12
278473,kāyamhi,kayamhi,21,20,1,0,7
278474,sampavattatī,sampavattati,4,4,0,0,12
278475,pariggahepi,pariggahepi,3,3,0,0,11
278476,atisukhumo,atisukhumo,6,6,0,0,10
278477,appavattimeva,appavattimeva,6,4,2,0,13
278478,dīghabhāṇakasaṃyuttabhāṇakānaṃ,dighabhanakasamyuttabhanakanam,3,1,2,0,30
278479,majjhimabhāṇakā,majjhimabhanaka,39,25,14,0,15
278480,V1.0264,V1.0264,32,32,0,0,7
278481,sukhumoti,sukhumoti,4,1,3,0,9
278482,uparūparijjhānupacārepi,uparuparijjhanupacarepi,1,1,0,0,23
278483,sukhumataramicchanti,sukhumataramicchanti,1,1,0,0,20
278484,sabbesaññeva,sabbesanneva,14,12,2,0,12
278485,pavattakāyasaṅkhāro,pavattakayasankharo,12,10,2,0,19
278486,paṭippassambhati,patippassambhati,159,157,2,0,16
278487,apariggahe,apariggahe,6,6,0,0,10
278488,mahābhūtapariggahe,mahabhutapariggahe,8,5,3,0,18
278489,upādārūpapariggahe,upadarupapariggahe,3,3,0,0,18
278490,sakalarūpapariggahe,sakalarupapariggahe,6,3,3,0,19
278491,arūpapariggahe,arupapariggahe,5,5,0,0,14
278492,rūpārūpapariggahe,ruparupapariggahe,5,3,2,0,17
278493,sappaccayanāmarūpapariggahe,sappaccayanamarupapariggahe,2,2,0,0,27
278494,lakkhaṇārammaṇikavipassanāya,lakkhanarammanikavipassanaya,9,9,0,0,28
278495,dubbalavipassanāya,dubbalavipassanaya,3,3,0,0,18
278496,balavavipassanāya,balavavipassanaya,14,14,0,0,17
278497,M1.0268,M1.0268,29,29,0,0,7
278498,paṭippassaddhi,patippassaddhi,44,43,1,0,14
278499,codanāsodhanāhi,codanasodhanahi,4,4,0,0,15
278500,kāyapaṭibaddhā,kayapatibaddha,7,7,0,0,14
278501,yathārūpehi,yatharupehi,19,19,0,0,11
278502,kāyasaṅkhārehi,kayasankharehi,12,12,0,0,14
278503,ānamanā,anamana,12,11,1,0,7
278504,vinamanā,vinamana,10,9,1,0,8
278505,sannamanā,sannamana,10,9,1,0,9
278506,paṇamanā,panamana,11,10,1,0,8
278507,phandanā,phandana,15,13,2,0,8
278508,aniñjanā,aninjana,3,3,0,0,8
278509,aphandanā,aphandana,5,5,0,0,9
278510,acalanā,acalana,3,3,0,0,7
278511,akampanā,akampana,3,3,0,0,8
278512,V1.0265,V1.0265,30,30,0,0,7
278513,vātūpaladdhiyā,vatupaladdhiya,10,9,1,0,14
278514,pabhāvanā,pabhavana,52,45,7,0,9
278515,assāsapassāsānañca,assasapassasananca,13,10,3,0,18
278516,ānāpānassatisamādhissa,anapanassatisamadhissa,29,28,1,0,22
278517,samāpajjantipi,samapajjantipi,12,12,0,0,14
278518,vuṭṭhahantipi,vutthahantipi,9,9,0,0,13
278519,ākoṭite,akotite,7,7,0,0,7
278520,sugahitattā,sugahitatta,1,1,0,0,11
278521,sumanasikatattā,sumanasikatatta,12,12,0,0,15
278522,sūpadhāritattā,supadharitatta,12,12,0,0,14
278523,sukhumakā,sukhumaka,11,8,3,0,9
278524,sukhumakānaṃ,sukhumakanam,6,6,0,0,12
278525,suggahitattā,suggahitatta,24,24,0,0,12
278526,sukhumake,sukhumake,6,6,0,0,9
278527,sukhumasaddanimittārammaṇatāpi,sukhumasaddanimittarammanatapi,3,3,0,0,30
278528,sukhumaassāsapassāsanimittārammaṇatāpi,sukhumaassasapassasanimittarammanatapi,2,2,0,0,38
278529,satipaṭṭhānabhāvanā,satipatthanabhavana,22,20,2,0,19
278530,V1.0266,V1.0266,32,32,0,0,7
278531,kāyānupassanāvasena,kayanupassanavasena,14,14,0,0,19
278532,paṭhamacatukkassa,pathamacatukkassa,4,4,0,0,17
278533,anupubbapadavaṇṇanā,anupubbapadavannana,15,14,1,0,19
278534,kammaṭṭhānavasena,kammatthanavasena,11,11,0,0,17
278535,pattajjhānassa,pattajjhanassa,3,3,0,0,14
278536,vedanācittadhammānupassanāvasena,vedanacittadhammanupassanavasena,5,5,0,0,32
278537,ānāpānacatutthajjhānapadaṭṭhānāya,anapanacatutthajjhanapadatthanaya,1,1,0,0,33
278538,pāpuṇitukāmena,papunitukamena,5,5,0,0,14
278539,sīlaparisodhanādīni,silaparisodhanadini,3,3,0,0,19
278540,pañcasandhikaṃ,pancasandhikam,13,9,4,0,14
278541,uggaṇhanaṃ,ugganhanam,30,24,6,0,10
278542,paripucchanā,paripucchana,4,2,2,0,12
278543,evaṃlakkhaṇamidaṃ,evamlakkhanamidam,2,2,0,0,17
278544,kammaṭṭhānasabhāvūpadhāraṇanti,kammatthanasabhavupadharananti,5,4,1,0,30
278545,ācariyampi,acariyampi,8,6,2,0,10
278546,viheseti,viheseti,22,21,1,0,8
278547,uddisāpetvā,uddisapetva,17,17,0,0,11
278548,katabhattakiccena,katabhattakiccena,8,8,0,0,17
278549,ratanattayaguṇānussaraṇena,ratanattayagunanussaranena,11,11,0,0,26
278550,ācariyuggahato,acariyuggahato,5,5,0,0,14
278551,anubandhanā,anubandhana,11,8,3,0,11
278552,paṭipassanāti,patipassanati,5,1,4,0,13
278553,anubandhanāti,anubandhanati,4,0,4,0,13
278554,anuvahanā,anuvahana,2,2,0,0,9
278555,phusanāti,phusanati,14,4,10,0,9
278556,phuṭṭhaṭṭhānaṃ,phutthatthanam,19,16,3,0,14
278557,sallakkhaṇāti,sallakkhanati,2,0,2,0,13
278558,vivaṭṭanāti,vivattanati,4,0,4,0,11
278559,V1.0267,V1.0267,32,32,0,0,7
278560,gaṇentena,ganentena,10,10,0,0,9
278561,ṭhapentassa,thapentassa,44,43,1,0,11
278562,vipphandati,vipphandati,30,30,0,0,11
278563,sanniruddhagogaṇo,sanniruddhagogano,3,3,0,0,17
278564,nentassa,nentassa,13,13,0,0,8
278565,gaṇananissitako,ganananissitako,1,1,0,0,15
278566,dassentassa,dassentassa,13,13,0,0,11
278567,sikhāppattaṃ,sikhappattam,24,20,4,0,12
278568,gaṇetabbaṃ,ganetabbam,362,360,2,0,10
278569,dandhagaṇanāya,dandhagananaya,5,5,0,0,14
278570,dhaññamāpakagaṇanāya,dhannamapakagananaya,3,1,2,0,20
278571,dhaññamāpako,dhannamapako,4,4,0,0,12
278572,okirati,okirati,6,5,1,0,7
278573,dvetiādīsu,dvetiadisu,2,2,0,0,10
278574,assāsapassāsesu,assasapassasesu,42,40,2,0,15
278575,upalakkhetvāva,upalakkhetvava,5,5,0,0,14
278576,gaṇayato,ganayato,10,10,0,0,8
278577,dandhagaṇanaṃ,dandhagananam,4,4,0,0,13
278578,dhaññamāpakagaṇanaṃ,dhannamapakagananam,3,3,0,0,19
278579,sīghagaṇanāya,sighagananaya,7,7,0,0,13
278580,gopālakagaṇanāya,gopalakagananaya,3,1,2,0,16
278581,sakkharādayo,sakkharadayo,2,2,0,0,12
278582,palighatthambhamatthake,palighatthambhamatthake,3,3,0,0,23
278583,dvārappattaṃyeva,dvarappattamyeva,7,7,0,0,16
278584,vutthagogaṇo,vutthagogano,3,3,0,0,12
278585,upanighaṃsanto,upanighamsanto,3,3,0,0,14
278586,puñjapuñjo,punjapunjo,2,2,0,0,10
278587,gaṇetiyeva,ganetiyeva,3,3,0,0,10
278588,evamimassāpi,evamimassapi,2,2,0,0,12
278589,tatonena,tatonena,3,3,0,0,8
278590,gaṇetabbameva,ganetabbameva,4,3,1,0,13
278591,gaṇanapaṭibaddhe,gananapatibaddhe,2,1,1,0,16
278592,gaṇanabaleneva,gananabaleneva,2,2,0,0,14
278593,arittupatthambhanavasena,arittupatthambhanavasena,2,2,0,0,24
278594,caṇḍasote,candasote,16,15,1,0,9
278595,nāvāṭṭhapanamiva,navatthapanamiva,1,1,0,0,16
278596,apariggahetvā,apariggahetva,9,9,0,0,13
278597,pavisanavātena,pavisanavatena,1,1,0,0,14
278598,pavesayato,pavesayato,3,3,0,0,10
278599,vātabbhāhataṃ,vatabbhahatam,5,3,2,0,13
278600,medapūritaṃ,medapuritam,3,3,0,0,11
278601,V1.0268,V1.0268,32,32,0,0,7
278602,nikkhamanavātena,nikkhamanavatena,1,1,0,0,16
278603,nīharato,niharato,12,11,1,0,8
278604,phuṭṭhaphuṭṭhokāse,phutthaphutthokase,2,2,0,0,18
278605,kīvaciraṃ,kivaciram,19,18,1,0,9
278606,gaṇetabbanti,ganetabbanti,3,3,0,0,12
278607,assāsapassāsārammaṇe,assasapassasarammane,7,7,0,0,20
278608,bahivisaṭavitakkavicchedaṃ,bahivisatavitakkavicchedam,1,1,0,0,26
278609,satisaṇṭhāpanatthaṃyeva,satisanthapanatthamyeva,1,1,0,0,23
278610,anubandhanāya,anubandhanaya,23,19,4,0,13
278611,paṭisaṃharitvā,patisamharitva,36,36,0,0,14
278612,anugamanaṃ,anugamanam,12,9,3,0,10
278613,ādimajjhapariyosānānugamanavasena,adimajjhapariyosananugamanavasena,4,4,0,0,33
278614,bahinikkhamanavātassa,bahinikkhamanavatassa,3,3,0,0,21
278615,nāsikaggaṃ,nasikaggam,20,16,4,0,10
278616,pavisanavātassa,pavisanavatassa,2,1,1,0,15
278617,vikkhepagataṃ,vikkhepagatam,6,4,2,0,13
278618,sāraddhāya,saraddhaya,2,2,0,0,10
278619,iñjanāya,injanaya,4,4,0,0,8
278620,phusanāvasena,phusanavasena,9,7,2,0,13
278621,ṭhapanāvasena,thapanavasena,17,13,4,0,13
278622,gaṇanānubandhanāvasena,ganananubandhanavasena,7,3,4,0,22
278623,phusanāṭhapanāvasena,phusanathapanavasena,6,3,3,0,20
278624,phuṭṭhaphuṭṭhaṭṭhāneyeva,phutthaphutthatthaneyeva,15,13,2,0,24
278625,gaṇento,ganento,10,9,1,0,7
278626,phusanāya,phusanaya,22,20,2,0,9
278627,svāyamattho,svayamattho,113,106,7,0,11
278628,vuttapaṅguḷadovārikūpamāhi,vuttapanguladovarikupamahi,1,1,0,0,26
278629,vuttakakacūpamāya,vuttakakacupamaya,2,2,0,0,17
278630,paṅguḷopamā,pangulopama,6,4,2,0,11
278631,kīḷataṃ,kilatam,6,3,3,0,7
278632,dolaṃ,dolam,3,3,0,0,5
278633,V1.0269,V1.0269,32,32,0,0,7
278634,dolāthambhamūle,dolathambhamule,2,2,0,0,15
278635,dolāphalakassa,dolaphalakassa,4,3,1,0,14
278636,ubhokoṭimajjhānaṃ,ubhokotimajjhanam,3,3,0,0,17
278637,evamevāyaṃ,evamevayam,22,22,0,0,10
278638,sativasena,sativasena,7,7,0,0,10
278639,upanibandhanathambhamūle,upanibandhanathambhamule,1,1,0,0,24
278640,assāsapassāsadolaṃ,assasapassasadolam,3,3,0,0,18
278641,āgacchantānañca,agacchantananca,9,9,0,0,15
278642,gacchantānañca,gacchantananca,10,10,0,0,14
278643,M1.0273,M1.0273,29,29,0,0,7
278644,dovārikūpamā,dovarikupama,2,1,1,0,12
278645,antopaviṭṭhavātā,antopavitthavata,2,2,0,0,16
278646,bahinikkhantavātā,bahinikkhantavata,2,2,0,0,17
278647,dvārappattā,dvarappatta,3,3,0,0,11
278648,dvārappattāyeva,dvarappattayeva,3,3,0,0,15
278649,kakacūpamā,kakacupama,7,5,2,0,10
278650,anārammaṇamekacittassa,anarammanamekacittassa,10,10,0,0,22
278651,aviditā,avidita,29,26,3,0,7
278652,visesamadhi,visesamadhi,1,1,0,0,11
278653,phuṭṭhakakacadantānaṃ,phutthakakacadantanam,8,6,2,0,21
278654,V1.0270,V1.0270,32,32,0,0,7
278655,kakacadante,kakacadante,12,10,2,0,11
278656,kakacadantā,kakacadanta,12,11,1,0,11
278657,upanibandhanānimittaṃ,upanibandhananimittam,4,2,2,0,21
278658,mukhanimitte,mukhanimitte,14,12,2,0,12
278659,āraddhavīriyassa,araddhaviriyassa,52,52,0,0,16
278660,byantī,byanti,30,18,12,0,6
278661,āgatāgatavasena,agatagatavasena,3,3,0,0,15
278662,amanasikāramattameva,amanasikaramattameva,5,4,1,0,20
278663,V1.0271,V1.0271,31,31,0,0,7
278664,avasesajhānaṅgapaṭimaṇḍitā,avasesajhanangapatimandita,4,3,1,0,26
278665,appanāsaṅkhātā,appanasankhata,6,4,2,0,14
278666,gaṇanāvaseneva,gananavaseneva,6,3,3,0,14
278667,manasikārakālato,manasikarakalato,7,4,3,0,16
278668,anukkamato,anukkamato,11,9,2,0,10
278669,oḷārikaassāsapassāsanirodhavasena,olarikaassasapassasanirodhavasena,5,5,0,0,33
278670,laṅghanākārappattaṃ,langhanakarappattam,6,5,1,0,19
278671,sāraddhakāyassa,saraddhakayassa,5,3,2,0,15
278672,nisīdato,nisidato,30,29,1,0,8
278673,onamati,onamati,30,28,2,0,7
278674,vikūjati,vikujati,7,7,0,0,8
278675,valiṃ,valim,15,13,2,0,5
278676,asāraddhakāyassa,asaraddhakayassa,3,3,0,0,16
278677,tūlapicupūritaṃ,tulapicupuritam,3,3,0,0,15
278678,asāraddho,asaraddho,40,39,1,0,9
278679,sukhumassāsapassāsanimittārammaṇaṃ,sukhumassasapassasanimittarammanam,1,1,0,0,34
278680,nimittārammaṇaṃ,nimittarammanam,11,9,2,0,15
278681,lohasalākāya,lohasalakaya,2,2,0,0,12
278682,kaṃsathālaṃ,kamsathalam,8,8,0,0,11
278683,oḷārikasaddārammaṇaṃ,olarikasaddarammanam,2,2,0,0,20
278684,sukhumasaddanimittārammaṇaṃ,sukhumasaddanimittarammanam,2,2,0,0,27
278685,saddanimittārammaṇaṃ,saddanimittarammanam,1,1,0,0,20
278686,pavattateva,pavattateva,15,15,0,0,11
278687,vibhūtāni,vibhutani,4,4,0,0,9
278688,sukhumattaṃ,sukhumattam,9,6,3,0,11
278689,upaṭṭhānampi,upatthanampi,12,12,0,0,12
278690,pucchissāmī,pucchissami,87,85,2,0,11
278691,vuṭṭhātabbaṃ,vutthatabbam,25,20,5,0,12
278692,navanavameva,navanavameva,4,4,0,0,12
278693,yathānisinneneva,yathanisinneneva,5,5,0,0,16
278694,āharaṇūpāyo,aharanupayo,4,4,0,0,11
278695,anupaṭṭhānabhāvaṃ,anupatthanabhavam,2,2,0,0,17
278696,paṭisañcikkhitabbaṃ,patisancikkhitabbam,39,39,0,0,19
278697,V1.0272,V1.0272,31,31,0,0,7
278698,paṭisañcikkhatā,patisancikkhata,2,2,0,0,15
278699,antomātukucchiyaṃ,antomatukucchiyam,7,5,2,0,17
278700,asaññībhūtānaṃ,asannibhutanam,5,5,0,0,14
278701,catutthajjhānasamāpannānaṃ,catutthajjhanasamapannanam,5,5,0,0,26
278702,rūpārūpabhavasamaṅgīnaṃ,ruparupabhavasamanginam,5,5,0,0,23
278703,nirodhasamāpannānanti,nirodhasamapannananti,6,6,0,0,21
278704,paṭicodetabbo,paticodetabbo,3,3,0,0,13
278705,asaññībhūto,asannibhuto,3,3,0,0,11
278706,catutthajjhānasamāpanno,catutthajjhanasamapanno,2,2,0,0,23
278707,rūpārūpabhavasamaṅgī,ruparupabhavasamangi,3,3,0,0,20
278708,mandapaññatāya,mandapannataya,4,4,0,0,14
278709,sakkosī,sakkosi,17,17,0,0,7
278710,pakatiphuṭṭhavasena,pakatiphutthavasena,2,2,0,0,19
278711,dīghanāsikassa,dighanasikassa,5,5,0,0,14
278712,nāsāpuṭaṃ,nasaputam,9,8,1,0,9
278713,ghaṭṭentā,ghattenta,15,15,0,0,9
278714,rassanāsikassa,rassanasikassa,4,4,0,0,14
278715,uttaroṭṭhaṃ,uttarottham,8,8,0,0,11
278716,ānāpānassatibhāvanaṃ,anapanassatibhavanam,4,4,0,0,20
278717,M1.0276,M1.0276,29,29,0,0,7
278718,sampajānasseva,sampajanasseva,4,4,0,0,14
278719,garukabhāvanaṃ,garukabhavanam,7,4,3,0,14
278720,buddhapaccekabuddhabuddhaputtānaṃ,buddhapaccekabuddhabuddhaputtanam,5,5,0,0,33
278721,mahāpurisānaṃyeva,mahapurisanamyeva,2,2,0,0,17
278722,manasikārabhūmibhūtaṃ,manasikarabhumibhutam,3,3,0,0,21
278723,ittaraṃ,ittaram,73,63,10,0,7
278724,ittarasattasamāsevitaṃ,ittarasattasamasevitam,3,3,0,0,22
278725,santañceva,santanceva,4,4,0,0,10
278726,sukhumañca,sukhumanca,4,4,0,0,10
278727,maṭṭhasāṭakassa,matthasatakassa,3,3,0,0,15
278728,tunnakaraṇakāle,tunnakaranakale,3,3,0,0,15
278729,sūcipi,sucipi,6,6,0,0,6
278730,sūcipāsavedhanampi,sucipasavedhanampi,3,3,0,0,18
278731,maṭṭhasāṭakasadisassa,matthasatakasadisassa,3,3,0,0,21
278732,sūcipaṭibhāgā,sucipatibhaga,3,3,0,0,13
278733,sūcipāsavedhanapaṭibhāgā,sucipasavedhanapatibhaga,3,3,0,0,24
278734,satipaññāhi,satipannahi,8,8,0,0,11
278735,pakatiphuṭṭhokāsā,pakatiphutthokasa,6,6,0,0,17
278736,pariyesitabbā,pariyesitabba,37,37,0,0,13
278737,gocaramukhe,gocaramukhe,2,2,0,0,11
278738,vissameyya,vissameyya,3,3,0,0,10
278739,aṭaviṃ,atavim,59,57,2,0,6
278740,paviseyyuṃ,paviseyyum,7,7,0,0,10
278741,yojetukāmo,yojetukamo,8,7,1,0,10
278742,āhiṇḍahi,ahindahi,1,1,0,0,8
278743,rasmiñca,rasminca,3,3,0,0,8
278744,patodañca,patodanca,6,6,0,0,9
278745,nipātanatitthaṃ,nipatanatittham,4,4,0,0,15
278746,V1.0273,V1.0273,31,31,0,0,7
278747,rasmiyā,rasmiya,6,5,1,0,7
278748,patodena,patodena,6,6,0,0,8
278749,satirasmiṃ,satirasmim,3,3,0,0,10
278750,paññāpatodañca,pannapatodanca,3,3,0,0,14
278751,pakatiphuṭṭhokāse,pakatiphutthokase,3,3,0,0,17
278752,nipātanatitthe,nipatanatitthe,2,2,0,0,14
278753,satirasmiyā,satirasmiya,5,3,2,0,11
278754,paññāpatodena,pannapatodena,3,3,0,0,13
278755,vijjhantena,vijjhantena,4,4,0,0,11
278756,tassevamanuyuñjato,tassevamanuyunjato,3,3,0,0,18
278757,sukhasamphassaṃ,sukhasamphassam,26,25,1,0,15
278758,uppādayamāno,uppadayamano,9,9,0,0,12
278759,tūlapicu,tulapicu,16,16,0,0,8
278760,kappāsapicu,kappasapicu,5,5,0,0,11
278761,vātadhārā,vatadhara,3,3,0,0,9
278762,tārakarūpaṃ,tarakarupam,7,4,3,0,11
278763,maṇiguḷikā,manigulika,4,3,1,0,10
278764,muttāguḷikā,muttagulika,3,3,0,0,11
278765,kappāsaṭṭhi,kappasatthi,3,3,0,0,11
278766,dārusārasūci,darusarasuci,2,2,0,0,12
278767,dīghapāmaṅgasuttaṃ,dighapamangasuttam,3,3,0,0,18
278768,kusumadāmaṃ,kusumadamam,4,4,0,0,11
278769,dhūmasikhā,dhumasikha,3,3,0,0,10
278770,makkaṭakasuttaṃ,makkatakasuttam,7,6,1,0,15
278771,valāhakapaṭalaṃ,valahakapatalam,3,3,0,0,15
278772,sītacchāyo,sitacchayo,7,5,2,0,10
278773,sākhāsampanno,sakhasampanno,3,3,0,0,13
278774,phalabhārabharitarukkho,phalabharabharitarukkho,2,2,0,0,23
278775,saññānānatāya,sannananataya,9,9,0,0,13
278776,nānato,nanato,37,34,3,0,6
278777,saññajañhi,sannajanhi,3,3,0,0,10
278778,saññānidānaṃ,sannanidanam,3,3,0,0,12
278779,saññāpabhavaṃ,sannapabhavam,2,2,0,0,13
278780,assāsārammaṇaṃ,assasarammanam,2,2,0,0,14
278781,passāsārammaṇaṃ,passasarammanam,2,2,0,0,15
278782,upacārañca,upacaranca,9,8,1,0,10
278783,appanañca,appananca,2,2,0,0,9
278784,V1.0274,V1.0274,30,30,0,0,7
278785,jānatova,janatova,1,1,0,0,8
278786,visīdeyya,visideyya,3,3,0,0,9
278787,manasikāreyeva,manasikareyeva,2,2,0,0,14
278788,niyojetabboti,niyojetabboti,3,3,0,0,13
278789,dīghabhāṇakā,dighabhanaka,23,19,4,0,12
278790,nimittamidaṃ,nimittamidam,5,3,2,0,12
278791,nimitteyeva,nimitteyeva,5,5,0,0,11
278792,ṭhapayaṃ,thapayam,8,5,3,0,8
278793,vibhāvayaṃ,vibhavayam,13,8,5,0,10
278794,nibandhatī,nibandhati,3,3,0,0,10
278795,nimittupaṭṭhānato,nimittupatthanato,7,6,1,0,17
278796,upaṭṭhitāyeva,upatthitayeva,2,2,0,0,13
278797,samāhitameva,samahitameva,5,5,0,0,12
278798,khattiyamahesiyā,khattiyamahesiya,3,3,0,0,16
278799,kassakena,kassakena,4,4,0,0,9
278800,sāliyavagabbho,saliyavagabbho,3,3,0,0,14
278801,āvāsādīni,avasadini,2,2,0,0,9
278802,asappāyāni,asappayani,22,21,1,0,10
278803,sevantena,sevantena,4,4,0,0,9
278804,gamayitvā,gamayitva,4,3,1,0,9
278805,V1.0275,V1.0275,30,30,0,0,7
278806,ghaṭentassa,ghatentassa,9,9,0,0,11
278807,vuttānukkameneva,vuttanukkameneva,3,3,0,0,16
278808,nibbattacatukkapañcakajjhāno,nibbattacatukkapancakajjhano,2,2,0,0,28
278809,sallakkhaṇāvivaṭṭanā,sallakkhanavivattana,1,0,1,0,20
278810,pattukāmo,pattukamo,6,6,0,0,9
278811,vasippattaṃ,vasippattam,11,8,3,0,11
278812,cittañcāti,cittancati,9,9,0,0,10
278813,kammāragaggariyā,kammaragaggariya,7,7,0,0,16
278814,dhamamānāya,dhamamanaya,7,7,0,0,11
278815,bhastañca,bhastanca,4,4,0,0,9
278816,assāsapassāsāti,assasapassasati,4,4,0,0,15
278817,taṃsampayuttadhamme,tamsampayuttadhamme,5,5,0,0,19
278818,arūpanti,arupanti,20,20,0,0,8
278819,kalāpasammasanavasena,kalapasammasanavasena,10,10,0,0,21
278820,udayabbayānupassanāya,udayabbayanupassanaya,20,20,0,0,21
278821,vipassanupakkilese,vipassanupakkilese,7,6,1,0,18
278822,upakkilesavimuttaṃ,upakkilesavimuttam,16,14,2,0,18
278823,paṭipadāñāṇaṃ,patipadananam,5,4,1,0,13
278824,bhaṅgānupassanaṃ,bhanganupassanam,12,11,1,0,16
278825,bhaṅgānupassanena,bhanganupassanena,3,3,0,0,17
278826,ekūnavīsatibhedassa,ekunavisatibhedassa,6,4,2,0,19
278827,paccavekkhaṇāñāṇassa,paccavekkhanananassa,4,4,0,0,20
278828,vipassanāpariyosānā,vipassanapariyosana,3,3,0,0,19
278829,ānāpānassatisamādhibhāvanā,anapanassatisamadhibhavana,8,8,0,0,26
278830,paṭhamacatukkavaṇṇanā,pathamacatukkavannana,4,4,0,0,21
278831,kammaṭṭhānabhāvanānayo,kammatthanabhavananayo,6,4,2,0,22
278832,anupadavaṇṇanānayeneva,anupadavannananayeneva,3,3,0,0,22
278833,pītipaṭisaṃvedīti,pitipatisamvediti,4,0,4,0,17
278834,paṭisaṃviditaṃ,patisamviditam,52,44,8,0,14
278835,V1.0276,V1.0276,30,30,0,0,7
278836,paṭisaṃviditā,patisamvidita,81,68,13,0,13
278837,asammohato,asammohato,139,116,23,0,10
278838,sappītike,sappitike,39,34,5,0,9
278839,samāpattikkhaṇe,samapattikkhane,24,24,0,0,15
278840,jhānapaṭilābhena,jhanapatilabhena,8,8,0,0,16
278841,paṭisaṃviditattā,patisamviditatta,13,11,2,0,16
278842,khayato,khayato,68,61,7,0,7
278843,vipassanākkhaṇe,vipassanakkhane,87,84,3,0,15
278844,lakkhaṇapaṭivedhena,lakkhanapativedhena,9,9,0,0,19
278845,assāsapassāsavasena,assasapassasavasena,46,46,0,0,19
278846,M1.0280,M1.0280,29,29,0,0,7
278847,adhiṭṭhahato,adhitthahato,8,8,0,0,12
278848,adhimuccato,adhimuccato,10,8,2,0,11
278849,paggaṇhato,pagganhato,11,11,0,0,10
278850,upaṭṭhāpayato,upatthapayato,20,20,0,0,13
278851,samādahato,samadahato,5,5,0,0,10
278852,sacchikaroto,sacchikaroto,10,8,2,0,12
278853,avasesapadānipi,avasesapadanipi,6,5,1,0,15
278854,idampanettha,idampanettha,1,1,0,0,12
278855,visesamattaṃ,visesamattam,14,14,0,0,12
278856,sukhapaṭisaṃveditā,sukhapatisamvedita,3,2,1,0,18
278857,cittasaṅkhārapaṭisaṃveditā,cittasankharapatisamvedita,3,2,1,0,26
278858,vedanādayo,vedanadayo,109,101,8,0,10
278859,sukhapaṭisaṃvedīpade,sukhapatisamvedipade,1,1,0,0,20
278860,vipassanābhūmidassanatthaṃ,vipassanabhumidassanattham,6,2,4,0,26
278861,cetasikañcā,cetasikanca,3,2,1,0,11
278862,nirodhentoti,nirodhentoti,6,3,3,0,12
278863,pītipade,pitipade,2,2,0,0,8
278864,pītisīsena,pitisisena,12,9,3,0,10
278865,sukhapade,sukhapade,1,1,0,0,9
278866,cittasaṅkhārapadesu,cittasankharapadesu,3,3,0,0,19
278867,V1.0277,V1.0277,30,30,0,0,7
278868,cittapaṭibaddhā,cittapatibaddha,19,17,2,0,15
278869,cittasaṅkhārā,cittasankhara,47,40,7,0,13
278870,saññāsampayuttā,sannasampayutta,6,3,3,0,15
278871,vedanānupassanānayena,vedananupassananayena,3,2,1,0,21
278872,tatiyacatukkepi,tatiyacatukkepi,3,3,0,0,15
278873,cittapaṭisaṃveditā,cittapatisamvedita,5,2,3,0,18
278874,modento,modento,4,4,0,0,7
278875,hāsento,hasento,9,9,0,0,7
278876,pahāsento,pahasento,3,3,0,0,9
278877,abhippamodo,abhippamodo,8,8,0,0,11
278878,sampayuttapītiyā,sampayuttapitiya,2,2,0,0,16
278879,āmodeti,amodeti,10,9,1,0,7
278880,pamodeti,pamodeti,11,11,0,0,8
278881,jhānasampayuttapītiṃ,jhanasampayuttapitim,2,2,0,0,20
278882,M1.0281,M1.0281,29,29,0,0,7
278883,paṭhamajjhānādivasena,pathamajjhanadivasena,17,17,0,0,21
278884,ādahanto,adahanto,9,9,0,0,8
278885,khaṇikacittekaggatā,khanikacittekaggata,3,3,0,0,19
278886,khaṇikacittekaggatāya,khanikacittekaggataya,3,3,0,0,21
278887,paṭhamajjhānena,pathamajjhanena,40,38,2,0,15
278888,niccasaññāto,niccasannato,5,3,2,0,12
278889,sukhasaññāto,sukhasannato,3,3,0,0,12
278890,attasaññāto,attasannato,3,3,0,0,11
278891,rāgato,ragato,30,25,5,0,6
278892,V1.0278,V1.0278,30,30,0,0,7
278893,cittānupassanāvasena,cittanupassanavasena,7,6,1,0,20
278894,aniccānupassīti,aniccanupassiti,14,1,13,0,15
278895,uppādavayaññathattabhāvā,uppadavayannathattabhava,9,7,2,0,24
278896,uppādavayaññathattaṃ,uppadavayannathattam,14,13,1,0,20
278897,tenevākārena,tenevakarena,27,26,1,0,12
278898,khaṇabhaṅgena,khanabhangena,4,4,0,0,13
278899,aniccānupassanāti,aniccanupassanati,7,4,3,0,17
278900,aniccanti,aniccanti,136,123,13,0,9
278901,anupassanāya,anupassanaya,53,51,2,0,12
278902,virāgānupassīti,viraganupassiti,8,0,8,0,15
278903,khayavirāgo,khayavirago,10,6,4,0,11
278904,accantavirāgo,accantavirago,12,6,6,0,13
278905,khayavirāgoti,khayaviragoti,5,0,5,0,13
278906,accantavirāgoti,accantaviragoti,3,0,3,0,15
278907,virāgānupassanāti,viraganupassanati,3,1,2,0,17
278908,tadubhayadassanavasena,tadubhayadassanavasena,4,3,1,0,22
278909,duvidhāyapi,duvidhayapi,16,16,0,0,11
278910,paṭinissaggānupassīti,patinissagganupassiti,8,1,7,0,21
278911,paṭinissaggā,patinissagga,40,40,0,0,12
278912,pariccāgapaṭinissaggo,pariccagapatinissaggo,24,15,9,0,21
278913,pakkhandanapaṭinissaggo,pakkhandanapatinissaggo,20,14,6,0,23
278914,paṭinissaggoyeva,patinissaggoyeva,3,3,0,0,16
278915,paṭinissaggānupassanā,patinissagganupassana,45,33,12,0,21
278916,vipassanāmaggānaṃ,vipassanamagganam,6,6,0,0,17
278917,tadaṅgavasena,tadangavasena,81,79,2,0,13
278918,khandhābhisaṅkhārehi,khandhabhisankharehi,16,11,5,0,20
278919,saṅkhatadosadassanena,sankhatadosadassanena,11,11,0,0,21
278920,tabbiparīte,tabbiparite,29,26,3,0,11
278921,tanninnatāya,tanninnataya,24,24,0,0,12
278922,pakkhandatīti,pakkhandatiti,96,64,32,0,13
278923,pakkhandanapaṭinissaggoti,pakkhandanapatinissaggoti,3,0,3,0,25
278924,ārammaṇakaraṇena,arammanakaranena,24,23,1,0,16
278925,purimapurimaññāṇānaṃ,purimapurimannananam,1,1,0,0,20
278926,anuanupassanato,anuanupassanato,1,1,0,0,15
278927,anupassanāti,anupassanati,8,7,1,0,12
278928,V1.0279,V1.0279,29,29,0,0,7
278929,catutthacatukkaṃ,catutthacatukkam,2,2,0,0,16
278930,suddhavipassanāvaseneva,suddhavipassanavaseneva,2,2,0,0,23
278931,catukkānaṃ,catukkanam,48,44,4,0,10
278932,soḷasavatthukāya,solasavatthukaya,7,7,0,0,16
278933,soḷasavatthuvasena,solasavatthuvasena,3,2,1,0,18
278934,santabhāvādivasenāpi,santabhavadivasenapi,1,1,0,0,20
278935,vitakkupacchedasamatthatāyapi,vitakkupacchedasamatthatayapi,2,2,0,0,29
278936,santapaṇītaasecanakasukhavihārattā,santapanitaasecanakasukhaviharatta,2,2,0,0,34
278937,samādhiantarāyakarānaṃ,samadhiantarayakaranam,2,2,0,0,22
278938,vitakkānaṃ,vitakkanam,54,49,5,0,10
278939,vidhāvanaṃ,vidhavanam,3,2,1,0,10
278940,ānāpānārammaṇābhimukhameva,anapanarammanabhimukhameva,2,2,0,0,26
278941,vitakkupacchedāyā,vitakkupacchedaya,6,6,0,0,17
278942,vijjāvimuttipāripūriyā,vijjavimuttiparipuriya,2,2,0,0,22
278943,mūlabhāvenāpi,mulabhavenapi,1,1,0,0,13
278944,vijjāvimuttiṃ,vijjavimuttim,29,26,3,0,13
278945,carimakānaṃ,carimakanam,3,2,1,0,11
278946,viditabhāvakaraṇatopissā,viditabhavakaranatopissa,2,2,0,0,24
278947,bahulīkatāya,bahulikataya,47,47,0,0,12
278948,carimakā,carimaka,8,8,0,0,8
278949,viditāva,viditava,5,5,0,0,8
278950,nirodhavasena,nirodhavasena,15,14,1,0,13
278951,bhavacarimakā,bhavacarimaka,4,2,2,0,13
278952,jhānacarimakā,jhanacarimaka,5,2,3,0,13
278953,cuticarimakāti,cuticarimakati,3,2,1,0,14
278954,V1.0280,V1.0280,29,29,0,0,7
278955,jhānattaye,jhanattaye,2,2,0,0,10
278956,soḷasamena,solasamena,7,6,1,0,10
278957,cuticarimakā,cuticarimaka,2,0,2,0,12
278958,anuyuttassa,anuyuttassa,53,53,0,0,11
278959,ānāpānārammaṇassa,anapanarammanassa,3,2,1,0,17
278960,soḷasamassa,solasamassa,3,3,0,0,11
278961,ṭhitipi,thitipi,5,5,0,0,7
278962,āyuantaraṃ,ayuantaram,8,7,1,0,10
278963,ānāpānassatiṃ,anapanassatim,38,32,6,0,13
278964,paricchinnameva,paricchinnameva,4,4,0,0,15
278965,pavattissanti,pavattissanti,7,7,0,0,13
278966,M1.0284,M1.0284,29,29,0,0,7
278967,sarīrapaṭijaggananivāsanapārupanādīni,sarirapatijaggananivasanaparupanadini,2,2,0,0,37
278968,nimīleti,nimileti,5,5,0,0,8
278969,koṭapabbatavihāravāsītissatthero,kotapabbataviharavasitissatthero,2,1,1,0,32
278970,mahākarañjiyavihāravāsīmahātissatthero,mahakaranjiyaviharavasimahatissatthero,1,1,0,0,38
278971,devaputtamahāraṭṭhe,devaputtamaharatthe,1,1,0,0,19
278972,piṇḍapātikatissatthero,pindapatikatissatthero,1,1,0,0,22
278973,cittalapabbatavihāravāsino,cittalapabbataviharavasino,2,2,0,0,26
278974,bhātiyattherā,bhatiyatthera,1,1,0,0,13
278975,ekavatthuparidīpanaṃ,ekavatthuparidipanam,4,4,0,0,20
278976,dvebhātiyattherānaṃ,dvebhatiyattheranam,1,1,0,0,19
278977,bhikkhusaṅghamāha,bhikkhusanghamaha,1,1,0,0,17
278978,parinibbāyantā,parinibbayanta,5,5,0,0,14
278979,nisinnakāva,nisinnakava,2,2,0,0,11
278980,pallaṅkamābhujitvā,pallankamabhujitva,6,6,0,0,18
278981,nisinnakā,nisinnaka,3,3,0,0,9
278982,caṅkamantameva,cankamantameva,2,2,0,0,14
278983,parinibbāyamānaṃ,parinibbayamanam,2,2,0,0,16
278984,dassessāmī,dassessami,54,51,3,0,10
278985,caṅkamakoṭito,cankamakotito,2,2,0,0,13
278986,parakoṭiṃ,parakotim,5,3,2,0,9
278987,nivattamāno,nivattamano,11,11,0,0,11
278988,parabhāgaṃ,parabhagam,15,12,3,0,10
278989,akkantakkhaṇeyeva,akkantakkhaneyeva,2,2,0,0,17
278990,upasamānussatikathā,upasamanussatikatha,1,1,0,0,19
278991,V1.0281,V1.0281,29,29,0,0,7
278992,upasamānussatiṃ,upasamanussatim,6,5,1,0,15
278993,madanimmadano,madanimmadano,15,12,3,0,13
278994,ālayasamugghāto,alayasamugghato,12,10,2,0,15
278995,vaṭṭupacchedo,vattupacchedo,22,21,1,0,13
278996,sabbadukkhūpasamasaṅkhātassa,sabbadukkhupasamasankhatassa,1,1,0,0,28
278997,M1.0285,M1.0285,29,29,0,0,7
278998,rāgābhāvamattameva,ragabhavamattameva,1,1,0,0,18
278999,madanimmadanotiādīni,madanimmadanotiadini,3,1,2,0,20
279000,asaṅkhatadhammo,asankhatadhammo,9,9,0,0,15
279001,mānamadapurisamadādayo,manamadapurisamadadayo,2,2,0,0,22
279002,nimmadā,nimmada,8,8,0,0,7
279003,amadā,amada,4,2,2,0,5
279004,madanimmadanoti,madanimmadanoti,1,0,1,0,15
279005,kāmapipāsā,kamapipasa,18,18,0,0,10
279006,abbhatthaṃ,abbhattham,107,97,10,0,10
279007,pipāsavinayoti,pipasavinayoti,2,0,2,0,14
279008,pañcakāmaguṇālayā,pancakamagunalaya,2,1,1,0,17
279009,ālayasamugghātoti,alayasamugghatoti,2,0,2,0,17
279010,vaṭṭupacchedoti,vattupacchedoti,2,0,2,0,15
279011,nirodhoti,nirodhoti,104,67,37,0,9
279012,sattāvāse,sattavase,44,41,3,0,9
279013,aparāparabhāvāya,aparaparabhavaya,3,3,0,0,16
279014,ābandhanato,abandhanato,4,4,0,0,11
279015,saṃsibbanato,samsibbanato,7,7,0,0,12
279016,laddhavohārāya,laddhavoharaya,2,2,0,0,14
279017,madanimmadanatādīnaṃ,madanimmadanatadinam,2,1,1,0,20
279018,nibbānasaṅkhāto,nibbanasankhato,10,10,0,0,15
279019,panaññepi,panannepi,28,28,0,0,9
279020,pārañca,paranca,7,7,0,0,7
279021,sududdasañca,sududdasanca,2,2,0,0,12
279022,ajarañca,ajaranca,1,1,0,0,8
279023,nippapañcañca,nippapancanca,2,2,0,0,13
279024,sivañca,sivanca,7,7,0,0,7
279025,khemañca,khemanca,9,9,0,0,8
279026,anītikañca,anitikanca,2,2,0,0,10
279027,abyābajjhañca,abyabajjhanca,1,1,0,0,13
279028,visuddhiñca,visuddhinca,1,1,0,0,11
279029,tāṇañca,tananca,8,8,0,0,7
279030,V1.0282,V1.0282,29,29,0,0,7
279031,leṇañca,lenanca,10,10,0,0,7
279032,upasamaguṇā,upasamaguna,3,3,0,0,11
279033,anussaritabboyeva,anussaritabboyeva,1,1,0,0,17
279034,madanimmadanatādiguṇavasena,madanimmadanatadigunavasena,1,1,0,0,27
279035,buddhānussatiādīsu,buddhanussatiadisu,6,6,0,0,18
279036,upasamaguṇānaṃ,upasamagunanam,1,1,0,0,14
279037,tadetamupasamaguṇānussaraṇavasena,tadetamupasamagunanussaranavasena,1,1,0,0,33
279038,upasamānussaticceva,upasamanussaticceva,1,1,0,0,19
279039,upasamagarukena,upasamagarukena,1,1,0,0,15
279040,sutavasenāpi,sutavasenapi,1,1,0,0,12
279041,satinti,satinti,1,1,0,0,7
279042,upasamānussatiyaṃ,upasamanussatiyam,1,1,0,0,17
279043,brahmavihāraniddeso,brahmaviharaniddeso,3,3,0,0,19
279044,mettābhāvanākathā,mettabhavanakatha,1,1,0,0,17
279045,anussatikammaṭṭhānānantaraṃ,anussatikammatthananantaram,1,1,0,0,27
279046,V1.0283,V1.0283,27,27,0,0,7
279047,upacchinnapalibodhena,upacchinnapalibodhena,5,5,0,0,21
279048,gahitakammaṭṭhānena,gahitakammatthanena,2,2,0,0,19
279049,vivitte,vivitte,38,38,0,0,7
279050,khantiyañca,khantiyanca,1,1,0,0,11
279051,adiṭṭhādīnavaṃ,aditthadinavam,1,1,0,0,14
279052,aviditānisaṃsaṃ,aviditanisamsam,1,1,0,0,15
279053,hanatī,hanati,8,6,2,0,6
279054,khantibalaṃ,khantibalam,19,14,5,0,11
279055,diṭṭhādīnavato,ditthadinavato,6,4,2,0,14
279056,vivecanatthāya,vivecanatthaya,2,2,0,0,14
279057,viditānisaṃsāya,viditanisamsaya,1,1,0,0,15
279058,saṃyojanatthāya,samyojanatthaya,4,3,1,0,15
279059,V1.0284,V1.0284,27,27,0,0,7
279060,ārabhitabbā,arabhitabba,9,9,0,0,11
279061,appiyapuggale,appiyapuggale,1,1,0,0,13
279062,atippiyasahāyake,atippiyasahayake,4,4,0,0,16
279063,verīpuggaleti,veripuggaleti,3,2,1,0,13
279064,liṅgavisabhāge,lingavisabhage,3,3,0,0,14
279065,bhāvetabbāva,bhavetabbava,2,2,0,0,12
279066,appiyādīsu,appiyadisu,2,2,0,0,10
279067,piyaṭṭhāne,piyatthane,6,4,2,0,10
279068,atippiyasahāyakaṃ,atippiyasahayakam,2,1,1,0,17
279069,majjhattaṭṭhāne,majjhattatthane,4,3,1,0,15
279070,appamattakepi,appamattakepi,30,28,2,0,13
279071,ārodanākārappatto,arodanakarappatto,1,1,0,0,17
279072,majjhattaṃ,majjhattam,24,22,2,0,10
279073,verimanussarato,verimanussarato,1,1,0,0,15
279074,kulūpakattheraṃ,kulupakattheram,1,1,0,0,15
279075,piyapuggale,piyapuggale,13,12,1,0,11
279076,bhittiyuddhamakāsi,bhittiyuddhamakasi,2,2,0,0,18
279077,paguṇāva,pagunava,2,1,1,0,8
279078,mettājhānasamāpatti,mettajhanasamapatti,1,1,0,0,19
279079,gavesāhī,gavesahi,2,2,0,0,8
279080,pariharāmī,pariharami,6,6,0,0,10
279081,attaniyeva,attaniyeva,12,11,1,0,10
279082,V1.0285,V1.0285,27,27,0,0,7
279083,mettāyeyya,mettayeyya,3,3,0,0,10
279084,anodhisopharaṇā,anodhisopharana,11,8,3,0,15
279085,anīghā,anigha,51,46,5,0,6
279086,pariharantu,pariharantu,13,13,0,0,11
279087,attabhāvapariyāpannā,attabhavapariyapanna,11,9,2,0,20
279088,pariharantū,pariharantu,14,14,0,0,11
279089,mettasutte,mettasutte,1,1,0,0,10
279090,sukhinova,sukhinova,4,3,1,0,9
279091,M1.0289,M1.0289,28,28,0,0,7
279092,sukhitattā,sukhitatta,17,17,0,0,10
279093,sakkhibhāvavasena,sakkhibhavavasena,1,1,0,0,17
279094,dukkhapaṭikkūlo,dukkhapatikkulo,4,4,0,0,15
279095,hitasukhakāmatā,hitasukhakamata,1,1,0,0,15
279096,V1.0286,V1.0286,27,27,0,0,7
279097,sakkhibhāvatthaṃ,sakkhibhavattham,1,1,0,0,16
279098,sukhappavattanatthaṃ,sukhappavattanattham,4,4,0,0,20
279099,ācariyamatto,acariyamatto,3,3,0,0,12
279100,upajjhāyamatto,upajjhayamatto,1,1,0,0,14
279101,dānapiyavacanādīni,danapiyavacanadini,1,1,0,0,18
279102,piyamanāpattakāraṇāni,piyamanapattakaranani,1,1,0,0,21
279103,sīlasutādīni,silasutadini,1,1,0,0,12
279104,garubhāvanīyattakāraṇāni,garubhavaniyattakaranani,1,1,0,0,24
279105,sīmāsambhedaṃ,simasambhedam,17,12,5,0,13
279106,atippiyasahāyakato,atippiyasahayakato,3,3,0,0,18
279107,verīpuggale,veripuggale,5,5,0,0,11
279108,upasaṃharitabbaṃ,upasamharitabbam,5,3,2,0,16
279109,verīpuggalo,veripuggalo,6,5,1,0,11
279110,mahāpurisajātikattā,mahapurisajatikatta,2,2,0,0,19
279111,karontepi,karontepi,10,9,1,0,9
279112,verīsaññāva,verisannava,2,1,1,0,11
279113,verimhi,verimhi,9,9,0,0,7
279114,upasaṃharāmī,upasamharami,2,2,0,0,12
279115,byāpārova,byaparova,2,2,0,0,9
279116,cittamupasaṃharato,cittamupasamharato,1,1,0,0,18
279117,katāparādhānussaraṇena,kataparadhanussaranena,1,1,0,0,22
279118,paṭighamuppajjati,patighamuppajjati,1,1,0,0,17
279119,purimapuggalesu,purimapuggalesu,1,1,0,0,15
279120,mettāyantena,mettayantena,7,4,3,0,12
279121,vinodetabbaṃ,vinodetabbam,14,12,2,0,12
279122,vāyamato,vayamato,30,30,0,0,8
279123,kakacūpamaovādaādīnaṃ,kakacupamaovadaadinam,1,1,0,0,21
279124,anusārato,anusarato,2,2,0,0,9
279125,ghaṭitabbaṃ,ghatitabbam,7,5,2,0,11
279126,ovadanteneva,ovadanteneva,1,1,0,0,12
279127,kujjhanapurisa,kujjhanapurisa,1,1,0,0,14
279128,ubhatodaṇḍakena,ubhatodandakena,10,10,0,0,15
279129,V1.0287,V1.0287,27,27,0,0,7
279130,padoseyya,padoseyya,3,3,0,0,9
279131,sāsanakaro,sasanakaro,17,16,1,0,10
279132,kuddhamappaṭikujjhanto,kuddhamappatikujjhanto,1,1,0,0,22
279133,upasammatī,upasammati,16,14,2,0,10
279134,sapattakantā,sapattakanta,8,8,0,0,12
279135,sapattakaraṇā,sapattakarana,5,5,0,0,13
279136,sapattassa,sapattassa,26,26,0,0,10
279137,vaṇṇavatāya,vannavataya,4,4,0,0,11
279138,kodhanāyaṃ,kodhanayam,6,5,1,0,10
279139,kodhapareto,kodhapareto,13,13,0,0,11
279140,sunhāto,sunhato,15,15,0,0,7
279141,suvilitto,suvilitto,18,17,1,0,9
279142,kappitakesamassu,kappitakesamassu,26,26,0,0,16
279143,odātavatthavasano,odatavatthavasano,6,6,0,0,17
279144,dubbaṇṇova,dubbannova,7,5,2,0,10
279145,M1.0291,M1.0291,28,28,0,0,7
279146,sapattakanto,sapattakanto,10,10,0,0,12
279147,sapattakaraṇo,sapattakarano,10,10,0,0,13
279148,sayeyyāti,sayeyyati,2,2,0,0,9
279149,pacurattho,pacurattho,4,4,0,0,10
279150,mittavā,mittava,13,13,0,0,7
279151,upapajjeyyāti,upapajjeyyati,6,5,1,0,13
279152,sugatigamanena,sugatigamanena,2,2,0,0,14
279153,V1.0288,V1.0288,27,27,0,0,7
279154,chavālātaṃ,chavalatam,16,10,6,0,10
279155,ubhatopadittaṃ,ubhatopadittam,7,4,3,0,14
279156,kaṭṭhatthaṃ,katthattham,19,15,4,0,11
279157,tathūpamāhaṃ,tathupamaham,98,95,3,0,12
279158,kujjhanto,kujjhanto,4,4,0,0,9
279159,paṭikujjhanto,patikujjhanto,2,2,0,0,13
279160,kuddhapurisatopi,kuddhapurisatopi,1,1,0,0,16
279161,jessasi,jessasi,1,1,0,0,7
279162,sapattakaraṇe,sapattakarane,1,1,0,0,13
279163,chavālātūpamo,chavalatupamo,3,3,0,0,13
279164,ghaṭayato,ghatayato,1,1,0,0,9
279165,anussariyamāno,anussariyamano,1,0,1,0,14
279166,kāyasamācārova,kayasamacarova,1,1,0,0,14
279167,upasantabhāvo,upasantabhavo,4,4,0,0,13
279168,sabbajanena,sabbajanena,2,2,0,0,11
279169,vacīsamācāramanosamācārā,vacisamacaramanosamacara,1,1,0,0,24
279170,avūpasantā,avupasanta,19,18,1,0,10
279171,kāyasamācāravūpasamoyeva,kayasamacaravupasamoyeva,1,1,0,0,24
279172,M1.0292,M1.0292,28,28,0,0,7
279173,vacīsamācārova,vacisamacarova,1,1,0,0,14
279174,paṭisanthārakusalo,patisantharakusalo,6,6,0,0,18
279175,sukhasambhāso,sukhasambhaso,9,9,0,0,13
279176,uttānamukho,uttanamukho,9,7,2,0,11
279177,pubbabhāsī,pubbabhasi,11,9,2,0,10
279178,osāreti,osareti,51,49,2,0,7
279179,parimaṇḍalehi,parimandalehi,16,13,3,0,13
279180,kāyasamācāramanosamācārā,kayasamacaramanosamacara,1,1,0,0,24
279181,vacīsamācāravūpasamoyeva,vacisamacaravupasamoyeva,1,1,0,0,24
279182,manosamācārova,manosamacarova,2,2,0,0,14
279183,cetiyavandanādīsu,cetiyavandanadisu,1,1,0,0,17
279184,avūpasantacitto,avupasantacitto,9,9,0,0,15
279185,dhammassavanamaṇḍape,dhammassavanamandape,3,3,0,0,20
279186,upasantacitto,upasantacitto,3,3,0,0,13
279187,okappetvā,okappetva,9,8,1,0,9
279188,kāyavacīsamācārā,kayavacisamacara,2,2,0,0,16
279189,manosamācāravūpasamoyeva,manosamacaravupasamoyeva,1,1,0,0,24
279190,V1.0289,V1.0289,27,27,0,0,7
279191,avūpasanto,avupasanto,15,14,1,0,10
279192,katipāhassa,katipahassa,7,7,0,0,11
279193,aṭṭhamahānirayasoḷasaussadanirayaparipūrako,atthamahanirayasolasaussadanirayaparipurako,2,1,1,0,43
279194,upaṭṭhapetabbaṃ,upatthapetabbam,10,9,1,0,15
279195,kāruññampi,karunnampi,5,4,1,0,10
279196,tayopime,tayopime,1,1,0,0,8
279197,mettābhāvanāti,mettabhavanati,1,1,0,0,14
279198,paṭivinodetabbo,pativinodetabbo,3,3,0,0,15
279199,ovaditabbo,ovaditabbo,20,19,1,0,10
279200,verinā,verina,6,6,0,0,6
279201,tassāvisaye,tassavisaye,1,1,0,0,11
279202,sacitte,sacitte,5,5,0,0,7
279203,kattumicchasi,kattumicchasi,5,5,0,0,13
279204,ñātivaggaṃ,nativaggam,2,2,0,0,10
279205,rudammukhaṃ,rudammukham,1,1,0,0,11
279206,mūlanikantanaṃ,mulanikantanam,2,1,1,0,14
279207,nāmupaḷālesi,namupalalesi,1,1,0,0,12
279208,anariyaṃ,anariyam,79,63,16,0,8
279209,kujjhasi,kujjhasi,26,25,1,0,8
279210,dosetukāmo,dosetukamo,1,1,0,0,10
279211,V1.0290,V1.0290,27,27,0,0,7
279212,dosuppādena,dosuppadena,1,1,0,0,11
279213,panidāneva,panidaneva,1,1,0,0,10
279214,kodhadukkhena,kodhadukkhena,1,1,0,0,13
279215,bādhasi,badhasi,3,3,0,0,7
279216,tesaṃyevānusikkhasi,tesamyevanusikkhasi,1,1,0,0,19
279217,chindassu,chindassu,3,2,1,0,9
279218,kimaṭṭhāne,kimatthane,1,1,0,0,10
279219,vihaññasi,vihannasi,10,9,1,0,9
279220,khaṇikattā,khanikatta,17,17,0,0,10
279221,dānīdha,danidha,4,3,1,0,7
279222,dukkhahetutta,dukkhahetutta,1,1,0,0,13
279223,kujjhasī,kujjhasi,3,2,1,0,8
279224,ovadatopi,ovadatopi,1,1,0,0,9
279225,kammassakatā,kammassakata,17,10,7,0,12
279226,paccavekkhitabbā,paccavekkhitabba,58,56,2,0,16
279227,dosanidānaṃ,dosanidanam,3,3,0,0,11
279228,saṃvattissati,samvattissati,20,19,1,0,13
279229,kammassako,kammassako,8,8,0,0,10
279230,kammadāyādo,kammadayado,12,9,3,0,11
279231,kammayoni,kammayoni,11,9,2,0,9
279232,kammabandhu,kammabandhu,11,9,2,0,11
279233,kammapaṭisaraṇo,kammapatisarano,7,5,2,0,15
279234,sāvakabhūmiṃ,savakabhumim,3,3,0,0,12
279235,brahmattasakkattacakkavattipadesarājādisampattīnaṃ,brahmattasakkattacakkavattipadesarajadisampattinam,2,2,0,0,50
279236,vighāsādādibhāvassa,vighasadadibhavassa,2,2,0,0,19
279237,nerayikādidukkhavisesānañca,nerayikadidukkhavisesananca,1,1,0,0,27
279238,saṃvattanikamidaṃ,samvattanikamidam,2,2,0,0,17
279239,vītaccite,vitaccite,1,1,0,0,9
279240,paharitukāmo,paharitukamo,6,6,0,0,12
279241,dahasi,dahasi,1,1,0,0,6
279242,duggandhañca,duggandhanca,2,2,0,0,12
279243,V1.0291,V1.0291,27,27,0,0,7
279244,kammassakataṃ,kammassakatam,31,27,4,0,13
279245,etassevetaṃ,etassevetam,1,1,0,0,11
279246,ayamāyasmā,ayamayasma,204,202,2,0,10
279247,idañcassa,idancassa,5,5,0,0,9
279248,nerayikādidukkhavisesānañcassa,nerayikadidukkhavisesanancassa,1,1,0,0,30
279249,rajena,rajena,24,24,0,0,6
279250,okiritukāmo,okiritukamo,1,1,0,0,11
279251,kammassakatampi,kammassakatampi,1,1,0,0,15
279252,pubbacariyaguṇā,pubbacariyaguna,2,0,2,0,15
279253,paccavekkhaṇānayo,paccavekkhananayo,4,4,0,0,17
279254,vadhakesupi,vadhakesupi,1,1,0,0,11
279255,paccatthikesu,paccatthikesu,7,6,1,0,13
279256,nappadūsesi,nappadusesi,3,3,0,0,11
279257,sīlavajātake,silavajatake,1,0,1,0,12
279258,pāpaamaccena,papaamaccena,1,1,0,0,12
279259,ānītassa,anitassa,4,4,0,0,8
279260,paṭirañño,patiranno,7,7,0,0,9
279261,nisedhanatthāya,nisedhanatthaya,1,1,0,0,15
279262,āvudhampi,avudhampi,1,1,0,0,9
279263,chupituṃ,chupitum,2,2,0,0,8
279264,āmakasusāne,amakasusane,39,39,0,0,11
279265,nikhaññamāno,nikhannamano,1,1,0,0,12
279266,cittappadosamattampi,cittappadosamattampi,1,1,0,0,20
279267,kuṇapakhādanatthaṃ,kunapakhadanattham,1,1,0,0,18
279268,paṃsuviyūhanaṃ,pamsuviyuhanam,1,1,0,0,14
279269,purisakāraṃ,purisakaram,10,8,2,0,11
279270,paṭiladdhajīvito,patiladdhajivito,1,1,0,0,16
279271,yakkhānubhāvena,yakkhanubhavena,11,11,0,0,15
279272,mittaṭṭhāne,mittatthane,1,1,0,0,11
279273,V1.0292,V1.0292,27,27,0,0,7
279274,vohamattānaṃ,vohamattanam,1,1,0,0,12
279275,khantivādījātake,khantivadijatake,2,2,0,0,16
279276,dummedhena,dummedhena,1,1,0,0,10
279277,sakaṇṭakāhi,sakantakahi,5,5,0,0,11
279278,tāḷetvā,taletva,18,17,1,0,7
279279,hatthapādesu,hatthapadesu,22,21,1,0,12
279280,kopamattampi,kopamattampi,3,3,0,0,12
279281,cūḷadhammapālajātake,culadhammapalajatake,2,1,1,0,20
279282,uttānaseyyakopi,uttanaseyyakopi,1,1,0,0,15
279283,candanarasānulittā,candanarasanulitta,1,1,0,0,18
279284,dhammapālassa,dhammapalassa,5,5,0,0,13
279285,rujjhantī,rujjhanti,3,3,0,0,9
279286,vippalapamānāya,vippalapamanaya,1,1,0,0,15
279287,mahāpatāpena,mahapatapena,1,1,0,0,12
279288,vaṃsakaḷīresu,vamsakaliresu,1,1,0,0,13
279289,chedāpitesu,chedapitesu,1,1,0,0,11
279290,tāvatāpi,tavatapi,4,4,0,0,8
279291,chindathāti,chindathati,4,3,1,0,11
279292,āṇatte,anatte,15,14,1,0,6
279293,cittapariggaṇhanakālo,cittaparigganhanakalo,1,1,0,0,21
279294,sīsacchedāṇāpake,sisacchedanapake,1,1,0,0,16
279295,sīsacchedake,sisacchedake,1,1,0,0,12
279296,paridevamānāya,paridevamanaya,4,4,0,0,14
279297,samādānamadhiṭṭhāya,samadanamadhitthaya,1,1,0,0,19
279298,paduṭṭhākāramattampi,padutthakaramattampi,2,2,0,0,20
279299,anacchariyameva,anacchariyameva,2,2,0,0,15
279300,tiracchānabhūtopi,tiracchanabhutopi,3,3,0,0,17
279301,visappitena,visappitena,1,1,0,0,11
279302,viddhopi,viddhopi,6,6,0,0,8
279303,anatthakārimhi,anatthakarimhi,2,2,0,0,14
279304,luddake,luddake,7,7,0,0,7
279305,M1.0296,M1.0296,28,28,0,0,7
279306,puthusallena,puthusallena,8,8,0,0,12
279307,kimatthayaṃ,kimatthayam,5,4,1,0,11
279308,vadhī,vadhi,15,15,0,0,5
279309,V1.0293,V1.0293,27,27,0,0,7
279310,dantānamatthāya,dantanamatthaya,1,1,0,0,15
279311,pesitomhi,pesitomhi,1,1,0,0,9
279312,bhadanteti,bhadanteti,29,14,15,0,10
279313,chabbaṇṇarasminiccharaṇasamujjalitacārusobhe,chabbannarasminiccharanasamujjalitacarusobhe,1,1,0,0,44
279314,pabbatapapātato,pabbatapapatato,1,1,0,0,15
279315,uddharitena,uddharitena,1,1,0,0,11
279316,yathevaññe,yathevanne,1,1,0,0,10
279317,yaṃnūnimaṃ,yamnunimam,6,6,0,0,10
279318,vānaraṃ,vanaram,12,11,1,0,7
279319,āhitova,ahitova,1,1,0,0,7
279320,maṃsamādāya,mamsamadaya,3,3,0,0,11
279321,nittharissāmi,nittharissami,3,3,0,0,13
279322,sampadālite,sampadalite,1,1,0,0,11
279323,ayyosi,ayyosi,2,1,1,0,6
279324,nāmetādisaṃ,nametadisam,2,1,1,0,11
279325,vāretumarahasī,varetumarahasi,1,1,0,0,14
279326,appadūsetvā,appadusetva,1,1,0,0,11
279327,bhūridatto,bhuridatto,26,25,1,0,10
279328,vammikamuddhani,vammikamuddhani,3,3,0,0,15
279329,kappuṭṭhānaggisadisena,kapputthanaggisadisena,1,1,0,0,22
279330,osadhena,osadhena,4,4,0,0,8
279331,siñciyamānopi,sinciyamanopi,1,1,0,0,13
279332,kīḷāpiyamānopi,kilapiyamanopi,1,1,0,0,14
279333,manopadosamattampi,manopadosamattampi,3,3,0,0,18
279334,pakkhipantepi,pakkhipantepi,6,6,0,0,13
279335,maddantepi,maddantepi,2,2,0,0,10
279336,alampāne,alampane,1,1,0,0,8
279337,kuppāmi,kuppami,14,14,0,0,7
279338,sīlakhaṇḍabhayā,silakhandabhaya,7,5,2,0,15
279339,campeyyopi,campeyyopi,1,0,1,0,10
279340,V1.0294,V1.0294,26,26,0,0,7
279341,ahituṇḍikena,ahitundikena,9,9,0,0,12
279342,viheṭhiyamāno,vihethiyamano,4,4,0,0,13
279343,nuppādesi,nuppadesi,1,1,0,0,9
279344,upavutthauposathaṃ,upavutthauposatham,2,2,0,0,18
279345,rājadvāramhi,rajadvaramhi,3,2,1,0,12
279346,cittānuvattanto,cittanuvattanto,2,2,0,0,15
279347,cintitasannibho,cintitasannibho,3,2,1,0,15
279348,chārikaṃ,charikam,35,32,3,0,8
279349,cittavasī,cittavasi,5,3,2,0,9
279350,parihāyissāmi,parihayissami,5,4,1,0,13
279351,parihīnassa,parihinassa,12,11,1,0,11
279352,uttamattho,uttamattho,14,10,4,0,10
279353,saṅkhapālanāgarājā,sankhapalanagaraja,7,6,1,0,18
279354,tikhiṇāhi,tikhinahi,4,4,0,0,9
279355,ovijjhitvā,ovijjhitva,3,3,0,0,10
279356,pahāramukhehi,paharamukhehi,4,4,0,0,13
279357,rajjuṃ,rajjum,88,82,6,0,6
279358,bhojaputtehi,bhojaputtehi,2,2,0,0,12
279359,vayhamāno,vayhamano,4,4,0,0,9
279360,ghaṃsiyamānasarīro,ghamsiyamanasariro,1,1,0,0,18
279361,olokitamatteneva,olokitamatteneva,2,2,0,0,16
279362,cātuddasiṃ,catuddasim,76,71,5,0,10
279363,pañcadasiñcaḷāra,pancadasincalara,1,1,0,0,16
279364,niccamupāvasāmi,niccamupavasami,3,3,0,0,15
279365,athāgamuṃ,athagamum,4,3,1,0,9
279366,bhojaputtā,bhojaputta,18,18,0,0,10
279367,V1.0295,V1.0295,26,26,0,0,7
279368,atikassa,atikassa,5,4,1,0,8
279369,samparigayha,samparigayha,3,3,0,0,12
279370,luddā,ludda,38,36,2,0,5
279371,dukkhamahaṃ,dukkhamaham,3,3,0,0,11
279372,appaṭikopayanto,appatikopayanto,3,3,0,0,15
279373,M1.0298,M1.0298,28,28,0,0,7
279374,mātuposakajātakā,matuposakajataka,1,0,1,0,16
279375,sadevaloke,sadevaloke,3,3,0,0,10
279376,appaṭisamakhantiguṇaṃ,appatisamakhantigunam,1,1,0,0,21
279377,apadisato,apadisato,1,1,0,0,9
279378,paṭighacittaṃ,patighacittam,3,3,0,0,13
279379,appatirūpanti,appatirupanti,2,2,0,0,13
279380,pubbacaritaguṇaṃ,pubbacaritagunam,1,1,0,0,16
279381,paccavekkhatopi,paccavekkhatopi,30,22,8,0,15
279382,dhītābhūtapubbā,dhitabhutapubba,1,1,0,0,15
279383,muttakarīsakheḷasiṅghāṇikādīni,muttakarisakhelasinghanikadini,1,1,0,0,30
279384,ajigucchamānā,ajigucchamana,1,1,0,0,13
279385,naccāpentī,naccapenti,1,1,0,0,10
279386,pariharamānā,pariharamana,7,7,0,0,12
279387,ajapathasaṅkupathādīni,ajapathasankupathadini,4,4,0,0,22
279388,mayhamatthāya,mayhamatthaya,1,1,0,0,13
279389,ubhatobyūḷhe,ubhatobyulhe,2,2,0,0,12
279390,posessāmī,posessami,17,17,0,0,9
279391,idañcidañcupakāraṃ,idancidancupakaram,1,1,0,0,18
279392,padūsetuṃ,padusetum,2,1,1,0,9
279393,mettānisaṃsā,mettanisamsa,11,10,1,0,12
279394,V1.0296,V1.0296,25,25,0,0,7
279395,āsevitāya,asevitaya,15,15,0,0,9
279396,yānīkatāya,yanikataya,24,24,0,0,10
279397,vatthukatāya,vatthukataya,24,24,0,0,12
279398,anuṭṭhitāya,anutthitaya,24,24,0,0,11
279399,paricitāya,paricitaya,24,24,0,0,10
279400,susamāraddhāya,susamaraddhaya,25,25,0,0,14
279401,ekādasānisaṃsā,ekadasanisamsa,13,13,0,0,14
279402,M1.0299,M1.0299,28,28,0,0,7
279403,mukhavaṇṇo,mukhavanno,45,40,5,0,10
279404,uttarimappaṭivijjhanto,uttarimappativijjhanto,1,1,0,0,22
279405,nibbāpessasi,nibbapessasi,1,1,0,0,12
279406,ānisaṃsehi,anisamsehi,8,8,0,0,10
279407,dhātuvinibbhogo,dhatuvinibbhogo,1,0,1,0,15
279408,kujjhamāno,kujjhamano,1,1,0,0,10
279409,itthannāmoti,itthannamoti,5,3,2,0,12
279410,saṅkhāraviññāṇakkhandhassa,sankharavinnanakkhandhassa,1,1,0,0,26
279411,cakkhāyatanassa,cakkhayatanassa,23,22,1,0,15
279412,dhammāyatanassa,dhammayatanassa,8,8,0,0,15
279413,dhātuvinibbhogaṃ,dhatuvinibbhogam,2,2,0,0,16
279414,sāsapassa,sasapassa,6,6,0,0,9
279415,dānasaṃvibhāgo,danasamvibhago,4,3,1,0,14
279416,bhinnājīvo,bhinnajivo,4,4,0,0,10
279417,aparibhogārahaparikkhāro,aparibhogarahaparikkharo,1,1,0,0,24
279418,atītajātito,atitajatito,1,1,0,0,11
279419,anubandhopi,anubandhopi,2,2,0,0,11
279420,cittalapabbatavihāre,cittalapabbatavihare,5,5,0,0,20
279421,vuṭṭhāpitasenāsanena,vutthapitasenasanena,1,1,0,0,20
279422,piṇḍapātikattherena,pindapatikattherena,1,1,0,0,19
279423,M1.0300,M1.0300,28,28,0,0,7
279424,aṭṭhakahāpaṇagghanako,atthakahapanagghanako,1,1,0,0,21
279425,dhammiyalābho,dhammiyalabho,2,1,1,0,13
279426,mahāupāsikāya,mahaupasikaya,26,26,0,0,13
279427,V1.0297,V1.0297,25,25,0,0,7
279428,puññalābhaṃ,punnalabham,1,1,0,0,11
279429,laddhamahātherassa,laddhamahatherassa,1,1,0,0,18
279430,mahānubhāvametaṃ,mahanubhavametam,1,1,0,0,16
279431,vūpasantapaṭighassa,vupasantapatighassa,1,1,0,0,19
279432,piyātippiyasahāyakamajjhattesu,piyatippiyasahayakamajjhattesu,1,1,0,0,30
279433,mettāvasena,mettavasena,18,18,0,0,11
279434,samacittataṃ,samacittatam,4,3,1,0,12
279435,sampādentena,sampadentena,10,10,0,0,12
279436,piyamajjhattaverīhi,piyamajjhattaverihi,1,1,0,0,19
279437,attacatutthe,attacatutthe,2,2,0,0,12
279438,balikaraṇatthāyā,balikaranatthaya,1,1,0,0,16
279439,akatova,akatova,2,2,0,0,7
279440,gahaṇamicchati,gahanamicchati,1,1,0,0,14
279441,ahitesī,ahitesi,1,1,0,0,7
279442,janānamantare,jananamantare,1,1,0,0,13
279443,hitamajjhatte,hitamajjhatte,1,1,0,0,13
279444,hitacittova,hitacittova,3,2,1,0,11
279445,kusalīti,kusaliti,5,2,3,0,8
279446,sambhinnā,sambhinna,17,16,1,0,9
279447,mahāviseso,mahaviseso,3,3,0,0,10
279448,M1.0301,M1.0301,28,28,0,0,7
279449,V1.0298,V1.0298,25,25,0,0,7
279450,sīmāsambhedasamakālameva,simasambhedasamakalameva,1,1,0,0,24
279451,sīmāsambhede,simasambhede,5,5,0,0,12
279452,āsevanto,asevanto,15,15,0,0,8
279453,bahulīkaronto,bahulikaronto,122,122,0,0,13
279454,ettāvatānena,ettavatanena,10,9,1,0,12
279455,dutiyatatiyajjhānāni,dutiyatatiyajjhanani,5,5,0,0,20
279456,dutiyatatiyacatutthajjhānāni,dutiyatatiyacatutthajjhanani,8,8,0,0,28
279457,appanāppattacittasseva,appanappattacittasseva,5,4,1,0,22
279458,mettāsahagatenāti,mettasahagatenati,7,1,6,0,17
279459,ekamekissā,ekamekissa,11,11,0,0,10
279460,paṭhamapariggahitaṃ,pathamapariggahitam,5,4,1,0,19
279461,ekadisāpariyāpannasattapharaṇavasena,ekadisapariyapannasattapharanavasena,4,3,1,0,36
279462,brahmavihārādhiṭṭhitaṃ,brahmaviharadhitthitam,5,4,1,0,22
279463,iriyāpathavihāraṃ,iriyapathaviharam,6,6,0,0,17
279464,puratthimādīsu,puratthimadisu,16,16,0,0,14
279465,catutthañcāti,catutthancati,7,4,3,0,13
279466,adhodisampi,adhodisampi,5,4,1,0,11
279467,tiriyaṃdisampi,tiriyamdisampi,2,2,0,0,14
279468,anudisāsu,anudisasu,3,3,0,0,9
279469,assamaṇḍale,assamandale,5,5,0,0,11
279470,assamiva,assamiva,4,4,0,0,8
279471,sāretipi,saretipi,6,6,0,0,8
279472,paccāsāretipīti,paccasaretipiti,4,4,0,0,15
279473,mettāpharaṇaṃ,mettapharanam,10,9,1,0,13
279474,sabbadhītiādi,sabbadhitiadi,5,0,5,0,13
279475,sabbattatāyāti,sabbattatayati,11,1,10,0,14
279476,hīnamajjhimukkaṭṭhamittasapattamajjhattādippabhedesu,hinamajjhimukkatthamittasapattamajjhattadippabhedesu,4,4,0,0,52
279477,attatāya,attataya,5,5,0,0,8
279478,M1.0302,M1.0302,28,28,0,0,7
279479,parasatto,parasatto,12,12,0,0,9
279480,attasamatāyāti,attasamatayati,5,5,0,0,14
279481,cittabhāgena,cittabhagena,1,1,0,0,12
279482,V1.0299,V1.0299,25,25,0,0,7
279483,avikkhipamānoti,avikkhipamanoti,5,4,1,0,15
279484,vipulenā,vipulena,9,6,3,0,8
279485,tievamādipariyāyadassanato,tievamadipariyayadassanato,2,2,0,0,26
279486,nigamavasena,nigamavasena,7,7,0,0,12
279487,vipulatā,vipulata,14,13,1,0,8
279488,paguṇavasena,pagunavasena,9,9,0,0,12
279489,appamāṇasattārammaṇavasena,appamanasattarammanavasena,4,4,0,0,26
279490,byāpādapaccatthikappahānena,byapadapaccatthikappahanena,6,6,0,0,27
279491,averaṃ,averam,54,41,13,0,6
279492,domanassappahānato,domanassappahanato,5,4,1,0,18
279493,niddukkhanti,niddukkhanti,5,5,0,0,12
279494,cetasātiādinā,cetasatiadina,1,1,0,0,13
279495,vikubbanāya,vikubbanaya,4,3,1,0,11
279496,mettācetovimutti,mettacetovimutti,145,143,2,0,16
279497,odhisopharaṇā,odhisopharana,6,4,2,0,13
279498,disāpharaṇā,disapharana,10,9,1,0,11
279499,cetovimuttī,cetovimutti,26,21,5,0,11
279500,pariharantūti,pariharantuti,12,11,1,0,13
279501,V1.0300,V1.0300,25,25,0,0,7
279502,anavasesapariyādānametaṃ,anavasesapariyadanametam,6,5,1,0,24
279503,chandarāgena,chandaragena,29,29,0,0,12
279504,visattāti,visattati,8,6,2,0,9
279505,ruḷhīsaddena,rulhisaddena,19,19,0,0,12
279506,vītarāgesupi,vitaragesupi,3,3,0,0,12
279507,vilīvamayepi,vilivamayepi,2,2,0,0,12
279508,bījanivisese,bijanivisese,2,2,0,0,12
279509,tālavaṇṭavohāro,talavantavoharo,4,4,0,0,15
279510,nāmamattametanti,namamattametanti,1,1,0,0,16
279511,vicārenti,vicarenti,19,19,0,0,9
279512,satvayogena,satvayogena,3,3,0,0,11
279513,pāṇanatāya,pananataya,2,2,0,0,10
279514,assāsapassāsāyattavuttitāyāti,assasapassasayattavuttitayati,2,2,0,0,29
279515,saṃbhūtattā,sambhutatta,1,1,0,0,11
279516,abhinibbattattāti,abhinibbattattati,2,2,0,0,17
279517,galantīti,galantiti,1,1,0,0,9
279518,tamupādāya,tamupadaya,5,5,0,0,10
279519,paññattimattasambhavato,pannattimattasambhavato,2,2,0,0,23
279520,sabbasattavevacanānīti,sabbasattavevacananiti,2,2,0,0,22
279521,jīvātiādīni,jivatiadini,1,1,0,0,11
279522,sabbasattavevacanāni,sabbasattavevacanani,2,2,0,0,20
279523,pāṇātiādīnaṃ,panatiadinam,1,1,0,0,12
279524,vacanamattatova,vacanamattatova,2,2,0,0,15
279525,nānattameva,nanattameva,3,3,0,0,11
279526,V1.0301,V1.0301,25,25,0,0,7
279527,iccheyyuṃ,iccheyyum,5,5,0,0,9
279528,pharitabbā,pharitabba,8,8,0,0,10
279529,ayamekā,ayameka,17,17,0,0,7
279530,byāpādarahitā,byapadarahita,2,2,0,0,13
279531,anīghāti,anighati,4,0,4,0,8
279532,appanānaṃ,appananam,2,2,0,0,9
279533,anodhisopharaṇe,anodhisopharane,2,1,1,0,15
279534,odhisopharaṇe,odhisopharane,2,1,1,0,13
279535,vinipātikāti,vinipatikati,18,6,12,0,12
279536,upapattivasena,upapattivasena,21,19,2,0,14
279537,disāpharaṇe,disapharane,3,2,1,0,11
279538,sattātiādinā,sattatiadina,2,1,1,0,12
279539,dvesatāni,dvesatani,13,13,0,0,9
279540,itthiyotiādinā,itthiyotiadina,1,1,0,0,14
279541,dvesatānīti,dvesataniti,1,1,0,0,11
279542,aṭṭhavīsādhikāni,atthavisadhikani,3,3,0,0,16
279543,appanāsatānīti,appanasataniti,1,1,0,0,14
279544,appanāsu,appanasu,1,1,0,0,8
279545,supatī,supati,10,10,0,0,6
279546,ekādasānisaṃse,ekadasanisamse,4,4,0,0,14
279547,samparivattamānā,samparivattamana,5,5,0,0,16
279548,kākacchamānā,kakacchamana,10,10,0,0,12
279549,asupitvā,asupitva,6,4,2,0,8
279550,okkantopi,okkantopi,4,4,0,0,9
279551,paṭibujjhatīti,patibujjhatiti,8,1,7,0,14
279552,nitthunantā,nitthunanta,7,5,2,0,11
279553,vijambhantā,vijambhanta,5,3,2,0,11
279554,samparivattantā,samparivattanta,6,4,2,0,15
279555,paṭibujjhanti,patibujjhanti,5,5,0,0,13
279556,appaṭibujjhitvā,appatibujjhitva,5,3,2,0,15
279557,vikasamānamiva,vikasamanamiva,7,7,0,0,14
279558,V1.0302,V1.0302,25,25,0,0,7
279559,bhaddakameva,bhaddakameva,14,12,2,0,12
279560,samparivāritaṃ,samparivaritam,8,8,0,0,14
279561,āmuttamuttāhāro,amuttamuttaharo,3,2,1,0,15
279562,piḷandhamālā,pilandhamala,3,3,0,0,12
279563,amanussānampi,amanussanampi,5,5,0,0,13
279564,visākhatthero,visakhatthero,4,3,1,0,13
279565,kuṭumbiyo,kutumbiyo,5,5,0,0,9
279566,tambapaṇṇidīpo,tambapannidipo,4,3,1,0,14
279567,cetiyamālālaṅkato,cetiyamalalankato,2,2,0,0,17
279568,icchiticchitaṭṭhāneyeva,icchiticchitatthaneyeva,1,1,0,0,23
279569,senāsanasappāyaṃ,senasanasappayam,7,7,0,0,16
279570,puggalasappāyaṃ,puggalasappayam,12,12,0,0,15
279571,dhammassavanasappāyanti,dhammassavanasappayanti,3,3,0,0,23
279572,sabbamettha,sabbamettha,15,12,3,0,11
279573,dussante,dussante,24,24,0,0,8
279574,baddhena,baddhena,10,10,0,0,8
279575,ekakahāpaṇeneva,ekakahapaneneva,2,2,0,0,15
279576,tenevantaramāsena,tenevantaramasena,2,2,0,0,17
279577,abhisaṃhari,abhisamhari,2,2,0,0,11
279578,pabbājanatthāya,pabbajanatthaya,2,2,0,0,15
279579,ovaṭṭikantarena,ovattikantarena,2,2,0,0,15
279580,idānevetaṃ,idanevetam,3,3,0,0,10
279581,vicārehī,vicarehi,2,2,0,0,8
279582,visākhassa,visakhassa,5,5,0,0,10
279583,pabbajjaṭṭhānamāgatā,pabbajjatthanamagata,1,1,0,0,20
279584,gamiṃsū,gamimsu,8,8,0,0,7
279585,sīmāmāḷake,simamalake,12,11,1,0,10
279586,pañcavasso,pancavasso,28,25,3,0,10
279587,dvemātikā,dvematika,6,6,0,0,9
279588,V1.0303,V1.0303,24,24,0,0,7
279589,samappavattavāsaṃ,samappavattavasam,4,3,1,0,17
279590,vanantare,vanantare,18,16,2,0,9
279591,gajjamānako,gajjamanako,2,2,0,0,11
279592,guṇamesanto,gunamesanto,2,2,0,0,11
279593,caṅkamasīse,cankamasise,2,2,0,0,11
279594,maṇilarukkhe,manilarukkhe,3,3,0,0,12
279595,maṇiliyāti,maniliyati,2,2,0,0,10
279596,duṭṭhullampi,dutthullampi,4,4,0,0,12
279597,kathayissantīti,kathayissantiti,3,2,1,0,15
279598,gamanacittaṃ,gamanacittam,8,8,0,0,12
279599,mettāvihārissa,mettaviharissa,13,11,2,0,14
279600,saṃyuttabhāṇakacūḷasivattherasseva,samyuttabhanakaculasivattherasseva,1,1,0,0,34
279601,saṃkiccasāmaṇerasseva,samkiccasamanerasseva,3,3,0,0,21
279602,vikopetīti,vikopetiti,11,5,6,0,10
279603,dhenuvatthumpi,dhenuvatthumpi,3,3,0,0,14
279604,V1.0304,V1.0304,24,24,0,0,7
279605,vacchakassa,vacchakassa,12,12,0,0,11
279606,samparivattetvā,samparivattetva,14,14,0,0,15
279607,dīghadaṇḍasattiṃ,dighadandasattim,1,1,0,0,16
279608,pavaṭṭamānā,pavattamana,6,6,0,0,11
279609,upacārabalena,upacarabalena,3,3,0,0,13
279610,appanābalena,appanabalena,3,3,0,0,12
279611,vacchake,vacchake,7,7,0,0,8
279612,balavapiyacittatāya,balavapiyacittataya,1,1,0,0,19
279613,mettāvihārino,mettaviharino,13,12,1,0,13
279614,vippasīdatīti,vippasidatiti,7,1,6,0,13
279615,tālapakkaṃ,talapakkam,9,8,1,0,10
279616,vippasannavaṇṇaṃ,vippasannavannam,5,5,0,0,16
279617,kālaṅkarotīti,kalankarotiti,3,0,3,0,13
279618,sammohamaraṇaṃ,sammohamaranam,8,8,0,0,14
279619,asammūḷhova,asammulhova,2,2,0,0,11
279620,okkamanto,okkamanto,25,23,2,0,9
279621,uttarimappaṭivijjhantoti,uttarimappativijjhantoti,2,0,2,0,24
279622,mettāsamāpattito,mettasamapattito,3,3,0,0,16
279623,brahmalokamupapajjatīti,brahmalokamupapajjatiti,1,1,0,0,23
279624,mettābhāvanāyaṃ,mettabhavanayam,3,2,1,0,15
279625,karuṇābhāvanākathā,karunabhavanakatha,1,1,0,0,18
279626,nikkaruṇatāya,nikkarunataya,4,3,1,0,13
279627,karuṇābhāvanā,karunabhavana,5,4,1,0,13
279628,piyapuggalādīsu,piyapuggaladisu,5,5,0,0,15
279629,piyaṭṭhāneyeva,piyatthaneyeva,2,1,1,0,14
279630,atippiyasahāyako,atippiyasahayako,3,3,0,0,16
279631,atippiyasahāyakaṭṭhāneyeva,atippiyasahayakatthaneyeva,1,1,0,0,26
279632,majjhattaṭṭhāneyeva,majjhattatthaneyeva,1,1,0,0,19
279633,appiyaṭṭhāneyeva,appiyatthaneyeva,1,1,0,0,16
279634,veriṭṭhāneyeva,veritthaneyeva,1,1,0,0,14
279635,liṅgavisabhāgakālakatā,lingavisabhagakalakata,2,2,0,0,22
279636,akhettameva,akhettameva,2,2,0,0,11
279637,karuṇāsahagatena,karunasahagatena,55,55,0,0,16
279638,karuṇāyeyya,karunayeyya,2,2,0,0,11
279639,V1.0305,V1.0305,24,24,0,0,7
279640,karuṇāyitabbarūpaṃ,karunayitabbarupam,1,1,0,0,18
279641,paramakicchappattaṃ,paramakicchappattam,2,1,1,0,19
279642,kapaṇapurisaṃ,kapanapurisam,1,1,0,0,13
279643,chinnāhāraṃ,chinnaharam,1,1,0,0,11
279644,anāthasālāya,anathasalaya,3,3,0,0,12
279645,paggharantakimigaṇaṃ,paggharantakimiganam,1,1,0,0,20
279646,mucceyyā,mucceyya,10,10,0,0,8
279647,upametvā,upametva,10,10,0,0,8
279648,gahitacoraṃ,gahitacoram,1,1,0,0,11
279649,vadhetha,vadhetha,3,2,1,0,8
279650,pahārasatāni,paharasatani,1,1,0,0,12
279651,mālāgandhavilepanatambulānipi,malagandhavilepanatambulanipi,1,1,0,0,29
279652,varāko,varako,14,13,1,0,6
279653,karuṇākammaṭṭhānikena,karunakammatthanikena,1,1,0,0,21
279654,susajjito,susajjito,2,2,0,0,9
279655,kalyāṇakammassa,kalyanakammassa,11,11,0,0,15
279656,paṭisaṃvedissatī,patisamvedissati,2,2,0,0,16
279657,karuṇāyitvā,karunayitva,2,2,0,0,11
279658,verimhīti,verimhiti,4,4,0,0,9
279659,katakusalo,katakusalo,13,12,1,0,10
279660,ñātirogabhogabyasanādīnaṃ,natirogabhogabyasanadinam,1,1,0,0,25
279661,āsevantena,asevantena,2,2,0,0,10
279662,bahulīkarontena,bahulikarontena,2,2,0,0,15
279663,tikacatukkajjhānavasena,tikacatukkajjhanavasena,13,12,1,0,23
279664,vaḍḍhetabbā,vaddhetabba,16,15,1,0,11
279665,V1.0306,V1.0306,24,24,0,0,7
279666,vuttanayenevettha,vuttanayenevettha,28,28,0,0,17
279667,bhāvanamārabhitvā,bhavanamarabhitva,1,1,0,0,17
279668,karuṇābhāvanāya,karunabhavanaya,4,4,0,0,15
279669,muditābhāvanākathā,muditabhavanakatha,1,1,0,0,18
279670,muditābhāvanaṃ,muditabhavanam,1,1,0,0,14
279671,ārabhantenāpi,arabhantenapi,2,2,0,0,13
279672,piyabhāvamatteneva,piyabhavamatteneva,1,1,0,0,18
279673,majjhattaverino,majjhattaverino,2,1,1,0,15
279674,soṇḍasahāyoti,sondasahayoti,1,1,0,0,13
279675,muditamuditova,muditamuditova,1,1,0,0,14
279676,hasitvā,hasitva,17,17,0,0,7
279677,pharitabbo,pharitabbo,6,6,0,0,10
279678,piyapuggalaṃ,piyapuggalam,6,5,1,0,12
279679,modamānaṃ,modamanam,1,1,0,0,9
279680,muditāsahagatena,muditasahagatena,51,51,0,0,16
279681,sacepissa,sacepissa,44,43,1,0,9
279682,soṇḍasahāyo,sondasahayo,2,1,1,0,11
279683,durūpeto,durupeto,2,2,0,0,8
279684,sukhitabhāvaṃ,sukhitabhavam,4,4,0,0,13
279685,niccappamudito,niccappamudito,1,1,0,0,14
279686,tamevassa,tamevassa,14,14,0,0,9
279687,muditākāraṃ,muditakaram,2,2,0,0,11
279688,M1.0310,M1.0310,28,28,0,0,7
279689,hatthikkhandhaassapiṭṭhisuvaṇṇasivikādīhi,hatthikkhandhaassapitthisuvannasivikadihi,1,1,0,0,41
279690,vicarissatī,vicarissati,12,12,0,0,11
279691,anāgatampissa,anagatampissa,1,1,0,0,13
279692,V1.0307,V1.0307,23,23,0,0,7
279693,tikacatukkajjhānavaseneva,tikacatukkajjhanavaseneva,2,2,0,0,25
279694,muditābhāvanāya,muditabhavanaya,2,2,0,0,15
279695,upekkhābhāvanākathā,upekkhabhavanakatha,1,1,0,0,19
279696,upekkhābhāvanaṃ,upekkhabhavanam,2,1,1,0,15
279697,mettādīsu,mettadisu,5,4,1,0,9
279698,paṭiladdhatikacatukkajjhānena,patiladdhatikacatukkajjhanena,1,1,0,0,29
279699,paguṇatatiyajjhānā,pagunatatiyajjhana,2,2,0,0,18
279700,hontū,hontu,90,86,4,0,5
279701,itiādivasena,itiadivasena,41,41,0,0,12
279702,sattakelāyanamanasikārayuttattā,sattakelayanamanasikarayuttatta,1,1,0,0,31
279703,paṭighānunayasamīpacārittā,patighanunayasamipacaritta,1,1,0,0,26
279704,somanassayogena,somanassayogena,2,1,1,0,15
279705,pakatimajjhatto,pakatimajjhatto,2,2,0,0,15
279706,majjhattapuggale,majjhattapuggale,2,2,0,0,16
279707,soṇḍasahāyake,sondasahayake,1,1,0,0,13
279708,majjhattavasena,majjhattavasena,1,1,0,0,15
279709,āsevitabbaṃ,asevitabbam,14,13,1,0,11
279710,bahulīkātabbaṃ,bahulikatabbam,15,15,0,0,14
279711,pathavīkasiṇādīsu,pathavikasinadisu,35,33,2,0,17
279712,uppannatatiyajjhānassāpi,uppannatatiyajjhanassapi,1,1,0,0,24
279713,ārammaṇavisabhāgatāya,arammanavisabhagataya,1,1,0,0,21
279714,uppannatatiyajjhānasseva,uppannatatiyajjhanasseva,1,1,0,0,24
279715,ārammaṇasabhāgatāyāti,arammanasabhagatayati,3,1,2,0,21
279716,ānisaṃsapaṭilābho,anisamsapatilabho,1,1,0,0,17
279717,V1.0308,V1.0308,23,23,0,0,7
279718,upekkhābhāvanāya,upekkhabhavanaya,1,1,0,0,16
279719,brahmuttamena,brahmuttamena,2,2,0,0,13
279720,mettākaruṇāmuditāupekkhāsu,mettakarunamuditaupekkhasu,2,2,0,0,26
279721,mejjatīti,mejjatiti,5,4,1,0,9
279722,pavattītipi,pavattitipi,4,4,0,0,11
279723,kiriyati,kiriyati,5,5,0,0,8
279724,pasāriyatīti,pasariyatiti,7,6,1,0,12
279725,modanamattameva,modanamattameva,6,5,1,0,15
279726,itiādibyāpārappahānena,itiadibyaparappahanena,3,3,0,0,22
279727,majjhattabhāvūpagamanena,majjhattabhavupagamanena,4,4,0,0,24
279728,hitākārappavattilakkhaṇā,hitakarappavattilakkhana,11,11,0,0,24
279729,hitūpasaṃhārarasā,hitupasamhararasa,8,8,0,0,17
279730,āghātavinayapaccupaṭṭhānā,aghatavinayapaccupatthana,7,6,1,0,25
279731,manāpabhāvadassanapadaṭṭhānā,manapabhavadassanapadatthana,10,9,1,0,28
279732,byāpādūpasamo,byapadupasamo,5,5,0,0,13
279733,sinehasambhavo,sinehasambhavo,4,4,0,0,14
279734,dukkhāpanayanākārappavattilakkhaṇā,dukkhapanayanakarappavattilakkhana,6,5,1,0,34
279735,paradukkhāsahanarasā,paradukkhasahanarasa,5,5,0,0,20
279736,avihiṃsāpaccupaṭṭhānā,avihimsapaccupatthana,7,5,2,0,21
279737,anāthabhāvadassanapadaṭṭhānā,anathabhavadassanapadatthana,7,7,0,0,28
279738,vihiṃsūpasamo,vihimsupasamo,3,3,0,0,13
279739,sokasambhavo,sokasambhavo,5,4,1,0,12
279740,pamodanalakkhaṇā,pamodanalakkhana,7,7,0,0,16
279741,anissāyanarasā,anissayanarasa,5,5,0,0,14
279742,arativighātapaccupaṭṭhānā,arativighatapaccupatthana,7,5,2,0,25
279743,sampattidassanapadaṭṭhānā,sampattidassanapadatthana,5,5,0,0,25
279744,arativūpasamo,arativupasamo,3,3,0,0,13
279745,pahāsasambhavo,pahasasambhavo,2,2,0,0,14
279746,majjhattākārappavattilakkhaṇā,majjhattakarappavattilakkhana,9,9,0,0,29
279747,samabhāvadassanarasā,samabhavadassanarasa,6,6,0,0,20
279748,paṭighānunayavūpasamapaccupaṭṭhānā,patighanunayavupasamapaccupatthana,7,6,1,0,34
279749,pattasampattito,pattasampattito,3,3,0,0,15
279750,parihāyissantī,parihayissanti,5,5,0,0,14
279751,pavattakammassakatādassanapadaṭṭhānā,pavattakammassakatadassanapadatthana,3,3,0,0,36
279752,paṭighānunayavūpasamo,patighanunayavupasamo,3,3,0,0,21
279753,gehasitāya,gehasitaya,2,2,0,0,10
279754,vipassanāsukhañceva,vipassanasukhanceva,3,2,1,0,19
279755,sādhāraṇappayojanaṃ,sadharanappayojanam,2,1,1,0,19
279756,V1.0309,V1.0309,23,23,0,0,7
279757,byāpādādipaṭighāto,byapadadipatighato,2,2,0,0,18
279758,byāpādapaṭighātappayojanā,byapadapatighatappayojana,2,2,0,0,25
279759,vihiṃsāaratirāgapaṭighātappayojanā,vihimsaaratiragapatighatappayojana,2,2,0,0,34
279760,vihesāya,vihesaya,33,32,1,0,8
279761,āsannadūravasena,asannaduravasena,2,2,0,0,16
279762,mettābrahmavihārassa,mettabrahmaviharassa,3,2,1,0,20
279763,samīpacāro,samipacaro,4,3,1,0,10
279764,guṇadassanasabhāgatāya,gunadassanasabhagataya,2,2,0,0,22
279765,āsannapaccatthiko,asannapaccatthiko,5,4,1,0,17
279766,rakkhitabbā,rakkhitabba,16,14,2,0,11
279767,pabbatādigahananissito,pabbatadigahananissito,2,2,0,0,22
279768,sabhāgavisabhāgatāya,sabhagavisabhagataya,7,7,0,0,20
279769,dūrapaccatthiko,durapaccatthiko,3,3,0,0,15
279770,nibbhayena,nibbhayena,11,11,0,0,10
279771,mettāyitabbaṃ,mettayitabbam,4,4,0,0,13
279772,mettāyissati,mettayissati,2,2,0,0,12
279773,karuṇābrahmavihārassa,karunabrahmaviharassa,4,3,1,0,21
279774,cakkhuviññeyyānaṃ,cakkhuvinneyyanam,12,12,0,0,17
279775,iṭṭhānaṃ,itthanam,30,26,4,0,8
279776,manoramānaṃ,manoramanam,15,11,4,0,11
279777,lokāmisapaṭisaṃyuttānaṃ,lokamisapatisamyuttanam,14,10,4,0,23
279778,appaṭilābhaṃ,appatilabham,6,6,0,0,12
279779,appaṭilābhato,appatilabhato,8,6,2,0,13
279780,paṭiladdhapubbaṃ,patiladdhapubbam,9,9,0,0,16
279781,vipariṇataṃ,viparinatam,87,74,13,0,11
279782,gehasitaṃ,gehasitam,24,20,4,0,9
279783,vipattidassanasabhāgatāya,vipattidassanasabhagataya,2,2,0,0,25
279784,āsannapaccatthikaṃ,asannapaccatthikam,4,4,0,0,18
279785,dūrapaccatthikā,durapaccatthika,9,9,0,0,15
279786,M1.0313,M1.0313,28,28,0,0,7
279787,karuṇāyitabbaṃ,karunayitabbam,2,2,0,0,14
279788,pāṇiādīhi,paniadihi,9,9,0,0,9
279789,viheṭhissatīti,vihethissatiti,1,1,0,0,14
279790,muditābrahmavihārassa,muditabrahmaviharassa,2,1,1,0,21
279791,sampattidassanasabhāgatāya,sampattidassanasabhagataya,2,2,0,0,26
279792,V1.0310,V1.0310,23,23,0,0,7
279793,pantasenāsanesu,pantasenasanesu,19,19,0,0,15
279794,ukkaṇṭhissatīti,ukkanthissatiti,2,2,0,0,15
279795,upekkhābrahmavihārassa,upekkhabrahmaviharassa,8,7,1,0,22
279796,anodhijinassa,anodhijinassa,10,6,4,0,13
279797,avipākajinassa,avipakajinassa,10,6,4,0,14
279798,gehasitāti,gehasitati,5,3,2,0,10
279799,gehasitā,gehasita,37,35,2,0,8
279800,aññāṇupekkhā,annanupekkha,14,9,5,0,12
279801,dosaguṇāvicāraṇavasena,dosagunavicaranavasena,3,2,1,0,22
279802,sabhāgattā,sabhagatta,11,11,0,0,10
279803,āsannapaccatthikā,asannapaccatthika,3,3,0,0,17
279804,rāgapaṭighā,ragapatigha,3,3,0,0,11
279805,upekkhitabbaṃ,upekkhitabbam,2,2,0,0,13
279806,upekkhissati,upekkhissati,2,2,0,0,12
279807,rajjissati,rajjissati,2,2,0,0,10
279808,paṭihaññissati,patihannissati,27,26,1,0,14
279809,nīvaraṇādivikkhambhanaṃ,nivaranadivikkhambhanam,2,2,0,0,23
279810,paññattidhammavasena,pannattidhammavasena,4,3,1,0,20
279811,ārammaṇavaḍḍhanaṃ,arammanavaddhanam,3,2,1,0,17
279812,vaḍḍhanakkamo,vaddhanakkamo,3,3,0,0,13
279813,ekamāvāsaṃ,ekamavasam,2,1,1,0,10
279814,paricchinditabbā,paricchinditabba,14,14,0,0,16
279815,upaḍḍhagāmo,upaddhagamo,2,2,0,0,11
279816,M1.0314,M1.0314,28,28,0,0,7
279817,karuṇādayoti,karunadayoti,2,2,0,0,12
279818,ārammaṇavaḍḍhanakkamo,arammanavaddhanakkamo,2,2,0,0,21
279819,kasiṇānaṃ,kasinanam,12,11,1,0,9
279820,samādhinissando,samadhinissando,3,2,1,0,15
279821,vipassanānissando,vipassananissando,6,5,1,0,17
279822,samathavipassanānissando,samathavipassananissando,3,2,1,0,24
279823,purimabrahmavihārattayanissando,purimabrahmaviharattayanissando,3,2,1,0,31
279824,anussāpetvā,anussapetva,2,2,0,0,11
279825,tulāsaṅghāṭaṃ,tulasanghatam,2,2,0,0,13
279826,anāropetvā,anaropetva,32,32,0,0,10
279827,kūṭagopānasiyo,kutagopanasiyo,2,2,0,0,14
279828,bhāvetunti,bhavetunti,1,1,0,0,10
279829,V1.0311,V1.0311,22,22,0,0,7
279830,mettākaruṇāmuditāupekkhā,mettakarunamuditaupekkha,1,1,0,0,24
279831,brahmavihārāti,brahmaviharati,5,5,0,0,14
279832,catassova,catassova,26,26,0,0,9
279833,brahmavihāratā,brahmaviharata,6,6,0,0,14
279834,sammāpaṭipattibhāvena,sammapatipattibhavena,2,2,0,0,21
279835,niddosacittā,niddosacitta,5,4,1,0,12
279836,brahmasamā,brahmasama,2,2,0,0,10
279837,catassovātiādi,catassovatiadi,1,1,0,0,14
279838,visuddhimaggādivasā,visuddhimaggadivasa,7,7,0,0,19
279839,hitādiākāravasā,hitadiakaravasa,6,6,0,0,15
279840,panāsaṃ,panasam,7,7,0,0,7
279841,appamāṇe,appamane,47,45,2,0,8
279842,tadappamaññā,tadappamanna,2,2,0,0,12
279843,byāpādabahulassa,byapadabahulassa,3,3,0,0,16
279844,vihesābahulassa,vihesabahulassa,1,1,0,0,15
279845,aratibahulassa,aratibahulassa,2,2,0,0,14
279846,rāgabahulassa,ragabahulassa,7,7,0,0,13
279847,hitūpasaṃhāraahitāpanayanasampattimodanaanābhogavasena,hitupasamharaahitapanayanasampattimodanaanabhogavasena,2,2,0,0,54
279848,catubbidhoyeva,catubbidhoyeva,2,2,0,0,14
279849,daharagilānayobbanappattasakiccapasutesu,daharagilanayobbanappattasakiccapasutesu,2,2,0,0,40
279850,abhivuḍḍhikāmā,abhivuddhikama,2,2,0,0,14
279851,gelaññāpanayanakāmā,gelannapanayanakama,2,2,0,0,19
279852,yobbanappattassa,yobbanappattassa,3,3,0,0,16
279853,yobbanasampattiyā,yobbanasampattiya,2,2,0,0,17
279854,ciraṭṭhitikāmā,ciratthitikama,2,2,0,0,14
279855,sakakiccapasutassa,sakakiccapasutassa,1,1,0,0,18
279856,abyāvaṭā,abyavata,15,15,0,0,8
279857,appamaññāvihārikenāpi,appamannaviharikenapi,2,2,0,0,21
279858,mettādivasena,mettadivasena,16,16,0,0,13
279859,M1.0315,M1.0315,27,27,0,0,7
279860,catassopetā,catassopeta,4,4,0,0,11
279861,hitākārappavattivasena,hitakarappavattivasena,2,2,0,0,22
279862,patthitahitānaṃ,patthitahitanam,5,4,1,0,15
279863,dukkhābhibhavaṃ,dukkhabhibhavam,2,2,0,0,15
279864,dukkhāpanayanākārappavattivasena,dukkhapanayanakarappavattivasena,2,2,0,0,32
279865,patthitadukkhāpagamānañca,patthitadukkhapagamananca,2,2,0,0,25
279866,sampattipamodanavasena,sampattipamodanavasena,1,1,0,0,22
279867,ajjhupekkhakattasaṅkhātena,ajjhupekkhakattasankhatena,1,1,0,0,26
279868,majjhattākārena,majjhattakarena,8,8,0,0,15
279869,V1.0312,V1.0312,21,21,0,0,7
279870,gocarabhūtā,gocarabhuta,9,9,0,0,11
279871,ekasattassāpi,ekasattassapi,2,2,0,0,13
279872,sakalapharaṇavaseneva,sakalapharanavaseneva,2,2,0,0,21
279873,tadappamaññāti,tadappamannati,2,2,0,0,14
279874,appamāṇagocaratāya,appamanagocarataya,4,4,0,0,18
279875,ekalakkhaṇāsu,ekalakkhanasu,2,2,0,0,13
279876,tikacatukkajjhānikāva,tikacatukkajjhanikava,3,3,0,0,21
279877,somanassāvippayogato,somanassavippayogato,3,3,0,0,20
279878,avippayogoti,avippayogoti,2,2,0,0,12
279879,byāpādādīnaṃ,byapadadinam,11,11,0,0,12
279880,nissaraṇattā,nissaranatta,5,5,0,0,12
279881,avasesaekajjhānikāva,avasesaekajjhanikava,1,1,0,0,20
279882,upekkhāvedanāsampayogato,upekkhavedanasampayogato,3,3,0,0,24
279883,majjhattākārappavattā,majjhattakarappavatta,3,3,0,0,21
279884,upekkhāvedanaṃ,upekkhavedanam,9,9,0,0,14
279885,aṭṭhakanipāte,atthakanipate,14,14,0,0,13
279886,savitakkampi,savitakkampi,6,6,0,0,12
279887,sappītikampi,sappitikampi,7,7,0,0,12
279888,nippītikampi,nippitikampi,7,7,0,0,12
279889,sātasahagatampi,satasahagatampi,7,7,0,0,15
279890,upekkhāsahagatampi,upekkhasahagatampi,8,8,0,0,18
279891,bhāveyyāsī,bhaveyyasi,4,4,0,0,10
279892,catukkapañcakajjhānikā,catukkapancakajjhanika,4,4,0,0,22
279893,māhevantissa,mahevantissa,1,1,0,0,12
279894,vedanādīsu,vedanadisu,45,42,3,0,10
279895,paṭhamajjhānampi,pathamajjhanampi,4,4,0,0,16
279896,byañjanacchāyāmattaṃ,byanjanacchayamattam,2,1,1,0,20
279897,abbhācikkhi,abbhacikkhi,43,41,2,0,11
279898,V1.0313,V1.0313,21,21,0,0,7
279899,tatrādhippāyo,tatradhippayo,3,3,0,0,13
279900,āyācitadhammadesanaṃ,ayacitadhammadesanam,2,1,1,0,20
279901,panidhekacce,panidhekacce,14,12,2,0,12
279902,ajjhesanti,ajjhesanti,16,16,0,0,10
279903,anubandhitabbaṃ,anubandhitabbam,5,4,1,0,15
279904,maññantī,mannanti,18,15,3,0,8
279905,upanissayasampanno,upanissayasampanno,24,23,1,0,18
279906,cuppannā,cuppanna,4,4,0,0,8
279907,ṭhassantīti,thassantiti,8,6,2,0,11
279908,niyakajjhattavasena,niyakajjhattavasena,5,5,0,0,19
279909,cittekaggatāmatto,cittekaggatamatto,3,3,0,0,17
279910,mūlasamādhi,mulasamadhi,5,5,0,0,11
279911,vaḍḍhetabbo,vaddhetabbo,7,6,1,0,11
279912,yānikatā,yanikata,1,1,0,0,8
279913,anuṭṭhitā,anutthita,71,71,0,0,9
279914,susamāraddhāti,susamaraddhati,15,3,12,0,14
279915,mūlasamādhiṃ,mulasamadhim,3,3,0,0,12
279916,tāvatakenāpi,tavatakenapi,1,1,0,0,12
279917,anāpajjitvāva,anapajjitvava,4,4,0,0,13
279918,M1.0317,M1.0317,27,27,0,0,7
279919,savicārantiādinā,savicarantiadina,1,1,0,0,16
279920,bhāveyyāsīti,bhaveyyasiti,2,2,0,0,12
279921,karuṇādiavasesabrahmavihārapubbaṅgamampissa,karunadiavasesabrahmaviharapubbangamampissa,1,1,0,0,43
279922,catukkapañcakajjhānavasena,catukkapancakajjhanavasena,6,6,0,0,26
279923,mettādipubbaṅgamaṃ,mettadipubbangamam,1,1,0,0,18
279924,kāyānupassanādipubbaṅgamaṃ,kayanupassanadipubbangamam,3,3,0,0,26
279925,V1.0314,V1.0314,21,21,0,0,7
279926,phāsuññeva,phasunneva,4,4,0,0,10
279927,yattheva,yattheva,31,31,0,0,8
279928,ṭhassasi,thassasi,10,10,0,0,8
279929,kappessasi,kappessasi,10,10,0,0,10
279930,kappessasī,kappessasi,2,2,0,0,10
279931,samāpesi,samapesi,10,10,0,0,8
279932,avasesaekajjhānikāvāti,avasesaekajjhanikavati,1,1,0,0,22
279933,avasesaekajjhānavasena,avasesaekajjhanavasena,1,1,0,0,22
279934,subhaparamādivasena,subhaparamadivasena,2,2,0,0,19
279935,ānubhāvaviseso,anubhavaviseso,2,1,1,0,14
279936,haliddavasanasuttasmiṃ,haliddavasanasuttasmim,1,0,1,0,22
279937,subhaparamādibhāvena,subhaparamadibhavena,1,1,0,0,20
279938,subhaparamāhaṃ,subhaparamaham,2,2,0,0,14
279939,ākāsānañcāyatanaparamāhaṃ,akasanancayatanaparamaham,2,2,0,0,25
279940,viññāṇañcāyatanaparamāhaṃ,vinnanancayatanaparamaham,2,2,0,0,25
279941,ākiñcaññāyatanaparamāhaṃ,akincannayatanaparamaham,2,2,0,0,24
279942,M1.0318,M1.0318,27,27,0,0,7
279943,upanissayattā,upanissayatta,12,11,1,0,13
279944,appaṭikkūlaparicayā,appatikkulaparicaya,1,1,0,0,19
279945,appaṭikkūlesu,appatikkulesu,1,1,0,0,13
279946,parisuddhavaṇṇesu,parisuddhavannesu,2,2,0,0,17
279947,upasaṃharato,upasamharato,11,11,0,0,12
279948,subhavimokkhassa,subhavimokkhassa,3,3,0,0,16
279949,subhaparamāti,subhaparamati,2,0,2,0,13
279950,karuṇāvihārissa,karunaviharissa,7,6,1,0,15
279951,daṇḍābhighātādirūpanimittaṃ,dandabhighatadirupanimittam,2,1,1,0,27
279952,pattadukkhaṃ,pattadukkham,1,1,0,0,12
279953,parividito,parividito,2,2,0,0,10
279954,parividitarūpādīnavattā,parividitarupadinavatta,2,2,0,0,23
279955,rūpanissaraṇe,rupanissarane,2,2,0,0,13
279956,ākāsānañcāyatanassa,akasanancayatanassa,22,22,0,0,19
279957,ākāsānañcāyatanaparamāti,akasanancayatanaparamati,2,0,2,0,24
279958,muditāvihārissa,muditaviharissa,4,3,1,0,15
279959,pāmojjakāraṇena,pamojjakaranena,3,3,0,0,15
279960,uppannapāmojjasattānaṃ,uppannapamojjasattanam,2,2,0,0,22
279961,viññāṇaggahaṇaparicitaṃ,vinnanaggahanaparicitam,4,3,1,0,23
279962,anukkamādhigataṃ,anukkamadhigatam,5,4,1,0,16
279963,V1.0315,V1.0315,21,21,0,0,7
279964,ākāsanimittagocare,akasanimittagocare,3,2,1,0,18
279965,viññāṇañcāyatanassa,vinnanancayatanassa,61,60,1,0,19
279966,viññāṇañcāyatanaparamāti,vinnanancayatanaparamati,2,0,2,0,24
279967,upekkhāvihārissa,upekkhaviharissa,6,4,2,0,16
279968,vimuccantu,vimuccantu,4,4,0,0,10
279969,sampattasukhato,sampattasukhato,2,2,0,0,15
279970,vimuccantū,vimuccantu,1,1,0,0,10
279971,ābhogābhāvato,abhogabhavato,2,2,0,0,13
279972,sukhadukkhādiparamatthagāhavimukhabhāvato,sukhadukkhadiparamatthagahavimukhabhavato,1,1,0,0,41
279973,avijjamānaggahaṇadukkhaṃ,avijjamanaggahanadukkham,3,1,2,0,24
279974,paramatthagāhato,paramatthagahato,2,2,0,0,16
279975,vimukhabhāvaparicitacittassa,vimukhabhavaparicitacittassa,2,2,0,0,28
279976,avijjamānaggahaṇadukkhacittassa,avijjamanaggahanadukkhacittassa,2,2,0,0,31
279977,paramatthabhūtassa,paramatthabhutassa,2,2,0,0,18
279978,ākiñcaññāyatanassa,akincannayatanassa,26,26,0,0,18
279979,ākiñcaññāyatanaparamāti,akincannayatanaparamati,2,0,2,0,23
279980,sabbakalyāṇadhammānaṃ,sabbakalyanadhammanam,3,1,2,0,21
279981,paripūrikāti,paripurikati,2,0,2,0,12
279982,dukkhāsahanatāya,dukkhasahanataya,1,1,0,0,16
279983,pattasampattivisesānaṃ,pattasampattivisesanam,1,1,0,0,22
279984,ciraṭṭhitikāmatāya,ciratthitikamataya,2,2,0,0,18
279985,pakkhapātābhāvena,pakkhapatabhavena,4,4,0,0,17
279986,samappavattacittā,samappavattacitta,1,1,0,0,17
279987,sukhanidānaṃ,sukhanidanam,5,5,0,0,12
279988,upaghātaṃ,upaghatam,35,31,4,0,9
279989,parivajjayantā,parivajjayanta,2,2,0,0,14
279990,sīlaparipūraṇatthaṃ,silaparipuranattham,2,2,0,0,19
279991,hitāhitesu,hitahitesu,7,7,0,0,10
279992,asammohatthāya,asammohatthaya,3,3,0,0,14
279993,pariyodapenti,pariyodapenti,4,4,0,0,13
279994,vīriyamārabhanti,viriyamarabhanti,2,2,0,0,16
279995,uttamavīriyavasena,uttamaviriyavasena,2,2,0,0,18
279996,vīrabhāvaṃ,virabhavam,3,2,1,0,10
279997,avicalādhiṭṭhānā,avicaladhitthana,1,1,0,0,16
279998,avicalāya,avicalaya,1,1,0,0,9
279999,pubbakārino,pubbakarino,7,7,0,0,11
