410000,vācāyāti,vacayati,24,7,17,0,8
410001,yantarūpaṃ,yantarupam,3,3,0,0,10
410002,paṭisedhitameva,patisedhitameva,5,5,0,0,15
410003,kammakāraṇakārakā,kammakaranakaraka,3,3,0,0,17
410004,vemānikapetarājā,vemanikapetaraja,4,2,2,0,16
410005,dibbavimāne,dibbavimane,2,2,0,0,11
410006,dibbakapparukkhadibbauyyānadibbanāṭakādisabbasampattiṃ,dibbakapparukkhadibbauyyanadibbanatakadisabbasampattim,1,1,0,0,54
410007,amatteyyoti,amatteyyoti,1,0,1,0,11
410008,matteyyoti,matteyyoti,1,1,0,0,10
410009,abrahmaññoti,abrahmannoti,1,0,1,0,12
410010,samanuyuñjatīti,samanuyunjatiti,2,1,1,0,15
410011,anuyogavattaṃ,anuyogavattam,28,19,9,0,13
410012,pahitassa,pahitassa,6,6,0,0,9
410013,devadūtassa,devadutassa,2,2,0,0,11
410014,sallakkhāpetukāmo,sallakkhapetukamo,2,2,0,0,17
410015,ambhotiādimāha,ambhotiadimaha,2,0,2,0,14
410016,jarājiṇṇaṃ,jarajinnam,10,10,0,0,10
410017,imināpissa,iminapissa,5,3,2,0,10
410018,vaṅkabhāvameva,vankabhavameva,4,2,2,0,14
410019,daṇḍapaṭisaraṇaṃ,dandapatisaranam,6,4,2,0,16
410020,daṇḍadutiyaṃ,dandadutiyam,3,2,1,0,12
410021,kampamānaṃ,kampamanam,11,11,0,0,10
410022,jarāturaṃ,jaraturam,5,3,2,0,9
410023,jarānubhāvena,jaranubhavena,2,2,0,0,13
410024,khaṇḍitadantaṃ,khanditadantam,3,2,1,0,14
410025,paṇḍarakesaṃ,pandarakesam,4,3,1,0,12
410026,gahitakesaṃ,gahitakesam,2,2,0,0,11
410027,khallāṭaṃ,khallatam,2,2,0,0,9
410028,mahākhallāṭasīsaṃ,mahakhallatasisam,4,2,2,0,17
410029,sañjātavaliṃ,sanjatavalim,3,2,1,0,12
410030,setatilakakāḷatilakehi,setatilakakalatilakehi,2,2,0,0,22
410031,vikiṇṇasarīraṃ,vikinnasariram,2,2,0,0,14
410032,jarādhammoti,jaradhammoti,6,0,6,0,12
410033,jarāsabhāvo,jarasabhavo,5,3,2,0,11
410034,maraṇadhammoti,maranadhammoti,4,0,4,0,14
410035,samanuyuñjitvāti,samanuyunjitvati,2,0,2,0,16
410036,jarājiṇṇasatto,jarajinnasatto,4,4,0,0,14
410037,balajavasampattiyo,balajavasampattiyo,2,2,0,0,18
410038,hatthapādakiccaṃ,hatthapadakiccam,8,7,1,0,16
410039,jarāyamhi,jarayamhi,3,3,0,0,9
410040,aparimuttatāya,aparimuttataya,11,11,0,0,14
410041,panāhameva,panahameva,12,12,0,0,10
410042,aparimuttāva,aparimuttava,12,12,0,0,12
410043,devadūto,devaduto,13,12,1,0,8
410044,bādhikaṃ,badhikam,1,1,0,0,8
410045,adhimattagilānaṃ,adhimattagilanam,3,3,0,0,16
410046,gilānasatto,gilanasatto,3,3,0,0,11
410047,abhihato,abhihato,7,7,0,0,8
410048,byādhitomhi,byadhitomhi,3,3,0,0,11
410049,ekāhamato,ekahamato,1,1,0,0,9
410050,vinīlo,vinilo,1,1,0,0,6
410051,viparibhinnavaṇṇo,viparibhinnavanno,1,1,0,0,17
410052,vinīlova,vinilova,1,1,0,0,8
410053,vissandamānapubbakaṃ,vissandamanapubbakam,1,1,0,0,20
410054,paribhinnaṭṭhāne,paribhinnatthane,1,1,0,0,16
410055,paggharitena,paggharitena,1,1,0,0,12
410056,palimakkhitanti,palimakkhitanti,1,1,0,0,15
410057,matakasatto,matakasatto,2,2,0,0,11
410058,uddhumātakādibhāvappattaṃ,uddhumatakadibhavappattam,1,1,0,0,25
410059,maraṇatomhi,maranatomhi,3,3,0,0,11
410060,aparimuttā,aparimutta,6,5,1,0,10
410061,devadūtānuyogaṃ,devadutanuyogam,2,2,0,0,15
410062,sabhaṇḍaṃ,sabhandam,3,3,0,0,9
410063,vinicchinanti,vinicchinanti,14,14,0,0,13
410064,anuvijjitvā,anuvijjitva,5,4,1,0,11
410065,vinicchayaṭṭhānaṃ,vinicchayatthanam,23,21,2,0,17
410066,evaṃsampadametaṃ,evamsampadametam,3,3,0,0,16
410067,parittapāpakammā,parittapapakamma,2,2,0,0,16
410068,sārīyamānāpi,sariyamanapi,1,1,0,0,12
410069,dīghajayantadamiḷo,dighajayantadamilo,2,1,1,0,18
410070,sumanagirimahāvihāre,sumanagirimahavihare,1,1,0,0,20
410071,rattapaṭena,rattapatena,2,2,0,0,11
410072,aggijālasaddaṃ,aggijalasaddam,5,3,2,0,14
410073,pūjitapaṭaṃ,pujitapatam,5,3,2,0,11
410074,khalisāṭakaṃ,khalisatakam,2,2,0,0,12
410075,maraṇakālamhi,maranakalamhi,3,3,0,0,13
410076,paṭapaṭāti,patapatati,4,4,0,0,10
410077,jālasaddena,jalasaddena,2,2,0,0,11
410078,asarante,asarante,4,4,0,0,8
410079,devadūtena,devadutena,2,2,0,0,10
410080,sumanapupphakumbhena,sumanapupphakumbhena,4,4,0,0,20
410081,sāresi,saresi,3,3,0,0,6
410082,uttānakaṃ,uttanakam,19,18,1,0,9
410083,vāmahatthādīsu,vamahatthadisu,3,3,0,0,14
410084,urenapi,urenapi,3,3,0,0,7
410085,vāmapassenapi,vamapassenapi,3,3,0,0,13
410086,dakkhiṇapassenapi,dakkhinapassenapi,3,3,0,0,17
410087,kammakāraṇaṃ,kammakaranam,29,27,2,0,12
410088,saṃvesetvāti,samvesetvati,3,0,3,0,12
410089,jalitāya,jalitaya,6,6,0,0,8
410090,kuṭhārīhīti,kutharihiti,3,0,3,0,11
410091,ekapakkhacchadanamattāhi,ekapakkhacchadanamattahi,1,1,0,0,24
410092,lohapathavito,lohapathavito,3,3,0,0,13
410093,tacchitaṭṭhānaṃ,tacchitatthanam,3,3,0,0,15
410094,tacchantā,tacchanta,7,7,0,0,9
410095,suttāhataṃ,suttahatam,4,3,1,0,10
410096,aṭṭhaṃsampi,atthamsampi,3,3,0,0,11
410097,chaḷaṃsampi,chalamsampi,3,3,0,0,11
410098,vāsīhīti,vasihiti,3,0,3,0,8
410099,mahāsuppappamāṇāhi,mahasuppappamanahi,1,1,0,0,18
410100,yugayottapakkharathacakkakubbarapājanehi,yugayottapakkharathacakkakubbarapajanehi,1,1,0,0,40
410101,pajjalite,pajjalite,9,8,1,0,9
410102,mahākūṭāgārappamāṇaṃ,mahakutagarappamanam,4,3,1,0,20
410103,sampajjalitehi,sampajjalitehi,3,3,0,0,14
410104,ayamuggarehi,ayamuggarehi,4,4,0,0,12
410105,pothentā,pothenta,7,7,0,0,8
410106,supakkuthitāya,supakkuthitaya,2,2,0,0,14
410107,pakkhittataṇḍulā,pakkhittatandula,2,2,0,0,16
410108,uddhamadhotiriyañca,uddhamadhotiriyanca,1,1,0,0,19
410109,mahānirayeti,mahanirayeti,5,0,5,0,12
410110,avīcimahānirayamhi,avicimahanirayamhi,5,5,0,0,18
410111,mitoti,mitoti,3,0,3,0,6
410112,pariyantoti,pariyantoti,9,2,7,0,11
410113,ayasāti,ayasati,4,0,4,0,7
410114,yamakagoḷakā,yamakagolaka,3,3,0,0,12
410115,hīnakāyūpagāti,hinakayupagati,3,0,3,0,14
410116,upādāneti,upadaneti,6,0,6,0,9
410117,taṇhādiṭṭhiggahaṇe,tanhaditthiggahane,2,1,1,0,18
410118,jātimaraṇasambhaveti,jatimaranasambhaveti,3,0,3,0,20
410119,anupādāti,anupadati,9,0,9,0,9
410120,anupādiyitvā,anupadiyitva,26,21,5,0,12
410121,jātimaraṇasaṅkhayeti,jatimaranasankhayeti,3,0,3,0,20
410122,jātimaraṇasaṅkhayasaṅkhāte,jatimaranasankhayasankhate,2,2,0,0,26
410123,diṭṭhadhammābhinibbutāti,ditthadhammabhinibbutati,7,0,7,0,24
410124,sabbakilesanibbānena,sabbakilesanibbanena,3,3,0,0,20
410125,sakalavaṭṭadukkhaṃ,sakalavattadukkham,4,3,1,0,18
410126,catumahārājasuttavaṇṇanā,catumaharajasuttavannana,3,3,0,0,24
410127,paricārikadevatā,paricarikadevata,2,1,1,0,16
410128,anuvicarantīti,anuvicarantiti,3,0,3,0,14
410129,aṭṭhamīdivase,atthamidivase,3,3,0,0,13
410130,anuvicaritvā,anuvicaritva,13,11,2,0,12
410131,puññakārakānaṃ,punnakarakanam,2,2,0,0,14
410132,anuvicarantī,anuvicaranti,1,1,0,0,12
410133,bahūtiādi,bahutiadi,1,0,1,0,9
410134,upaparikkhākāradassanatthaṃ,upaparikkhakaradassanattham,1,1,0,0,27
410135,upavasantīti,upavasantiti,10,4,6,0,12
410136,aṭṭhavāre,atthavare,2,1,1,0,9
410137,paṭijāgarontīti,patijagarontiti,2,0,2,0,15
410138,paṭijāgarauposathakammaṃ,patijagarauposathakammam,1,1,0,0,24
410139,uposathadivasānaṃ,uposathadivasanam,1,1,0,0,17
410140,paccuggamanānuggamanavasena,paccuggamananuggamanavasena,4,4,0,0,27
410141,pañcamīuposathaṃ,pancamiuposatham,1,1,0,0,16
410142,paccuggacchantā,paccuggacchanta,3,3,0,0,15
410143,aṭṭhamīuposathaṃ,atthamiuposatham,1,1,0,0,16
410144,pannarasīuposathaṃ,pannarasiuposatham,3,3,0,0,18
410145,saraṇagamananiccasīlapupphapūjādhammassavanapadīpasahassaāropanavihārakaraṇādīni,saranagamananiccasilapupphapujadhammassavanapadipasahassaaropanaviharakaranadini,1,1,0,0,80
410146,puññakammakārakānaṃ,punnakammakarakanam,1,1,0,0,19
410147,tadahūti,tadahuti,14,0,14,0,8
410148,uposatheti,uposatheti,9,0,9,0,10
410149,puññapaṭipattiṃ,punnapatipattim,1,1,0,0,15
410150,anuvicarantā,anuvicaranta,3,3,0,0,12
410151,suvaṇṇapaṭṭaparimāṇeneva,suvannapattaparimaneneva,1,1,0,0,24
410152,abhinibbatte,abhinibbatte,6,6,0,0,12
410153,evaṃladdhanāmānaṃ,evamladdhanamanam,2,2,0,0,17
410154,sakkapañhasuttavaṇṇanāya,sakkapanhasuttavannanaya,2,2,0,0,24
410155,ārocanena,arocanena,2,2,0,0,9
410156,parihāyissantīti,parihayissantiti,1,0,1,0,16
410157,apātubhāvena,apatubhavena,1,1,0,0,12
410158,dasayojanasahassaṃ,dasayojanasahassam,20,19,1,0,18
410159,devasaṅghamajjhe,devasanghamajjhe,1,1,0,0,16
410160,devānamindoti,devanamindoti,6,5,1,0,13
410161,sakkadevarājakālaṃ,sakkadevarajakalam,1,1,0,0,18
410162,anunayamānoti,anunayamanoti,1,0,1,0,13
410163,anubodhayamāno,anubodhayamano,2,2,0,0,14
410164,pāṭihāriyapakkhañcāti,patihariyapakkhancati,7,0,7,0,21
410165,pāṭihāriyapakkho,patihariyapakkho,3,2,1,0,16
410166,nibaddhuposatho,nibaddhuposatho,2,2,0,0,15
410167,pavāraṇānaṃ,pavarananam,2,2,0,0,11
410168,paṭhamapavāraṇato,pathamapavaranato,1,1,0,0,17
410169,pāṭihāriyapakkhoyeva,patihariyapakkhoyeva,1,1,0,0,20
410170,uposathakammassa,uposathakammassa,15,15,0,0,16
410171,devalokasampattiyo,devalokasampattiyo,2,2,0,0,18
410172,iccheyyāti,iccheyyati,12,10,2,0,10
410173,uposathakammena,uposathakammena,17,16,1,0,15
410174,pāpuṇitunti,papunitunti,11,9,2,0,11
410175,vusitavāti,vusitavati,8,0,8,0,10
410176,vutthavāso,vutthavaso,21,18,3,0,10
410177,ohitabhāroti,ohitabharoti,6,0,6,0,12
410178,khandhabhārakilesabhāraabhisaṅkhārabhāre,khandhabharakilesabharaabhisankharabhare,1,1,0,0,40
410179,anuppattasadatthoti,anuppattasadatthoti,5,0,5,0,19
410180,sadattho,sadattho,21,19,2,0,8
410181,parikkhīṇabhavasaṃyojanoti,parikkhinabhavasamyojanoti,6,0,6,0,26
410182,vacanāyāti,vacanayati,17,4,13,0,10
410183,upavaseyyāti,upavaseyyati,2,2,0,0,12
410184,khīṇāsavasampattiṃ,khinasavasampattim,2,2,0,0,18
410185,sukhumālasuttavaṇṇanā,sukhumalasuttavannana,3,3,0,0,21
410186,sukhumāloti,sukhumaloti,4,3,1,0,11
410187,paramasukhumāloti,paramasukhumaloti,1,0,1,0,17
410188,paramaniddukkho,paramaniddukkho,1,1,0,0,15
410189,accantasukhumāloti,accantasukhumaloti,1,0,1,0,18
410190,satataniddukkho,satataniddukkho,2,1,1,0,15
410191,kapilapure,kapilapure,5,5,0,0,10
410192,niddukkhabhāvaṃ,niddukkhabhavam,4,4,0,0,15
410193,cariyakāle,cariyakale,1,1,0,0,10
410194,anubhūtadukkhassa,anubhutadukkhassa,1,1,0,0,17
410195,vappatīti,vappatiti,2,0,2,0,9
410196,nīluppalavanasañchannā,niluppalavanasanchanna,1,1,0,0,22
410197,paṇḍarapadumaṃ,pandarapadumam,1,1,0,0,14
410198,padumapuṇḍarīkavanehi,padumapundarikavanehi,1,1,0,0,21
410199,sattaṭṭhavassikakāle,sattatthavassikakale,1,1,0,0,20
410200,katarakīḷikaṃ,katarakilikam,1,1,0,0,13
410201,piyāyantī,piyayanti,3,2,1,0,9
410202,udakakīḷikaṃ,udakakilikam,2,2,0,0,12
410203,kuddālakammakārake,kuddalakammakarake,1,1,0,0,18
410204,pokkharaṇiṭṭhānāni,pokkharanitthanani,1,1,0,0,18
410205,mānusakaparibhogo,manusakaparibhogo,1,1,0,0,17
410206,dibbaparibhogo,dibbaparibhogo,1,1,0,0,14
410207,kīḷābhūmiyaṃ,kilabhumiyam,1,1,0,0,12
410208,apagatakalalakaddamā,apagatakalalakaddama,2,2,0,0,20
410209,vippakiṇṇamaṇimuttapavāḷikā,vippakinnamanimuttapavalika,1,1,0,0,27
410210,sattaratanamayapākāraparikkhittā,sattaratanamayapakaraparikkhitta,1,1,0,0,32
410211,pavāḷamayauṇhīsehi,pavalamayaunhisehi,1,1,0,0,18
410212,maṇimayasopānabāhukehi,manimayasopanabahukehi,1,1,0,0,22
410213,suvaṇṇarajatamaṇimayaphalakehi,suvannarajatamanimayaphalakehi,1,1,0,0,30
410214,sopānehi,sopanehi,1,1,0,0,8
410215,suvaṇṇarajatamaṇipavāḷamayā,suvannarajatamanipavalamaya,2,2,0,0,27
410216,suvaṇṇanāvāya,suvannanavaya,3,3,0,0,13
410217,rajatapallaṅko,rajatapallanko,1,1,0,0,14
410218,rajatanāvāya,rajatanavaya,1,1,0,0,12
410219,suvaṇṇapallaṅko,suvannapallanko,1,1,0,0,15
410220,maṇināvāya,maninavaya,1,1,0,0,10
410221,pavāḷapallaṅko,pavalapallanko,1,1,0,0,14
410222,pavāḷanāvāya,pavalanavaya,1,1,0,0,12
410223,maṇipallaṅko,manipallanko,4,4,0,0,12
410224,suvaṇṇarajatamaṇipavāḷamayāva,suvannarajatamanipavalamayava,1,1,0,0,29
410225,udakasecananāḷikā,udakasecananalika,1,1,0,0,17
410226,padumehi,padumehi,20,20,0,0,8
410227,gāhāpitapokkharaṇiṭṭhānesuyeva,gahapitapokkharanitthanesuyeva,1,1,0,0,30
410228,pupphiṃsūti,pupphimsuti,1,1,0,0,11
410229,khuddakanāvāyo,khuddakanavayo,1,1,0,0,14
410230,kalalakaddamapūritā,kalalakaddamapurita,1,1,0,0,19
410231,pupphantū,pupphantu,1,1,0,0,9
410232,reṇuvaṭṭiyo,renuvattiyo,1,1,0,0,11
410233,udakapiṭṭhaṃ,udakapittham,2,2,0,0,12
410234,bhamaragaṇā,bhamaragana,4,4,0,0,11
410235,upakūjantā,upakujanta,1,1,0,0,10
410236,mahāpurissassa,mahapurissassa,1,1,0,0,14
410237,mahājanaparivāro,mahajanaparivaro,4,4,0,0,16
410238,mamatthāyāti,mamatthayati,1,0,1,0,12
410239,payojanāvadhiniyāmavacanaṃ,payojanavadhiniyamavacanam,1,1,0,0,26
410240,asaṇhaṃ,asanham,1,1,0,0,7
410241,saṇhameva,sanhameva,1,1,0,0,9
410242,kañcukāti,kancukati,1,0,1,0,9
410243,pārupanakañcukopi,parupanakancukopi,1,1,0,0,17
410244,saṇhakañcukova,sanhakancukova,1,1,0,0,14
410245,mānusakasetacchattampi,manusakasetacchattampi,1,1,0,0,22
410246,dibbasetacchattampi,dibbasetacchattampi,1,1,0,0,19
410247,uparidhāritameva,uparidharitameva,1,1,0,0,16
410248,uṇhādīsu,unhadisu,2,2,0,0,8
410249,phusatūti,phusatuti,2,1,1,0,9
410250,soḷasavassuddesike,solasavassuddesike,3,3,0,0,18
410251,vasanakapāsāde,vasanakapasade,1,1,0,0,14
410252,nakkhattamuhuttena,nakkhattamuhuttena,1,1,0,0,18
410253,navabhūmikataparikammaṃ,navabhumikataparikammam,1,1,0,0,23
410254,hemantikotiādīsu,hemantikotiadisu,2,0,2,0,16
410255,navabhūmako,navabhumako,1,1,0,0,11
410256,uṇhautuggāhāpanatthāya,unhautuggahapanatthaya,1,1,0,0,22
410257,dvāravātapānāni,dvaravatapanani,17,17,0,0,15
410258,suphusitakavāṭāni,suphusitakavatani,1,1,0,0,17
410259,nibbivarāni,nibbivarani,1,1,0,0,11
410260,cittakammampi,cittakammampi,2,2,0,0,13
410261,aggikkhandheyeva,aggikkhandheyeva,1,1,0,0,16
410262,kambalamayaṃ,kambalamayam,1,1,0,0,12
410263,sāṇivitānanivāsanapārupanaveṭhanāni,sanivitananivasanaparupanavethanani,2,2,0,0,35
410264,uṇhaggāhāpanatthaṃ,unhaggahapanattham,1,1,0,0,18
410265,pihitāni,pihitani,3,3,0,0,8
410266,pañcabhūmako,pancabhumako,1,1,0,0,12
410267,sītautuggāhāpanatthaṃ,sitautuggahapanattham,1,1,0,0,21
410268,asambādhā,asambadha,4,4,0,0,9
410269,nātiphusitāni,natiphusitani,1,1,0,0,13
410270,savivarāni,savivarani,2,2,0,0,10
410271,sajālāni,sajalani,1,1,0,0,8
410272,puṇḍarīkāniyeva,pundarikaniyeva,1,1,0,0,15
410273,dukūlamayaṃ,dukulamayam,1,1,0,0,11
410274,vātapānasamīpesu,vatapanasamipesu,4,4,0,0,16
410275,nīluppalādīhi,niluppaladihi,4,4,0,0,13
410276,sañchādenti,sanchadenti,6,6,0,0,11
410277,udakayantāni,udakayantani,4,4,0,0,12
410278,antopāsāde,antopasade,4,4,0,0,10
410279,kalalapūrā,kalalapura,1,1,0,0,10
410280,doṇiyo,doniyo,4,4,0,0,6
410281,ropayiṃsu,ropayimsu,2,2,0,0,9
410282,pāsādamatthake,pasadamatthake,5,5,0,0,14
410283,sukkhamahiṃsacammaṃ,sukkhamahimsacammam,4,4,0,0,19
410284,chadanapiṭṭhiyā,chadanapitthiya,1,1,0,0,15
410285,pavaṭṭantānaṃ,pavattantanam,1,1,0,0,13
410286,meghagajjitaṃ,meghagajjitam,5,5,0,0,13
410287,sattabhūmako,sattabhumako,2,2,0,0,12
410288,nātiuccā,natiucca,3,2,1,0,8
410289,nātinīcā,natinica,1,1,0,0,8
410290,suphusitāni,suphusitani,1,1,0,0,11
410291,pajjalitaaggikkhandhavasena,pajjalitaaggikkhandhavasena,1,1,0,0,27
410292,jātassaravasena,jatassaravasena,1,1,0,0,15
410293,bhūmattharaṇādīni,bhumattharanadini,3,3,0,0,17
410294,kambaladukūlavasena,kambaladukulavasena,1,1,0,0,19
410295,ubhayamissakāni,ubhayamissakani,1,1,0,0,15
410296,dvāravātapānā,dvaravatapana,1,1,0,0,13
410297,bhūmikāsu,bhumikasu,2,2,0,0,9
410298,chattamassa,chattamassa,2,2,0,0,11
410299,pesentū,pesentu,7,7,0,0,7
410300,dassanakkhamo,dassanakkhamo,1,1,0,0,13
410301,rūpasampanno,rupasampanno,6,6,0,0,12
410302,sahassathāmadhanuṃ,sahassathamadhanum,8,8,0,0,18
410303,purisasahassaṃ,purisasahassam,11,11,0,0,14
410304,oropeti,oropeti,9,9,0,0,7
410305,pādaṅguṭṭhake,padangutthake,3,3,0,0,13
410306,pādaṅguṭṭhakeneva,padangutthakeneva,2,2,0,0,17
410307,pothesi,pothesi,15,15,0,0,7
410308,uppatanākārappattaṃ,uppatanakarappattam,1,1,0,0,19
410309,pothentassa,pothentassa,1,1,0,0,11
410310,jiyappahārasaddo,jiyappaharasaddo,2,2,0,0,16
410311,aṭṭhaṅgulamattabahalaṃ,atthangulamattabahalam,1,1,0,0,22
410312,ayopaṭṭaṃ,ayopattam,2,2,0,0,9
410313,vinivijjhituṃ,vinivijjhitum,6,6,0,0,13
410314,caturaṅgulabahalaṃ,caturangulabahalam,5,5,0,0,18
410315,asanaphalakaṃ,asanaphalakam,2,2,0,0,13
410316,vidatthibahalaṃ,vidatthibahalam,3,3,0,0,15
410317,udumbaraphalakaṃ,udumbaraphalakam,2,2,0,0,16
410318,saṭṭhipaṭalaṃ,satthipatalam,1,1,0,0,13
410319,vālikasakaṭādīni,valikasakatadini,1,1,0,0,16
410320,vālikasakaṭampi,valikasakatampi,2,2,0,0,15
410321,palālasakaṭampi,palalasakatampi,2,2,0,0,15
410322,ekusabhappamāṇaṃ,ekusabhappamanam,1,1,0,0,16
410323,aṭṭhausabhappamāṇaṃ,atthausabhappamanam,3,3,0,0,19
410324,vātiṅgaṇasaññāya,vatinganasannaya,5,5,0,0,16
410325,bandhāpethāti,bandhapethati,1,1,0,0,13
410326,bajjhatu,bajjhatu,1,1,0,0,8
410327,gāvutantare,gavutantare,1,1,0,0,11
410328,addhayojane,addhayojane,36,35,1,0,11
410329,bandhāpetha,bandhapetha,1,1,0,0,11
410330,yojanamatthake,yojanamatthake,3,3,0,0,14
410331,meghapaṭalacchannāsu,meghapatalacchannasu,1,1,0,0,20
410332,vattamānasippaṃ,vattamanasippam,1,1,0,0,15
410333,cattālīsasahassanāṭakitthiyo,cattalisasahassanatakitthiyo,2,2,0,0,28
410334,paricārento,paricarento,16,16,0,0,11
410335,nippurisehīti,nippurisehiti,4,0,4,0,13
410336,purisavirahitehi,purisavirahitehi,4,4,0,0,16
410337,tūriyāneva,turiyaneva,5,5,0,0,10
410338,nippurisāni,nippurisani,5,5,0,0,11
410339,sabbaṭṭhānānipi,sabbatthananipi,4,4,0,0,15
410340,nippurisāneva,nippurisaneva,4,4,0,0,13
410341,dovārikāpi,dovarikapi,4,4,0,0,10
410342,itthiyova,itthiyova,14,14,0,0,9
410343,nhāpanādiparikammakarāpi,nhapanadiparikammakarapi,2,2,0,0,24
410344,issariyasukhasampattiṃ,issariyasukhasampattim,4,4,0,0,22
410345,anubhavamānassa,anubhavamanassa,6,6,0,0,15
410346,parisaṅkā,parisanka,3,3,0,0,9
410347,paricārayamānoti,paricarayamanoti,1,0,1,0,16
410348,orohāmīti,orohamiti,1,0,1,0,9
410349,otarāmi,otarami,2,2,0,0,7
410350,sikhābaddho,sikhabaddho,3,3,0,0,11
410351,dāsakammakaraporisassāti,dasakammakaraporisassati,1,0,1,0,24
410352,dāsānañceva,dasananceva,1,1,0,0,11
410353,devasikabhattavetanābhatānaṃ,devasikabhattavetanabhatanam,1,1,0,0,28
410354,kammakarānañca,kammakarananca,1,1,0,0,14
410355,jīvamānapurisānañca,jivamanapurisananca,1,1,0,0,19
410356,sakuṇḍakabhattaṃ,sakundakabhattam,8,6,2,0,16
410357,kañjikadutiyaṃ,kanjikadutiyam,5,4,1,0,14
410358,sukhumālenāti,sukhumalenati,1,0,1,0,13
410359,evaṃjātikena,evamjatikena,1,1,0,0,12
410360,niddukkhabhāvena,niddukkhabhavena,1,1,0,0,16
410361,sokhumālenātipi,sokhumalenatipi,1,1,0,0,15
410362,uppilāvitabhāvatthaṃ,uppilavitabhavattham,2,1,1,0,20
410363,appamattova,appamattova,9,9,0,0,11
410364,appamādalakkhaṇasseva,appamadalakkhanasseva,1,1,0,0,21
410365,puthujjanotiādimāha,puthujjanotiadimaha,1,0,1,0,19
410366,aṭṭīyatīti,attiyatiti,8,4,4,0,10
410367,atisitvāti,atisitvati,4,0,4,0,10
410368,jarādhammampi,jaradhammampi,1,1,0,0,13
410369,anatikkanto,anatikkanto,6,6,0,0,11
410370,paṭisañcikkhatoti,patisancikkhatoti,2,0,2,0,17
410371,yobbanamadoti,yobbanamadoti,2,0,2,0,13
410372,pahīyīti,pahiyiti,1,0,1,0,8
410373,pahīnasadiso,pahinasadiso,1,1,0,0,12
410374,jarāpattaṃ,jarapattam,1,1,0,0,10
410375,ārogyamadoti,arogyamadoti,1,0,1,0,12
410376,nirogoti,nirogoti,2,1,1,0,8
410377,jīvitamadoti,jivitamadoti,2,0,2,0,12
410378,jīvīti,jiviti,2,1,1,0,6
410379,hīnāyāvattatīti,hinayavattatiti,4,2,2,0,15
410380,lāmakāya,lamakaya,2,2,0,0,8
410381,gihibhāvāya,gihibhavaya,11,11,0,0,11
410382,yathādhammāti,yathadhammati,1,0,1,0,13
410383,yathāsabhāvā,yathasabhava,2,2,0,0,12
410384,tathāsantāti,tathasantati,1,0,1,0,12
410385,aviparītabyādhiādisabhāvāva,aviparitabyadhiadisabhavava,1,1,0,0,27
410386,jigucchantīti,jigucchantiti,2,0,2,0,13
410387,vihārinoti,viharinoti,1,0,1,0,10
410388,jigucchāvihārena,jigucchaviharena,1,1,0,0,16
410389,nānucchavikaṃ,nanucchavikam,3,3,0,0,13
410390,paṭisaṅkhānavihārena,patisankhanaviharena,1,1,0,0,20
410391,sabbūpadhivirahitaṃ,sabbupadhivirahitam,1,1,0,0,19
410392,abhibhosmīti,abhibhosmiti,3,0,3,0,12
410393,abhibhaviṃ,abhibhavim,4,4,0,0,10
410394,samatikkamiṃ,samatikkamim,6,6,0,0,12
410395,khematotipi,khematotipi,1,1,0,0,11
410396,nekkhammasaṅkhātaṃ,nekkhammasankhatam,6,6,0,0,18
410397,abhipassantassa,abhipassantassa,2,2,0,0,15
410398,nivattissāmi,nivattissami,7,7,0,0,12
410399,anivattako,anivattako,1,1,0,0,10
410400,brahmacariyaparāyaṇoti,brahmacariyaparayanoti,3,0,3,0,22
410401,maggabrahmacariyaparāyaṇo,maggabrahmacariyaparayano,3,3,0,0,25
410402,jātosmīti,jatosmiti,5,5,0,0,9
410403,āgamanīyavīriyaṃ,agamaniyaviriyam,1,1,0,0,16
410404,ādhipateyyasuttavaṇṇanā,adhipateyyasuttavannana,3,3,0,0,23
410405,ādhipateyyānīti,adhipateyyaniti,2,0,2,0,15
410406,jeṭṭhakakāraṇato,jetthakakaranato,1,1,0,0,16
410407,bhavābhavahetūti,bhavabhavahetuti,3,0,3,0,16
410408,sampattibhavassa,sampattibhavassa,3,2,1,0,16
410409,otiṇṇoti,otinnoti,15,3,12,0,8
410410,antopaviṭṭhā,antopavittha,3,2,1,0,12
410411,vaṭṭadukkharāsissa,vattadukkharasissa,3,3,0,0,18
410412,antakaraṇaṃ,antakaranam,2,2,0,0,11
410413,paricchedaparivaṭumakaraṇaṃ,paricchedaparivatumakaranam,1,1,0,0,27
410414,ohāyāti,ohayati,12,0,12,0,7
410415,pāpiṭṭhatareti,papitthatareti,1,0,1,0,14
410416,lāmakatare,lamakatare,1,1,0,0,10
410417,āraddhattāva,araddhattava,1,1,0,0,12
410418,upaṭṭhitāti,upatthitati,13,0,13,0,11
410419,catusatipaṭṭhānavasena,catusatipatthanavasena,3,3,0,0,22
410420,upaṭṭhitattāva,upatthitattava,1,1,0,0,14
410421,passaddhattāva,passaddhattava,1,1,0,0,14
410422,āhitaṃ,ahitam,18,15,3,0,6
410423,āhitattāva,ahitattava,1,1,0,0,10
410424,gopāyatīti,gopayatiti,2,1,1,0,10
410425,phalappattova,phalappattova,1,1,0,0,13
410426,svākkhātotiādīni,svakkhatotiadini,2,0,2,0,16
410427,pakubbatoti,pakubbatoti,1,0,1,0,11
410428,yathāsabhāvanti,yathasabhavanti,1,1,0,0,15
410429,paṭicchannaṭṭhānaṃ,paticchannatthanam,14,14,0,0,18
410430,atimaññasīti,atimannasiti,2,0,2,0,12
410431,parigūhasīti,pariguhasiti,1,0,1,0,12
410432,parigūhāmīti,pariguhamiti,1,1,0,0,12
410433,vāyamasi,vayamasi,4,4,0,0,8
410434,attādhipateyyakoti,attadhipateyyakoti,1,0,1,0,18
410435,attajeṭṭhako,attajetthako,1,1,0,0,12
410436,lokādhipoti,lokadhipoti,1,0,1,0,11
410437,lokajeṭṭhako,lokajetthako,1,1,0,0,12
410438,dhammādhipoti,dhammadhipoti,1,0,1,0,13
410439,dhammajeṭṭhako,dhammajetthako,1,1,0,0,14
410440,saccaparakkamoti,saccaparakkamoti,2,0,2,0,16
410441,bhūtaparakkamo,bhutaparakkamo,1,1,0,0,14
410442,padhānavāti,padhanavati,9,1,8,0,11
410443,tathāsaṇṭhito,tathasanthito,1,1,0,0,13
410444,taṇhāsaṅkhātāya,tanhasankhataya,6,6,0,0,15
410445,tammayatāya,tammayataya,3,2,1,0,11
410446,khīṇāsavamuni,khinasavamuni,11,10,1,0,13
410447,parihīyatīti,parihiyatiti,1,1,0,0,12
410448,sammukhībhāvasuttavaṇṇanā,sammukhibhavasuttavannana,3,3,0,0,25
410449,sammukhībhāvena,sammukhibhavena,5,5,0,0,15
410450,vijjamānatāyāti,vijjamanatayati,2,2,0,0,15
410451,dakkhiṇeyyasaṅkhātā,dakkhineyyasankhata,1,1,0,0,19
410452,paṭiggāhakapuggalā,patiggahakapuggala,1,1,0,0,18
410453,deyyadhammā,deyyadhamma,4,4,0,0,11
410454,athāvarā,athavara,2,2,0,0,8
410455,padavārena,padavarena,43,39,4,0,10
410456,mahāmoggallānasadisopi,mahamoggallanasadisopi,2,2,0,0,22
410457,tiṭhānasuttavaṇṇanā,tithanasuttavannana,6,6,0,0,19
410458,vigatamacchariyamalena,vigatamacchariyamalena,1,1,0,0,22
410459,dhotahattho,dhotahattho,5,4,1,0,11
410460,dhovitvāpi,dhovitvapi,3,3,0,0,10
410461,malinahatthova,malinahatthova,1,1,0,0,14
410462,dānābhiratattā,danabhiratatta,1,1,0,0,14
410463,malinahatthopi,malinahatthopi,1,1,0,0,14
410464,dhotahatthova,dhotahatthova,2,1,1,0,13
410465,vossaggasaṅkhāte,vossaggasankhate,2,2,0,0,16
410466,yojanasatampi,yojanasatampi,31,30,1,0,13
410467,pāṭaliputtakabrāhmaṇo,pataliputtakabrahmano,1,0,1,0,21
410468,kāḷavallimaṇḍapavāsimahānāgattherassa,kalavallimandapavasimahanagattherassa,1,1,0,0,37
410469,kāḷavallimaṇḍapo,kalavallimandapo,1,1,0,0,16
410470,rohaṇajanapadeti,rohanajanapadeti,1,1,0,0,16
410471,cūḷanagaragāme,culanagaragame,1,1,0,0,14
410472,dhuraghare,dhuraghare,1,1,0,0,10
410473,janapariyante,janapariyante,1,1,0,0,13
410474,nātiucco,natiucco,11,9,2,0,8
410475,nātirasso,natirasso,5,5,0,0,9
410476,pamāṇayuttova,pamanayuttova,4,4,0,0,13
410477,mecakavaṇṇassa,mecakavannassa,1,1,0,0,14
410478,sakalajambudīpatalaṃ,sakalajambudipatalam,5,5,0,0,20
410479,pāṭaliputtanagaradvāre,pataliputtanagaradvare,2,2,0,0,22
410480,bhikkhāhāraṃ,bhikkhaharam,6,6,0,0,12
410481,tassovāde,tassovade,21,21,0,0,9
410482,vanditabbayuttakaṃ,vanditabbayuttakam,1,1,0,0,18
410483,maṅgalavāsī,mangalavasi,2,2,0,0,11
410484,kuṭṭatissatthero,kuttatissatthero,2,2,0,0,16
410485,pañcayojanamaggaṃ,pancayojanamaggam,4,4,0,0,17
410486,likhanto,likhanto,7,6,1,0,8
410487,likhantaṃ,likhantam,1,1,0,0,9
410488,hatthakukkuccaṃ,hatthakukkuccam,17,12,5,0,15
410489,avanditvāva,avanditvava,10,10,0,0,11
410490,pasādarakkhanaṃ,pasadarakkhanam,1,1,0,0,15
410491,mahallakattherassa,mahallakattherassa,7,7,0,0,18
410492,kūṭāgāramhi,kutagaramhi,1,1,0,0,11
410493,attharathā,attharatha,3,3,0,0,10
410494,atthate,atthate,74,71,3,0,7
410495,appatiṭṭhahitvā,appatitthahitva,5,5,0,0,15
410496,diṭṭhakāleyeva,ditthakaleyeva,2,2,0,0,14
410497,pañcayojanamagge,pancayojanamagge,1,1,0,0,16
410498,dhajapaggahitāva,dhajapaggahitava,1,1,0,0,16
410499,gacchāpi,gacchapi,1,1,0,0,8
410500,gumbāpi,gumbapi,1,1,0,0,7
410501,kūṭāgārābhimukhā,kutagarabhimukha,1,1,0,0,16
410502,silācetiyaṭṭhānaṃ,silacetiyatthanam,2,1,1,0,17
410503,kūṭāgāramatthake,kutagaramatthake,1,1,0,0,16
410504,sādhukārasahassāni,sadhukarasahassani,15,15,0,0,18
410505,mahābyagghatthero,mahabyagghatthero,1,1,0,0,17
410506,sattamakūṭāgāre,sattamakutagare,1,1,0,0,15
410507,sādhukārasaddoti,sadhukarasaddoti,1,1,0,0,16
410508,dutiyamañce,dutiyamance,1,1,0,0,11
410509,gandhapupphacuṇṇāni,gandhapupphacunnani,1,1,0,0,19
410510,sotumicchatīti,sotumicchatiti,1,0,1,0,14
410511,piṇḍapātikattherādayo,pindapatikattheradayo,1,0,1,0,21
410512,gaṅgāvanavāliaṅgaṇamhi,gangavanavalianganamhi,1,1,0,0,22
410513,catupaccayasantosabhāvanārāmamahāariyavaṃsañca,catupaccayasantosabhavanaramamahaariyavamsanca,1,1,0,0,46
410514,piṇḍapātikatthero,pindapatikatthero,4,4,0,0,17
410515,pacchābhāgena,pacchabhagena,12,12,0,0,13
410516,jaṅghapiṇḍimaṃsaṃ,janghapindimamsam,1,1,0,0,17
410517,gonasaṃ,gonasam,3,3,0,0,7
410518,dhammassavanantarāyaṃ,dhammassavanantarayam,3,2,1,0,21
410519,thavikāmukhaṃ,thavikamukham,1,1,0,0,13
410520,aruṇuggamanañca,arunuggamananca,6,6,0,0,15
410521,pāpuṇanañca,papunananca,3,3,0,0,11
410522,daṭṭhaṭṭhāneneva,datthatthaneneva,1,1,0,0,16
410523,pathavipavisanañca,pathavipavisananca,1,1,0,0,18
410524,dhammakathikattherassa,dhammakathikattherassa,1,1,0,0,22
410525,dhammakathāniṭṭhāpanañca,dhammakathanitthapananca,1,1,0,0,24
410526,daṭṭhattha,datthattha,1,1,0,0,10
410527,dīghajātikena,dighajatikena,3,3,0,0,13
410528,daṭṭhoti,datthoti,2,2,0,0,8
410529,dīghavāpiyampi,dighavapiyampi,1,1,0,0,14
410530,mahājātakabhāṇakatthero,mahajatakabhanakatthero,1,1,0,0,23
410531,gāthāsahassaṃ,gathasahassam,2,1,1,0,13
410532,mahāvessantaraṃ,mahavessantaram,1,1,0,0,15
410533,tissamahāgāme,tissamahagame,1,1,0,0,13
410534,tissamahāvihāravāsī,tissamahaviharavasi,3,3,0,0,19
410535,navayojanamaggaṃ,navayojanamaggam,1,1,0,0,16
410536,dūramaggāgamanena,duramaggagamanena,1,1,0,0,17
410537,sañjātakāyadarathattā,sanjatakayadarathatta,1,1,0,0,21
410538,paṭṭhānagāthāya,patthanagathaya,1,1,0,0,15
410539,avasānagāthaṃyeva,avasanagathamyeva,1,1,0,0,17
410540,vavatthapesi,vavatthapesi,2,1,1,0,12
410541,āgamanakammaṃ,agamanakammam,2,2,0,0,13
410542,tissamahāvihārā,tissamahavihara,1,1,0,0,15
410543,kāyadarathabhāvena,kayadarathabhavena,1,1,0,0,18
410544,saññāpetha,sannapetha,3,3,0,0,10
410545,kathessāmā,kathessama,9,9,0,0,10
410546,ullakolikaṇṇivāsikā,ullakolikannivasika,1,0,1,0,19
410547,pāyamānā,payamana,2,2,0,0,8
410548,dīghabhāṇakamahāabhayatthero,dighabhanakamahaabhayatthero,2,2,0,0,28
410549,ariyavaṃsapaṭipadaṃ,ariyavamsapatipadam,2,2,0,0,19
410550,divākathikattherassa,divakathikattherassa,2,2,0,0,20
410551,nisinnakāleyeva,nisinnakaleyeva,2,2,0,0,15
410552,ṭhitakāva,thitakava,11,10,1,0,9
410553,sarabhāṇake,sarabhanake,1,1,0,0,11
410554,catupaccayasantosabhāvanārāmamahāariyavaṃsaṃ,catupaccayasantosabhavanaramamahaariyavamsam,1,1,0,0,44
410555,uṭṭhānākāraṃ,utthanakaram,4,3,1,0,12
410556,ariyavaṃsaṃ,ariyavamsam,29,27,2,0,11
410557,siniddhabhojanaṃ,siniddhabhojanam,6,6,0,0,16
410558,madhurapānakaṃ,madhurapanakam,1,1,0,0,14
410559,yaṭṭhimadhukatelādīhi,yatthimadhukateladihi,1,1,0,0,21
410560,yuttaṭṭhāneyeva,yuttatthaneyeva,3,3,0,0,15
410561,bhāvanārāmaṃ,bhavanaramam,5,5,0,0,12
410562,sotāpattiphaluppatti,sotapattiphaluppatti,1,1,0,0,20
410563,kaḷamparavāsikā,kalamparavasika,1,0,1,0,15
410564,dīghajātiko,dighajatiko,2,2,0,0,11
410565,nipannadārakaṃ,nipannadarakam,3,2,1,0,14
410566,vaṭṭantiyā,vattantiya,1,1,0,0,10
410567,carissāmī,carissami,30,30,0,0,9
410568,nimmathetvā,nimmathetva,7,7,0,0,11
410569,atthavasasuttavaṇṇanā,atthavasasuttavannana,3,3,0,0,21
410570,sampassamānenāti,sampassamanenati,5,2,3,0,16
410571,alamevāti,alamevati,10,1,9,0,9
410572,atthappaṭisaṃvedīti,atthappatisamvediti,1,0,1,0,19
410573,dhammappaṭisaṃvedīti,dhammappatisamvediti,1,0,1,0,20
410574,kathāpavattisuttavaṇṇanā,kathapavattisuttavannana,3,3,0,0,24
410575,ṭhānehīti,thanehiti,23,0,23,0,9
410576,pavattinīti,pavattiniti,4,1,3,0,11
410577,appaṭihatā,appatihata,2,1,1,0,10
410578,paṇḍitasuttavaṇṇanā,panditasuttavannana,3,3,0,0,19
410579,paṇḍitapaññattānīti,panditapannattaniti,2,0,2,0,19
410580,sappurisapaññattānīti,sappurisapannattaniti,1,0,1,0,21
410581,ahiṃsāti,ahimsati,6,0,6,0,8
410582,saṃyamoti,samyamoti,20,4,16,0,9
410583,uposathavasena,uposathavasena,6,6,0,0,14
410584,attadamanaṃ,attadamanam,2,1,1,0,11
410585,puṇṇovāde,punnovade,2,1,1,0,9
410586,khantipi,khantipi,2,1,1,0,8
410587,buddhapaccekabuddhaariyasāvakā,buddhapaccekabuddhaariyasavaka,2,2,0,0,30
410588,mātāpituupaṭṭhākā,matapituupatthaka,2,2,0,0,17
410589,brahmacārīnaṃ,brahmacarinam,5,4,1,0,13
410590,upaññātanti,upannatanti,1,1,0,0,11
410591,dassanasampannoti,dassanasampannoti,4,0,4,0,17
410592,pitupaṭṭhānanti,pitupatthananti,2,2,0,0,15
410593,kāraṇānīti,karananiti,13,10,3,0,10
410594,mātāpituupaṭṭhākavasena,matapituupatthakavasena,1,1,0,0,23
410595,mātāpituupaṭṭhākoyeva,matapituupatthakoyeva,1,1,0,0,21
410596,sīlavantasuttavaṇṇanā,silavantasuttavannana,7,7,0,0,21
410597,kāyenātiādīsu,kayenatiadisu,7,0,7,0,13
410598,sammajjanaupalepanādīni,sammajjanaupalepanadini,1,1,0,0,23
410599,paññāpentā,pannapenta,5,5,0,0,10
410600,paccupaṭṭhāpentā,paccupatthapenta,1,1,0,0,16
410601,labhantū,labhantu,9,9,0,0,8
410602,cintentā,cintenta,9,9,0,0,8
410603,saṅkhatalakkhaṇasuttavaṇṇanā,sankhatalakkhanasuttavannana,3,3,0,0,28
410604,saṅkhatassāti,sankhatassati,1,0,1,0,13
410605,saṅkhatalakkhaṇānīti,sankhatalakkhananiti,3,1,2,0,20
410606,sañjānanakāraṇāni,sanjananakaranani,3,3,0,0,17
410607,asammasanūpagattā,asammasanupagatta,3,3,0,0,17
410608,saṅkhatalakkhaṇā,sankhatalakkhana,1,0,1,0,16
410609,bhedakkhaṇe,bhedakkhane,1,1,0,0,11
410610,hatthiassagomahiṃsādīnaṃ,hatthiassagomahimsadinam,1,1,0,0,24
410611,sattisūlādīni,sattisuladini,1,1,0,0,13
410612,sañjānanalakkhaṇāni,sanjananalakkhanani,1,1,0,0,19
410613,lakkhaṇāneva,lakkhananeva,1,1,0,0,12
410614,asukahatthī,asukahatthi,1,1,0,0,11
410615,asukaasso,asukaasso,1,1,0,0,9
410616,asaṅkhatalakkhaṇasuttavaṇṇanā,asankhatalakkhanasuttavannana,3,3,0,0,29
410617,asaṅkhatassāti,asankhatassati,3,1,2,0,14
410618,asaṅkhatalakkhaṇānīti,asankhatalakkhananiti,1,0,1,0,21
410619,paññāyatītiādīhi,pannayatitiadihi,1,0,1,0,16
410620,uppādajarābhaṅgānaṃ,uppadajarabhanganam,1,1,0,0,19
410621,uppādādīnañhi,uppadadinanhi,1,1,0,0,13
410622,pabbatarājasuttavaṇṇanā,pabbatarajasuttavannana,3,3,0,0,23
410623,mahārukkhā,maharukkha,8,7,1,0,10
410624,kulajeṭṭhakaṃ,kulajetthakam,2,1,1,0,13
410625,seloti,seloti,7,1,6,0,6
410626,silāmayo,silamayo,7,6,1,0,8
410627,agāmakaṭṭhāne,agamakatthane,2,1,1,0,13
410628,vanappatīti,vanappatiti,3,2,1,0,11
410629,vanajeṭṭhakā,vanajetthaka,1,1,0,0,12
410630,sugatigāmikamaggasaṅkhātaṃ,sugatigamikamaggasankhatam,1,1,0,0,26
410631,ātappakaraṇīyasuttavaṇṇanā,atappakaraniyasuttavannana,3,3,0,0,26
410632,sādhessāmīti,sadhessamiti,1,1,0,0,12
410633,sarīrasambhavānaṃ,sarirasambhavanam,2,1,1,0,17
410634,dukkhamānaṃ,dukkhamanam,6,5,1,0,11
410635,bahalānaṃ,bahalanam,4,3,1,0,9
410636,tāpanavasena,tapanavasena,1,1,0,0,12
410637,pharusānaṃ,pharusanam,4,4,0,0,10
410638,tikhiṇānaṃ,tikhinanam,3,3,0,0,10
410639,amadhurānaṃ,amadhuranam,4,4,0,0,11
410640,jīvitaharānaṃ,jivitaharanam,4,4,0,0,13
410641,adhivāsanāyāti,adhivasanayati,1,0,1,0,14
410642,adhivāsanatthāya,adhivasanatthaya,1,1,0,0,16
410643,sahanatthāya,sahanatthaya,1,1,0,0,12
410644,khamanatthāya,khamanatthaya,1,1,0,0,13
410645,antakiriyāyāti,antakiriyayati,7,2,5,0,14
410646,paricchedaparivaṭumakiriyāya,paricchedaparivatumakiriyaya,1,1,0,0,28
410647,ātāpādayo,atapadayo,1,1,0,0,9
410648,mahācorasuttavaṇṇanā,mahacorasuttavannana,4,4,0,0,20
410649,mahācoroti,mahacoroti,6,1,5,0,10
410650,balavacoro,balavacoro,2,1,1,0,10
410651,gharasandhiṃ,gharasandhim,6,6,0,0,12
410652,mahāvilopaṃ,mahavilopam,11,9,2,0,11
410653,vilumpanaṃ,vilumpanam,7,7,0,0,10
410654,duggamaṭṭhānaṃ,duggamatthanam,1,1,0,0,14
410655,antaradīpakaṃ,antaradipakam,2,2,0,0,13
410656,nilīyituṃ,niliyitum,8,8,0,0,9
410657,dvattiyojanaṭṭhānaṃ,dvattiyojanatthanam,1,1,0,0,19
410658,saṃsaṭṭhasākhaṃ,samsatthasakham,1,1,0,0,15
410659,bhaṇissantīti,bhanissantiti,1,0,1,0,13
410660,pariyodahitvā,pariyodahitva,1,1,0,0,13
410661,kathayissanti,kathayissanti,5,5,0,0,13
410662,tyāssāti,tyassati,3,0,3,0,8
410663,āraddheyeva,araddheyeva,3,3,0,0,11
410664,kulaparamparāya,kulaparamparaya,6,6,0,0,15
410665,pariyodhāyāti,pariyodhayati,2,0,2,0,13
410666,paṭicchādetvātipi,paticchadetvatipi,1,1,0,0,17
410667,guṇakhananena,gunakhananena,2,2,0,0,13
410668,guṇupaghātena,gunupaghatena,2,2,0,0,13
410669,sampakkhalanaṭṭhena,sampakkhalanatthena,1,1,0,0,19
410670,kāyadvārikakammena,kayadvarikakammena,1,1,0,0,18
410671,vacīmanokammesupi,vacimanokammesupi,1,1,0,0,17
410672,antaggāhikāyāti,antaggahikayati,6,0,6,0,15
410673,ṭhitadiṭṭhiyā,thitaditthiya,2,2,0,0,13
410674,paṭhamadvebrāhmaṇasuttavaṇṇanā,pathamadvebrahmanasuttavannana,3,3,0,0,30
410675,brāhmaṇavaggassa,brahmanavaggassa,2,2,0,0,16
410676,jiṇṇāti,jinnati,7,0,7,0,7
410677,jarājiṇṇā,jarajinna,10,10,0,0,9
410678,vuddhāti,vuddhati,4,0,4,0,8
410679,vayovuddhā,vayovuddha,2,2,0,0,10
410680,mahallakāti,mahallakati,5,0,5,0,11
410681,jātimahallakā,jatimahallaka,5,5,0,0,13
410682,addhagatāti,addhagatati,7,1,6,0,11
410683,vayoanuppattāti,vayoanuppattati,5,0,5,0,15
410684,tenupasaṅkamiṃsūti,tenupasankamimsuti,24,2,22,0,18
410685,niyyānikamaggaṃ,niyyanikamaggam,1,1,0,0,15
410686,gavesissāmā,gavesissama,1,1,0,0,11
410687,nāmaccā,namacca,1,1,0,0,7
410688,gahapatikāti,gahapatikati,5,3,2,0,12
410689,jiṇṇātiādimāhaṃsu,jinnatiadimahamsu,1,0,1,0,17
410690,akatabhīruttāṇāti,akatabhiruttanati,1,0,1,0,17
410691,akatabhayaparittāṇā,akatabhayaparittana,2,2,0,0,19
410692,avassayabhūtaṃ,avassayabhutam,1,1,0,0,14
410693,patiṭṭhākammaṃ,patitthakammam,2,1,1,0,14
410694,tagghāti,tagghati,20,0,20,0,8
410695,sampaṭicchāmīti,sampaticchamiti,3,3,0,0,15
410696,upasaṃharīyati,upasamhariyati,1,1,0,0,14
410697,upanīyatī,upaniyati,5,4,1,0,9
410698,saṃyamotiādimāha,samyamotiadimaha,1,0,1,0,16
410699,petassāti,petassati,2,0,2,0,9
410700,avassayanaṭṭhena,avassayanatthena,1,1,0,0,16
410701,uttamagativasena,uttamagativasena,1,1,0,0,16
410702,parāyaṇañca,parayananca,12,10,2,0,11
410703,dutiyadvebrāhmaṇasuttavaṇṇanā,dutiyadvebrahmanasuttavannana,3,3,0,0,29
410704,aññatarabrāhmaṇasuttavaṇṇanā,annatarabrahmanasuttavannana,4,4,0,0,28
410705,sammodajananiṃ,sammodajananim,1,1,0,0,14
410706,saritabbayuttakaṃ,saritabbayuttakam,4,3,1,0,17
410707,vītisāretvāti,vitisaretvati,3,0,3,0,13
410708,kittāvatāti,kittavatati,9,0,9,0,11
410709,phaladāyako,phaladayako,6,6,0,0,11
410710,ehipassikoti,ehipassikoti,1,0,1,0,12
410711,āgamanīyapaṭipadaṃ,agamaniyapatipadam,6,6,0,0,18
410712,pariyādinnacittoti,pariyadinnacittoti,4,0,4,0,18
410713,ādinnagahitaparāmaṭṭhacitto,adinnagahitaparamatthacitto,1,1,0,0,27
410714,paribbājakasuttavaṇṇanā,paribbajakasuttavannana,4,4,0,0,23
410715,brāhmaṇaparibbājakoti,brahmanaparibbajakoti,1,0,1,0,21
410716,brāhmaṇajātiko,brahmanajatiko,8,8,0,0,14
410717,khattiyādijātiko,khattiyadijatiko,1,1,0,0,16
410718,attatthampīti,attatthampiti,1,0,1,0,13
410719,diṭṭhadhammikasamparāyikaṃ,ditthadhammikasamparayikam,16,14,2,0,26
410720,nibbutasuttavaṇṇanā,nibbutasuttavannana,3,3,0,0,19
410721,palokasuttavaṇṇanā,palokasuttavannana,3,3,0,0,18
410722,ācariyānañceva,acariyananceva,3,3,0,0,14
410723,ācariyācariyānañca,acariyacariyananca,3,3,0,0,18
410724,nirantaraphuṭo,nirantaraphuto,2,1,1,0,14
410725,nerayikasattehi,nerayikasattehi,3,2,1,0,15
410726,kukkuṭasaṃpātikāti,kukkutasampatikati,1,0,1,0,18
410727,ekagāmassa,ekagamassa,2,2,0,0,10
410728,chadanapiṭṭhito,chadanapitthito,1,1,0,0,15
410729,itaragāmassa,itaragamassa,2,2,0,0,12
410730,chadanapiṭṭhe,chadanapitthe,6,6,0,0,13
410731,patanasaṅkhāto,patanasankhato,2,2,0,0,14
410732,kukkuṭasaṃpāto,kukkutasampato,1,1,0,0,14
410733,kukkuṭasaṃpādikātipi,kukkutasampadikatipi,1,1,0,0,20
410734,gāmantarato,gamantarato,7,7,0,0,11
410735,kukkuṭānaṃ,kukkutanam,8,8,0,0,10
410736,gamanasaṅkhāto,gamanasankhato,2,2,0,0,14
410737,kukkuṭasaṃpādo,kukkutasampado,1,1,0,0,14
410738,ghananivāsataṃyeva,ghananivasatamyeva,2,2,0,0,18
410739,adhammarāgarattāti,adhammaragarattati,1,0,1,0,18
410740,adhammarāgoti,adhammaragoti,4,2,2,0,13
410741,paraparikkhāresu,paraparikkharesu,3,3,0,0,16
410742,visamalobhābhibhūtāti,visamalobhabhibhutati,1,0,1,0,21
410743,visamova,visamova,1,1,0,0,8
410744,pariggahitavatthumhi,pariggahitavatthumhi,2,2,0,0,20
410745,samalobho,samalobho,2,1,1,0,9
410746,parapariggahitavatthumhi,parapariggahitavatthumhi,1,1,0,0,24
410747,visamoti,visamoti,9,6,3,0,8
410748,micchādhammaparetāti,micchadhammaparetati,1,0,1,0,20
410749,avatthupaṭisevanasaṅkhātena,avatthupatisevanasankhatena,1,1,0,0,27
410750,micchādhammena,micchadhammena,1,1,0,0,14
410751,anuppavecchatīti,anuppavecchatiti,5,0,5,0,16
410752,vassitabbayutte,vassitabbayutte,1,1,0,0,15
410753,vividhasassānaṃ,vividhasassanam,2,1,1,0,15
410754,asampajjanena,asampajjanena,1,1,0,0,13
410755,daṭṭhattā,datthatta,2,2,0,0,9
410756,nikkhantanikkhantāni,nikkhantanikkhantani,1,1,0,0,20
410757,setavaṇṇāni,setavannani,1,1,0,0,11
410758,vapitaṃ,vapitam,7,7,0,0,7
410759,salākāmattameva,salakamattameva,4,3,1,0,15
410760,caṇḍayakkhe,candayakkhe,1,1,0,0,11
410761,vacchagottasuttavaṇṇanā,vacchagottasuttavannana,3,3,0,0,23
410762,mahāvipākaṃ,mahavipakam,15,14,1,0,11
410763,byākarontīti,byakarontiti,13,3,10,0,12
410764,anudhammo,anudhammo,28,20,8,0,9
410765,paṭikathanaṃ,patikathanam,2,2,0,0,12
410766,sahadhammikoti,sahadhammikoti,9,0,9,0,14
410767,sakāraṇo,sakarano,21,18,3,0,8
410768,vādānupātoti,vadanupatoti,3,0,3,0,12
410769,anupāto,anupato,3,2,1,0,7
410770,anupatanaṃ,anupatanam,4,4,0,0,10
410771,garahitabbayuttaṃ,garahitabbayuttam,1,1,0,0,17
410772,vādappavatti,vadappavatti,4,3,1,0,12
410773,kicchalābhakaṃ,kicchalabhakam,1,1,0,0,14
410774,vilomakaṃ,vilomakam,1,1,0,0,9
410775,pāripanthikoti,paripanthikoti,1,0,1,0,14
410776,panthadūhanacoro,panthaduhanacoro,2,1,1,0,16
410777,upahatoti,upahatoti,2,0,2,0,9
410778,guṇupaghāteneva,gunupaghateneva,1,1,0,0,15
410779,candanikāyāti,candanikayati,1,0,1,0,13
410780,asucikalalakūpe,asucikalalakupe,1,1,0,0,15
410781,oligalleti,oligalleti,1,0,1,0,10
410782,niddhamanakalale,niddhamanakalale,1,1,0,0,16
410783,vuttakhīṇāsavo,vuttakhinasavo,1,1,0,0,14
410784,sīlakkhandhenāti,silakkhandhenati,7,1,6,0,16
410785,sīlarāsinā,silarasina,3,3,0,0,10
410786,asekkhanti,asekkhanti,4,4,0,0,10
410787,sikkhāpariyosānappattatāya,sikkhapariyosanappattataya,1,1,0,0,26
410788,asekkhāneva,asekkhaneva,1,1,0,0,11
410789,rohiṇīsūti,rohinisuti,1,0,1,0,10
410790,rattavaṇṇāsu,rattavannasu,1,1,0,0,12
410791,sarūpāsūti,sarupasuti,1,0,1,0,10
410792,vacchakehi,vacchakehi,1,1,0,0,10
410793,samānarūpāsu,samanarupasu,1,1,0,0,12
410794,pārevatāsūti,parevatasuti,1,0,1,0,12
410795,kapotavaṇṇāsu,kapotavannasu,1,1,0,0,13
410796,dantoti,dantoti,18,3,15,0,7
410797,nibbisevano,nibbisevano,18,18,0,0,11
410798,dhorayhoti,dhorayhoti,1,0,1,0,10
410799,dhuravāho,dhuravaho,2,2,0,0,9
410800,kalyāṇajavanikkamoti,kalyanajavanikkamoti,1,0,1,0,20
410801,ujunā,ujuna,5,5,0,0,5
410802,parikkhareti,parikkhareti,1,0,1,0,12
410803,dhuravahanakammameva,dhuravahanakammameva,1,1,0,0,20
410804,jātiyeti,jatiyeti,1,0,1,0,8
410805,kulajāte,kulajate,2,1,1,0,8
410806,khattiyādippabhedāsu,khattiyadippabhedasu,1,1,0,0,20
410807,kevalīti,kevaliti,15,2,13,0,8
410808,paripuṇṇabhāvena,paripunnabhavena,2,1,1,0,16
410809,sakalabrahmacārī,sakalabrahmacari,1,1,0,0,16
410810,pannabhāroti,pannabharoti,9,1,8,0,12
410811,oropitabhāro,oropitabharo,2,2,0,0,12
410812,khandhabhāraṃ,khandhabharam,12,11,1,0,13
410813,kilesabhāraṃ,kilesabharam,3,3,0,0,12
410814,kāmaguṇabhārañca,kamagunabharanca,1,1,0,0,16
410815,katakiccoti,katakiccoti,1,0,1,0,11
410816,abhiññāpāraṃ,abhinnaparam,3,2,1,0,12
410817,pariññāpāraṃ,parinnaparam,1,1,0,0,12
410818,pahānapāraṃ,pahanaparam,1,1,0,0,11
410819,bhāvanāpāraṃ,bhavanaparam,1,1,0,0,12
410820,sacchikiriyāpāraṃ,sacchikiriyaparam,1,1,0,0,17
410821,samāpattipārañcāti,samapattiparancati,1,1,0,0,18
410822,anupādāyāti,anupadayati,9,0,9,0,11
410823,kilesasantāparahito,kilesasantaparahito,1,1,0,0,19
410824,virajeti,virajeti,1,0,1,0,8
410825,rāgadosamoharajarahite,ragadosamoharajarahite,1,1,0,0,22
410826,avijānantāti,avijanantati,2,0,2,0,12
410827,dummedhāti,dummedhati,7,0,7,0,10
410828,assutāvinoti,assutavinoti,2,0,2,0,12
410829,khettavinicchayasavanena,khettavinicchayasavanena,2,2,0,0,24
410830,upāsareti,upasareti,3,0,3,0,9
410831,buddhapaccekabuddhakhīṇāsave,buddhapaccekabuddhakhinasave,3,3,0,0,28
410832,uttamapurise,uttamapurise,1,1,0,0,12
410833,dhīrasammateti,dhirasammateti,1,0,1,0,14
410834,sambhāvite,sambhavite,4,3,1,0,10
410835,khattiyabrāhmaṇavessakule,khattiyabrahmanavessakule,1,1,0,0,25
410836,kulasampatti,kulasampatti,1,1,0,0,12
410837,sīlasamādhipaññāti,silasamadhipannati,1,1,0,0,18
410838,tikaṇṇasuttavaṇṇanā,tikannasuttavannana,3,3,0,0,19
410839,tikaṇṇoti,tikannoti,1,0,1,0,9
410840,sammukhāti,sammukhati,14,0,14,0,10
410841,akathente,akathente,16,16,0,0,9
410842,samāgamaṭṭhāne,samagamatthane,7,7,0,0,14
410843,vacanamattampi,vacanamattampi,7,7,0,0,14
410844,ghaṭṭessāmīti,ghattessamiti,2,2,0,0,13
410845,tevijjakabrāhmaṇā,tevijjakabrahmana,1,1,0,0,17
410846,evaṃpaṇḍitā,evampandita,1,1,0,0,11
410847,evaṃdhīrā,evamdhira,1,1,0,0,9
410848,evaṃbyattā,evambyatta,1,1,0,0,10
410849,evaṃbahussutā,evambahussuta,1,1,0,0,13
410850,evaṃsammatāti,evamsammatati,1,1,0,0,13
410851,paṇḍitādiākāraparicchedaṃ,panditadiakaraparicchedam,2,1,1,0,25
410852,sammatāti,sammatati,27,21,6,0,9
410853,jānanaṭṭhāneyeva,jananatthaneyeva,3,3,0,0,16
410854,ajānanaṭṭhāne,ajananatthane,2,2,0,0,13
410855,gotamātiādimāha,gotamatiadimaha,4,0,4,0,15
410856,ubhatoti,ubhatoti,9,0,9,0,8
410857,saṃsuddhagahaṇikoti,samsuddhagahanikoti,7,1,6,0,19
410858,saṃsuddhā,samsuddha,8,7,1,0,9
410859,kucchīti,kucchiti,4,3,1,0,8
410860,gahaṇīti,gahaniti,3,2,1,0,8
410861,pitāmahayugāti,pitamahayugati,9,0,9,0,14
410862,abhilāpamattameva,abhilapamattameva,8,8,0,0,17
410863,pitāmahoyeva,pitamahoyeva,8,7,1,0,12
410864,pitāmahaggahaṇeneva,pitamahaggahaneneva,14,11,3,0,19
410865,akkhittoti,akkhittoti,12,0,12,0,10
410866,anavakkhitto,anavakkhitto,6,6,0,0,12
410867,anupakkuṭṭhoti,anupakkutthoti,4,0,4,0,14
410868,upakkuṭṭho,upakkuttho,5,5,0,0,10
410869,pattapubbo,pattapubbo,4,4,0,0,10
410870,ajjhāyakāteva,ajjhayakateva,1,1,0,0,13
410871,irubbedayajubbedasāmabbedānaṃ,irubbedayajubbedasamabbedanam,1,1,0,0,29
410872,oṭṭhapahatakaraṇavasena,otthapahatakaranavasena,5,4,1,0,23
410873,nighaṇḍunā,nighanduna,8,8,0,0,10
410874,keṭubhena,ketubhena,9,9,0,0,9
410875,nighaṇḍūti,nighanduti,10,1,9,0,10
410876,nāmanighaṇḍurukkhādīnaṃ,namanighandurukkhadinam,3,3,0,0,23
410877,vevacanapakāsakasatthaṃ,vevacanapakasakasattham,1,1,0,0,23
410878,kiriyākappavikappo,kiriyakappavikappo,14,10,4,0,18
410879,akkharappabhedena,akkharappabhedena,5,5,0,0,17
410880,akkharappabhedoti,akkharappabhedoti,5,0,5,0,17
410881,khattavijjāsaṅkhāto,khattavijjasankhato,1,1,0,0,19
410882,tadavasesañca,tadavasesanca,6,6,0,0,13
410883,vitaṇḍavādasatthaṃ,vitandavadasattham,4,4,0,0,18
410884,mahāpurisānaṃ,mahapurisanam,17,17,0,0,13
410885,lakkhaṇadīpakaṃ,lakkhanadipakam,5,4,1,0,15
410886,dvādasasahassaganthapamāṇaṃ,dvadasasahassaganthapamanam,3,2,1,0,27
410887,soḷasasahassagāthāpadaparimāṇā,solasasahassagathapadaparimana,2,2,0,0,30
410888,buddhamantā,buddhamanta,7,5,2,0,11
410889,aggupaṭṭhākā,aggupatthaka,3,3,0,0,12
410890,anūno,anuno,21,19,2,0,5
410891,ukāralopo,ukaralopo,4,4,0,0,9
410892,paripuṇṇasippoti,paripunnasippoti,3,3,0,0,16
410893,āyācantaṃ,ayacantam,1,1,0,0,9
410894,āyācasi,ayacasi,1,1,0,0,7
410895,anupadavaṇṇanā,anupadavannana,8,8,0,0,14
410896,vitthāritova,vittharitova,10,9,1,0,12
410897,aviditakaraṇaṭṭhena,aviditakaranatthena,7,7,0,0,19
410898,tappaṭicchādako,tappaticchadako,2,2,0,0,15
410899,paṭicchādakaṭṭhena,paticchadakatthena,7,5,2,0,18
410900,obhāsakaraṇaṭṭhena,obhasakaranatthena,5,5,0,0,18
410901,adhigatavijjassa,adhigatavijjassa,6,6,0,0,16
410902,avippavāsena,avippavasena,13,12,1,0,12
410903,vīriyātāpena,viriyatapena,10,8,2,0,12
410904,anapekkhatāya,anapekkhataya,23,22,1,0,13
410905,pesitattassāti,pesitattassati,6,3,3,0,14
410906,vihaññeyya,vihanneyya,12,12,0,0,10
410907,P2.0263,P2.0263,12,12,0,0,7
410908,padhānānuyogassa,padhananuyogassa,5,5,0,0,16
410909,anurūpameva,anurupameva,14,14,0,0,11
410910,cutūpapātakathāyaṃ,cutupapatakathayam,2,2,0,0,18
410911,dibbacakkhuñāṇavijjā,dibbacakkhunanavijja,5,5,0,0,20
410912,cutipaṭisandhippaṭicchādikā,cutipatisandhippaticchadika,1,1,0,0,27
410913,āsavavināsanato,asavavinasanato,3,3,0,0,15
410914,apavattiṃ,apavattim,1,1,0,0,9
410915,jātītiādīni,jatitiadini,2,2,0,0,11
410916,vāyāmābhāvato,vayamabhavato,14,9,5,0,13
410917,ekacatupañcavokārabhavesu,ekacatupancavokarabhavesu,12,12,0,0,25
410918,ekacatupañcakkhandhappabhedā,ekacatupancakkhandhappabheda,9,9,0,0,28
410919,kilesābhāve,kilesabhave,10,10,0,0,11
410920,āyatiappaṭisandhikaṃ,ayatiappatisandhikam,1,1,0,0,20
410921,parivutthaṃ,parivuttham,13,10,3,0,11
410922,pariññāpahānasacchikiriyābhāvanābhisamayavasena,parinnapahanasacchikiriyabhavanabhisamayavasena,7,7,0,0,47
410923,itthabhāvāya,itthabhavaya,11,11,0,0,12
410924,soḷasavidhakiccabhāvāya,solasavidhakiccabhavaya,2,2,0,0,23
410925,itthabhāvato,itthabhavato,13,8,5,0,12
410926,vattamānakkhandhasantānā,vattamanakkhandhasantana,9,9,0,0,24
410927,chinnamūlakā,chinnamulaka,22,18,4,0,12
410928,carimakaviññāṇanirodhena,carimakavinnananirodhena,7,7,0,0,24
410929,nibbāyissantīti,nibbayissantiti,5,5,0,0,15
410930,arahattamaggañāṇavijjā,arahattamaggananavijja,4,4,0,0,22
410931,catusaccappaṭicchādikā,catusaccappaticchadika,3,3,0,0,22
410932,anuccāvacasīlassāti,anuccavacasilassati,1,0,1,0,19
410933,uccāvacasīlo,uccavacasilo,1,1,0,0,12
410934,ekantavaḍḍhitameva,ekantavaddhitameva,1,1,0,0,18
410935,anuccāvacasīlo,anuccavacasilo,1,1,0,0,14
410936,suṭṭhapitaṃ,sutthapitam,3,3,0,0,11
410937,dhitisampannaṃ,dhitisampannam,7,6,1,0,14
410938,catusaccabuddhaṃ,catusaccabuddham,4,3,1,0,16
410939,sabbapacchimasarīradhārinaṃ,sabbapacchimasariradharinam,1,1,0,0,27
410940,gotamagottaṃ,gotamagottam,7,6,1,0,12
410941,namassantīti,namassantiti,20,9,11,0,12
410942,pubbenivutthakkhandhaparamparaṃ,pubbenivutthakkhandhaparamparam,1,1,0,0,31
410943,yovetīti,yovetiti,1,0,1,0,8
410944,yovedītipi,yoveditipi,1,1,0,0,10
410945,abhiññāvositoti,abhinnavositoti,4,0,4,0,15
410946,kiccavosānena,kiccavosanena,2,2,0,0,13
410947,moneyyena,moneyyena,2,1,1,0,9
410948,niddiṭṭhāhi,nidditthahi,1,1,0,0,11
410949,pubbenivāsañāṇādīhi,pubbenivasananadihi,2,2,0,0,19
410950,panañño,pananno,8,8,0,0,7
410951,lapitavacanamattameva,lapitavacanamattameva,1,1,0,0,21
410952,attapaccakkhato,attapaccakkhato,7,6,1,0,15
410953,kathentamevāhaṃ,kathentamevaham,1,1,0,0,15
410954,jāṇussoṇisuttavaṇṇanā,janussonisuttavannana,7,7,0,0,21
410955,yassassūti,yassassuti,1,0,1,0,10
410956,yaññotiādīsu,yannotiadisu,1,0,1,0,12
410957,thālipākoti,thalipakoti,1,0,1,0,11
410958,varapurisānaṃ,varapurisanam,2,1,1,0,13
410959,dātabbayuttaṃ,databbayuttam,1,1,0,0,13
410960,saṅgāravasuttavaṇṇanā,sangaravasuttavannana,15,15,0,0,21
410961,saṅgāravoti,sangaravoti,1,0,1,0,11
410962,jiṇṇapaṭisaṅkharaṇakārako,jinnapatisankharanakarako,2,1,1,0,25
410963,āyuttakabrāhmaṇo,ayuttakabrahmano,1,1,0,0,16
410964,mayamassūti,mayamassuti,1,0,1,0,11
410965,yajāmāti,yajamati,1,0,1,0,8
410966,sabbacatukkena,sabbacatukkena,9,9,0,0,14
410967,sabbaṭṭhakena,sabbatthakena,1,1,0,0,13
410968,sabbasoḷasakena,sabbasolasakena,1,1,0,0,15
410969,sabbadvattiṃsāya,sabbadvattimsaya,1,1,0,0,16
410970,sabbacatusaṭṭhiyā,sabbacatusatthiya,1,1,0,0,17
410971,sabbapañcasatenāti,sabbapancasatenati,1,1,0,0,18
410972,pāṇaghātapaṭisaṃyutto,panaghatapatisamyutto,1,1,0,0,21
410973,anekasarīrasambhavaṃ,anekasarirasambhavam,1,1,0,0,20
410974,yajanakāraṇā,yajanakarana,1,1,0,0,12
410975,yājanakāraṇā,yajanakarana,1,1,0,0,12
410976,dadantepi,dadantepi,1,1,0,0,9
410977,dāpentepi,dapentepi,1,1,0,0,9
410978,dentesupi,dentesupi,3,3,0,0,9
410979,dāpentesupi,dapentesupi,1,1,0,0,11
410980,puññapaṭipadā,punnapatipada,2,2,0,0,13
410981,yajāmīti,yajamiti,1,1,0,0,8
410982,vadantassāpi,vadantassapi,17,17,0,0,12
410983,yajāhīti,yajahiti,1,1,0,0,8
410984,āṇāpentassāpi,anapentassapi,1,1,0,0,13
410985,anekasārīrikāva,anekasaririkava,1,1,0,0,15
410986,indriyadamanavasena,indriyadamanavasena,1,1,0,0,19
410987,rāgādisamanavasena,ragadisamanavasena,1,1,0,0,18
410988,parinibbāpetīti,parinibbapetiti,1,0,1,0,15
410989,rāgādiparinibbāneneva,ragadiparinibbaneneva,1,1,0,0,21
410990,pasughātakasaṃyuttaṃ,pasughatakasamyuttam,1,1,0,0,20
410991,puññapaṭipadaṃ,punnapatipadam,1,1,0,0,14
410992,puññuppattipaṭipadaṃ,punnuppattipatipadam,1,1,0,0,20
410993,ekasārīrikanti,ekasaririkanti,1,1,0,0,14
410994,ekasārīrikañca,ekasaririkanca,1,1,0,0,14
410995,anekasārīrikañca,anekasaririkanca,1,1,0,0,16
410996,uppajjatītiādi,uppajjatitiadi,2,0,2,0,14
410997,arahattamaggasaṅkhātassa,arahattamaggasankhatassa,1,1,0,0,24
410998,uttamapatiṭṭhābhūtaṃ,uttamapatitthabhutam,1,1,0,0,20
410999,appaṭṭhatarāti,appatthatarati,1,0,1,0,14
411000,veyyāvaccakarehi,veyyavaccakarehi,8,8,0,0,16
411001,appasamārambhatarāti,appasamarambhatarati,1,0,1,0,20
411002,kammacchedavasena,kammacchedavasena,2,2,0,0,17
411003,pīḷāsaṅkhāto,pilasankhato,4,3,1,0,12
411004,pujjāti,pujjati,2,1,1,0,7
411005,kathāpetukāmo,kathapetukamo,12,12,0,0,13
411006,padussanako,padussanako,1,1,0,0,11
411007,akathetukāmo,akathetukamo,4,4,0,0,12
411008,saṃsādetīti,samsadetiti,1,0,1,0,11
411009,saṃsīdāpeti,samsidapeti,3,3,0,0,11
411010,vihesato,vihesato,2,2,0,0,8
411011,akathento,akathento,5,5,0,0,9
411012,ānandopi,anandopi,4,4,0,0,8
411013,akathentaṃ,akathentam,3,3,0,0,10
411014,kathāpento,kathapento,3,3,0,0,10
411015,nvajjāti,nvajjati,2,0,2,0,8
411016,khvajjāti,khvajjati,2,0,2,0,9
411017,uppādessāmā,uppadessama,5,5,0,0,11
411018,soppena,soppena,1,1,0,0,7
411019,vītināmentī,vitinamenti,10,10,0,0,11
411020,pāṭihāriyānīti,patihariyaniti,2,0,2,0,14
411021,ijjhanavasena,ijjhanavasena,2,2,0,0,13
411022,paṭiharaṇavasena,patiharanavasena,2,2,0,0,16
411023,āgatanimittena,agatanimittena,5,5,0,0,14
411024,gatanimittena,gatanimittena,3,3,0,0,13
411025,ṭhitanimittena,thitanimittena,3,3,0,0,14
411026,pakkhantā,pakkhanta,10,10,0,0,9
411027,athāvidūre,athavidure,1,1,0,0,10
411028,gataṭhitanimittehipi,gatathitanimittehipi,1,1,0,0,20
411029,kāmavitakkādisaṃyutto,kamavitakkadisamyutto,1,1,0,0,21
411030,cintayamānaṃ,cintayamanam,6,4,2,0,12
411031,yakkhapisācādīnaṃ,yakkhapisacadinam,4,3,1,0,17
411032,cātumahārājikādīnaṃ,catumaharajikadinam,7,7,0,0,19
411033,itiādisati,itiadisati,1,1,0,0,10
411034,vinicchayasabhāyaṃ,vinicchayasabhayam,2,2,0,0,18
411035,rājamahāmattānañca,rajamahamattananca,4,4,0,0,18
411036,aṭṭakārakena,attakarakena,1,1,0,0,12
411037,niccharantaṃ,niccharantam,3,3,0,0,12
411038,aṭṭakammenāti,attakammenati,1,1,0,0,13
411039,jayameva,jayameva,1,1,0,0,8
411040,moḷiyagāme,moliyagame,2,2,0,0,10
411041,caritthā,carittha,3,3,0,0,8
411042,paṇihitāti,panihitati,4,0,4,0,10
411043,suṭṭhapitā,sutthapita,9,8,1,0,10
411044,vitakkayissati,vitakkayissati,3,3,0,0,14
411045,pavattayissatīti,pavattayissatiti,2,2,0,0,16
411046,kasiṇaparikammakāleyeva,kasinaparikammakaleyeva,3,3,0,0,23
411047,yenākārenesa,yenakarenesa,3,3,0,0,12
411048,kasiṇabhāvanaṃ,kasinabhavanam,3,3,0,0,14
411049,nibbattessatī,nibbattessati,3,3,0,0,13
411050,paṭhamavipassanāya,pathamavipassanaya,2,2,0,0,18
411051,āraddhāyayeva,araddhayayeva,1,1,0,0,13
411052,nibbattessati,nibbattessati,6,6,0,0,13
411053,vitakkessati,vitakkessati,6,6,0,0,12
411054,ariyesupi,ariyesupi,3,3,0,0,9
411055,sotāpattiphalasamāpattiṃ,sotapattiphalasamapattim,4,4,0,0,24
411056,arahattaphalasamāpattiṃ,arahattaphalasamapattim,12,12,0,0,23
411057,tatravattiyeva,tatravattiyeva,1,1,0,0,14
411058,cetopariyañāṇavasena,cetopariyananavasena,3,3,0,0,20
411059,ñātañhi,natanhi,3,3,0,0,7
411060,vitakkethāti,vitakkethati,5,1,4,0,12
411061,vitakkayitthāti,vitakkayitthati,5,0,5,0,15
411062,aniccasaññameva,aniccasannameva,6,3,3,0,15
411063,dukkhasaññādīsu,dukkhasannadisu,3,3,0,0,15
411064,pañcakāmaguṇarāgaṃ,pancakamagunaragam,2,1,1,0,18
411065,catumaggaphalappabhedaṃ,catumaggaphalappabhedam,3,3,0,0,23
411066,lokuttaradhammameva,lokuttaradhammameva,6,5,1,0,19
411067,samānakāraṇajātikaṃ,samanakaranajatikam,1,1,0,0,19
411068,māyākāropi,mayakaropi,1,1,0,0,10
411069,tathārūpamevāti,tatharupamevati,1,1,0,0,15
411070,cintāmaṇikavijjāsarikkhakataṃ,cintamanikavijjasarikkhakatam,2,1,1,0,29
411071,cintāmaṇikavijjaṃ,cintamanikavijjam,1,1,0,0,17
411072,āgacchantameva,agacchantameva,7,7,0,0,14
411073,abhikkantataraṃ,abhikkantataram,5,0,5,0,15
411074,uttamataraṃ,uttamataram,6,6,0,0,11
411075,bāhirakanti,bahirakanti,1,1,0,0,11
411076,kathentoyeva,kathentoyeva,9,9,0,0,12
411077,upanītā,upanita,19,18,1,0,7
411078,titthāyatanasuttavaṇṇanā,titthayatanasuttavannana,3,3,0,0,24
411079,titthikarā,titthikara,1,1,0,0,10
411080,samosaraṇamānāpi,samosaranamanapi,1,1,0,0,16
411081,sañjātiādinā,sanjatiadina,2,2,0,0,12
411082,samanuyuñjiyamānānīti,samanuyunjiyamananiti,1,0,1,0,21
411083,nāmetā,nameta,20,20,0,0,6
411084,diṭṭhiyoti,ditthiyoti,13,5,8,0,10
411085,pucchiyamānāni,pucchiyamanani,1,1,0,0,14
411086,samanugāhiyamānānīti,samanugahiyamananiti,1,0,1,0,20
411087,anuggāhiyamānāni,anuggahiyamanani,1,1,0,0,16
411088,samanubhāsiyamānānīti,samanubhasiyamananiti,1,0,1,0,21
411089,paṭinissajjetha,patinissajjetha,1,1,0,0,15
411090,diṭṭhigatānīti,ditthigataniti,10,3,7,0,14
411091,anusāsiyamānāni,anusasiyamanani,1,1,0,0,15
411092,anuyogapucchāvevacanāneva,anuyogapucchavevacananeva,1,1,0,0,25
411093,samanuggāhatīti,samanuggahatiti,1,1,0,0,15
411094,samanubhāsatīti,samanubhasatiti,2,1,1,0,15
411095,laddhiparamparā,laddhiparampara,1,1,0,0,15
411096,attabhāvaparamparāti,attabhavaparamparati,1,1,0,0,20
411097,paramparaṃ,paramparam,16,12,4,0,10
411098,akiriyamatte,akiriyamatte,1,1,0,0,12
411099,saṃtiṭṭhanti,samtitthanti,1,1,0,0,12
411100,pubbekatavādī,pubbekatavadi,5,5,0,0,13
411101,issaranimmānavādī,issaranimmanavadi,3,3,0,0,17
411102,ahetuapaccayavādī,ahetuapaccayavadi,3,3,0,0,17
411103,pubbekataladdhiko,pubbekataladdhiko,1,1,0,0,17
411104,ahetuapaccayaladdhiko,ahetuapaccayaladdhiko,1,1,0,0,21
411105,laddhiparamparaṃ,laddhiparamparam,1,1,0,0,16
411106,pācariyassa,pacariyassa,1,1,0,0,11
411107,ācariyapācariyassa,acariyapacariyassa,1,1,0,0,18
411108,attabhāvaparamparaṃ,attabhavaparamparam,1,1,0,0,19
411109,suvidūrampi,suvidurampi,2,2,0,0,11
411110,akiriyamatteyeva,akiriyamatteyeva,1,1,0,0,16
411111,pubbekatakāraṇā,pubbekatakarana,1,1,0,0,15
411112,pubbekatakammapaccayeneva,pubbekatakammapaccayeneva,1,1,0,0,25
411113,vipākavedanaṃyeva,vipakavedanamyeva,1,1,0,0,17
411114,yepime,yepime,7,7,0,0,6
411115,kammarāsayo,kammarasayo,1,1,0,0,11
411116,aparapariyāyakammaṃyeva,aparapariyayakammamyeva,1,1,0,0,23
411117,diṭṭhadhammavedanīyo,ditthadhammavedaniyo,1,1,0,0,20
411118,upapajjavedanīyo,upapajjavedaniyo,1,1,0,0,16
411119,aparapariyāyavedanīyoti,aparapariyayavedaniyoti,1,1,0,0,23
411120,vipākarāsayo,vipakarasayo,1,1,0,0,12
411121,aparapariyāyavipākameva,aparapariyayavipakameva,1,1,0,0,23
411122,kiriyacetanāti,kiriyacetanati,1,1,0,0,14
411123,cetanārāsayo,cetanarasayo,1,1,0,0,12
411124,pubbekatena,pubbekatena,2,2,0,0,11
411125,ahetuapaccayā,ahetuapaccaya,3,3,0,0,13
411126,paṭisaṃvedituṃ,patisamveditum,2,2,0,0,14
411127,issaranimmānakāraṇāyeva,issaranimmanakaranayeva,1,1,0,0,23
411128,rogesu,rogesu,3,3,0,0,6
411129,kammarāsīsu,kammarasisu,1,1,0,0,11
411130,vipākarāsīsu,vipakarasisu,1,1,0,0,12
411131,cetanārāsīsu,cetanarasisu,1,1,0,0,12
411132,ahetuapaccayāti,ahetuapaccayati,1,0,1,0,15
411133,issaranimmānahetunā,issaranimmanahetuna,2,2,0,0,19
411134,ahetuapaccayāyeva,ahetuapaccayayeva,1,1,0,0,17
411135,rogādīsu,rogadisu,1,1,0,0,8
411136,laddhiñhi,laddhinhi,1,1,0,0,9
411137,appatiṭṭhāpetvā,appatitthapetva,1,1,0,0,15
411138,niggayhamānā,niggayhamana,4,3,1,0,12
411139,pubbekatavādaṃ,pubbekatavadam,2,2,0,0,14
411140,vadāmātiādīni,vadamatiadini,1,1,0,0,13
411141,patiṭṭhāpitāya,patitthapitaya,3,3,0,0,14
411142,saṅkamituṃ,sankamitum,3,3,0,0,10
411143,suniggahitā,suniggahita,1,1,0,0,11
411144,tenahāyasmantoti,tenahayasmantoti,1,0,1,0,16
411145,pubbekatahetuyeva,pubbekatahetuyeva,3,2,1,0,17
411146,viramantāpi,viramantapi,1,1,0,0,11
411147,viramissantīti,viramissantiti,7,7,0,0,14
411148,adinnādāyinotiādīsupi,adinnadayinotiadisupi,1,0,1,0,21
411149,sārabhāvena,sarabhavena,6,6,0,0,11
411150,akaraṇatthāya,akaranatthaya,14,14,0,0,13
411151,paccattapurisakāro,paccattapurisakaro,6,4,2,0,18
411152,chandavāyāmesu,chandavayamesu,1,1,0,0,14
411153,anupalabbhiyamāneti,anupalabbhiyamaneti,3,2,1,0,19
411154,apaññāyamāne,apannayamane,3,3,0,0,12
411155,viramituṃ,viramitum,14,13,1,0,9
411156,karaṇīyākaraṇīyaṃ,karaniyakaraniyam,4,3,1,0,17
411157,naṭṭhassatīnaṃ,natthassatinam,1,1,0,0,14
411158,vissaṭṭhassatīnaṃ,vissatthassatinam,1,1,0,0,17
411159,nirārakkhānaṃ,nirarakkhanam,1,1,0,0,13
411160,samaṇavādoti,samanavadoti,1,0,1,0,12
411161,pubbekatakāraṇāyeva,pubbekatakaranayeva,4,3,1,0,19
411162,assamaṇāpi,assamanapi,3,2,1,0,10
411163,pubbekatakāraṇāyevāti,pubbekatakaranayevati,2,1,1,0,21
411164,pubbekatavādino,pubbekatavadino,1,1,0,0,15
411165,issaranimmānavādino,issaranimmanavadino,1,1,0,0,19
411166,pubbekatavāde,pubbekatavade,3,2,1,0,13
411167,ahetukavādepi,ahetukavadepi,1,1,0,0,13
411168,titthāyatanānaṃ,titthayatananam,2,2,0,0,15
411169,saṇṭhahanabhāvena,santhahanabhavena,1,1,0,0,17
411170,tucchabhāvaṃ,tucchabhavam,6,6,0,0,12
411171,aniyyānikabhāvaṃ,aniyyanikabhavam,2,2,0,0,16
411172,thusakoṭṭanasadisataṃ,thusakottanasadisatam,1,1,0,0,21
411173,āpajjanabhāvena,apajjanabhavena,1,1,0,0,15
411174,aggisaññāya,aggisannaya,1,1,0,0,11
411175,dhamamānakhajjupanakasarikkhataṃ,dhamamanakhajjupanakasarikkhatam,1,1,0,0,32
411176,taṃdiṭṭhikānaṃ,tamditthikanam,1,1,0,0,14
411177,purimassapi,purimassapi,1,1,0,0,11
411178,pacchimassapi,pacchimassapi,1,1,0,0,13
411179,atthadassanatāya,atthadassanataya,1,1,0,0,16
411180,andhaveṇūpamataṃ,andhavenupamatam,1,1,0,0,16
411181,saddamatteneva,saddamatteneva,3,3,0,0,14
411182,sāradiṭṭhikānaṃ,saraditthikanam,1,1,0,0,15
411183,beluvapakkassa,beluvapakkassa,1,1,0,0,14
411184,daddabhāyitasaddaṃ,daddabhayitasaddam,1,1,0,0,18
411185,saṃvaṭṭamānā,samvattamana,2,2,0,0,12
411186,palāyantena,palayantena,1,1,0,0,11
411187,sasakena,sasakena,2,2,0,0,8
411188,sarikkhabhāvañca,sarikkhabhavanca,1,1,0,0,16
411189,sārabhāvañceva,sarabhavanceva,1,1,0,0,14
411190,niyyānikabhāvañca,niyyanikabhavanca,1,1,0,0,17
411191,aniggahitoti,aniggahitoti,4,0,4,0,12
411192,asaṃkiliṭṭhoti,asamkilitthoti,2,0,2,0,14
411193,pavattehipi,pavattehipi,1,1,0,0,11
411194,anupavajjoti,anupavajjoti,6,2,4,0,12
411195,upavādavinimutto,upavadavinimutto,1,1,0,0,16
411196,appaṭikuṭṭhoti,appatikutthoti,1,0,1,0,14
411197,appaṭibāhito,appatibahito,2,1,1,0,12
411198,apaṇḍitānañhi,apanditananhi,1,1,0,0,13
411199,nijjīvanissattabhāvappakāsako,nijjivanissattabhavappakasako,1,1,0,0,29
411200,vipākaphassānaṃ,vipakaphassanam,1,1,0,0,15
411201,vitakkavicārapādehi,vitakkavicarapadehi,1,1,0,0,19
411202,upavicārā,upavicara,5,4,1,0,9
411203,patiṭṭhādhātu,patitthadhatu,3,3,0,0,13
411204,vitthāratova,vittharatova,2,1,1,0,12
411205,titthāyatanasutte,titthayatanasutte,2,2,0,0,17
411206,chadhātuvasena,chadhatuvasena,4,4,0,0,14
411207,pariggaṇhantopi,parigganhantopi,1,1,0,0,15
411208,diṭṭhānevāti,ditthanevati,2,1,1,0,12
411209,arahattasampāpakaṃ,arahattasampapakam,4,4,0,0,18
411210,ākāsadhātupariggahānusārena,akasadhatupariggahanusarena,1,1,0,0,27
411211,vīsatikoṭṭhāsā,visatikotthasa,1,1,0,0,14
411212,chakoṭṭhāsāti,chakotthasati,1,1,0,0,13
411213,lokiyacittavasena,lokiyacittavasena,1,1,0,0,17
411214,tattakāyevāti,tattakayevati,1,1,0,0,13
411215,catuvīsādhikāni,catuvisadhikani,1,1,0,0,15
411216,dhammasatāni,dhammasatani,3,3,0,0,12
411217,rūpadhammāti,rupadhammati,6,4,2,0,12
411218,nāmarūpavasena,namarupavasena,4,4,0,0,14
411219,āhārapaccayāti,aharapaccayati,4,3,1,0,14
411220,etehiyeva,etehiyeva,5,5,0,0,9
411221,suvaṇṇādiākaro,suvannadiakaro,1,1,0,0,14
411222,cakkhuviññāṇāni,cakkhuvinnanani,4,4,0,0,15
411223,sampaṭicchanāni,sampaticchanani,2,2,0,0,15
411224,chaphassāyatanānaṃ,chaphassayatananam,2,2,0,0,18
411225,aṭṭhārasamanopavicāravasena,attharasamanopavicaravasena,2,2,0,0,27
411226,diṭṭhehi,ditthehi,3,3,0,0,8
411227,ariyabhāvakarāni,ariyabhavakarani,9,9,0,0,16
411228,ariyapaṭividdhāni,ariyapatividdhani,1,1,0,0,17
411229,dvādasapadaṃ,dvadasapadam,6,5,1,0,12
411230,paccayāvaṭṭaṃ,paccayavattam,1,1,0,0,13
411231,utumpīti,utumpiti,1,1,0,0,8
411232,idamāraddhanti,idamaraddhanti,5,5,0,0,14
411233,paccayamattaṃ,paccayamattam,3,2,1,0,13
411234,chadhātupaccayā,chadhatupaccaya,1,1,0,0,15
411235,pitūti,pituti,1,1,0,0,6
411236,paṭisandhiggaṇhanakasattasseva,patisandhigganhanakasattasseva,1,1,0,0,30
411237,nirayagabbho,nirayagabbho,2,1,1,0,12
411238,tiracchānayonigabbho,tiracchanayonigabbho,2,1,1,0,20
411239,pettivisayagabbho,pettivisayagabbho,1,1,0,0,17
411240,manussagabbho,manussagabbho,3,2,1,0,13
411241,devagabbhoti,devagabbhoti,1,1,0,0,12
411242,viññāṇakkhandhampi,vinnanakkhandhampi,2,1,1,0,18
411243,nāmarūpapātubhāvo,namarupapatubhavo,1,1,0,0,17
411244,saḷāyatanapātubhāvo,salayatanapatubhavo,1,1,0,0,19
411245,phassapātubhāvo,phassapatubhavo,1,1,0,0,15
411246,vedanāpātubhāvo,vedanapatubhavo,1,1,0,0,15
411247,vediyamānassāti,vediyamanassati,1,0,1,0,15
411248,vediyamānoti,vediyamanoti,2,1,1,0,12
411249,paññapemīti,pannapemiti,7,4,3,0,11
411250,bodhemi,bodhemi,1,1,0,0,7
411251,dukkhasamudayotiādīsupi,dukkhasamudayotiadisupi,1,0,1,0,23
411252,sanniṭṭhānakathā,sannitthanakatha,1,1,0,0,16
411253,pubbataṇhā,pubbatanha,1,1,0,0,10
411254,jānamānasseva,janamanasseva,2,2,0,0,13
411255,paccayākāravasena,paccayakaravasena,4,4,0,0,17
411256,paccayākāranirodhavasena,paccayakaranirodhavasena,1,1,0,0,24
411257,asesavirāganirodhāti,asesaviraganirodhati,10,1,9,0,20
411258,asesavirāgena,asesaviragena,2,2,0,0,13
411259,asesanirodhena,asesanirodhena,2,2,0,0,14
411260,aññamaññavevacanameva,annamannavevacanameva,1,1,0,0,21
411261,avijjānirodhotipi,avijjanirodhotipi,1,1,0,0,17
411262,saṅkhāranirodhotipi,sankharanirodhotipi,1,1,0,0,19
411263,nirodhanāmena,nirodhanamena,1,1,0,0,13
411264,khīṇākāradassanavasena,khinakaradassanavasena,1,1,0,0,22
411265,dvādasasuyeva,dvadasasuyeva,3,3,0,0,13
411266,tūriyanti,turiyanti,2,2,0,0,9
411267,pañcaṅgamattameva,pancangamattameva,1,1,0,0,17
411268,aṭṭhaṅgikamattameva,atthangikamattameva,1,1,0,0,19
411269,hāpetvāpi,hapetvapi,1,1,0,0,9
411270,vaḍḍhetvāpi,vaddhetvapi,3,3,0,0,11
411271,amātāputtikānīti,amataputtikaniti,1,0,1,0,16
411272,mātāputtaṃ,mataputtam,2,2,0,0,10
411273,parittātuṃ,parittatum,3,2,1,0,10
411274,mātāputtanti,mataputtanti,1,1,0,0,12
411275,nappaṭilabhatīti,nappatilabhatiti,1,0,1,0,16
411276,aggibhaye,aggibhaye,1,1,0,0,9
411277,aṭavisaṅkopoti,atavisankopoti,1,0,1,0,14
411278,saṅkopo,sankopo,1,1,0,0,7
411279,aṭavivāsino,atavivasino,4,3,1,0,11
411280,cakkasamārūḷhāti,cakkasamarulhati,1,0,1,0,16
411281,iriyāpathacakkampi,iriyapathacakkampi,2,1,1,0,18
411282,yānacakkampi,yanacakkampi,1,1,0,0,12
411283,bhayasmiṃ,bhayasmim,5,5,0,0,9
411284,yānakāni,yanakani,1,1,0,0,8
411285,parikkhārabhaṇḍaṃ,parikkharabhandam,4,3,1,0,17
411286,palāyantiyeva,palayantiyeva,1,1,0,0,13
411287,pariyāyantīti,pariyayantiti,3,0,3,0,13
411288,udakavāhakoti,udakavahakoti,4,0,4,0,13
411289,nadīpūro,nadipuro,2,2,0,0,8
411290,kulle,kulle,5,4,1,0,5
411291,mattikābhājane,mattikabhajane,2,2,0,0,14
411292,dārukkhaṇḍe,darukkhande,1,1,0,0,11
411293,tīṇimānītiādimāha,tinimanitiadimaha,1,0,1,0,17
411294,venāgapurasuttavaṇṇanā,venagapurasuttavannana,3,3,0,0,22
411295,kosalesūti,kosalesuti,11,1,10,0,10
411296,caramānoti,caramanoti,17,2,15,0,10
411297,addhānagamanaṃ,addhanagamanam,11,8,3,0,14
411298,turitacārikā,turitacarika,18,10,8,0,12
411299,aturitacārikā,aturitacarika,17,10,7,0,13
411300,bodhaneyyapuggalaṃ,bodhaneyyapuggalam,6,5,1,0,18
411301,bodhanatthāya,bodhanatthaya,10,8,2,0,13
411302,mahākassapapaccuggamanādīsu,mahakassapapaccuggamanadisu,4,4,0,0,27
411303,yojanaaddhayojanavasena,yojanaaddhayojanavasena,1,1,0,0,23
411304,anuggaṇhantassa,anugganhantassa,11,11,0,0,15
411305,cārikākathā,carikakatha,1,1,0,0,11
411306,ambaṭṭhasuttavaṇṇanāyaṃ,ambatthasuttavannanayam,2,2,0,0,23
411307,brāhmaṇagāmoti,brahmanagamoti,6,2,4,0,14
411308,samosaraṇagāmopi,samosaranagamopi,2,2,0,0,16
411309,bhogagāmopi,bhogagamopi,2,2,0,0,11
411310,samosaraṇagāmo,samosaranagamo,2,2,0,0,14
411311,brāhmaṇavasanagāmoti,brahmanavasanagamoti,1,1,0,0,20
411312,tadavasarīti,tadavasariti,12,1,11,0,12
411313,sampattoti,sampattoti,11,9,2,0,10
411314,aniyāmito,aniyamito,2,2,0,0,9
411315,upalabhiṃsu,upalabhimsu,2,2,0,0,11
411316,sotadvārasampattavacananigghosānusārena,sotadvarasampattavacananigghosanusarena,7,5,2,0,39
411317,avadhāraṇatthe,avadharanatthe,34,32,2,0,14
411318,savanantarāyo,savanantarayo,6,6,0,0,13
411319,padapūraṇena,padapuranena,13,9,4,0,12
411320,byañjanasiliṭṭhatāmattameva,byanjanasilitthatamattameva,5,5,0,0,27
411321,gotamotiādi,gotamotiadi,3,0,3,0,11
411322,samitapāpattā,samitapapatta,21,19,2,0,13
411323,ālapanamattaṃ,alapanamattam,11,6,5,0,13
411324,gotamagottoti,gotamagottoti,6,6,0,0,13
411325,uccākulaparidīpanaṃ,uccakulaparidipanam,9,7,2,0,19
411326,saddhāpabbajitabhāvaparidīpanaṃ,saddhapabbajitabhavaparidipanam,5,5,0,0,31
411327,pārijuññena,parijunnena,19,18,1,0,11
411328,aparikkhīṇaṃyeva,aparikkhinamyeva,7,6,1,0,16
411329,itthambhūtākhyānatthe,itthambhutakhyanatthe,14,10,4,0,21
411330,kalyāṇaguṇasamannāgato,kalyanagunasamannagato,9,6,3,0,22
411331,kittiyeva,kittiyeva,4,4,0,0,9
411332,vitthāritānīti,vittharitaniti,9,9,0,0,14
411333,pajātattā,pajatatta,12,12,0,0,9
411334,sadevakavacanena,sadevakavacanena,18,17,1,0,16
411335,pañcakāmāvacaradevaggahaṇaṃ,pancakamavacaradevaggahanam,17,12,5,0,27
411336,samārakavacanena,samarakavacanena,11,9,2,0,16
411337,chaṭṭhakāmāvacaradevaggahaṇaṃ,chatthakamavacaradevaggahanam,17,12,5,0,29
411338,sabrahmakavacanena,sabrahmakavacanena,13,11,2,0,18
411339,brahmakāyikādibrahmaggahaṇaṃ,brahmakayikadibrahmaggahanam,15,10,5,0,28
411340,sassamaṇabrāhmaṇivacanena,sassamanabrahmanivacanena,5,5,0,0,25
411341,paccatthikapaccāmittasamaṇabrāhmaṇaggahaṇaṃ,paccatthikapaccamittasamanabrahmanaggahanam,8,6,2,0,43
411342,samitapāpabāhitapāpasamaṇabrāhmaṇaggahaṇañca,samitapapabahitapapasamanabrahmanaggahananca,9,9,0,0,44
411343,pajāvacanena,pajavacanena,16,11,5,0,12
411344,sattalokaggahaṇaṃ,sattalokaggahanam,17,12,5,0,17
411345,sadevamanussavacanena,sadevamanussavacanena,10,9,1,0,21
411346,sammutidevaavasesamanussaggahaṇaṃ,sammutidevaavasesamanussaggahanam,10,9,1,0,33
411347,okāsalokena,okasalokena,7,5,2,0,11
411348,pajāvasena,pajavasena,13,11,2,0,10
411349,sattalokova,sattalokova,4,4,0,0,11
411350,sadevakaggahaṇena,sadevakaggahanena,13,8,5,0,17
411351,arūpāvacaraloko,arupavacaraloko,9,5,4,0,15
411352,samārakaggahaṇena,samarakaggahanena,13,8,5,0,17
411353,chakāmāvacaradevaloko,chakamavacaradevaloko,12,6,6,0,21
411354,sabrahmakaggahaṇena,sabrahmakaggahanena,7,6,1,0,19
411355,rūpībrahmaloko,rupibrahmaloko,4,3,1,0,14
411356,sassamaṇabrāhmaṇādiggahaṇena,sassamanabrahmanadiggahanena,6,6,0,0,28
411357,catuparisavasena,catuparisavasena,12,12,0,0,16
411358,sammutidevehi,sammutidevehi,15,14,1,0,13
411359,avasesasabbasattaloko,avasesasabbasattaloko,15,11,4,0,21
411360,avasesalokaṃ,avasesalokam,15,14,1,0,12
411361,tibhavūpage,tibhavupage,10,9,1,0,11
411362,tedhātukameva,tedhatukameva,10,9,1,0,13
411363,pariyādinnanti,pariyadinnanti,7,7,0,0,14
411364,aparaneyyo,aparaneyyo,11,10,1,0,10
411365,anumānādipaṭikkhepo,anumanadipatikkhepo,4,4,0,0,19
411366,ādikalyāṇādippakārameva,adikalyanadippakarameva,11,10,1,0,23
411367,ādimhipi,adimhipi,4,4,0,0,8
411368,catuppadikāyapi,catuppadikayapi,7,5,2,0,15
411369,paṭhamapādo,pathamapado,9,8,1,0,11
411370,paṭhamānusandhi,pathamanusandhi,3,3,0,0,15
411371,sīlasamādhivipassanā,silasamadhivipassana,11,5,6,0,20
411372,etaṃpāraṃ,etamparam,1,1,0,0,9
411373,etaṃpariyosānaṃ,etampariyosanam,2,1,1,0,15
411374,pariyosananti,pariyosananti,1,1,0,0,13
411375,pariyosānamhi,pariyosanamhi,3,3,0,0,13
411376,kathikasaṇṭhitī,kathikasanthiti,5,5,0,0,15
411377,yāgubhattaitthipurisādivaṇṇanānissitā,yagubhattaitthipurisadivannananissita,2,2,0,0,37
411378,catusatipaṭṭhānādinissitaṃ,catusatipatthanadinissitam,4,4,0,0,26
411379,ekabyañjanādiyuttā,ekabyanjanadiyutta,7,4,3,0,18
411380,sabbaniroṭṭhabyañjanā,sabbanirotthabyanjana,7,4,3,0,21
411381,sabbavissaṭṭhabyañjanā,sabbavissatthabyanjana,5,2,3,0,22
411382,sabbaniggahitabyañjanā,sabbaniggahitabyanjana,4,1,3,0,22
411383,damiḷakirātayavanādimilakkhānaṃ,damilakiratayavanadimilakkhanam,1,1,0,0,31
411384,byañjanapāripūriyā,byanjanaparipuriya,5,4,1,0,18
411385,abyañjanā,abyanjana,9,5,4,0,9
411386,garukañca,garukanca,2,2,0,0,9
411387,amakkhetvā,amakkhetva,9,9,0,0,10
411388,paripuṇṇabyañjanameva,paripunnabyanjanameva,7,4,3,0,21
411389,sakalādhivacanaṃ,sakaladhivacanam,6,3,3,0,16
411390,anūnādhikavacanaṃ,anunadhikavacanam,6,3,3,0,17
411391,sakalaparipuṇṇameva,sakalaparipunnameva,3,3,0,0,19
411392,ekadesanāpi,ekadesanapi,7,4,3,0,11
411393,lokāmisanirapekkho,lokamisanirapekkho,7,4,3,0,18
411394,hitapharaṇeneva,hitapharaneneva,1,1,0,0,15
411395,muduhadayo,muduhadayo,10,8,2,0,10
411396,ullumpanasabhāvasaṇṭhitena,ullumpanasabhavasanthitena,5,5,0,0,26
411397,sakalasāsanabrahmacariyaṃ,sakalasasanabrahmacariyam,1,1,0,0,25
411398,brahmabhūtaṃ,brahmabhutam,11,10,1,0,12
411399,cariyanti,cariyanti,11,11,0,0,9
411400,sukhāvahanti,sukhavahanti,10,10,0,0,12
411401,yathārūpo,yatharupo,11,8,3,0,9
411402,kappakoṭisatasahassehi,kappakotisatasahassehi,2,2,0,0,22
411403,dullabhadassanānaṃ,dullabhadassananam,2,2,0,0,18
411404,asītianubyañjanapaṭimaṇḍitehi,asitianubyanjanapatimanditehi,1,1,0,0,29
411405,dvattiṃsamahāpurisalakkhaṇavarehi,dvattimsamahapurisalakkhanavarehi,1,1,0,0,33
411406,samākiṇṇamanoramasarīrānaṃ,samakinnamanoramasariranam,2,2,0,0,26
411407,anappakadassanānaṃ,anappakadassananam,1,1,0,0,18
411408,atimadhuradhammanigghosānaṃ,atimadhuradhammanigghosanam,2,2,0,0,27
411409,yathābhūtaguṇādhigamena,yathabhutagunadhigamena,3,3,0,0,23
411410,laddhasaddānaṃ,laddhasaddanam,4,3,1,0,14
411411,pasādasommāni,pasadasommani,6,6,0,0,13
411412,sādhutaraṃyeva,sadhutaramyeva,3,2,1,0,14
411413,paṇāmetvāti,panametvati,9,0,9,0,11
411414,ubhatopakkhikā,ubhatopakkhika,6,5,1,0,14
411415,codessanti,codessanti,14,14,0,0,10
411416,vanditthā,vandittha,8,8,0,0,9
411417,añjalikaraṇamattenāpi,anjalikaranamattenapi,1,1,0,0,21
411418,paharanteneva,paharanteneva,5,5,0,0,13
411419,añjalikammampi,anjalikammampi,4,4,0,0,14
411420,vakkhāmā,vakkhama,9,8,1,0,8
411421,jiṇṇakulaputtā,jinnakulaputta,3,3,0,0,14
411422,kerāṭikā,keratika,11,10,1,0,8
411423,kathāsallāpe,kathasallape,3,3,0,0,12
411424,mocentā,mocenta,5,5,0,0,7
411425,aññāṇatāyeva,annanatayeva,4,4,0,0,12
411426,avakkhittamattikāpiṇḍā,avakkhittamattikapinda,2,2,0,0,22
411427,venāgapurikoti,venagapurikoti,1,0,1,0,14
411428,venāgapuravāsī,venagapuravasi,1,1,0,0,14
411429,pādantato,padantato,7,7,0,0,9
411430,kesaggā,kesagga,7,7,0,0,7
411431,asītianubyañjanasamujjalehi,asitianubyanjanasamujjalehi,1,1,0,0,27
411432,asītihatthappadesaṃ,asitihatthappadesam,3,3,0,0,19
411433,chabbaṇṇāhi,chabbannahi,7,6,1,0,11
411434,ghanabuddharaṃsīhi,ghanabuddharamsihi,1,1,0,0,18
411435,sañjātavimhayo,sanjatavimhayo,1,1,0,0,14
411436,adhimattappamāṇaparicchedavacanametaṃ,adhimattappamanaparicchedavacanametam,2,1,1,0,37
411437,vippasannapadena,vippasannapadena,1,1,0,0,16
411438,adhimattavippasannānīti,adhimattavippasannaniti,2,1,1,0,23
411439,patiṭṭhitokāsassa,patitthitokasassa,4,4,0,0,17
411440,vippasannataṃ,vippasannatam,4,4,0,0,13
411441,vippasannatā,vippasannata,4,4,0,0,12
411442,vippasanneyeva,vippasanneyeva,2,1,1,0,14
411443,avippasannacittānañhi,avippasannacittananhi,1,1,0,0,21
411444,indriyappasādo,indriyappasado,1,1,0,0,14
411445,manindriyappasādopi,manindriyappasadopi,1,1,0,0,19
411446,pariyodātoti,pariyodatoti,4,1,3,0,12
411447,nātisuparipakkaṃ,natisuparipakkam,1,1,0,0,16
411448,parisuddhañceva,parisuddhanceva,1,1,0,0,15
411449,pariyodātañca,pariyodatanca,1,1,0,0,13
411450,suparipakkatālaphalaṃ,suparipakkatalaphalam,1,1,0,0,21
411451,paramukhaṃ,paramukham,2,2,0,0,10
411452,surattavaṇṇassa,surattavannassa,1,1,0,0,15
411453,jambonadasuvaṇṇassa,jambonadasuvannassa,2,1,1,0,19
411454,suvaṇṇakāraputtena,suvannakaraputtena,1,1,0,0,18
411455,kataparikammaṃ,kataparikammam,6,6,0,0,14
411456,suvaṇṇakārauddhane,suvannakarauddhane,1,1,0,0,18
411457,suvaṇṇakārena,suvannakarena,4,4,0,0,13
411458,ghaṭṭanaparimajjanahaṃsanena,ghattanaparimajjanahamsanena,1,1,0,0,28
411459,suparimadditanti,suparimadditanti,1,1,0,0,16
411460,dīpidāṭhāya,dipidathaya,3,3,0,0,11
411461,bhāsateti,bhasateti,2,0,2,0,9
411462,sañjātaobhāsatāya,sanjataobhasataya,1,1,0,0,17
411463,tapateti,tapateti,2,0,2,0,8
411464,andhakāraviddhaṃsanatāya,andhakaraviddhamsanataya,1,1,0,0,24
411465,uccāsayanamahāsayanānīti,uccasayanamahasayananiti,1,0,1,0,24
411466,atikkantappamāṇaṃ,atikkantappamanam,3,3,0,0,17
411467,akappiyabhaṇḍaṃ,akappiyabhandam,8,8,0,0,15
411468,āsandītiādimāha,asanditiadimaha,1,0,1,0,15
411469,āsandīti,asanditi,6,0,6,0,8
411470,pallaṅkoti,pallankoti,12,4,8,0,10
411471,vāḷarūpāni,valarupani,17,17,0,0,10
411472,gonakoti,gonakoti,5,0,5,0,8
411473,dīghalomako,dighalomako,8,5,3,0,11
411474,mahākojavo,mahakojavo,6,6,0,0,10
411475,caturaṅgulādhikāni,caturanguladhikani,10,9,1,0,18
411476,cittakoti,cittakoti,2,0,2,0,9
411477,vānacittaṃ,vanacittam,4,4,0,0,10
411478,uṇṇāmayattharaṇaṃ,unnamayattharanam,38,37,1,0,17
411479,paṭikāti,patikati,6,0,6,0,8
411480,uṇṇāmayo,unnamayo,9,8,1,0,8
411481,setattharako,setattharako,2,2,0,0,12
411482,paṭalikāti,patalikati,5,0,5,0,10
411483,ghanapuppho,ghanapuppho,1,1,0,0,11
411484,uṇṇāmayattharako,unnamayattharako,3,3,0,0,16
411485,āmalakapaṭṭotipi,amalakapattotipi,2,2,0,0,16
411486,tūlikāti,tulikati,5,0,5,0,8
411487,tūlānaṃ,tulanam,11,7,4,0,7
411488,aññatarapuṇṇā,annatarapunna,4,4,0,0,13
411489,vikatikāti,vikatikati,7,0,7,0,10
411490,sīhabyagghādirūpavicitro,sihabyagghadirupavicitro,4,4,0,0,24
411491,uddalomīti,uddalomiti,17,4,13,0,10
411492,ubhatodasaṃ,ubhatodasam,7,7,0,0,11
411493,uggatapupphanti,uggatapupphanti,2,2,0,0,15
411494,ekantalomīti,ekantalomiti,18,5,13,0,12
411495,ekatodasaṃ,ekatodasam,7,7,0,0,10
411496,ratanaparisibbitaṃ,ratanaparisibbitam,20,16,4,0,18
411497,koseyyakaṭṭissamayaṃ,koseyyakattissamayam,13,6,7,0,20
411498,ratanaparisibbitameva,ratanaparisibbitameva,2,2,0,0,21
411499,kosiyasuttamayaṃ,kosiyasuttamayam,4,4,0,0,16
411500,nāṭakitthīnaṃ,natakitthinam,13,13,0,0,13
411501,naccanayoggaṃ,naccanayoggam,6,6,0,0,13
411502,hatthattharā,hatthatthara,1,0,1,0,12
411503,hatthipiṭṭhādīsu,hatthipitthadisu,1,1,0,0,16
411504,attharaṇakaattharakā,attharanakaattharaka,1,1,0,0,20
411505,kataattharakā,kataattharaka,1,1,0,0,13
411506,ajinappaveṇīti,ajinappaveniti,5,0,5,0,14
411507,ajinacammehi,ajinacammehi,10,10,0,0,12
411508,mañcappamāṇena,mancappamanena,6,6,0,0,14
411509,katappaveṇī,katappaveni,1,1,0,0,11
411510,atikāmalābhī,atikamalabhi,1,1,0,0,12
411511,icchiticchitalābhī,icchiticchitalabhi,3,2,1,0,18
411512,adukkhalābhī,adukkhalabhi,6,5,1,0,12
411513,vipulalābhī,vipulalabhi,10,9,1,0,11
411514,mahantalābhī,mahantalabhi,2,1,1,0,12
411515,uḷāruḷārāneva,ularularaneva,1,1,0,0,13
411516,sayanagaruko,sayanagaruko,1,1,0,0,12
411517,vippasannindriyāditaṃ,vippasannindriyaditam,1,1,0,0,21
411518,uccāsayanamahāsayanesu,uccasayanamahasayanesu,1,1,0,0,22
411519,senāsanavaṇṇaṃ,senasanavannam,1,1,0,0,14
411520,suddhakoseyyañhi,suddhakoseyyanhi,1,1,0,0,16
411521,gonakādayo,gonakadayo,1,1,0,0,10
411522,bhūmattharaṇaparibhogena,bhumattharanaparibhogena,1,1,0,0,24
411523,āsandiyā,asandiya,10,9,1,0,8
411524,bimbohanañca,bimbohananca,2,2,0,0,12
411525,araññaṃyeva,arannamyeva,4,4,0,0,11
411526,yadevāti,yadevati,6,0,6,0,8
411527,yāniyeva,yaniyeva,1,1,0,0,8
411528,evaṃbhūtoti,evambhutoti,4,0,4,0,11
411529,aññatarasamaṅgī,annatarasamangi,8,8,0,0,15
411530,rūpajjhānāni,rupajjhanani,8,8,0,0,12
411531,dibbacaṅkamo,dibbacankamo,1,1,0,0,12
411532,caṅkamantassāpi,cankamantassapi,1,1,0,0,15
411533,dibbacaṅkamoyeva,dibbacankamoyeva,1,1,0,0,16
411534,ṭhānādīsupi,thanadisupi,6,6,0,0,11
411535,pahīnarāgameva,pahinaragameva,1,1,0,0,14
411536,phalasamāpattiñhi,phalasamapattinhi,1,1,0,0,17
411537,samāpannassapi,samapannassapi,5,5,0,0,14
411538,vuṭṭhitassāpi,vutthitassapi,1,1,0,0,13
411539,caṅkamādayo,cankamadayo,1,1,0,0,11
411540,ariyacaṅkamādayo,ariyacankamadayo,2,1,1,0,16
411541,sarabhasuttavaṇṇanā,sarabhasuttavannana,3,3,0,0,19
411542,rājagaheti,rajagaheti,13,0,13,0,10
411543,pabbateti,pabbateti,13,2,11,0,9
411544,gijjhasadisānissa,gijjhasadisanissa,1,1,0,0,17
411545,kūṭesu,kutesu,5,5,0,0,6
411546,gijjhakūṭasmiñhi,gijjhakutasminhi,1,1,0,0,16
411547,gijjhakūṭavihārotvevassa,gijjhakutaviharotvevassa,1,1,0,0,24
411548,sarabhoti,sarabhoti,2,2,0,0,9
411549,vibbhantoti,vibbhantoti,3,1,2,0,11
411550,naṭṭhalābhasakkārā,natthalabhasakkara,2,1,1,0,18
411551,agarukatā,agarukata,8,8,0,0,9
411552,amānitā,amanita,7,7,0,0,7
411553,apūjitā,apujita,7,7,0,0,7
411554,sāvakānañcassa,savakanancassa,5,5,0,0,14
411555,upadhāretha,upadharetha,12,12,0,0,11
411556,ājīve,ajive,1,1,0,0,5
411557,jīvitasadisāpi,jivitasadisapi,1,1,0,0,14
411558,lābhasakkārauḷāro,labhasakkaraularo,1,1,0,0,17
411559,ekavādā,ekavada,1,1,0,0,7
411560,etamācariya,etamacariya,1,1,0,0,11
411561,katoyevāsi,katoyevasi,1,1,0,0,10
411562,sāvakasadisena,savakasadisena,1,1,0,0,14
411563,bhaveyyāthāti,bhaveyyathati,8,6,2,0,13
411564,gijjhakūṭamahāvihāraṃ,gijjhakutamahaviharam,1,1,0,0,21
411565,diṭṭhadiṭṭhānaṃ,ditthaditthanam,7,7,0,0,15
411566,yuttaṭṭhānasmiṃyeva,yuttatthanasmimyeva,1,1,0,0,19
411567,aniyyānikamagge,aniyyanikamagge,1,1,0,0,15
411568,vicarāmāti,vicaramati,3,3,0,0,10
411569,nhānodakādīni,nhanodakadini,1,1,0,0,13
411570,paṭiyādeti,patiyadeti,8,8,0,0,10
411571,pabbajasī,pabbajasi,7,7,0,0,9
411572,bhadantānaṃ,bhadantanam,5,5,0,0,11
411573,vicarimhāti,vicarimhati,4,2,2,0,11
411574,pabbājessāmī,pabbajessami,10,10,0,0,12
411575,vattapaṭivattamakāsi,vattapativattamakasi,1,1,0,0,20
411576,paggaṇhante,pagganhante,1,1,0,0,11
411577,uttamadhammo,uttamadhammo,2,2,0,0,12
411578,sakalasāsanadhāraṇī,sakalasasanadharani,1,1,0,0,19
411579,sikkhādhammo,sikkhadhammo,1,1,0,0,12
411580,gaṇhāvusoti,ganhavusoti,1,1,0,0,11
411581,yathānivatthapārutova,yathanivatthaparutova,3,3,0,0,21
411582,gahitanīhāreneva,gahitanihareneva,1,1,0,0,16
411583,nāsakkhittha,nasakkhittha,1,1,0,0,12
411584,āvaṭṭanimāyā,avattanimaya,1,1,0,0,12
411585,akatthāti,akatthati,1,1,0,0,9
411586,vācehīti,vacehiti,1,1,0,0,8
411587,anugghāṭitesuyeva,anugghatitesuyeva,1,1,0,0,17
411588,dvārasamīpaṃ,dvarasamipam,9,9,0,0,12
411589,apakkantaṃ,apakkantam,1,1,0,0,10
411590,osarissanti,osarissanti,4,3,1,0,11
411591,pattharatū,pattharatu,1,1,0,0,10
411592,satthārameva,sattharameva,6,6,0,0,12
411593,dvāragāmasamīpeyeva,dvaragamasamipeyeva,1,1,0,0,19
411594,sarabhopi,sarabhopi,1,1,0,0,9
411595,rājadvāravīthicatukkādīsu,rajadvaravithicatukkadisu,1,1,0,0,25
411596,bhāsatītiādi,bhasatitiadi,1,0,1,0,12
411597,aññātoti,annatoti,5,0,5,0,8
411598,uggahitoti,uggahitoti,3,2,1,0,10
411599,aññāyāti,annayati,13,0,13,0,8
411600,apakkantoti,apakkantoti,1,0,1,0,11
411601,apakkamissaṃ,apakkamissam,1,1,0,0,12
411602,bhāsamāne,bhasamane,3,3,0,0,9
411603,araññavāsino,arannavasino,6,6,0,0,12
411604,sippinikāti,sippinikati,1,0,1,0,11
411605,evaṃnāmikāya,evamnamikaya,8,8,0,0,12
411606,tuṇhībhāvenāti,tunhibhavenati,6,0,6,0,14
411607,adhivāsesīti,adhivasesiti,13,5,8,0,12
411608,bhikkhusaṅghaparivutenā,bhikkhusanghaparivutena,1,1,0,0,23
411609,vāduppattiṭṭhānaṃ,vaduppattitthanam,1,1,0,0,17
411610,parisabalena,parisabalena,2,2,0,0,12
411611,maddanakiccaṃ,maddanakiccam,1,1,0,0,13
411612,maddissāmi,maddissami,1,1,0,0,10
411613,maddeyyaṃ,maddeyyam,1,1,0,0,9
411614,caraṇakāle,caranakale,10,10,0,0,10
411615,nibbattenāpi,nibbattenapi,2,2,0,0,12
411616,vahitabbaṃ,vahitabbam,7,7,0,0,10
411617,gambhīravattanī,gambhiravattani,4,4,0,0,15
411618,yuñjenti,yunjenti,1,1,0,0,8
411619,svāssu,svassu,8,6,2,0,6
411620,kaṇhajātakaṃ,kanhajatakam,5,5,0,0,12
411621,puttasineho,puttasineho,21,21,0,0,11
411622,gehavetanaṃ,gehavetanam,3,2,1,0,11
411623,yāgubhattatiṇādīni,yagubhattatinadini,1,1,0,0,18
411624,paripuṇṇarūpo,paripunnarupo,1,1,0,0,13
411625,balavīriyasampanno,balaviriyasampanno,1,1,0,0,18
411626,sampannācāro,sampannacaro,1,1,0,0,12
411627,udakabhinnaṭṭhāne,udakabhinnatthane,1,1,0,0,17
411628,nīharāpetuṃ,niharapetum,4,4,0,0,11
411629,dhurasakaṭe,dhurasakate,1,1,0,0,11
411630,ekakaṃyeva,ekakamyeva,7,7,0,0,10
411631,nihārena,niharena,1,1,0,0,8
411632,sabbapacchimasakaṭaṃ,sabbapacchimasakatam,1,1,0,0,20
411633,mociyamāno,mociyamano,1,1,0,0,10
411634,vetanatthaṃ,vetanattham,1,1,0,0,11
411635,sakaṭagaṇanāya,sakatagananaya,1,1,0,0,14
411636,pañcasatabhaṇḍikaṃ,pancasatabhandikam,1,1,0,0,18
411637,kahāpaṇabhāvaṃ,kahapanabhavam,1,1,0,0,14
411638,jīvissatī,jivissati,9,9,0,0,9
411639,saññamakāsī,sannamakasi,1,1,0,0,11
411640,vahitabbadhuraṃ,vahitabbadhuram,1,1,0,0,15
411641,vuṭṭhitotiādi,vutthitotiadi,1,0,1,0,13
411642,paṭisallānāti,patisallanati,10,1,9,0,13
411643,puthuttārammaṇehi,puthuttarammanehi,1,1,0,0,17
411644,sallānato,sallanato,1,1,0,0,9
411645,phalasamāpattitoti,phalasamapattitoti,2,1,1,0,18
411646,sīhanādakathaṃ,sihanadakatham,1,1,0,0,14
411647,paribbājakārāmassa,paribbajakaramassa,1,1,0,0,18
411648,nagaramajjheneva,nagaramajjheneva,1,1,0,0,16
411649,vissaṭṭhabalo,vissatthabalo,1,1,0,0,13
411650,patthariṃsu,pattharimsu,3,3,0,0,11
411651,sarabhena,sarabhena,4,4,0,0,9
411652,mahādhammasaṅgāmo,mahadhammasangamo,1,1,0,0,17
411653,khandhaviṭapasākhantarehi,khandhavitapasakhantarehi,1,1,0,0,25
411654,samuggacchantā,samuggacchanta,1,1,0,0,14
411655,chabbaṇṇaghanabuddharasmiyo,chabbannaghanabuddharasmiyo,6,6,0,0,27
411656,jāṇukantare,janukantare,1,1,0,0,11
411657,aggakule,aggakule,2,2,0,0,8
411658,aggāsanārahotissa,aggasanarahotissa,1,1,0,0,17
411659,paññattameva,pannattameva,10,10,0,0,12
411660,kathenteyeva,kathenteyeva,26,26,0,0,12
411661,paribbājakārāmeyeva,paribbajakarameyeva,1,1,0,0,19
411662,paṭisattūnaṃ,patisattunam,1,1,0,0,12
411663,satapākatelena,satapakatelena,6,6,0,0,14
411664,anuvattantā,anuvattanta,7,7,0,0,11
411665,yāceyyāsīti,yaceyyasiti,2,1,1,0,11
411666,āyāceyyāsi,ayaceyyasi,1,1,0,0,10
411667,pattheyyāsi,pattheyyasi,3,3,0,0,11
411668,piheyyāsi,piheyyasi,1,1,0,0,9
411669,tuṇhībhūtoti,tunhibhutoti,3,0,3,0,12
411670,nittejataṃ,nittejatam,6,5,1,0,10
411671,pattakkhandhoti,pattakkhandhoti,5,0,5,0,15
411672,onatagīvo,onatagivo,3,2,1,0,9
411673,adhomukhoti,adhomukhoti,2,0,2,0,11
411674,heṭṭhāmukho,hetthamukho,2,2,0,0,11
411675,dassitadhammesu,dassitadhammesu,6,3,3,0,15
411676,paṭicarissatīti,paticarissatiti,2,0,2,0,15
411677,paṭicchādessati,paticchadessati,2,2,0,0,15
411678,apanāmessatīti,apanamessatiti,1,0,1,0,14
411679,āgantukakathaṃ,agantukakatham,6,5,1,0,14
411680,purimakathaṃ,purimakatham,2,2,0,0,12
411681,anabhiraddhiṃ,anabhiraddhim,1,1,0,0,13
411682,pātukarissatīti,patukarissatiti,5,2,3,0,15
411683,mandabalavabhedo,mandabalavabhedo,1,1,0,0,16
411684,kodhoyeva,kodhoyeva,5,5,0,0,9
411685,paṭhamavesārajjena,pathamavesarajjena,1,1,0,0,18
411686,paribbājakātiādimāha,paribbajakatiadimaha,1,0,1,0,20
411687,takkarassāti,takkarassati,9,1,8,0,12
411688,paṭipattipūrakassa,patipattipurakassa,1,1,0,0,18
411689,dukkhakkhayāyāti,dukkhakkhayayati,22,8,14,0,16
411690,rāgapaṭighātatthāya,ragapatighatatthaya,2,2,0,0,19
411691,dosapaṭighātatthāya,dosapatighatatthaya,1,1,0,0,19
411692,mohapaṭighātatthāya,mohapatighatatthaya,2,2,0,0,19
411693,yathādesitaṃ,yathadesitam,4,4,0,0,12
411694,vaṭṭadukkhakkhayāya,vattadukkhakkhayaya,2,2,0,0,19
411695,paribbājakoti,paribbajakoti,19,2,17,0,13
411696,nisīdissatīti,nisidissatiti,1,1,0,0,13
411697,nivattentasseva,nivattentasseva,1,1,0,0,15
411698,caturāsītipāṇasahassaparimāṇā,caturasitipanasahassaparimana,1,1,0,0,29
411699,amatapānassa,amatapanassa,1,1,0,0,12
411700,pītabhāvaṃ,pitabhavam,4,4,0,0,10
411701,appaṭinādaṃ,appatinadam,5,3,2,0,11
411702,gijjhakūṭamahāvihāre,gijjhakutamahavihare,1,1,0,0,20
411703,sannitodakenāti,sannitodakenati,2,0,2,0,15
411704,vacanapatodena,vacanapatodena,4,4,0,0,14
411705,sambharitaṃ,sambharitam,4,3,1,0,11
411706,nirantaraphuṭaṃ,nirantaraphutam,1,1,0,0,15
411707,vijjhiṃsūti,vijjhimsuti,3,3,0,0,11
411708,brahāraññeti,braharanneti,2,0,2,0,12
411709,nadituṃ,naditum,5,4,1,0,7
411710,siṅgālasaddoyeva,singalasaddoyeva,1,1,0,0,16
411711,nicchari,nicchari,2,2,0,0,8
411712,bheraṇḍakaṃ,bherandakam,1,0,1,0,11
411713,bhinnassaraṃ,bhinnassaram,2,1,1,0,12
411714,amanāpasaddaṃ,amanapasaddam,3,2,1,0,13
411715,sīhasadisaṃ,sihasadisam,5,5,0,0,11
411716,siṅgālasadisaṃ,singalasadisam,1,1,0,0,14
411717,ambukasañcarīti,ambukasancariti,1,0,1,0,15
411718,khuddakakukkuṭikā,khuddakakukkutika,1,1,0,0,17
411719,ravissāmīti,ravissamiti,1,0,1,0,11
411720,mahākukkuṭaṃ,mahakukkutam,1,1,0,0,12
411721,ravantaṃ,ravantam,2,2,0,0,8
411722,ravitaṃ,ravitam,1,1,0,0,7
411723,ravituṃ,ravitum,1,1,0,0,7
411724,ravamānā,ravamana,2,2,0,0,8
411725,kukkuṭikāravaṃyeva,kukkutikaravamyeva,1,1,0,0,18
411726,suññāyāti,sunnayati,1,0,1,0,9
411727,tucchāya,tucchaya,1,1,0,0,8
411728,jeṭṭhakavasabhehi,jetthakavasabhehi,1,1,0,0,17
411729,virahitāya,virahitaya,2,2,0,0,10
411730,jeṭṭhakavasabhassa,jetthakavasabhassa,1,1,0,0,18
411731,nādasadisaṃ,nadasadisam,1,1,0,0,11
411732,gambhīranādaṃ,gambhiranadam,1,1,0,0,13
411733,kesamuttisuttavaṇṇanā,kesamuttisuttavannana,3,3,0,0,21
411734,nigamoti,nigamoti,10,2,8,0,8
411735,kesamuttiyāti,kesamuttiyati,2,0,2,0,13
411736,kesamuttanigamavāsino,kesamuttanigamavasino,2,1,1,0,21
411737,upasaṅkamiṃsūti,upasankamimsuti,8,0,8,0,15
411738,sappinavanītādibhesajjāni,sappinavanitadibhesajjani,2,2,0,0,25
411739,aṭṭhavidhapānakāni,atthavidhapanakani,1,1,0,0,18
411740,dīpentīti,dipentiti,7,2,5,0,9
411741,khuṃsentīti,khumsentiti,2,0,2,0,11
411742,vambhentīti,vambhentiti,2,0,2,0,11
411743,avajānanti,avajananti,11,10,1,0,10
411744,paribhavantīti,paribhavantiti,1,0,1,0,14
411745,atikkamitukāmā,atikkamitukama,2,2,0,0,14
411746,uggaṇhiṃsū,ugganhimsu,1,1,0,0,10
411747,ekaladdhiyampi,ekaladdhiyampi,1,1,0,0,14
411748,evamārocetvā,evamarocetva,1,1,0,0,12
411749,bhantetiādimāhaṃsu,bhantetiadimahamsu,2,0,2,0,18
411750,anussavenāti,anussavenati,1,0,1,0,12
411751,anussavakathāyapi,anussavakathayapi,1,1,0,0,17
411752,paramparāyāti,paramparayati,7,1,6,0,13
411753,paramparakathāyapi,paramparakathayapi,1,1,0,0,18
411754,itikirāyāti,itikirayati,2,0,2,0,11
411755,piṭakasampadānenāti,pitakasampadanenati,4,0,4,0,19
411756,piṭakatantiyā,pitakatantiya,3,3,0,0,13
411757,takkahetūti,takkahetuti,2,0,2,0,11
411758,takkaggāhenapi,takkaggahenapi,2,2,0,0,14
411759,nayahetūti,nayahetuti,1,0,1,0,10
411760,nayaggāhenapi,nayaggahenapi,1,1,0,0,13
411761,ākāraparivitakkenāti,akaraparivitakkenati,3,0,3,0,20
411762,kāraṇaparivitakkenapi,karanaparivitakkenapi,2,2,0,0,21
411763,diṭṭhinijjhānakkhantiyāti,ditthinijjhanakkhantiyati,2,0,2,0,25
411764,gahitadiṭṭhiyā,gahitaditthiya,4,4,0,0,14
411765,sametītipi,sametitipi,2,2,0,0,10
411766,bhabbarūpatāyāti,bhabbarupatayati,1,0,1,0,16
411767,lobhādipaṭipakkhavasena,lobhadipatipakkhavasena,2,2,0,0,23
411768,vigatābhijjhotiādīhi,vigatabhijjhotiadihi,1,0,1,0,20
411769,mettādikaṃ,mettadikam,1,1,0,0,10
411770,mettāsahagatenātiādimāha,mettasahagatenatiadimaha,2,0,2,0,24
411771,kammaṭṭhānakathāya,kammatthanakathaya,1,1,0,0,18
411772,pāḷivaṇṇanāya,palivannanaya,1,1,0,0,13
411773,averacittoti,averacittoti,1,0,1,0,12
411774,akusalaverassa,akusalaverassa,1,1,0,0,14
411775,puggalaverino,puggalaverino,1,1,0,0,13
411776,abyābajjhacittoti,abyabajjhacittoti,1,0,1,0,17
411777,kodhacittassa,kodhacittassa,2,1,1,0,13
411778,niddukkhacitto,niddukkhacitto,1,1,0,0,14
411779,asaṃkiliṭṭhacittoti,asamkilitthacittoti,1,0,1,0,19
411780,visuddhacittoti,visuddhacittoti,1,0,1,0,15
411781,kilesamalābhāvena,kilesamalabhavena,3,3,0,0,17
411782,assāsāti,assasati,2,0,2,0,8
411783,avassayā,avassaya,4,4,0,0,8
411784,upapajjissāmīti,upapajjissamiti,5,4,1,0,15
411785,sāḷhasuttavaṇṇanā,salhasuttavannana,6,6,0,0,17
411786,migāranattāti,migaranattati,3,0,3,0,13
411787,sekhuniyanattāti,sekhuniyanattati,1,0,1,0,16
411788,sekhuniyaseṭṭhino,sekhuniyasetthino,1,1,0,0,17
411789,dāsakammakaraparivutā,dasakammakaraparivuta,1,1,0,0,21
411790,pubbaṇhasamayeyeva,pubbanhasamayeyeva,1,1,0,0,18
411791,sāḷhātiādimāha,salhatiadimaha,1,0,1,0,14
411792,lubbhanasabhāvo,lubbhanasabhavo,1,1,0,0,15
411793,lobhasaṅkhātaṃ,lobhasankhatam,2,2,0,0,14
411794,samuṭṭhitapañhassa,samutthitapanhassa,1,1,0,0,18
411795,dukkhasaccasaṅkhātaṃ,dukkhasaccasankhatam,1,1,0,0,20
411796,vipassanāsaññāsaṅkhātassa,vipassanasannasankhatassa,1,1,0,0,25
411797,tamatthīti,tamatthiti,1,1,0,0,10
411798,santāpakarānaṃ,santapakaranam,2,1,1,0,14
411799,sukhappaṭisaṃvedīti,sukhappatisamvediti,1,0,1,0,19
411800,kāyikacetasikassa,kayikacetasikassa,7,5,2,0,17
411801,paṭisaṃveditā,patisamvedita,2,2,0,0,13
411802,brahmabhūtenāti,brahmabhutenati,2,0,2,0,15
411803,kathāvatthusuttavaṇṇanā,kathavatthusuttavannana,3,3,0,0,23
411804,kathāvatthūnīti,kathavatthuniti,6,0,6,0,15
411805,kathākāraṇāni,kathakaranani,2,2,0,0,13
411806,patiṭṭhāyoti,patitthayoti,1,1,0,0,12
411807,anāgatapaccuppannesupi,anagatapaccuppannesupi,4,3,1,0,22
411808,kāsikarājā,kasikaraja,2,2,0,0,10
411809,kathāsampayogenāti,kathasampayogenati,2,1,1,0,18
411810,kathāsamāgamena,kathasamagamena,1,1,0,0,15
411811,kacchoti,kacchoti,1,0,1,0,8
411812,pucchasī,pucchasi,13,13,0,0,8
411813,pucchāmī,pucchami,44,44,0,0,8
411814,kāraṇākāraṇe,karanakarane,6,5,1,0,12
411815,ucchedavādiṃ,ucchedavadim,3,3,0,0,12
411816,niggayhamāno,niggayhamano,2,2,0,0,12
411817,sassatavādibhāvameva,sassatavadibhavameva,3,2,1,0,20
411818,ucchedavādimhi,ucchedavadimhi,1,1,0,0,14
411819,pahonte,pahonte,3,3,0,0,7
411820,puggalavādimhi,puggalavadimhi,1,1,0,0,14
411821,suññatavādī,sunnatavadi,1,1,0,0,11
411822,suññatavādimhi,sunnatavadimhi,1,1,0,0,14
411823,puggalavādīti,puggalavaditi,4,3,1,0,13
411824,pañhapucchanepi,panhapucchanepi,1,1,0,0,15
411825,pañhakathanepi,panhakathanepi,1,1,0,0,14
411826,pucchissasī,pucchissasi,3,3,0,0,11
411827,ñātabhāvaṃ,natabhavam,12,12,0,0,10
411828,hanuṃ,hanum,5,4,1,0,5
411829,saṃsodheti,samsodheti,1,1,0,0,10
411830,kathessasī,kathessasi,4,4,0,0,10
411831,jānitavāde,janitavade,1,1,0,0,10
411832,pucchitabbaniyāmeneva,pucchitabbaniyameneva,1,1,0,0,21
411833,apañhaṃ,apanham,1,1,0,0,7
411834,kathetabbaniyāmeneva,kathetabbaniyameneva,1,1,0,0,20
411835,apañho,apanho,1,1,0,0,6
411836,apucchitabbaṭṭhāne,apucchitabbatthane,2,2,0,0,18
411837,bhikkhācāramagge,bhikkhacaramagge,7,7,0,0,16
411838,divāvihāraṭṭhānagamanakālepi,divaviharatthanagamanakalepi,1,1,0,0,28
411839,kāretvāva,karetvava,5,5,0,0,9
411840,akāretvā,akaretva,13,13,0,0,8
411841,niggayhamānopi,niggayhamanopi,3,3,0,0,14
411842,ucchedavādīyevā,ucchedavadiyeva,1,1,0,0,15
411843,sassatapuggalasuññatavādādīsupi,sassatapuggalasunnatavadadisupi,1,1,0,0,31
411844,saṃsodhentopi,samsodhentopi,1,1,0,0,13
411845,vatthacchādanamālāgandhādīni,vatthacchadanamalagandhadini,1,1,0,0,28
411846,nāgadīpagamanena,nagadipagamanena,1,1,0,0,16
411847,pucchāmāti,pucchamati,6,3,3,0,10
411848,khādinti,khadinti,1,1,0,0,8
411849,macchakhādanena,macchakhadanena,1,1,0,0,15
411850,kirasi,kirasi,1,1,0,0,6
411851,nātisupakko,natisupakko,1,1,0,0,11
411852,aphāsukamakāsi,aphasukamakasi,1,1,0,0,14
411853,phāsukena,phasukena,1,1,0,0,9
411854,aphāsukena,aphasukena,7,7,0,0,10
411855,āpannosīti,apannositi,6,5,1,0,10
411856,āgantukakathāvasena,agantukakathavasena,1,1,0,0,19
411857,tepiṭakatissatthero,tepitakatissatthero,1,0,1,0,19
411858,saṅghakiccaṃ,sanghakiccam,18,18,0,0,12
411859,abhimaddatīti,abhimaddatiti,4,3,1,0,13
411860,anupajagghatīti,anupajagghatiti,1,0,1,0,15
411861,pucchitepi,pucchitepi,3,3,0,0,10
411862,apucchitabbaṃ,apucchitabbam,6,6,0,0,13
411863,akathetabbaṃ,akathetabbam,2,2,0,0,12
411864,mukhadosamattaṃ,mukhadosamattam,1,1,0,0,15
411865,durutte,durutte,3,3,0,0,7
411866,ujjhāyamāno,ujjhayamano,1,1,0,0,11
411867,saupanisoti,saupanisoti,4,1,3,0,11
411868,saupanissayo,saupanissayo,6,4,2,0,12
411869,ṭhapitasoto,thapitasoto,5,4,1,0,11
411870,dukkhasaccadhammaṃ,dukkhasaccadhammam,1,1,0,0,18
411871,sabbākusaladhammaṃ,sabbakusaladhammam,1,1,0,0,18
411872,arahattaphaladhammaṃ,arahattaphaladhammam,1,1,0,0,20
411873,arahattaphalavimokkhaṃ,arahattaphalavimokkham,1,1,0,0,22
411874,kacchākacchesu,kacchakacchesu,1,1,0,0,14
411875,etadatthāyeva,etadatthayeva,2,2,0,0,13
411876,upanisāya,upanisaya,2,2,0,0,9
411877,arahattaphalavimokkho,arahattaphalavimokkho,1,1,0,0,21
411878,arahattaphalatthāya,arahattaphalatthaya,6,6,0,0,19
411879,sabbametanti,sabbametanti,1,1,0,0,12
411880,viruddhātiādimāha,viruddhatiadimaha,1,0,1,0,17
411881,virodhasaṅkhātena,virodhasankhatena,1,1,0,0,17
411882,sallapantīti,sallapantiti,1,0,1,0,12
411883,viniviṭṭhāti,vinivitthati,1,0,1,0,12
411884,samussitāti,samussitati,1,0,1,0,11
411885,mānussayena,manussayena,2,2,0,0,11
411886,anariyaguṇamāsajjāti,anariyagunamasajjati,1,0,1,0,20
411887,anariyaguṇakathaṃ,anariyagunakatham,1,1,0,0,17
411888,guṇamāsajja,gunamasajja,1,1,0,0,11
411889,anariyakathā,anariyakatha,1,1,0,0,12
411890,ariyakathā,ariyakatha,2,2,0,0,10
411891,aññoññavivaresinoti,annonnavivaresinoti,1,0,1,0,19
411892,mukhadosakhalitaṃ,mukhadosakhalitam,1,1,0,0,17
411893,mukhadosena,mukhadosena,1,1,0,0,11
411894,sampamohañca,sampamohanca,1,1,0,0,12
411895,parājayañca,parajayanca,3,3,0,0,11
411896,nācareti,nacareti,1,0,1,0,8
411897,dhammaṭṭhapaṭisaṃyuttāti,dhammatthapatisamyuttati,1,0,1,0,24
411898,paṭisaṃyuttāti,patisamyuttati,2,1,1,0,14
411899,anuddhatena,anuddhatena,4,4,0,0,11
411900,apaḷāsoti,apalasoti,1,0,1,0,9
411901,yugaggāhapaḷāsavasena,yugaggahapalasavasena,1,1,0,0,21
411902,asāhasoti,asahasoti,1,0,1,0,9
411903,rāgadosamohasāhasānaṃ,ragadosamohasahasanam,1,1,0,0,21
411904,anusūyāyamānoti,anusuyayamanoti,1,0,1,0,15
411905,usūyamāno,usuyamano,3,3,0,0,9
411906,nāpasādayeti,napasadayeti,1,0,1,0,12
411907,dukkathitasmiṃ,dukkathitasmim,1,1,0,0,14
411908,apasādeyya,apasadeyya,5,5,0,0,10
411909,sikkheyyāti,sikkheyyati,17,11,6,0,11
411910,kāraṇuttariyalakkhaṇaṃ,karanuttariyalakkhanam,1,1,0,0,22
411911,gāhayeti,gahayeti,3,0,3,0,8
411912,mukhakhalitaṃ,mukhakhalitam,1,1,0,0,13
411913,gāhayeyya,gahayeyya,1,1,0,0,9
411914,nābhihareti,nabhihareti,1,0,1,0,11
411915,nāvatthareyya,navatthareyya,2,2,0,0,13
411916,nābhimaddeti,nabhimaddeti,1,0,1,0,12
411917,maddeyya,maddeyya,3,3,0,0,8
411918,saccālikapaṭisaṃyuttaṃ,saccalikapatisamyuttam,1,1,0,0,22
411919,pasādajananatthaṃ,pasadajananattham,14,14,0,0,17
411920,mantayeti,mantayeti,1,0,1,0,9
411921,mānussitā,manussita,1,1,0,0,9
411922,anussitova,anussitova,1,1,0,0,10
411923,aññatitthiyasuttavaṇṇanā,annatitthiyasuttavannana,6,6,0,0,24
411924,bhagavaṃmūlakāti,bhagavammulakati,3,0,3,0,16
411925,kassapasammāsambuddhena,kassapasammasambuddhena,5,4,1,0,23
411926,paṭivijjhāmāti,pativijjhamati,5,3,2,0,14
411927,bhagavaṃnettikāti,bhagavamnettikati,3,0,3,0,17
411928,dassetāti,dassetati,6,4,2,0,9
411929,bhagavaṃpaṭisaraṇāti,bhagavampatisaranati,3,0,3,0,20
411930,paṭisarantīti,patisarantiti,8,3,5,0,13
411931,catubhūmakadhammānaṃ,catubhumakadhammanam,8,6,2,0,20
411932,paṭisaratīti,patisaratiti,2,2,0,0,12
411933,paṭibhātūti,patibhatuti,17,3,14,0,11
411934,pavattarāgo,pavattarago,5,5,0,0,11
411935,appasāvajjoti,appasavajjoti,1,0,1,0,13
411936,lokavajjavasenapi,lokavajjavasenapi,2,2,0,0,17
411937,vipākavajjavasenapīti,vipakavajjavasenapiti,2,2,0,0,21
411938,appadosoti,appadosoti,1,1,0,0,10
411939,bhātibhaginiādayo,bhatibhaginiadayo,2,2,0,0,17
411940,puttabhātikānaṃ,puttabhatikanam,1,1,0,0,15
411941,āvāhavivāhamaṅgalaṃ,avahavivahamangalam,3,3,0,0,19
411942,tāveso,taveso,1,1,0,0,6
411943,lokavajjavasena,lokavajjavasena,3,3,0,0,15
411944,sadārasantosamūlikā,sadarasantosamulika,1,1,0,0,19
411945,vipākavajjavasena,vipakavajjavasena,2,2,0,0,17
411946,dandhavirāgīti,dandhaviragiti,3,0,3,0,14
411947,telamasirāgo,telamasirago,1,1,0,0,12
411948,bhavantarāni,bhavantarani,3,3,0,0,12
411949,nāpagacchatīti,napagacchatiti,1,1,0,0,14
411950,sāmikato,samikato,4,4,0,0,8
411951,ghātehī,ghatehi,12,12,0,0,7
411952,dvajjhabhāvaṃ,dvajjhabhavam,1,1,0,0,13
411953,tatiyavāraṃ,tatiyavaram,11,11,0,0,11
411954,mahākakudhasamīpe,mahakakudhasamipe,1,1,0,0,17
411955,daṇḍakavāsiṃ,dandakavasim,1,1,0,0,12
411956,jeṭṭhabhātāpissa,jetthabhatapissa,1,1,0,0,16
411957,olikhissāmī,olikhissami,1,1,0,0,11
411958,olikhantī,olikhanti,1,1,0,0,9
411959,āmalakapiṇḍaṃ,amalakapindam,1,1,0,0,13
411960,āgacchāhī,agacchahi,17,17,0,0,9
411961,vuttatitthameva,vuttatitthameva,1,1,0,0,15
411962,āmalakakakkena,amalakakakkena,1,1,0,0,14
411963,rukkhantarato,rukkhantarato,1,1,0,0,13
411964,khandhaṭṭhike,khandhatthike,3,3,0,0,13
411965,pariccajitumasakkonto,pariccajitumasakkonto,1,1,0,0,21
411966,mahādhammani,mahadhammani,1,1,0,0,12
411967,nisinnāyapi,nisinnayapi,3,3,0,0,11
411968,ghātāpesi,ghatapesi,5,5,0,0,9
411969,gamanakālato,gamanakalato,5,5,0,0,12
411970,gacchantiyāpi,gacchantiyapi,11,10,1,0,13
411971,kataraṭṭhānaṃ,kataratthanam,5,5,0,0,13
411972,carissantī,carissanti,5,5,0,0,10
411973,jātissaro,jatissaro,7,5,2,0,9
411974,ghātitabhāvaṃ,ghatitabhavam,2,2,0,0,13
411975,paccatthikāya,paccatthikaya,1,1,0,0,13
411976,nibbattosmī,nibbattosmi,6,6,0,0,11
411977,ayyakova,ayyakova,1,1,0,0,8
411978,vuddhippattaṃ,vuddhippattam,8,6,2,0,13
411979,kandasī,kandasi,1,1,0,0,7
411980,nivāsakiccaṃ,nivasakiccam,1,1,0,0,12
411981,pitaripi,pitaripi,2,2,0,0,8
411982,bhātibhaginiādīsupi,bhatibhaginiadisupi,2,2,0,0,19
411983,pabbajitesupi,pabbajitesupi,5,5,0,0,13
411984,gatagataṭṭhānesu,gatagatatthanesu,2,2,0,0,16
411985,mātāpitūsupi,matapitusupi,7,7,0,0,12
411986,pabbajitesupī,pabbajitesupi,1,1,0,0,13
411987,khippavirāgīti,khippaviragiti,1,0,1,0,14
411988,cetiyepi,cetiyepi,2,2,0,0,8
411989,bodhimhipi,bodhimhipi,2,2,0,0,10
411990,vipākavajjavasenapi,vipakavajjavasenapi,1,1,0,0,19
411991,akusalamūlasuttavaṇṇanā,akusalamulasuttavannana,3,3,0,0,23
411992,jāniyāti,janiyati,6,0,6,0,8
411993,pabbājanāyāti,pabbajanayati,2,0,2,0,13
411994,pabbājanīyakammena,pabbajaniyakammena,2,2,0,0,18
411995,balavamhīti,balavamhiti,1,0,1,0,11
411996,ṭhitomhītipi,thitomhitipi,1,1,0,0,12
411997,akālavādīti,akalavaditi,2,0,2,0,11
411998,akālasmiṃ,akalasmim,1,1,0,0,9
411999,abhūtavādīti,abhutavaditi,8,0,8,0,12
412000,anatthavādīti,anatthavaditi,2,0,2,0,13
412001,adhammavādīti,adhammavaditi,4,1,3,0,13
412002,avinayavādīti,avinayavaditi,2,0,2,0,13
412003,nibbeṭhanāyāti,nibbethanayati,1,0,1,0,14
412004,nibbeṭhanatthāya,nibbethanatthaya,1,1,0,0,16
412005,nirayādikā,nirayadika,2,2,0,0,10
412006,avassabhāvinī,avassabhavini,1,1,0,0,13
412007,tatthānena,tatthanena,1,1,0,0,10
412008,nibbattitabbanti,nibbattitabbanti,5,5,0,0,16
412009,uddhastoti,uddhastoti,2,0,2,0,10
412010,dhaṃsito,dhamsito,6,6,0,0,8
412011,pariyonaddhoti,pariyonaddhoti,7,0,7,0,14
412012,gimhakālasmiñhi,gimhakalasminhi,1,1,0,0,15
412013,māluvāsipāṭikāya,maluvasipatikaya,1,1,0,0,16
412014,vaṭarukkhādīnaṃ,vatarukkhadinam,5,4,1,0,15
412015,abhivaṭṭhe,abhivatthe,1,1,0,0,10
412016,rukkhadevatāyo,rukkhadevatayo,1,1,0,0,14
412017,latābhāvaṃ,latabhavam,1,1,0,0,10
412018,sabbaviṭapasākhāpasākhā,sabbavitapasakhapasakha,1,1,0,0,23
412019,pariyonandhanti,pariyonandhanti,2,2,0,0,15
412020,ghanehi,ghanehi,1,1,0,0,7
412021,māluvāpattehi,maluvapattehi,1,1,0,0,13
412022,vāyante,vayante,12,11,1,0,7
412023,khāṇumattameva,khanumattameva,2,2,0,0,14
412024,sālādīsu,saladisu,11,10,1,0,8
412025,aññatararukkho,annatararukkho,2,2,0,0,14
412026,rukkhārohanaṃ,rukkharohanam,1,1,0,0,13
412027,asampattakālo,asampattakalo,1,1,0,0,13
412028,sākhānusārena,sakhanusarena,1,1,0,0,13
412029,pariyonaddhakālo,pariyonaddhakalo,2,2,0,0,16
412030,pariyuṭṭhitakālo,pariyutthitakalo,1,1,0,0,16
412031,khuddakasākhānaṃ,khuddakasakhanam,2,2,0,0,16
412032,palujjanakālo,palujjanakalo,2,2,0,0,13
412033,dvārappattānaṃ,dvarappattanam,1,1,0,0,14
412034,khuddānukhuddakā,khuddanukhuddaka,7,7,0,0,16
412035,mahāsākhānaṃ,mahasakhanam,1,1,0,0,12
412036,latānusārena,latanusarena,1,1,0,0,12
412037,otiṇṇena,otinnena,6,6,0,0,8
412038,tintesu,tintesu,1,1,0,0,7
412039,nibbattanakālo,nibbattanakalo,1,1,0,0,14
412040,āgatapuriso,agatapuriso,5,5,0,0,11
412041,saddhāpiṭakaṃ,saddhapitakam,1,1,0,0,13
412042,palikhananakhaṇitti,palikhananakhanitti,1,1,0,0,19
412043,mūlacchedanaṃ,mulacchedanam,3,3,0,0,13
412044,avijjāmūlassa,avijjamulassa,1,1,0,0,13
412045,chindanakālo,chindanakalo,4,4,0,0,12
412046,phālanakālo,phalanakalo,2,2,0,0,11
412047,samugghātitakālo,samugghatitakalo,1,1,0,0,16
412048,masikaraṇakālo,masikaranakalo,2,2,0,0,14
412049,dharamānakapañcakkhandhakālo,dharamanakapancakkhandhakalo,1,1,0,0,28
412050,opuṇitvā,opunitva,1,1,0,0,8
412051,appavattanakālo,appavattanakalo,1,1,0,0,15
412052,upādinnakakkhandhānaṃ,upadinnakakkhandhanam,3,3,0,0,21
412053,paṭisandhiaggahaṇakālo,patisandhiaggahanakalo,1,1,0,0,22
412054,uposathasuttavaṇṇanā,uposathasuttavannana,10,10,0,0,20
412055,tadahuposatheti,tadahuposatheti,8,1,7,0,15
412056,pannarasikauposathadivaseti,pannarasikauposathadivaseti,1,1,0,0,27
412057,gandhamālādihatthā,gandhamaladihattha,22,21,1,0,18
412058,vavassaggatthe,vavassaggatthe,15,15,0,0,14
412059,divassāti,divassati,13,0,13,0,9
412060,vicarasīti,vicarasiti,4,4,0,0,10
412061,gopālakuposathoti,gopalakuposathoti,1,0,1,0,17
412062,upavasanauposatho,upavasanauposatho,3,3,0,0,17
412063,nigaṇṭhuposathoti,niganthuposathoti,1,0,1,0,17
412064,ariyuposathoti,ariyuposathoti,1,0,1,0,14
412065,visākheti,visakheti,2,1,1,0,9
412066,niyyātetvāti,niyyatetvati,2,0,2,0,12
412067,devasikavetanena,devasikavetanena,2,2,0,0,16
412068,pañcāhadasāhaaddhamāsamāsachamāsasaṃvaccharaparicchedena,pancahadasahaaddhamasamasachamasasamvaccharaparicchedena,1,1,0,0,56
412069,abhijjhāsahagatenāti,abhijjhasahagatenati,1,0,1,0,20
412070,ariyuposathova,ariyuposathova,1,1,0,0,14
412071,aparisuddhavitakkatāya,aparisuddhavitakkataya,1,1,0,0,22
412072,gopālakauposathaṭṭhāne,gopalakauposathatthane,1,1,0,0,22
412073,mahapphaloti,mahapphaloti,3,0,3,0,12
412074,vipākaphalena,vipakaphalena,6,6,0,0,13
412075,mahānisaṃsoti,mahanisamsoti,4,1,3,0,13
412076,vipākānisaṃsena,vipakanisamsena,1,1,0,0,15
412077,mahājutikoti,mahajutikoti,2,0,2,0,12
412078,vipākobhāsena,vipakobhasena,2,2,0,0,13
412079,vipākavipphārassa,vipakavippharassa,1,1,0,0,17
412080,amahantatāya,amahantataya,1,1,0,0,12
412081,samaṇajātikāti,samanajatikati,1,0,1,0,14
412082,samaṇāyeva,samanayeva,2,2,0,0,10
412083,nikkhipāhīti,nikkhipahiti,5,1,4,0,12
412084,yojanasatato,yojanasatato,4,4,0,0,12
412085,parabhāgesu,parabhagesu,3,3,0,0,11
412086,nikkhipa,nikkhipa,11,10,1,0,8
412087,ekaparikkhārepi,ekaparikkharepi,1,1,0,0,15
412088,chinnapalibodhohamasmīti,chinnapalibodhohamasmiti,1,1,0,0,24
412089,bhogeti,bhogeti,12,0,12,0,7
412090,mañcapīṭhayāgubhattādayo,mancapithayagubhattadayo,1,1,0,0,24
412091,nipajjantopi,nipajjantopi,4,4,0,0,12
412092,pivantopi,pivantopi,3,3,0,0,9
412093,adinneyeva,adinneyeva,1,1,0,0,10
412094,nipphalotveva,nipphalotveva,1,1,0,0,13
412095,cittavisodhanakammaṭṭhānaṃ,cittavisodhanakammatthanam,1,1,0,0,26
412096,paccattapurisakārena,paccattapurisakarena,10,10,0,0,20
412097,pāṭiyekkaguṇāva,patiyekkagunava,2,1,1,0,15
412098,kakkaṃ,kakkam,2,1,1,0,6
412099,āmalakakakkaṃ,amalakakakkam,1,1,0,0,13
412100,tajjātikaṃ,tajjatikam,14,9,5,0,10
412101,kakkena,kakkena,3,3,0,0,7
412102,makkhanaghaṃsanadhovanavāyāmaṃ,makkhanaghamsanadhovanavayamam,1,1,0,0,30
412103,suddhabhāvakaraṇaṃ,suddhabhavakaranam,1,1,0,0,18
412104,kiliṭṭhasmiṃ,kilitthasmim,1,1,0,0,12
412105,kiliṭṭhacittena,kilitthacittena,1,1,0,0,15
412106,upavasatīti,upavasatiti,2,1,1,0,11
412107,guṇānussaraṇavasena,gunanussaranavasena,2,2,0,0,19
412108,brahmuposatho,brahmuposatho,1,1,0,0,13
412109,saṃvasatīti,samvasatiti,6,1,5,0,11
412110,sahatantikaṃ,sahatantikam,3,2,1,0,12
412111,sottiṃ,sottim,2,1,1,0,6
412112,kuruvindakasottiṃ,kuruvindakasottim,1,1,0,0,17
412113,kuruvindakapāsāṇacuṇṇena,kuruvindakapasanacunnena,1,1,0,0,24
412114,lākhaṃ,lakham,7,5,2,0,6
412115,kalāpapantiṃ,kalapapantim,1,1,0,0,12
412116,ghaṃsenti,ghamsenti,3,3,0,0,9
412117,nhānīyacuṇṇaṃ,nhaniyacunnam,2,2,0,0,13
412118,ubbaṭṭanaghaṃsanadhovanādikaṃ,ubbattanaghamsanadhovanadikam,1,1,0,0,29
412119,tadanurūpavāyāmaṃ,tadanurupavayamam,1,1,0,0,17
412120,upavutthattā,upavutthatta,2,2,0,0,12
412121,dhammuposatho,dhammuposatho,1,1,0,0,13
412122,gāhāpitaṃ,gahapitam,4,3,1,0,9
412123,usañcātipi,usancatipi,1,1,0,0,10
412124,gomuttaṃ,gomuttam,5,5,0,0,8
412125,ajalaṇḍikā,ajalandika,9,9,0,0,10
412126,saṅghuposatho,sanghuposatho,6,6,0,0,13
412127,akhaṇḍānītiādīnaṃ,akhandanitiadinam,1,0,1,0,17
412128,assavālehi,assavalehi,2,2,0,0,10
412129,makacivālādīhi,makacivaladihi,1,1,0,0,14
412130,tintabhāvaṃ,tintabhavam,1,1,0,0,11
412131,vālaṇḍupakena,valandupakena,1,1,0,0,13
412132,ghaṃsanavāyāmo,ghamsanavayamo,1,1,0,0,14
412133,kiliṭṭhasmiñhi,kilitthasminhi,3,3,0,0,14
412134,maṇḍitapasādhitopi,manditapasadhitopi,2,2,0,0,18
412135,sīlānussaraṇavasena,silanussaranavasena,1,1,0,0,19
412136,sīluposatho,siluposatho,1,1,0,0,11
412137,pañcasīladasasīlena,pancasiladasasilena,3,3,0,0,19
412138,loṇamattikā,lonamattika,1,1,0,0,11
412139,gerukaṃ,gerukam,7,6,1,0,7
412140,gerukacuṇṇaṃ,gerukacunnam,1,1,0,0,12
412141,nāḷikasaṇḍāsaṃ,nalikasandasam,1,0,1,0,14
412142,dhamananāḷikañceva,dhamananalikanceva,1,1,0,0,18
412143,parivattanasaṇḍāsañca,parivattanasandasanca,1,1,0,0,21
412144,pakkhipanadhamanaparivattanādikaṃ,pakkhipanadhamanaparivattanadikam,1,1,0,0,33
412145,saṃkiliṭṭhasuvaṇṇamayena,samkilitthasuvannamayena,1,1,0,0,24
412146,pasādhanabhaṇḍena,pasadhanabhandena,1,1,0,0,17
412147,parisuddhasuvaṇṇamayena,parisuddhasuvannamayena,1,1,0,0,23
412148,parisuddhacittassa,parisuddhacittassa,3,3,0,0,18
412149,anussarantena,anussarantena,8,8,0,0,13
412150,upavutthauposatho,upavutthauposatho,1,1,0,0,17
412151,devatuposatho,devatuposatho,1,1,0,0,13
412152,paṭiviratāti,pativiratati,14,11,3,0,12
412153,viratāva,viratava,1,1,0,0,8
412154,nihitasatthāti,nihitasatthati,1,0,1,0,14
412155,nikkhittadaṇḍā,nikkhittadanda,1,1,0,0,14
412156,nikkhittasatthā,nikkhittasattha,3,3,0,0,15
412157,vihiṃsanabhāvato,vihimsanabhavato,3,3,0,0,16
412158,satthanti,satthanti,7,7,0,0,9
412159,pipphalakaṃ,pipphalakam,3,3,0,0,11
412160,dayāpannāti,dayapannati,1,0,1,0,11
412161,hitacittakāti,hitacittakati,1,1,0,0,13
412162,ahampajjāti,ahampajjati,1,0,1,0,11
412163,aṅgenāti,angenati,9,1,8,0,8
412164,guṇaṅgena,gunangena,6,6,0,0,9
412165,anukaromīti,anukaromiti,1,0,1,0,11
412166,arahatañca,arahatanca,1,1,0,0,10
412167,anukataṃ,anukatam,1,1,0,0,8
412168,corikanti,corikanti,1,1,0,0,9
412169,paṭikaṅkhantīti,patikankhantiti,1,1,0,0,15
412170,dūrācārī,duracari,1,1,0,0,8
412171,methunoti,methunoti,2,1,1,0,9
412172,alikavacanā,alikavacana,1,1,0,0,11
412173,tucchavacanā,tucchavacana,1,1,0,0,12
412174,saṃdahanti,samdahanti,1,1,0,0,10
412175,saṃdahantiyevāti,samdahantiyevati,1,1,0,0,16
412176,thetāti,thetati,1,0,1,0,7
412177,ṭhitakathāti,thitakathati,2,1,1,0,12
412178,nikhātakhāṇu,nikhatakhanu,6,6,0,0,12
412179,ṭhitakatho,thitakatho,2,2,0,0,10
412180,paccayikāti,paccayikati,2,0,2,0,11
412181,pattiyāyitabbakā,pattiyayitabbaka,1,1,0,0,16
412182,saddhāyikāti,saddhayikati,2,1,1,0,12
412183,surāmerayamajjānaṃ,suramerayamajjanam,2,2,0,0,18
412184,pānacetanāsaṅkhātaṃ,panacetanasankhatam,1,1,0,0,19
412185,pamādakāraṇaṃ,pamadakaranam,4,4,0,0,13
412186,ekabhattikāti,ekabhattikati,3,2,1,0,13
412187,bhuñjamānāpi,bhunjamanapi,2,2,0,0,12
412188,ekabhattikāva,ekabhattikava,3,3,0,0,13
412189,rattibhojanaṃ,rattibhojanam,4,4,0,0,13
412190,uparatāti,uparatati,2,2,0,0,9
412191,sūriyatthaṅgamanā,suriyatthangamana,13,11,2,0,17
412192,paṭāṇibhūtaṃ,patanibhutam,1,1,0,0,12
412193,mayūranaccanādivasenāpi,mayuranaccanadivasenapi,2,2,0,0,23
412194,visūkabhūtaṃ,visukabhutam,4,3,1,0,12
412195,dassanañcāti,dassanancati,3,2,1,0,12
412196,naccagītavāditavisūkadassanaṃ,naccagitavaditavisukadassanam,5,1,4,0,29
412197,payuttāni,payuttani,10,10,0,0,9
412198,akappiyattharaṇaṃ,akappiyattharanam,10,5,5,0,17
412199,kīvamahapphaloti,kivamahapphaloti,2,0,2,0,16
412200,pahūtena,pahutena,3,2,1,0,8
412201,rattasaṅkhātena,rattasankhatena,2,1,1,0,15
412202,ratanena,ratanena,10,9,1,0,8
412203,bheritalasadisaṃ,bheritalasadisam,3,2,1,0,16
412204,kaṭippamāṇehi,katippamanehi,1,1,0,0,13
412205,pūritānanti,puritananti,1,1,0,0,11
412206,issariyameva,issariyameva,2,2,0,0,12
412207,sāhasikakammantipi,sahasikakammantipi,1,1,0,0,18
412208,kāreyyāti,kareyyati,9,5,4,0,9
412209,upavutthauposathe,upavutthauposathe,1,1,0,0,17
412210,ekarattuposathassa,ekarattuposathassa,1,1,0,0,18
412211,soḷasiyā,solasiya,1,1,0,0,8
412212,abrahmacariyāti,abrahmacariyati,4,0,4,0,15
412213,aseṭṭhacariyato,asetthacariyato,3,3,0,0,15
412214,upavasanto,upavasanto,9,9,0,0,10
412215,rattibhojanañca,rattibhojananca,3,3,0,0,15
412216,divāvikālabhojanañca,divavikalabhojananca,3,3,0,0,20
412217,chamāyaṃva,chamayamva,4,2,2,0,10
412218,santhateti,santhateti,5,0,5,0,10
412219,muṭṭhihatthapādake,mutthihatthapadake,1,1,0,0,18
412220,kappiyamañce,kappiyamance,4,4,0,0,12
412221,sudhādiparikammakatāya,sudhadiparikammakataya,6,6,0,0,22
412222,tiṇapaṇṇapalālādīni,tinapannapalaladini,3,3,0,0,19
412223,sayethāti,sayethati,4,4,0,0,9
412224,asamācarantena,asamacarantena,3,3,0,0,14
412225,upavutthaṃ,upavuttham,4,4,0,0,10
412226,aṭṭhaṅgikanti,atthangikanti,1,1,0,0,13
412227,upavasantena,upavasantena,3,2,1,0,12
412228,āhārādividhānaṃ,aharadividhanam,1,1,0,0,15
412229,dasasīlalakkhaṇaññuno,dasasilalakkhanannuno,1,1,0,0,21
412230,buddhapaññattaṃ,buddhapannattam,2,2,0,0,15
412231,adhiṭṭhāmī,adhitthami,76,76,0,0,10
412232,kātabboyeva,katabboyeva,9,9,0,0,11
412233,parūparodhapaṭisaṃyuttā,paruparodhapatisamyutta,2,1,1,0,23
412234,āyavayagaṇanaṃ,ayavayagananam,1,1,0,0,14
412235,vītināmetabbaṃ,vitinametabbam,3,3,0,0,14
412236,niccabhattikabhikkhunā,niccabhattikabhikkhuna,1,1,0,0,22
412237,sudassanāti,sudassanati,4,0,4,0,11
412238,sundaradassanā,sundaradassana,2,2,0,0,14
412239,obhāsayamānā,obhasayamana,5,5,0,0,12
412240,anupariyantīti,anupariyantiti,3,0,3,0,14
412241,antalikkhagāti,antalikkhagati,1,0,1,0,14
412242,ākāsaṅgamā,akasangama,1,1,0,0,10
412243,pabhāsantīti,pabhasantiti,3,1,2,0,12
412244,disāvirocanāti,disavirocanati,1,0,1,0,14
412245,obhāsanti,obhasanti,12,12,0,0,9
412246,virocanāti,virocanati,6,0,6,0,10
412247,jātimaṇibhāvaṃ,jatimanibhavam,2,2,0,0,14
412248,ekavassikaveḷuvaṇṇañhi,ekavassikaveluvannanhi,1,1,0,0,22
412249,jātimaṇi,jatimani,1,1,0,0,8
412250,gosiṅgasadisaṃ,gosingasadisam,1,1,0,0,14
412251,jātasuvaṇṇaṃ,jatasuvannam,1,1,0,0,12
412252,satthuvaṇṇasuvaṇṇaṃ,satthuvannasuvannam,1,1,0,0,19
412253,kipillikāhi,kipillikahi,1,1,0,0,11
412254,nīhaṭasuvaṇṇaṃ,nihatasuvannam,1,1,0,0,14
412255,nānubhavantīti,nanubhavantiti,6,4,2,0,14
412256,candappabhāti,candappabhati,4,0,4,0,13
412257,candappabhāyāti,candappabhayati,1,1,0,0,15
412258,sukhudrayānīti,sukhudrayaniti,1,0,1,0,14
412259,sukhaphalāni,sukhaphalani,1,1,0,0,12
412260,sukhavedanīyāni,sukhavedaniyani,1,1,0,0,15
412261,saggasaṅkhātaṃ,saggasankhatam,1,1,0,0,14
412262,channasuttavaṇṇanā,channasuttavannana,9,9,0,0,18
412263,channoti,channoti,10,2,8,0,8
412264,channaparibbājako,channaparibbajako,18,15,3,0,17
412265,paññāpemāti,pannapemati,2,2,0,0,11
412266,āvusotiādimāha,avusotiadimaha,13,0,13,0,14
412267,bāhirasamayaṃ,bahirasamayam,4,4,0,0,13
412268,mayamevā,mayameva,1,1,0,0,8
412269,tumhetiādimāha,tumhetiadimaha,2,0,2,0,14
412270,khotiādimāha,khotiadimaha,20,0,20,0,12
412271,paratthaubhayatthesupi,paratthaubhayatthesupi,1,1,0,0,22
412272,andhakaraṇotiādīsu,andhakaranotiadisu,1,0,1,0,18
412273,yathābhūtadassananivāraṇena,yathabhutadassananivaranena,2,2,0,0,27
412274,vipassanāpaññāti,vipassanapannati,5,3,2,0,16
412275,aniṭṭhaphaladāyakattā,anitthaphaladayakatta,2,2,0,0,21
412276,dukkhasaṅkhātassa,dukkhasankhatassa,3,2,1,0,17
412277,appamādāyāti,appamadayati,3,0,3,0,12
412278,lokuttaramissako,lokuttaramissako,2,1,1,0,16
412279,ājīvakasuttavaṇṇanā,ajivakasuttavannana,3,3,0,0,19
412280,pariggaṇhanatthaṃ,parigganhanattham,6,5,1,0,17
412281,pucchitapañhaṃ,pucchitapanham,13,12,1,0,14
412282,hītiādimāha,hitiadimaha,7,0,7,0,11
412283,kāraṇāpadeso,karanapadeso,2,2,0,0,12
412284,paṭipucchāmīti,patipucchamiti,1,1,0,0,14
412285,sadhammukkaṃsanāti,sadhammukkamsanati,1,0,1,0,18
412286,paradhammāpasādanāti,paradhammapasadanati,1,0,1,0,20
412287,avakkhipanā,avakkhipana,1,1,0,0,11
412288,kāraṇasmiṃyeva,karanasmimyeva,1,1,0,0,14
412289,pucchitapañhāya,pucchitapanhaya,1,1,0,0,15
412290,anupanītoti,anupanitoti,2,0,2,0,11
412291,nupanītotipi,nupanitotipi,1,1,0,0,12
412292,mahānāmasakkasuttavaṇṇanā,mahanamasakkasuttavannana,3,3,0,0,25
412293,vuṭṭhitoti,vutthitoti,45,5,40,0,10
412294,gelaññāti,gelannati,2,1,1,0,9
412295,mālāgandhādīni,malagandhadini,17,17,0,0,14
412296,mahāparivāraparivuto,mahaparivaraparivuto,1,1,0,0,20
412297,nisinnāsanato,nisinnasanato,20,20,0,0,13
412298,dakkhiṇabāhāyaṃ,dakkhinabahayam,1,1,0,0,15
412299,aṅguṭṭhakena,angutthakena,7,7,0,0,12
412300,apanesīti,apanesiti,2,1,1,0,9
412301,arahattaphalavasena,arahattaphalavasena,5,5,0,0,19
412302,sekhasamādhito,sekhasamadhito,1,1,0,0,14
412303,sekhavipassanāñāṇato,sekhavipassanananato,1,1,0,0,20
412304,asekhaphalasamādhi,asekhaphalasamadhi,1,1,0,0,18
412305,sampayuttāni,sampayuttani,11,11,0,0,12
412306,samādhiñāṇāni,samadhinanani,1,1,0,0,13
412307,nigaṇṭhasuttavaṇṇanā,niganthasuttavannana,3,3,0,0,20
412308,haṃsavaṭṭakacchannena,hamsavattakacchannena,7,7,0,0,21
412309,upaṭṭhitamevāti,upatthitamevati,1,1,0,0,15
412310,āyūhitakammānaṃ,ayuhitakammanam,1,1,0,0,15
412311,dukkaratapena,dukkaratapena,1,1,0,0,13
412312,vigatantakaraṇaṃ,vigatantakaranam,1,1,0,0,16
412313,āyūhitabbakammānaṃ,ayuhitabbakammanam,1,1,0,0,18
412314,akaraṇāti,akaranati,1,0,1,0,9
412315,anāyūhanena,anayuhanena,2,2,0,0,11
412316,paccayaghātaṃ,paccayaghatam,1,1,0,0,13
412317,dukkhakkhayoti,dukkhakkhayoti,2,1,1,0,14
412318,kammavaṭṭakkhayena,kammavattakkhayena,1,1,0,0,18
412319,vedanākkhayoti,vedanakkhayoti,1,0,1,0,14
412320,dukkhavaṭṭakkhayena,dukkhavattakkhayena,1,1,0,0,19
412321,dukkhavaṭṭasmiñhi,dukkhavattasminhi,1,1,0,0,17
412322,vedanāvaṭṭampi,vedanavattampi,1,1,0,0,14
412323,khīṇameva,khinameva,2,2,0,0,9
412324,vedanākkhayena,vedanakkhayena,1,1,0,0,14
412325,nijjiṇṇameva,nijjinnameva,1,1,0,0,12
412326,sandiṭṭhikāyāti,sanditthikayati,1,0,1,0,15
412327,passitabbāya,passitabbaya,1,1,0,0,12
412328,kilesajīraṇakapaṭipadāya,kilesajiranakapatipadaya,1,1,0,0,24
412329,nijjīraṇato,nijjiranato,1,1,0,0,11
412330,kimāhāti,kimahati,2,1,1,0,8
412331,kimāha,kimaha,5,5,0,0,6
412332,kilesanijjīraṇakapaṭipadaṃ,kilesanijjiranakapatipadam,1,1,0,0,26
412333,visuddhisampāpanatthāya,visuddhisampapanatthaya,1,1,0,0,23
412334,samatikkamāyāti,samatikkamayati,10,0,10,0,15
412335,atthaṅgamāyāti,atthangamayati,7,0,7,0,14
412336,adhigamāyāti,adhigamayati,14,4,10,0,12
412337,apaccayanibbānassa,apaccayanibbanassa,3,2,1,0,18
412338,nāyūhati,nayuhati,4,4,0,0,8
412339,vigatantaṃ,vigatantam,23,21,2,0,10
412340,vipākaphassaṃ,vipakaphassam,1,1,0,0,13
412341,sandiṭṭhikāti,sanditthikati,3,0,3,0,13
412342,akālikāti,akalikati,1,0,1,0,9
412343,kiccakārikā,kiccakarika,3,3,0,0,11
412344,ehipassikāti,ehipassikati,1,0,1,0,12
412345,opaneyyikāti,opaneyyikati,1,0,1,0,12
412346,upanaye,upanaye,1,1,0,0,7
412347,allīyitabbayuttā,alliyitabbayutta,1,1,0,0,16
412348,santāneyeva,santaneyeva,2,2,0,0,11
412349,dujjānā,dujjana,6,6,0,0,7
412350,kāmehītiādikāya,kamehitiadikaya,1,0,1,0,15
412351,khayātiādīhi,khayatiadihi,1,0,1,0,12
412352,sīlasamādhayopi,silasamadhayopi,1,1,0,0,15
412353,arahattaphalasampayuttāva,arahattaphalasampayuttava,1,1,0,0,25
412354,nivesakasuttavaṇṇanā,nivesakasuttavannana,3,3,0,0,20
412355,amaccāti,amaccati,5,1,4,0,8
412356,sassusasurapakkhikā,sassusasurapakkhika,11,8,3,0,19
412357,sālohitāti,salohitati,6,0,6,0,10
412358,samānalohitā,samanalohita,2,2,0,0,12
412359,aveccappasādeti,aveccappasadeti,2,1,1,0,15
412360,acalappasāde,acalappasade,1,1,0,0,12
412361,pathavīdhātuyātiādīsu,pathavidhatuyatiadisu,1,0,1,0,21
412362,thaddhākārabhūtāya,thaddhakarabhutaya,1,1,0,0,18
412363,yūsagatāya,yusagataya,1,1,0,0,10
412364,ābandhanabhūtāya,abandhanabhutaya,1,1,0,0,16
412365,paripācanabhūtāya,paripacanabhutaya,1,1,0,0,17
412366,vitthambhanabhūtāya,vitthambhanabhutaya,1,1,0,0,19
412367,tvevāti,tvevati,13,0,13,0,7
412368,aññamaññabhāvūpagamanena,annamannabhavupagamanena,1,1,0,0,24
412369,pasādaññathattañca,pasadannathattanca,1,1,0,0,18
412370,gatiaññathattañca,gatiannathattanca,1,1,0,0,17
412371,apāyagatisaṅkhātaṃ,apayagatisankhatam,1,1,0,0,18
412372,gatiaññathattaṃ,gatiannathattam,5,3,2,0,15
412373,paṭhamabhavasuttavaṇṇanā,pathamabhavasuttavannana,1,1,0,0,24
412374,kāmadhātuvepakkaṃ,kamadhatuvepakkam,1,0,1,0,17
412375,vipaccanakaṃ,vipaccanakam,2,2,0,0,12
412376,viruhanaṭṭhānaṭṭhena,viruhanatthanatthena,2,2,0,0,20
412377,viruhanaṭṭhena,viruhanatthena,4,4,0,0,14
412378,snehoti,snehoti,5,0,5,0,7
412379,paggaṇhanānubrūhanavasena,pagganhananubruhanavasena,1,1,0,0,25
412380,āvaritānaṃ,avaritanam,2,2,0,0,10
412381,taṇhābandhanena,tanhabandhanena,6,6,0,0,15
412382,dutiyabhavasuttavaṇṇanā,dutiyabhavasuttavannana,1,1,0,0,23
412383,kammapatthanāva,kammapatthanava,1,1,0,0,15
412384,sīlabbatasuttavaṇṇanā,silabbatasuttavannana,3,3,0,0,21
412385,dukkarakārikānuyogo,dukkarakarikanuyogo,1,1,0,0,19
412386,upaṭṭhitanti,upatthitanti,5,5,0,0,12
412387,saudrayaṃ,saudrayam,4,4,0,0,9
412388,savaḍḍhikaṃ,savaddhikam,4,3,1,0,11
412389,byākātabbanti,byakatabbanti,1,1,0,0,13
412390,sevatoti,sevatoti,7,0,7,0,8
412391,iṭṭhaphalena,itthaphalena,3,3,0,0,12
412392,kammavādikiriyavādīnaṃ,kammavadikiriyavadinam,2,2,0,0,22
412393,bāhirakasamayo,bahirakasamayo,1,1,0,0,14
412394,sulabhoti,sulabhoti,1,1,0,0,9
412395,sekkhabhūmi,sekkhabhumi,17,14,3,0,11
412396,gandhajātasuttavaṇṇanā,gandhajatasuttavannana,3,3,0,0,22
412397,divāvihāraṭṭhānaṃ,divaviharatthanam,4,4,0,0,17
412398,gahaṇakāleyeva,gahanakaleyeva,1,1,0,0,14
412399,kaṅkhuppattisamaye,kankhuppattisamaye,1,1,0,0,18
412400,upasaṅkamanavarassa,upasankamanavarassa,1,1,0,0,19
412401,takkhaṇaṃyeva,takkhanamyeva,1,1,0,0,13
412402,gandhajātānīti,gandhajataniti,1,0,1,0,14
412403,gandhajātiyo,gandhajatiyo,2,2,0,0,12
412404,mūlavatthuko,mulavatthuko,3,1,2,0,12
412405,gandhasampannaṃ,gandhasampannam,12,11,1,0,15
412406,sāragandhapupphagandhesu,saragandhapupphagandhesu,1,0,1,0,24
412407,saraṇagamanādayo,saranagamanadayo,1,1,0,0,16
412408,guṇavaṇṇabhāsanavasena,gunavannabhasanavasena,1,1,0,0,22
412409,disāgāmitāya,disagamitaya,1,1,0,0,12
412410,gandhasadisattā,gandhasadisatta,1,1,0,0,15
412411,vaṇṇabhāsanavasena,vannabhasanavasena,1,1,0,0,18
412412,pañcasīlena,pancasilena,3,3,0,0,11
412413,dasasīlena,dasasilena,2,2,0,0,10
412414,sīladhammena,siladhammena,1,1,0,0,12
412415,vigatamalamaccherenātiādīnaṃ,vigatamalamaccherenatiadinam,1,0,1,0,28
412416,disāsūti,disasuti,4,0,4,0,8
412417,paṭivātametīti,pativatametiti,3,0,3,0,14
412418,vassikapupphādīnaṃ,vassikapupphadinam,4,3,1,0,18
412419,candanatagaramallikānampi,candanatagaramallikanampi,1,1,0,0,25
412420,phuṭasumanā,phutasumana,1,1,0,0,11
412421,pupphitadivase,pupphitadivase,1,1,0,0,14
412422,vidatthimattampi,vidatthimattampi,8,8,0,0,16
412423,ratanamattampi,ratanamattampi,6,6,0,0,14
412424,sīlādiguṇagandho,siladigunagandho,1,1,0,0,16
412425,sīlādiguṇagandhena,siladigunagandhena,1,1,0,0,18
412426,avattharatīti,avattharatiti,4,4,0,0,13
412427,cūḷanikāsuttavaṇṇanā,culanikasuttavannana,3,3,0,0,20
412428,dasamassa,dasamassa,11,11,0,0,9
412429,atthuppattikopi,atthuppattikopi,1,1,0,0,15
412430,pucchāvasikopi,pucchavasikopi,1,1,0,0,14
412431,kataraatthuppattiyaṃ,kataraatthuppattiyam,1,1,0,0,20
412432,aruṇavatisuttantaatthuppattiyaṃ,arunavatisuttantaatthuppattiyam,1,1,0,0,31
412433,aruṇavatisuttanto,arunavatisuttanto,1,1,0,0,17
412434,sikhinā,sikhina,4,3,1,0,7
412435,ekatiṃsakappamatthake,ekatimsakappamatthake,2,2,0,0,21
412436,aruṇavatinagare,arunavatinagare,1,1,0,0,15
412437,pabhāvatiyā,pabhavatiya,24,24,0,0,11
412438,aruṇavatiṃ,arunavatim,9,9,0,0,10
412439,sarīrappaṭijagganaṃ,sarirappatijagganam,7,7,0,0,19
412440,vihāradvārakoṭṭhakasamīpe,viharadvarakotthakasamipe,2,2,0,0,25
412441,tenupasaṅkamiṃsū,tenupasankamimsu,5,3,2,0,16
412442,brahmāsanaṃ,brahmasanam,3,3,0,0,11
412443,brahmaparisāya,brahmaparisaya,6,6,0,0,14
412444,dhammīkathāti,dhammikathati,1,1,0,0,13
412445,brahmagaṇā,brahmagana,4,4,0,0,10
412446,cirassañca,cirassanca,2,2,0,0,10
412447,brahmalokāgamanaṃ,brahmalokagamanam,2,2,0,0,17
412448,anattamanabhāvaṃ,anattamanabhavam,5,5,0,0,16
412449,saṃvejehī,samvejehi,6,6,0,0,9
412450,nikkamathā,nikkamatha,10,10,0,0,10
412451,viññāpesīti,vinnapesiti,10,9,1,0,11
412452,vicinantānaṃ,vicinantanam,5,3,2,0,12
412453,sahassacakkavāḷe,sahassacakkavale,3,3,0,0,16
412454,theraṃyeva,theramyeva,3,3,0,0,10
412455,osaṭāya,osataya,5,3,2,0,7
412456,bhāsamānassā,bhasamanassa,7,7,0,0,12
412457,sutabhāvaṃ,sutabhavam,4,4,0,0,10
412458,āvikarontā,avikaronta,1,1,0,0,10
412459,udāhariṃsu,udaharimsu,2,2,0,0,10
412460,jeṭṭhamūlamāsapuṇṇamadivase,jetthamulamasapunnamadivase,1,1,0,0,27
412461,aruṇavatisuttaṃ,arunavatisuttam,2,2,0,0,15
412462,sakalasuttaṃ,sakalasuttam,11,11,0,0,12
412463,saddhivihārikantevāsikesu,saddhiviharikantevasikesu,2,2,0,0,25
412464,cakkavāḷasahasse,cakkavalasahasse,16,14,2,0,16
412465,sarīrobhāsaṃ,sarirobhasam,10,10,0,0,12
412466,viññāpeyyā,vinnapeyya,7,6,1,0,10
412467,dūtaparamparāyāti,dutaparamparayati,1,1,0,0,17
412468,nakhasikhāya,nakhasikhaya,2,2,0,0,12
412469,mahāpathavipaṃsunā,mahapathavipamsuna,1,1,0,0,18
412470,upamento,upamento,10,10,0,0,8
412471,buddhānanti,buddhananti,6,6,0,0,11
412472,anantākāsena,anantakasena,2,2,0,0,12
412473,cātakasakuṇaṃ,catakasakunam,3,3,0,0,13
412474,diyaḍḍhayojanasatikena,diyaddhayojanasatikena,2,2,0,0,22
412475,supaṇṇarājena,supannarajena,2,2,0,0,13
412476,hatthisoṇḍāya,hatthisondaya,1,1,0,0,13
412477,nāḷikodanamattalābhiṃ,nalikodanamattalabhim,1,1,0,0,21
412478,cakkavattiraññā,cakkavattiranna,3,3,0,0,15
412479,paṃsupisācakaṃ,pamsupisacakam,3,1,2,0,14
412480,khajjopanakappabhaṃ,khajjopanakappabham,1,1,0,0,19
412481,appameyyabhāvameva,appameyyabhavameva,1,1,0,0,18
412482,buddhasīhanādaṃ,buddhasihanadam,10,8,2,0,15
412483,nadāpessāmī,nadapessami,2,2,0,0,11
412484,ānandātiādimāha,anandatiadimaha,11,0,11,0,15
412485,hānandātiādimāha,hanandatiadimaha,2,0,2,0,16
412486,candimasūriyāti,candimasuriyati,6,1,5,0,15
412487,bhantīti,bhantiti,3,0,3,0,8
412488,ekacakkavāḷaṃ,ekacakkavalam,4,4,0,0,13
412489,mahārājasahassānīti,maharajasahassaniti,1,0,1,0,19
412490,cūḷanikāti,culanikati,1,0,1,0,10
412491,majjhimikāya,majjhimikaya,3,2,1,0,12
412492,paricchedadassanatthaṃ,paricchedadassanattham,10,8,2,0,22
412493,sahassadhāti,sahassadhati,6,0,6,0,12
412494,lokadhātūti,lokadhatuti,8,4,4,0,11
412495,sahassacakkavāḷāni,sahassacakkavalani,2,1,1,0,18
412496,dasasatasahassacakkavāḷaparimāṇā,dasasatasahassacakkavalaparimana,3,3,0,0,32
412497,bodhisattānañhi,bodhisattananhi,9,9,0,0,15
412498,sambodhidhammacakkappavattanaāyusaṅkhāravossajjanaparinibbānadivasesu,sambodhidhammacakkappavattanaayusankharavossajjanaparinibbanadivasesu,1,1,0,0,69
412499,mahāsahassīti,mahasahassiti,1,0,1,0,13
412500,sahassito,sahassito,2,2,0,0,9
412501,tatiyāti,tatiyati,8,6,2,0,8
412502,majjhimikaṃ,majjhimikam,7,5,2,0,11
412503,gaṇitattā,ganitatta,12,12,0,0,9
412504,gaṇitāti,ganitati,5,5,0,0,8
412505,koṭisatasahassacakkavāḷaparimāṇo,kotisatasahassacakkavalaparimano,2,2,0,0,32
412506,viññāpeyyāti,vinnapeyyati,6,2,4,0,12
412507,gaṇakaputtatissatthero,ganakaputtatissatthero,2,2,0,0,22
412508,sajjhāyamuḷhakaṃ,sajjhayamulhakam,1,1,0,0,16
412509,parihīnaṭṭhānaṃ,parihinatthanam,2,2,0,0,15
412510,dasakoṭisatasahassacakkavāḷaparimāṇaṃ,dasakotisatasahassacakkavalaparimanam,2,2,0,0,37
412511,tisahassimahāsahassilokadhātu,tisahassimahasahassilokadhatu,3,3,0,0,29
412512,āṭānāṭiyaparittaisigiliparittadhajaggaparittabojjhaṅgaparittakhandhaparitta,atanatiyaparittaisigiliparittadhajaggaparittabojjhangaparittakhandhaparitta,1,1,0,0,75
412513,moraparittamettaparittaratanaparittānaṃ,moraparittamettaparittaratanaparittanam,1,1,0,0,39
412514,ākaṅkheyyāti,akankheyyati,5,1,4,0,12
412515,visayakkhettaṃ,visayakkhettam,9,5,4,0,14
412516,pamāṇaparicchedo,pamanaparicchedo,8,8,0,0,16
412517,natthikabhāve,natthikabhave,2,2,0,0,13
412518,koṭisatasahassacakkavāḷamhi,kotisatasahassacakkavalamhi,2,2,0,0,27
412519,sāsapehi,sasapehi,2,2,0,0,8
412520,sāsapaṃ,sasapam,7,7,0,0,7
412521,sāsapā,sasapa,4,4,0,0,6
412522,dakkhiṇādīsupi,dakkhinadisupi,2,2,0,0,14
412523,pacchimayāmo,pacchimayamo,4,4,0,0,12
412524,kammappasutā,kammappasuta,2,2,0,0,12
412525,āhārappasutāti,aharappasutati,1,1,0,0,14
412526,vikkhittā,vikkhitta,12,12,0,0,9
412527,vimaticchedanatthaṃ,vimaticchedanattham,1,1,0,0,19
412528,phareyyāti,phareyyati,3,0,3,0,10
412529,bhūtāvaṭṭayakkhāvaṭṭadevatāvaṭṭānaṃ,bhutavattayakkhavattadevatavattanam,1,1,0,0,35
412530,vittakkaṃ,vittakkam,1,1,0,0,9
412531,nāgāvaṭṭabhūtāvaṭṭayakkhāvaṭṭadevatāvaṭṭānaṃ,nagavattabhutavattayakkhavattadevatavattanam,1,1,0,0,44
412532,ālokañca,alokanca,4,4,0,0,8
412533,andhakārañca,andhakaranca,1,1,0,0,12
412534,pariyesamānesu,pariyesamanesu,1,1,0,0,14
412535,patthareyya,patthareyya,3,3,0,0,11
412536,kammādippasutānaṃ,kammadippasutanam,1,1,0,0,17
412537,santāsajananatthaṃ,santasajananattham,1,1,0,0,18
412538,āpannabhāvaṃ,apannabhavam,17,17,0,0,12
412539,odātakasiṇasamāpattiṃ,odatakasinasamapattim,2,2,0,0,21
412540,ghanabuddharasmiṃ,ghanabuddharasmim,1,1,0,0,17
412541,candasahassasūriyasahassauṭṭhānakālo,candasahassasuriyasahassautthanakalo,1,1,0,0,36
412542,tilabījamattena,tilabijamattena,1,1,0,0,15
412543,kāyappadesena,kayappadesena,2,2,0,0,13
412544,cakkavāḷapathaviṃ,cakkavalapathavim,1,1,0,0,17
412545,dīpakapallakaṃ,dipakapallakam,2,2,0,0,14
412546,ekacakkavāḷeyeva,ekacakkavaleyeva,2,2,0,0,16
412547,vidatthimpi,vidatthimpi,2,2,0,0,11
412548,tilaphalappamāṇena,tilaphalappamanena,1,1,0,0,18
412549,sarīrappadesena,sarirappadesena,1,1,0,0,15
412550,bahalandhakārañca,bahalandhakaranca,1,1,0,0,17
412551,nisīdeyyuṃ,nisideyyum,2,2,0,0,10
412552,saddamanussāveyyāti,saddamanussaveyyati,1,0,1,0,19
412553,dhammakathāsaddamanussāveyya,dhammakathasaddamanussaveyya,1,1,0,0,28
412554,bhericammaṃ,bhericammam,1,1,0,0,11
412555,visayakkhettameva,visayakkhettameva,1,1,0,0,17
412556,pītivasena,pitivasena,12,12,0,0,10
412557,metiādimāha,metiadimaha,6,0,6,0,11
412558,evaṃmahiddhikoti,evammahiddhikoti,2,0,2,0,16
412559,suladdhañcāti,suladdhancati,1,1,0,0,13
412560,pādaparikammaṃ,padaparikammam,3,3,0,0,14
412561,mukhadhovanaudakanhānodakāni,mukhadhovanaudakanhanodakani,1,1,0,0,28
412562,madhuradhammakathañca,madhuradhammakathanca,1,1,0,0,21
412563,suladdhañcātipi,suladdhancatipi,1,1,0,0,15
412564,andhakārālokasaddasavanasaṅkhātānaṃ,andhakaralokasaddasavanasankhatanam,1,1,0,0,35
412565,anupharaṇena,anupharanena,1,1,0,0,12
412566,udāyīti,udayiti,20,0,20,0,7
412567,upaṭṭhākatthere,upatthakatthere,1,1,0,0,15
412568,buddhasīhanādapariyosāne,buddhasihanadapariyosane,1,1,0,0,24
412569,bhattabharitaṃ,bhattabharitam,4,4,0,0,14
412570,avakujjanto,avakujjanto,2,2,0,0,11
412571,pasādabhaṅgaṃ,pasadabhangam,1,1,0,0,13
412572,papātataṭe,papatatate,1,1,0,0,10
412573,avacāti,avacati,10,5,5,0,7
412574,uppannapasādassa,uppannapasadassa,1,1,0,0,16
412575,ettakaattabhāvaparimāṇattā,ettakaattabhavaparimanatta,1,1,0,0,26
412576,dandhapaññopi,dandhapannopi,1,1,0,0,13
412577,paricchindanto,paricchindanto,15,14,1,0,14
412578,appaccayaparinibbānena,appaccayaparinibbanena,2,2,0,0,22
412579,niṭṭhāpesīti,nitthapesiti,18,13,5,0,12
412580,samaṇasuttavaṇṇanā,samanasuttavannana,3,3,0,0,18
412581,samaṇiyānīti,samaniyaniti,1,0,1,0,12
412582,samaṇasantakāni,samanasantakani,1,1,0,0,15
412583,samaṇakaraṇīyānīti,samanakaraniyaniti,1,0,1,0,18
412584,lokuttarasīlaṃ,lokuttarasilam,6,6,0,0,14
412585,lokiyacittaṃ,lokiyacittam,4,4,0,0,12
412586,tibboti,tibboti,2,0,2,0,7
412587,kattukamyatākusalacchando,kattukamyatakusalacchando,8,7,1,0,25
412588,gadrabhasuttavaṇṇanā,gadrabhasuttavannana,1,1,0,0,20
412589,piṭṭhitoti,pitthitoti,5,0,5,0,10
412590,dammoti,dammoti,1,0,1,0,7
412591,dammamāno,dammamano,1,1,0,0,9
412592,rattāpi,rattapi,2,2,0,0,7
412593,setādivaṇṇāpi,setadivannapi,1,1,0,0,13
412594,gadrabhassa,gadrabhassa,16,15,1,0,11
412595,aññādisameva,annadisameva,3,2,1,0,12
412596,missikāva,missikava,7,7,0,0,9
412597,khettasuttavaṇṇanā,khettasuttavannana,2,2,0,0,18
412598,paṭikaccevāti,patikaccevati,8,0,8,0,13
412599,vapitabbayuttakālena,vapitabbayuttakalena,1,1,0,0,20
412600,vajjiputtasuttavaṇṇanā,vajjiputtasuttavannana,4,4,0,0,22
412601,vajjirājakulassa,vajjirajakulassa,1,1,0,0,16
412602,paṇṇāsādhikaṃ,pannasadhikam,1,1,0,0,13
412603,sikkhāpadāneva,sikkhapadaneva,2,2,0,0,14
412604,ajjavasampanno,ajjavasampanno,1,1,0,0,14
412605,sikkhantassa,sikkhantassa,5,5,0,0,12
412606,tiṇakalāpiyo,tinakalapiyo,1,1,0,0,12
412607,kalāpiyasataṃ,kalapiyasatam,1,1,0,0,13
412608,jānapadamanusso,janapadamanusso,1,1,0,0,15
412609,lohapāsādavihāre,lohapasadavihare,1,1,0,0,16
412610,ovassati,ovassati,27,27,0,0,8
412611,lāyitaṃ,layitam,1,1,0,0,7
412612,tiṇaṃyeva,tinamyeva,1,1,0,0,9
412613,karaḷe,karale,6,5,1,0,6
412614,karaḷasataṃ,karalasatam,3,3,0,0,11
412615,kilantarūposi,kilantaruposi,1,1,0,0,13
412616,vañcesuṃ,vancesum,1,1,0,0,8
412617,ukkhipāhī,ukkhipahi,1,1,0,0,9
412618,vañcayiṃsu,vancayimsu,1,1,0,0,10
412619,sekkhasuttavaṇṇanā,sekkhasuttavannana,1,1,0,0,18
412620,ujumaggānusārinoti,ujumagganusarinoti,5,0,5,0,18
412621,paṭipannakassāti,patipannakassati,3,1,2,0,16
412622,khepanato,khepanato,12,12,0,0,9
412623,catutthamaggañāṇato,catutthamaggananato,1,1,0,0,19
412624,aññāvimuttassāti,annavimuttassati,1,0,1,0,16
412625,arahattaphalavimuttiyā,arahattaphalavimuttiya,18,18,0,0,22
412626,paṭhamasikkhāsuttavaṇṇanā,pathamasikkhasuttavannana,3,3,0,0,25
412627,attakāmāti,attakamati,4,0,4,0,10
412628,kārīti,kariti,4,0,4,0,6
412629,sesasikkhāpadāni,sesasikkhapadani,1,1,0,0,16
412630,anukhuddakaṃ,anukhuddakam,9,9,0,0,12
412631,pāṭidesaniyadukkaṭadubbhāsitāni,patidesaniyadukkatadubbhasitani,1,1,0,0,31
412632,anukhuddakāni,anukhuddakani,3,3,0,0,13
412633,aṅguttaramahānikāyavaḷañjanakaācariyā,anguttaramahanikayavalanjanakaacariya,1,1,0,0,37
412634,khuddānukhuddakānī,khuddanukhuddakani,3,3,0,0,18
412635,vuṭṭhātipīti,vutthatipiti,1,0,1,0,12
412636,lokavajjaṃ,lokavajjam,170,154,16,0,10
412637,paṇṇattivajjameva,pannattivajjameva,5,4,1,0,17
412638,kuṭikārasahaseyyādīni,kutikarasahaseyyadini,1,1,0,0,21
412639,sañcarittapadasodhammādīni,sancarittapadasodhammadini,1,1,0,0,26
412640,rūpiyapaṭiggahaṇaṃ,rupiyapatiggahanam,3,3,0,0,18
412641,sekkhesupi,sekkhesupi,1,1,0,0,10
412642,ādibrahmacariyakānīti,adibrahmacariyakaniti,3,0,3,0,21
412643,brahmacariyasāruppānīti,brahmacariyasaruppaniti,1,0,1,0,23
412644,catumaggabrahmacariyassa,catumaggabrahmacariyassa,1,1,0,0,24
412645,dhuvasīloti,dhuvasiloti,1,0,1,0,11
412646,nibaddhasīlo,nibaddhasilo,1,1,0,0,12
412647,ṭhitasīloti,thitasiloti,1,0,1,0,11
412648,patiṭṭhitasīlo,patitthitasilo,1,1,0,0,14
412649,sotasaṅkhātena,sotasankhatena,2,1,1,0,14
412650,apatanasabhāvo,apatanasabhavo,2,1,1,0,14
412651,sotāpattimagganiyāmena,sotapattimagganiyamena,2,1,1,0,22
412652,uparimaggattayasambodhiparāyaṇo,uparimaggattayasambodhiparayano,2,1,1,0,31
412653,tanuttāti,tanuttati,5,0,5,0,9
412654,macchikāpattaṃ,macchikapattam,1,1,0,0,14
412655,bahalā,bahala,12,12,0,0,6
412656,heṭṭhābhāgiyānaṃ,hetthabhagiyanam,10,5,5,0,16
412657,uppannako,uppannako,1,1,0,0,9
412658,anotaritvā,anotaritva,25,25,0,0,10
412659,anāvattidhammoti,anavattidhammoti,4,0,4,0,16
412660,anāgamanadhammo,anagamanadhammo,3,2,1,0,15
412661,padesakārītiādīsu,padesakaritiadisu,1,0,1,0,17
412662,padesameva,padesameva,1,1,0,0,10
412663,paripūrameva,paripurameva,1,1,0,0,12
412664,avañjhānīti,avanjhaniti,2,0,2,0,11
412665,atucchāni,atucchani,1,1,0,0,9
412666,saphalāni,saphalani,1,1,0,0,9
412667,saudrayānīti,saudrayaniti,1,1,0,0,12
412668,missakāva,missakava,6,6,0,0,9
412669,dutiyasikkhāsuttavaṇṇanā,dutiyasikkhasuttavannana,1,1,0,0,24
412670,kolaṃkoloti,kolamkoloti,2,1,1,0,11
412671,gamanako,gamanako,1,1,0,0,8
412672,kulānī,kulani,4,3,1,0,6
412673,uddhaṃsototiādīsu,uddhamsototiadisu,1,0,1,0,17
412674,aparinibbāyitvā,aparinibbayitva,2,2,0,0,15
412675,akaniṭṭhampi,akanitthampi,2,2,0,0,12
412676,uparimabrahmaloke,uparimabrahmaloke,1,1,0,0,17
412677,akaniṭṭheyeva,akanittheyeva,2,2,0,0,13
412678,kappasahassāyukesu,kappasahassayukesu,4,3,1,0,18
412679,kappasataṃ,kappasatam,4,4,0,0,10
412680,atappādīsupi,atappadisupi,3,3,0,0,12
412681,nibbattadivaseyeva,nibbattadivaseyeva,2,2,0,0,18
412682,nibbattadivase,nibbattadivase,2,2,0,0,14
412683,kappasatassa,kappasatassa,3,3,0,0,12
412684,dukkhapaṭipadādandhābhiññādayo,dukkhapatipadadandhabhinnadayo,1,1,0,0,30
412685,abhiniviṭṭhopīti,abhinivitthopiti,1,1,0,0,16
412686,sakadāgāmibhūmiṃ,sakadagamibhumim,2,2,0,0,16
412687,atappādīsu,atappadisu,3,3,0,0,10
412688,arahantopi,arahantopi,4,3,1,0,10
412689,tatiyasikkhāsuttavaṇṇanā,tatiyasikkhasuttavannana,1,1,0,0,24
412690,dutiyasikkhattayasuttavaṇṇanā,dutiyasikkhattayasuttavannana,1,1,0,0,29
412691,sikkhitasikkhassa,sikkhitasikkhassa,2,2,0,0,17
412692,heṭṭhimakāyaṃ,hetthimakayam,1,1,0,0,13
412693,uparimakāyampi,uparimakayampi,1,1,0,0,14
412694,sabbāti,sabbati,21,0,21,0,7
412695,appamāṇasamādhināti,appamanasamadhinati,1,0,1,0,19
412696,arahattamaggasamādhinā,arahattamaggasamadhina,1,1,0,0,22
412697,sakaraṇīyaṃ,sakaraniyam,1,1,0,0,11
412698,paṭipannakaṃ,patipannakam,3,3,0,0,12
412699,saṃsuddhacaraṇaṃ,samsuddhacaranam,1,1,0,0,16
412700,parisuddhasīlaṃ,parisuddhasilam,6,6,0,0,15
412701,khandhadhīraāyatanadhīravasena,khandhadhiraayatanadhiravasena,1,1,0,0,30
412702,carimakaviññāṇassa,carimakavinnanassa,1,1,0,0,18
412703,taṇhākkhayavimuttinoti,tanhakkhayavimuttinoti,1,0,1,0,22
412704,taṇhākkhayavimuttisaṅkhātāya,tanhakkhayavimuttisankhataya,1,1,0,0,28
412705,padīpanibbānaṃ,padipanibbanam,1,1,0,0,14
412706,vimuccanā,vimuccana,6,6,0,0,9
412707,appavattibhāvo,appavattibhavo,2,2,0,0,14
412708,apaṇṇattikabhāvūpagamoyeva,apannattikabhavupagamoyeva,1,1,0,0,26
412709,saṅkavāsuttavaṇṇanā,sankavasuttavannana,3,3,0,0,19
412710,saṅkavāti,sankavati,1,0,1,0,9
412711,āvāsikoti,avasikoti,4,0,4,0,9
412712,sikkhāpadapaṭisaṃyuttāyāti,sikkhapadapatisamyuttayati,1,0,1,0,26
412713,sikkhāsaṅkhātehi,sikkhasankhatehi,2,1,1,0,16
412714,samannāgatāyāti,samannagatayati,1,1,0,0,15
412715,paṭiladdhaguṇehi,patiladdhagunehi,2,2,0,0,16
412716,adhisallikhateti,adhisallikhateti,1,0,1,0,16
412717,sallikhitaṃ,sallikhitam,1,1,0,0,11
412718,accayoti,accayoti,10,1,9,0,8
412719,akkhantīti,akkhantiti,1,0,1,0,10
412720,ahosiyeva,ahosiyeva,12,12,0,0,9
412721,anadhivāsanā,anadhivasana,1,1,0,0,12
412722,paṭiggaṇhātūti,patigganhatuti,10,2,8,0,14
412723,khalitassa,khalitassa,10,10,0,0,10
412724,akaraṇatthāyāti,akaranatthayati,1,1,0,0,15
412725,paṭikarosīti,patikarositi,5,0,5,0,12
412726,khamāpesīti,khamapesiti,7,6,1,0,11
412727,paṭiggaṇhāmāti,patigganhamati,10,3,7,0,14
412728,khamāma,khamama,8,8,0,0,7
412729,vinayeti,vinayeti,23,3,20,0,8
412730,saṃvarāpajjanā,samvarapajjana,8,7,1,0,14
412731,puggalādhiṭṭhānaṃ,puggaladhitthanam,23,20,3,0,17
412732,sikkhāsamādānassāti,sikkhasamadanassati,1,0,1,0,19
412733,sikkhāparipūraṇassa,sikkhaparipuranassa,2,2,0,0,19
412734,vaṇṇavādīti,vannavaditi,10,0,10,0,11
412735,yuttappayuttakālena,yuttappayuttakalena,2,2,0,0,19
412736,accāyikasuttavaṇṇanā,accayikasuttavannana,3,3,0,0,20
412737,accāyikānīti,accayikaniti,1,0,1,0,12
412738,atipātikāni,atipatikani,1,1,0,0,11
412739,karaṇīyānīti,karaniyaniti,11,0,11,0,12
412740,avassakiccāni,avassakiccani,1,1,0,0,13
412741,uttarasveti,uttarasveti,1,0,1,0,11
412742,utupariṇāminīti,utuparinaminiti,1,0,1,0,15
412743,laddhautupariṇāmāni,laddhautuparinamani,1,1,0,0,19
412744,jāyantipīti,jayantipiti,1,0,1,0,11
412745,nikkhantasetaṅkurāni,nikkhantasetankurani,2,2,0,0,20
412746,nīlaṅkurāni,nilankurani,1,1,0,0,11
412747,gahitagabbhāni,gahitagabbhani,1,1,0,0,14
412748,paccantipīti,paccantipiti,1,0,1,0,12
412749,gahapatikena,gahapatikena,3,3,0,0,12
412750,sassehi,sassehi,1,1,0,0,7
412751,tappaṭirūpakaṃ,tappatirupakam,1,1,0,0,14
412752,dassetukāmena,dassetukamena,6,6,0,0,13
412753,missikā,missika,6,6,0,0,7
412754,pavivekasuttavaṇṇanā,pavivekasuttavannana,3,3,0,0,20
412755,uppajjanakakilesehi,uppajjanakakilesehi,1,1,0,0,19
412756,vivittabhāvaṃ,vivittabhavam,5,4,1,0,13
412757,rukkhatacavatthāni,rukkhatacavatthani,2,2,0,0,18
412758,ajinānīti,ajinaniti,1,0,1,0,9
412759,ajinamigacammāni,ajinamigacammani,1,1,0,0,16
412760,sahakhurakantipi,sahakhurakantipi,1,1,0,0,16
412761,katacīraṃ,kataciram,7,7,0,0,9
412762,vālakambalaṃ,valakambalam,8,2,6,0,12
412763,assavālādīhi,assavaladihi,2,2,0,0,12
412764,ulūkapakkhikaṃ,ulukapakkhikam,6,2,4,0,14
412765,sākabhakkhāti,sakabhakkhati,1,0,1,0,13
412766,allasākabhakkhā,allasakabhakkha,1,1,0,0,15
412767,sāmākabhakkhāti,samakabhakkhati,1,0,1,0,15
412768,sāmākataṇḍulabhakkhā,samakatandulabhakkha,1,1,0,0,20
412769,jātavīhijāti,jatavihijati,1,1,0,0,12
412770,jhāmaodano,jhamaodano,2,2,0,0,10
412771,odanakañjiyantipi,odanakanjiyantipi,1,1,0,0,17
412772,khalasālaṃ,khalasalam,1,1,0,0,10
412773,aggappattoti,aggappattoti,1,0,1,0,12
412774,sīlaggappatto,silaggappatto,1,1,0,0,13
412775,sārappattoti,sarappattoti,1,0,1,0,12
412776,sīlasāraṃ,silasaram,2,2,0,0,9
412777,suddhoti,suddhoti,8,3,5,0,8
412778,sīlasamādhipaññāsāre,silasamadhipannasare,1,1,0,0,20
412779,paripakkasālibharitaṃ,paripakkasalibharitam,1,1,0,0,21
412780,saṅgharāpeyyāti,sangharapeyyati,1,0,1,0,15
412781,saṅkaḍḍhāpeyya,sankaddhapeyya,1,1,0,0,14
412782,ubbahāpeyyāti,ubbahapeyyati,1,0,1,0,13
412783,khalaṭṭhānaṃ,khalatthanam,1,1,0,0,12
412784,āharāpeyya,aharapeyya,3,3,0,0,10
412785,koṭṭāpeyyāti,kottapeyyati,1,0,1,0,12
412786,paharāpeyya,paharapeyya,1,1,0,0,11
412787,aggappattānīti,aggappattaniti,1,0,1,0,14
412788,taṇḍulaggaṃ,tandulaggam,1,1,0,0,11
412789,saradasuttavaṇṇanā,saradasuttavannana,3,3,0,0,18
412790,viddheti,viddheti,8,0,8,0,8
412791,valāhakavigamena,valahakavigamena,3,2,1,0,16
412792,dūrībhūte,duribhute,9,6,3,0,9
412793,abhivihaccāti,abhivihaccati,4,0,4,0,13
412794,abhivihanitvā,abhivihanitva,1,1,0,0,13
412795,rāgarajādirahitaṃ,ragarajadirahitam,1,1,0,0,17
412796,catusaccadhammapariggāhakaṃ,catusaccadhammapariggahakam,1,1,0,0,27
412797,sotāpattimaggacakkhuṃ,sotapattimaggacakkhum,1,1,0,0,21
412798,duvidhamevassa,duvidhamevassa,2,1,1,0,14
412799,jhānānāgāmī,jhananagami,5,3,2,0,11
412800,parisāsuttavaṇṇanā,parisasuttavannana,10,10,0,0,18
412801,sāthalikāti,sathalikati,6,2,4,0,11
412802,kāyacittaupadhivivekasaṅkhāte,kayacittaupadhivivekasankhate,1,1,0,0,29
412803,jhānavipassanāmaggaphalasaṅkhātassa,jhanavipassanamaggaphalasankhatassa,1,1,0,0,35
412804,appattavisesassa,appattavisesassa,1,1,0,0,16
412805,saddhivihārikaantevāsikādayo,saddhiviharikaantevasikadayo,1,1,0,0,28
412806,anukaroti,anukaroti,2,2,0,0,9
412807,ācariyupajjhāyesu,acariyupajjhayesu,19,19,0,0,17
412808,aggapuggalavatī,aggapuggalavati,1,1,0,0,15
412809,jātabhaṇḍanā,jatabhandana,3,2,1,0,12
412810,kalahajātāti,kalahajatati,4,1,3,0,12
412811,jātakalahā,jatakalaha,1,1,0,0,10
412812,bhaṇḍananti,bhandananti,2,2,0,0,11
412813,hatthaparāmāsādivasena,hatthaparamasadivasena,9,9,0,0,22
412814,mukhasattīhīti,mukhasattihiti,4,0,4,0,14
412815,guṇavijjhanaṭṭhena,gunavijjhanatthena,1,1,0,0,18
412816,mukhasattiyo,mukhasattiyo,2,1,1,0,12
412817,sammodamānāti,sammodamanati,4,0,4,0,13
412818,samappavattamodā,samappavattamoda,5,5,0,0,16
412819,khīrodakībhūtāti,khirodakibhutati,7,1,6,0,16
412820,upasantehi,upasantehi,3,2,1,0,10
412821,mettacakkhūhi,mettacakkhuhi,2,2,0,0,13
412822,vigatadaratho,vigatadaratho,4,3,1,0,13
412823,passaddhakāyoti,passaddhakayoti,3,0,3,0,15
412824,thullaphusitaketi,thullaphusitaketi,2,0,2,0,17
412825,mahāphusitake,mahaphusitake,2,2,0,0,13
412826,pabbatakandarapadarasākhāti,pabbatakandarapadarasakhati,2,0,2,0,27
412827,udakabhinno,udakabhinno,2,2,0,0,11
412828,pabbatappadeso,pabbatappadeso,2,2,0,0,14
412829,nitambho,nitambho,1,1,0,0,8
412830,nadikuñjo,nadikunjo,2,1,1,0,9
412831,kusobbhagāminiyo,kusobbhagaminiyo,1,1,0,0,16
412832,khuddakamātikāyo,khuddakamatikayo,4,4,0,0,16
412833,kusobbhāti,kusobbhati,3,0,3,0,10
412834,khuddakaāvāṭā,khuddakaavata,3,3,0,0,13
412835,mahāsobbhāti,mahasobbhati,2,0,2,0,12
412836,mahāāvāṭā,mahaavata,2,2,0,0,9
412837,kunnadiyoti,kunnadiyoti,4,0,4,0,11
412838,khuddakanadiyo,khuddakanadiyo,3,3,0,0,14
412839,mahānadiyoti,mahanadiyoti,4,1,3,0,12
412840,gaṅgāyamunādikā,gangayamunadika,3,3,0,0,15
412841,mahāsaritā,mahasarita,2,2,0,0,10
412842,paṭhamaājānīyasuttādivaṇṇanā,pathamaajaniyasuttadivannana,3,3,0,0,28
412843,para97-99,para97-99,2,2,0,0,9
412844,para97-99_an3,para97-99_an3,2,2,0,0,13
412845,aṅgehīti,angehiti,18,1,17,0,8
412846,rājārahoti,rajarahoti,2,0,2,0,10
412847,rājabhoggoti,rajabhoggoti,6,0,6,0,12
412848,upabhogabhūto,upabhogabhuto,5,5,0,0,13
412849,hatthapādādiaṅgasamatāya,hatthapadadiangasamataya,1,1,0,0,24
412850,vaṇṇasampannoti,vannasampannoti,8,0,8,0,15
412851,balasampannoti,balasampannoti,7,0,7,0,14
412852,āhutisaṅkhātaṃ,ahutisankhatam,2,1,1,0,14
412853,pāhunakabhattassa,pahunakabhattassa,1,1,0,0,17
412854,dakkhiṇeyyoti,dakkhineyyoti,3,1,2,0,13
412855,dasavidhadānavatthupariccāgavasena,dasavidhadanavatthupariccagavasena,2,2,0,0,34
412856,saddhādānasaṅkhātāya,saddhadanasankhataya,1,1,0,0,20
412857,añjalikaraṇīyoti,anjalikaraniyoti,1,0,1,0,16
412858,añjalipaggahaṇassa,anjalipaggahanassa,2,1,1,0,18
412859,puññaviruhanaṭṭhānaṃ,punnaviruhanatthanam,2,2,0,0,20
412860,javasampannoti,javasampannoti,6,0,6,0,14
412861,ñāṇajavena,nanajavena,4,4,0,0,10
412862,paggahitadhuro,paggahitadhuro,1,1,0,0,14
412863,nikkhipissāmīti,nikkhipissamiti,1,1,0,0,15
412864,catusaccavasena,catusaccavasena,29,26,3,0,15
412865,ñāṇajavasampannatā,nanajavasampannata,2,2,0,0,18
412866,javitajavena,javitajavena,1,1,0,0,12
412867,javoti,javoti,4,2,2,0,6
412868,potthakasuttavaṇṇanā,potthakasuttavannana,3,3,0,0,20
412869,P2.0359,P2.0359,10,10,0,0,7
412870,vākamayavatthaṃ,vakamayavattham,2,1,1,0,15
412871,jiṇṇoti,jinnoti,14,2,12,0,7
412872,paribhogajiṇṇo,paribhogajinno,1,1,0,0,14
412873,ukkhaliparipuñchanaṃ,ukkhaliparipunchanam,2,1,1,0,20
412874,guṇavaṇṇābhāvena,gunavannabhavena,1,1,0,0,16
412875,anukaronti,anukaronti,2,2,0,0,10
412876,vipākānisaṃseneva,vipakanisamseneva,2,2,0,0,17
412877,appagghatāyāti,appagghatayati,1,0,1,0,14
412878,vipākagghena,vipakagghena,1,1,0,0,12
412879,kappāsaaṃsūhi,kappasaamsuhi,2,1,1,0,13
412880,kāsiraṭṭheyeva,kasirattheyeva,3,3,0,0,14
412881,loṇakapallasuttavaṇṇanā,lonakapallasuttavannana,3,3,0,0,23
412882,paṭisaṃvediyateva,patisamvediyateva,1,1,0,0,17
412883,tattakassa,tattakassa,6,6,0,0,10
412884,paṭisaṃvediyatevā,patisamvediyateva,1,1,0,0,17
412885,maggabhāvanato,maggabhavanato,1,1,0,0,14
412886,paṭisaṃvedanīyattā,patisamvedaniyatta,1,1,0,0,18
412887,vutthampi,vutthampi,5,5,0,0,9
412888,avutthameva,avutthameva,1,1,0,0,11
412889,kammāyūhanañceva,kammayuhananceva,1,1,0,0,16
412890,vipākānubhavanā,vipakanubhavana,1,1,0,0,15
412891,P2.0360,P2.0360,10,10,0,0,7
412892,paṭisaṃvediyatīti,patisamvediyatiti,3,2,1,0,17
412893,paṭhamajavanakammaṃ,pathamajavanakammam,1,1,0,0,19
412894,labhantameva,labhantameva,1,1,0,0,12
412895,sattamajavanakammaṃ,sattamajavanakammam,1,1,0,0,19
412896,pañcajavanakammaṃ,pancajavanakammam,1,1,0,0,17
412897,paṭisaṃvediyati,patisamvediyati,4,4,0,0,15
412898,laddhavipākavārameva,laddhavipakavarameva,1,1,0,0,20
412899,yathāvedanīyaṃ,yathavedaniyam,1,1,0,0,14
412900,kammakkhayakarassa,kammakkhayakarassa,4,4,0,0,18
412901,khepetabbakammasambhavato,khepetabbakammasambhavato,1,1,0,0,25
412902,suvutthameva,suvutthameva,1,1,0,0,12
412903,yathāvedanīyakammasabhāvaṃ,yathavedaniyakammasabhavam,1,1,0,0,26
412904,ekaccassātiādimāha,ekaccassatiadimaha,1,0,1,0,18
412905,tādisaṃyevāti,tadisamyevati,1,0,1,0,13
412906,taṃsarikkhakameva,tamsarikkhakameva,1,1,0,0,17
412907,vipaccitabbaṃ,vipaccitabbam,5,5,0,0,13
412908,aṇupi,anupi,1,1,0,0,5
412909,bahudevāti,bahudevati,1,0,1,0,10
412910,P2.0361,P2.0361,10,10,0,0,7
412911,abhāvitakāyotiādīhi,abhavitakayotiadihi,1,0,1,0,19
412912,kāyabhāvanārahito,kayabhavanarahito,1,1,0,0,17
412913,vaṭṭagāmī,vattagami,3,3,0,0,9
412914,parittaguṇo,parittaguno,3,3,0,0,11
412915,appātumoti,appatumoti,1,0,1,0,10
412916,guṇaparittatāya,gunaparittataya,1,1,0,0,15
412917,appātumoyeva,appatumoyeva,1,1,0,0,12
412918,appadukkhavihārīti,appadukkhavihariti,2,0,2,0,18
412919,dukkhavihārī,dukkhavihari,1,1,0,0,12
412920,bhāvitakāyotiādīhi,bhavitakayotiadihi,1,0,1,0,18
412921,kāyānupassanāsaṅkhātāya,kayanupassanasankhataya,2,1,1,0,23
412922,bhāvitasīloti,bhavitasiloti,4,2,2,0,13
412923,vaḍḍhitasīlo,vaddhitasilo,3,2,1,0,12
412924,pañcadvārabhāvanāya,pancadvarabhavanaya,1,1,0,0,19
412925,aparittoti,aparittoti,2,0,2,0,10
412926,mahattoti,mahattoti,1,0,1,0,9
412927,appamāṇavihārīti,appamanavihariti,1,0,1,0,16
412928,khīṇāsavassetaṃ,khinasavassetam,12,9,3,0,15
412929,paritteti,paritteti,2,0,2,0,9
412930,udakamallaketi,udakamallaketi,1,0,1,0,14
412931,udakasarāve,udakasarave,1,1,0,0,11
412932,orabbhikoti,orabbhikoti,1,0,1,0,11
412933,urabbhasāmiko,urabbhasamiko,1,1,0,0,13
412934,urabbhaghātakoti,urabbhaghatakoti,1,0,1,0,16
412935,sūnakāro,sunakaro,1,1,0,0,8
412936,jhāpetuntipi,jhapetuntipi,1,1,0,0,12
412937,eḷakaagghanakamūlaṃ,elakaagghanakamulam,1,1,0,0,19
412938,nikkaḍḍhāpeti,nikkaddhapeti,38,38,0,0,13
412939,P2.0362,P2.0362,10,10,0,0,7
412940,paṃsudhovakasuttavaṇṇanā,pamsudhovakasuttavannana,3,3,0,0,24
412941,sandhovatīti,sandhovatiti,1,0,1,0,12
412942,niddhovatīti,niddhovatiti,1,0,1,0,12
412943,anīhatadosaṃ,anihatadosam,2,1,1,0,12
412944,anapanītakasāvaṃ,anapanitakasavam,2,1,1,0,16
412945,adhikaraṇīyaṃ,adhikaraniyam,1,1,0,0,13
412946,muṭṭhikāya,mutthikaya,2,2,0,0,10
412947,pahaṭamattaṃ,pahatamattam,2,1,1,0,12
412948,paṭṭikāyāti,pattikayati,1,0,1,0,11
412949,suvaṇṇapaṭṭakāya,suvannapattakaya,1,1,0,0,16
412950,gīveyyaketi,giveyyaketi,1,0,1,0,11
412951,gīvālaṅkāre,givalankare,1,1,0,0,11
412952,anuyuttassāti,anuyuttassati,2,0,2,0,13
412953,sacetasoti,sacetasoti,1,0,1,0,10
412954,cittasampanno,cittasampanno,1,1,0,0,13
412955,dabbajātikoti,dabbajatikoti,5,0,5,0,13
412956,kāmavitakkā,kamavitakka,5,4,1,0,11
412957,byāpādavihiṃsasampayuttā,byapadavihimsasampayutta,1,1,0,0,24
412958,byāpādavihiṃsavitakkā,byapadavihimsavitakka,1,1,0,0,21
412959,ñātivitakkādīsu,nativitakkadisu,1,1,0,0,15
412960,janapadamārabbha,janapadamarabbha,2,1,1,0,16
412961,dhammavitakkāvasissantīti,dhammavitakkavasissantiti,1,0,1,0,25
412962,dhammavitakkā,dhammavitakka,2,2,0,0,13
412963,dasavipassanupakkilesavitakkā,dasavipassanupakkilesavitakka,1,1,0,0,29
412964,avasiṭṭhadhammavitakko,avasitthadhammavitakko,2,1,1,0,22
412965,avūpasantakilesattā,avupasantakilesatta,1,1,0,0,19
412966,atappako,atappako,10,7,3,0,8
412967,nappaṭippassaddhiladdhoti,nappatippassaddhiladdhoti,1,0,1,0,25
412968,P2.0363,P2.0363,10,10,0,0,7
412969,ekodibhāvādhigatoti,ekodibhavadhigatoti,1,0,1,0,19
412970,ekaggabhāvappatto,ekaggabhavappatto,2,1,1,0,17
412971,sasaṅkhāraniggayhavāritagatoti,sasankharaniggayhavaritagatoti,2,0,2,0,30
412972,chinnante,chinnante,5,4,1,0,9
412973,sappāyānaṃ,sappayanam,4,4,0,0,10
412974,paṭilābhakālo,patilabhakalo,2,2,0,0,13
412975,niyakajjhattañhi,niyakajjhattanhi,1,1,0,0,16
412976,gocarajjhattampi,gocarajjhattampi,1,1,0,0,16
412977,nibbānagocareyeva,nibbanagocareyeva,2,1,1,0,17
412978,sannisīdatīti,sannisidatiti,3,0,3,0,13
412979,santotiādīsu,santotiadisu,2,0,2,0,12
412980,paccanīkakilesavūpasamena,paccanikakilesavupasamena,2,2,0,0,25
412981,vāritoti,varitoti,7,6,1,0,8
412982,abhiññāpaṭipadaṃ,abhinnapatipadam,1,1,0,0,16
412983,sacchikaraṇīyassāti,sacchikaraniyassati,2,0,2,0,19
412984,satiāyataneti,satiayataneti,5,1,4,0,13
412985,pubbahetusaṅkhāte,pubbahetusankhate,1,1,0,0,17
412986,paṭiladdhabbe,patiladdhabbe,1,1,0,0,13
412987,abhiññāpādakajjhānādibhede,abhinnapadakajjhanadibhede,1,1,0,0,26
412988,satikāraṇe,satikarane,4,4,0,0,10
412989,P2.0364,P2.0364,10,10,0,0,7
412990,khayātiādi,khayatiadi,2,0,2,0,10
412991,nimittasuttavaṇṇanā,nimittasuttavannana,3,3,0,0,19
412992,samathavipassanācittameva,samathavipassanacittameva,1,1,0,0,25
412993,majjhattabhāvassa,majjhattabhavassa,2,2,0,0,17
412994,kosajjabhāve,kosajjabhave,1,1,0,0,12
412995,ñāṇajavaṃ,nanajavam,2,1,1,0,9
412996,upekkheyyāti,upekkheyyati,1,1,0,0,12
412997,bandheyyāti,bandheyyati,9,4,5,0,11
412998,ālimpeyyāti,alimpeyyati,3,0,3,0,11
412999,nāḷikāya,nalikaya,5,5,0,0,8
413000,gāhāpeyya,gahapeyya,11,11,0,0,9
413001,pakkhipeyyāti,pakkhipeyyati,6,1,5,0,13
413002,aṅgāramatthake,angaramatthake,5,5,0,0,14
413003,mūsāya,musaya,2,1,1,0,6
413004,pakkāpakkabhāvaṃ,pakkapakkabhavam,2,2,0,0,16
413005,P2.0365,P2.0365,10,10,0,0,7
413006,pubbevasambodhasuttavaṇṇanā,pubbevasambodhasuttavannana,1,1,0,0,27
413007,sambodhāti,sambodhati,5,0,5,0,10
413008,ariyamaggappattito,ariyamaggappattito,4,2,2,0,18
413009,aparabhāgeyevāti,aparabhageyevati,2,2,0,0,16
413010,anabhisambuddhassāti,anabhisambuddhassati,4,0,4,0,20
413011,appaṭividdhacatusaccassa,appatividdhacatusaccassa,2,2,0,0,24
413012,bujjhanakasattasseva,bujjhanakasattasseva,3,2,1,0,20
413013,ārabhantasseva,arabhantasseva,2,1,1,0,14
413014,laggasseva,laggasseva,5,4,1,0,10
413015,aṭṭhadhammasamodhānena,atthadhammasamodhanena,2,2,0,0,22
413016,abhinīhārasamiddhito,abhiniharasamiddhito,2,2,0,0,20
413017,madhurākāro,madhurakaro,3,2,1,0,11
413018,ādīnavoti,adinavoti,27,9,18,0,9
413019,anabhinanditabbākāro,anabhinanditabbakaro,1,1,0,0,20
413020,lokanissaraṇanti,lokanissarananti,1,1,0,0,16
413021,yāvakīvaṃ,yavakivam,4,0,4,0,9
413022,P2.0366,P2.0366,10,10,0,0,7
413023,paṭhamaassādasuttavaṇṇanā,pathamaassadasuttavannana,1,1,0,0,25
413024,assādapariyesanatthāya,assadapariyesanatthaya,1,1,0,0,22
413025,sumedhakālato,sumedhakalato,1,1,0,0,13
413026,sahavipassanāya,sahavipassanaya,20,18,2,0,15
413027,sudiṭṭhoti,suditthoti,2,0,2,0,10
413028,samaṇabrāhmaṇasuttavaṇṇanā,samanabrahmanasuttavannana,8,8,0,0,26
413029,sāmaññatthena,samannatthena,2,1,1,0,13
413030,brahmaññatthena,brahmannatthena,1,1,0,0,15
413031,khandhalokova,khandhalokova,1,1,0,0,13
413032,ruṇṇasuttavaṇṇanā,runnasuttavannana,1,1,0,0,17
413033,gāyantā,gayanta,12,12,0,0,7
413034,naccantā,naccanta,16,16,0,0,8
413035,ovādatthāya,ovadatthaya,23,23,0,0,11
413036,ummattakaṃ,ummattakam,8,6,2,0,10
413037,ummattakakiriyā,ummattakakiriya,1,1,0,0,15
413038,komārakaṃ,komarakam,4,2,2,0,9
413039,kumārakehi,kumarakehi,6,6,0,0,10
413040,gīteti,giteti,1,0,1,0,6
413041,paccayaghāto,paccayaghato,4,4,0,0,12
413042,sitamattāyāti,sitamattayati,1,0,1,0,13
413043,sitakāraṇe,sitakarane,1,1,0,0,10
413044,sitamattāya,sitamattaya,1,1,0,0,11
413045,aggadante,aggadante,4,4,0,0,9
413046,pahaṭṭhākāramattadassanāyayeva,pahatthakaramattadassanayayeva,1,1,0,0,30
413047,P2.0367,P2.0367,10,10,0,0,7
413048,atittisuttavaṇṇanā,atittisuttavannana,1,1,0,0,18
413049,soppassāti,soppassati,1,0,1,0,10
413050,tittīti,tittiti,2,0,2,0,7
413051,ruccatiyevāti,ruccatiyevati,1,1,0,0,13
413052,surāsoṇḍo,surasondo,5,5,0,0,9
413053,carantassapi,carantassapi,5,5,0,0,12
413054,sayantassapi,sayantassapi,5,5,0,0,12
413055,arakkhitasuttavaṇṇanā,arakkhitasuttavannana,1,1,0,0,21
413056,paṭisandhipaccayatāya,patisandhipaccayataya,2,2,0,0,21
413057,byāpannasuttavaṇṇanā,byapannasuttavannana,1,1,0,0,20
413058,paṭhamanidānasuttavaṇṇanā,pathamanidanasuttavannana,1,1,0,0,25
413059,kammanirodhāyāti,kammanirodhayati,1,0,1,0,16
413060,nirodhatthāya,nirodhatthaya,5,5,0,0,13
413061,P2.0368,P2.0368,10,10,0,0,7
413062,vivaṭṭagāmikammānaṃ,vivattagamikammanam,4,3,1,0,19
413063,samudayatthāya,samudayatthaya,1,1,0,0,14
413064,dutiyanidānasuttavaṇṇanā,dutiyanidanasuttavannana,3,3,0,0,24
413065,vaṭṭagāmikammānameva,vattagamikammanameva,1,1,0,0,20
413066,chandarāgaṭṭhāniyeti,chandaragatthaniyeti,1,0,1,0,20
413067,rajjitattaṃ,rajjitattam,1,1,0,0,11
413068,tadabhinivattetīti,tadabhinivattetiti,2,0,2,0,18
413069,abhinivatteti,abhinivatteti,2,2,0,0,13
413070,tadabhinivattetvāti,tadabhinivattetvati,1,0,1,0,19
413071,abhinivijjhitvāti,abhinivijjhitvati,1,0,1,0,17
413072,āpāyikasuttavaṇṇanā,apayikasuttavannana,4,4,0,0,19
413073,gacchissantīti,gacchissantiti,12,10,2,0,14
413074,idamappahāyāti,idamappahayati,4,0,4,0,14
413075,brahmacāripaṭiññatādiṃ,brahmacaripatinnatadim,1,1,0,0,22
413076,pāpadhammattayaṃ,papadhammattayam,1,1,0,0,16
413077,P2.0369,P2.0369,10,10,0,0,7
413078,brahmacāripaṭirūpako,brahmacaripatirupako,3,2,1,0,20
413079,evaṃpaṭiñño,evampatinno,3,2,1,0,11
413080,anuddhaṃsetīti,anuddhamsetiti,11,3,8,0,14
413081,pivitabbataṃ,pivitabbatam,4,3,1,0,12
413082,paribhuñjitabbataṃ,paribhunjitabbatam,6,4,2,0,18
413083,nirāsaṅkena,nirasankena,3,3,0,0,11
413084,pipāsitassa,pipasitassa,12,12,0,0,11
413085,pānīyapivanasadisaṃ,paniyapivanasadisam,1,1,0,0,19
413086,dullabhasuttavaṇṇanā,dullabhasuttavannana,3,3,0,0,20
413087,paṭikaraṇakapuggalo,patikaranakapuggalo,1,1,0,0,19
413088,appameyyasuttavaṇṇanā,appameyyasuttavannana,3,3,0,0,21
413089,metabboti,metabboti,4,2,2,0,9
413090,asaññatavacano,asannatavacano,2,1,1,0,14
413091,bhantagāvibhantamigasappaṭibhāgo,bhantagavibhantamigasappatibhago,1,1,0,0,32
413092,pākatindriyoti,pakatindriyoti,4,0,4,0,14
413093,āneñjasuttavaṇṇanā,anenjasuttavannana,3,3,0,0,18
413094,tadadhimuttoti,tadadhimuttoti,2,0,2,0,14
413095,tabbahulavihārīti,tabbahulavihariti,4,2,2,0,17
413096,nirayādīhi,nirayadihi,7,6,1,0,10
413097,aparapariyāyavasena,aparapariyayavasena,1,1,0,0,19
413098,P2.0370,P2.0370,10,10,0,0,7
413099,adhippayāsoti,adhippayasoti,9,0,9,0,13
413100,adhikappayogo,adhikappayogo,8,5,3,0,13
413101,upapattijjhānaṃ,upapattijjhanam,1,1,0,0,15
413102,upapattijjhānañca,upapattijjhananca,1,1,0,0,17
413103,vipassanāpādakajjhānañca,vipassanapadakajjhananca,1,1,0,0,24
413104,vipattisampadāsuttavaṇṇanā,vipattisampadasuttavannana,3,3,0,0,26
413105,vipannākāro,vipannakaro,1,1,0,0,11
413106,phalābhāvaṃ,phalabhavam,10,5,5,0,11
413107,mahāyogo,mahayogo,1,1,0,0,8
413108,paheṇakasakkāro,pahenakasakkaro,4,4,0,0,15
413109,sukatadukkatānaṃ,sukatadukkatanam,2,2,0,0,16
413110,kusalākusalānanti,kusalakusalananti,4,4,0,0,17
413111,sammāpaṭipattimicchāpaṭipattīnaṃ,sammapatipattimicchapatipattinam,11,11,0,0,32
413112,phalābhāvavasena,phalabhavavasena,4,4,0,0,16
413113,uppajjanakasattā,uppajjanakasatta,3,2,1,0,16
413114,pāripūriyo,paripuriyo,1,1,0,0,10
413115,paripuṇṇaavekallabhāvo,paripunnaavekallabhavo,1,1,0,0,22
413116,P2.0371,P2.0371,10,10,0,0,7
413117,talehi,talehi,3,2,1,0,6
413118,paṭhamasoceyyasuttavaṇṇanā,pathamasoceyyasuttavannana,3,3,0,0,26
413119,sucibhāvā,sucibhava,2,2,0,0,9
413120,agārikapaṭipadā,agarikapatipada,2,2,0,0,15
413121,dutiyasoceyyasuttavaṇṇanā,dutiyasoceyyasuttavannana,3,3,0,0,25
413122,ninhāpetvā,ninhapetva,1,1,0,0,10
413123,suttenapi,suttenapi,2,2,0,0,9
413124,moneyyasuttavaṇṇanā,moneyyasuttavannana,4,4,0,0,19
413125,moneyyānīti,moneyyaniti,4,0,4,0,11
413126,munibhāvā,munibhava,1,1,0,0,9
413127,munibhāvo,munibhavo,3,3,0,0,9
413128,sādhubhāvo,sadhubhavo,2,2,0,0,10
413129,tividhakāyaduccaritappahānaṃ,tividhakayaduccaritappahanam,2,1,1,0,28
413130,kāyasucaritampi,kayasucaritampi,2,2,0,0,15
413131,kāyārammaṇaṃ,kayarammanam,2,2,0,0,12
413132,P2.0372,P2.0372,10,10,0,0,7
413133,kāyapariññā,kayaparinna,6,6,0,0,11
413134,pariññāsahagato,parinnasahagato,19,18,1,0,15
413135,kāyasaṅkhāranirodho,kayasankharanirodho,4,4,0,0,19
413136,vacīmoneyye,vacimoneyye,1,0,1,0,11
413137,vacīsaṅkhāranirodho,vacisankharanirodho,5,5,0,0,19
413138,vacīmoneyyanti,vacimoneyyanti,1,1,0,0,14
413139,manomoneyyampi,manomoneyyampi,1,1,0,0,14
413140,cittasaṅkhāranirodho,cittasankharanirodho,5,5,0,0,20
413141,manomoneyyanti,manomoneyyanti,1,1,0,0,14
413142,sabbappahāyī,sabbappahayi,1,1,0,0,12
413143,kusinārasuttavaṇṇanā,kusinarasuttavannana,5,5,0,0,20
413144,vanasaṇḍeti,vanasandeti,14,6,8,0,11
413145,bhūtabalikaraṇatthaṃ,bhutabalikaranattham,1,1,0,0,20
413146,baliharaṇanti,baliharananti,2,2,0,0,13
413147,ākaṅkhamānoti,akankhamanoti,5,1,4,0,13
413148,sahatthāti,sahatthati,17,0,17,0,10
413149,sampavāretīti,sampavaretiti,2,1,1,0,13
413150,hatthavikārena,hatthavikarena,15,14,1,0,14
413151,paṭikkhipāpeti,patikkhipapeti,1,1,0,0,14
413152,gathitoti,gathitoti,2,0,2,0,9
413153,taṇhāgedhena,tanhagedhena,4,3,1,0,12
413154,P2.0373,P2.0373,10,10,0,0,7
413155,taṇhāmucchanāyayeva,tanhamucchanayayeva,1,1,0,0,19
413156,ajjhopannoti,ajjhopannoti,3,0,3,0,12
413157,anissaraṇapaññoti,anissaranapannoti,2,0,2,0,17
413158,sacchandarāgo,sacchandarago,4,2,2,0,13
413159,bhaṇḍanasuttavaṇṇanā,bhandanasuttavannana,1,1,0,0,20
413160,pajahiṃsūti,pajahimsuti,2,1,1,0,11
413161,bahulamakaṃsūti,bahulamakamsuti,1,0,1,0,15
413162,gotamakacetiyasuttavaṇṇanā,gotamakacetiyasuttavannana,3,3,0,0,26
413163,gotamakayakkhassa,gotamakayakkhassa,1,1,0,0,17
413164,gotamaketi,gotamaketi,1,1,0,0,10
413165,devakulesuyeva,devakulesuyeva,1,1,0,0,14
413166,gotamakassa,gotamakassa,1,1,0,0,11
413167,bhavanaṭṭhāne,bhavanatthane,2,2,0,0,13
413168,atthuppattiyaṃ,atthuppattiyam,6,6,0,0,14
413169,kataraatthuppattiyanti,kataraatthuppattiyanti,1,1,0,0,22
413170,mūlapariyāyaatthuppattiyaṃ,mulapariyayaatthuppattiyam,1,1,0,0,26
413171,brāhmaṇapabbajitā,brahmanapabbajita,8,7,1,0,17
413172,uggahitabuddhavacanaṃ,uggahitabuddhavacanam,5,5,0,0,21
413173,jānanamadaṃ,jananamadam,1,1,0,0,11
413174,dhammassavanaggaṃ,dhammassavanaggam,14,9,5,0,17
413175,mukhapaṭiññaṃ,mukhapatinnam,2,1,1,0,13
413176,mūlapariyāyaṃ,mulapariyayam,10,10,0,0,13
413177,niyyātī,niyyati,14,10,4,0,7
413178,mukhasampattameva,mukhasampattameva,2,1,1,0,17
413179,P2.0374,P2.0374,10,10,0,0,7
413180,paccanīkapaṭiharaṇena,paccanikapatiharanena,3,2,1,0,21
413181,sappāṭihāriyameva,sappatihariyameva,3,2,1,0,17
413182,tuṭṭhiyāti,tutthiyati,1,0,1,0,10
413183,pathavikampo,pathavikampo,7,7,0,0,12
413184,bodhimaṇḍepi,bodhimandepi,2,2,0,0,12
413185,dakkhiṇadisābhāgena,dakkhinadisabhagena,3,3,0,0,19
413186,abhiruḷhe,abhirulhe,7,7,0,0,9
413187,dakkhiṇadisābhāgo,dakkhinadisabhago,2,2,0,0,17
413188,uttarabhāgo,uttarabhago,1,1,0,0,11
413189,abhihananto,abhihananto,5,5,0,0,11
413190,pacchimadisaṃ,pacchimadisam,11,9,2,0,13
413191,pacchimabhāgo,pacchimabhago,3,3,0,0,13
413192,pācīnabhāgo,pacinabhago,1,1,0,0,11
413193,uttaradisaṃ,uttaradisam,2,2,0,0,11
413194,pācīnadisaṃ,pacinadisam,5,5,0,0,11
413195,pācīnadisābhāgo,pacinadisabhago,1,1,0,0,15
413196,bodhirukkhopi,bodhirukkhopi,1,1,0,0,13
413197,cakkavāḷasahassī,cakkavalasahassi,1,1,0,0,16
413198,bharaṇḍukālāmasuttavaṇṇanā,bharandukalamasuttavannana,3,3,0,0,26
413199,anvāhiṇḍantoti,anvahindantoti,1,0,1,0,14
413200,aggapiṇḍaṃ,aggapindam,44,41,3,0,10
413201,samuṭṭhahissatīti,samutthahissatiti,2,2,0,0,17
413202,P2.0375,P2.0375,10,10,0,0,7
413203,purāṇasabrahmacārīti,puranasabrahmacariti,1,0,1,0,20
413204,āḷārakālāmakāle,alarakalamakale,1,1,0,0,15
413205,santharāhīti,santharahiti,1,1,0,0,12
413206,paññāpetvāti,pannapetvati,6,0,6,0,12
413207,kappiyamañcake,kappiyamancake,3,3,0,0,14
413208,samatikkamabhūtaṃ,samatikkamabhutam,1,1,0,0,17
413209,arūpāvacarasamāpattiṃ,arupavacarasamapattim,5,5,0,0,21
413210,puthūti,puthuti,37,3,34,0,7
413211,khayasundarābhirūpaabbhanumodanādīsu,khayasundarabhirupaabbhanumodanadisu,5,5,0,0,36
413212,abhikkantavaṇṇāti,abhikkantavannati,13,0,13,0,17
413213,P2.0376,P2.0376,10,10,0,0,7
413214,gandhatthenoti,gandhatthenoti,6,5,1,0,14
413215,abhirūpacchavi,abhirupacchavi,2,2,0,0,14
413216,iṭṭhavaṇṇā,itthavanna,3,3,0,0,10
413217,manāpavaṇṇāti,manapavannati,4,4,0,0,13
413218,anavasesayebhuyyābyāmissānatirekadaḷhatthavisaṃyogādianekattho,anavasesayebhuyyabyamissanatirekadalhatthavisamyogadianekattho,2,2,0,0,62
413219,anavasesatā,anavasesata,8,6,2,0,11
413220,upasaṅkamissantī,upasankamissanti,5,5,0,0,16
413221,abyāmissatā,abyamissata,10,6,4,0,11
413222,saddhāmattakaṃ,saddhamattakam,20,14,6,0,14
413223,anatirekatā,anatirekata,10,6,4,0,11
413224,daḷhatthatā,dalhatthata,6,6,0,0,11
413225,uttamapurisoti,uttamapurisoti,10,8,2,0,14
413226,P2.0377,P2.0377,10,10,0,0,7
413227,okappaniyametaṃ,okappaniyametam,7,6,1,0,15
413228,kappamāṇavapucchā,kappamanavapuccha,9,9,0,0,17
413229,kappamāṇavapucchāniddeso,kappamanavapucchaniddeso,3,3,0,0,24
413230,obhāsetvāti,obhasetvati,10,0,10,0,11
413231,vālukāyāti,valukayati,1,0,1,0,10
413232,saṇhāya,sanhaya,2,2,0,0,7
413233,brahmadevatāya,brahmadevataya,2,2,0,0,14
413234,patiṭṭhānakāle,patitthanakale,6,6,0,0,14
413235,sajjhāyamūḷhakā,sajjhayamulhaka,1,1,0,0,15
413236,parihīnāyeva,parihinayeva,1,1,0,0,12
413237,P2.0378,P2.0378,10,10,0,0,7
413238,anivatto,anivatto,1,1,0,0,8
413239,dassanassāti,dassanassati,2,0,2,0,12
413240,upaṭṭhānassāti,upatthanassati,1,0,1,0,14
413241,adhisīlanti,adhisilanti,5,4,1,0,11
413242,avihabrahmaloke,avihabrahmaloke,1,1,0,0,15
413243,nibbattosmīti,nibbattosmiti,4,4,0,0,13
413244,kaṭuviyasuttavaṇṇanā,katuviyasuttavannana,3,3,0,0,20
413245,vikkayaṭṭhāne,vikkayatthane,2,1,1,0,13
413246,uṭṭhitapilakkhassa,utthitapilakkhassa,2,1,1,0,18
413247,jhānasukhābhāvena,jhanasukhabhavena,2,1,1,0,17
413248,kāmaguṇasukhavasena,kamagunasukhavasena,1,1,0,0,19
413249,āmagandhenāti,amagandhenati,1,0,1,0,13
413250,kodhasaṅkhātena,kodhasankhatena,2,2,0,0,15
413251,vissagandhena,vissagandhena,1,1,0,0,13
413252,kilesamakkhikā,kilesamakkhika,2,2,0,0,14
413253,nānupatissantīti,nanupatissantiti,1,0,1,0,16
413254,anubandhissanti,anubandhissanti,2,2,0,0,15
413255,saṃvegamāpādīti,samvegamapaditi,10,7,3,0,15
413256,kaṭuviyakatoti,katuviyakatoti,1,0,1,0,14
413257,ucchiṭṭhakato,ucchitthakato,1,1,0,0,13
413258,dukkhasseva,dukkhasseva,14,14,0,0,11
413259,caretīti,caretiti,1,0,1,0,8
413260,dutiyaanuruddhasuttavaṇṇanā,dutiyaanuruddhasuttavannana,3,3,0,0,27
413261,vaḍḍhitamānoti,vaddhitamanoti,1,1,0,0,14
413262,P2.0379,P2.0379,10,10,0,0,7
413263,paṭicchannasuttavaṇṇanā,paticchannasuttavannana,3,3,0,0,23
413264,āvahantīti,avahantiti,6,3,3,0,10
413265,paṭicchannova,paticchannova,2,2,0,0,13
413266,sabbatthakatoti,sabbatthakatoti,1,1,0,0,15
413267,vivaṭatā,vivatata,1,1,0,0,8
413268,asādhāraṇasikkhāpadaṃ,asadharanasikkhapadam,2,1,1,0,21
413269,sādhāraṇasikkhāpadaṃ,sadharanasikkhapadam,2,1,1,0,20
413270,paṭiladdhadhammaguṇo,patiladdhadhammaguno,1,1,0,0,20
413271,sabbatthakavivaṭaṃ,sabbatthakavivatam,1,0,1,0,18
413272,lekhasuttavaṇṇanā,lekhasuttavannana,3,3,0,0,17
413273,kakkhaḷena,kakkhalena,9,9,0,0,10
413274,pharusavacanena,pharusavacanena,9,9,0,0,15
413275,vuccamānopīti,vuccamanopiti,1,1,0,0,13
413276,anallīyantena,analliyantena,2,2,0,0,13
413277,avaḍḍhantena,avaddhantena,1,1,0,0,12
413278,sandhiyatimevāti,sandhiyatimevati,1,0,1,0,16
413279,ghaṭiyatiyeva,ghatiyatiyeva,1,1,0,0,13
413280,saṃsandatimevāti,samsandatimevati,1,0,1,0,16
413281,nirantarova,nirantarova,1,1,0,0,11
413282,sammodatimevāti,sammodatimevati,1,0,1,0,15
413283,yodhājīvasuttavaṇṇanā,yodhajivasuttavannana,4,4,0,0,21
413284,upabhogaparibhogo,upabhogaparibhogo,2,2,0,0,17
413285,aṭṭhusabhamattaṃ,atthusabhamattam,2,2,0,0,16
413286,uttarinti,uttarinti,4,4,0,0,9
413287,duṭṭhagāmaṇiabhayassa,dutthagamaniabhayassa,1,1,0,0,21
413288,navausabhamattaṃ,navausabhamattam,1,1,0,0,16
413289,akkhaṇavedhīti,akkhanavedhiti,2,0,2,0,14
413290,P2.0380,P2.0380,10,10,0,0,7
413291,avirādhitavedhī,aviradhitavedhi,2,2,0,0,15
413292,padāletāti,padaletati,1,0,1,0,10
413293,ekatobaddhaṃ,ekatobaddham,1,1,0,0,12
413294,phalakasatampi,phalakasatampi,2,2,0,0,14
413295,mahiṃsacammasatampi,mahimsacammasatampi,1,1,0,0,19
413296,aṅguṭṭhapamāṇabahalaṃ,angutthapamanabahalam,1,1,0,0,21
413297,lohapaṭṭampi,lohapattampi,1,1,0,0,12
413298,asanapadarampi,asanapadarampi,1,1,0,0,14
413299,udumbarapadarampi,udumbarapadarampi,1,1,0,0,17
413300,dīghantena,dighantena,1,1,0,0,10
413301,mamātiādi,mamatiadi,2,0,2,0,9
413302,taṇhāmānadiṭṭhipaṭikkhepavasena,tanhamanaditthipatikkhepavasena,1,1,0,0,31
413303,ukkācitavinītāti,ukkacitavinitati,1,0,1,0,16
413304,appaṭipucchitvā,appatipucchitva,6,5,1,0,15
413305,dubbinītaparisā,dubbinitaparisa,1,1,0,0,15
413306,suvinītaparisā,suvinitaparisa,1,1,0,0,14
413307,yāvatāvinītāti,yavatavinitati,1,0,1,0,14
413308,vinītaparisāti,vinitaparisati,2,2,0,0,14
413309,yāvatajjhā,yavatajjha,1,1,0,0,10
413310,uppādāsuttavaṇṇanā,uppadasuttavannana,3,3,0,0,18
413311,dhammaṭṭhitatāti,dhammatthitatati,3,1,2,0,16
413312,catubhūmakasaṅkhārā,catubhumakasankhara,2,2,0,0,19
413313,sampaṭipīḷanaṭṭhena,sampatipilanatthena,1,1,0,0,19
413314,kesakambalasuttavaṇṇanā,kesakambalasuttavannana,1,1,0,0,23
413315,tantehi,tantehi,1,1,0,0,7
413316,vāyitavatthānīti,vayitavatthaniti,1,1,0,0,16
413317,kesakambaloti,kesakambaloti,4,1,3,0,13
413318,P2.0381,P2.0381,11,11,0,0,7
413319,vāyitakambalo,vayitakambalo,1,1,0,0,13
413320,paṭikiṭṭhoti,patikitthoti,3,0,3,0,12
413321,paṭibāhatīti,patibahatiti,14,5,9,0,12
413322,assakhaḷuṅkasuttavaṇṇanā,assakhalunkasuttavannana,3,3,0,0,24
413323,assakhaḷuṅkoti,assakhalunkoti,1,0,1,0,14
413324,ñāṇajavoti,nanajavoti,1,1,0,0,10
413325,guṇavaṇṇoti,gunavannoti,4,4,0,0,11
413326,uccabhāvo,uccabhavo,2,1,1,0,9
413327,parimaṇḍalabhāvoti,parimandalabhavoti,1,1,0,0,18
413328,assaparassasuttavaṇṇanā,assaparassasuttavannana,1,1,0,0,23
413329,assaparasseti,assaparasseti,1,0,1,0,13
413330,purisaparasseti,purisaparasseti,1,0,1,0,15
413331,purisapuriseti,purisapuriseti,1,1,0,0,14
413332,ñāṇajavasampannoti,nanajavasampannoti,2,2,0,0,18
413333,assājānīyasuttavaṇṇanā,assajaniyasuttavannana,3,3,0,0,22
413334,bhadreti,bhadreti,2,0,2,0,8
413335,assājānīyeti,assajaniyeti,1,0,1,0,12
413336,jānanake,jananake,1,1,0,0,8
413337,purisājānīyesu,purisajaniyesu,1,0,1,0,14
413338,paṭhamamoranivāpasuttavaṇṇanā,pathamamoranivapasuttavannana,1,1,0,0,29
413339,accantaniṭṭhoti,accantanitthoti,4,0,4,0,15
413340,atikkantaniṭṭho,atikkantanittho,2,1,1,0,15
413341,akuppaniṭṭho,akuppanittho,1,1,0,0,12
413342,dhuvaniṭṭhoti,dhuvanitthoti,2,1,1,0,13
413343,dutiyamoranivāpasuttavaṇṇanā,dutiyamoranivapasuttavannana,1,1,0,0,28
413344,iddhipāṭihāriyenāti,iddhipatihariyenati,4,0,4,0,19
413345,ijjhanakapāṭihāriyena,ijjhanakapatihariyena,1,1,0,0,21
413346,ādesanāpāṭihāriyenāti,adesanapatihariyenati,2,0,2,0,21
413347,P2.0382,P2.0382,11,11,0,0,7
413348,apadisitvā,apadisitva,26,25,1,0,10
413349,kathanaanukathanakathāpāṭihāriyena,kathanaanukathanakathapatihariyena,1,1,0,0,34
413350,tatiyamoranivāpasuttavaṇṇanā,tatiyamoranivapasuttavannana,1,1,0,0,28
413351,sammādiṭṭhiyāti,sammaditthiyati,4,1,3,0,15
413352,phalasamāpattatthāya,phalasamapattatthaya,2,2,0,0,20
413353,sammāñāṇenāti,sammananenati,2,0,2,0,13
413354,sammāvimuttiyāti,sammavimuttiyati,1,0,1,0,16
413355,phalasamāpattidhammehi,phalasamapattidhammehi,1,1,0,0,22
413356,akusalasuttādivaṇṇanā,akusalasuttadivannana,1,1,0,0,21
413357,para147-155,para147-155,1,1,0,0,11
413358,para147-155_an3,para147-155_an3,1,1,0,0,15
413359,sāvajjenāti,savajjenati,1,0,1,0,11
413360,visamenāti,visamenati,1,0,1,0,10
413361,sapakkhalanena,sapakkhalanena,1,1,0,0,14
413362,apakkhalanena,apakkhalanena,1,1,0,0,13
413363,asucināti,asucinati,5,0,5,0,9
413364,gūthasadisena,guthasadisena,1,1,0,0,13
413365,amejjhena,amejjhena,1,1,0,0,9
413366,mejjhena,mejjhena,1,1,0,0,8
413367,uttānāneva,uttananeva,18,18,0,0,10
413368,pubbaṇhasuttavaṇṇanā,pubbanhasuttavannana,1,1,0,0,20
413369,sucaritadhammā,sucaritadhamma,1,1,0,0,14
413370,laddhanakkhattayogo,laddhanakkhattayogo,1,1,0,0,19
413371,katamaṅgalo,katamangalo,1,1,0,0,11
413372,pabhātampissa,pabhatampissa,1,1,0,0,13
413373,suppabhāta,suppabhata,1,0,1,0,10
413374,uṭṭhānampi,utthanampi,2,2,0,0,10
413375,suhuṭṭhita,suhutthita,1,0,1,0,10
413376,khaṇopi,khanopi,9,9,0,0,7
413377,sukkhaṇova,sukkhanova,1,0,1,0,10
413378,muhuttopi,muhuttopi,1,1,0,0,9
413379,sumuhuttova,sumuhuttova,1,0,1,0,11
413380,dasaccharapamāṇo,dasaccharapamano,1,1,0,0,16
413381,P2.0383,P2.0383,11,11,0,0,7
413382,dasakkhaṇo,dasakkhano,1,1,0,0,10
413383,dasalayo,dasalayo,1,1,0,0,8
413384,dasaguṇo,dasaguno,2,2,0,0,8
413385,brahmacārisūti,brahmacarisuti,2,0,2,0,14
413386,seṭṭhacārīsu,setthacarisu,1,1,0,0,12
413387,vaḍḍhikāyakammaṃ,vaddhikayakammam,1,1,0,0,16
413388,katvānāti,katvanati,18,0,18,0,9
413389,vaḍḍhiyuttāni,vaddhiyuttani,1,1,0,0,13
413390,padakkhiṇeti,padakkhineti,1,0,1,0,12
413391,vaḍḍhiattheyeva,vaddhiattheyeva,1,1,0,0,15
413392,acelakavaggavaṇṇanā,acelakavaggavannana,4,4,0,0,19
413393,gāḷhā,galha,6,5,1,0,5
413394,thiraggahaṇā,thiraggahana,2,1,1,0,12
413395,nijjhāmāti,nijjhamati,1,0,1,0,10
413396,attakilamathānuyogavasena,attakilamathanuyogavasena,11,11,0,0,25
413397,jhāmā,jhama,2,2,0,0,5
413398,paritattā,paritatta,1,1,0,0,9
413399,majjhimāti,majjhimati,11,1,10,0,10
413400,vissaṭṭhācāro,vissatthacaro,2,2,0,0,13
413401,P2.0384,P2.0384,11,11,0,0,7
413402,hatthasmiṃyeva,hatthasmimyeva,1,1,0,0,14
413403,evamārocitabhikkhaṃ,evamarocitabhikkham,1,1,0,0,19
413404,bhikkhampi,bhikkhampi,4,4,0,0,10
413405,kumbhikaḷopiyo,kumbhikalopiyo,5,4,1,0,14
413406,P2.0385,P2.0385,11,11,0,0,7
413407,katasovīrakaṃ,katasovirakam,1,1,0,0,13
413408,dvāgārikādīsu,dvagarikadisu,2,0,2,0,13
413409,addhamāsikaṃ,addhamasikam,4,1,3,0,12
413410,addhamāsantarikaṃ,addhamasantarikam,3,3,0,0,17
413411,addhamāsavārenāti,addhamasavarenati,1,1,0,0,17
413412,sākabhakkhotiādīni,sakabhakkhotiadini,2,0,2,0,18
413413,ukkuṭikavīriyamanuyutto,ukkutikaviriyamanuyutto,2,1,1,0,23
413414,P2.0386,P2.0386,11,11,0,0,7
413415,kāyānupassītiādīni,kayanupassitiadini,1,0,1,0,18
413416,ekakanipātavaṇṇanāyaṃ,ekakanipatavannanayam,2,2,0,0,21
413417,kāmasukhallikānuyogañca,kamasukhallikanuyoganca,1,1,0,0,23
413418,attakilamathānuyogañcāti,attakilamathanuyogancati,1,1,0,0,24
413419,sassatucchedantehi,sassatucchedantehi,1,1,0,0,18
413420,peyyālavaggādivaṇṇanā,peyyalavaggadivannana,1,1,0,0,21
413421,para164-184,para164-184,2,2,0,0,11
413422,para164-184_an3,para164-184_an3,2,2,0,0,15
413423,samanuññoti,samanunnoti,6,0,6,0,11
413424,samānajjhāsayo,samanajjhasayo,2,1,1,0,14
413425,samādhītiādīhi,samadhitiadihi,1,0,1,0,14
413426,niccābhinivesaniccanimittaniccapaṇidhiādīnaṃ,niccabhinivesaniccanimittaniccapanidhiadinam,1,1,0,0,44
413427,peyyālavaggādi,peyyalavaggadi,1,1,0,0,14
413428,catukkanipātaaṭṭhakathā,catukkanipataatthakatha,1,1,0,0,23
413429,anubuddhasuttavaṇṇanā,anubuddhasuttavannana,1,1,0,0,21
413430,catukkanipātassa,catukkanipatassa,4,4,0,0,16
413431,ananubodhāti,ananubodhati,10,0,10,0,12
413432,abujjhanena,abujjhanena,6,6,0,0,11
413433,appaṭivedhāti,appativedhati,8,0,8,0,13
413434,appaṭivijjhanena,appativijjhanena,6,6,0,0,16
413435,apaccakkhakiriyāya,apaccakkhakiriyaya,1,1,0,0,18
413436,ariyassāti,ariyassati,5,0,5,0,10
413437,niddosassa,niddosassa,3,3,0,0,10
413438,maggaphalasampayuttāva,maggaphalasampayuttava,1,1,0,0,22
413439,vimuttināmena,vimuttinamena,1,1,0,0,13
413440,anuttarāti,anuttarati,3,2,1,0,10
413441,paṭhamaparinibbānaṃ,pathamaparinibbanam,1,1,0,0,19
413442,papatitasuttavaṇṇanā,papatitasuttavannana,1,1,0,0,20
413443,apatito,apatito,1,1,0,0,7
413444,patitoyeva,patitoyeva,1,1,0,0,10
413445,kilesuppattikkhaṇe,kilesuppattikkhane,1,1,0,0,18
413446,ekantapatiṭṭhito,ekantapatitthito,1,1,0,0,16
413447,patitāti,patitati,6,2,4,0,8
413448,giddhāti,giddhati,11,0,11,0,8
413449,punarāgatāti,punaragatati,2,0,2,0,12
413450,ramitabbayuttake,ramitabbayuttake,1,1,0,0,16
413451,guṇajāte,gunajate,1,1,0,0,8
413452,ramitaṃ,ramitam,3,3,0,0,7
413453,anuāgataṃ,anuagatam,2,2,0,0,9
413454,mānusakasukhena,manusakasukhena,1,1,0,0,15
413455,vipassanāsukhena,vipassanasukhena,4,4,0,0,16
413456,maggasukhena,maggasukhena,11,11,0,0,12
413457,paṭhamakhatasuttavaṇṇanā,pathamakhatasuttavannana,1,1,0,0,24
413458,dukanipātavaṇṇanāyaṃ,dukanipatavannanayam,1,1,0,0,20
413459,ninditabbayuttakaṃ,ninditabbayuttakam,1,1,0,0,18
413460,nindatīti,nindatiti,4,2,2,0,9
413461,pasaṃsitabbayutto,pasamsitabbayutto,1,1,0,0,17
413462,sabbenapi,sabbenapi,18,17,1,0,9
413463,sugatesūti,sugatesuti,4,0,4,0,10
413464,sammaggatesu,sammaggatesu,8,8,0,0,12
413465,padusseyya,padusseyya,2,2,0,0,10
413466,cittapadosova,cittapadosova,3,3,0,0,13
413467,mahantatarabhāvaṃ,mahantatarabhavam,3,3,0,0,17
413468,nirabbudagaṇanāya,nirabbudagananaya,6,6,0,0,17
413469,chattiṃsatīti,chattimsatiti,4,0,4,0,13
413470,yamariyagarahīti,yamariyagarahiti,3,0,3,0,16
413471,dutiyakhatasuttavaṇṇanā,dutiyakhatasuttavannana,1,1,0,0,23
413472,bahuñcāti,bahuncati,1,0,1,0,9
413473,micchāpaṭipattisaṅkhātāya,micchapatipattisankhataya,1,1,0,0,25
413474,anusotasuttavaṇṇanā,anusotasuttavannana,3,3,0,0,19
413475,kilesasotassa,kilesasotassa,1,1,0,0,13
413476,paccanīkapaṭipattiyā,paccanikapatipattiya,1,1,0,0,20
413477,pañcaverakammaṃ,pancaverakammam,2,1,1,0,15
413478,taṇhādhipannāti,tanhadhipannati,2,0,2,0,15
413479,adhipannā,adhipanna,5,5,0,0,9
413480,ajjhogāḷhā,ajjhogalha,6,6,0,0,10
413481,paripuṇṇasekhoti,paripunnasekhoti,2,0,2,0,16
413482,sikkhāpāripūriyā,sikkhaparipuriya,13,13,0,0,16
413483,aparihānadhammoti,aparihanadhammoti,4,1,3,0,17
413484,aparihīnasabhāvo,aparihinasabhavo,1,1,0,0,16
413485,cetovasippattoti,cetovasippattoti,6,1,5,0,16
413486,cittavasībhāvaṃ,cittavasibhavam,1,1,0,0,15
413487,samāhitindriyoti,samahitindriyoti,1,0,1,0,16
413488,samāhitachaḷindriyo,samahitachalindriyo,1,1,0,0,19
413489,paroparāti,paroparati,2,0,2,0,10
413490,parovarā,parovara,2,2,0,0,8
413491,uttamalāmakā,uttamalamaka,1,1,0,0,12
413492,sameccāti,sameccati,13,0,13,0,9
413493,vidhūpitāti,vidhupitati,6,0,6,0,11
413494,viddhaṃsitā,viddhamsita,19,19,0,0,11
413495,vusitabrahmacariyoti,vusitabrahmacariyoti,4,1,3,0,20
413496,appassutasuttavaṇṇanā,appassutasuttavannana,3,3,0,0,21
413497,anupapannoti,anupapannoti,4,1,3,0,12
413498,anupāgato,anupagato,2,2,0,0,9
413499,ubhatovibhaṅganiddesakhandhakaparivārasuttanipātamaṅgalasuttaratanasutta,ubhatovibhanganiddesakhandhakaparivarasuttanipatamangalasuttaratanasutta,1,1,0,0,72
413500,nāḷakasuttatuvaṭakasuttāni,nalakasuttatuvatakasuttani,1,1,0,0,26
413501,niggāthakasuttaṃ,niggathakasuttam,1,1,0,0,16
413502,dhammapadatheragāthātherigāthā,dhammapadatheragathatherigatha,1,1,0,0,30
413503,somanassañāṇamayikagāthāpaṭisaṃyuttā,somanassananamayikagathapatisamyutta,7,5,2,0,36
413504,acchariyaabbhutadhammapaṭisaṃyuttā,acchariyaabbhutadhammapatisamyutta,4,4,0,0,34
413505,cūḷavedallamahāvedallasammādiṭṭhisakkapañhasaṅkhārabhājaniyamahāpuṇṇamasuttādayo,culavedallamahavedallasammaditthisakkapanhasankharabhajaniyamahapunnamasuttadayo,4,4,0,0,80
413506,sahasīlaṃ,sahasilam,1,1,0,0,9
413507,appassutadussīlo,appassutadussilo,1,1,0,0,16
413508,appassutakhīṇāsavo,appassutakhinasavo,2,2,0,0,18
413509,bahussutadussīlo,bahussutadussilo,1,1,0,0,16
413510,bahussutakhīṇāsavo,bahussutakhinasavo,1,1,0,0,18
413511,sīlabhāgena,silabhagena,1,1,0,0,11
413512,sutabhāgena,sutabhagena,1,1,0,0,11
413513,sutakiccaṃ,sutakiccam,1,1,0,0,10
413514,sutakiccassa,sutakiccassa,1,1,0,0,12
413515,sutadhammānaṃ,sutadhammanam,3,2,1,0,13
413516,supaññaṃ,supannam,2,2,0,0,8
413517,jambonadassevāti,jambonadassevati,1,0,1,0,16
413518,jātisuvaṇṇaṃ,jatisuvannam,1,1,0,0,12
413519,jambunadassa,jambunadassa,1,1,0,0,12
413520,pañcasuvaṇṇaparimāṇaṃ,pancasuvannaparimanam,2,2,0,0,21
413521,sobhanasuttavaṇṇanā,sobhanasuttavannana,4,4,0,0,19
413522,viyattāti,viyattati,7,0,7,0,9
413523,paññāveyyattiyena,pannaveyyattiyena,12,12,0,0,17
413524,vinītāti,vinitati,10,2,8,0,8
413525,visāradāti,visaradati,7,1,6,0,10
413526,vesārajjena,vesarajjena,12,12,0,0,11
413527,somanassasahagatena,somanassasahagatena,3,3,0,0,19
413528,vesārajjasuttavaṇṇanā,vesarajjasuttavannana,3,3,0,0,21
413529,vesārajjānīti,vesarajjaniti,4,0,4,0,13
413530,sārajjapaṭipakkho,sarajjapatipakkho,2,2,0,0,17
413531,sārajjābhāvaṃ,sarajjabhavam,3,3,0,0,13
413532,uppannasomanassamayañāṇassetaṃ,uppannasomanassamayananassetam,4,4,0,0,30
413533,tiṭṭhamānova,titthamanova,8,8,0,0,12
413534,ratanadhammūracakkādīsu,ratanadhammuracakkadisu,2,2,0,0,23
413535,dīpaṅkarato,dipankarato,8,8,0,0,11
413536,aññāsikoṇḍaññassa,annasikondannassa,8,4,4,0,17
413537,sahetunā,sahetuna,6,4,2,0,8
413538,sakāraṇena,sakaranena,18,15,3,0,10
413539,vesārajjañāṇameva,vesarajjananameva,2,2,0,0,17
413540,codanākāraṇaṃ,codanakaranam,2,2,0,0,13
413541,anabhisambuddhadhammaṃ,anabhisambuddhadhammam,2,2,0,0,22
413542,sabhāvabuddhoyeva,sabhavabuddhoyeva,2,2,0,0,17
413543,vītikkantā,vitikkanta,13,11,2,0,10
413544,dukkaṭadubbhāsitampi,dukkatadubbhasitampi,3,3,0,0,20
413545,methunadhammo,methunadhammo,66,53,13,0,13
413546,nissaṃsayameva,nissamsayameva,2,2,0,0,14
413547,rāgakkhayādīsu,ragakkhayadisu,2,2,0,0,14
413548,asubhabhāvanādidhammo,asubhabhavanadidhammo,3,3,0,0,21
413549,aniyyānikadhamme,aniyyanikadhamme,2,2,0,0,16
413550,vādāyeva,vadayeva,1,1,0,0,8
413551,upanibaddhā,upanibaddha,3,3,0,0,11
413552,puthussitāti,puthussitati,1,0,1,0,12
413553,puthūhi,puthuhi,6,5,1,0,7
413554,sitātipi,sitatipi,1,1,0,0,8
413555,vādapathaṃ,vadapatham,7,6,1,0,10
413556,sakalaguṇasamannāgato,sakalagunasamannagato,1,1,0,0,21
413557,taṇhuppādasuttavaṇṇanā,tanhuppadasuttavannana,4,4,0,0,22
413558,taṇhāvatthūni,tanhavatthuni,2,2,0,0,13
413559,taṇhākāraṇānīti,tanhakarananiti,2,2,0,0,15
413560,bhavābhavahetupīti,bhavabhavahetupiti,3,3,0,0,18
413561,sampattibhavesu,sampattibhavesu,5,5,0,0,15
413562,paṇītatarapaṇītatamabhavotipi,panitatarapanitatamabhavotipi,1,1,0,0,29
413563,vadantiyeva,vadantiyeva,30,30,0,0,11
413564,taṇhādutiyoti,tanhadutiyoti,4,0,4,0,13
413565,itthabhāvo,itthabhavo,11,7,4,0,10
413566,anāgatattabhāvo,anagatattabhavo,4,4,0,0,15
413567,vaṭṭadukkhasambhūto,vattadukkhasambhuto,1,1,0,0,19
413568,pattabhāvo,pattabhavo,1,1,0,0,10
413569,vītataṇhotiādimāha,vitatanhotiadimaha,1,0,1,0,18
413570,anādānoti,anadanoti,2,0,2,0,9
413571,niggahaṇo,niggahano,5,5,0,0,9
413572,vepullappatto,vepullappatto,2,2,0,0,13
413573,yogasuttavaṇṇanā,yogasuttavannana,3,3,0,0,16
413574,kāmayogotiādīsu,kamayogotiadisu,1,0,1,0,15
413575,avijjāyogoti,avijjayogoti,5,4,1,0,12
413576,vuttadhammānaṃyevetaṃ,vuttadhammanamyevetam,1,1,0,0,21
413577,amadhurabhāvaṃ,amadhurabhavam,2,1,1,0,14
413578,nissaṭabhāvaṃ,nissatabhavam,1,1,0,0,13
413579,kāmarāgoti,kamaragoti,1,0,1,0,10
413580,uppannarāgo,uppannarago,27,27,0,0,11
413581,kāmayogoti,kamayogoti,3,0,3,0,10
413582,yojanakāraṇaṃ,yojanakaranam,1,1,0,0,13
413583,cakkhusamphassādikāraṇānaṃ,cakkhusamphassadikarananam,2,1,1,0,26
413584,ñāṇapaṭipakkhabhāvena,nanapatipakkhabhavena,1,1,0,0,21
413585,aññāṇasaṅkhātā,annanasankhata,1,1,0,0,14
413586,saṃyuttoti,samyuttoti,5,1,4,0,10
413587,pāpakehīti,papakehiti,1,0,1,0,10
413588,lāmakehi,lamakehi,2,2,0,0,8
413589,akusalehīti,akusalehiti,4,2,2,0,11
413590,akosallasambhūtehi,akosallasambhutehi,1,1,0,0,18
413591,saṃkilesikehīti,samkilesikehiti,1,0,1,0,15
413592,saṃkilesanakehi,samkilesanakehi,1,1,0,0,15
413593,pasannabhāvadūsakehīti,pasannabhavadusakehiti,1,1,0,0,22
413594,ponobbhavikehīti,ponobbhavikehiti,1,0,1,0,16
413595,punabbhavanibbattakehi,punabbhavanibbattakehi,1,1,0,0,22
413596,sadarehīti,sadarehiti,1,0,1,0,10
413597,sadarathehi,sadarathehi,1,1,0,0,11
413598,dukkhavipākehīti,dukkhavipakehiti,1,0,1,0,16
413599,vipākakāle,vipakakale,6,5,1,0,10
413600,dukkhuppādakehi,dukkhuppadakehi,1,1,0,0,15
413601,jātijarāmaraṇikehīti,jatijaramaranikehiti,1,0,1,0,20
413602,jātijarāmaraṇanibbattakehi,jatijaramarananibbattakehi,1,1,0,0,26
413603,appahīnayogo,appahinayogo,1,1,0,0,12
413604,visaṃyogoti,visamyogoti,2,1,1,0,11
413605,visaṃyojanakāraṇāni,visamyojanakaranani,2,2,0,0,19
413606,kāmayogavisaṃyogoti,kamayogavisamyogoti,1,0,1,0,19
413607,kāmayogato,kamayogato,1,1,0,0,10
413608,visaṃyojanakāraṇaṃ,visamyojanakaranam,1,1,0,0,18
413609,purakkhatāti,purakkhatati,7,0,7,0,12
413610,samūhaccāti,samuhaccati,1,0,1,0,11
413611,samūhanitvā,samuhanitva,24,24,0,0,11
413612,virājento,virajento,3,3,0,0,9
413613,carasuttavaṇṇanā,carasuttavannana,4,4,0,0,16
413614,adhiropetvā,adhiropetva,1,1,0,0,11
413615,vinodetīti,vinodetiti,14,4,10,0,10
413616,byantīkarotīti,byantikarotiti,5,1,4,0,14
413617,paricchinnaparivaṭumaṃ,paricchinnaparivatumam,1,1,0,0,22
413618,avaḍḍhiṃ,avaddhim,13,9,4,0,8
413619,carampīti,carampiti,1,0,1,0,9
413620,anātāpīti,anatapiti,4,0,4,0,9
413621,nibbīriyo,nibbiriyo,4,4,0,0,9
413622,anottāpīti,anottapiti,3,1,2,0,10
413623,upavādabhayarahito,upavadabhayarahito,1,1,0,0,18
413624,kilesanissitaṃ,kilesanissitam,1,1,0,0,14
413625,mohaneyyesūti,mohaneyyesuti,2,0,2,0,13
413626,mohajanakesu,mohajanakesu,1,1,0,0,12
413627,arahattamaggasaṅkhātaṃ,arahattamaggasankhatam,1,1,0,0,22
413628,uttamañāṇaṃ,uttamananam,2,1,1,0,11
413629,sīlasuttavaṇṇanā,silasuttavannana,7,7,0,0,16
413630,sampannasīlāti,sampannasilati,12,2,10,0,14
413631,paripuṇṇasīlā,paripunnasila,12,9,3,0,13
413632,sampannapātimokkhāti,sampannapatimokkhati,3,0,3,0,20
413633,paripuṇṇapātimokkhā,paripunnapatimokkha,1,1,0,0,19
413634,pātimokkhasaṃvarasaṃvutāti,patimokkhasamvarasamvutati,3,0,3,0,26
413635,ācāragocarasampannāti,acaragocarasampannati,3,0,3,0,21
413636,bhayadassāvinoti,bhayadassavinoti,1,0,1,0,16
413637,sabbasikkhākoṭṭhāsesu,sabbasikkhakotthasesu,1,1,0,0,21
413638,dhammakkhānena,dhammakkhanena,1,1,0,0,14
413639,sikkhattaye,sikkhattaye,2,2,0,0,11
413640,kimassātiādimāha,kimassatiadimaha,1,0,1,0,16
413641,kimassāti,kimassati,2,1,1,0,9
413642,accheti,accheti,2,0,2,0,7
413643,pasārayeti,pasarayeti,3,0,3,0,10
413644,aṅgapaccaṅgaṃ,angapaccangam,26,25,1,0,13
413645,saṃyatameva,samyatameva,1,1,0,0,11
413646,paricchedavacanaṃ,paricchedavacanam,7,6,1,0,17
413647,pañcakkhandhadhammānaṃ,pancakkhandhadhammanam,4,4,0,0,22
413648,pañcakkhandhānaṃ,pancakkhandhanam,5,5,0,0,16
413649,avekkhitā,avekkhita,3,3,0,0,9
413650,cittasamathassa,cittasamathassa,1,1,0,0,15
413651,paṭipajjamānaṃ,patipajjamanam,8,8,0,0,14
413652,pesitatto,pesitatto,9,9,0,0,9
413653,sammappadhānānīti,sammappadhananiti,1,0,1,0,17
413654,sundarapadhānāni,sundarapadhanani,1,1,0,0,16
413655,uttamavīriyāni,uttamaviriyani,3,2,1,0,14
413656,paripuṇṇavīriyā,paripunnaviriya,1,1,0,0,15
413657,māradheyyābhibhūtāti,maradheyyabhibhutati,1,0,1,0,20
413658,tebhūmakavaṭṭasaṅkhātaṃ,tebhumakavattasankhatam,3,2,1,0,23
413659,asitāti,asitati,3,0,3,0,7
413660,jātimaraṇabhayassāti,jatimaranabhayassati,1,0,1,0,20
413661,jātiñca,jatinca,46,32,14,0,7
413662,uppajjanakabhayassa,uppajjanakabhayassa,1,1,0,0,19
413663,jātimaraṇasaṅkhātasseva,jatimaranasankhatasseva,1,1,0,0,23
413664,pāragūti,paraguti,27,5,22,0,8
413665,tusitāti,tusitati,2,0,2,0,8
413666,anejāti,anejati,1,0,1,0,7
413667,upātivattāti,upativattati,1,0,1,0,12
413668,sukhitāti,sukhitati,3,1,2,0,9
413669,lokuttarasukhena,lokuttarasukhena,5,5,0,0,16
413670,mohajālaṃ,mohajalam,7,4,3,0,9
413671,padālitaṃ,padalitam,4,3,1,0,9
413672,saṃvarasuttavaṇṇanā,samvarasuttavannana,6,6,0,0,19
413673,anurakkhantassa,anurakkhantassa,4,4,0,0,15
413674,upadhivivekattā,upadhivivekatta,2,2,0,0,15
413675,virajjantīti,virajjantiti,8,3,5,0,12
413676,vivekanissitantiādīsu,vivekanissitantiadisu,1,1,0,0,21
413677,adhigantabbavasena,adhigantabbavasena,4,2,2,0,18
413678,nibbānanissitanti,nibbananissitanti,2,2,0,0,17
413679,vossaggā,vossagga,16,12,4,0,8
413680,vossaggapariṇāminti,vossaggaparinaminti,2,2,0,0,19
413681,bhāviyamāno,bhaviyamano,2,2,0,0,11
413682,vossaggatthāya,vossaggatthaya,2,2,0,0,14
413683,vipassanābhāvañca,vipassanabhavanca,3,2,1,0,17
413684,maggabhāvañca,maggabhavanca,4,2,2,0,13
413685,aṭṭhikasaññādivasena,atthikasannadivasena,2,2,0,0,20
413686,samādhipāripanthikadhamme,samadhiparipanthikadhamme,3,3,0,0,25
413687,rāgadosamohe,ragadosamohe,2,2,0,0,12
413688,aṭṭhikasaññādikā,atthikasannadika,2,2,0,0,16
413689,saṃvarādinipphādakaṃ,samvaradinipphadakam,1,1,0,0,20
413690,pāpuṇeti,papuneti,2,0,2,0,8
413691,dukkhakkhayasaṅkhātaṃ,dukkhakkhayasankhatam,1,1,0,0,21
413692,paññattisuttavaṇṇanā,pannattisuttavannana,3,3,0,0,20
413693,aggapaññattiyoti,aggapannattiyoti,1,0,1,0,16
413694,uttamapaññattiyo,uttamapannattiyo,1,1,0,0,16
413695,attabhāvavantānaṃ,attabhavavantanam,2,1,1,0,17
413696,asurindoti,asurindoti,2,0,2,0,10
413697,bāhantaramassa,bahantaramassa,4,4,0,0,14
413698,dvādasayojanasatāni,dvadasayojanasatani,4,4,0,0,19
413699,hatthatalapādatalānaṃ,hatthatalapadatalanam,3,3,0,0,21
413700,puthulatā,puthulata,3,3,0,0,9
413701,aṅgulipabbāni,angulipabbani,5,5,0,0,13
413702,bhamukantaraṃ,bhamukantaram,9,8,1,0,13
413703,paṇṇāsayojanaṃ,pannasayojanam,5,5,0,0,14
413704,navayojanasataṃ,navayojanasatam,3,3,0,0,15
413705,mandhātāti,mandhatati,2,0,2,0,10
413706,dibbepi,dibbepi,5,5,0,0,7
413707,mānusakepi,manusakepi,2,2,0,0,10
413708,paribhuñjanakānaṃ,paribhunjanakanam,1,1,0,0,17
413709,asaṅkheyyāyukesu,asankheyyayukesu,1,1,0,0,16
413710,hiraññavassaṃ,hirannavassam,1,1,0,0,13
413711,chattiṃsāya,chattimsaya,16,11,5,0,11
413712,indānaṃ,indanam,5,3,2,0,7
413713,paribhuñjīti,paribhunjiti,5,3,2,0,12
413714,jeṭṭhakaṭṭhānaṃ,jetthakatthanam,8,6,2,0,15
413715,dibbasampattisamiddhiyā,dibbasampattisamiddhiya,1,1,0,0,23
413716,parivārasaṅkhātena,parivarasankhatena,3,2,1,0,18
413717,jalantānaṃ,jalantanam,1,1,0,0,10
413718,lokanipphatti,lokanipphatti,1,1,0,0,13
413719,sokhummasuttavaṇṇanā,sokhummasuttavannana,3,3,0,0,20
413720,sokhummānīti,sokhummaniti,1,0,1,0,12
413721,sukhumalakkhaṇapaṭivijjhanakāni,sukhumalakkhanapativijjhanakani,1,1,0,0,31
413722,saṇhasukhumalakkhaṇapariggāhakena,sanhasukhumalakkhanapariggahakena,2,2,0,0,33
413723,rūpasokhummenāti,rupasokhummenati,1,0,1,0,16
413724,anulomabhāvaṃ,anulomabhavam,1,1,0,0,13
413725,sukhumalakkhaṇapariggāhakañāṇena,sukhumalakkhanapariggahakananena,1,1,0,0,32
413726,vedanāsokhummā,vedanasokhumma,1,0,1,0,14
413727,sukhumataṃ,sukhumatam,2,2,0,0,10
413728,lujjanabhāvena,lujjanabhavena,1,1,0,0,14
413729,attatoti,attatoti,11,6,5,0,8
413730,dukkhānattānupassanā,dukkhanattanupassana,1,1,0,0,20
413731,kilesasantatāya,kilesasantataya,4,4,0,0,15
413732,lokuttaradhammopīti,lokuttaradhammopiti,1,1,0,0,19
413733,paṭhamaagatisuttavaṇṇanā,pathamaagatisuttavannana,1,1,0,0,24
413734,para17-19,para17-19,3,3,0,0,9
413735,para17-19_an4,para17-19_an4,1,1,0,0,13
413736,agatigamanānīti,agatigamananiti,6,3,3,0,15
413737,nagatigamanāni,nagatigamanani,1,1,0,0,14
413738,mohāti,mohati,3,0,3,0,6
413739,ativattatīti,ativattatiti,12,3,9,0,12
413740,tathābujjhanakānaṃ,tathabujjhanakanam,4,4,0,0,18
413741,bhattuddesakasuttavaṇṇanā,bhattuddesakasuttavannana,1,1,0,0,25
413742,bhattuddesakoti,bhattuddesakoti,1,0,1,0,15
413743,salākabhattādīnaṃ,salakabhattadinam,5,5,0,0,17
413744,uddesako,uddesako,3,2,1,0,8
413745,asaṃyatāti,asamyatati,2,0,2,0,10
413746,asaṃyatā,asamyata,10,10,0,0,8
413747,parisākacavaro,parisakacavaro,1,1,0,0,14
413748,paṭhamauruvelasuttavaṇṇanā,pathamauruvelasuttavannana,3,3,0,0,26
413749,uruvelāti,uruvelati,12,7,5,0,9
413750,mahāvelā,mahavela,10,7,3,0,8
413751,mahāvālikarāsīti,mahavalikarasiti,6,4,2,0,16
413752,urūti,uruti,8,3,5,0,5
413753,velātikkamanahetu,velatikkamanahetu,8,8,0,0,17
413754,ākiratu,akiratu,4,4,0,0,7
413755,ākirati,akirati,18,16,2,0,7
413756,mahāvālukarāsi,mahavalukarasi,2,2,0,0,14
413757,cetiyaṭṭhānamakāsi,cetiyatthanamakasi,4,4,0,0,18
413758,uruvelagāmaṃ,uruvelagamam,3,2,1,0,12
413759,nerañjarānadītīre,neranjaranaditire,2,2,0,0,17
413760,ajapālanigrodheti,ajapalanigrodheti,2,0,2,0,17
413761,ajapālakā,ajapalaka,4,4,0,0,9
413762,nisīdantipi,nisidantipi,3,3,0,0,11
413763,ajapālanigrodhotveva,ajapalanigrodhotveva,3,3,0,0,20
413764,paṭhamābhisambuddhoti,pathamabhisambuddhoti,10,0,10,0,21
413765,āciṇṇattā,acinnatta,2,2,0,0,9
413766,pubbāsevanatāya,pubbasevanataya,1,1,0,0,15
413767,pubbāsevanāya,pubbasevanaya,1,1,0,0,13
413768,hatthivānaratittirā,hatthivanaratittira,2,1,1,0,19
413769,tittirassa,tittirassa,5,5,0,0,10
413770,suggatī,suggati,7,7,0,0,7
413771,ahetukatiracchānayoniyaṃ,ahetukatiracchanayoniyam,2,2,0,0,24
413772,sagāravavāsaṃ,sagaravavasam,1,1,0,0,13
413773,rocessatīti,rocessatiti,1,1,0,0,11
413774,gāravarahito,garavarahito,5,5,0,0,12
413775,aṭṭhapetvāti,atthapetvati,7,4,3,0,12
413776,patissayarahito,patissayarahito,4,2,2,0,15
413777,samitapāpabāhitapāpāyeva,samitapapabahitapapayeva,1,1,0,0,24
413778,devaggahaṇena,devaggahanena,8,8,0,0,13
413779,mārabrahmesu,marabrahmesu,4,4,0,0,12
413780,ekaṅguliyā,ekanguliya,11,10,1,0,10
413781,sīlasampannataroti,silasampannataroti,2,2,0,0,18
413782,sabrahmaketi,sabrahmaketi,4,0,4,0,12
413783,vatthuvijjādivasena,vatthuvijjadivasena,2,2,0,0,19
413784,sampannatarāti,sampannatarati,1,1,0,0,14
413785,sadevamanussāyāti,sadevamanussayati,8,1,7,0,17
413786,lokavasena,lokavasena,5,3,2,0,10
413787,sampannataraṃ,sampannataram,2,2,0,0,13
413788,adhikataranti,adhikataranti,6,4,2,0,13
413789,paccavekkhaṇañāṇameva,paccavekkhanananameva,2,2,0,0,21
413790,paṭividdhanavalokuttaradhammameva,patividdhanavalokuttaradhammameva,1,1,0,0,33
413791,gacchāmissa,gacchamissa,8,8,0,0,11
413792,mahattamabhikaṅkhatāti,mahattamabhikankhatati,2,0,2,0,22
413793,sarantena,sarantena,5,5,0,0,9
413794,vepullamahattaṃ,vepullamahattam,10,9,1,0,15
413795,brahmacariyamahattaṃ,brahmacariyamahattam,1,1,0,0,20
413796,lābhaggamahattanti,labhaggamahattanti,1,1,0,0,18
413797,gāravoti,garavoti,9,2,7,0,8
413798,dussayugadānakāle,dussayugadanakale,1,1,0,0,17
413799,dutiyauruvelasuttavaṇṇanā,dutiyauruvelasuttavannana,3,3,0,0,25
413800,sambahulāti,sambahulati,19,10,9,0,11
413801,huhukkajātikena,huhukkajatikena,1,1,0,0,15
413802,vuḍḍhāti,vuddhati,6,0,6,0,8
413803,sutakāraṇaṃ,sutakaranam,2,2,0,0,11
413804,abhivādanādiakaraṇaṃ,abhivadanadiakaranam,2,2,0,0,20
413805,ananucchavikameva,ananucchavikameva,1,1,0,0,17
413806,akālavādītiādīsu,akalavaditiadisu,1,0,1,0,16
413807,asabhāvaṃ,asabhavam,4,3,1,0,9
413808,nidhetabbayuttakaṃ,nidhetabbayuttakam,3,2,1,0,18
413809,akālenāti,akalenati,5,0,5,0,9
413810,ayuttakālena,ayuttakalena,2,2,0,0,12
413811,apadesarahitaṃ,apadesarahitam,2,1,1,0,14
413812,pariyantarahitaṃ,pariyantarahitam,2,1,1,0,16
413813,lokiyalokuttaraatthanissitaṃ,lokiyalokuttaraatthanissitam,2,1,1,0,28
413814,kālavādītiādīni,kalavaditiadini,2,0,2,0,15
413815,paṇḍiccena,pandiccena,44,38,6,0,10
413816,pāḷianusandhipubbāparavasena,palianusandhipubbaparavasena,2,2,0,0,28
413817,sutadharoti,sutadharoti,3,0,3,0,11
413818,chiddaghaṭe,chiddaghate,4,4,0,0,11
413819,ekasuttaṃ,ekasuttam,2,2,0,0,9
413820,uggahitakālasadisameva,uggahitakalasadisameva,3,3,0,0,22
413821,sutasannicayoti,sutasannicayoti,3,0,3,0,15
413822,sannicayabhūto,sannicayabhuto,2,2,0,0,14
413823,hadayamañjūsāya,hadayamanjusaya,2,2,0,0,15
413824,suvaṇṇapatte,suvannapatte,2,2,0,0,12
413825,pakkhittasīhavasā,pakkhittasihavasa,11,11,0,0,17
413826,dhātāti,dhatati,4,0,4,0,7
413827,niccalikaṃ,niccalikam,2,1,1,0,10
413828,samanuggāhitvā,samanuggahitva,3,3,0,0,14
413829,bhavaṅgasotasadisaṃ,bhavangasotasadisam,5,5,0,0,19
413830,suttadasakavaggadasakapaṇṇāsadasakavasena,suttadasakavaggadasakapannasadasakavasena,3,3,0,0,41
413831,sajjhāyitā,sajjhayita,7,5,2,0,10
413832,manasānupekkhitāti,manasanupekkhitati,7,0,7,0,18
413833,sajjhāyitaṃ,sajjhayitam,20,17,3,0,11
413834,abhicetoti,abhicetoti,4,0,4,0,10
413835,abhicetasi,abhicetasi,6,6,0,0,10
413836,ābhicetasikāni,abhicetasikani,10,7,3,0,14
413837,abhicetosannissitānīti,abhicetosannissitaniti,2,2,0,0,22
413838,sukhavihārabhūtānanti,sukhaviharabhutananti,4,4,0,0,21
413839,rūpāvacarajjhānānametaṃ,rupavacarajjhananametam,4,4,0,0,23
413840,asaṃkiliṭṭhanekkhammasukhaṃ,asamkilitthanekkhammasukham,1,1,0,0,27
413841,diṭṭhadhammasukhavihārānī,ditthadhammasukhaviharani,5,5,0,0,25
413842,nikāmena,nikamena,4,4,0,0,8
413843,akasirānaṃ,akasiranam,4,4,0,0,10
413844,lābhīyeva,labhiyeva,7,5,2,0,9
413845,tathāsamāpajjituṃ,tathasamapajjitum,1,1,0,0,17
413846,pāripanthike,paripanthike,7,6,1,0,12
413847,nāḷikayantaṃ,nalikayantam,3,2,1,0,12
413848,yathāparicchedeyeva,yathaparicchedeyeva,5,4,1,0,19
413849,khayātiādīni,khayatiadini,1,0,1,0,12
413850,bāhusaccampi,bahusaccampi,2,2,0,0,12
413851,bāhusaccañca,bahusaccanca,7,7,0,0,12
413852,vaḷañjanakajjhānāni,valanjanakajjhanani,1,1,0,0,19
413853,uddhatenāti,uddhatenati,1,0,1,0,11
413854,uddhaccasahagatena,uddhaccasahagatena,1,1,0,0,18
413855,palāpakathaṃ,palapakatham,1,1,0,0,12
413856,asamāhitasaṅkappoti,asamahitasankappoti,1,0,1,0,19
413857,aṭṭhapitasaṅkappo,atthapitasankappo,1,1,0,0,17
413858,magoti,magoti,4,0,4,0,6
413859,magasadiso,magasadiso,3,3,0,0,10
413860,ārāti,arati,4,0,4,0,5
413861,thāvareyyamhāti,thavareyyamhati,1,0,1,0,15
413862,thāvarabhāvato,thavarabhavato,1,1,0,0,14
413863,pāpadiṭṭhīti,papaditthiti,1,0,1,0,12
413864,lāmakadiṭṭhi,lamakaditthi,1,1,0,0,12
413865,anādaroti,anadaroti,5,0,5,0,9
413866,ādararahito,adararahito,4,4,0,0,11
413867,paṭibhānavāti,patibhanavati,12,0,12,0,13
413868,abhiññāpāragū,abhinnaparagu,18,15,3,0,13
413869,sacchikiriyāpāragū,sacchikiriyaparagu,11,10,1,0,18
413870,samāpattipāragūti,samapattiparaguti,6,4,2,0,17
413871,pāragamanena,paragamanena,3,3,0,0,12
413872,akhiloti,akhiloti,5,0,5,0,8
413873,rāgakhilādivirahito,ragakhiladivirahito,1,1,0,0,19
413874,sakalabrahmacariyo,sakalabrahmacariyo,2,1,1,0,18
413875,lokasuttavaṇṇanā,lokasuttavannana,13,13,0,0,16
413876,lokasmāti,lokasmati,2,0,2,0,9
413877,sukhadukkhādi,sukhadukkhadi,2,1,1,0,13
413878,apariyesitvā,apariyesitva,42,38,4,0,12
413879,anusañcaritaṃ,anusancaritam,12,9,3,0,13
413880,pītakantiādi,pitakantiadi,3,3,0,0,12
413881,mudiṅgasaddotiādi,mudingasaddotiadi,3,3,0,0,17
413882,tacagandhotiādi,tacagandhotiadi,3,3,0,0,15
413883,khandharasotiādi,khandharasotiadi,3,3,0,0,16
413884,mudukantiādi,mudukantiadi,3,3,0,0,12
413885,pathavīdhātutejodhātuvāyodhātubhedaṃ,pathavidhatutejodhatuvayodhatubhedam,5,5,0,0,36
413886,sukhadukkhādibhedaṃ,sukhadukkhadibhedam,4,4,0,0,19
413887,gatasaddena,gatasaddena,11,10,1,0,11
413888,ekapuggalavaṇṇanāyaṃ,ekapuggalavannanayam,1,1,0,0,20
413889,tathāgatasaddavitthāre,tathagatasaddavitthare,2,2,0,0,22
413890,dakkhatīti,dakkhatiti,9,5,4,0,10
413891,tedhātukalokasannivāse,tedhatukalokasannivase,2,2,0,0,22
413892,visaṃyuttoti,visamyuttoti,18,6,12,0,12
413893,yogānaṃ,yoganam,7,6,1,0,7
413894,anūpayoti,anupayoti,7,2,5,0,9
413895,taṇhādiṭṭhiupayehi,tanhaditthiupayehi,3,2,1,0,18
413896,sabbārammaṇāni,sabbarammanani,5,5,0,0,14
413897,dhīroti,dhiroti,34,6,28,0,7
413898,sabbaganthappamocanoti,sabbaganthappamocanoti,2,0,2,0,22
413899,ñāṇaphusanena,nanaphusanena,3,3,0,0,13
413900,paramāsantīti,paramasantiti,1,0,1,0,13
413901,upadhisaṅkhayeti,upadhisankhayeti,6,1,5,0,16
413902,upadhisaṅkhayasaṅkhāte,upadhisankhayasankhate,4,3,1,0,22
413903,phalavimuttiyā,phalavimuttiya,18,18,0,0,14
413904,anuttaroti,anuttaroti,24,13,11,0,10
413905,sahanaṭṭhena,sahanatthena,3,3,0,0,12
413906,hiṃsanaṭṭhena,himsanatthena,6,6,0,0,13
413907,dantotiādi,dantotiadi,2,0,2,0,10
413908,kāḷakārāmasuttavaṇṇanā,kalakaramasuttavannana,3,3,0,0,22
413909,atthuppattiyanti,atthuppattiyanti,1,1,0,0,16
413910,dasabalaguṇakathāya,dasabalagunakathaya,1,1,0,0,19
413911,cūḷasubhaddā,culasubhadda,7,7,0,0,12
413912,kāḷakaseṭṭhiputtassa,kalakasetthiputtassa,1,1,0,0,20
413913,micchādiṭṭhikakulaṃ,micchaditthikakulam,2,2,0,0,19
413914,pesiyamāne,pesiyamane,1,1,0,0,10
413915,āvajjeyyātha,avajjeyyatha,1,1,0,0,12
413916,acelakasatāni,acelakasatani,1,1,0,0,13
413917,arahanteti,arahanteti,3,1,2,0,10
413918,nissirikadassane,nissirikadassane,1,1,0,0,16
413919,dhīdhī,dhidhi,1,1,0,0,6
413920,acelakā,acelaka,11,11,0,0,7
413921,lajjāpesī,lajjapesi,3,3,0,0,9
413922,pasaṃsasi,pasamsasi,11,11,0,0,9
413923,kiṃsīlā,kimsila,3,2,1,0,7
413924,kiṃsamācārā,kimsamacara,3,2,1,0,11
413925,santamanā,santamana,2,2,0,0,9
413926,santatejā,santateja,1,1,0,0,9
413927,guṇamaggasaṇṭhitā,gunamaggasanthita,1,1,0,0,17
413928,okkhittacakkhū,okkhittacakkhu,11,11,0,0,14
413929,vanamogayha,vanamogayha,15,15,0,0,11
413930,chetvāva,chetvava,6,5,1,0,8
413931,ekakiyā,ekakiya,1,1,0,0,7
413932,adutiyā,adutiya,6,5,1,0,7
413933,katipāhaccayenāti,katipahaccayenati,3,1,2,0,17
413934,pakkosāpeyyā,pakkosapeyya,1,1,0,0,12
413935,pupphasamuggaṃ,pupphasamuggam,3,3,0,0,14
413936,pupphamuṭṭhiyo,pupphamutthiyo,11,11,0,0,14
413937,nimantitamha,nimantitamha,3,3,0,0,12
413938,seṭṭhīti,setthiti,6,5,1,0,8
413939,yojanasatamatthakepi,yojanasatamatthakepi,1,1,0,0,20
413940,yojanasahassamatthakepi,yojanasahassamatthakepi,1,1,0,0,23
413941,chaḷabhiññānaṃyeva,chalabhinnanamyeva,1,1,0,0,18
413942,vimanā,vimana,14,14,0,0,6
413943,chaḷabhiññasatehi,chalabhinnasatehi,1,1,0,0,17
413944,kūṭāgārayānena,kutagarayanena,1,1,0,0,14
413945,vilikhanto,vilikhanto,6,6,0,0,10
413946,sasurapakkho,sasurapakkho,1,1,0,0,12
413947,anucchavikadhammaṃ,anucchavikadhammam,2,2,0,0,18
413948,kāḷakaseṭṭhi,kalakasetthi,1,1,0,0,12
413949,nīharitabbaniyāmena,niharitabbaniyamena,1,1,0,0,19
413950,kāḷakena,kalakena,4,4,0,0,8
413951,kāritatāya,karitataya,1,1,0,0,10
413952,kāḷakārāmo,kalakaramo,1,1,0,0,10
413953,upaṭṭhānasālāya,upatthanasalaya,18,17,1,0,15
413954,kāḷakaseṭṭhiṃ,kalakasetthim,1,1,0,0,13
413955,diṭṭhito,ditthito,6,6,0,0,8
413956,devalokasadisaṃ,devalokasadisam,4,4,0,0,15
413957,samuṭṭhissati,samutthissati,1,1,0,0,13
413958,kampissatī,kampissati,1,1,0,0,10
413959,guṇakathāya,gunakathaya,13,12,1,0,11
413960,padapariyosāne,padapariyosane,7,7,0,0,14
413961,abhiaññāsiṃ,abhiannasim,1,1,0,0,11
413962,jāninti,janinti,2,2,0,0,7
413963,sabbaññutabhūmi,sabbannutabhumi,1,1,0,0,15
413964,khīṇāsavabhūmi,khinasavabhumi,4,4,0,0,14
413965,saccabhūmi,saccabhumi,1,1,0,0,10
413966,taṇhāmānadiṭṭhīhi,tanhamanaditthihi,13,13,0,0,17
413967,adiṭṭhameva,aditthameva,6,6,0,0,11
413968,maññanāhi,mannanahi,17,16,1,0,9
413969,daṭṭhabbañhi,datthabbanhi,1,1,0,0,12
413970,passitāraṃ,passitaram,1,1,0,0,10
413971,ekasattaṃ,ekasattam,1,1,0,0,9
413972,suññatābhūmi,sunnatabhumi,1,1,0,0,12
413973,tādīti,taditi,22,6,16,0,6
413974,tāditā,tadita,1,0,1,0,6
413975,alābhepi,alabhepi,16,14,2,0,8
413976,ayasepi,ayasepi,12,12,0,0,7
413977,nindāyapi,nindayapi,13,13,0,0,9
413978,pasaṃsāyapi,pasamsayapi,13,13,0,0,11
413979,tāditāya,taditaya,3,3,0,0,8
413980,tādimhāti,tadimhati,1,0,1,0,9
413981,tathāgatatādito,tathagatatadito,1,1,0,0,15
413982,tādibhūmi,tadibhumi,1,1,0,0,9
413983,pañcabhūmīhi,pancabhumihi,1,1,0,0,12
413984,niṭṭhāpentassa,nitthapentassa,3,3,0,0,14
413985,adhunāpabbajite,adhunapabbajite,1,1,0,0,15
413986,yaṃkiñcītiādimāha,yamkincitiadimaha,1,0,1,0,17
413987,parapattiyāyanāya,parapattiyayanaya,1,1,0,0,17
413988,saccamutanti,saccamutanti,1,1,0,0,12
413989,pariniṭṭhāpetvā,parinitthapetva,12,11,1,0,15
413990,sayasaṃvutesūti,sayasamvutesuti,1,0,1,0,15
413991,gahitagahaṇesu,gahitagahanesu,1,1,0,0,14
413992,diṭṭhigatikesūti,ditthigatikesuti,2,1,1,0,16
413993,saṃvutāti,samvutati,5,1,4,0,9
413994,daheyyāti,daheyyati,3,0,3,0,9
413995,saṃvutasaṅkhātesu,samvutasankhatesu,1,1,0,0,17
413996,diṭṭhigatikesu,ditthigatikesu,4,4,0,0,14
413997,odaheyya,odaheyya,7,6,1,0,8
413998,saddaheyya,saddaheyya,18,18,0,0,10
413999,pattiyāyeyya,pattiyayeyya,1,1,0,0,12
414000,lagitā,lagita,4,4,0,0,6
414001,palibuddhā,palibuddha,18,17,1,0,10
414002,tathāgatānanti,tathagatananti,2,2,0,0,14
414003,brahmacariyasuttavaṇṇanā,brahmacariyasuttavannana,3,3,0,0,24
414004,kuhanatthāya,kuhanatthaya,1,1,0,0,12
414005,upalāpanatthaṃ,upalapanattham,3,2,1,0,14
414006,cīvarādithutivacanatthaṃ,civaradithutivacanattham,1,1,0,0,24
414007,katavādānisaṃsatthaṃ,katavadanisamsattham,1,1,0,0,20
414008,pamokkhānisaṃsatthaṃ,pamokkhanisamsattham,1,1,0,0,20
414009,saṃvarehi,samvarehi,3,3,0,0,9
414010,saṃvaraṇatthāya,samvaranatthaya,7,7,0,0,15
414011,itihaparivajjitaṃ,itihaparivajjitam,2,1,1,0,17
414012,aparapattiyanti,aparapattiyanti,2,2,0,0,15
414013,antogāminaṃ,antogaminam,4,3,1,0,11
414014,maggabrahmacariyañhi,maggabrahmacariyanhi,2,2,0,0,20
414015,kuhasuttavaṇṇanā,kuhasuttavannana,4,4,0,0,16
414016,kuhāti,kuhati,5,0,5,0,6
414017,thaddhāti,thaddhati,7,1,6,0,9
414018,lapāti,lapati,6,0,6,0,6
414019,upalāpakā,upalapaka,2,2,0,0,9
414020,siṅgīti,singiti,8,1,7,0,7
414021,siṅgasadisehi,singasadisehi,3,3,0,0,13
414022,pākaṭakilesehi,pakatakilesehi,3,3,0,0,14
414023,cittekaggamattassāpi,cittekaggamattassapi,1,1,0,0,20
414024,māmakāti,mamakati,4,0,4,0,8
414025,sammāpaṭipannattā,sammapatipannatta,2,2,0,0,17
414026,patthaṭatāya,patthatataya,3,2,1,0,12
414027,virūḷhā,virulha,4,4,0,0,7
414028,santuṭṭhisuttavaṇṇanā,santutthisuttavannana,3,3,0,0,21
414029,appānīti,appaniti,2,0,2,0,8
414030,sulabhānīti,sulabhaniti,2,0,2,0,11
414031,laddhabbāni,laddhabbani,5,5,0,0,11
414032,niddosāni,niddosani,2,2,0,0,9
414033,jaṅghāpiṇḍiyabalena,janghapindiyabalena,1,1,0,0,19
414034,ālopamattaṃ,alopamattam,3,3,0,0,11
414035,pūtikāyoti,putikayoti,2,1,1,0,10
414036,pūtimuttameva,putimuttameva,5,5,0,0,13
414037,vighātoti,vighatoti,9,2,7,0,9
414038,vigataghāto,vigataghato,1,1,0,0,11
414039,nappaṭihaññatīti,nappatihannatiti,4,1,3,0,16
414040,paṭipattidhammā,patipattidhamma,2,2,0,0,15
414041,sāmaññassānulomikāti,samannassanulomikati,2,0,2,0,20
414042,adhiggahitāti,adhiggahitati,2,0,2,0,13
414043,tuṭṭhacittassa,tutthacittassa,5,4,1,0,14
414044,ariyavaṃsasuttavaṇṇanā,ariyavamsasuttavannana,3,3,0,0,22
414045,ajjhāsayiko,ajjhasayiko,1,1,0,0,11
414046,mahāariyavaṃsasuttantaṃ,mahaariyavamsasuttantam,1,1,0,0,23
414047,parapuggalānampi,parapuggalanampi,1,1,0,0,16
414048,nisinnāni,nisinnani,6,6,0,0,9
414049,ariyavaṃsāti,ariyavamsati,7,0,7,0,12
414050,vaṃsā,vamsa,8,8,0,0,5
414051,khattiyavaṃso,khattiyavamso,7,7,0,0,13
414052,brāhmaṇavaṃso,brahmanavamso,4,4,0,0,13
414053,vessavaṃso,vessavamso,4,4,0,0,10
414054,suddavaṃso,suddavamso,4,4,0,0,10
414055,samaṇavaṃso,samanavamso,6,4,2,0,11
414056,rājavaṃso,rajavamso,7,7,0,0,9
414057,ariyatanti,ariyatanti,4,4,0,0,10
414058,ariyapaveṇī,ariyapaveni,3,3,0,0,11
414059,vaṃsānaṃ,vamsanam,5,5,0,0,8
414060,mūlagandhādīnaṃ,mulagandhadinam,6,4,2,0,15
414061,kāḷānusārigandhādayo,kalanusarigandhadayo,2,2,0,0,20
414062,vaṃsāti,vamsati,17,15,2,0,7
414063,satasahassakappādhikānaṃ,satasahassakappadhikanam,5,5,0,0,24
414064,dīpaṅkaroti,dipankaroti,7,7,0,0,11
414065,sabbabuddhapaccekabuddhabuddhasāvakānaṃ,sabbabuddhapaccekabuddhabuddhasavakanam,5,5,0,0,39
414066,adhunuppattikā,adhunuppattika,2,2,0,0,14
414067,avikiṇṇā,avikinna,4,4,0,0,8
414068,anapanītā,anapanita,6,4,2,0,9
414069,atītabuddhehipi,atitabuddhehipi,1,1,0,0,15
414070,saṃkiṇṇapubbā,samkinnapubba,2,2,0,0,13
414071,imehī,imehi,14,10,4,0,5
414072,apanītapubbā,apanitapubba,4,4,0,0,12
414073,saṃkīyantīti,samkiyantiti,4,0,4,0,12
414074,apanīyanti,apaniyanti,6,5,1,0,10
414075,saṃkīyissantīti,samkiyissantiti,3,0,3,0,15
414076,anāgatabuddhehipi,anagatabuddhehipi,2,2,0,0,17
414077,apanīyissanti,apaniyissanti,5,4,1,0,13
414078,paccayasantosavasena,paccayasantosavasena,5,4,1,0,20
414079,itarītarenāti,itaritarenati,16,0,16,0,13
414080,thūlasukhumalūkhapaṇītathirajiṇṇānaṃ,thulasukhumalukhapanitathirajinnanam,5,5,0,0,36
414081,yathāladdhādīnaṃ,yathaladdhadinam,6,5,1,0,16
414082,cīvarasmiñhi,civarasminhi,5,5,0,0,12
414083,santosā,santosa,17,17,0,0,7
414084,piṇḍapātādīsupi,pindapatadisupi,8,8,0,0,15
414085,yathāladdhādīsu,yathaladdhadisu,3,3,0,0,15
414086,cīvarakkhettaṃ,civarakkhettam,5,2,3,0,14
414087,cīvarasantoso,civarasantoso,4,4,0,0,13
414088,cīvarappaṭisaṃyuttāni,civarappatisamyuttani,3,1,2,0,21
414089,dukūlādīni,dukuladini,4,4,0,0,10
414090,anulomacīvarāni,anulomacivarani,4,4,0,0,15
414091,kappiyacīvarāni,kappiyacivarani,5,3,2,0,15
414092,phalakacīraṃ,phalakaciram,12,7,5,0,12
414093,rukkhadussaṃ,rukkhadussam,5,3,2,0,12
414094,latādussaṃ,latadussam,5,3,2,0,10
414095,erakadussaṃ,erakadussam,5,3,2,0,11
414096,kadalidussaṃ,kadalidussam,5,3,2,0,12
414097,veḷudussanti,veludussanti,3,3,0,0,12
414098,akappiyacīvarāni,akappiyacivarani,7,5,2,0,16
414099,mittato,mittato,14,14,0,0,7
414100,mātikānaṃ,matikanam,22,18,4,0,9
414101,aggidaḍḍhaṃ,aggidaddham,9,6,3,0,11
414102,upacikakhāyitaṃ,upacikakhayitam,2,2,0,0,15
414103,dasacchinnaṃ,dasacchinnam,2,2,0,0,12
414104,ābhisekiyaṃ,abhisekiyam,5,4,1,0,11
414105,devadattiyanti,devadattiyanti,5,5,0,0,14
414106,paṃsukūlāni,pamsukulani,56,54,2,0,11
414107,gabbhamalaharaṇaṃ,gabbhamalaharanam,3,3,0,0,17
414108,matakasarīraṃ,matakasariram,3,3,0,0,13
414109,ānītacīvaraṃ,anitacivaram,3,3,0,0,12
414110,pūjitacīvaraṃ,pujitacivaram,3,3,0,0,13
414111,panthaṃ,pantham,10,9,1,0,7
414112,pāsāṇehi,pasanehi,16,16,0,0,8
414113,cīvarasantosoti,civarasantosoti,5,0,5,0,15
414114,cīvarasantosā,civarasantosa,3,3,0,0,13
414115,vitakkasantoso,vitakkasantoso,16,9,7,0,14
414116,gamanasantoso,gamanasantoso,12,6,6,0,13
414117,pariyesanasantoso,pariyesanasantoso,12,6,6,0,17
414118,paṭilābhasantoso,patilabhasantoso,12,6,6,0,16
414119,mattapaṭiggahaṇasantoso,mattapatiggahanasantoso,8,4,4,0,23
414120,loluppavivajjanasantoso,loluppavivajjanasantoso,12,6,6,0,23
414121,udakasantoso,udakasantoso,6,3,3,0,12
414122,dhovanasantoso,dhovanasantoso,6,3,3,0,14
414123,karaṇasantoso,karanasantoso,6,3,3,0,13
414124,parimāṇasantoso,parimanasantoso,12,6,6,0,15
414125,suttasantoso,suttasantoso,6,3,3,0,12
414126,sibbanasantoso,sibbanasantoso,6,3,3,0,14
414127,rajanasantoso,rajanasantoso,6,3,3,0,13
414128,kappasantoso,kappasantoso,8,3,5,0,12
414129,paribhogasantoso,paribhogasantoso,12,6,6,0,16
414130,sannidhiparivajjanasantoso,sannidhiparivajjanasantoso,12,6,6,0,26
414131,vissajjanasantosoti,vissajjanasantosoti,6,6,0,0,19
414132,sādakabhikkhunā,sadakabhikkhuna,2,2,0,0,15
414133,cīvaramāse,civaramase,14,14,0,0,10
414134,aḍḍhamāseneva,addhamaseneva,2,2,0,0,13
414135,māsaḍḍhamāsamattaṃ,masaddhamasamattam,3,2,1,0,18
414136,vitakkasantosena,vitakkasantosena,2,2,0,0,16
414137,santuṭṭhena,santutthena,8,8,0,0,11
414138,pācīnakhaṇḍarājivāsikapaṃsukūlikattherasadisena,pacinakhandarajivasikapamsukulikattherasadisena,1,1,0,0,47
414139,cetiyapabbatavihāre,cetiyapabbatavihare,3,3,0,0,19
414140,ahampāvuso,ahampavuso,4,3,1,0,10
414141,mahābodhidvārakoṭṭhake,mahabodhidvarakotthake,2,2,0,0,22
414142,ambaṅgaṇasamīpato,ambanganasamipato,2,2,0,0,17
414143,catutthadivase,catutthadivase,33,33,0,0,14
414144,pucchamāno,pucchamano,11,9,2,0,10
414145,uccārapalibuddho,uccarapalibuddho,2,2,0,0,16
414146,sāṭakeyeva,satakeyeva,2,2,0,0,10
414147,paṃsukūlikatthero,pamsukulikatthero,2,1,1,0,17
414148,nīlamakkhikāhi,nilamakkhikahi,5,5,0,0,14
414149,saṅkāraṭṭhānassa,sankaratthanassa,4,4,0,0,16
414150,paggaṇhāsī,pagganhasi,2,2,0,0,10
414151,puṇṇadāsiyā,punnadasiya,3,3,0,0,11
414152,tumbamatte,tumbamatte,9,9,0,0,10
414153,paṃsukūlikattheropi,pamsukulikattheropi,2,2,0,0,19
414154,lajjiṃ,lajjim,20,20,0,0,6
414155,āhariyamānaṃ,ahariyamanam,15,13,2,0,12
414156,avitakketvā,avitakketva,3,3,0,0,11
414157,thūlasukhumādīsu,thulasukhumadisu,3,3,0,0,16
414158,dupaṭṭassa,dupattassa,6,6,0,0,10
414159,ekapaṭṭassā,ekapattassa,3,3,0,0,11
414160,pahonakamatteneva,pahonakamatteneva,3,3,0,0,17
414161,lūkhapaṇītesu,lukhapanitesu,3,3,0,0,13
414162,dhovanūpagena,dhovanupagena,1,1,0,0,13
414163,paṇḍumattikagerukapūtipaṇṇarasakiliṭṭhāni,pandumattikagerukaputipannarasakilitthani,3,3,0,0,41
414164,vajjetuṃ,vajjetum,4,4,0,0,8
414165,muggarādīhi,muggaradihi,10,10,0,0,11
414166,apaharitvā,apaharitva,11,11,0,0,10
414167,asujjhantaṃ,asujjhantam,3,3,0,0,11
414168,tāpitaudakenāpi,tapitaudakenapi,3,3,0,0,15
414169,pahonakanīhāreneva,pahonakanihareneva,3,3,0,0,18
414170,timaṇḍalapaticchādanamattasseva,timandalapaticchadanamattasseva,1,1,0,0,31
414171,cīvarakaraṇatthāya,civarakaranatthaya,3,3,0,0,18
414172,pariyesissāmīti,pariyesissamiti,4,4,0,0,15
414173,rathikādīsu,rathikadisu,9,9,0,0,11
414174,devaṭṭhāne,devatthane,11,10,1,0,10
414175,kusibandhanakāle,kusibandhanakale,3,3,0,0,16
414176,aṅgulamatte,angulamatte,2,2,0,0,11
414177,vijjhitabbaṃ,vijjhitabbam,7,7,0,0,12
414178,vattabhedopi,vattabhedopi,3,3,0,0,12
414179,tivaṅgulamatte,tivangulamatte,3,3,0,0,14
414180,maggappaṭipannenāpi,maggappatipannenapi,1,1,0,0,19
414181,rajantena,rajantena,17,17,0,0,9
414182,kāḷakacchakādīni,kalakacchakadini,3,3,0,0,16
414183,somavakkalādīsu,somavakkaladisu,3,3,0,0,15
414184,vākaṃ,vakam,18,15,3,0,5
414185,chaḍḍitarajanaṃ,chadditarajanam,3,3,0,0,15
414186,nīlakaddamakāḷasāmesu,nilakaddamakalasamesu,3,3,0,0,21
414187,hatthipiṭṭhe,hatthipitthe,16,16,0,0,12
414188,paññāyamānakappakaraṇaṃ,pannayamanakappakaranam,2,2,0,0,23
414189,hirikopīnappaṭicchādanamattavasena,hirikopinappaticchadanamattavasena,1,1,0,0,34
414190,antevāsikādīnaṃ,antevasikadinam,7,7,0,0,15
414191,asannihitā,asannihita,3,3,0,0,10
414192,āgatamattesu,agatamattesu,3,3,0,0,12
414193,paccattharaṇampi,paccattharanampi,9,7,2,0,16
414194,anadhiṭṭhitameva,anadhitthitameva,4,4,0,0,16
414195,vissajjentena,vissajjentena,13,13,0,0,13
414196,sāraṇīyadhamme,saraniyadhamme,11,7,4,0,14
414197,vissajjetabbanti,vissajjetabbanti,5,5,0,0,16
414198,vissajjanasantoso,vissajjanasantoso,6,0,6,0,17
414199,paṃsukūlikaṅgañceva,pamsukulikanganceva,3,3,0,0,19
414200,tecīvarikaṅgañca,tecivarikanganca,4,4,0,0,16
414201,cīvarasantosamahāariyavaṃsaṃ,civarasantosamahaariyavamsam,3,3,0,0,28
414202,gopento,gopento,14,13,1,0,7
414203,cīvarasantosamahāariyavaṃsavasena,civarasantosamahaariyavamsavasena,2,2,0,0,33
414204,dūteyyapahinagamanānuyogapabhedaṃ,duteyyapahinagamananuyogapabhedam,1,1,0,0,33
414205,agadhitoti,agadhitoti,6,0,6,0,10
414206,vigatalobhagiddho,vigatalobhagiddho,4,3,1,0,17
414207,adhimattataṇhāya,adhimattatanhaya,5,5,0,0,16
414208,anajjhopannoti,anajjhopannoti,2,0,2,0,14
414209,anotthato,anotthato,3,2,1,0,9
414210,apariyonaddho,apariyonaddho,5,5,0,0,13
414211,anesanāpattiyañca,anesanapattiyanca,5,5,0,0,17
414212,gedhitaparibhoge,gedhitaparibhoge,2,2,0,0,16
414213,nissaraṇapaññoti,nissaranapannoti,6,0,6,0,16
414214,nissaraṇameva,nissaranameva,3,3,0,0,13
414215,itarītaracīvarasantuṭṭhiyāti,itaritaracivarasantutthiyati,4,0,4,0,28
414216,nevattānukkaṃsetīti,nevattanukkamsetiti,7,0,7,0,19
414217,upasampadamāḷeyeva,upasampadamaleyeva,4,4,0,0,18
414218,attukkaṃsanaṃ,attukkamsanam,8,8,0,0,13
414219,vambhetīti,vambhetiti,11,1,10,0,10
414220,paṃsukūlikaṅgamattampi,pamsukulikangamattampi,2,2,0,0,22
414221,cīvarasantose,civarasantose,7,7,0,0,13
414222,vaṇṇavādādīsu,vannavadadisu,3,2,1,0,13
414223,analasoti,analasoti,8,0,8,0,9
414224,ālasiyavirahito,alasiyavirahito,4,4,0,0,15
414225,paṭissatoti,patissatoti,12,3,9,0,11
414226,piṇḍapātenāti,pindapatenati,6,0,6,0,13
414227,piṇḍapātakkhettaṃ,pindapatakkhettam,8,2,6,0,17
414228,piṇḍapātasantoso,pindapatasantoso,6,4,2,0,16
414229,piṇḍapātappaṭisaṃyuttaṃ,pindapatappatisamyuttam,1,1,0,0,23
414230,lehanīyanti,lehaniyanti,2,2,0,0,11
414231,pāṭipadikabhattaṃ,patipadikabhattam,2,1,1,0,17
414232,kuṭibhattaṃ,kutibhattam,12,6,6,0,11
414233,vārabhattaṃ,varabhattam,12,6,6,0,11
414234,vihārabhattanti,viharabhattanti,3,3,0,0,15
414235,piṇḍapātakkhettāni,pindapatakkhettani,2,2,0,0,18
414236,piṇḍapātasantosoti,pindapatasantosoti,3,0,3,0,18
414237,paṭiggahaṇasantoso,patiggahanasantoso,6,3,3,0,18
414238,upakārasantoso,upakarasantoso,6,3,3,0,14
414239,sādako,sadako,9,8,1,0,6
414240,therūpaṭṭhānakāle,therupatthanakale,3,3,0,0,17
414241,vitakketabbaṃ,vitakketabbam,6,6,0,0,13
414242,ekacārikena,ekacarikena,4,4,0,0,11
414243,pesalameva,pesalameva,3,3,0,0,10
414244,paṭiggahaṇasmiñhi,patiggahanasminhi,3,3,0,0,17
414245,jānitvāva,janitvava,18,18,0,0,9
414246,aḍḍhakulāniyeva,addhakulaniyeva,2,2,0,0,15
414247,yathālābhasantosā,yathalabhasantosa,3,0,3,0,17
414248,anupālessāmī,anupalessami,2,2,0,0,12
414249,gāhāpetabbaṃ,gahapetabbam,13,10,3,0,12
414250,paṭiggahaṇamattaṃ,patiggahanamattam,6,6,0,0,17
414251,paṭivinodanaṃ,pativinodanam,5,5,0,0,13
414252,piṇḍapātappaṭisaṃyuttāni,pindapatappatisamyuttani,1,0,1,0,24
414253,khalupacchābhattikaṅganti,khalupacchabhattikanganti,4,4,0,0,25
414254,piṇḍapātasantosamahāariyavaṃsaṃ,pindapatasantosamahaariyavamsam,3,3,0,0,31
414255,piṇḍapātasantosamahāariyavaṃsena,pindapatasantosamahaariyavamsena,3,3,0,0,32
414256,vaṇṇavādītiādīni,vannavaditiadini,2,1,1,0,16
414257,senāsanenāti,senasanenati,4,0,4,0,12
414258,senāsanakkhettaṃ,senasanakkhettam,4,2,2,0,16
414259,senāsanasantoso,senasanasantoso,5,5,0,0,15
414260,senāsanappaṭisaṃyuttaṃ,senasanappatisamyuttam,1,1,0,0,22
414261,veḷugumbo,velugumbo,5,5,0,0,9
414262,senāsanasantosoti,senasanasantosoti,3,0,3,0,17
414263,vitakkasantosādayo,vitakkasantosadayo,3,3,0,0,18
414264,senāsanappaṭisaṃyuttāni,senasanappatisamyuttani,1,0,1,0,23
414265,senāsanasantosamahāariyavaṃsaṃ,senasanasantosamahaariyavamsam,2,2,0,0,30
414266,senāsanasantosamahāariyavaṃsena,senasanasantosamahaariyavamsena,3,3,0,0,31
414267,piṇḍapāteyeva,pindapateyeva,2,2,0,0,13
414268,yathālābhayathābalayathāsāruppasantoseneva,yathalabhayathabalayathasaruppasantoseneva,3,3,0,0,42
414269,santussitabbaṃ,santussitabbam,4,4,0,0,14
414270,bhāvanārāmaariyavaṃsaṃ,bhavanaramaariyavamsam,7,5,2,0,22
414271,āhāranissitā,aharanissita,5,4,1,0,12
414272,vīriyasaṃyutto,viriyasamyutto,3,3,0,0,14
414273,cīvaranissitā,civaranissita,3,3,0,0,13
414274,pattharamāno,pattharamano,5,3,2,0,12
414275,sāgarakucchiṃ,sagarakucchim,3,3,0,0,13
414276,vitthārayamāno,vittharayamano,3,3,0,0,14
414277,cīvarasantosaṃ,civarasantosam,4,4,0,0,14
414278,uṭṭhāpento,utthapento,32,32,0,0,10
414279,ullaṅghento,ullanghento,3,3,0,0,11
414280,piṇḍapātasantosaṃ,pindapatasantosam,3,3,0,0,17
414281,senāsanasantosaṃ,senasanasantosam,5,5,0,0,16
414282,sahassanayapaṭimaṇḍitaṃ,sahassanayapatimanditam,2,1,1,0,23
414283,abhiratīti,abhiratiti,12,7,5,0,10
414284,pahānārāmoti,pahanaramoti,3,0,3,0,12
414285,ārammaṇavibhattiyo,arammanavibhattiyo,7,7,0,0,18
414286,ariyavaṃsesu,ariyavamsesu,3,3,0,0,12
414287,dhutaṅgānaṃ,dhutanganam,11,10,1,0,11
414288,catupaccayasantosassa,catupaccayasantosassa,2,2,0,0,21
414289,bhāvanārāmena,bhavanaramena,4,2,2,0,13
414290,piṭakadvayaṃ,pitakadvayam,6,4,2,0,12
414291,nekkhammapāḷiyā,nekkhammapaliya,6,5,1,0,15
414292,dasuttarasuttantapariyāyena,dasuttarasuttantapariyayena,4,4,0,0,27
414293,satipaṭṭhānasuttantapariyāyena,satipatthanasuttantapariyayena,5,5,0,0,30
414294,niddesapariyāyena,niddesapariyayena,4,4,0,0,17
414295,nekkhammapāḷiyāti,nekkhammapaliyati,2,0,2,0,17
414296,dhammavavatthānaṃ,dhammavavatthanam,30,26,4,0,17
414297,paṭighasaññaṃ,patighasannam,10,9,1,0,13
414298,nānattasaññaṃ,nanattasannam,11,10,1,0,13
414299,anusahagate,anusahagate,5,4,1,0,11
414300,dasuttarasuttantapariyāyenāti,dasuttarasuttantapariyayenati,3,0,3,0,29
414301,micchatte,micchatte,4,4,0,0,9
414302,satipaṭṭhānasuttantapariyāyenāti,satipatthanasuttantapariyayenati,2,0,2,0,32
414303,niddesapariyāyenāti,niddesapariyayenati,2,0,2,0,19
414304,upasīvamāṇavapucchāniddeso,upasivamanavapucchaniddeso,3,3,0,0,26
414305,nandamāṇavapucchāniddeso,nandamanavapucchaniddeso,3,3,0,0,24
414306,vipassanāmattakampi,vipassanamattakampi,2,2,0,0,19
414307,vissaṭṭhakammaṭṭhānā,vissatthakammatthana,3,3,0,0,20
414308,paravambhanaṃ,paravambhanam,4,4,0,0,13
414309,ariyatantiyo,ariyatantiyo,1,1,0,0,12
414310,ariyapaveṇiyo,ariyapaveniyo,1,1,0,0,13
414311,ariyañjasā,ariyanjasa,1,1,0,0,10
414312,ariyavaṭumānīti,ariyavatumaniti,1,1,0,0,15
414313,mahāariyavaṃsaparipūrakassa,mahaariyavamsaparipurakassa,1,1,0,0,27
414314,vasanadisā,vasanadisa,1,1,0,0,10
414315,aratiratisahoti,aratiratisahoti,2,0,2,0,15
414316,aratiñca,aratinca,15,14,1,0,8
414317,pañcakāmaguṇaratiñca,pancakamagunaratinca,1,1,0,0,20
414318,nāratītiādimāha,naratitiadimaha,1,0,1,0,15
414319,vīriyavantaṃ,viriyavantam,8,6,2,0,12
414320,aratissahoti,aratissahoti,1,0,1,0,12
414321,aratisahattā,aratisahatta,1,1,0,0,12
414322,tebhūmakakammaṃ,tebhumakakammam,5,5,0,0,15
414323,panuditvā,panuditva,18,18,0,0,9
414324,ninditumarahatīti,ninditumarahatiti,3,1,2,0,17
414325,jambonadasaṅkhātassa,jambonadasankhatassa,1,1,0,0,20
414326,jātirattasuvaṇṇassa,jatirattasuvannassa,1,1,0,0,19
414327,nikkhasadisaṃ,nikkhasadisam,1,1,0,0,13
414328,garahitabbadosavimuttaṃ,garahitabbadosavimuttam,1,1,0,0,23
414329,mahābrahmunāpi,mahabrahmunapi,4,4,0,0,14
414330,pasaṃsitoyevāti,pasamsitoyevati,2,2,0,0,15
414331,dhammapadasuttavaṇṇanā,dhammapadasuttavannana,3,3,0,0,22
414332,dhammapadānīti,dhammapadaniti,8,1,7,0,14
414333,dhammakoṭṭhāsā,dhammakotthasa,5,5,0,0,14
414334,anabhijjhātiādīsu,anabhijjhatiadisu,1,0,1,0,17
414335,abhijjhāpaṭikkhepena,abhijjhapatikkhepena,1,1,0,0,20
414336,byāpādapaṭikkhepena,byapadapatikkhepena,1,1,0,0,19
414337,micchāsatipaṭikkhepena,micchasatipatikkhepena,1,1,0,0,22
414338,micchāsamādhipaṭikkhepena,micchasamadhipatikkhepena,1,1,0,0,25
414339,anabhijjhālūti,anabhijjhaluti,2,0,2,0,14
414340,avijahantena,avijahantena,3,3,0,0,12
414341,ekaggacittassāti,ekaggacittassati,1,0,1,0,16
414342,ṭhapitacitto,thapitacitto,4,4,0,0,12
414343,abhiññātāti,abhinnatati,13,1,12,0,11
414344,annabhārotiādīni,annabharotiadini,1,0,1,0,16
414345,bahalarāgaṃ,bahalaragam,3,2,1,0,11
414346,paṭikkositabbāni,patikkositabbani,1,1,0,0,16
414347,paṭibāhitabbani,patibahitabbani,1,1,0,0,15
414348,sahadhammikāti,sahadhammikati,4,0,4,0,14
414349,vādānupātāti,vadanupatati,1,0,1,0,12
414350,dhammikavāde,dhammikavade,1,1,0,0,12
414351,ghaṭṭayamānā,ghattayamana,2,2,0,0,12
414352,adhammikavādānupātā,adhammikavadanupata,1,1,0,0,19
414353,vādappavattiyoti,vadappavattiyoti,1,1,0,0,16
414354,ṭhānāti,thanati,14,0,14,0,7
414355,garahitabbayuttakā,garahitabbayuttaka,1,1,0,0,18
414356,ukkalāti,ukkalati,3,0,3,0,8
414357,ukkalajanapadavāsino,ukkalajanapadavasino,2,2,0,0,20
414358,vassabhaññāti,vassabhannati,3,0,3,0,13
414359,bhañño,bhanno,3,3,0,0,6
414360,ahetukavādāti,ahetukavadati,2,0,2,0,13
414361,tievamādivādino,tievamadivadino,1,1,0,0,15
414362,akiriyavādāti,akiriyavadati,2,0,2,0,13
414363,kiriyapaṭikkhepavādino,kiriyapatikkhepavadino,2,2,0,0,22
414364,natthikavādāti,natthikavadati,2,0,2,0,14
414365,itiādivādino,itiadivadino,1,1,0,0,12
414366,paṭhamajavane,pathamajavane,9,6,3,0,13
414367,satekiccho,satekiccho,14,13,1,0,10
414368,ariṭṭhakaṇṭakasadiso,aritthakantakasadiso,1,1,0,0,20
414369,niyatamicchādiṭṭhikova,niyatamicchaditthikova,6,6,0,0,22
414370,saggamaggāvaraṇañceva,saggamaggavarananceva,5,5,0,0,21
414371,mokkhamaggāvaraṇañca,mokkhamaggavarananca,5,5,0,0,20
414372,saggampi,saggampi,6,6,0,0,8
414373,vaṭṭakhāṇuko,vattakhanuko,3,2,1,0,12
414374,pathavigopako,pathavigopako,3,3,0,0,13
414375,vassabhaññāpi,vassabhannapi,3,3,0,0,13
414376,nindābyārosanaupārambhabhayāti,nindabyarosanauparambhabhayati,1,0,1,0,30
414377,nindabhayena,nindabhayena,1,1,0,0,12
414378,ghaṭṭanabhayena,ghattanabhayena,3,3,0,0,15
414379,upavādabhayena,upavadabhayena,4,4,0,0,14
414380,abhijjhāvinayo,abhijjhavinayo,3,1,2,0,14
414381,vaṭṭaviṭṭaṃ,vattavittam,1,1,0,0,11
414382,cakkasuttavaṇṇanā,cakkasuttavannana,3,3,0,0,17
414383,cakkānīti,cakkaniti,12,4,8,0,9
414384,sampatticakkāni,sampatticakkani,5,4,1,0,15
414385,ghaṭiyantiyevāti,ghatiyantiyevati,1,1,0,0,16
414386,patirūpadesavāsoti,patirupadesavasoti,3,0,3,0,18
414387,sappurisāvassayoti,sappurisavassayoti,2,0,2,0,18
414388,attasammāpaṇidhīti,attasammapanidhiti,4,1,3,0,18
414389,assaddhādīhi,assaddhadihi,3,3,0,0,12
414390,katapuññatāti,katapunnatati,6,1,5,0,13
414391,upacitakusalatā,upacitakusalata,7,7,0,0,15
414392,patirūpadese,patirupadese,4,4,0,0,12
414393,puññakatoti,punnakatoti,1,0,1,0,11
414394,sukhañcetaṃdhivattatīti,sukhancetamdhivattatiti,1,0,1,0,23
414395,adhivattati,adhivattati,2,2,0,0,11
414396,saṅgahasuttavaṇṇanā,sangahasuttavannana,3,3,0,0,19
414397,saṅgahavatthūnīti,sangahavatthuniti,6,0,6,0,17
414398,saṅgaṇhanakāraṇāni,sanganhanakaranani,3,3,0,0,18
414399,dānañcātiādīsu,danancatiadisu,1,0,1,0,14
414400,dāneneva,daneneva,6,5,1,0,8
414401,vacanamevassa,vacanamevassa,1,1,0,0,13
414402,agghatī,agghati,19,18,1,0,7
414403,piyavacanameva,piyavacanameva,5,5,0,0,14
414404,atthacariyāti,atthacariyati,3,0,3,0,13
414405,atthavaḍḍhanakathā,atthavaddhanakatha,1,1,0,0,18
414406,hitakathaṃ,hitakatham,2,2,0,0,10
414407,vaḍḍhikathameva,vaddhikathameva,1,1,0,0,15
414408,atthacariyakathāva,atthacariyakathava,1,1,0,0,18
414409,samānattatāti,samanattatati,8,5,3,0,13
414410,samānasukhadukkhabhāvo,samanasukhadukkhabhavo,2,1,1,0,22
414411,ekapallaṅke,ekapallanke,3,3,0,0,11
414412,samānasukhadukkhataṃ,samanasukhadukkhatam,3,3,0,0,20
414413,yathānucchavikaṃ,yathanucchavikam,4,4,0,0,16
414414,yāyatoti,yayatoti,5,0,5,0,8
414415,puttakāraṇāti,puttakaranati,3,0,3,0,13
414416,samavekkhantīti,samavekkhantiti,1,0,1,0,15
414417,sīhasuttavaṇṇanā,sihasuttavannana,10,10,0,0,16
414418,paṇḍusīho,pandusiho,12,7,5,0,9
414419,kesarasīhoti,kesarasihoti,7,6,1,0,12
414420,kapotavaṇṇagāvisadiso,kapotavannagavisadiso,2,2,0,0,21
414421,kāḷagāvisadiso,kalagavisadiso,4,2,2,0,14
414422,tiṇabhakkhoyeva,tinabhakkhoyeva,2,2,0,0,15
414423,paṇḍupalāsavaṇṇagāvisadiso,pandupalasavannagavisadiso,4,2,2,0,26
414424,maṃsabhakkho,mamsabhakkho,4,4,0,0,12
414425,lākhāparikammakateneva,lakhaparikammakateneva,1,1,0,0,22
414426,agganaṅguṭṭhena,agganangutthena,2,2,0,0,15
414427,pādapariyantehi,padapariyantehi,2,2,0,0,15
414428,matthakatopissa,matthakatopissa,2,2,0,0,15
414429,lākhātūlikāya,lakhatulikaya,2,2,0,0,13
414430,piṭṭhimajjhena,pitthimajjhena,3,3,0,0,14
414431,satasahassagghanikakambalaparikkhepo,satasahassagghanikakambalaparikkhepo,2,2,0,0,36
414432,kesarabhāro,kesarabharo,2,2,0,0,11
414433,avasesaṭṭhānaṃ,avasesatthanam,3,3,0,0,14
414434,parisuddhasālipiṇḍasaṅkhacuṇṇapiṇḍavaṇṇaṃ,parisuddhasalipindasankhacunnapindavannam,1,1,0,0,41
414435,sīhesu,sihesu,3,3,0,0,6
414436,migarājāti,migarajati,5,1,4,0,10
414437,sabbamigagaṇassa,sabbamigaganassa,3,1,2,0,16
414438,āsayāti,asayati,2,0,2,0,7
414439,suvaṇṇaguhato,suvannaguhato,4,2,2,0,13
414440,rajatamaṇiphalikamanosilāguhato,rajatamaniphalikamanosilaguhato,2,2,0,0,31
414441,nikkhamatīti,nikkhamatiti,23,16,7,0,12
414442,nikkhamamāno,nikkhamamano,2,2,0,0,12
414443,andhakārapīḷito,andhakarapilito,2,2,0,0,15
414444,ālokatthāya,alokatthaya,6,5,1,0,11
414445,uccārapassāvapīḷito,uccarapassavapilito,2,2,0,0,19
414446,vissajjanatthāya,vissajjanatthaya,7,7,0,0,16
414447,sambhavapīḷito,sambhavapilito,2,2,0,0,14
414448,assaddhammapaṭisevanatthāya,assaddhammapatisevanatthaya,2,2,0,0,27
414449,rajatamaṇiphalikamanosilātalānaṃ,rajatamaniphalikamanosilatalanam,2,2,0,0,32
414450,pacchābhāgaṃ,pacchabhagam,5,5,0,0,12
414451,purimabhāgaṃ,purimabhagam,5,5,0,0,12
414452,asanisaddaṃ,asanisaddam,4,4,0,0,11
414453,nāsapuṭāni,nasaputani,2,2,0,0,10
414454,sarīralaggaṃ,sariralaggam,4,3,1,0,12
414455,vidhunanto,vidhunanto,9,9,0,0,10
414456,vijambhanabhūmiyañca,vijambhanabhumiyanca,2,2,0,0,20
414457,taruṇavacchako,tarunavacchako,2,2,0,0,14
414458,anuviloketīti,anuviloketiti,3,0,3,0,13
414459,parānuddayatāya,paranuddayataya,14,14,0,0,15
414460,nadante,nadante,4,4,0,0,7
414461,papātāvāṭādīsu,papatavatadisu,2,2,0,0,14
414462,visamaṭṭhānesu,visamatthanesu,4,4,0,0,14
414463,hatthigokaṇṇamahiṃsādayo,hatthigokannamahimsadayo,2,2,0,0,24
414464,papātepi,papatepi,8,7,1,0,8
414465,āvāṭepi,avatepi,2,2,0,0,7
414466,paramaṃsakhādino,paramamsakhadino,2,2,0,0,16
414467,ghātitehī,ghatitehi,2,2,0,0,9
414468,gocaratthāyāpi,gocaratthayapi,1,1,0,0,14
414469,vijambhanabhūmiyaṃ,vijambhanabhumiyam,6,6,0,0,18
414470,nadantassa,nadantassa,4,4,0,0,10
414471,tiyojanapadesaṃ,tiyojanapadesam,2,2,0,0,15
414472,tiyojanabbhantaragatā,tiyojanabbhantaragata,2,2,0,0,21
414473,dvipadacatuppadagaṇā,dvipadacatuppadagana,2,2,0,0,20
414474,uppatanto,uppatanto,10,10,0,0,9
414475,usabhaṭṭhānāni,usabhatthanani,1,1,0,0,14
414476,soḷasausabhamattampi,solasausabhamattampi,2,2,0,0,20
414477,vīsatiusabhamattampi,visatiusabhamattampi,2,2,0,0,20
414478,thalā,thala,3,3,0,0,5
414479,saṭṭhiusabhamattampi,satthiusabhamattampi,2,2,0,0,20
414480,asītiusabhamattampi,asitiusabhamattampi,2,2,0,0,19
414481,nādassa,nadassa,3,3,0,0,7
414482,anunādaṃ,anunadam,2,2,0,0,8
414483,cittutrāsasseva,cittutrasasseva,2,2,0,0,15
414484,samasīho,samasiho,4,4,0,0,8
414485,usabhājānīyo,usabhajaniyo,7,7,0,0,12
414486,bhāyantīti,bhayantiti,5,5,0,0,10
414487,jātigottakulasūrabhāvehi,jatigottakulasurabhavehi,2,2,0,0,24
414488,samānosmī,samanosmi,2,2,0,0,9
414489,hatthājānīyādayo,hatthajaniyadayo,2,2,0,0,16
414490,sakkāyadiṭṭhibalavatāya,sakkayaditthibalavataya,2,2,0,0,23
414491,bilāsayāti,bilasayati,3,0,3,0,10
414492,bilavāsino,bilavasino,2,2,0,0,10
414493,ahinakulagodhādayo,ahinakulagodhadayo,2,2,0,0,18
414494,udakāsayāti,udakasayati,1,0,1,0,11
414495,udakavāsino,udakavasino,2,2,0,0,11
414496,vanāsayāti,vanasayati,2,0,2,0,10
414497,vanavāsino,vanavasino,2,2,0,0,10
414498,hatthiassagokaṇṇamigādayo,hatthiassagokannamigadayo,2,2,0,0,25
414499,daḷhehīti,dalhehiti,2,0,2,0,9
414500,varattehīti,varattehiti,2,0,2,0,11
414501,cammarajjūhi,cammarajjuhi,2,2,0,0,12
414502,mahiddhikotiādīsu,mahiddhikotiadisu,2,0,2,0,17
414503,dakkhiṇapassādīhi,dakkhinapassadihi,4,4,0,0,17
414504,vīsatiusabhamattādilaṅghanavasena,visatiusabhamattadilanghanavasena,2,2,0,0,33
414505,sesamigānaṃ,sesamiganam,2,2,0,0,11
414506,mahesakkhatā,mahesakkhata,4,4,0,0,12
414507,palāyantānaṃ,palayantanam,3,3,0,0,12
414508,sallakattoti,sallakattoti,9,5,4,0,12
414509,vejjasadisaṃ,vejjasadisam,3,3,0,0,12
414510,brāhmaṇasadisaṃ,brahmanasadisam,3,3,0,0,15
414511,maggadesakapurisasadisaṃ,maggadesakapurisasadisam,3,3,0,0,24
414512,rājāhamasmi,rajahamasmi,25,22,3,0,11
414513,rājasadisaṃ,rajasadisam,3,3,0,0,11
414514,sīhasadisameva,sihasadisameva,2,2,0,0,14
414515,kañcanaguhādīsu,kancanaguhadisu,2,2,0,0,15
414516,vasanakālo,vasanakalo,5,5,0,0,10
414517,katābhinīhārassa,katabhiniharassa,17,16,1,0,16
414518,aparimitakālaṃ,aparimitakalam,5,5,0,0,14
414519,nikkhamanena,nikkhamanena,9,9,0,0,12
414520,dibbasampattisadisaṃ,dibbasampattisadisam,5,5,0,0,20
414521,nivāsakālo,nivasakalo,4,4,0,0,10
414522,kañcanaguhādito,kancanaguhadito,2,2,0,0,15
414523,nikkhantakālo,nikkhantakalo,2,2,0,0,13
414524,ekūnatiṃsasaṃvacchare,ekunatimsasamvacchare,1,1,0,0,21
414525,channasahāyassa,channasahayassa,2,2,0,0,15
414526,paṇḍavagiripabbhāre,pandavagiripabbhare,2,2,0,0,19
414527,paṭiññādānakālo,patinnadanakalo,4,4,0,0,15
414528,vijambhanakālo,vijambhanakalo,2,2,0,0,14
414529,dinnapaṭiññassa,dinnapatinnassa,2,2,0,0,15
414530,āḷārakālāmaupasaṅkamanaṃ,alarakalamaupasankamanam,2,2,0,0,24
414531,dinnapāyāsassa,dinnapayasassa,2,2,0,0,14
414532,ekūnapaṇṇāsāya,ekunapannasaya,2,2,0,0,14
414533,piṇḍehi,pindehi,6,6,0,0,7
414534,sarīravidhunanaṃ,sariravidhunanam,1,1,0,0,16
414535,sottiyena,sottiyena,4,3,1,0,9
414536,dasasahassacakkavāḷadevatāhi,dasasahassacakkavaladevatahi,10,10,0,0,28
414537,thomiyamānassa,thomiyamanassa,2,2,0,0,14
414538,pūjiyamānassa,pujiyamanassa,2,2,0,0,13
414539,cuddasahatthubbedhe,cuddasahatthubbedhe,3,3,0,0,19
414540,tiṇasantharaṃ,tinasantharam,32,32,0,0,13
414541,caturaṅgavīriyaṃ,caturangaviriyam,21,19,2,0,16
414542,paṭiccasamuppādamahāsamuddaṃ,paticcasamuppadamahasamuddam,2,2,0,0,28
414543,yamakañāṇamanthanena,yamakananamanthanena,2,2,0,0,20
414544,manthentassa,manthentassa,2,2,0,0,12
414545,tadanubhāvena,tadanubhavena,2,2,0,0,13
414546,dasasahassilokadhātukampanaṃ,dasasahassilokadhatukampanam,4,4,0,0,28
414547,catudisāvilokanaṃ,catudisavilokanam,1,1,0,0,17
414548,paribhuttamadhupiṇḍikāhārassa,paribhuttamadhupindikaharassa,2,2,0,0,29
414549,dhammadesanāyācanaṃ,dhammadesanayacanam,4,4,0,0,19
414550,pavattessāmī,pavattessami,6,6,0,0,12
414551,ajapālanigrodhato,ajapalanigrodhato,2,2,0,0,17
414552,aṭṭhārasayojanamaggaṃ,attharasayojanamaggam,13,13,0,0,21
414553,sīhanādakālo,sihanadakalo,2,2,0,0,12
414554,acalapallaṅke,acalapallanke,2,2,0,0,13
414555,sannipatitena,sannipatitena,4,4,0,0,13
414556,dhammacakkappavattanakālo,dhammacakkappavattanakalo,2,2,0,0,25
414557,tathāgatasīhassa,tathagatasihassa,3,3,0,0,16
414558,dhammaghoso,dhammaghoso,5,3,2,0,11
414559,paṭicchādesi,paticchadesi,17,15,2,0,12
414560,khuddakapāṇānaṃ,khuddakapananam,2,2,0,0,15
414561,santāsāpajjanakālo,santasapajjanakalo,1,1,0,0,18
414562,dīghāyukānaṃ,dighayukanam,3,3,0,0,12
414563,ñāṇasantāsassa,nanasantasassa,2,2,0,0,14
414564,āsayabhūtāya,asayabhutaya,1,1,0,0,12
414565,kanakaguhāya,kanakaguhaya,1,1,0,0,12
414566,upasaṅkamanakālo,upasankamanakalo,3,3,0,0,16
414567,disāvilokanaṃ,disavilokanam,5,5,0,0,13
414568,parisāvilokanaṃ,parisavilokanam,1,1,0,0,15
414569,sīhanādanadanaṃ,sihanadanadanam,8,5,3,0,15
414570,dhammadesanākālo,dhammadesanakalo,4,4,0,0,16
414571,paravādanimmaddanatthāya,paravadanimmaddanatthaya,1,1,0,0,24
414572,himavantanissitāya,himavantanissitaya,1,1,0,0,18
414573,kañcanaguhāya,kancanaguhaya,7,7,0,0,13
414574,nibbānanissitāya,nibbananissitaya,1,1,0,0,16
414575,veneyyasattavilokanaṃ,veneyyasattavilokanam,1,1,0,0,21
414576,asampattānaṃ,asampattanam,5,5,0,0,12
414577,santikūpasaṅkamanaṃ,santikupasankamanam,1,1,0,0,19
414578,yadāti,yadati,29,1,28,0,6
414579,bodhipallaṅkā,bodhipallanka,4,2,2,0,13
414580,arahattamaggañāṇā,arahattamagganana,4,2,2,0,17
414581,sakkāyoti,sakkayoti,10,2,8,0,9
414582,sakkāyasamudayoti,sakkayasamudayoti,3,0,3,0,17
414583,rūpanirodho,rupanirodho,28,28,0,0,11
414584,vaṇṇavantoti,vannavantoti,4,0,4,0,12
414585,paṇṇāsalakkhaṇappaṭimaṇḍitaṃ,pannasalakkhanappatimanditam,1,1,0,0,28
414586,khīṇāsavattā,khinasavatta,7,7,0,0,12
414587,cittutrāsabhayampi,cittutrasabhayampi,7,7,0,0,18
414588,pattatāya,pattataya,5,5,0,0,9
414589,ñāṇasaṃvegopi,nanasamvegopi,2,2,0,0,13
414590,manasikarontānaṃ,manasikarontanam,4,4,0,0,16
414591,ñāṇabhayampi,nanabhayampi,2,2,0,0,12
414592,dhammālapanamattametaṃ,dhammalapanamattametam,3,3,0,0,22
414593,sakkāyapariyāpannāti,sakkayapariyapannati,2,0,2,0,20
414594,pañcakkhandhapariyāpannā,pancakkhandhapariyapanna,2,2,0,0,24
414595,vaṭṭadosaṃ,vattadosam,2,2,0,0,10
414596,tilakkhaṇāhataṃ,tilakkhanahatam,15,13,2,0,15
414597,aṭṭhārasabrahmakoṭīhi,attharasabrahmakotihi,1,1,0,0,21
414598,aññākoṇḍaññattherassa,annakondannattherassa,1,1,0,0,21
414599,yasassinoti,yasassinoti,15,1,14,0,11
414600,ekasadisassa,ekasadisassa,2,2,0,0,12
414601,pasādasuttavaṇṇanā,pasadasuttavannana,1,1,0,0,18
414602,pasādāti,pasadati,8,5,3,0,8
414603,apadāti,apadati,3,0,3,0,7
414604,nippadā,nippada,2,2,0,0,7
414605,ahimacchādayo,ahimacchadayo,3,3,0,0,13
414606,dvipadāti,dvipadati,3,0,3,0,9
414607,manussapakkhiādayo,manussapakkhiadayo,1,1,0,0,18
414608,catuppadāti,catuppadati,2,0,2,0,11
414609,hatthiassādayo,hatthiassadayo,15,15,0,0,14
414610,bahuppadāti,bahuppadati,2,0,2,0,11
414611,satapadiādayo,satapadiadayo,3,3,0,0,13
414612,nevasaññināsaññinoti,nevasanninasanninoti,1,0,1,0,20
414613,virāgotiādīni,viragotiadini,3,0,3,0,13
414614,rāgamadādayo,ragamadadayo,2,2,0,0,12
414615,ālayā,alaya,24,13,11,0,5
414616,vaṭṭadukkhā,vattadukkha,8,8,0,0,11
414617,vassakārasuttavaṇṇanā,vassakarasuttavannana,9,9,0,0,21
414618,tatrupāyāyāti,tatrupayayati,11,0,11,0,13
414619,nappaṭikkhipatīti,nappatikkhipatiti,1,1,0,0,17
414620,nappaṭikkosati,nappatikkosati,3,3,0,0,14
414621,ñāyeti,nayeti,3,0,3,0,6
414622,sahavipassanake,sahavipassanake,5,3,2,0,15
414623,nekkhammavitakkādīsu,nekkhammavitakkadisu,1,1,0,0,20
414624,kāmavitakkādīsu,kamavitakkadisu,5,4,1,0,15
414625,vitakkapatheti,vitakkapatheti,1,0,1,0,14
414626,vitakkapatho,vitakkapatho,1,1,0,0,12
414627,brāhmaṇātiādīsu,brahmanatiadisu,4,0,4,0,15
414628,kiriyavitakkāni,kiriyavitakkani,1,1,0,0,15
414629,kiriyajjhānāni,kiriyajjhanani,1,1,0,0,14
414630,maccupāsā,maccupasa,11,11,0,0,9
414631,pamocanakaṃ,pamocanakam,1,1,0,0,11
414632,doṇasuttavaṇṇanā,donasuttavannana,3,3,0,0,16
414633,ukkaṭṭhāti,ukkatthati,7,2,5,0,10
414634,ukkāhi,ukkahi,10,9,1,0,6
414635,dhārīyamānāhi,dhariyamanahi,1,1,0,0,13
414636,evaṃladdhavohāraṃ,evamladdhavoharam,1,1,0,0,17
414637,kāraṇakhaṇacittavemajjhavivarādīsu,karanakhanacittavemajjhavivaradisu,3,3,0,0,34
414638,kimantaraṃ,kimantaram,14,13,1,0,10
414639,dhovantī,dhovanti,19,18,1,0,8
414640,yassantarato,yassantarato,22,17,5,0,12
414641,antarāvosānamāpādī,antaravosanamapadi,1,1,0,0,18
414642,setabyassa,setabyassa,1,1,0,0,10
414643,vivareti,vivareti,7,6,1,0,8
414644,nadiñca,nadinca,13,12,1,0,7
414645,antarāsaddaṃ,antarasaddam,9,9,0,0,12
414646,dutiyapadenapi,dutiyapadenapi,7,7,0,0,14
414647,ayojiyamāne,ayojiyamane,11,7,4,0,11
414648,addhānasaṅkhātaṃ,addhanasankhatam,11,10,1,0,16
414649,dīghamagganti,dighamagganti,4,4,0,0,13
414650,athassāhaṃ,athassaham,16,16,0,0,10
414651,dvādasapadasahassaparimāṇaṃ,dvadasapadasahassaparimanam,1,1,0,0,27
414652,mahākalahaṃ,mahakalaham,5,3,2,0,11
414653,paguṇe,pagune,10,10,0,0,6
414654,satagghanakaṃ,satagghanakam,1,1,0,0,13
414655,pañcasatagghanakaṃ,pancasatagghanakam,7,7,0,0,18
414656,ekaṃsavaragataṃ,ekamsavaragatam,3,2,1,0,15
414657,āmuttayaññasutto,amuttayannasutto,1,1,0,0,16
414658,rattavaṭṭikā,rattavattika,1,1,0,0,12
414659,pañcasatamāṇavakaparivāro,pancasatamanavakaparivaro,1,1,0,0,25
414660,pādesūti,padesuti,1,0,1,0,8
414661,akkantaṭṭhānesu,akkantatthanesu,1,1,0,0,15
414662,lakkhaṇacakkāni,lakkhanacakkani,2,2,0,0,15
414663,akkantaṭṭhāne,akkantatthane,10,10,0,0,13
414664,mahābalattā,mahabalatta,2,2,0,0,11
414665,mahājanānuggahena,mahajananuggahena,1,1,0,0,17
414666,sukhumacchavitāya,sukhumacchavitaya,1,1,0,0,17
414667,akkantaṭṭhānaṃ,akkantatthanam,4,4,0,0,14
414668,padavaḷañjo,padavalanjo,3,3,0,0,11
414669,vātajavasindhavassa,vatajavasindhavassa,1,1,0,0,19
414670,paduminipattepi,paduminipattepi,1,1,0,0,15
414671,akkantamattameva,akkantamattameva,2,2,0,0,16
414672,padavaḷañjaṃ,padavalanjam,9,9,0,0,12
414673,avisahantassa,avisahantassa,1,1,0,0,13
414674,gamanavicchedo,gamanavicchedo,1,1,0,0,14
414675,antaradhāyateva,antaradhayateva,1,1,0,0,15
414676,uttamadamatho,uttamadamatho,1,1,0,0,13
414677,uttamasamatho,uttamasamatho,1,1,0,0,13
414678,arahattamaggasamādhi,arahattamaggasamadhi,1,1,0,0,20
414679,rakkhitindriyaṃ,rakkhitindriyam,2,2,0,0,15
414680,agacchanato,agacchanato,1,1,0,0,11
414681,anāgacchanato,anagacchanato,1,1,0,0,13
414682,balavantaṭṭhenāti,balavantatthenati,4,1,3,0,17
414683,pucchāsabhāgeneva,pucchasabhageneva,2,2,0,0,17
414684,sabbaññutaññāṇādhigameneva,sabbannutannanadhigameneva,1,1,0,0,26
414685,taṇhādiṭṭhilepānaṃ,tanhaditthilepanam,3,3,0,0,18
414686,saṅkhāralokena,sankharalokena,1,1,0,0,14
414687,āsavena,asavena,6,6,0,0,7
414688,devūpapatyassāti,devupapatyassati,3,0,3,0,16
414689,vihaṅgamoti,vihangamoti,1,0,1,0,11
414690,ākāsacaro,akasacaro,2,2,0,0,9
414691,gandhabbakāyikadevo,gandhabbakayikadevo,2,2,0,0,19
414692,viddhastāti,viddhastati,2,0,2,0,11
414693,vidhamitā,vidhamita,5,4,1,0,9
414694,vinaḷīkatāti,vinalikatati,4,0,4,0,12
414695,vigatanaḷā,vigatanala,4,4,0,0,10
414696,vigatabandhanā,vigatabandhana,1,1,0,0,14
414697,vaggūti,vagguti,19,1,18,0,7
414698,nupalippatīti,nupalippatiti,1,0,1,0,13
414699,sobhayamānaṃ,sobhayamanam,4,3,1,0,12
414700,bhamaragaṇaṃ,bhamaraganam,1,1,0,0,12
414701,bhājesīti,bhajesiti,2,2,0,0,9
414702,aparihāniyasuttavaṇṇanā,aparihaniyasuttavannana,3,3,0,0,23
414703,nibbānasantikeyeva,nibbanasantikeyeva,2,1,1,0,18
414704,vihārīti,vihariti,4,1,3,0,8
414705,yogakkhemassāti,yogakkhemassati,6,0,6,0,15
414706,bhayadassivāti,bhayadassivati,1,0,1,0,14
414707,patilīnasuttavaṇṇanā,patilinasuttavannana,3,3,0,0,20
414708,panuṇṇapaccekasaccoti,panunnapaccekasaccoti,2,0,2,0,21
414709,paccekasaṅkhātāni,paccekasankhatani,3,3,0,0,17
414710,diṭṭhisaccāni,ditthisaccani,4,4,0,0,13
414711,nīhaṭāni,nihatani,7,7,0,0,8
414712,samavayasaṭṭhesanoti,samavayasatthesanoti,5,0,5,0,20
414713,avayāti,avayati,7,1,6,0,7
414714,saṭṭhāti,satthati,5,1,4,0,8
414715,vissaṭṭhasabbaesanoti,vissatthasabbaesanoti,4,4,0,0,21
414716,pabbajjūpagatā,pabbajjupagata,11,11,0,0,14
414717,bhovādino,bhovadino,11,10,1,0,9
414718,puthupaccekasaccānīti,puthupaccekasaccaniti,4,0,4,0,21
414719,pāṭekkasaccāni,patekkasaccani,4,4,0,0,14
414720,nuṇṇānīti,nunnaniti,3,0,3,0,9
414721,panuṇṇānīti,panunnaniti,3,0,3,0,11
414722,cattānīti,cattaniti,4,0,4,0,9
414723,vissaṭṭhāni,vissatthani,9,9,0,0,11
414724,vantānīti,vantaniti,5,0,5,0,9
414725,vamitāni,vamitani,4,4,0,0,8
414726,muttānīti,muttaniti,4,0,4,0,9
414727,chinnabandhanāni,chinnabandhanani,6,5,1,0,16
414728,pahīnānīti,pahinaniti,5,1,4,0,10
414729,pajahitāni,pajahitani,4,4,0,0,10
414730,paṭinissaṭṭhānīti,patinissatthaniti,4,0,4,0,17
414731,paṭinissajjitāni,patinissajjitani,3,3,0,0,16
414732,gahitagahaṇassa,gahitagahanassa,1,1,0,0,15
414733,vissaṭṭhabhāvavevacanāni,vissatthabhavavevacanani,5,5,0,0,24
414734,esissāmi,esissami,2,2,0,0,8
414735,pavattajjhāsayasaṅkhātā,pavattajjhasayasankhata,1,1,0,0,23
414736,diṭṭhibrahmacariyesanā,ditthibrahmacariyesana,2,1,1,0,22
414737,paṭippasambhatīti,patippasambhatiti,1,1,0,0,17
414738,vūpasantaassāsapassāso,vupasantaassasapassaso,1,1,0,0,22
414739,asmimānoti,asmimanoti,13,1,12,0,10
414740,navavidhamāno,navavidhamano,7,7,0,0,13
414741,bhavesanāti,bhavesanati,5,3,2,0,11
414742,paṭinissaṭṭhāti,patinissatthati,8,2,6,0,15
414743,samussayāti,samussayati,2,1,1,0,11
414744,gahaṇaparāmāso,gahanaparamaso,1,1,0,0,14
414745,diṭṭhisaṅkhātāyeva,ditthisankhatayeva,1,1,0,0,18
414746,samussitattā,samussitatta,1,1,0,0,12
414747,samūhatāti,samuhatati,16,3,13,0,10
414748,sabbarāgehipi,sabbaragehipi,1,1,0,0,13
414749,passaddhoti,passaddhoti,3,0,3,0,11
414750,kāyacittapassaddhīhi,kayacittapassaddhihi,1,1,0,0,20
414751,aparājitoti,aparajitoti,4,0,4,0,11
414752,mānābhisamayāti,manabhisamayati,12,0,12,0,15
414753,ujjayasuttavaṇṇanā,ujjayasuttavannana,3,3,0,0,18
414754,pitāmahehi,pitamahehi,2,2,0,0,10
414755,kulānukulavasena,kulanukulavasena,2,1,1,0,16
414756,yajitabbaṃ,yajitabbam,9,8,1,0,10
414757,assamettha,assamettha,5,5,0,0,10
414758,medhantīti,medhantiti,7,6,1,0,10
414759,pariyaññehi,pariyannehi,15,15,0,0,11
414760,ekavīsatiyūpassa,ekavisatiyupassa,5,5,0,0,16
414761,bhūmiñca,bhuminca,13,12,1,0,8
414762,avasesasabbavibhavadakkhiṇassa,avasesasabbavibhavadakkhinassa,5,5,0,0,30
414763,yaññassetaṃ,yannassetam,15,15,0,0,11
414764,purisamettha,purisamettha,5,5,0,0,12
414765,assamedhe,assamedhe,10,10,0,0,9
414766,vuttavibhavadakkhiṇassa,vuttavibhavadakkhinassa,10,10,0,0,23
414767,sammamettha,sammamettha,5,5,0,0,11
414768,pāsantīti,pasantiti,5,3,2,0,9
414769,patitokāse,patitokase,6,6,0,0,10
414770,vediṃ,vedim,7,7,0,0,5
414771,saṃhārimehi,samharimehi,6,6,0,0,11
414772,yūpādīhi,yupadihi,5,5,0,0,8
414773,sarassatinadiyā,sarassatinadiya,4,4,0,0,15
414774,nimuggokāsato,nimuggokasato,8,5,3,0,13
414775,sabbayāgassetaṃ,sabbayagassetam,1,1,0,0,15
414776,vājamettha,vajamettha,5,5,0,0,10
414777,pariyaññena,pariyannena,5,5,0,0,11
414778,pasūhi,pasuhi,9,9,0,0,6
414779,beluvayūpassa,beluvayupassa,4,4,0,0,13
414780,sattarasakadakkhiṇassa,sattarasakadakkhinassa,8,5,3,0,22
414781,sabbamedhapariyāyanāmassa,sabbamedhapariyayanamassa,5,5,0,0,25
414782,assamedhavikappassetaṃ,assamedhavikappassetam,4,4,0,0,22
414783,mahārambhāti,maharambhati,6,2,4,0,12
414784,mahākiccā,mahakicca,4,4,0,0,9
414785,mahākaraṇīyā,mahakaraniya,3,3,0,0,12
414786,pāṇātipātasamārambhassa,panatipatasamarambhassa,1,1,0,0,23
414787,mahantatāyapi,mahantatayapi,1,1,0,0,13
414788,mahārambhāyeva,maharambhayeva,1,1,0,0,14
414789,mahapphalāti,mahapphalati,2,0,2,0,12
414790,niravasesatthe,niravasesatthe,3,2,1,0,14
414791,sāvasesarūpanaṃ,savasesarupanam,1,1,0,0,15
414792,pāṇātipātasamārambhameva,panatipatasamarambhameva,1,1,0,0,24
414793,samārambhena,samarambhena,1,1,0,0,12
414794,mandaphalaṃ,mandaphalam,1,1,0,0,11
414795,haññareti,hannareti,2,0,2,0,9
414796,yiṭṭhattā,yitthatta,1,1,0,0,9
414797,pacchimapurisāpi,pacchimapurisapi,1,1,0,0,16
414798,yajantīti,yajantiti,2,1,1,0,9
414799,udāyisuttavaṇṇanā,udayisuttavannana,5,5,0,0,17
414800,pāṇasamārambharahitaṃ,panasamarambharahitam,2,1,1,0,21
414801,yajitabbattā,yajitabbatta,1,1,0,0,12
414802,yaññanti,yannanti,5,5,0,0,8
414803,yuttappattakālena,yuttappattakalena,6,6,0,0,17
414804,upasaṃyantīti,upasamyantiti,1,0,1,0,13
414805,vaṭṭakulañceva,vattakulanceva,1,1,0,0,14
414806,vaṭṭagatiñca,vattagatinca,1,1,0,0,12
414807,kovidāti,kovidati,7,0,7,0,8
414808,catubhūmakayaññe,catubhumakayanne,1,1,0,0,16
414809,yaññeti,yanneti,4,0,4,0,7
414810,pakatidāne,pakatidane,1,1,0,0,10
414811,saddheti,saddheti,4,0,4,0,8
414812,matakadāne,matakadane,1,1,0,0,10
414813,hunitabbaṃ,hunitabbam,3,3,0,0,10
414814,upakappetvā,upakappetva,1,1,0,0,11
414815,brahmacārisaṅkhāte,brahmacarisankhate,1,1,0,0,18
414816,sukhettamhīti,sukhettamhiti,1,1,0,0,13
414817,upakappitaṃ,upakappitam,1,1,0,0,11
414818,suppattanti,suppattanti,1,1,0,0,11
414819,buddhadhammasaṅghaguṇānaṃ,buddhadhammasanghagunanam,2,2,0,0,25
414820,saddahanatāya,saddahanataya,1,1,0,0,13
414821,muttacāgaṃ,muttacagam,1,1,0,0,10
414822,samādhibhāvanāsuttavaṇṇanā,samadhibhavanasuttavannana,3,3,0,0,26
414823,ñāṇadassanappaṭilābhāyāti,nanadassanappatilabhayati,3,0,3,0,25
414824,dibbacakkhuñāṇadassanassa,dibbacakkhunanadassanassa,1,1,0,0,25
414825,ālokasaññā,alokasanna,35,29,6,0,10
414826,dibbacakkhuñāṇobhāsena,dibbacakkhunanobhasena,1,1,0,0,22
414827,sahobhāsaṃ,sahobhasam,3,2,1,0,10
414828,ālokasadisaṃ,alokasadisam,2,1,1,0,12
414829,dibbacakkhuñāṇāloko,dibbacakkhunanaloko,1,1,0,0,19
414830,pariggahitavatthārammaṇatāya,pariggahitavattharammanataya,1,1,0,0,28
414831,saññāvitakkesu,sannavitakkesu,1,0,1,0,14
414832,uttamādhamāni,uttamadhamani,2,2,0,0,13
414833,ekakkhandhepi,ekakkhandhepi,1,1,0,0,13
414834,ekāyatanepi,ekayatanepi,1,1,0,0,11
414835,ekadhātuyāpi,ekadhatuyapi,1,1,0,0,12
414836,kodhadhūmena,kodhadhumena,1,1,0,0,12
414837,vigatadhūmo,vigatadhumo,1,1,0,0,11
414838,maggekaggatampi,maggekaggatampi,1,1,0,0,15
414839,phalasamāpattiyeva,phalasamapattiyeva,1,1,0,0,18
414840,pañhabyākaraṇasuttavaṇṇanā,panhabyakaranasuttavannana,1,1,0,0,26
414841,duppasahoti,duppasahoti,4,1,3,0,11
414842,sattasīdantaramahāsamuddo,sattasidantaramahasamuddo,1,1,0,0,25
414843,duppadhaṃsiyoti,duppadhamsiyoti,1,0,1,0,15
414844,dummocāpayo,dummocapayo,1,1,0,0,11
414845,vaḍḍhiyañca,vaddhiyanca,1,1,0,0,11
414846,avaḍḍhiyañca,avaddhiyanca,1,1,0,0,12
414847,atthābhisamayāti,atthabhisamayati,15,1,14,0,16
414848,atthasamāgamena,atthasamagamena,1,1,0,0,15
414849,kodhagarusuttadvayavaṇṇanā,kodhagarusuttadvayavannana,1,1,0,0,26
414850,para43-44,para43-44,3,3,0,0,9
414851,para43-44_an4,para43-44_an4,1,1,0,0,13
414852,agāravena,agaravena,12,11,1,0,9
414853,virūhantīti,viruhantiti,1,0,1,0,11
414854,sañjātamūlāya,sanjatamulaya,1,1,0,0,13
414855,kodhagarutāti,kodhagarutati,1,0,1,0,13
414856,kodhamhi,kodhamhi,1,1,0,0,8
414857,rohitassasuttavaṇṇanā,rohitassasuttavannana,4,4,0,0,21
414858,cakkavāḷalokassa,cakkavalalokassa,10,10,0,0,16
414859,padagamanena,padagamanena,2,2,0,0,12
414860,pattabbanti,pattabbanti,13,12,1,0,11
414861,sampahaṃsanto,sampahamsanto,4,4,0,0,13
414862,daḷhadhanu,dalhadhanu,9,7,2,0,10
414863,uttamappamāṇena,uttamappamanena,2,2,0,0,15
414864,dhanuācariyo,dhanuacariyo,4,2,2,0,12
414865,katahatthoti,katahatthoti,8,0,8,0,12
414866,usabhappamāṇepi,usabhappamanepi,2,2,0,0,15
414867,vālaggaṃ,valaggam,11,7,4,0,8
414868,katūpāsanoti,katupasanoti,6,0,6,0,12
414869,katasarakkhepo,katasarakkhepo,2,2,0,0,14
414870,dassitasippo,dassitasippo,8,4,4,0,12
414871,asanenāti,asanenati,4,0,4,0,9
414872,atikkamāmīti,atikkamamiti,3,3,0,0,12
414873,javasampattiṃ,javasampattim,2,2,0,0,13
414874,pacchimasamuddo,pacchimasamuddo,2,2,0,0,15
414875,pācīnacakkavāḷamukhavaṭṭiyaṃ,pacinacakkavalamukhavattiyam,8,8,0,0,28
414876,pacchimacakkavāḷamukhavaṭṭiṃ,pacchimacakkavalamukhavattim,4,4,0,0,28
414877,dutiyapādaṃ,dutiyapadam,1,1,0,0,11
414878,paracakkavāḷamukhavaṭṭiṃ,paracakkavalamukhavattim,1,1,0,0,24
414879,vassasatāyukoti,vassasatayukoti,2,0,2,0,15
414880,dīghāyukakālo,dighayukakalo,2,2,0,0,13
414881,vassasatāvasiṭṭhe,vassasatavasitthe,2,2,0,0,17
414882,appatvāti,appatvati,7,1,6,0,9
414883,pariyantakaraṇaṃ,pariyantakaranam,2,2,0,0,16
414884,kaḷevareti,kalevareti,4,0,4,0,10
414885,samanaketi,samanaketi,6,0,6,0,10
414886,sasaññe,sasanne,2,2,0,0,7
414887,sacittake,sacittake,3,2,1,0,9
414888,tiṇakaṭṭhādīsu,tinakatthadisu,4,4,0,0,14
414889,catumahābhūtike,catumahabhutike,1,1,0,0,15
414890,kāyasmiṃyeva,kayasmimyeva,1,1,0,0,12
414891,samitāvīti,samitaviti,7,1,6,0,10
414892,samitapāpo,samitapapo,11,10,1,0,10
414893,nāsīsatīti,nasisatiti,6,0,6,0,10
414894,suvidūrasuttavaṇṇanā,suvidurasuttavannana,3,3,0,0,20
414895,anāsannāni,anasannani,2,1,1,0,10
414896,suvidūrāneva,suviduraneva,1,1,0,0,12
414897,vidūrāni,vidurani,1,1,0,0,8
414898,dvaṅgulamattepi,dvangulamattepi,1,1,0,0,15
414899,verocanoti,verocanoti,1,0,1,0,10
414900,catusatipaṭṭhānādibhedo,catusatipatthanadibhedo,1,1,0,0,23
414901,sattatiṃsabodhipakkhiyadhammo,sattatimsabodhipakkhiyadhammo,1,1,0,0,29
414902,dvāsaṭṭhidiṭṭhigatabhedo,dvasatthiditthigatabhedo,1,1,0,0,24
414903,assaddhammo,assaddhammo,1,1,0,0,11
414904,pabhaṅkaroti,pabhankaroti,6,0,6,0,12
414905,avigacchanasabhāvo,avigacchanasabhavo,1,1,0,0,18
414906,visākhasuttavaṇṇanā,visakhasuttavannana,6,6,0,0,19
414907,pañcālaputtoti,pancalaputtoti,2,0,2,0,14
414908,pañcālabrāhmaṇiyā,pancalabrahmaniya,1,1,0,0,17
414909,paripuṇṇavācāya,paripunnavacaya,1,1,0,0,15
414910,vissaṭṭhāyāti,vissatthayati,8,0,8,0,13
414911,apalibuddhāya,apalibuddhaya,9,7,2,0,13
414912,anelagalāyāti,anelagalayati,12,1,11,0,13
414913,niddosāya,niddosaya,13,12,1,0,9
414914,agaḷitāya,agalitaya,2,1,1,0,9
414915,apatitapadabyañjanāya,apatitapadabyanjanaya,2,2,0,0,21
414916,pariyāpannāyāti,pariyapannayati,2,0,2,0,15
414917,vivaṭṭapariyāpannāya,vivattapariyapannaya,1,1,0,0,20
414918,vivaṭṭanissitameva,vivattanissitameva,1,1,0,0,18
414919,vaṭṭanissitaṃ,vattanissitam,8,8,0,0,13
414920,nibbānapadaṃ,nibbanapadam,24,23,1,0,12
414921,bhāsayeti,bhasayeti,2,0,2,0,9
414922,obhāseyya,obhaseyya,3,2,1,0,9
414923,jotayeti,jotayeti,1,0,1,0,8
414924,navalokuttaradhammo,navalokuttaradhammo,10,10,0,0,19
414925,paggaṇheyya,pagganheyya,26,22,4,0,11
414926,ukkhipeyya,ukkhipeyya,8,8,0,0,10
414927,navalokuttaradhammadīpakaṃ,navalokuttaradhammadipakam,1,1,0,0,26
414928,vipallāsasuttavaṇṇanā,vipallasasuttavannana,3,3,0,0,21
414929,saññāvipallāsāti,sannavipallasati,2,0,2,0,16
414930,vipallatthabhāvā,vipallatthabhava,2,2,0,0,16
414931,viparītasaññāyoti,viparitasannayoti,1,1,0,0,17
414932,saññāvipallāsoti,sannavipallasoti,3,1,2,0,16
414933,evaṃsaññinoti,evamsanninoti,3,2,1,0,13
414934,micchādiṭṭhihatāti,micchaditthihatati,3,0,3,0,18
414935,saññinova,sanninova,2,2,0,0,9
414936,micchādiṭṭhiyāpi,micchaditthiyapi,2,2,0,0,16
414937,khittacittāti,khittacittati,4,0,4,0,13
414938,saññādiṭṭhiyo,sannaditthiyo,1,1,0,0,13
414939,khittena,khittena,2,2,0,0,8
414940,visaññinoti,visanninoti,3,0,3,0,11
414941,desanāmattametaṃ,desanamattametam,16,15,1,0,16
414942,viparītasaññācittadiṭṭhinoti,viparitasannacittaditthinoti,2,2,0,0,28
414943,ayogakkheminoti,ayogakkheminoti,2,0,2,0,15
414944,catusaccabuddhā,catusaccabuddha,4,4,0,0,15
414945,paccaladdhāti,paccaladdhati,1,0,1,0,13
414946,aniccabhāvena,aniccabhavena,5,5,0,0,13
414947,asubhatoyeva,asubhatoyeva,1,1,0,0,12
414948,sammādiṭṭhisamādānāti,sammaditthisamadanati,2,0,2,0,21
414949,gahitasammādassanā,gahitasammadassana,2,2,0,0,18
414950,upakkilesasuttavaṇṇanā,upakkilesasuttavannana,7,7,0,0,22
414951,upakkiliṭṭhabhāvakaraṇena,upakkilitthabhavakaranena,2,2,0,0,25
414952,mahikāti,mahikati,4,0,4,0,8
414953,asampattaupakkilesā,asampattaupakkilesa,2,2,0,0,19
414954,sampattaupakkilesavasena,sampattaupakkilesavasena,2,2,0,0,24
414955,guṇappatāpena,gunappatapena,1,1,0,0,13
414956,guṇobhāsena,gunobhasena,2,2,0,0,11
414957,guṇavirocanena,gunavirocanena,2,2,0,0,14
414958,appaṭiviratāti,appativiratati,3,0,3,0,14
414959,merayassa,merayassa,6,6,0,0,9
414960,pānato,panato,6,6,0,0,6
414961,aviratā,avirata,2,2,0,0,7
414962,avijjānivutāti,avijjanivutati,2,0,2,0,14
414963,piyarūpābhinandinoti,piyarupabhinandinoti,2,0,2,0,20
414964,tussamānā,tussamana,4,4,0,0,9
414965,sādiyantīti,sadiyantiti,8,5,3,0,11
414966,aviddasūti,aviddasuti,7,0,7,0,10
414967,sanettikāti,sanettikati,1,0,1,0,11
414968,taṇhāyotteneva,tanhayotteneva,1,1,0,0,14
414969,sayottā,sayotta,1,1,0,0,7
414970,paṭhamapuññābhisandasuttavaṇṇanā,pathamapunnabhisandasuttavannana,5,5,0,0,32
414971,puññābhisandāti,punnabhisandati,3,0,3,0,15
414972,abhisandā,abhisanda,3,3,0,0,9
414973,puññappattiyoti,punnappattiyoti,1,1,0,0,15
414974,kusalābhisandāti,kusalabhisandati,4,1,3,0,16
414975,aggānaṃ,agganam,5,5,0,0,7
414976,paribhuñjamānoti,paribhunjamanoti,3,1,2,0,16
414977,sūcisuttādīnaṃ,sucisuttadinam,1,1,0,0,14
414978,nikkhipantopi,nikkhipantopi,1,1,0,0,13
414979,paccattharitumpi,paccattharitumpi,1,1,0,0,16
414980,bhūmattharaṇassa,bhumattharanassa,5,5,0,0,16
414981,pādapuñchanampi,padapunchanampi,1,1,0,0,15
414982,arahattaphalasamādhiṃ,arahattaphalasamadhim,9,8,1,0,21
414983,puññacetanāya,punnacetanaya,1,1,0,0,13
414984,appamāṇataṃ,appamanatam,4,4,0,0,11
414985,puññacetanā,punnacetana,4,4,0,0,11
414986,rattiṭṭhānadivāṭṭhānādīsu,rattitthanadivatthanadisu,4,4,0,0,25
414987,bheravārammaṇehi,bheravarammanehi,2,2,0,0,16
414988,ratanavarānaṃ,ratanavaranam,1,0,1,0,13
414989,vararatanānaṃ,vararatananam,1,1,0,0,13
414990,dutiyapuññābhisandasuttavaṇṇanā,dutiyapunnabhisandasuttavannana,3,3,0,0,31
414991,ariyakantehīti,ariyakantehiti,7,0,7,0,14
414992,maggaphalasampayuttehi,maggaphalasampayuttehi,1,1,0,0,22
414993,ujubhūtadassanaṃ,ujubhutadassanam,1,1,0,0,16
414994,catusaccadhammadassanaṃ,catusaccadhammadassanam,5,5,0,0,23
414995,paṭhamasaṃvāsasuttavaṇṇanā,pathamasamvasasuttavannana,1,1,0,0,26
414996,āvāhavivāhakaraṇatthāya,avahavivahakaranatthaya,1,1,0,0,23
414997,saṃvāsāti,samvasati,1,0,1,0,9
414998,sahavāsā,sahavasa,2,1,1,0,8
414999,ekatovāsā,ekatovasa,1,1,0,0,9
415000,chavāyāti,chavayati,2,0,2,0,9
415001,guṇamaraṇena,gunamaranena,3,3,0,0,12
415002,matattā,matatta,7,7,0,0,7
415003,guṇamaraṇeneva,gunamaraneneva,1,1,0,0,14
415004,devibhūtāya,devibhutaya,1,1,0,0,11
415005,akkosakaparibhāsakoti,akkosakaparibhasakoti,2,0,2,0,21
415006,santajjanena,santajjanena,2,2,0,0,12
415007,kadariyāti,kadariyati,9,0,9,0,10
415008,thaddhamaccharino,thaddhamaccharino,7,6,1,0,17
415009,jānipatayoti,janipatayoti,1,0,1,0,12
415010,vadaññūti,vadannuti,12,1,11,0,9
415011,saññatāti,sannatati,3,0,3,0,9
415012,sīlasaṃyamena,silasamyamena,14,14,0,0,13
415013,dhammajīvinoti,dhammajivinoti,3,0,3,0,14
415014,vaḍḍhisaṅkhātā,vaddhisankhata,2,2,0,0,14
415015,upajāyatīti,upajayatiti,1,0,1,0,11
415016,kāmakāminoti,kamakaminoti,5,0,5,0,12
415017,dutiyasaṃvāsasuttavaṇṇanā,dutiyasamvasasuttavannana,1,1,0,0,25
415018,samajīvīsuttadvayavaṇṇanā,samajivisuttadvayavannana,1,1,0,0,25
415019,para55-56,para55-56,3,3,0,0,9
415020,para55-56_an4,para55-56_an4,2,2,0,0,13
415021,anuggaṇhanatthaṃ,anugganhanattham,12,11,1,0,16
415022,saṅgaṇhanatthāya,sanganhanatthaya,5,5,0,0,16
415023,hantāta,hantata,1,1,0,0,7
415024,hantātā,hantata,1,1,0,0,7
415025,paññattāneva,pannattaneva,5,5,0,0,12
415026,aticaritāti,aticaritati,2,0,2,0,11
415027,atikkamitā,atikkamita,1,1,0,0,10
415028,samasaddhāti,samasaddhati,1,0,1,0,12
415029,suppavāsāsuttavaṇṇanā,suppavasasuttavannana,2,2,0,0,21
415030,kolarājakulānaṃ,kolarajakulanam,1,1,0,0,15
415031,āyudānaṃ,ayudanam,3,3,0,0,8
415032,āyubhāgapaṭilābhinī,ayubhagapatilabhini,2,1,1,0,19
415033,bhajanikā,bhajanika,1,1,0,0,9
415034,āyuppaṭilābhinīti,ayuppatilabhiniti,1,1,0,0,17
415035,ujjugatesūti,ujjugatesuti,2,0,2,0,12
415036,kāyavaṅkādirahitattā,kayavankadirahitatta,3,3,0,0,20
415037,caraṇūpapannesūti,caranupapannesuti,1,0,1,0,17
415038,caraṇadhammehi,caranadhammehi,3,3,0,0,14
415039,samannāgatesu,samannagatesu,3,3,0,0,13
415040,mahaggatesūti,mahaggatesuti,1,0,1,0,13
415041,khīṇāsavānaññevetaṃ,khinasavanannevetam,1,1,0,0,19
415042,saṃsandamānāti,samsandamanati,1,0,1,0,14
415043,ghaṭayamānā,ghatayamana,1,1,0,0,11
415044,dānasaṅkhātā,danasankhata,4,4,0,0,12
415045,tividhalokaṃ,tividhalokam,2,1,1,0,12
415046,lokavidūnaṃ,lokavidunam,2,1,1,0,11
415047,pasatthāti,pasatthati,7,3,4,0,10
415048,yaññamanussarantāti,yannamanussarantati,2,0,2,0,19
415049,vedajātāti,vedajatati,3,0,3,0,10
415050,tuṭṭhijātā,tutthijata,2,2,0,0,10
415051,sudattasuttavaṇṇanā,sudattasuttavannana,4,4,0,0,19
415052,saṃyatānaṃ,samyatanam,2,2,0,0,10
415053,yāpentānaṃ,yapentanam,1,1,0,0,10
415054,anuppaveseti,anuppaveseti,1,1,0,0,12
415055,gihisāmīcisuttavaṇṇanā,gihisamicisuttavannana,1,1,0,0,22
415056,patiupaṭṭhito,patiupatthito,1,1,0,0,13
415057,upaṭṭhāyako,upatthayako,2,2,0,0,11
415058,pariccāgavasena,pariccagavasena,7,7,0,0,15
415059,saggaṭṭhānaṃ,saggatthanam,3,3,0,0,12
415060,āgāriyapaṭipadā,agariyapatipada,1,1,0,0,15
415061,pattakammasuttavaṇṇanā,pattakammasuttavannana,1,1,0,0,22
415062,aniṭṭhapaṭikkhepena,anitthapatikkhepena,2,1,1,0,19
415063,pavaḍḍhentīti,pavaddhentiti,1,1,0,0,13
415064,bhogāti,bhogati,15,1,14,0,7
415065,bhuñjitabbā,bhunjitabba,10,8,2,0,11
415066,dhammūpaghātaṃ,dhammupaghatam,2,1,1,0,14
415067,senāpatiseṭṭhiṭṭhānādikāraṇena,senapatisetthitthanadikaranena,1,1,0,0,30
415068,yasoti,yasoti,23,2,21,0,6
415069,parivārasampatti,parivarasampatti,5,5,0,0,16
415070,ñātībhīti,natibhiti,1,0,1,0,9
415071,upanijjhāyitabbattā,upanijjhayitabbatta,2,1,1,0,19
415072,upajjhāyasaṅkhātehi,upajjhayasankhatehi,1,1,0,0,19
415073,sandiṭṭhasambhattehi,sanditthasambhattehi,2,2,0,0,20
415074,aparādhetīti,aparadhetiti,1,0,1,0,12
415075,abhijjhāsaṅkhātaṃ,abhijjhasankhatam,2,2,0,0,17
415076,mahantapañño,mahantapanno,1,1,0,0,12
415077,āpātadasoti,apatadasoti,1,0,1,0,11
415078,āpāteti,apateti,1,1,0,0,7
415079,sukhumampissa,sukhumampissa,1,1,0,0,13
415080,uṭṭhānavīriyādhigatehīti,utthanaviriyadhigatehiti,3,0,3,0,24
415081,uṭṭhānasaṅkhātena,utthanasankhatena,3,3,0,0,17
415082,adhigatehi,adhigatehi,3,3,0,0,10
415083,bāhābalaparicitehīti,bahabalaparicitehiti,2,0,2,0,20
415084,bāhābalena,bahabalena,1,1,0,0,10
415085,paricitehi,paricitehi,2,2,0,0,10
415086,vaḍḍhitehi,vaddhitehi,1,1,0,0,10
415087,sedāvakkhittehīti,sedavakkhittehiti,2,0,2,0,17
415088,avakkhittasedehi,avakkhittasedehi,1,1,0,0,16
415089,samadhigatehīti,samadhigatehiti,1,1,0,0,15
415090,dhammikehīti,dhammikehiti,3,0,3,0,12
415091,dhammayuttehi,dhammayuttehi,2,2,0,0,13
415092,dasakusalakammapathadhamme,dasakusalakammapathadhamme,5,4,1,0,26
415093,pattakammānīti,pattakammaniti,1,0,1,0,14
415094,yuttakammāni,yuttakammani,1,1,0,0,12
415095,anucchavikakammāni,anucchavikakammani,1,1,0,0,18
415096,sukhetīti,sukhetiti,2,0,2,0,9
415097,balasampannaṃ,balasampannam,4,3,1,0,13
415098,kāraṇagataṃ,karanagatam,1,1,0,0,11
415099,pattakammesu,pattakammesu,1,1,0,0,12
415100,bhogajātameva,bhogajatameva,1,1,0,0,13
415101,yuttappattaṭṭhānagataṃ,yuttappattatthanagatam,1,1,0,0,22
415102,uppannāsu,uppannasu,7,7,0,0,9
415103,ādittagehanibbāpanādīnaṃ,adittagehanibbapanadinam,1,1,0,0,24
415104,āpadānaṃ,apadanam,6,6,0,0,8
415105,paralokagatānaṃ,paralokagatanam,3,3,0,0,15
415106,kattabbabaliṃ,kattabbabalim,1,1,0,0,13
415107,yathānucchavikavasena,yathanucchavikavasena,1,1,0,0,21
415108,dātabbadānassa,databbadanassa,4,4,0,0,14
415109,niviṭṭhāti,nivitthati,24,2,22,0,10
415110,adhivāsanakkhantiyañca,adhivasanakkhantiyanca,3,2,1,0,22
415111,susīlatāya,susilataya,2,1,1,0,10
415112,damentīti,damentiti,2,0,2,0,9
415113,indriyadamena,indriyadamena,23,22,1,0,13
415114,samentīti,samentiti,15,6,9,0,9
415115,kilesavūpasamanena,kilesavupasamanena,1,1,0,0,18
415116,parinibbāpentīti,parinibbapentiti,2,1,1,0,16
415117,kilesaparinibbāneneva,kilesaparinibbaneneva,1,1,0,0,21
415118,uparūparibhūmīsu,uparuparibhumisu,3,3,0,0,16
415119,phaladānavasena,phaladanavasena,3,3,0,0,15
415120,uddhamaggamassāti,uddhamaggamassati,2,2,0,0,17
415121,uddhaggikā,uddhaggika,6,1,5,0,10
415122,tatrupapattijananato,tatrupapattijananato,1,1,0,0,20
415123,sukhova,sukhova,1,1,0,0,7
415124,dibbavaṇṇādīnaṃ,dibbavannadinam,3,3,0,0,15
415125,pañcasīladhamme,pancasiladhamme,1,1,0,0,15
415126,ānaṇyasuttavaṇṇanā,ananyasuttavannana,1,1,0,0,18
415127,adhigamanīyānīti,adhigamaniyaniti,1,0,1,0,16
415128,kāmabhogināti,kamabhoginati,3,0,3,0,13
415129,kilesakāme,kilesakame,34,32,2,0,10
415130,atthisukhā,atthisukha,1,0,1,0,10
415131,anaṇosmīti,ananosmiti,1,1,0,0,10
415132,anavajjosmīti,anavajjosmiti,1,1,0,0,13
415133,bhāgeti,bhageti,3,1,2,0,7
415134,koṭṭhāsanti,kotthasanti,2,2,0,0,11
415135,anavajjasukhassa,anavajjasukhassa,1,1,0,0,16
415136,brahmasuttavaṇṇanā,brahmasuttavannana,3,3,0,0,18
415137,vaṇṇitameva,vannitameva,2,2,0,0,11
415138,sapubbadevatānīti,sapubbadevataniti,1,0,1,0,17
415139,rūpasuttavaṇṇanā,rupasuttavannana,3,3,0,0,16
415140,dhammappamāṇāti,dhammappamanati,1,1,0,0,15
415141,pamāṇiṃsūti,pamanimsuti,2,0,2,0,11
415142,pasīdiṃsūti,pasidimsuti,2,2,0,0,11
415143,anvagūti,anvaguti,2,0,2,0,8
415144,ghosappamāṇaṃ,ghosappamanam,1,1,0,0,13
415145,chandarāgavasūpetāti,chandaragavasupetati,1,0,1,0,20
415146,bahiddhāpissa,bahiddhapissa,1,1,0,0,13
415147,samantāvaraṇoti,samantavaranoti,2,0,2,0,15
415148,āvārito,avarito,1,1,0,0,7
415149,āvaraṇamassāti,avaranamassati,1,1,0,0,14
415150,vuyhatīti,vuyhatiti,4,0,4,0,9
415151,phaladassāvīti,phaladassaviti,1,0,1,0,14
415152,sakkāraphalaṃ,sakkaraphalam,1,1,0,0,13
415153,vinīvaraṇadassāvīti,vinivaranadassaviti,1,0,1,0,19
415154,vivaṭadassāvī,vivatadassavi,1,1,0,0,13
415155,sarāgasuttavaṇṇanā,saragasuttavannana,1,1,0,0,18
415156,cāpaviddasūti,capaviddasuti,1,0,1,0,13
415157,dukkhavaḍḍhidāyakaṃ,dukkhavaddhidayakam,1,1,0,0,19
415158,acakkhukāti,acakkhukati,1,0,1,0,11
415159,paññācakkhurahitā,pannacakkhurahita,1,1,0,0,17
415160,sabhāvāva,sabhavava,1,1,0,0,9
415161,maññareti,mannareti,1,0,1,0,9
415162,evaṃsabhāvāti,evamsabhavati,10,9,1,0,13
415163,ahirājasuttavaṇṇanā,ahirajasuttavannana,3,3,0,0,19
415164,ahirājakulānīti,ahirajakulaniti,3,0,3,0,15
415165,daṭṭhavisāneva,datthavisaneva,1,1,0,0,14
415166,ahirājakulānaṃ,ahirajakulanam,2,2,0,0,14
415167,attaguttiyāti,attaguttiyati,2,0,2,0,13
415168,guttatthāya,guttatthaya,11,11,0,0,11
415169,attarakkhāyāti,attarakkhayati,2,0,2,0,14
415170,attaparittāyāti,attaparittayati,1,0,1,0,15
415171,parittāṇatthāya,parittanatthaya,3,3,0,0,15
415172,anujānāmīti,anujanamiti,75,75,0,0,11
415173,virūpakkhehīti,virupakkhehiti,2,0,2,0,14
415174,virūpakkhanāgakulehi,virupakkhanagakulehi,2,2,0,0,20
415175,apādakehīti,apadakehiti,3,0,3,0,11
415176,apādakasattehi,apadakasattehi,2,2,0,0,14
415177,odissakamettaṃ,odissakamettam,2,2,0,0,14
415178,anodissakamettaṃ,anodissakamettam,2,2,0,0,16
415179,idamāraddhaṃ,idamaraddham,8,8,0,0,12
415180,puggalavevacanāneva,puggalavevacananeva,2,2,0,0,19
415181,pāpamāgamāti,papamagamati,4,0,4,0,12
415182,pamāṇavantānīti,pamanavantaniti,3,0,3,0,15
415183,uṇṇanābhīti,unnanabhiti,5,0,5,0,11
415184,lomasanābhiko,lomasanabhiko,3,3,0,0,13
415185,sarabūti,sarabuti,6,0,6,0,8
415186,gharagolikā,gharagolika,1,1,0,0,11
415187,parittāṇañca,parittananca,2,2,0,0,12
415188,kataparittāṇā,kataparittana,2,2,0,0,13
415189,apagacchantu,apagacchantu,4,4,0,0,12
415190,viheṭhayiṃsūti,vihethayimsuti,2,2,0,0,14
415191,devadattasuttavaṇṇanā,devadattasuttavannana,7,7,0,0,21
415192,devadatteti,devadatteti,1,0,1,0,11
415193,nacirapakkante,nacirapakkante,2,2,0,0,14
415194,parābhavāyāti,parabhavayati,4,0,4,0,13
415195,assatarīti,assatariti,4,0,4,0,10
415196,sampayojenti,sampayojenti,10,10,0,0,12
415197,nasakkontī,nasakkonti,1,1,0,0,10
415198,paharantī,paharanti,10,10,0,0,9
415199,khāṇūsu,khanusu,1,1,0,0,7
415200,potakaṃ,potakam,8,7,1,0,7
415201,brūhanatthāya,bruhanatthaya,1,1,0,0,13
415202,anurakkhaṇatthāya,anurakkhanatthaya,7,7,0,0,17
415203,adhammikasuttavaṇṇanā,adhammikasuttavannana,3,3,0,0,21
415204,porāṇakarājūhi,poranakarajuhi,5,5,0,0,14
415205,dasabhāgabaliñceva,dasabhagabalinceva,1,1,0,0,18
415206,aparādhānurūpañca,aparadhanurupanca,1,1,0,0,17
415207,atirekabalino,atirekabalino,1,1,0,0,13
415208,atirekadaṇḍassa,atirekadandassa,1,1,0,0,15
415209,rājāyuttāti,rajayuttati,2,0,2,0,11
415210,kiccasaṃvidhāyakā,kiccasamvidhayaka,1,1,0,0,17
415211,āyuttakapurisā,ayuttakapurisa,3,3,0,0,14
415212,brāhmaṇagahapatikāti,brahmanagahapatikati,4,0,4,0,20
415213,antonagaravāsino,antonagaravasino,1,1,0,0,16
415214,brāhmaṇagahapatayo,brahmanagahapatayo,1,1,0,0,18
415215,negamajānapadāti,negamajanapadati,1,0,1,0,16
415216,vāyantīti,vayantiti,9,6,3,0,9
415217,atithaddhā,atithaddha,2,2,0,0,10
415218,atimudukā,atimuduka,2,2,0,0,9
415219,apañjasāti,apanjasati,1,0,1,0,10
415220,ummaggagāmino,ummaggagamino,1,1,0,0,13
415221,sañjātakhīrāni,sanjatakhirani,1,1,0,0,14
415222,kattikapuṇṇamā,kattikapunnama,14,14,0,0,14
415223,kattikanakkhattameva,kattikanakkhattameva,1,1,0,0,20
415224,migasirapuṇṇamā,migasirapunnama,1,1,0,0,15
415225,migasiranakkhattamevāti,migasiranakkhattamevati,1,1,0,0,23
415226,nakkhattameva,nakkhattameva,2,2,0,0,13
415227,avisamā,avisama,3,3,0,0,7
415228,samayasmiṃyeva,samayasmimyeva,1,1,0,0,14
415229,māsedakkhiṇāti,masedakkhinati,1,1,0,0,14
415230,samappavattino,samappavattino,1,1,0,0,14
415231,nātithaddhā,natithaddha,1,1,0,0,11
415232,nātimudū,natimudu,1,1,0,0,8
415233,pañjasāti,panjasati,1,0,1,0,9
415234,maggappaṭipannā,maggappatipanna,5,4,1,0,15
415235,amaggenāti,amaggenati,1,1,0,0,10
415236,atitthaṃ,atittham,6,6,0,0,8
415237,atitthameva,atitthameva,1,1,0,0,11
415238,netetipi,netetipi,1,1,0,0,8
415239,aviraddhappaṭipadaṃ,aviraddhappatipadam,1,1,0,0,19
415240,sappurisasuttavaṇṇanā,sappurisasuttavannana,2,2,0,0,21
415241,pañhābhinītoti,panhabhinitoti,1,0,1,0,14
415242,pañhatthāya,panhatthaya,3,2,1,0,11
415243,alambitvāti,alambitvati,1,0,1,0,11
415244,alambitaṃ,alambitam,2,1,1,0,9
415245,lajjitāya,lajjitaya,6,4,2,0,9
415246,hirottapparahito,hirottapparahito,1,1,0,0,16
415247,saṃvāsenāpi,samvasenapi,1,1,0,0,11
415248,nāvajānāti,navajanati,8,7,1,0,10
415249,asappurisabhāvasādhakaṃ,asappurisabhavasadhakam,1,1,0,0,23
415250,adhunāgatavadhukopammaṃ,adhunagatavadhukopammam,1,1,0,0,23
415251,vadhukātiādimāha,vadhukatiadimaha,1,0,1,0,16
415252,vadhukāti,vadhukati,2,0,2,0,9
415253,aggasuttadvayavaṇṇanā,aggasuttadvayavannana,1,1,0,0,21
415254,para74-75,para74-75,1,1,0,0,9
415255,para74-75_an4,para74-75_an4,1,1,0,0,13
415256,aggappattaṃ,aggappattam,3,2,1,0,11
415257,uttamasīlaṃ,uttamasilam,4,3,1,0,11
415258,upavattaneti,upavattaneti,2,0,2,0,12
415259,pācīnagatāya,pacinagataya,1,1,0,0,12
415260,sālapantiyā,salapantiya,3,3,0,0,11
415261,vinicchituṃ,vinicchitum,16,14,2,0,11
415262,puccheyyāthāti,puccheyyathati,2,0,2,0,14
415263,pabbajimha,pabbajimha,4,4,0,0,10
415264,ārocetūti,arocetuti,5,3,2,0,9
415265,ārocetu,arocetu,14,14,0,0,7
415266,bhavathāti,bhavathati,19,19,0,0,10
415267,nikkaṅkhabhāvapaccakkhakaraṇañāṇaṃyeva,nikkankhabhavapaccakkhakaranananamyeva,2,2,0,0,38
415268,saddhāmattanti,saddhamattanti,2,2,0,0,14
415269,pacchimakoti,pacchimakoti,4,0,4,0,12
415270,ānandattheraṃyeva,anandattheramyeva,2,2,0,0,17
415271,acinteyyasuttavaṇṇanā,acinteyyasuttavannana,3,3,0,0,21
415272,acinteyyānīti,acinteyyaniti,3,0,3,0,13
415273,acinteyyattāyeva,acinteyyattayeva,1,1,0,0,16
415274,cintentoti,cintentoti,3,0,3,0,10
415275,ummādassāti,ummadassati,1,0,1,0,11
415276,ummattakabhāvassa,ummattakabhavassa,1,1,0,0,17
415277,vighātassāti,vighatassati,1,0,1,0,12
415278,buddhavisayoti,buddhavisayoti,2,1,1,0,14
415279,jhānavisayoti,jhanavisayoti,1,0,1,0,13
415280,abhiññājhānavisayo,abhinnajhanavisayo,1,1,0,0,18
415281,diṭṭhadhammavedanīyādīnaṃ,ditthadhammavedaniyadinam,5,4,1,0,25
415282,lokacintāti,lokacintati,3,0,3,0,11
415283,ambatālanāḷikerādayo,ambatalanalikeradayo,2,2,0,0,20
415284,dakkhiṇasuttavaṇṇanā,dakkhinasuttavannana,3,3,0,0,20
415285,dakkhiṇāvisuddhiyoti,dakkhinavisuddhiyoti,2,0,2,0,20
415286,dānasaṅkhātāya,danasankhataya,4,3,1,0,14
415287,visujjhanakāraṇāni,visujjhanakaranani,1,1,0,0,18
415288,mahapphalabhāvena,mahapphalabhavena,4,4,0,0,17
415289,kalyāṇīnadīmukhadvāravāsī,kalyaninadimukhadvaravasi,1,1,0,0,25
415290,dīghasumattherassa,dighasumattherassa,2,2,0,0,18
415291,dāyakatoti,dayakatoti,3,0,3,0,10
415292,vaḍḍhamānavāsī,vaddhamanavasi,1,1,0,0,14
415293,petadakkhiṇaṃ,petadakkhinam,4,2,2,0,13
415294,dussīlasseva,dussilasseva,4,4,0,0,12
415295,pāpitakāleyevassa,papitakaleyevassa,2,2,0,0,17
415296,asadisadānaṃ,asadisadanam,24,22,2,0,12
415297,vaṇijjasuttavaṇṇanā,vanijjasuttavannana,1,1,0,0,19
415298,taṃsadisāva,tamsadisava,1,1,0,0,11
415299,taṃsarikkhakāva,tamsarikkhakava,1,1,0,0,15
415300,yathājjhāsayā,yathajjhasaya,1,1,0,0,13
415301,parajjhāsayā,parajjhasaya,1,1,0,0,12
415302,adhikataraphalā,adhikataraphala,2,1,1,0,15
415303,samitapāpabāhitapāpatāhi,samitapapabahitapapatahi,1,1,0,0,24
415304,samaṇabrāhmaṇatā,samanabrahmanata,1,1,0,0,16
415305,pavāretīti,pavaretiti,19,9,10,0,10
415306,kambojasuttavaṇṇanā,kambojasuttavannana,1,1,0,0,19
415307,vinicchayakaraṇatthaṃ,vinicchayakaranattham,2,2,0,0,21
415308,kasivaṇijjādimahākammantaṃ,kasivanijjadimahakammantam,1,1,0,0,26
415309,nappayojeti,nappayojeti,5,5,0,0,11
415310,sambharaṇatthāya,sambharanatthaya,1,1,0,0,16
415311,kambojaraṭṭhaṃ,kambojarattham,3,3,0,0,14
415312,kodhanotiādīsu,kodhanotiadisu,1,0,1,0,14
415313,kodhanatāya,kodhanataya,2,2,0,0,11
415314,kodhapariyuṭṭhito,kodhapariyutthito,1,1,0,0,17
415315,issukitāya,issukitaya,1,1,0,0,10
415316,maccharitāya,maccharitaya,2,2,0,0,12
415317,nippaññatāya,nippannataya,1,1,0,0,12
415318,sabhānisīdanādīni,sabhanisidanadini,1,1,0,0,17
415319,pāṇātipātādisuttapañcakavaṇṇanā,panatipatadisuttapancakavannana,1,1,0,0,31
415320,para81-85,para81-85,1,1,0,0,9
415321,para81-85_an4,para81-85_an4,1,1,0,0,13
415322,khandhatamova,khandhatamova,4,4,0,0,13
415323,sagguppattijotibhāvūpagamanato,sagguppattijotibhavupagamanato,1,1,0,0,30
415324,telakapallādino,telakapalladino,1,1,0,0,15
415325,dīpaupakaraṇassa,dipaupakaranassa,1,1,0,0,16
415326,kucchimhiyeva,kucchimhiyeva,1,1,0,0,13
415327,tamotamaparāyaṇova,tamotamaparayanova,2,2,0,0,18
415328,paccuppannapaccayavipatti,paccuppannapaccayavipatti,1,1,0,0,25
415329,pavattapaccayavipatti,pavattapaccayavipatti,2,2,0,0,21
415330,attabhāvavipatti,attabhavavipatti,2,2,0,0,16
415331,oṇatoṇatasuttavaṇṇanā,onatonatasuttavannana,1,1,0,0,21
415332,nīcako,nicako,2,2,0,0,6
415333,purimasuttanayeneva,purimasuttanayeneva,1,1,0,0,19
415334,puttasuttavaṇṇanā,puttasuttavannana,5,5,0,0,17
415335,niccalasamaṇoti,niccalasamanoti,2,1,1,0,15
415336,puṇḍarīkasadiso,pundarikasadiso,1,1,0,0,15
415337,ūnasatapattaṃ,unasatapattam,2,2,0,0,13
415338,sukkhavipassakakhīṇāsavaṃ,sukkhavipassakakhinasavam,1,1,0,0,25
415339,jhānābhiññānaṃ,jhanabhinnanam,5,5,0,0,14
415340,aparipuṇṇaguṇattā,aparipunnagunatta,1,1,0,0,17
415341,padumasadiso,padumasadiso,1,1,0,0,12
415342,paripuṇṇasatapattaṃ,paripunnasatapattam,1,1,0,0,19
415343,paripuṇṇaguṇattā,paripunnagunatta,1,1,0,0,16
415344,sukhumālasamaṇo,sukhumalasamano,1,1,0,0,15
415345,muducittasarīro,muducittasariro,1,1,0,0,15
415346,kāyikacetasikadukkharahito,kayikacetasikadukkharahito,1,1,0,0,26
415347,attasadise,attasadise,2,2,0,0,10
415348,sattavidhopi,sattavidhopi,1,1,0,0,12
415349,pāṭipadoti,patipadoti,5,0,5,0,10
415350,avasittassa,avasittassa,2,2,0,0,11
415351,katābhisekassāti,katabhisekassati,1,1,0,0,16
415352,macalappattoti,macalappattoti,1,0,1,0,14
415353,puttabhāvena,puttabhavena,6,6,0,0,12
415354,abhisittabhāvena,abhisittabhavena,1,1,0,0,16
415355,abhisekappattiatthāya,abhisekappattiatthaya,1,1,0,0,21
415356,niccalapatto,niccalapatto,1,1,0,0,12
415357,phusitvāti,phusitvati,12,0,12,0,10
415358,yācamāneheva,yacamaneheva,1,1,0,0,12
415359,ayācitaṃ,ayacitam,5,5,0,0,8
415360,khadiravanamagge,khadiravanamagge,2,1,1,0,16
415361,aṭṭhakanāgarasutte,atthakanagarasutte,4,3,1,0,18
415362,pilindavacchathero,pilindavacchathero,1,1,0,0,18
415363,tyassāti,tyassati,7,0,7,0,8
415364,manāpenevāti,manapenevati,1,0,1,0,12
415365,allīyanakena,alliyanakena,1,1,0,0,12
415366,upaharantīti,upaharantiti,3,1,2,0,12
415367,kāyikacetasikaupahāraṃ,kayikacetasikaupaharam,1,1,0,0,22
415368,upanīyanti,upaniyanti,6,6,0,0,10
415369,sannipātikānīti,sannipatikaniti,2,0,2,0,15
415370,utupariṇāmajānīti,utuparinamajaniti,2,0,2,0,17
415371,utupariṇāmato,utuparinamato,3,3,0,0,13
415372,atisītaatiuṇhaututo,atisitaatiunhaututo,2,1,1,0,19
415373,visamaparihārajānīti,visamapariharajaniti,2,0,2,0,20
415374,accāsanaatiṭṭhānādikā,accasanaatitthanadika,2,1,1,0,21
415375,visamaparihārato,visamapariharato,2,2,0,0,16
415376,opakkamikānīti,opakkamikaniti,3,0,3,0,14
415377,vadhabandhanādiupakkamena,vadhabandhanadiupakkamena,2,1,1,0,25
415378,kammavipākajānīti,kammavipakajaniti,2,0,2,0,17
415379,katakammavipākavaseneva,katakammavipakavaseneva,1,1,0,0,23
415380,kiriyajjhānāneva,kiriyajjhananeva,2,2,0,0,16
415381,laddhappatiṭṭhattā,laddhappatitthatta,2,1,1,0,18
415382,nātibahuguṇattā,natibahugunatta,1,1,0,0,15
415383,bahutaraguṇattā,bahutaragunatta,1,1,0,0,15
415384,mudubhāvappatto,mudubhavappatto,1,1,0,0,15
415385,sammādiṭṭhisuttavaṇṇanā,sammaditthisuttavannana,4,4,0,0,23
415386,sammādiṭṭhikotiādīhi,sammaditthikotiadihi,1,0,1,0,20
415387,aṭṭhaṅgikamaggavasena,atthangikamaggavasena,5,4,1,0,21
415388,dasaṅgikamaggavasena,dasangikamaggavasena,1,1,0,0,20
415389,arahattaphalañāṇaarahattaphalavimuttīhi,arahattaphalananaarahattaphalavimuttihi,1,1,0,0,39
415390,tathāgatasadisakhīṇāsavo,tathagatasadisakhinasavo,1,1,0,0,24
415391,kathitapuggalānaṃ,kathitapuggalanam,1,1,0,0,17
415392,khandhasuttavaṇṇanā,khandhasuttavannana,7,7,0,0,19
415393,sekhapuggalo,sekhapuggalo,4,4,0,0,12
415394,anuppāditajjhāno,anuppaditajjhano,1,1,0,0,16
415395,appamādavihārī,appamadavihari,19,19,0,0,14
415396,paramasukhumālakhīṇāsavoti,paramasukhumalakhinasavoti,1,1,0,0,26
415397,asurasuttavaṇṇanā,asurasuttavannana,1,1,0,0,17
415398,asurasadiso,asurasadiso,1,1,0,0,11
415399,devasadiso,devasadiso,1,1,0,0,10
415400,paṭhamasamādhisuttavaṇṇanā,pathamasamadhisuttavannana,1,1,0,0,26
415401,appanācittasamādhissa,appanacittasamadhissa,1,1,0,0,21
415402,saṅkhārapariggāhakavipassanāñāṇassa,sankharapariggahakavipassanananassa,1,1,0,0,35
415403,adhipaññāsaṅkhātañca,adhipannasankhatanca,1,1,0,0,20
415404,pañcakkhandhasaṅkhātesu,pancakkhandhasankhatesu,1,1,0,0,23
415405,vipassanābhūtaṃ,vipassanabhutam,1,1,0,0,15
415406,dutiyasamādhisuttavaṇṇanā,dutiyasamadhisuttavannana,3,3,0,0,25
415407,adhimattataraṃ,adhimattataram,1,1,0,0,14
415408,ussoḷhīti,ussolhiti,7,1,6,0,9
415409,paṅkalaggasakaṭauddharaṇasadisaṃ,pankalaggasakatauddharanasadisam,1,1,0,0,32
415410,appaṭivānīti,appativaniti,7,0,7,0,12
415411,tatiyasamādhisuttavaṇṇanā,tatiyasamadhisuttavannana,3,3,0,0,25
415412,daṭṭhabbātiādīsu,datthabbatiadisu,1,0,1,0,16
415413,samādahitabbaṃ,samadahitabbam,2,1,1,0,14
415414,dutiyajjhānādivasenāti,dutiyajjhanadivasenati,1,1,0,0,22
415415,chavālātasuttavaṇṇanā,chavalatasuttavannana,1,1,0,0,21
415416,gūthamakkhitaṃ,guthamakkhitam,6,5,1,0,14
415417,kūṭagopānasithambhasopānādīnaṃ,kutagopanasithambhasopanadinam,1,1,0,0,30
415418,anupaneyyatāya,anupaneyyataya,2,2,0,0,14
415419,khettakuṭipādaṃ,khettakutipadam,1,1,0,0,15
415420,mañcapādaṃ,mancapadam,1,1,0,0,10
415421,taṃsarikkhakaṃ,tamsarikkhakam,5,3,2,0,14
415422,sundarataro,sundarataro,32,31,1,0,11
415423,dadhītiādīsu,dadhitiadisu,1,0,1,0,12
415424,aggameva,aggameva,2,2,0,0,8
415425,aggotiādīsu,aggotiadisu,1,0,1,0,11
415426,chavālātūpamāya,chavalatupamaya,1,1,0,0,15
415427,vissaṭṭhakammanto,vissatthakammanto,1,1,0,0,17
415428,goṇasadiso,gonasadiso,1,1,0,0,10
415429,khippanisantisuttavaṇṇanā,khippanisantisuttavannana,2,2,0,0,25
415430,khippanisantīti,khippanisantiti,3,0,3,0,15
415431,khippanisāmano,khippanisamano,2,1,1,0,14
415432,sutappaguṇānaṃ,sutappagunanam,1,1,0,0,14
415433,tantidhammānaṃ,tantidhammanam,1,1,0,0,14
415434,atthūpaparikkhīti,atthupaparikkhiti,1,0,1,0,17
415435,upaparikkhako,upaparikkhako,2,2,0,0,13
415436,navalokuttaradhammānaṃ,navalokuttaradhammanam,4,4,0,0,22
415437,anurūpadhammabhūtaṃ,anurupadhammabhutam,3,3,0,0,19
415438,sasīlakaṃ,sasilakam,1,1,0,0,9
415439,pubbabhāgappaṭipadaṃ,pubbabhagappatipadam,14,12,2,0,20
415440,kalyāṇavācoti,kalyanavacoti,2,0,2,0,13
415441,kalyāṇavākkaraṇoti,kalyanavakkaranoti,5,0,5,0,18
415442,sundaravacanaghoso,sundaravacanaghoso,1,1,0,0,18
415443,poriyātiādīhi,poriyatiadihi,1,0,1,0,13
415444,yojetabboyeva,yojetabboyeva,1,1,0,0,13
415445,guṇaparipuṇṇāya,gunaparipunnaya,1,1,0,0,15
415446,adosāya,adosaya,1,1,0,0,7
415447,agaḷitapadabyañjanāya,agalitapadabyanjanaya,3,3,0,0,21
415448,samatthāya,samatthaya,20,20,0,0,10
415449,attahitasuttavaṇṇanā,attahitasuttavannana,1,1,0,0,20
415450,para98-99_an4,para98-99_an4,1,1,0,0,13
415451,puggalajjhāsayavasenāpi,puggalajjhasayavasenapi,1,1,0,0,23
415452,desanāñāṇavilāsenāpi,desanananavilasenapi,1,1,0,0,20
415453,pañcaveravasena,pancaveravasena,2,2,0,0,15
415454,potaliyasuttavaṇṇanā,potaliyasuttavannana,4,4,0,0,20
415455,kālaññutāti,kalannutati,1,0,1,0,11
415456,avaṇṇakathanaṃ,avannakathanam,4,4,0,0,14
415457,vaṇṇakathanaṃ,vannakathanam,5,5,0,0,13
415458,valāhakasuttadvayavaṇṇanā,valahakasuttadvayavannana,3,3,0,0,25
415459,para101-2,para101-2,4,4,0,0,9
415460,para101-2_an4,para101-2_an4,2,2,0,0,13
415461,tatiyapaṇṇāsakassa,tatiyapannasakassa,3,3,0,0,18
415462,akathetvāva,akathetvava,11,11,0,0,11
415463,kumbhasuttavaṇṇanā,kumbhasuttavannana,5,5,0,0,18
415464,kumbhāti,kumbhati,1,0,1,0,8
415465,pihitamukho,pihitamukho,3,3,0,0,11
415466,udakapuṇṇo,udakapunno,2,2,0,0,10
415467,apārutamukho,aparutamukho,1,1,0,0,12
415468,udakarahadasuttavaṇṇanā,udakarahadasuttavannana,3,3,0,0,23
415469,gambhīrobhāsotiādīsu,gambhirobhasotiadisu,1,0,1,0,20
415470,purāṇapaṇṇarasasambhinnavaṇṇo,puranapannarasasambhinnavanno,1,1,0,0,29
415471,kāḷaudako,kalaudako,1,1,0,0,9
415472,acchavippasannamaṇivaṇṇaudako,acchavippasannamanivannaudako,2,1,1,0,29
415473,ambasuttavaṇṇanā,ambasuttavannana,1,1,0,0,16
415474,para105-6,para105-6,2,2,0,0,9
415475,para105-6_an4,para105-6_an4,2,2,0,0,13
415476,mūsikasuttavaṇṇanā,musikasuttavannana,3,3,0,0,18
415477,khantātipi,khantatipi,1,1,0,0,10
415478,balībaddasuttavaṇṇanā,balibaddasuttavannana,3,3,0,0,21
415479,paragogaṇaṃ,paragoganam,1,1,0,0,11
415480,paragavacaṇḍoti,paragavacandoti,1,0,1,0,15
415481,ubbegapattaṃ,ubbegapattam,1,1,0,0,12
415482,rukkhasuttavaṇṇanā,rukkhasuttavannana,5,5,0,0,18
415483,phegguparivāroti,phegguparivaroti,1,0,1,0,16
415484,pheggurukkho,pheggurukkho,1,1,0,0,12
415485,pheggurukkheheva,pheggurukkheheva,1,1,0,0,16
415486,sāraparivāroti,saraparivaroti,2,0,2,0,14
415487,khadirādīhi,khadiradihi,2,2,0,0,11
415488,sārarukkheheva,sararukkheheva,1,1,0,0,14
415489,āsīvisasuttavaṇṇanā,asivisasuttavannana,3,3,0,0,19
415490,ghoravisoti,ghoravisoti,4,1,3,0,11
415491,kesisuttavaṇṇanā,kesisuttavannana,1,1,0,0,16
415492,kesīti,kesiti,2,0,2,0,6
415493,assadamme,assadamme,3,3,0,0,9
415494,vinetītiādīsu,vinetitiadisu,1,0,1,0,13
415495,madhurapānaṃ,madhurapanam,1,1,0,0,12
415496,muduvacanena,muduvacanena,1,1,0,0,12
415497,jāṇubandhanamukhabandhanādīhi,janubandhanamukhabandhanadihi,1,1,0,0,29
415498,patodavijjhanakasābhighātapharusavacanehi,patodavijjhanakasabhighatapharusavacanehi,1,1,0,0,41
415499,javasuttavaṇṇanā,javasuttavannana,1,1,0,0,16
415500,ajjavenāti,ajjavenati,2,0,2,0,10
415501,ujukabhāvena,ujukabhavena,1,1,0,0,12
415502,javenāti,javenati,3,0,3,0,8
415503,padavegena,padavegena,1,1,0,0,10
415504,adhivāsanakkhantiyā,adhivasanakkhantiya,2,2,0,0,19
415505,soraccenāti,soraccenati,5,0,5,0,11
415506,sucibhāvasīlena,sucibhavasilena,1,1,0,0,15
415507,puggalaguṇaṅgesu,puggalagunangesu,1,1,0,0,16
415508,patodasuttavaṇṇanā,patodasuttavannana,1,1,0,0,18
415509,ukkhittassa,ukkhittassa,12,12,0,0,11
415510,lomavedhaviddhoti,lomavedhaviddhoti,1,0,1,0,17
415511,patodavedhena,patodavedhena,2,2,0,0,13
415512,viddhamatto,viddhamatto,1,1,0,0,11
415513,cammavedhaviddhoti,cammavedhaviddhoti,1,0,1,0,18
415514,aṭṭhivedhaviddhoti,atthivedhaviddhoti,1,0,1,0,18
415515,vedhena,vedhena,1,1,0,0,7
415516,nāgasuttavaṇṇanā,nagasuttavannana,11,11,0,0,16
415517,aṭṭhiko,atthiko,4,2,2,0,7
415518,tiṇavaninnādasaddānaṃ,tinavaninnadasaddanam,1,0,1,0,21
415519,tiṇavoti,tinavoti,1,0,1,0,8
415520,ninnādasaddoti,ninnadasaddoti,1,0,1,0,14
415521,ekatomissito,ekatomissito,1,1,0,0,12
415522,ḍaṃsādīsu,damsadisu,2,2,0,0,9
415523,sīlasamādhipaññāvimuttivimuttiñāṇadassanāni,silasamadhipannavimuttivimuttinanadassanani,2,2,0,0,43
415524,ṭhānasuttavaṇṇanā,thanasuttavannana,4,4,0,0,17
415525,opātakkhaṇanamacchabandhanasandhicchedanādibhedaṃ,opatakkhananamacchabandhanasandhicchedanadibhedam,1,1,0,0,49
415526,samajīvikānaṃ,samajivikanam,1,1,0,0,13
415527,pupphacchaḍḍakādikammaṃ,pupphacchaddakadikammam,1,1,0,0,23
415528,sudhākoṭṭanagehacchādanaasuciṭṭhānasammajjanādikammañca,sudhakottanagehacchadanaasucitthanasammajjanadikammanca,1,1,0,0,55
415529,surāpānagandhavilepanamālāpiḷandhanādikammañceva,surapanagandhavilepanamalapilandhanadikammanceva,1,1,0,0,48
415530,pāṇātipātādikammañca,panatipatadikammanca,1,1,0,0,20
415531,suddhavatthacchādanamālāgandhādīnaṃ,suddhavatthacchadanamalagandhadinam,1,1,0,0,35
415532,bodhivandanaṃ,bodhivandanam,2,2,0,0,13
415533,madhuradhammakathāsavanaṃ,madhuradhammakathasavanam,1,1,0,0,25
415534,pañcasīlasamādānanti,pancasilasamadananti,1,1,0,0,20
415535,somanassasampayuttaṃ,somanassasampayuttam,3,3,0,0,20
415536,purisathāmeti,purisathameti,1,0,1,0,13
415537,ñāṇathāmasmiṃ,nanathamasmim,1,1,0,0,13
415538,appamādasuttavaṇṇanā,appamadasuttavannana,8,8,0,0,20
415539,samparāyikassāti,samparayikassati,1,0,1,0,16
415540,ārakkhasuttavaṇṇanā,arakkhasuttavannana,1,1,0,0,19
415541,attarūpenāti,attarupenati,3,0,3,0,12
415542,hitakāmenāti,hitakamenati,1,1,0,0,12
415543,rajanīyesūti,rajaniyesuti,6,1,5,0,12
415544,iṭṭhārammaṇesūti,ittharammanesuti,1,1,0,0,16
415545,vacanahetupi,vacanahetupi,1,1,0,0,12
415546,saṃvejanīyādisuttattayavaṇṇanā,samvejaniyadisuttattayavannana,1,1,0,0,30
415547,para118-120,para118-120,2,2,0,0,11
415548,para118-120_an4,para118-120_an4,2,2,0,0,15
415549,dassanīyānīti,dassaniyaniti,3,0,3,0,13
415550,passitabbayuttakāni,passitabbayuttakani,1,1,0,0,19
415551,saṃvejanīyānīti,samvejaniyaniti,2,0,2,0,15
415552,saṃvegajanakāni,samvegajanakani,3,3,0,0,15
415553,attānuvādasuttavaṇṇanā,attanuvadasuttavannana,3,3,0,0,22
415554,ūmibhayasuttavaṇṇanā,umibhayasuttavannana,3,3,0,0,20
415555,udakorohantassāti,udakorohantassati,1,0,1,0,17
415556,caṇḍamacchabhayaṃ,candamacchabhayam,2,2,0,0,17
415557,mukhapidahanaṃ,mukhapidahanam,1,1,0,0,14
415558,odarikattassāti,odarikattassati,1,0,1,0,15
415559,mahodaratāya,mahodarataya,1,1,0,0,12
415560,mahagghasabhāvassa,mahagghasabhavassa,1,1,0,0,18
415561,paṭhamanānākaraṇasuttavaṇṇanā,pathamananakaranasuttavannana,3,3,0,0,29
415562,sukhassādena,sukhassadena,2,2,0,0,12
415563,nirayagamanīyassa,nirayagamaniyassa,1,1,0,0,17
415564,dutiyatatiyādīsu,dutiyatatiyadisu,1,1,0,0,16
415565,nirayādigamanaṃ,nirayadigamanam,1,1,0,0,15
415566,kappāti,kappati,30,10,20,0,7
415567,paṇītabhāvanena,panitabhavanena,1,1,0,0,15
415568,aṭṭhakappā,atthakappa,1,1,0,0,10
415569,guṇassapi,gunassapi,2,1,1,0,9
415570,catusaṭṭhīti,catusatthiti,2,2,0,0,12
415571,paṇītajjhānavasena,panitajjhanavasena,1,1,0,0,18
415572,kappasatānīti,kappasataniti,1,0,1,0,13
415573,paṇītasseva,panitasseva,1,1,0,0,11
415574,upapattijjhānassa,upapattijjhanassa,1,1,0,0,17
415575,vehapphalesu,vehapphalesu,7,7,0,0,12
415576,paṭhamajjhānabhūmiādīsu,pathamajjhanabhumiadisu,1,1,0,0,23
415577,dutiyanānākaraṇasuttavaṇṇanā,dutiyananakaranasuttavannana,1,1,0,0,28
415578,aniccatotiādīsu,aniccatotiadisu,6,1,5,0,15
415579,padussanaṭṭhena,padussanatthena,3,3,0,0,15
415580,sadukkhaṭṭhena,sadukkhatthena,1,1,0,0,14
415581,sampīḷanaṭṭhena,sampilanatthena,1,1,0,0,15
415582,avidheyyaṭṭhena,avidheyyatthena,1,1,0,0,15
415583,palujjanaṭṭhena,palujjanatthena,4,4,0,0,15
415584,mettāsuttadvayavaṇṇanā,mettasuttadvayavannana,1,1,0,0,22
415585,para125-126,para125-126,2,2,0,0,11
415586,para125-126_an4,para125-126_an4,1,1,0,0,15
415587,dutiyādivasena,dutiyadivasena,1,1,0,0,14
415588,paṭhamatathāgataacchariyasuttavaṇṇanā,pathamatathagataacchariyasuttavannana,3,3,0,0,37
415589,pātubhāvāti,patubhavati,4,0,4,0,11
415590,okkamamāne,okkamamane,5,3,2,0,10
415591,appamāṇoti,appamanoti,14,4,10,0,10
415592,vuḍḍhippamāṇo,vuddhippamano,2,2,0,0,13
415593,vipuloti,vipuloti,6,3,3,0,8
415594,uḷāroti,ularoti,10,1,9,0,7
415595,nivatthavatthassa,nivatthavatthassa,5,5,0,0,17
415596,vimānassa,vimanassa,20,20,0,0,9
415597,lokantarikāti,lokantarikati,4,0,4,0,13
415598,lokantariko,lokantariko,2,2,0,0,11
415599,sakaṭacakkānaṃ,sakatacakkanam,6,6,0,0,14
415600,aghāti,aghati,3,0,3,0,6
415601,niccavivaṭā,niccavivata,5,3,2,0,11
415602,asaṃvutāti,asamvutati,8,0,8,0,10
415603,andhakārāti,andhakarati,5,0,5,0,11
415604,tamabhūtā,tamabhuta,3,3,0,0,9
415605,andhakāratimisāti,andhakaratimisati,4,0,4,0,17
415606,cakkhuviññāṇuppattinivāraṇato,cakkhuvinnanuppattinivaranato,3,3,0,0,29
415607,andhabhāvakaraṇatimisāya,andhabhavakaranatimisaya,1,1,0,0,24
415608,yojanasatasahassāni,yojanasatasahassani,6,5,1,0,19
415609,nānubhontīti,nanubhontiti,10,0,10,0,12
415610,cakkavāḷapabbatassa,cakkavalapabbatassa,9,6,3,0,19
415611,vemajjhena,vemajjhena,11,8,3,0,10
415612,cakkavāḷapabbatañca,cakkavalapabbatanca,6,6,0,0,19
415613,lokantaranirayā,lokantaraniraya,1,1,0,0,15
415614,lokantaramahāniraye,lokantaramahaniraye,2,2,0,0,19
415615,dhammikasamaṇabrāhmaṇānañca,dhammikasamanabrahmanananca,4,4,0,0,27
415616,pāṇavadhādisāhasikakammaṃ,panavadhadisahasikakammam,3,3,0,0,25
415617,abhayacoranāgacorādayo,abhayacoranagacoradayo,4,4,0,0,22
415618,tigāvutiko,tigavutiko,6,6,0,0,10
415619,vaggulīnaṃ,vaggulinam,4,4,0,0,10
415620,dīghanakhā,dighanakha,6,6,0,0,10
415621,cakkavāḷapabbatapāde,cakkavalapabbatapade,2,2,0,0,20
415622,lokasandhārakaudake,lokasandharakaudake,3,3,0,0,19
415623,accantakhāre,accantakhare,10,6,4,0,12
415624,anubhavāma,anubhavama,5,5,0,0,10
415625,anubhavanatthāya,anubhavanatthaya,4,4,0,0,16
415626,idhūpapannāti,idhupapannati,4,4,0,0,13
415627,ekayāgupānamattampi,ekayagupanamattampi,3,3,0,0,19
415628,accharāsaṅghātamattameva,accharasanghatamattameva,1,1,0,0,24
415629,vijjuobhāso,vijjuobhaso,1,1,0,0,11
415630,bhaṇantānaṃyeva,bhanantanamyeva,4,4,0,0,15
415631,dutiyatathāgataacchariyasuttavaṇṇanā,dutiyatathagataacchariyasuttavannana,3,3,0,0,36
415632,allīyitabbaṭṭhena,alliyitabbatthena,2,2,0,0,17
415633,ratāti,ratati,25,9,16,0,6
415634,sammuditāti,sammuditati,2,2,0,0,11
415635,ālayapaṭipakkhe,alayapatipakkhe,1,1,0,0,15
415636,vivaṭṭūpanissite,vivattupanissite,2,2,0,0,16
415637,sussūsatīti,sussusatiti,4,0,4,0,11
415638,odahatīti,odahatiti,2,0,2,0,9
415639,upaṭṭhapetīti,upatthapetiti,4,2,2,0,13
415640,ājānanatthāya,ajananatthaya,2,2,0,0,13
415641,maññitabbaṭṭhena,mannitabbatthena,1,1,0,0,16
415642,mānavinayadhamme,manavinayadhamme,1,1,0,0,16
415643,upasamapaṭipakkho,upasamapatipakkho,2,2,0,0,17
415644,anupasamo,anupasamo,2,1,1,0,9
415645,anupasantaṭṭhena,anupasantatthena,1,1,0,0,16
415646,opasamiketi,opasamiketi,1,0,1,0,11
415647,upasamakare,upasamakare,1,1,0,0,11
415648,avijjaṇḍakosena,avijjandakosena,4,4,0,0,15
415649,pariyonaddhattā,pariyonaddhatta,2,2,0,0,15
415650,onaddhāti,onaddhati,1,1,0,0,9
415651,avijjāvinayeti,avijjavinayeti,1,0,1,0,14
415652,avijjāvinayo,avijjavinayo,1,1,0,0,12
415653,taṃnissite,tamnissite,2,2,0,0,10
415654,desiyamāneti,desiyamaneti,4,2,2,0,12
415655,ānandaacchariyasuttavaṇṇanā,anandaacchariyasuttavannana,1,1,0,0,27
415656,kirānando,kiranando,2,2,0,0,9
415657,upasaṅkamatī,upasankamati,7,7,0,0,12
415658,attamanāti,attamanati,14,0,14,0,10
415659,sakamanā,sakamana,12,9,3,0,8
415660,yonisomanasikārakammaṃ,yonisomanasikarakammam,2,2,0,0,22
415661,pūrethā,puretha,3,3,0,0,7
415662,paṭisanthāradhammaṃ,patisantharadhammam,4,2,2,0,19
415663,vattathā,vattatha,4,4,0,0,8
415664,upaṭṭhānavattaṃ,upatthanavattam,2,2,0,0,15
415665,dhammikasamaṇabrāhmaṇe,dhammikasamanabrahmane,8,8,0,0,22
415666,upāsikāsupi,upasikasupi,2,2,0,0,11
415667,cakkavattiacchariyasuttavaṇṇanā,cakkavattiacchariyasuttavannana,1,1,0,0,31
415668,khattiyaparisāti,khattiyaparisati,5,1,4,0,16
415669,dassanamhi,dassanamhi,2,2,0,0,10
415670,samente,samente,1,1,0,0,7
415671,rājadhammaṃ,rajadhammam,9,9,0,0,11
415672,rakkhathā,rakkhatha,9,9,0,0,9
415673,labhathā,labhatha,6,6,0,0,8
415674,pabbajitaparikkhārā,pabbajitaparikkhara,2,2,0,0,19
415675,nappamajjathā,nappamajjatha,1,1,0,0,13
415676,upapattipaṭilābhiyānīti,upapattipatilabhiyaniti,1,0,1,0,23
415677,bhavapaṭilābhiyānīti,bhavapatilabhiyaniti,2,0,2,0,20
415678,appahīnasaṃyojanesu,appahinasamyojanesu,2,1,1,0,19
415679,appahīnānī,appahinani,4,3,1,0,10
415680,orambhāgiyesu,orambhagiyesu,2,1,1,0,13
415681,paṭibhānasuttavaṇṇanā,patibhanasuttavannana,3,3,0,0,21
415682,muttappaṭibhānoti,muttappatibhanoti,1,0,1,0,17
415683,ugghaṭitaññūsuttavaṇṇanā,ugghatitannusuttavannana,1,1,0,0,24
415684,uṭṭhānaphalasuttavaṇṇanā,utthanaphalasuttavannana,1,1,0,0,24
415685,puññaphalasseva,punnaphalasseva,1,1,0,0,15
415686,upajīvanato,upajivanato,1,1,0,0,11
415687,kammaphalūpajīvino,kammaphalupajivino,5,2,3,0,18
415688,nerayikasattā,nerayikasatta,8,8,0,0,13
415689,kammaphalanti,kammaphalanti,1,1,0,0,13
415690,sāvajjasuttavaṇṇanā,savajjasuttavannana,1,1,0,0,19
415691,kusalakārako,kusalakarako,1,1,0,0,12
415692,sīlasuttādivaṇṇanā,silasuttadivannana,6,6,0,0,18
415693,para136-137,para136-137,1,1,0,0,11
415694,para136-137_an4,para136-137_an4,1,1,0,0,15
415695,taṅkhaṇikampi,tankhanikampi,1,1,0,0,13
415696,upapattinimittakaṃ,upapattinimittakam,1,1,0,0,18
415697,paṭilabhatiyeva,patilabhatiyeva,1,1,0,0,15
415698,sukkhavipassakopi,sukkhavipassakopi,2,2,0,0,17
415699,paripūrakārīyeva,paripurakariyeva,2,2,0,0,16
415700,khīṇāsavoyeva,khinasavoyeva,1,1,0,0,13
415701,sīlādipaccanīkānaṃ,siladipaccanikanam,1,1,0,0,18
415702,puggalaparicchedo,puggalaparicchedo,1,1,0,0,17
415703,nikaṭṭhasuttavaṇṇanā,nikatthasuttavannana,1,1,0,0,20
415704,nikaṭṭhakāyoti,nikatthakayoti,1,0,1,0,14
415705,niggatakāyo,niggatakayo,1,1,0,0,11
415706,anikaṭṭhacittoti,anikatthacittoti,1,0,1,0,16
415707,anupaviṭṭhacitto,anupavitthacitto,1,1,0,0,16
415708,kāyeneva,kayeneva,13,11,2,0,8
415709,gāmameva,gamameva,3,3,0,0,8
415710,dhammakathikasuttavaṇṇanā,dhammakathikasuttavannana,7,7,0,0,25
415711,sahitāsahitassāti,sahitasahitassati,5,0,5,0,17
415712,atthanissitassa,atthanissitassa,1,1,0,0,15
415713,anissitassa,anissitassa,16,12,4,0,11
415714,vādīsuttavaṇṇanā,vadisuttavannana,1,1,0,0,16
415715,byañjanatoti,byanjanatoti,1,0,1,0,12
415716,ābhāsuttavaṇṇanā,abhasuttavannana,1,1,0,0,16
415717,ābhāsanavasena,abhasanavasena,1,1,0,0,14
415718,pabhāsuttādivaṇṇanā,pabhasuttadivannana,1,1,0,0,19
415719,para142-145,para142-145,1,1,0,0,11
415720,para142-145_an4,para142-145_an4,1,1,0,0,15
415721,pabhāsanavasena,pabhasanavasena,1,1,0,0,15
415722,ālokanavasena,alokanavasena,1,1,0,0,13
415723,pajjotanavasena,pajjotanavasena,1,1,0,0,15
415724,candapajjototi,candapajjototi,1,0,1,0,14
415725,paṭhamakālasuttavaṇṇanā,pathamakalasuttavannana,1,1,0,0,23
415726,kālāti,kalati,7,0,7,0,6
415727,yuttappayuttakālā,yuttappayuttakala,1,1,0,0,17
415728,yuttappayuttakāle,yuttappayuttakale,5,5,0,0,17
415729,dhammasākacchāti,dhammasakacchati,4,2,2,0,16
415730,pañhapucchanavissajjanavasena,panhapucchanavissajjanavasena,2,2,0,0,29
415731,dutiyakālasuttavaṇṇanā,dutiyakalasuttavannana,1,1,0,0,22
415732,dhammassavanādivasena,dhammassavanadivasena,2,1,1,0,21
415733,anuparivattiyanti,anuparivattiyanti,1,1,0,0,17
415734,sucaritasuttādivaṇṇanā,sucaritasuttadivannana,1,1,0,0,22
415735,para149-150,para149-150,1,1,0,0,11
415736,para149-150_an4,para149-150_an4,1,1,0,0,15
415737,mudukavācā,mudukavaca,1,1,0,0,10
415738,mantabhāsāti,mantabhasati,2,0,2,0,12
415739,mantasaṅkhātāya,mantasankhataya,1,1,0,0,15
415740,sīlasāroti,silasaroti,1,0,1,0,10
415741,sārasampāpakaṃ,sarasampapakam,1,1,0,0,14
415742,indriyasuttādivaṇṇanā,indriyasuttadivannana,3,3,0,0,21
415743,niddosabalaṃ,niddosabalam,1,1,0,0,12
415744,saṅgaṇhitabbayuttakānaṃ,sanganhitabbayuttakanam,1,1,0,0,23
415745,saṅgaṇhanabalaṃ,sanganhanabalam,1,1,0,0,15
415746,kappasuttavaṇṇanā,kappasuttavannana,3,3,0,0,17
415747,rogasuttavaṇṇanā,rogasuttavannana,1,1,0,0,16
415748,vighātavāti,vighatavati,6,0,6,0,11
415749,mahicchāpaccayena,mahicchapaccayena,1,1,0,0,17
415750,vighātena,vighatena,3,3,0,0,9
415751,asantuṭṭhoti,asantutthoti,6,3,3,0,12
415752,santosehi,santosehi,12,12,0,0,9
415753,anavaññappaṭilābhāyāti,anavannappatilabhayati,1,0,1,0,22
415754,anavajānanassa,anavajananassa,1,1,0,0,14
415755,lābhasakkārasilokappaṭilābhāyāti,labhasakkarasilokappatilabhayati,1,0,1,0,32
415756,susaṅkhatacatupaccayasaṅkhātassa,susankhatacatupaccayasankhatassa,1,1,0,0,32
415757,lābhasakkārassa,labhasakkarassa,6,5,1,0,15
415758,vaṇṇabhaṇanasaṅkhātassa,vannabhananasankhatassa,1,1,0,0,23
415759,silokassa,silokassa,2,2,0,0,9
415760,upasaṅkamatīti,upasankamatiti,10,5,5,0,14
415761,parihānisuttavaṇṇanā,parihanisuttavannana,1,1,0,0,20
415762,gambhīresūti,gambhiresuti,2,0,2,0,12
415763,atthagambhīresu,atthagambhiresu,1,1,0,0,15
415764,ṭhānāṭhānesūti,thanathanesuti,1,0,1,0,14
415765,uggahaparipucchāpaññāpi,uggahaparipucchapannapi,3,3,0,0,23
415766,sammasanappaṭivedhapaññāpi,sammasanappativedhapannapi,1,1,0,0,26
415767,bhikkhunīsuttavaṇṇanā,bhikkhunisuttavannana,3,3,0,0,21
415768,nipajjīti,nipajjiti,4,1,3,0,9
415769,lobhappahānatthāya,lobhappahanatthaya,1,1,0,0,18
415770,saṇheneva,sanheneva,1,1,0,0,9
415771,asubhakathaṃ,asubhakatham,28,25,3,0,12
415772,āhārasambhūtoti,aharasambhutoti,4,2,2,0,15
415773,pubbakammasaṅkhātaṃ,pubbakammasankhatam,1,1,0,0,19
415774,nikantitaṇhā,nikantitanha,2,2,0,0,12
415775,pajahitabbā,pajahitabba,2,2,0,0,11
415776,paccuppannataṇhaṃ,paccuppannatanham,2,1,1,0,17
415777,vaṭṭamūlikaṃ,vattamulikam,2,2,0,0,12
415778,pubbataṇhaṃ,pubbatanham,1,1,0,0,11
415779,paccuppannataṇhā,paccuppannatanha,1,1,0,0,16
415780,etissāpi,etissapi,5,5,0,0,8
415781,sevitabbataṇhāya,sevitabbatanhaya,1,1,0,0,16
415782,pajahitabbāyeva,pajahitabbayeva,1,1,0,0,15
415783,kāraṇaparivitakkanametaṃ,karanaparivitakkanametam,1,1,0,0,24
415784,uppannasevitabbamānaṃ,uppannasevitabbamanam,1,1,0,0,21
415785,pubbamānaṃ,pubbamanam,1,1,0,0,10
415786,pajahitabbāva,pajahitabbava,1,1,0,0,13
415787,vinivaṭṭente,vinivattente,4,4,0,0,12
415788,apagañchi,apaganchi,3,3,0,0,9
415789,theropissā,theropissa,1,1,0,0,10
415790,bhikkhunītiādi,bhikkhunitiadi,1,0,1,0,14
415791,sugatavinayasuttavaṇṇanā,sugatavinayasuttavannana,3,3,0,0,24
415792,pariyāpuṇantīti,pariyapunantiti,22,13,9,0,15
415793,dunnikkhittassāti,dunnikkhittassati,2,0,2,0,17
415794,chinnamūlakoti,chinnamulakoti,2,0,2,0,14
415795,mūlabhūtānaṃ,mulabhutanam,5,5,0,0,12
415796,appaṭisaraṇoti,appatisaranoti,2,0,2,0,14
415797,appatiṭṭho,appatittho,16,15,1,0,10
415798,paccayabāhullāya,paccayabahullaya,6,5,1,0,16
415799,sithilaggahaṇena,sithilaggahanena,1,1,0,0,16
415800,gaṇhanakā,ganhanaka,1,1,0,0,9
415801,avagamanato,avagamanato,1,1,0,0,11
415802,okkamananti,okkamananti,1,1,0,0,11
415803,nibbīriyā,nibbiriya,2,2,0,0,9
415804,saṃkhittasuttavaṇṇanā,samkhittasuttavannana,14,14,0,0,21
415805,sukhapaṭikkhepena,sukhapatikkhepena,2,2,0,0,17
415806,asīghappavattitāya,asighappavattitaya,1,1,0,0,18
415807,vitthārasuttavaṇṇanā,vittharasuttavannana,6,6,0,0,20
415808,anantaravipākadāyakaṃ,anantaravipakadayakam,1,1,0,0,21
415809,vipassanāpañcamakāni,vipassanapancamakani,1,1,0,0,20
415810,vipassanāpaññāva,vipassanapannava,6,6,0,0,16
415811,āvibhāvakathā,avibhavakatha,5,4,1,0,13
415812,ādīnavānupassane,adinavanupassane,4,4,0,0,16
415813,nibbidānupassane,nibbidanupassane,1,1,0,0,16
415814,muccitukamyatāñāṇe,muccitukamyatanane,1,1,0,0,18
415815,saṅkhārupekkhāñāṇe,sankharupekkhanane,2,2,0,0,18
415816,gotrabhuñāṇeti,gotrabhunaneti,1,1,0,0,14
415817,kilamitvāva,kilamitvava,1,1,0,0,11
415818,akilamitvāva,akilamitvava,1,1,0,0,12
415819,agarubhāvena,agarubhavena,1,1,0,0,12
415820,goṇapariyesakaupamāhi,gonapariyesakaupamahi,1,1,0,0,21
415821,vibhāvetabbā,vibhavetabba,15,15,0,0,12
415822,sagahane,sagahane,1,1,0,0,8
415823,gahanamaggeneva,gahanamaggeneva,1,1,0,0,15
415824,gahanaṭṭhāneyeva,gahanatthaneyeva,1,1,0,0,16
415825,nilīne,niline,6,6,0,0,6
415826,abbhokāsamaggena,abbhokasamaggena,1,1,0,0,16
415827,abbhokāsamaggeneva,abbhokasamaggeneva,1,1,0,0,18
415828,goṇapariyesako,gonapariyesako,1,1,0,0,14
415829,gahanamaggena,gahanamaggena,1,1,0,0,13
415830,kiccheneva,kiccheneva,1,1,0,0,10
415831,sesaupamāpi,sesaupamapi,1,1,0,0,11
415832,asubhasuttavaṇṇanā,asubhasuttavannana,3,3,0,0,18
415833,paṭikūlasaññīti,patikulasanniti,3,0,3,0,15
415834,pāṭikulyānaṃ,patikulyanam,6,5,1,0,12
415835,anabhiratisaññīti,anabhiratisanniti,1,0,1,0,17
415836,anabhiratāya,anabhirataya,1,1,0,0,12
415837,ukkaṇṭhitasaññāya,ukkanthitasannaya,2,1,1,0,17
415838,tebhūmakasaṅkhāre,tebhumakasankhare,8,8,0,0,17
415839,sekhabalānīti,sekhabalaniti,2,0,2,0,13
415840,sikkhanakānaṃ,sikkhanakanam,1,1,0,0,13
415841,asubhādīni,asubhadini,1,1,0,0,10
415842,paṭikūlārammaṇāni,patikularammanani,1,1,0,0,17
415843,sampiyāyamānaṃ,sampiyayamanam,1,1,0,0,14
415844,paṇītasukhāni,panitasukhani,1,1,0,0,13
415845,saṅgāmāvacarapuriso,sangamavacarapuriso,1,1,0,0,19
415846,phalakakoṭṭhakaṃ,phalakakotthakam,5,5,0,0,16
415847,pañcāvudhāni,pancavudhani,4,3,1,0,12
415848,vissamitukāmo,vissamitukamo,2,2,0,0,13
415849,kilesasaṅgāmo,kilesasangamo,1,1,0,0,13
415850,phalakakoṭṭhako,phalakakotthako,4,4,0,0,15
415851,pañcanissayabalāni,pancanissayabalani,1,1,0,0,18
415852,saṅgāmapavisanapuriso,sangamapavisanapuriso,1,1,0,0,21
415853,pañcāvudhasannāho,pancavudhasannaho,1,1,0,0,17
415854,vipassanāpañcamāni,vipassanapancamani,1,1,0,0,18
415855,pavisanakālo,pavisanakalo,3,3,0,0,12
415856,vissamitukāmassa,vissamitukamassa,1,1,0,0,16
415857,vissamanapānabhojanāni,vissamanapanabhojanani,1,1,0,0,22
415858,paṭisevanakālo,patisevanakalo,1,1,0,0,14
415859,nirassādakkhaṇe,nirassadakkhane,1,1,0,0,15
415860,sampahaṃsanakālo,sampahamsanakalo,1,1,0,0,16
415861,saṅgāmassa,sangamassa,2,2,0,0,10
415862,arahattaggahaṇakālo,arahattaggahanakalo,1,1,0,0,19
415863,paṭhamakhamasuttavaṇṇanā,pathamakhamasuttavannana,1,1,0,0,24
415864,akkhamāti,akkhamati,1,0,1,0,9
415865,anadhivāsikapaṭipadā,anadhivasikapatipada,1,1,0,0,20
415866,khamāti,khamati,1,0,1,0,7
415867,adhivāsikapaṭipadā,adhivasikapatipada,1,1,0,0,18
415868,damāti,damati,1,0,1,0,6
415869,indriyadamanapaṭipadā,indriyadamanapatipada,1,1,0,0,21
415870,akusalavitakkānaṃ,akusalavitakkanam,2,1,1,0,17
415871,vūpasamanapaṭipadā,vupasamanapatipada,2,1,1,0,18
415872,paṭirosatīti,patirosatiti,1,0,1,0,12
415873,ghaṭṭentaṃ,ghattentam,3,3,0,0,10
415874,paṭighaṭṭeti,patighatteti,1,1,0,0,12
415875,paṭibhaṇḍatīti,patibhandatiti,1,0,1,0,14
415876,paharantaṃ,paharantam,17,17,0,0,10
415877,paṭipaharati,patipaharati,3,3,0,0,12
415878,mahāmoggallānasuttavaṇṇanā,mahamoggallanasuttavannana,3,3,0,0,26
415879,sasaṅkhārasuttavaṇṇanā,sasankharasuttavannana,3,3,0,0,22
415880,paṭhamadutiyapuggalā,pathamadutiyapuggala,1,1,0,0,20
415881,vipassanindriyānaṃ,vipassanindriyanam,2,2,0,0,18
415882,samathayānikā,samathayanika,3,3,0,0,13
415883,yuganaddhasuttavaṇṇanā,yuganaddhasuttavannana,3,3,0,0,22
415884,sañjāyatīti,sanjayatiti,14,1,13,0,11
415885,ekacittakkhaṇikamaggassa,ekacittakkhanikamaggassa,1,1,0,0,24
415886,āsevanādīni,asevanadini,4,4,0,0,11
415887,dutiyamaggādayo,dutiyamaggadayo,4,4,0,0,15
415888,vipassanālābhī,vipassanalabhi,6,3,3,0,14
415889,dasavipassanupakkilesasaṅkhātena,dasavipassanupakkilesasankhatena,1,1,0,0,32
415890,viggahitaṃ,viggahitam,5,5,0,0,10
415891,suggahitanti,suggahitanti,5,5,0,0,12
415892,paccottharitvā,paccottharitva,1,1,0,0,14
415893,gocarajjhattasaṅkhāte,gocarajjhattasankhate,3,3,0,0,21
415894,cetanāsuttavaṇṇanā,cetanasuttavannana,6,6,0,0,18
415895,kāyasañcetanāhetūtiādīsu,kayasancetanahetutiadisu,1,0,1,0,24
415896,pakappanā,pakappana,6,6,0,0,9
415897,kāmāvacarakusalavasena,kamavacarakusalavasena,2,2,0,0,22
415898,kāyasañcetanāhetūti,kayasancetanahetuti,4,0,4,0,19
415899,kāyasañcetanāpaccayā,kayasancetanapaccaya,1,1,0,0,20
415900,aṭṭhakusalakammapaccayā,atthakusalakammapaccaya,1,1,0,0,23
415901,dvādasaakusalakammapaccayā,dvadasaakusalakammapaccaya,1,1,0,0,26
415902,avijjāpaccayāvāti,avijjapaccayavati,2,0,2,0,17
415903,avijjākāraṇeneva,avijjakaraneneva,1,1,0,0,16
415904,chādayamānā,chadayamana,1,1,0,0,11
415905,anāṇatto,ananatto,13,13,0,0,8
415906,kusalavipākoti,kusalavipakoti,1,1,0,0,14
415907,akusalavipākoti,akusalavipakoti,1,1,0,0,15
415908,asampajānakammaṃ,asampajanakammam,1,1,0,0,16
415909,daharadārakā,daharadaraka,2,2,0,0,12
415910,ajānantānampi,ajanantanampi,5,5,0,0,13
415911,migapakkhiādayo,migapakkhiadayo,1,1,0,0,15
415912,jānantānampi,janantanampi,3,3,0,0,12
415913,uggiranti,uggiranti,2,2,0,0,9
415914,āyūhanacetanā,ayuhanacetana,4,3,1,0,13
415915,samodhānetabbā,samodhanetabba,8,8,0,0,14
415916,sayaṃkatamūlikā,sayamkatamulika,1,1,0,0,15
415917,āṇattimūlikā,anattimulika,1,1,0,0,12
415918,sampajānamūlikā,sampajanamulika,1,1,0,0,15
415919,asampajānamūlikā,asampajanamulika,1,1,0,0,16
415920,saṅkhārakkhandhoteva,sankharakkhandhoteva,1,1,0,0,20
415921,vedayitākāro,vedayitakaro,1,1,0,0,12
415922,anupatitāti,anupatitati,2,0,2,0,11
415923,vuttappabhedesu,vuttappabhedesu,4,4,0,0,15
415924,cetanādhammesu,cetanadhammesu,1,1,0,0,14
415925,vaṭṭañceva,vattanceva,1,1,0,0,10
415926,asesavirāganirodhātiādimāha,asesaviraganirodhatiadimaha,2,0,2,0,27
415927,karaṇakammaṃ,karanakammam,4,3,1,0,12
415928,cetiyaṅgaṇasammajjanaṃ,cetiyanganasammajjanam,1,1,0,0,22
415929,bodhiyaṅgaṇasammajjanaṃ,bodhiyanganasammajjanam,1,1,0,0,23
415930,vattānuvattakaraṇanti,vattanuvattakarananti,1,1,0,0,21
415931,avipākadhammataṃ,avipakadhammatam,7,7,0,0,16
415932,paccayāssa,paccayassa,1,1,0,0,10
415933,kusalākusalakammasseva,kusalakusalakammasseva,1,1,0,0,22
415934,adhikaraṇaṭṭhena,adhikaranatthena,5,5,0,0,16
415935,attabhāvappaṭilābhāti,attabhavappatilabhati,1,0,1,0,21
415936,paṭiladdhaattabhāvā,patiladdhaattabhava,1,1,0,0,19
415937,pakappitacetanā,pakappitacetana,1,1,0,0,15
415938,nandanavanacittalatāvanaphārusakavanādīsu,nandanavanacittalatavanapharusakavanadisu,1,1,0,0,41
415939,dibbaratisamappitānaṃ,dibbaratisamappitanam,1,1,0,0,21
415940,pānabhojane,panabhojane,5,5,0,0,11
415941,āhārupacchedena,aharupacchedena,3,3,0,0,15
415942,khittamālā,khittamala,3,3,0,0,10
415943,suvijānā,suvijana,2,2,0,0,8
415944,kuddhabhāvamassa,kuddhabhavamassa,4,3,1,0,16
415945,kuddhesu,kuddhesu,7,7,0,0,8
415946,kandantānaṃyeva,kandantanamyeva,5,4,1,0,15
415947,orodhānaṃ,orodhanam,6,5,1,0,9
415948,attasañcetanāya,attasancetanaya,3,2,1,0,15
415949,parasañcetanāya,parasancetanaya,3,2,1,0,15
415950,rajjubandhanādīhipi,rajjubandhanadihipi,1,1,0,0,19
415951,satthane,satthane,1,1,0,0,8
415952,attasañcetanāpi,attasancetanapi,1,1,0,0,15
415953,parasañcetanāpi,parasancetanapi,1,1,0,0,15
415954,daṭṭhabbātipi,datthabbatipi,1,1,0,0,13
415955,kāmāvacarepi,kamavacarepi,1,1,0,0,12
415956,rūpāvacarepi,rupavacarepi,1,1,0,0,12
415957,bhavaggena,bhavaggena,2,2,0,0,10
415958,itthabhāvaṃ,itthabhavam,12,8,4,0,11
415959,kāmāvacarapañcakkhandhabhāvameva,kamavacarapancakkhandhabhavameva,1,1,0,0,32
415960,tatrūpapattikā,tatrupapattika,2,2,0,0,14
415961,uparūpapattikā,uparupapattika,3,3,0,0,14
415962,heṭṭhūpapattikā,hetthupapattika,2,2,0,0,15
415963,heṭṭhimabhave,hetthimabhave,1,1,0,0,13
415964,vibhattisuttavaṇṇanā,vibhattisuttavannana,3,3,0,0,20
415965,kāraṇaso,karanaso,1,1,0,0,8
415966,byañjanasoti,byanjanasoti,1,0,1,0,12
415967,anekapariyāyenāti,anekapariyayenati,14,0,14,0,17
415968,ācikkhāmīti,acikkhamiti,2,0,2,0,11
415969,paññāpemīti,pannapemiti,4,2,2,0,11
415970,paṭṭhapemīti,patthapemiti,2,1,1,0,12
415971,vivarāmīti,vivaramiti,1,0,1,0,10
415972,vibhajāmīti,vibhajamiti,1,0,1,0,11
415973,uttānīkaromīti,uttanikaromiti,2,1,1,0,14
415974,pañhenāti,panhenati,2,0,2,0,9
415975,upagacchatu,upagacchatu,2,2,0,0,11
415976,veyyākaraṇenāti,veyyakaranenati,3,0,3,0,15
415977,pañhakathanena,panhakathanena,2,2,0,0,14
415978,adhigatadhammānaṃ,adhigatadhammanam,1,1,0,0,17
415979,sacchikarohi,sacchikarohi,1,1,0,0,12
415980,paṭibāhissatīti,patibahissatiti,2,2,0,0,15
415981,mahākoṭṭhikasuttavaṇṇanā,mahakotthikasuttavannana,1,1,0,0,24
415982,phassākarānaṃ,phassakaranam,4,2,2,0,13
415983,uppattiṭṭhānānanti,uppattitthanananti,1,1,0,0,18
415984,sassatucchedaekaccasassataamarāvikkhepavasena,sassatucchedaekaccasassataamaravikkhepavasena,1,1,0,0,45
415985,bhaṇīti,bhaniti,12,7,5,0,7
415986,attūpaladdhivaseneva,attupaladdhivaseneva,1,1,0,0,20
415987,sassatādiākārena,sassatadiakarena,6,6,0,0,16
415988,attūpaladdhikoti,attupaladdhikoti,1,1,0,0,16
415989,attūpaladdhiko,attupaladdhiko,1,1,0,0,14
415990,evaṃladdhiko,evamladdhiko,11,11,0,0,12
415991,vissajjāpanatthaṃ,vissajjapanattham,1,1,0,0,17
415992,buddhakālepeso,buddhakalepeso,1,1,0,0,14
415993,mahāsāvakehi,mahasavakehi,1,1,0,0,12
415994,vacanokāsupacchedanatthaṃ,vacanokasupacchedanattham,3,3,0,0,25
415995,pucchatiyeva,pucchatiyeva,2,2,0,0,12
415996,papañcetīti,papancetiti,2,1,1,0,11
415997,papañcetabbaṭṭhāne,papancetabbatthane,1,1,0,0,18
415998,anācaritabbaṃ,anacaritabbam,2,2,0,0,13
415999,taṇhādiṭṭhimānappabhedassa,tanhaditthimanappabhedassa,1,1,0,0,26
416000,papañcavūpasamoti,papancavupasamoti,1,0,1,0,17
416001,papañcāpi,papancapi,1,1,0,0,9
416002,vūpasantāva,vupasantava,1,1,0,0,11
416003,puthujjanadevatānaṃ,puthujjanadevatanam,1,1,0,0,19
416004,aniruddhattā,aniruddhatta,5,5,0,0,12
416005,pañcavokārabhavavaseneva,pancavokarabhavavaseneva,2,2,0,0,24
416006,upavāṇasuttavaṇṇanā,upavanasuttavannana,3,3,0,0,19
416007,para175-176,para175-176,1,1,0,0,11
416008,para175-176_an4,para175-176_an4,1,1,0,0,15
416009,saupādānoti,saupadanoti,3,1,2,0,11
416010,sagahaṇova,sagahanova,1,1,0,0,10
416011,caraṇasampannoti,caranasampannoti,2,1,1,0,16
416012,pannarasadhammabhedena,pannarasadhammabhedena,4,3,1,0,22
416013,rāhulasuttavaṇṇanā,rahulasuttavannana,5,5,0,0,18
416014,thaddhākāralakkhaṇā,thaddhakaralakkhana,2,2,0,0,19
416015,pāsāṇapabbatādīsu,pasanapabbatadisu,1,1,0,0,17
416016,taṇhāmānadiṭṭhiggāhapaṭikkhepavasena,tanhamanaditthiggahapatikkhepavasena,1,1,0,0,36
416017,maggavajjhataṇhaṃ,maggavajjhatanham,1,1,0,0,17
416018,pahānābhisamayā,pahanabhisamaya,6,6,0,0,15
416019,saṃyuttamahānikāye,samyuttamahanikaye,1,1,0,0,18
416020,cūḷarāhulovādepi,cularahulovadepi,1,1,0,0,16
416021,ambalaṭṭhikarāhulovāde,ambalatthikarahulovade,1,1,0,0,22
416022,aṅguttaramahānikāye,anguttaramahanikaye,1,1,0,0,19
416023,catukoṭikasuññatā,catukotikasunnata,3,2,1,0,17
416024,jambālīsuttavaṇṇanā,jambalisuttavannana,3,3,0,0,19
416025,tebhūmakavaṭṭasaṅkhātassa,tebhumakavattasankhatassa,1,1,0,0,25
416026,pāṭikaṅkhoti,patikankhoti,3,0,3,0,12
416027,pāṭikaṅkhitabbo,patikankhitabbo,3,3,0,0,15
416028,lepagatenāti,lepagatenati,1,0,1,0,12
416029,lepamakkhitena,lepamakkhitena,2,2,0,0,14
416030,gantukāmapurisopammaṃ,gantukamapurisopammam,1,1,0,0,21
416031,caṇḍasotāya,candasotaya,3,3,0,0,11
416032,vāḷamacchākulāya,valamacchakulaya,1,1,0,0,16
416033,kakudharukkhe,kakudharukkhe,1,1,0,0,13
416034,rukkhapaṭipāṭiyā,rukkhapatipatiya,1,1,0,0,16
416035,kakudharukkhā,kakudharukkha,3,3,0,0,13
416036,maṭṭhasākhā,matthasakha,2,2,0,0,11
416037,nigrodhapilakkharukkhādīnaṃ,nigrodhapilakkharukkhadinam,1,1,0,0,27
416038,vāmapādenāti,vamapadenati,1,1,0,0,12
416039,lagiṃsu,lagimsu,1,1,0,0,7
416040,adhosiro,adhosiro,10,9,1,0,8
416041,uparinadiyaṃ,uparinadiyam,3,3,0,0,12
416042,gantukāmapuriso,gantukamapuriso,3,3,0,0,15
416043,sākhāgahaṇaṃ,sakhagahanam,3,3,0,0,12
416044,olambanaṃ,olambanam,3,3,0,0,9
416045,laggakālo,laggakalo,1,1,0,0,9
416046,bhakkhabhūtakālo,bhakkhabhutakalo,1,1,0,0,16
416047,saṃsārasote,samsarasote,2,2,0,0,11
416048,dukkhānubhavanakālo,dukkhanubhavanakalo,1,1,0,0,19
416049,hatthenāti,hatthenati,6,1,5,0,10
416050,sudhotena,sudhotena,1,1,0,0,9
416051,parisuddhahatthena,parisuddhahatthena,1,1,0,0,18
416052,kiliṭṭhahatthena,kilitthahatthena,1,1,0,0,16
416053,parigaleyyā,parigaleyya,1,1,0,0,11
416054,sudhote,sudhote,2,2,0,0,7
416055,aṭṭhamarukkhato,atthamarukkhato,2,2,0,0,15
416056,cintitakālo,cintitakalo,2,2,0,0,11
416057,pāripanthikadhamme,paripanthikadhamme,2,2,0,0,18
416058,paṭhamarukkhārohaṇakālo,pathamarukkharohanakalo,1,1,0,0,23
416059,paṭhamajjhānasamāpattikālo,pathamajjhanasamapattikalo,1,1,0,0,26
416060,paṭhamarukkhato,pathamarukkhato,1,1,0,0,15
416061,āruḷhakālo,arulhakalo,4,4,0,0,10
416062,abaddhassa,abaddhassa,11,10,1,0,10
416063,dutiyajjhānasamāpannakālo,dutiyajjhanasamapannakalo,1,1,0,0,25
416064,sattamarukkhato,sattamarukkhato,1,1,0,0,15
416065,nevasaññānāsaññāyatanasamāpannakālo,nevasannanasannayatanasamapannakalo,1,1,0,0,35
416066,arahattappattakālo,arahattappattakalo,4,4,0,0,18
416067,gaṇabahalamahāavijjāya,ganabahalamahaavijjaya,1,1,0,0,22
416068,pabhedasaṅkhātaṃ,pabhedasankhatam,1,1,0,0,16
416069,jambālīti,jambaliti,1,0,1,0,9
416070,mahāudakassa,mahaudakassa,1,1,0,0,12
416071,patiṭṭhānabhūto,patitthanabhuto,2,2,0,0,15
416072,mahāāvāṭo,mahaavato,2,2,0,0,9
416073,anekavassagaṇikāti,anekavassaganikati,1,0,1,0,18
416074,uppannakāleyeva,uppannakaleyeva,1,1,0,0,15
416075,vassagaṇāni,vassaganani,1,1,0,0,11
416076,āyamukhānīti,ayamukhaniti,2,0,2,0,12
416077,pavisanakandarā,pavisanakandara,2,1,1,0,15
416078,apāyamukhānīti,apayamukhaniti,6,1,5,0,14
416079,apavāhanacchiddāni,apavahanacchiddani,2,2,0,0,18
416080,uyyānagavesakaopammaṃ,uyyanagavesakaopammam,1,1,0,0,21
416081,jambāliṃ,jambalim,1,1,0,0,8
416082,kuddālaṃ,kuddalam,12,12,0,0,8
416083,avasesaudakaṃ,avasesaudakam,2,2,0,0,13
416084,apavāhanacchiddena,apavahanacchiddena,1,1,0,0,18
416085,parissavitvā,parissavitva,2,2,0,0,12
416086,cammakhaṇḍapilotikādīni,cammakhandapilotikadini,1,1,0,0,23
416087,anupagamanīyā,anupagamaniya,1,1,0,0,13
416088,upagatānampi,upagatanampi,3,3,0,0,12
416089,cātumahābhūtikakāyo,catumahabhutikakayo,1,1,0,0,19
416090,āyamukhānaṃ,ayamukhanam,2,2,0,0,11
416091,pihitakālo,pihitakalo,2,2,0,0,10
416092,dhammassavanodakassa,dhammassavanodakassa,1,1,0,0,20
416093,aladdhakālo,aladdhakalo,2,2,0,0,11
416094,apāyamukhānaṃ,apayamukhanam,3,3,0,0,13
416095,vivaṭakālo,vivatakalo,2,2,0,0,10
416096,chadvārikasaṃvarassa,chadvarikasamvarassa,1,1,0,0,20
416097,vissaṭṭhakālo,vissatthakalo,3,3,0,0,13
416098,avuṭṭhakālo,avutthakalo,1,1,0,0,11
416099,sappāyakammaṭṭhānassa,sappayakammatthanassa,2,2,0,0,21
416100,avasesaudakassa,avasesaudakassa,1,1,0,0,15
416101,apāyamukhehi,apayamukhehi,1,1,0,0,12
416102,parihīnakālo,parihinakalo,1,1,0,0,12
416103,avijjāpāḷiṃ,avijjapalim,1,1,0,0,11
416104,kilesarāsiṃ,kilesarasim,2,2,0,0,11
416105,cammakhaṇḍapilotikādīnaṃ,cammakhandapilotikadinam,1,1,0,0,24
416106,pūtibhāvo,putibhavo,4,4,0,0,9
416107,rāgādikilesehi,ragadikilesehi,3,3,0,0,14
416108,paripūritakālo,paripuritakalo,1,1,0,0,14
416109,vaṭṭasamaṅgipuggalassa,vattasamangipuggalassa,1,1,0,0,22
416110,abhiratakālo,abhiratakalo,1,1,0,0,12
416111,sappāyadhammassavanassa,sappayadhammassavanassa,1,1,0,0,23
416112,paccupaṭṭhitakālo,paccupatthitakalo,2,2,0,0,17
416113,vuṭṭhakālo,vutthakalo,1,1,0,0,10
416114,sacchikatakālo,sacchikatakalo,1,1,0,0,14
416115,āyamukhehi,ayamukhehi,1,1,0,0,10
416116,uyyānamajjhe,uyyanamajjhe,1,1,0,0,12
416117,dhammapāsādaṃ,dhammapasadam,8,7,1,0,13
416118,lokiyalokuttaramissikā,lokiyalokuttaramissika,2,2,0,0,22
416119,nibbānasuttavaṇṇanā,nibbanasuttavannana,3,3,0,0,19
416120,saññātiādīsu,sannatiadisu,1,0,1,0,12
416121,mahāpadesasuttavaṇṇanā,mahapadesasuttavannana,3,3,0,0,22
416122,ānandacetiyeti,anandacetiyeti,1,0,1,0,14
416123,ānandayakkhassa,anandayakkhassa,1,1,0,0,15
416124,patiṭṭhitavihāre,patitthitavihare,1,1,0,0,16
416125,mahāpadeseti,mahapadeseti,7,1,6,0,12
416126,mahāokāse,mahaokase,3,3,0,0,9
416127,mahāapadese,mahaapadese,3,3,0,0,11
416128,mahākāraṇānīti,mahakarananiti,5,5,0,0,14
416129,haṭṭhatuṭṭhehi,hatthatutthehi,2,2,0,0,14
416130,yuttampi,yuttampi,9,9,0,0,8
416131,appaṭikkositvāti,appatikkositvati,2,0,2,0,16
416132,padabyañjanānīti,padabyanjananiti,7,0,7,0,16
416133,padasaṅkhātāni,padasankhatani,4,4,0,0,14
416134,otāretabbānīti,otaretabbaniti,3,0,3,0,14
416135,otaritabbāni,otaritabbani,1,1,0,0,12
416136,sandassetabbānīti,sandassetabbaniti,2,0,2,0,17
416137,saṃsandetabbāni,samsandetabbani,5,5,0,0,15
416138,suttavibhaṅge,suttavibhange,20,19,1,0,13
416139,vinayātisāre,vinayatisare,5,4,1,0,12
416140,ubhatovibhaṅgā,ubhatovibhanga,8,6,2,0,14
416141,khandhakaparivārā,khandhakaparivara,7,5,2,0,17
416142,suttantābhidhammapiṭakāni,suttantabhidhammapitakani,6,5,1,0,25
416143,asuttanāmakañhi,asuttanamakanhi,2,2,0,0,15
416144,apadānanti,apadananti,2,2,0,0,10
416145,sudinnatthero,sudinnatthero,4,4,0,0,13
416146,asuttanāmakaṃ,asuttanamakam,4,4,0,0,13
416147,suttamāhari,suttamahari,3,3,0,0,11
416148,tepiṭakabuddhavacane,tepitakabuddhavacane,1,1,0,0,20
416149,rāgādivinayakāraṇe,ragadivinayakarane,4,2,2,0,18
416150,saṃsandetabbānīti,samsandetabbaniti,2,2,0,0,17
416151,otarantīti,otarantiti,9,3,6,0,10
416152,suttapaṭipāṭiyā,suttapatipatiya,3,2,1,0,15
416153,challiṃ,challim,8,5,3,0,7
416154,guḷhavessantaraguḷhaummaggaguḷhavinayavedallapiṭakānaṃ,gulhavessantaragulhaummaggagulhavinayavedallapitakanam,2,2,0,0,54
416155,rāgādivinaye,ragadivinaye,3,3,0,0,12
416156,apaññāyamānāni,apannayamanani,2,1,1,0,14
416157,chaḍḍeyyāthā,chaddeyyatha,2,2,0,0,12
416158,dhāreyyāthāti,dhareyyathati,4,1,3,0,13
416159,patiṭṭhānokāsaṃ,patitthanokasam,3,3,0,0,15
416160,ṭhānakusaloti,thanakusaloti,1,0,1,0,13
416161,pāṭibhogasuttavaṇṇanā,patibhogasuttavannana,1,1,0,0,21
416162,sutasuttavaṇṇanā,sutasuttavannana,1,1,0,0,16
416163,abhayasuttavaṇṇanā,abhayasuttavannana,6,6,0,0,18
416164,kicchājīvitakāraṇaṭṭhena,kicchajivitakaranatthena,1,1,0,0,24
416165,rogova,rogova,6,5,1,0,6
416166,akatakalyāṇotiādīsu,akatakalyanotiadisu,1,0,1,0,19
416167,kosallasambhūtattā,kosallasambhutatta,1,1,0,0,18
416168,parittāyakattā,parittayakatta,1,1,0,0,14
416169,katapāpotiādīsu,katapapotiadisu,1,0,1,0,15
416170,kakkhaḷakammaṃ,kakkhalakammam,5,5,0,0,14
416171,aparisuddhakammaṃ,aparisuddhakammam,1,1,0,0,17
416172,buddhadhammasaṅghaguṇesu,buddhadhammasanghagunesu,1,1,0,0,24
416173,vicikicchīti,vicikicchiti,2,0,2,0,12
416174,sāsanasaddhamme,sasanasaddhamme,3,3,0,0,15
416175,brāhmaṇasaccasuttavaṇṇanā,brahmanasaccasuttavannana,3,3,0,0,25
416176,brāhmaṇasaccānīti,brahmanasaccaniti,2,0,2,0,17
416177,tadabhiññāyāti,tadabhinnayati,3,0,3,0,14
416178,anuddayatthāya,anuddayatthaya,1,1,0,0,14
416179,anukampatthāya,anukampatthaya,3,3,0,0,14
416180,sesapaṭipadāsupi,sesapatipadasupi,1,1,0,0,16
416181,vatthukāmakilesakāmā,vatthukamakilesakama,7,7,0,0,20
416182,saccamāhāti,saccamahati,1,0,1,0,11
416183,catukkoṭikasuññatā,catukkotikasunnata,1,1,0,0,18
416184,maññanānaṃ,mannananam,24,24,0,0,10
416185,kiñcanabhāvavirahitaṃ,kincanabhavavirahitam,1,1,0,0,21
416186,nippalibodhaṃ,nippalibodham,2,2,0,0,13
416187,niggahaṇameva,niggahanameva,1,1,0,0,13
416188,paveditānīti,paveditaniti,1,0,1,0,12
416189,bhovādibrāhmaṇānaṃ,bhovadibrahmananam,1,1,0,0,18
416190,bāhitapāpabrāhmaṇassa,bahitapapabrahmanassa,1,1,0,0,21
416191,jotitānīti,jotitaniti,1,1,0,0,10
416192,vacīsaccameva,vacisaccameva,1,1,0,0,13
416193,ummaggasuttavaṇṇanā,ummaggasuttavannana,3,3,0,0,19
416194,parikassatīti,parikassatiti,2,0,2,0,13
416195,ummaggoti,ummaggoti,4,1,3,0,9
416196,paññāgamananti,pannagamananti,1,1,0,0,14
416197,ummujjanaṭṭhena,ummujjanatthena,1,1,0,0,15
416198,paṭibhānaṭṭhena,patibhanatthena,1,1,0,0,15
416199,tesaṃyevettha,tesamyevettha,2,1,1,0,13
416200,nibbijjhanakapañño,nibbijjhanakapanno,1,1,0,0,18
416201,tebhūmakakkhandhapañcakaṃ,tebhumakakkhandhapancakam,1,1,0,0,25
416202,vaṭṭamūlakataṇhā,vattamulakatanha,1,1,0,0,16
416203,catutthapañhavissajjanena,catutthapanhavissajjanena,2,2,0,0,25
416204,todeyyassāti,todeyyassati,1,0,1,0,12
416205,tudigāmavāsikassa,tudigamavasikassa,1,1,0,0,17
416206,parisatīti,parisatiti,5,0,5,0,10
416207,sannipatitāya,sannipatitaya,14,13,1,0,13
416208,paragarahaṃ,paragaraham,2,2,0,0,11
416209,rājātiādi,rajatiadi,2,0,2,0,9
416210,rāmaputteti,ramaputteti,1,0,1,0,11
416211,abhippasannoti,abhippasannoti,6,3,3,0,14
416212,uttamanipātakiriyaṃ,uttamanipatakiriyam,1,1,0,0,19
416213,parihārakāti,pariharakati,1,0,1,0,12
416214,yamakotiādīni,yamakotiadini,1,0,1,0,13
416215,assudaṃ,assudam,3,2,1,0,7
416216,anuneti,anuneti,1,1,0,0,7
416217,karaṇīyādhikaraṇīyesūti,karaniyadhikaraniyesuti,1,0,1,0,23
416218,atirekakattabbakiccesu,atirekakattabbakiccesu,1,1,0,0,22
416219,vacanīyādhivacanīyesūti,vacaniyadhivacaniyesuti,1,0,1,0,23
416220,atirekavattabbesu,atirekavattabbesu,1,1,0,0,17
416221,alamatthadasatarehīti,alamatthadasatarehiti,1,0,1,0,21
416222,alamatthadasā,alamatthadasa,2,2,0,0,13
416223,alamatthadasataroti,alamatthadasataroti,2,0,2,0,19
416224,alamatthadasatāya,alamatthadasataya,1,1,0,0,17
416225,chekataro,chekataro,1,1,0,0,9
416226,paṇḍitataroti,panditataroti,1,1,0,0,13
416227,paṭipucchantā,patipucchanta,1,1,0,0,13
416228,bhotiādimāhaṃsu,bhotiadimahamsu,1,0,1,0,15
416229,sappurisatāya,sappurisataya,2,2,0,0,13
416230,eḷeyyarājānampi,eleyyarajanampi,1,1,0,0,15
416231,parivārikepi,parivarikepi,1,1,0,0,12
416232,rāmaputtaṃ,ramaputtam,18,18,0,0,10
416233,andhampi,andhampi,1,1,0,0,8
416234,anandhampi,anandhampi,2,2,0,0,10
416235,sappurisampi,sappurisampi,1,1,0,0,12
416236,asappurisampi,asappurisampi,1,1,0,0,13
416237,todeyyopi,todeyyopi,1,1,0,0,9
416238,asappurise,asappurise,6,6,0,0,10
416239,imamatthavasaṃ,imamatthavasam,1,1,0,0,14
416240,gotamātiādīni,gotamatiadini,1,0,1,0,13
416241,upakasuttavaṇṇanā,upakasuttavannana,3,3,0,0,17
416242,upakoti,upakoti,1,0,1,0,7
416243,maṇḍikāputtoti,mandikaputtoti,1,0,1,0,14
416244,maṇḍikāya,mandikaya,1,1,0,0,9
416245,ghaṭṭetukāmo,ghattetukamo,2,2,0,0,12
416246,upasaṅkamītipi,upasankamitipi,3,3,0,0,14
416247,upapādetīti,upapadetiti,1,0,1,0,11
416248,upapādetuṃ,upapadetum,1,1,0,0,10
416249,upavajjoti,upavajjoti,1,0,1,0,10
416250,upavaditabbo,upavaditabbo,2,2,0,0,12
416251,vajjena,vajjena,3,3,0,0,7
416252,ummujjamānakaṃyevāti,ummujjamanakamyevati,1,0,1,0,20
416253,ukkhipantaṃyeva,ukkhipantamyeva,1,1,0,0,15
416254,padātiādīsu,padatiadisu,1,0,1,0,11
416255,aparimāṇāyeva,aparimanayeva,1,1,0,0,13
416256,akusalapaññattiyaṃ,akusalapannattiyam,1,1,0,0,18
416257,āgatānipi,agatanipi,1,1,0,0,9
416258,apariyādinnāvassa,apariyadinnavassa,2,1,1,0,17
416259,apariyādinnaṃ,apariyadinnam,3,2,1,0,13
416260,dhammapadabyañjanaṃ,dhammapadabyanjanam,5,2,3,0,19
416261,guṇadhaṃsī,gunadhamsi,2,2,0,0,10
416262,loṇakāradārakoti,lonakaradarakoti,1,0,1,0,16
416263,loṇakāragāmadārako,lonakaragamadarako,1,1,0,0,18
416264,maññissatīti,mannissatiti,2,1,1,0,12
416265,ghaṭṭetabbaṃ,ghattetabbam,8,6,2,0,12
416266,apehīti,apehiti,9,2,7,0,7
416267,nikkaḍḍhāpesiyevāti,nikkaddhapesiyevati,1,1,0,0,19
416268,sacchikaraṇīyasuttavaṇṇanā,sacchikaraniyasuttavannana,3,3,0,0,26
416269,sacchikaraṇīyāti,sacchikaraniyati,2,0,2,0,16
416270,paccavekkhaṇapaññāya,paccavekkhanapannaya,5,5,0,0,20
416271,sacchikaraṇīyaṃ,sacchikaraniyam,1,1,0,0,15
416272,tuṇhībhūtameva,tunhibhutameva,6,6,0,0,14
416273,paṭipattisampanne,patipattisampanne,1,1,0,0,17
416274,pasannehi,pasannehi,22,22,0,0,9
416275,uppannadhammapāmojjo,uppannadhammapamojjo,1,1,0,0,20
416276,thometukāmatāya,thometukamataya,1,1,0,0,15
416277,apalāpāti,apalapati,1,0,1,0,9
416278,palāparahitā,palaparahita,1,1,0,0,12
416279,suddhāti,suddhati,14,4,10,0,8
416280,nimmalā,nimmala,13,13,0,0,7
416281,sīlādisāre,siladisare,2,2,0,0,10
416282,yojanagaṇanānīti,yojanaganananiti,3,1,2,0,16
416283,yojanameva,yojanameva,5,5,0,0,10
416284,yojanāneva,yojananeva,2,2,0,0,10
416285,yojanagaṇanānī,yojanagananani,1,1,0,0,14
416286,yojanasahassampi,yojanasahassampi,7,7,0,0,16
416287,puṭosenāpīti,putosenapiti,2,0,2,0,12
416288,puṭosaṃ,putosam,7,3,4,0,7
416289,puṭaṃsenātipi,putamsenatipi,2,2,0,0,13
416290,puṭaṃso,putamso,3,3,0,0,7
416291,puṭaṃsena,putamsena,4,3,1,0,9
416292,pātheyyapuṭaṃ,patheyyaputam,5,5,0,0,13
416293,vahantenāpīti,vahantenapiti,3,3,0,0,13
416294,devappattāti,devappattati,1,0,1,0,12
416295,upapattidevanibbattakaṃ,upapattidevanibbattakam,1,1,0,0,23
416296,brahmappattāti,brahmappattati,1,0,1,0,14
416297,niddosaṭṭhena,niddosatthena,7,5,2,0,13
416298,brahmabhāvasādhakaṃ,brahmabhavasadhakam,1,1,0,0,19
416299,brahmavihārena,brahmaviharena,5,5,0,0,14
416300,āneñjappattāti,anenjappattati,2,1,1,0,14
416301,aniñjanabhāvasādhakaṃ,aninjanabhavasadhakam,1,1,0,0,21
416302,āneñjena,anenjena,5,5,0,0,8
416303,ariyappattāti,ariyappattati,1,0,1,0,13
416304,sotānugatasuttavaṇṇanā,sotanugatasuttavannana,3,3,0,0,22
416305,ñāṇasotena,nanasotena,3,2,1,0,10
416306,vavatthapitānaṃ,vavatthapitanam,3,2,1,0,15
416307,guṇānisaṃsā,gunanisamsa,1,1,0,0,11
416308,atthuppattivasena,atthuppattivasena,4,4,0,0,17
416309,kataraatthuppattivasenāti,kataraatthuppattivasenati,1,1,0,0,25
416310,anupasaṅkamanaatthuppattivasena,anupasankamanaatthuppattivasena,1,1,0,0,31
416311,liṅgavacanavibhattipadabyañjanādīhi,lingavacanavibhattipadabyanjanadihi,1,1,0,0,35
416312,sajjhāyantānañca,sajjhayantananca,1,1,0,0,16
416313,pariyāpuṇātīti,pariyapunatiti,7,3,4,0,14
416314,geyyantiādikaṃ,geyyantiadikam,1,1,0,0,14
416315,satthusāsanabhūtaṃ,satthusasanabhutam,4,4,0,0,18
416316,tantidhammaṃ,tantidhammam,10,8,2,0,12
416317,kurumānoti,kurumanoti,4,2,2,0,10
416318,anussaraṇasatiyā,anussaranasatiya,1,1,0,0,16
416319,puthujjanakālakiriyaṃ,puthujjanakalakiriyam,10,10,0,0,21
416320,plavantīti,plavantiti,1,0,1,0,10
416321,nibbattamuṭṭhassatino,nibbattamutthassatino,1,1,0,0,21
416322,sajjhāyamūlikā,sajjhayamulika,1,1,0,0,14
416323,vācāparicitabuddhavacanadhammā,vacaparicitabuddhavacanadhamma,1,1,0,0,30
416324,satuppādoti,satuppadoti,2,0,2,0,11
416325,buddhavacanānussaraṇasatiyā,buddhavacananussaranasatiya,1,1,0,0,27
416326,iddhisampanno,iddhisampanno,1,1,0,0,13
416327,vasibhāvapatto,vasibhavapatto,1,1,0,0,14
416328,dhammavinayoti,dhammavinayoti,6,2,4,0,14
416329,vibhāvanattho,vibhavanattho,4,4,0,0,13
416330,vaḷañjitanti,valanjitanti,3,3,0,0,12
416331,buddhavacanānussaraṇavasenetaṃ,buddhavacananussaranavasenetam,1,1,0,0,30
416332,hatthakamahābrahmā,hatthakamahabrahma,1,1,0,0,18
416333,sanaṅkumārabrahmā,sanankumarabrahma,1,1,0,0,17
416334,dhammakathikadevaputto,dhammakathikadevaputto,1,1,0,0,22
416335,sahapaṃsukīḷikāti,sahapamsukilikati,1,0,1,0,17
416336,kataparicayabhāvaṃ,kataparicayabhavam,1,1,0,0,18
416337,saṃvasamānoti,samvasamanoti,1,0,1,0,13
416338,santatakārīti,santatakariti,3,0,3,0,13
416339,sīlesūti,silesuti,9,1,8,0,8
416340,sīlajīvitaṃ,silajivitam,1,1,0,0,11
416341,saṃvohāramānoti,samvoharamanoti,1,0,1,0,15
416342,vokkamatīti,vokkamatiti,2,0,2,0,11
416343,purimakathāya,purimakathaya,8,8,0,0,13
416344,pacchimakathaṃ,pacchimakatham,1,1,0,0,14
416345,pacchimakathā,pacchimakatha,11,9,2,0,13
416346,pacchimakathāya,pacchimakathaya,4,4,0,0,15
416347,ñātibyasanenātiādīsu,natibyasanenatiadisu,1,0,1,0,20
416348,rogabyasane,rogabyasane,1,0,1,0,11
416349,ārogyavināsanato,arogyavinasanato,1,1,0,0,16
416350,sākacchāyamānoti,sakacchayamanoti,1,0,1,0,16
416351,pañhummaggo,panhummaggo,1,1,0,0,11
416352,abhinīhāroti,abhiniharoti,13,2,11,0,12
416353,pañhābhisaṅkharaṇavasena,panhabhisankharanavasena,1,1,0,0,24
416354,samudāhāroti,samudaharoti,1,0,1,0,12
416355,pañhapucchanaṃ,panhapucchanam,12,10,2,0,14
416356,paccanīkasantatāya,paccanikasantataya,3,3,0,0,18
416357,atappakaṃ,atappakam,6,5,1,0,9
416358,takkena,takkena,31,29,2,0,7
416359,jānitabbakaṃ,janitabbakam,4,3,1,0,12
416360,bhaddiyasuttavaṇṇanā,bhaddiyasuttavannana,4,4,0,0,20
416361,anussavenātiādīsu,anussavenatiadisu,1,0,1,0,17
416362,anussavavacanena,anussavavacanena,1,1,0,0,16
416363,sārambhoti,sarambhoti,2,1,1,0,10
416364,kusaladhammūpasampadāyāti,kusaladhammupasampadayati,1,0,1,0,25
416365,uttānatthattā,uttanatthatta,20,20,0,0,13
416366,sāmugiyāsuttavaṇṇanā,samugiyasuttavannana,1,1,0,0,20
416367,sāmugiyāti,samugiyati,1,0,1,0,10
416368,sāmuganigamavāsino,samuganigamavasino,1,1,0,0,18
416369,byagghapajjāti,byagghapajjati,4,2,2,0,14
416370,kolanagarassa,kolanagarassa,1,1,0,0,13
416371,kolarukkhe,kolarukkhe,5,5,0,0,10
416372,kolanagaranti,kolanagaranti,2,2,0,0,13
416373,byagghapathe,byagghapathe,4,4,0,0,12
416374,byagghapajjanti,byagghapajjanti,1,1,0,0,15
416375,vasiṃsūti,vasimsuti,8,6,2,0,9
416376,byagghapajjavāsitāya,byagghapajjavasitaya,1,1,0,0,20
416377,byagghapajjavāsino,byagghapajjavasino,1,1,0,0,18
416378,pārisuddhipadhāniyaṅgānīti,parisuddhipadhaniyanganiti,2,0,2,0,26
416379,pārisuddhiatthāya,parisuddhiatthaya,1,1,0,0,17
416380,padahitabbavīriyassa,padahitabbaviriyassa,1,1,0,0,20
416381,sīlaparisodhanavīriyassetaṃ,silaparisodhanaviriyassetam,1,1,0,0,27
416382,sīlapārisuddhiparipūraṇatthāya,silaparisuddhiparipuranatthaya,1,1,0,0,30
416383,padhāniyaṅganti,padhaniyanganti,1,1,0,0,15
416384,chandotiādīsu,chandotiadisu,3,0,3,0,13
416385,anuggaṇhane,anugganhane,1,1,0,0,11
416386,kattukāmatāchandoti,kattukamatachandoti,1,1,0,0,19
416387,vīriyapaggahanatthaṃ,viriyapaggahanattham,1,1,0,0,20
416388,virājetīti,virajetiti,3,1,2,0,10
416389,rāgapaccayesu,ragapaccayesu,1,1,0,0,13
416390,iṭṭhārammaṇesu,ittharammanesu,3,3,0,0,14
416391,vimocetabbaṃ,vimocetabbam,2,2,0,0,12
416392,virājetvāti,virajetvati,7,0,7,0,11
416393,virattaṃ,virattam,34,26,8,0,8
416394,arahattaphalavimuttiṃ,arahattaphalavimuttim,3,3,0,0,21
416395,vappasuttavaṇṇanā,vappasuttavannana,3,3,0,0,17
416396,vappoti,vappoti,1,0,1,0,7
416397,nigaṇṭhasāvakoti,niganthasavakoti,4,1,3,0,16
416398,sīhasenāpati,sihasenapati,1,1,0,0,12
416399,upāligahapati,upaligahapati,1,1,0,0,13
416400,saṃvutattā,samvutatta,2,2,0,0,10
416401,pihitattā,pihitatta,7,7,0,0,9
416402,avijjāvirāgāti,avijjaviragati,4,1,3,0,14
416403,vijjuppādāti,vijjuppadati,4,0,4,0,12
416404,maggavijjāya,maggavijjaya,2,2,0,0,12
416405,kāyasamārambhapaccayāti,kayasamarambhapaccayati,1,0,1,0,23
416406,kāyakammapaccayena,kayakammapaccayena,1,1,0,0,18
416407,vighātapariḷāhāti,vighataparilahati,4,0,4,0,17
416408,pariḷāhoti,parilahoti,7,1,6,0,10
416409,ñāṇavajjhaṃ,nanavajjham,1,1,0,0,11
416410,vipākavajjhaṃ,vipakavajjham,1,1,0,0,13
416411,vipākaphassena,vipakaphassena,1,1,0,0,14
416412,nijjarāti,nijjarati,3,1,2,0,9
416413,kilesajīraṇakapaṭipadā,kilesajiranakapatipada,1,1,0,0,22
416414,catusaccavavatthānaṃ,catusaccavavatthanam,1,1,0,0,20
416415,satatavihāre,satatavihare,2,2,0,0,12
416416,vimuttacittassātiādimāha,vimuttacittassatiadimaha,1,0,1,0,24
416417,vimuttacittassāti,vimuttacittassati,2,0,2,0,17
416418,satatavihārāti,satataviharati,4,0,4,0,14
416419,niccavihārā,niccavihara,2,2,0,0,11
416420,nibaddhavihārā,nibaddhavihara,1,1,0,0,14
416421,satisampajaññapariggahitāya,satisampajannapariggahitaya,1,1,0,0,27
416422,majjhattākāralakkhaṇāya,majjhattakaralakkhanaya,1,1,0,0,23
416423,kāyantikaṃ,kayantikam,2,1,1,0,10
416424,kāyaparicchinnaṃ,kayaparicchinnam,2,2,0,0,16
416425,pañcadvārakāyo,pancadvarakayo,6,4,2,0,14
416426,pañcadvārikavedananti,pancadvarikavedananti,2,2,0,0,21
416427,jīvitantikaṃ,jivitantikam,2,1,1,0,12
416428,jīvitaparicchinnaṃ,jivitaparicchinnam,2,2,0,0,18
416429,manodvārikavedananti,manodvarikavedananti,2,2,0,0,20
416430,pañcadvārikavedanā,pancadvarikavedana,4,4,0,0,18
416431,manodvārikavedanā,manodvarikavedana,4,2,2,0,17
416432,vatthurūpasmiṃyeva,vatthurupasmimyeva,2,2,0,0,18
416433,pañcadvārikā,pancadvarika,4,4,0,0,12
416434,vīsativassakāle,visativassakale,10,10,0,0,15
416435,paṇṇāsavassakāle,pannasavassakale,2,2,0,0,16
416436,saṭṭhivassakālato,satthivassakalato,4,4,0,0,17
416437,parihāyamānā,parihayamana,9,9,0,0,12
416438,asītinavutivassakāle,asitinavutivassakale,5,5,0,0,20
416439,nipajjimhā,nipajjimha,2,2,0,0,10
416440,adhimattānipi,adhimattanipi,2,2,0,0,13
416441,rūpādiārammaṇāni,rupadiarammanani,6,6,0,0,16
416442,sugandhaduggandhaṃ,sugandhaduggandham,1,1,0,0,18
416443,sāduasāduṃ,saduasadum,1,1,0,0,10
416444,thaddhamudukaṃ,thaddhamudukam,2,2,0,0,14
416445,jānāmātipi,janamatipi,1,1,0,0,10
416446,hadayakoṭiṃyeva,hadayakotimyeva,2,2,0,0,15
416447,pañcaudakamaggasampannaṃ,pancaudakamaggasampannam,4,2,2,0,24
416448,udakamaggehi,udakamaggehi,2,2,0,0,12
416449,antovāpiyaṃ,antovapiyam,5,5,0,0,11
416450,pūreyya,pureyya,10,10,0,0,7
416451,udakamagge,udakamagge,2,2,0,0,10
416452,gāvutaḍḍhayojanamattaṃ,gavutaddhayojanamattam,4,4,0,0,22
416453,niddhamanatumbe,niddhamanatumbe,3,3,0,0,15
416454,sassapākakāle,sassapakakale,2,2,0,0,13
416455,āvāṭesuyeva,avatesuyeva,4,4,0,0,11
416456,saṇṭhaheya,santhaheya,1,1,0,0,10
416457,mahāvāpiyaṃ,mahavapiyam,2,2,0,0,11
416458,āvāṭānaṃ,avatanam,5,5,0,0,8
416459,pūraṇakālo,puranakalo,3,3,0,0,10
416460,manodvārikavedanāya,manodvarikavedanaya,5,5,0,0,19
416461,patiṭṭhitakālo,patitthitakalo,5,5,0,0,14
416462,pañcamaggānaṃ,pancamagganam,1,1,0,0,13
416463,pañcadvārikavedanāya,pancadvarikavedanaya,4,4,0,0,20
416464,adhimattabalavabhāvo,adhimattabalavabhavo,2,2,0,0,20
416465,vāpito,vapito,2,2,0,0,6
416466,pūrāya,puraya,2,2,0,0,6
416467,niddhamanatumbesu,niddhamanatumbesu,2,2,0,0,17
416468,vivaṭesu,vivatesu,7,5,2,0,8
416469,bhaṭṭhe,bhatthe,7,4,3,0,7
416470,udakamaggesu,udakamaggesu,2,2,0,0,12
416471,parittaudakassa,parittaudakassa,1,1,0,0,15
416472,asītinavutikāle,asitinavutikale,1,1,0,0,15
416473,mandakālo,mandakalo,2,2,0,0,9
416474,hadayavatthukoṭiṃ,hadayavatthukotim,2,2,0,0,17
416475,vattabbakālo,vattabbakalo,2,2,0,0,12
416476,appavattamānāya,appavattamanaya,2,2,0,0,15
416477,pavattivipphandanadaratharahitāni,pavattivipphandanadaratharahitani,1,1,0,0,33
416478,appavattanadhammāni,appavattanadhammani,3,2,1,0,19
416479,kuddālañca,kuddalanca,1,1,0,0,10
416480,khaṇittiñca,khanittinca,1,1,0,0,11
416481,pacchiñca,pacchinca,3,3,0,0,9
416482,kuddālavaseneva,kuddalavaseneva,1,1,0,0,15
416483,palikhaṇeyyāti,palikhaneyyati,1,0,1,0,14
416484,khaṇeyya,khaneyya,13,11,2,0,8
416485,palikhaṇanakālo,palikhananakalo,1,1,0,0,15
416486,chedanakālo,chedanakalo,1,1,0,0,11
416487,karaṇakālo,karanakalo,5,5,0,0,10
416488,sakalīkaraṇakālo,sakalikaranakalo,1,1,0,0,16
416489,visosanakālo,visosanakalo,1,1,0,0,12
416490,vattamānakapañcakkhandhakālo,vattamanakapancakkhandhakalo,1,1,0,0,28
416491,ophunanakālo,ophunanakalo,1,1,0,0,12
416492,pavāhanakālo,pavahanakalo,1,1,0,0,12
416493,appaṭisandhikanirodho,appatisandhikanirodho,1,1,0,0,21
416494,ophunanappavāhanehi,ophunanappavahanehi,1,1,0,0,19
416495,apaññattikabhāvūpagamo,apannattikabhavupagamo,1,1,0,0,22
416496,anuppādena,anuppadena,2,2,0,0,10
416497,apaṇṇattikabhāvo,apannattikabhavo,1,1,0,0,16
416498,udayatthikoti,udayatthikoti,1,0,1,0,13
416499,vaḍḍhiatthiko,vaddhiatthiko,1,1,0,0,13
416500,poseyyāti,poseyyati,1,0,1,0,9
416501,assapotasatāni,assapotasatani,1,1,0,0,14
416502,vikkiṇissāmīti,vikkinissamiti,1,1,0,0,14
416503,sahassagghanakassa,sahassagghanakassa,1,1,0,0,18
416504,pañcasatamattaṃ,pancasatamattam,2,2,0,0,15
416505,gandhamālādivasena,gandhamaladivasena,1,1,0,0,18
416506,posāvanikaṃyeva,posavanikamyeva,1,1,0,0,15
416507,pāpuṇeyyunti,papuneyyunti,1,1,0,0,12
416508,nādhigaccheyyāti,nadhigaccheyyati,3,0,3,0,16
416509,vaḍḍhiñca,vaddhinca,6,6,0,0,9
416510,dinnamūlañca,dinnamulanca,1,1,0,0,12
416511,upaṭṭhahiṃ,upatthahim,33,31,2,0,10
416512,dinnadhanaṃ,dinnadhanam,3,3,0,0,11
416513,paṇiyaassajagganako,paniyaassajagganako,1,1,0,0,19
416514,caturoghanittharaṇaṃ,caturoghanittharanam,1,1,0,0,20
416515,tapojigucchāhetūti,tapojigucchahetuti,1,0,1,0,18
416516,dukkarakārikasaṅkhātena,dukkarakarikasankhatena,1,1,0,0,23
416517,pāpajigucchanahetu,papajigucchanahetu,1,1,0,0,18
416518,sāmaññaṅgaṃ,samannangam,3,2,1,0,11
416519,samaṇadhammakoṭṭhāsaṃ,samanadhammakotthasam,1,1,0,0,21
416520,aparisuddhakāyasamācārātiādīsu,aparisuddhakayasamacaratiadisu,1,0,1,0,30
416521,kāyikavācasikacetasikasīlānaṃ,kayikavacasikacetasikasilanam,1,1,0,0,29
416522,aparisuddhataṃ,aparisuddhatam,1,1,0,0,14
416523,aparisuddhājīvataṃ,aparisuddhajivatam,1,1,0,0,18
416524,ñāṇadassanāyāti,nanadassanayati,3,1,2,0,15
416525,maggañāṇasaṅkhātāya,maggananasankhataya,2,1,1,0,19
416526,arahattañāṇaphassena,arahattananaphassena,1,1,0,0,20
416527,sālarukkhaṃ,salarukkham,6,6,0,0,11
416528,ajanetabbakukkuccaṃ,ajanetabbakukkuccam,1,1,0,0,19
416529,likheyyāti,likheyyati,1,0,1,0,10
416530,avalekhanamattakena,avalekhanamattakena,1,1,0,0,19
416531,avalikheyya,avalikheyya,1,1,0,0,11
416532,dhoveyyāti,dhoveyyati,3,1,2,0,10
416533,avisuddhāti,avisuddhati,2,0,2,0,11
416534,apanītasārā,apanitasara,1,1,0,0,11
416535,sālalaṭṭhiyā,salalatthiya,2,2,0,0,12
416536,suparikammakatakālo,suparikammakatakalo,2,2,0,0,19
416537,asuddhakālo,asuddhakalo,1,1,0,0,11
416538,adhogamanaṃ,adhogamanam,1,1,0,0,11
416539,diṭṭhigatikassa,ditthigatikassa,44,43,1,0,15
416540,phiyañca,phiyanca,1,1,0,0,8
416541,arittañca,arittanca,1,1,0,0,9
416542,suvisodhitabhāvo,suvisodhitabhavo,1,1,0,0,16
416543,parisuddhasīlabhāvo,parisuddhasilabhavo,1,1,0,0,19
416544,phiyārittabandhanaṃ,phiyarittabandhanam,1,1,0,0,19
416545,kāyikacetasikavīriyakaraṇaṃ,kayikacetasikaviriyakaranam,1,1,0,0,27
416546,pārimatīragamanaṃ,parimatiragamanam,1,1,0,0,17
416547,kaṇḍacitrakānīti,kandacitrakaniti,1,0,1,0,16
416548,saralaṭṭhisararajjusarapāsādasarasāṇisarapokkharaṇisarapadumānīti,saralatthisararajjusarapasadasarasanisarapokkharanisarapadumaniti,1,1,0,0,65
416549,kattabbacitrāni,kattabbacitrani,1,1,0,0,15
416550,tīhiyeva,tihiyeva,5,5,0,0,8
416551,maggasamādhinā,maggasamadhina,12,11,1,0,14
416552,phalasamādhinā,phalasamadhina,12,10,2,0,14
416553,sammāvimuttīti,sammavimuttiti,11,3,8,0,14
416554,avijjākkhandho,avijjakkhandho,2,2,0,0,14
416555,mallikādevīsuttavaṇṇanā,mallikadevisuttavannana,3,3,0,0,23
416556,pasenadirañño,pasenadiranno,9,9,0,0,13
416557,dubbaṇṇāti,dubbannati,1,0,1,0,10
416558,bībhacchavaṇṇā,bibhacchavanna,1,1,0,0,14
416559,durūpāti,durupati,1,0,1,0,8
416560,dussaṇṭhitā,dussanthita,1,1,0,0,11
416561,supāpikāti,supapikati,1,0,1,0,10
416562,daliddāti,daliddati,2,0,2,0,9
416563,dhanadaliddā,dhanadalidda,1,1,0,0,12
416564,appassakāti,appassakati,1,0,1,0,11
416565,appabhogāti,appabhogati,1,0,1,0,11
416566,upabhogaparibhogabhaṇḍakarahitā,upabhogaparibhogabhandakarahita,1,1,0,0,31
416567,appesakkhāti,appesakkhati,6,0,6,0,12
416568,vaḷañjanakadhanena,valanjanakadhanena,2,1,1,0,18
416569,upabhogaparibhogabhaṇḍabhogena,upabhogaparibhogabhandabhogena,1,1,0,0,30
416570,mahesakkhāti,mahesakkhati,2,0,2,0,12
416571,dassanayuttā,dassanayutta,1,1,0,0,12
416572,sarīrasaṇṭhānena,sarirasanthanena,2,1,1,0,16
416573,mañcapallaṅkādisayanaṃ,mancapallankadisayanam,1,1,0,0,22
416574,āvasathoti,avasathoti,8,3,5,0,10
416575,vaṭṭitelādipadīpūpakaraṇaṃ,vattiteladipadipupakaranam,1,1,0,0,26
416576,issāmanikāti,issamanikati,1,1,0,0,12
416577,sampayuttacittā,sampayuttacitta,2,2,0,0,15
416578,kodhamanā,kodhamana,1,1,0,0,9
416579,issāvirahitacittā,issavirahitacitta,1,1,0,0,17
416580,attantapasuttavaṇṇanā,attantapasuttavannana,3,3,0,0,21
416581,acelakotiādīni,acelakotiadini,1,0,1,0,14
416582,vacchakopi,vacchakopi,1,1,0,0,10
416583,catutthapuggalaṃ,catutthapuggalam,1,1,0,0,16
416584,tathāgatotiādīni,tathagatotiadini,1,0,1,0,16
416585,dhammasāmimhi,dhammasamimhi,1,1,0,0,13
416586,sambādhova,sambadhova,3,3,0,0,10
416587,rajāpathoti,rajapathoti,3,0,3,0,11
416588,kūṭāgāraratanapāsādadevavimānādīsu,kutagararatanapasadadevavimanadisu,3,3,0,0,34
416589,pihitadvāravātapānesu,pihitadvaravatapanesu,4,4,0,0,21
416590,okāsasabbhāvato,okasasabbhavato,6,6,0,0,15
416591,pabbajeyyanti,pabbajeyyanti,7,7,0,0,13
416592,kasivaṇijjādikammaṃ,kasivanijjadikammam,4,4,0,0,19
416593,agāriyanti,agariyanti,9,9,0,0,10
416594,anagāriyāti,anagariyati,4,4,0,0,11
416595,ābandhanaṭṭhena,abandhanatthena,3,3,0,0,15
416596,pahāyātiādīni,pahayatiadini,1,0,1,0,13
416597,sāmaggiguṇaparidīpikameva,samaggigunaparidipikameva,3,3,0,0,25
416598,diṭṭhadhammikasamparāyikaatthasannissitameva,ditthadhammikasamparayikaatthasannissitameva,1,1,0,0,44
416599,nidhānamassā,nidhanamassa,4,4,0,0,12
416600,avekkhitvāva,avekkhitvava,1,1,0,0,12
416601,sālivīhiyavagodhūmakaṅguvarakakudrūsakasaṅkhātassa,salivihiyavagodhumakanguvarakakudrusakasankhatassa,3,3,0,0,50
416602,sattavidhassapi,sattavidhassapi,1,1,0,0,15
416603,āmakamaṃsamacchānaṃ,amakamamsamacchanam,5,4,1,0,19
416604,āmasananti,amasananti,1,1,0,0,10
416605,pahiṇagamanaṃ,pahinagamanam,11,5,6,0,13
416606,duteyyapahiṇagamanānaṃ,duteyyapahinagamananam,1,1,0,0,22
416607,tulākūṭā,tulakuta,2,0,2,0,8
416608,heṭṭhāchiddena,hetthachiddena,5,5,0,0,14
416609,ukkoṭanā,ukkotana,4,1,3,0,8
416610,migapotakenattho,migapotakenattho,1,1,0,0,16
416611,maṇinti,maninti,6,6,0,0,7
416612,dantakaṭṭhacchedanavāsi,dantakatthacchedanavasi,5,5,0,0,23
416613,parissāvananti,parissavananti,4,4,0,0,14
416614,parissāvanena,parissavanena,11,10,1,0,13
416615,kāyaparihārikāpi,kayapariharikapi,4,4,0,0,16
416616,kucchiparihārikāpi,kucchipariharikapi,4,4,0,0,18
416617,vicaraṇakāle,vicaranakale,24,24,0,0,12
416618,kāyaparihārikaṃ,kayapariharikam,17,15,2,0,15
416619,pivanakāle,pivanakale,7,7,0,0,10
416620,khāditabbaphalāphalaṃ,khaditabbaphalaphalam,1,1,0,0,21
416621,kucchiparihārikaṃ,kucchipariharikam,14,12,2,0,17
416622,kuṭiparibhaṇḍakaraṇakāle,kutiparibhandakaranakale,4,4,0,0,24
416623,kāyaparihāriko,kayaparihariko,4,4,0,0,14
416624,bhuñjanakāle,bhunjanakale,4,4,0,0,12
416625,kucchiparihāriko,kucchiparihariko,4,4,0,0,16
416626,vāsipi,vasipi,5,5,0,0,6
416627,dantakaṭṭhacchedanakāle,dantakatthacchedanakale,4,4,0,0,23
416628,mañcapīṭhānaṃ,mancapithanam,24,24,0,0,13
416629,aṅgapādacīvarakuṭidaṇḍakasajjanakāle,angapadacivarakutidandakasajjanakale,5,5,0,0,36
416630,kāyaparihārikā,kayapariharika,9,8,1,0,14
416631,ucchucchedananāḷikerāditacchanakāle,ucchucchedananalikeraditacchanakale,3,3,0,0,35
416632,kucchiparihārikā,kucchipariharika,9,8,1,0,16
416633,cīvarasibbanakāle,civarasibbanakale,4,4,0,0,17
416634,khādanakāle,khadanakale,15,15,0,0,11
416635,ucchuādīni,ucchuadini,9,9,0,0,10
416636,senāsanaparibhaṇḍakaraṇakāle,senasanaparibhandakaranakale,4,4,0,0,28
416637,pānīyapānakaparissāvanakāle,paniyapanakaparissavanakale,1,1,0,0,27
416638,tilataṇḍulaputhukādīni,tilatandulaputhukadini,4,4,0,0,22
416639,aṭṭhaparikkhārikassa,atthaparikkharikassa,7,7,0,0,20
416640,parikkhāramattā,parikkharamatta,4,3,1,0,15
416641,navaparikkhārikassa,navaparikkharikassa,3,3,0,0,19
416642,dasaparikkhārikassa,dasaparikkharikassa,3,3,0,0,19
416643,ekādasaparikkhārikassa,ekadasaparikkharikassa,3,3,0,0,22
416644,telanāḷikā,telanalika,6,6,0,0,10
416645,dvādasaparikkhārikassa,dvadasaparikkharikassa,3,3,0,0,22
416646,aṭṭhaparikkhārikova,atthaparikkharikova,3,3,0,0,19
416647,mahābhārāti,mahabharati,3,3,0,0,11
416648,appicchāva,appicchava,4,4,0,0,10
416649,santuṭṭhāva,santutthava,4,4,0,0,11
416650,subharāva,subharava,3,3,0,0,9
416651,sallahukavuttinova,sallahukavuttinova,3,3,0,0,18
416652,khuddakavāsiñca,khuddakavasinca,3,3,0,0,15
416653,sūciñca,sucinca,4,4,0,0,7
416654,cīvarenātiādimāha,civarenatiadimaha,2,0,2,0,17
416655,kāyapariharaṇamattakena,kayapariharanamattakena,3,3,0,0,23
416656,aṭṭhaparikkhāramattakaṃ,atthaparikkharamattakam,3,3,0,0,23
416657,seyyathāpītiādimāha,seyyathapitiadimaha,18,0,18,0,19
416658,anāsittasukhaṃ,anasittasukham,1,1,0,0,14
416659,indriyasaṃvarasukhaṃ,indriyasamvarasukham,1,1,0,0,20
416660,pacchāgamanaṃ,pacchagamanam,1,1,0,0,13
416661,satisampayuttānaṃ,satisampayuttanam,1,1,0,0,17
416662,sampajaññānaṃ,sampajannanam,3,3,0,0,13
416663,paricchinditvāyeva,paricchinditvayeva,1,1,0,0,18
416664,abhikkantapaṭikkantāni,abhikkantapatikkantani,1,1,0,0,22
416665,sāmaññaphalavaṇṇanāto,samannaphalavannanato,1,1,0,0,21
416666,satipaṭṭhānavaṇṇanāto,satipatthanavannanato,1,1,0,0,21
416667,vatthabbataṃ,vatthabbatam,2,2,0,0,12
416668,bheravasaddaṃ,bheravasaddam,15,12,3,0,13
416669,pāpakammamakāsī,papakammamakasi,1,1,0,0,15
416670,appanigghosanti,appanigghosanti,11,8,3,0,15
416671,mañcapīṭhānametaṃ,mancapithanametam,1,1,0,0,17
416672,hammiyampi,hammiyampi,4,4,0,0,10
416673,maṇḍapopi,mandapopi,6,6,0,0,9
416674,vihārasenāsanaṃ,viharasenasanam,12,6,6,0,15
416675,bimbohananti,bimbohananti,3,3,0,0,12
416676,mañcapīṭhasenāsanaṃ,mancapithasenasanam,12,5,7,0,19
416677,cimilikā,cimilika,18,12,6,0,8
416678,cammakhaṇḍo,cammakhando,21,18,3,0,11
416679,tiṇasanthāro,tinasantharo,22,21,1,0,12
416680,paṇṇasanthāroti,pannasantharoti,9,9,0,0,15
416681,santhatasenāsanaṃ,santhatasenasanam,10,4,6,0,17
416682,okāsasenāsanaṃ,okasasenasanam,8,3,5,0,14
416683,senāsanaggahaṇena,senasanaggahanena,8,6,2,0,17
416684,sakuṇasadisassa,sakunasadisassa,4,4,0,0,15
416685,dāritaṃ,daritam,5,5,0,0,7
416686,udakabhinnaṃ,udakabhinnam,1,1,0,0,12
416687,pabbatapadesaṃ,pabbatapadesam,4,4,0,0,14
416688,nitambantipi,nitambantipi,1,1,0,0,12
416689,nadīnikuñjantipi,nadinikunjantipi,1,1,0,0,16
416690,palālarāsiṃ,palalarasim,4,4,0,0,11
416691,piṇḍapātapaṭikkantoti,pindapatapatikkantoti,8,0,8,0,21
416692,piṇḍapātapariyesanato,pindapatapariyesanato,8,5,3,0,21
416693,pahāyātiādīsupi,pahayatiadisupi,7,0,7,0,15
416694,purimapakatiṃ,purimapakatim,9,6,3,0,13
416695,diṭṭhaālokasañjānanasamatthāya,ditthaalokasanjananasamatthaya,1,1,0,0,30
416696,kathamime,kathamime,4,4,0,0,9
416697,vacanatthalakkhaṇādibhedato,vacanatthalakkhanadibhedato,3,3,0,0,27
416698,ucchinditvā,ucchinditva,9,7,2,0,11
416699,dubbalīkaraṇāti,dubbalikaranati,2,1,1,0,15
416700,kāmehītiādīni,kamehitiadini,1,0,1,0,13
416701,āsavātiādi,asavatiadi,2,0,2,0,10
416702,aparenāpi,aparenapi,6,5,1,0,9
416703,catusaccappakāsanatthaṃ,catusaccappakasanattham,1,1,0,0,23
416704,bāhirasamayassa,bahirasamayassa,1,1,0,0,15
416705,nipphalabhāvaṃ,nipphalabhavam,4,4,0,0,14
416706,taṇhāsuttavaṇṇanā,tanhasuttavannana,4,4,0,0,17
416707,jālasadisaṃ,jalasadisam,1,1,0,0,11
416708,taṇhāpīti,tanhapiti,2,2,0,0,9
416709,jālinīti,jaliniti,6,1,5,0,8
416710,koṭṭhāsabhūtaṃ,kotthasabhutam,3,3,0,0,14
416711,lagitaṃ,lagitam,1,1,0,0,7
416712,mettagūmāṇavapucchāniddeso,mettagumanavapucchaniddeso,5,5,0,0,26
416713,tantākulakajātoti,tantakulakajatoti,2,0,2,0,17
416714,ākulajāto,akulajato,2,1,1,0,9
416715,nissaraṇamaggaṃ,nissaranamaggam,2,2,0,0,15
416716,gulāguṇṭhikajātoti,gulagunthikajatoti,1,0,1,0,18
416717,gulāguṇṭhikaṃ,gulagunthikam,3,2,1,0,13
416718,pesakārakañjiyasuttaṃ,pesakarakanjiyasuttam,9,6,3,0,21
416719,gulā,gula,1,1,0,0,4
416720,kulāvakotipi,kulavakotipi,3,3,0,0,12
416721,muñjapabbajabhūtoti,munjapabbajabhutoti,2,0,2,0,19
416722,pabbajatiṇaṃ,pabbajatinam,6,6,0,0,12
416723,katarajjuṃ,katarajjum,1,1,0,0,10
416724,paccattapurisakāre,paccattapurisakare,8,8,0,0,18
416725,taṇhājālena,tanhajalena,6,5,1,0,11
416726,vaḍḍhisaṅkhātassa,vaddhisankhatassa,5,5,0,0,17
416727,apāyāti,apayati,6,1,5,0,7
416728,gatibhāvato,gatibhavato,4,4,0,0,11
416729,cutinti,cutinti,4,4,0,0,7
416730,vātakkhittanāvā,vatakkhittanava,1,1,0,0,15
416731,paribbhamatiyeva,paribbhamatiyeva,4,4,0,0,16
416732,samūhaggāhato,samuhaggahato,1,1,0,0,13
416733,evamahampīti,evamahampiti,2,2,0,0,12
416734,sīsaññe,sisanne,1,1,0,0,7
416735,asasmi,asasmi,2,2,0,0,6
416736,itthasmītiādayo,itthasmitiadayo,1,1,0,0,15
416737,taṇhāvicaritesupi,tanhavicaritesupi,1,1,0,0,17
416738,chattiṃsāva,chattimsava,1,1,0,0,11
416739,pemasuttavaṇṇanā,pemasuttavannana,1,1,0,0,16
416740,ussenetīti,ussenetiti,1,0,1,0,10
416741,paṭisenetīti,patisenetiti,1,0,1,0,12
416742,kalahabhaṇḍanavasena,kalahabhandanavasena,3,3,0,0,20
416743,taṇhāvicaritavasena,tanhavicaritavasena,2,2,0,0,19
416744,pajjalatīti,pajjalatiti,5,1,4,0,11
416745,sampajjhāyatīti,sampajjhayatiti,1,0,1,0,15
416746,asmimānavasena,asmimanavasena,1,1,0,0,14
416747,sikkhāpadasuttavaṇṇanā,sikkhapadasuttavannana,1,1,0,0,22
416748,lāmakapurisaṃ,lamakapurisam,1,1,0,0,13
416749,tucchapurisaṃ,tucchapurisam,1,1,0,0,13
416750,mūḷhapurisaṃ,mulhapurisam,1,1,0,0,12
416751,andhīkataṃ,andhikatam,1,1,0,0,10
416752,asappurisataraṃ,asappurisataram,1,0,1,0,15
416753,assaddhammavasena,assaddhammavasena,2,2,0,0,17
416754,kāyavacīdvāravasena,kayavacidvaravasena,2,2,0,0,19
416755,aṭṭhamicchattavasena,atthamicchattavasena,1,1,0,0,20
416756,dasamicchattavasena,dasamicchattavasena,1,1,0,0,19
416757,pāpadhammasuttacatukkavaṇṇanā,papadhammasuttacatukkavannana,1,1,0,0,29
416758,para207-210,para207-210,1,1,0,0,11
416759,para207-210_an4,para207-210_an4,1,1,0,0,15
416760,saṃkiliṭṭhapuggalaṃ,samkilitthapuggalam,1,1,0,0,19
416761,anavajjapuggalaṃ,anavajjapuggalam,1,1,0,0,16
416762,aṭṭhamepi,atthamepi,11,11,0,0,9
416763,lāmakadhammaṃ,lamakadhammam,3,3,0,0,13
416764,anavajjadhammaṃ,anavajjadhammam,4,4,0,0,15
416765,agāriyappaṭipadā,agariyappatipada,1,1,0,0,16
416766,sobhentīti,sobhentiti,2,1,1,0,10
416767,diṭṭhisuttavaṇṇanā,ditthisuttavannana,1,1,0,0,18
416768,pariyāpannāpi,pariyapannapi,1,1,0,0,13
416769,akataññutāsuttavaṇṇanā,akatannutasuttavannana,1,1,0,0,22
416770,akataññutāya,akatannutaya,2,2,0,0,12
416771,akataveditāya,akataveditaya,1,1,0,0,13
416772,pāṇātipātīsuttādivaṇṇanā,panatipatisuttadivannana,1,1,0,0,24
416773,para214-217,para214-217,1,1,0,0,11
416774,para214-217_an4,para214-217_an4,1,1,0,0,15
416775,tappaṭipakkhassa,tappatipakkhassa,5,5,0,0,16
416776,sukkapakkhānaṃ,sukkapakkhanam,1,1,0,0,14
416777,anariyavohāraariyavohārānaṃ,anariyavoharaariyavoharanam,1,1,0,0,27
416778,aṭṭhamanavamadasamāni,atthamanavamadasamani,12,12,0,0,21
416779,sappaṭipakkhānaṃ,sappatipakkhanam,1,1,0,0,16
416780,assaddhammānaṃ,assaddhammanam,1,1,0,0,14
416781,sukkapakkhadhammā,sukkapakkhadhamma,1,1,0,0,17
416782,duccaritavaggavaṇṇanā,duccaritavaggavannana,3,3,0,0,21
416783,para221-231,para221-231,2,2,0,0,11
416784,para221-231_an4,para221-231_an4,2,2,0,0,15
416785,dasaakusalakammapathakammaṃ,dasaakusalakammapathakammam,5,4,1,0,27
416786,kāḷakavipākaṃ,kalakavipakam,3,3,0,0,13
416787,paṇḍarakaṃ,pandarakam,8,7,1,0,10
416788,kusalakammapathakammaṃ,kusalakammapathakammam,2,2,0,0,22
416789,paṇḍarakavipākaṃ,pandarakavipakam,1,1,0,0,16
416790,missakakammaṃ,missakakammam,6,3,3,0,13
416791,sukhadukkhavipākaṃ,sukhadukkhavipakam,7,4,3,0,18
416792,missakakammañhi,missakakammanhi,4,4,0,0,15
416793,maṅgalahatthiṭṭhānādīsu,mangalahatthitthanadisu,3,3,0,0,23
416794,rājakulepi,rajakulepi,3,3,0,0,10
416795,ubhayavipākassa,ubhayavipakassa,6,6,0,0,15
416796,asukkanti,asukkanti,3,2,1,0,9
416797,kāyadvāracetanaṃ,kayadvaracetanam,1,1,0,0,16
416798,sukhasammissaṃ,sukhasammissam,1,1,0,0,14
416799,nerayikasatte,nerayikasatte,9,9,0,0,13
416800,taṃsarikkhakā,tamsarikkhaka,2,2,0,0,13
416801,manussātiādīsu,manussatiadisu,2,0,2,0,14
416802,pārutauttarāsaṅgassa,parutauttarasangassa,1,1,0,0,20
416803,añjalipaggaṇhanantiādīnaṃ,anjalipagganhanantiadinam,1,1,0,0,25
416804,anubhavantānaṃ,anubhavantanam,5,4,1,0,14
416805,nāgasupaṇṇahatthiassādayo,nagasupannahatthiassadayo,1,1,0,0,25
416806,vivaṭṭagāminī,vivattagamini,3,2,1,0,13
416807,soṇakāyanasuttavaṇṇanā,sonakayanasuttavannana,1,1,0,0,22
416808,sikhāmoggallānoti,sikhamoggallanoti,1,0,1,0,17
416809,sīsamajjhe,sisamajjhe,1,1,0,0,10
416810,sikhāya,sikhaya,9,9,0,0,7
416811,moggallānagotto,moggallanagotto,4,3,1,0,15
416812,atītānantaradivasato,atitanantaradivasato,2,1,1,0,20
416813,dutiyādito,dutiyadito,1,1,0,0,10
416814,soṇakāyanoti,sonakayanoti,1,0,1,0,12
416815,kammasabhāvo,kammasabhavo,2,2,0,0,12
416816,kammasamārambhaṭṭhāyīti,kammasamarambhatthayiti,1,0,1,0,23
416817,kammasamārambhena,kammasamarambhena,1,1,0,0,17
416818,āyūhantova,ayuhantova,1,1,0,0,10
416819,anāyūhanto,anayuhanto,4,4,0,0,10
416820,sikkhāpadasuttādivaṇṇanā,sikkhapadasuttadivannana,3,3,0,0,24
416821,catutthādīnipi,catutthadinipi,1,1,0,0,14
416822,ubhayameva,ubhayameva,17,17,0,0,10
416823,aṅgāneva,anganeva,1,1,0,0,8
416824,bojjhaṅgesupi,bojjhangesupi,1,1,0,0,13
416825,cetanāsampayuttakammanteva,cetanasampayuttakammanteva,1,1,0,0,26
416826,saññivādā,sannivada,4,1,3,0,9
416827,āgatadvāsaṭṭhidiṭṭhiyo,agatadvasatthiditthiyo,1,1,0,0,22
416828,phalaṭṭhakasamaṇehi,phalatthakasamanehi,2,2,0,0,19
416829,maggaṭṭhakasamaṇehipi,maggatthakasamanehipi,2,2,0,0,21
416830,āraddhavipassakehipīti,araddhavipassakehipiti,2,2,0,0,22
416831,mahāparinibbāne,mahaparinibbane,12,8,4,0,15
416832,padesavattīti,padesavattiti,3,2,1,0,13
416833,āraddhavipassakaṃ,araddhavipassakam,7,6,1,0,17
416834,maggaṭṭhaṃ,maggattham,6,6,0,0,10
416835,phalaṭṭhanti,phalatthanti,4,4,0,0,12
416836,saṅghabhedakasuttavaṇṇanā,sanghabhedakasuttavannana,3,3,0,0,25
416837,vivādādhikaraṇādīsu,vivadadhikaranadisu,6,6,0,0,19
416838,vūpasantabhāvaṃ,vupasantabhavam,2,2,0,0,15
416839,vūpasamissatīti,vupasamissatiti,1,1,0,0,15
416840,vādatthāya,vadatthaya,4,4,0,0,10
416841,paṭikathentova,patikathentova,1,1,0,0,14
416842,tatrāyasmāti,tatrayasmati,1,0,1,0,12
416843,voyuñjatīti,voyunjatiti,1,0,1,0,11
416844,kāraṇavase,karanavase,4,3,1,0,10
416845,nāsessantīti,nasessantiti,1,0,1,0,12
416846,uposathappavāraṇaṃ,uposathappavaranam,5,5,0,0,18
416847,nikkaḍḍhissanti,nikkaddhissanti,2,2,0,0,15
416848,āpattibhayasuttavaṇṇanā,apattibhayasuttavannana,1,1,0,0,23
416849,sikhaṇḍake,sikhandake,1,1,0,0,10
416850,kharassarenāti,kharassarenati,2,0,2,0,14
416851,kakkhaḷasaddena,kakkhalasaddena,1,1,0,0,15
416852,paṇavenāti,panavenati,2,0,2,0,10
416853,vajjhabheriyā,vajjhabheriya,3,3,0,0,13
416854,thalaṭṭhassāti,thalatthassati,1,0,1,0,14
416855,sīsacchedārahaṃ,sisacchedaraham,1,1,0,0,15
416856,kareyyanti,kareyyanti,12,12,0,0,10
416857,paṭikarissatīti,patikarissatiti,4,1,3,0,15
416858,paridhāyāti,paridhayati,1,0,1,0,11
416859,kāḷapilotikaṃ,kalapilotikam,1,1,0,0,13
416860,musalābhipātārahaṃ,musalabhipataraham,1,1,0,0,18
416861,patiṭṭhahanto,patitthahanto,12,12,0,0,13
416862,chārikābhaṇḍikaṃ,charikabhandikam,2,1,1,0,16
416863,garahitabbachārikāpuṭena,garahitabbacharikaputena,1,1,0,0,24
416864,abhighātārahaṃ,abhighataraham,1,1,0,0,14
416865,upavādārahaṃ,upavadaraham,1,1,0,0,12
416866,pāṭidesanīyesūti,patidesaniyesuti,1,0,1,0,16
416867,paṭidesetabbesu,patidesetabbesu,1,1,0,0,15
416868,sesāpattiyo,sesapattiyo,2,2,0,0,11
416869,āpattibhayānīti,apattibhayaniti,1,0,1,0,15
416870,uppajjanakabhayāni,uppajjanakabhayani,1,1,0,0,18
416871,sikkhānisaṃsasuttavaṇṇanā,sikkhanisamsasuttavannana,2,2,0,0,25
416872,ādhipateyyā,adhipateyya,1,1,0,0,11
416873,sikkhādisaṅkhātānaṃ,sikkhadisankhatanam,1,1,0,0,19
416874,ānisaṃsādīnaṃ,anisamsadinam,1,1,0,0,13
416875,ābhisamācārikāti,abhisamacarikati,1,0,1,0,16
416876,uttamasamācārikā,uttamasamacarika,1,1,0,0,16
416877,paññattasīlassetaṃ,pannattasilassetam,1,1,0,0,18
416878,ādibrahmacariyikāti,adibrahmacariyikati,2,0,2,0,19
416879,mahāsīlānametaṃ,mahasilanametam,1,1,0,0,15
416880,niyakajjhatteyeva,niyakajjhatteyeva,1,1,0,0,17
416881,samavekkhissāmīti,samavekkhissamiti,1,0,1,0,17
416882,maggapaññāva,maggapannava,1,1,0,0,12
416883,seyyāsuttavaṇṇanā,seyyasuttavannana,1,1,0,0,17
416884,uttānakāva,uttanakava,1,1,0,0,10
416885,aṭṭhisaṅghātajaṭitā,atthisanghatajatita,2,2,0,0,19
416886,sīhavijambhanaṃ,sihavijambhanam,2,1,1,0,15
416887,thūpārahasuttavaṇṇanā,thuparahasuttavannana,1,1,0,0,21
416888,thūpakaraṇaṃ,thupakaranam,1,1,0,0,12
416889,puthujjanabhikkhussāti,puthujjanabhikkhussati,1,1,0,0,22
416890,puthujjanabhikkhūnañhi,puthujjanabhikkhunanhi,2,2,0,0,22
416891,anuññāyamāne,anunnayamane,4,4,0,0,12
416892,thūpānaṃ,thupanam,2,2,0,0,8
416893,puthujjanasīlavato,puthujjanasilavato,2,2,0,0,18
416894,parinibbutabhikkhuno,parinibbutabhikkhuno,2,2,0,0,20
416895,paṭhamavohārasuttavaṇṇanā,pathamavoharasuttavannana,3,3,0,0,25
416896,abhiññāsuttādivaṇṇanā,abhinnasuttadivannana,3,3,0,0,21
416897,para254-256,para254-256,2,2,0,0,11
416898,para254-256_an4,para254-256_an4,2,2,0,0,15
416899,saṅkhārapariggahavipassanāñāṇañca,sankharapariggahavipassananananca,1,1,0,0,33
416900,maggañāṇavijjā,maggananavijja,1,1,0,0,14
416901,sampayuttakadhammā,sampayuttakadhamma,1,1,0,0,18
416902,anariyapariyesanāti,anariyapariyesanati,2,0,2,0,19
416903,mālukyaputtasuttavaṇṇanā,malukyaputtasuttavannana,4,4,0,0,24
416904,mālukyaputtoti,malukyaputtoti,2,0,2,0,14
416905,mālukyabrāhmaṇiyā,malukyabrahmaniya,2,2,0,0,17
416906,ovādayācane,ovadayacane,1,1,0,0,11
416907,apasādetipi,apasadetipi,2,2,0,0,11
416908,ussādetipi,ussadetipi,2,2,0,0,10
416909,mahallakakāleva,mahallakakaleva,1,1,0,0,15
416910,taruṇakālepi,tarunakalepi,5,5,0,0,12
416911,ussādeti,ussadeti,9,9,0,0,8
416912,kulasuttādivaṇṇanā,kulasuttadivannana,2,2,0,0,18
416913,para258-263,para258-263,1,1,0,0,11
416914,para258-263_an4,para258-263_an4,1,1,0,0,15
416915,bhaṇḍāgārikaṭṭhāne,bhandagarikatthane,4,4,0,0,18
416916,bhikkhuvāre,bhikkhuvare,3,3,0,0,11
416917,kammapathavaggavaṇṇanā,kammapathavaggavannana,1,1,0,0,22
416918,para264-273,para264-273,1,1,0,0,11
416919,para264-273_an4,para264-273_an4,1,1,0,0,15
416920,kammapathavaggepi,kammapathavaggepi,1,1,0,0,17
416921,rāgapeyyālavaṇṇanā,ragapeyyalavannana,2,2,0,0,18
416922,para274-783,para274-783,1,1,0,0,11
416923,para274-783_an4,para274-783_an4,1,1,0,0,15
416924,para0_an5,para0_an5,2,2,0,0,9
416925,pañcakanipātaaṭṭhakathā,pancakanipataatthakatha,1,1,0,0,23
416926,pañcakanipātassa,pancakanipatassa,3,3,0,0,16
416927,vitthatasuttavaṇṇanā,vitthatasuttavannana,4,4,0,0,20
416928,hirīyitabbāni,hiriyitabbani,1,1,0,0,13
416929,ottappaniddese,ottappaniddese,2,2,0,0,14
416930,anosakkitamānaso,anosakkitamanaso,5,3,2,0,16
416931,vīriyathāmena,viriyathamena,4,4,0,0,13
416932,anoropitadhuro,anoropitadhuro,2,2,0,0,14
416933,anosakkitavīriyo,anosakkitaviriyo,3,3,0,0,16
416934,udayatthagāminiyāti,udayatthagaminiyati,11,0,11,0,19
416935,udayavayagāminiyā,udayavayagaminiya,2,2,0,0,17
416936,ariyāyāti,ariyayati,10,0,10,0,9
416937,nibbedhikāyāti,nibbedhikayati,8,0,8,0,14
416938,abhinivijjhanato,abhinivijjhanato,1,1,0,0,16
416939,nibbedhikāti,nibbedhikati,3,3,0,0,12
416940,nibbedhikā,nibbedhika,12,9,3,0,10
416941,paṭilābhasaṃvattanato,patilabhasamvattanato,5,3,2,0,21
416942,tabbipassanā,tabbipassana,1,1,0,0,12
416943,dukkhakkhayagāminiyāti,dukkhakkhayagaminiyati,7,0,7,0,22
416944,kilesadukkhañca,kilesadukkhanca,4,4,0,0,15
416945,khepayamānā,khepayamana,6,6,0,0,11
416946,dukkhakkhayagāminī,dukkhakkhayagamini,5,5,0,0,18
416947,saṃvattanatopesā,samvattanatopesa,1,1,0,0,16
416948,dukkhakkhayagāminīti,dukkhakkhayagaminiti,1,1,0,0,20
416949,samāpattisuttavaṇṇanā,samapattisuttavannana,1,1,0,0,21
416950,samāpattīti,samapattiti,14,3,11,0,11
416951,samaṅgibhāvoti,samangibhavoti,3,1,2,0,14
416952,kāmasuttavaṇṇanā,kamasuttavannana,8,8,0,0,16
416953,laḷitāti,lalitati,1,0,1,0,8
416954,tiṇalāyanaasitañceva,tinalayanaasitanceva,2,2,0,0,20
416955,tiṇavahanakājañca,tinavahanakajanca,1,1,0,0,17
416956,nīcakulānaṃ,nicakulanam,1,1,0,0,11
416957,majjhimasattānaṃ,majjhimasattanam,1,1,0,0,16
416958,kāmātveva,kamatveva,1,0,1,0,9
416959,kāmetabbavasena,kametabbavasena,1,1,0,0,15
416960,kāmāicceva,kamaicceva,1,1,0,0,10
416961,alaṃpaññoti,alampannoti,1,0,1,0,11
416962,yuttapañño,yuttapanno,1,1,0,0,10
416963,attaguttoti,attaguttoti,1,0,1,0,11
416964,pamādāyāti,pamadayati,1,0,1,0,10
416965,cavanasuttavaṇṇanā,cavanasuttavannana,3,3,0,0,18
416966,okappanasaddhāya,okappanasaddhaya,5,5,0,0,16
416967,pakkhandanasaddhāya,pakkhandanasaddhaya,1,1,0,0,19
416968,nappatiṭṭhātīti,nappatitthatiti,2,0,2,0,15
416969,appatiṭṭhānañca,appatitthananca,1,1,0,0,15
416970,patiṭṭhānañca,patitthananca,4,4,0,0,13
416971,paṭhamaagāravasuttavaṇṇanā,pathamaagaravasuttavannana,4,4,0,0,26
416972,patissoti,patissoti,3,3,0,0,9
416973,ajeṭṭhako,ajetthako,2,1,1,0,9
416974,dutiyaagāravasuttavaṇṇanā,dutiyaagaravasuttavannana,4,4,0,0,25
416975,abhājanaṃ,abhajanam,4,4,0,0,9
416976,virūḷhamūlatāya,virulhamulataya,1,1,0,0,15
416977,niccalabhāvaṃ,niccalabhavam,5,4,1,0,13
416978,ananussutasuttavaṇṇanā,ananussutasuttavannana,3,3,0,0,22
416979,saccadhammesu,saccadhammesu,1,1,0,0,13
416980,paṭijānāmīti,patijanamiti,4,2,2,0,12
416981,soḷasavidhassa,solasavidhassa,9,8,1,0,14
416982,vosānapāramiṃ,vosanaparamim,1,1,0,0,13
416983,katakiccabhāvaṃ,katakiccabhavam,4,4,0,0,15
416984,āgamanīyaguṇaṃ,agamaniyagunam,1,1,0,0,14
416985,ñāṇabalāni,nanabalani,4,4,0,0,10
416986,kūṭasuttavaṇṇanā,kutasuttavannana,4,4,0,0,16
416987,sesabalāni,sesabalani,1,1,0,0,10
416988,saṃhatāni,samhatani,1,1,0,0,9
416989,upakārakabhāvena,upakarakabhavena,5,5,0,0,16
416990,daṭṭhabbasuttavaṇṇanā,datthabbasuttavannana,5,5,0,0,21
416991,savisayasmiṃyeva,savisayasmimyeva,3,3,0,0,16
416992,lokiyalokuttaradhamme,lokiyalokuttaradhamme,5,4,1,0,21
416993,seṭṭhiputtā,setthiputta,16,16,0,0,11
416994,rājapañcamesu,rajapancamesu,3,3,0,0,13
416995,kīḷissāmā,kilissama,27,27,0,0,9
416996,gehasāmikova,gehasamikova,24,24,0,0,12
416997,gandhamālālaṅkārādīni,gandhamalalankaradini,12,12,0,0,21
416998,dutiyatatiyacatutthassa,dutiyatatiyacatutthassa,1,1,0,0,23
416999,saddhāpañcamesu,saddhapancamesu,2,2,0,0,15
417000,otarantesu,otarantesu,4,4,0,0,10
417001,saddhābalameva,saddhabalameva,1,1,0,0,14
417002,vīriyabalameva,viriyabalameva,1,1,0,0,14
417003,satibalameva,satibalameva,1,1,0,0,12
417004,samādhibalameva,samadhibalameva,1,1,0,0,15
417005,paññābalameva,pannabalameva,1,1,0,0,13
417006,purimavagge,purimavagge,3,3,0,0,11
417007,sekhabalāneva,sekhabalaneva,1,1,0,0,13
417008,karaṇḍakolavāsī,karandakolavasi,1,1,0,0,15
417009,asekhabalānī,asekhabalani,1,1,0,0,12
417010,paṭhamahitasuttavaṇṇanā,pathamahitasuttavannana,1,1,0,0,23
417011,dutiyahitasuttādivaṇṇanā,dutiyahitasuttadivannana,1,1,0,0,24
417012,para18-20,para18-20,3,3,0,0,9
417013,para18-20_an5,para18-20_an5,1,1,0,0,13
417014,asabhāgavuttikoti,asabhagavuttikoti,1,0,1,0,17
417015,asabhāgāya,asabhagaya,1,1,0,0,10
417016,jīvitavuttiyā,jivitavuttiya,9,9,0,0,13
417017,uttamasamācārabhūtaṃ,uttamasamacarabhutam,3,2,1,0,20
417018,paññattasīlaṃ,pannattasilam,3,2,1,0,13
417019,sekhapaṇṇattisīlaṃ,sekhapannattisilam,3,2,1,0,18
417020,mahāsīlāni,mahasilani,2,2,0,0,10
417021,vipassanāsammādiṭṭhiṃ,vipassanasammaditthim,5,5,0,0,21
417022,maggasamādhiñceva,maggasamadhinceva,2,2,0,0,17
417023,pabhāvantaṃ,pabhavantam,5,3,2,0,11
417024,cātubhūmakakusalacittassa,catubhumakakusalacittassa,1,1,0,0,25
417025,tadaggeneva,tadaggeneva,3,3,0,0,11
417026,lokiyassapi,lokiyassapi,2,2,0,0,11
417027,lokuttarassapi,lokuttarassapi,4,4,0,0,14
417028,cuṇṇavicuṇṇabhāvūpagamanena,cunnavicunnabhavupagamanena,2,2,0,0,27
417029,bhijjanasabhāvaṃ,bhijjanasabhavam,7,6,1,0,16
417030,khayasaṅkhātassa,khayasankhatassa,1,1,0,0,16
417031,abhiññāpaṭivedhaṃ,abhinnapativedham,1,1,0,0,17
417032,dussīlasuttavaṇṇanā,dussilasuttavannana,1,1,0,0,19
417033,hatūpanisoti,hatupanisoti,3,0,3,0,12
417034,hataupanissayo,hataupanissayo,1,1,0,0,14
417035,hatakāraṇo,hatakarano,2,2,0,0,10
417036,nāmarūpaparicchedañāṇaṃ,namarupaparicchedananam,1,1,0,0,23
417037,nibbidāvirāgoti,nibbidaviragoti,3,0,3,0,15
417038,paccavekkhaṇañāṇañca,paccavekkhananananca,7,7,0,0,20
417039,anuggahitasuttavaṇṇanā,anuggahitasuttavannana,3,3,0,0,22
417040,cetovimuttiphalātiādīsu,cetovimuttiphalatiadisu,1,0,1,0,23
417041,maggaphalasamādhi,maggaphalasamadhi,2,2,0,0,17
417042,sīlānuggahitāti,silanuggahitati,1,0,1,0,15
417043,sutānuggahitāti,sutanuggahitati,1,0,1,0,15
417044,bāhusaccena,bahusaccena,18,17,1,0,11
417045,sākacchānuggahitāti,sakacchanuggahitati,1,0,1,0,19
417046,samathānuggahitāti,samathanuggahitati,1,0,1,0,18
417047,patitapāṇake,patitapanake,1,1,0,0,12
417048,makkaṭajālaṃ,makkatajalam,1,1,0,0,12
417049,madhurambabījaropanaṃ,madhurambabijaropanam,1,1,0,0,21
417050,mariyādabandhanaṃ,mariyadabandhanam,1,1,0,0,17
417051,udakāsecanaṃ,udakasecanam,1,1,0,0,12
417052,mūlaparisodhanaṃ,mulaparisodhanam,1,1,0,0,16
417053,pāṇakaharaṇaṃ,panakaharanam,1,1,0,0,13
417054,jhānavipassanāpāripanthikasodhanavasena,jhanavipassanaparipanthikasodhanavasena,1,1,0,0,39
417055,samathānuggaṇhanaṃ,samathanugganhanam,1,1,0,0,18
417056,makkaṭajālaluñcanaṃ,makkatajalaluncanam,1,1,0,0,19
417057,balavavipassanānuggaṇhanaṃ,balavavipassananugganhanam,1,1,0,0,26
417058,anuggahitassa,anuggahitassa,3,3,0,0,13
417059,phalappadānaṃ,phalappadanam,1,1,0,0,13
417060,anuggahitāya,anuggahitaya,3,3,0,0,12
417061,mūlasammādiṭṭhiyā,mulasammaditthiya,1,1,0,0,17
417062,cetovimuttipaññāvimuttiphalappadānaṃ,cetovimuttipannavimuttiphalappadanam,1,1,0,0,36
417063,vimuttāyatanasuttavaṇṇanā,vimuttayatanasuttavannana,3,3,0,0,25
417064,vimuttāyatanānīti,vimuttayatananiti,6,0,6,0,17
417065,vimuccanakāraṇāni,vimuccanakaranani,4,4,0,0,17
417066,vimuttāyatanesu,vimuttayatanesu,1,1,0,0,15
417067,atthapaṭisaṃvedinoti,atthapatisamvedinoti,2,0,2,0,20
417068,pāḷiatthaṃ,paliattham,7,5,2,0,10
417069,dhammapaṭisaṃvedinoti,dhammapatisamvedinoti,2,0,2,0,21
417070,tuṭṭhākārabhūtā,tutthakarabhuta,6,4,2,0,15
417071,arahattaphalasamādhinā,arahattaphalasamadhina,5,5,0,0,22
417072,āgatāgataṭṭhāne,agatagatatthane,5,5,0,0,15
417073,upacārakammaṭṭhāniko,upacarakammatthaniko,2,2,0,0,20
417074,hotītiādisu,hotitiadisu,1,0,1,0,11
417075,uggaṇhantena,ugganhantena,6,6,0,0,12
417076,kammaṭṭhānapāḷidhamme,kammatthanapalidhamme,2,2,0,0,21
417077,samādhisuttavaṇṇanā,samadhisuttavannana,19,19,0,0,19
417078,pamāṇakaradhammarahitaṃ,pamanakaradhammarahitam,1,1,0,0,23
417079,patissatāti,patissatati,8,0,8,0,11
417080,maggasamādhītipi,maggasamadhitipi,1,1,0,0,16
417081,atappaniyaṭṭhena,atappaniyatthena,2,2,0,0,16
417082,kilesappaṭippassaddhiyā,kilesappatippassaddhiya,4,3,1,0,23
417083,kilesappaṭippassaddhibhāvaṃ,kilesappatippassaddhibhavam,3,2,1,0,27
417084,pañcaṅgikasuttavaṇṇanā,pancangikasuttavannana,1,1,0,0,22
417085,pahīnakilesehi,pahinakilesehi,1,1,0,0,14
417086,abhisandetīti,abhisandetiti,8,1,7,0,13
417087,sneheti,sneheti,4,4,0,0,7
417088,pavattapītisukhaṃ,pavattapitisukham,5,4,1,0,17
417089,parisandetīti,parisandetiti,3,0,3,0,13
417090,sandeti,sandeti,4,4,0,0,7
417091,bhastaṃ,bhastam,20,14,6,0,7
417092,parippharatīti,parippharatiti,4,0,4,0,14
417093,sabbakoṭṭhāsavato,sabbakotthasavato,7,3,4,0,17
417094,upādinnakasantatipavattiṭṭhāne,upadinnakasantatipavattitthane,3,3,0,0,30
417095,chavimaṃsalohitānugataṃ,chavimamsalohitanugatam,4,3,1,0,23
417096,paṭhamajjhānasukhena,pathamajjhanasukhena,3,3,0,0,20
417097,aphuṭaṃ,aphutam,10,5,5,0,7
417098,kātuñceva,katunceva,4,4,0,0,9
417099,yojetuñca,yojetunca,3,3,0,0,9
417100,sannetuñca,sannetunca,3,3,0,0,10
417101,kaṃsathāleti,kamsathaleti,3,0,3,0,12
417102,katabhājane,katabhajane,7,4,3,0,11
417103,mattikābhājanaṃ,mattikabhajanam,9,7,2,0,15
417104,sannentassa,sannentassa,4,3,1,0,11
417105,sanneyyāti,sanneyyati,3,0,3,0,10
417106,parimaddanto,parimaddanto,3,3,0,0,12
417107,snehānugatāti,snehanugatati,5,0,5,0,13
417108,udakasinehena,udakasinehena,15,13,2,0,13
417109,snehaparetāti,snehaparetati,5,0,5,0,13
417110,santarabāhirāti,santarabahirati,4,0,4,0,15
417111,antopadesena,antopadesena,3,3,0,0,12
417112,bahipadesena,bahipadesena,3,3,0,0,12
417113,phuṭāti,phutati,5,5,0,0,7
417114,pagghariṇīti,pagghariniti,3,0,3,0,12
417115,ovaṭṭikāyapi,ovattikayapi,2,2,0,0,12
417116,dutiyajjhānasukhaupamāyaṃ,dutiyajjhanasukhaupamayam,2,2,0,0,25
417117,ubbhidodakoti,ubbhidodakoti,2,0,2,0,13
417118,ubbhinnaudako,ubbhinnaudako,4,3,1,0,13
417119,uggacchanaudako,uggacchanaudako,2,2,0,0,15
417120,uppajjanaudakoti,uppajjanaudakoti,1,1,0,0,16
417121,anudasāhaṃ,anudasaham,13,11,2,0,10
417122,nānuppaveccheyyāti,nanuppaveccheyyati,2,0,2,0,18
417123,nappaveseyya,nappaveseyya,1,1,0,0,12
417124,vasseyyāti,vasseyyati,5,4,1,0,10
417125,ubbhijjitvāti,ubbhijjitvati,3,0,3,0,13
417126,rahadaṃ,rahadam,21,19,2,0,7
417127,uggacchanaudakañhi,uggacchanaudakanhi,3,3,0,0,18
417128,pavisanaudakaṃ,pavisanaudakam,3,3,0,0,14
417129,purāṇapaṇṇatiṇakaṭṭhadaṇḍakādīhi,puranapannatinakatthadandakadihi,3,3,0,0,32
417130,vuṭṭhiudakaṃ,vutthiudakam,4,4,0,0,12
417131,dhārānipātabubbuḷakehi,dharanipatabubbulakehi,1,1,0,0,22
417132,iddhinimmitamiva,iddhinimmitamiva,3,3,0,0,16
417133,aphuṭokāso,aphutokaso,6,6,0,0,10
417134,dutiyajjhānasukhaṃ,dutiyajjhanasukham,3,3,0,0,18
417135,tatiyajjhānasukhaupamāyaṃ,tatiyajjhanasukhaupamayam,2,2,0,0,25
417136,setarattanīlesu,setarattanilesu,3,3,0,0,15
417137,uppalameva,uppalameva,7,4,3,0,10
417138,ūnakasatapattaṃ,unakasatapattam,4,4,0,0,15
417139,pattaniyamaṃ,pattaniyamam,3,3,0,0,12
417140,puṇḍarīkanti,pundarikanti,5,5,0,0,12
417141,udakānuggatānīti,udakanuggataniti,4,0,4,0,16
417142,uggatāni,uggatani,3,3,0,0,8
417143,antonimuggaposīnīti,antonimuggaposiniti,9,0,9,0,19
417144,udakatalassa,udakatalassa,3,3,0,0,12
417145,nimuggāniyeva,nimugganiyeva,3,3,0,0,13
417146,catutthajjhānaupamāyaṃ,catutthajjhanaupamayam,1,1,0,0,22
417147,pariyodātenāti,pariyodatenati,4,0,4,0,14
417148,utupharaṇatthaṃ,utupharanattham,6,3,3,0,15
417149,kiliṭṭhavatthena,kilitthavatthena,3,3,0,0,16
417150,utupharaṇaṃ,utupharanam,24,17,7,0,11
417151,taṅkhaṇadhotaparisuddhena,tankhanadhotaparisuddhena,3,3,0,0,25
417152,catutthajjhānasukhena,catutthajjhanasukhena,6,6,0,0,21
417153,aphuṭo,aphuto,3,3,0,0,6
417154,catutthajjhānacittameva,catutthajjhanacittameva,3,3,0,0,23
417155,taṃsamuṭṭhānarūpaṃ,tamsamutthanarupam,3,2,1,0,18
417156,odātavatthe,odatavatthe,2,2,0,0,11
417157,aphusantepi,aphusantepi,1,1,0,0,11
417158,catutthajjhānasamuṭṭhāpitena,catutthajjhanasamutthapitena,1,1,0,0,28
417159,jhānavipassanāmaggā,jhanavipassanamagga,1,1,0,0,19
417160,aparāparena,aparaparena,1,1,0,0,11
417161,paccavekkhaṇanimittena,paccavekkhananimittena,1,1,0,0,22
417162,ṭhitakassāpi,thitakassapi,1,1,0,0,12
417163,tenevaṃ,tenevam,3,3,0,0,7
417164,udakamaṇikoti,udakamanikoti,3,0,3,0,13
417165,samekhalā,samekhala,3,3,0,0,9
417166,udakacāṭi,udakacati,6,6,0,0,9
417167,samatittikoti,samatittikoti,1,0,1,0,13
417168,samabharito,samabharito,1,1,0,0,11
417169,kākapeyyāti,kakapeyyati,5,0,5,0,11
417170,anāmetvāva,anametvava,3,3,0,0,10
417171,samabhūmiyaṃ,samabhumiyam,2,2,0,0,12
417172,vihatakhāṇuke,vihatakhanuke,2,2,0,0,13
417173,patiṭṭhāpeyyā,patitthapeyya,1,1,0,0,13
417174,maṇḍabhūmi,mandabhumi,2,2,0,0,10
417175,subhūmīti,subhumiti,2,2,0,0,9
417176,catumahāpatheti,catumahapatheti,2,0,2,0,15
417177,mahāmaggānaṃ,mahamagganam,2,2,0,0,12
417178,ājaññarathoti,ajannarathoti,2,0,2,0,13
417179,vinītaassaratho,vinitaassaratho,2,2,0,0,15
417180,odhastapatodoti,odhastapatodoti,3,0,3,0,15
417181,ṭhapitapatodo,thapitapatodo,3,3,0,0,13
417182,yoggācariyoti,yoggacariyoti,2,0,2,0,13
417183,assācariyo,assacariyo,2,2,0,0,10
417184,sāreyyāti,sareyyati,3,0,3,0,9
417185,paccāsāreyyāti,paccasareyyati,3,0,3,0,14
417186,samāpattiparikammaṃ,samapattiparikammam,1,1,0,0,19
417187,paguṇasamāpattiyā,pagunasamapattiya,1,1,0,0,17
417188,abhiññāpaṭipāṭiṃ,abhinnapatipatim,2,2,0,0,16
417189,ākaṅkhatītiādimāha,akankhatitiadimaha,1,0,1,0,18
417190,caṅkamasuttavaṇṇanā,cankamasuttavannana,4,4,0,0,19
417191,padhānakkhamoti,padhanakkhamoti,1,0,1,0,15
417192,vīriyakkhamo,viriyakkhamo,1,1,0,0,12
417193,aññatarasamādhi,annatarasamadhi,1,1,0,0,15
417194,ṭhitakena,thitakena,4,4,0,0,9
417195,gahitanimittañhi,gahitanimittanhi,1,1,0,0,16
417196,calitārammaṇe,calitarammane,1,1,0,0,13
417197,nisinnassapi,nisinnassapi,8,5,3,0,12
417198,nipannassapi,nipannassapi,3,3,0,0,12
417199,nāgitasuttavaṇṇanā,nagitasuttavannana,6,6,0,0,18
417200,uggatuggatesu,uggatuggatesu,1,1,0,0,13
417201,khattiyamahāsālabrāhmaṇamahāsālādīsu,khattiyamahasalabrahmanamahasaladisu,1,1,0,0,36
417202,macchavilopeti,macchavilopeti,7,0,7,0,14
417203,macchapacchiṃ,macchapacchim,3,2,1,0,13
417204,vikkiṇanaṭṭhāne,vikkinanatthane,1,1,0,0,15
417205,asucisukhaṃ,asucisukham,4,2,2,0,11
417206,lābhasakkārañceva,labhasakkaranceva,1,1,0,0,17
417207,vaṇṇabhaṇanañca,vannabhanananca,6,6,0,0,15
417208,gamissantīti,gamissantiti,23,11,12,0,12
417209,anubandhissantiyevāti,anubandhissantiyevati,1,1,0,0,21
417210,samāgacchatu,samagacchatu,5,5,0,0,12
417211,piyajanānaṃ,piyajananam,1,1,0,0,11
417212,asubhakammaṭṭhānānuyogaṃ,asubhakammatthananuyogam,1,1,0,0,24
417213,subhanimitteti,subhanimitteti,2,1,1,0,14
417214,rāgaṭṭhāniye,ragatthaniye,1,1,0,0,12
417215,asubhanimittānuyogassa,asubhanimittanuyogassa,1,1,0,0,22
417216,sumanasuttavaṇṇanā,sumanasuttavannana,3,3,0,0,18
417217,rājakumārīti,rajakumariti,1,0,1,0,12
417218,vipassisammāsambuddhakālasmiṃ,vipassisammasambuddhakalasmim,1,1,0,0,29
417219,nāgaresu,nagaresu,3,3,0,0,8
417220,yuddhampi,yuddhampi,4,4,0,0,9
417221,āraddhesu,araddhesu,1,1,0,0,9
417222,sabbapaṭhamadivaso,sabbapathamadivaso,1,1,0,0,18
417223,ekabhikkhampi,ekabhikkhampi,2,2,0,0,13
417224,bhojeyyaṃ,bhojeyyam,3,3,0,0,9
417225,buddhappamukho,buddhappamukho,34,33,1,0,14
417226,bhuñjissatī,bhunjissati,9,9,0,0,11
417227,sappimadhusakkharādīhi,sappimadhusakkharadihi,3,3,0,0,22
417228,sumanamālāguḷehi,sumanamalagulehi,2,2,0,0,16
417229,mālāguḷasadisaṃ,malagulasadisam,2,2,0,0,15
417230,dhātigaṇaparivutā,dhatiganaparivuta,7,6,1,0,17
417231,manāpakathā,manapakatha,2,2,0,0,11
417232,bhaṇantānaṃ,bhanantanam,4,4,0,0,11
417233,cūḷapita,culapita,2,2,0,0,8
417234,mahāpita,mahapita,1,1,0,0,8
417235,ṭhapitamha,thapitamha,2,2,0,0,10
417236,mālāpūjampi,malapujampi,1,1,0,0,11
417237,apethāti,apethati,3,2,1,0,8
417238,bhavābhavābhinibbattiyaṃ,bhavabhavabhinibbattiyam,1,1,0,0,24
417239,paritassanajīvitaṃ,paritassanajivitam,3,2,1,0,18
417240,sumanamālā,sumanamala,2,2,0,0,10
417241,piyāva,piyava,2,2,0,0,6
417242,sumanāyevā,sumanayeva,1,1,0,0,10
417243,vañcesī,vancesi,5,5,0,0,7
417244,piṇḍapātamadāsī,pindapatamadasi,2,2,0,0,15
417245,saggasampatti,saggasampatti,3,3,0,0,13
417246,pitugehe,pitugehe,3,3,0,0,8
417247,senāpatigehe,senapatigehe,1,1,0,0,12
417248,jāṇuppamāṇena,januppamanena,2,2,0,0,13
417249,paripūrayamānaṃ,paripurayamanam,1,1,0,0,15
417250,sumanavassaṃ,sumanavassam,2,2,0,0,12
417251,tvevassā,tvevassa,4,4,0,0,8
417252,avijahitasumanavassā,avijahitasumanavassa,1,1,0,0,20
417253,taṃdivasaññeva,tamdivasanneva,1,1,0,0,14
417254,katābhinīhārā,katabhinihara,10,10,0,0,13
417255,sumanātvevassā,sumanatvevassa,1,1,0,0,14
417256,vicināpento,vicinapento,1,1,0,0,11
417257,dārikāsatāni,darikasatani,2,2,0,0,12
417258,sampate,sampate,2,2,0,0,7
417259,evaṃladdhanāmāti,evamladdhanamati,1,1,0,0,16
417260,maṅgalameva,mangalameva,11,11,0,0,11
417261,mahāseṭṭhī,mahasetthi,15,14,1,0,10
417262,mātugāmasatāni,matugamasatani,5,5,0,0,14
417263,sotāpannasahassāni,sotapannasahassani,1,1,0,0,18
417264,pucchitukāmatāya,pucchitukamataya,1,1,0,0,16
417265,sāraṇīyadhammaṃ,saraniyadhammam,10,8,2,0,15
417266,sāraṇīyadhammapūrako,saraniyadhammapurako,19,19,0,0,20
417267,otāretuṃ,otaretum,5,5,0,0,8
417268,adhigaṇhi,adhiganhi,1,1,0,0,9
417269,upaṭṭhākaitthiyā,upatthakaitthiya,1,1,0,0,16
417270,sirisayanaṃ,sirisayanam,12,12,0,0,11
417271,alaṅkatapaṭiyattañca,alankatapatiyattanca,1,1,0,0,20
417272,sāraṇīyadhammanissandenā,saraniyadhammanissandena,1,1,0,0,24
417273,nīcasayane,nicasayane,1,1,0,0,10
417274,pūremīti,puremiti,3,3,0,0,8
417275,nākāsī,nakasi,9,9,0,0,6
417276,nipannosmi,nipannosmi,1,1,0,0,10
417277,nīcamañce,nicamance,1,1,0,0,9
417278,thaddhaattharaṇamatte,thaddhaattharanamatte,1,1,0,0,21
417279,nipannosīti,nipannositi,1,1,0,0,11
417280,veḷusalākāhi,velusalakahi,1,1,0,0,12
417281,pathavīdhātumattamevāti,pathavidhatumattamevati,1,1,0,0,23
417282,samaṇadevaputtā,samanadevaputta,1,1,0,0,15
417283,nīharāpessanti,niharapessanti,1,1,0,0,14
417284,kaṅkhacchedakaṃ,kankhacchedakam,1,1,0,0,15
417285,purisaheraññikaṃ,purisaherannikam,1,1,0,0,16
417286,mahāgotamadasabalaṃyeva,mahagotamadasabalamyeva,1,1,0,0,23
417287,yojāpesi,yojapesi,2,2,0,0,8
417288,jambudīpatalasmiñhi,jambudipatalasminhi,4,4,0,0,19
417289,rājakaññāti,rajakannati,1,1,0,0,11
417290,pañcarathasataparivārā,pancarathasataparivara,1,1,0,0,22
417291,idhassūti,idhassuti,1,0,1,0,9
417292,laddhalābhato,laddhalabhato,1,1,0,0,13
417293,paribhuñjanako,paribhunjanako,2,2,0,0,14
417294,bhattaggavattapūrako,bhattaggavattapurako,1,1,0,0,20
417295,adhigaṇhātīti,adhiganhatiti,3,2,1,0,13
417296,ādhipateyyenāti,adhipateyyenati,1,0,1,0,15
417297,jeṭṭhakakāraṇena,jetthakakaranena,1,1,0,0,16
417298,sesadeve,sesadeve,4,4,0,0,8
417299,mānusakenātiādīsu,manusakenatiadisu,1,0,1,0,17
417300,mahāgatimbaabhayatthero,mahagatimbaabhayatthero,1,1,0,0,23
417301,bhaṇḍāgāraamacco,bhandagaraamacco,1,1,0,0,16
417302,raṭṭhapālakulaputto,ratthapalakulaputto,1,1,0,0,19
417303,soṇaseṭṭhiputto,sonasetthiputto,1,1,0,0,15
417304,yasadārako,yasadarako,2,2,0,0,10
417305,ādhipaccenāti,adhipaccenati,2,1,1,0,13
417306,bākulattherasīvalittheraānandattherādayo,bakulattherasivalittheraanandattheradayo,1,1,0,0,40
417307,sattavassikadārako,sattavassikadarako,3,3,0,0,18
417308,paṭivijjhatu,pativijjhatu,1,1,0,0,12
417309,paṭividdhalokuttaramagge,patividdhalokuttaramagge,1,1,0,0,24
417310,ākāsadhātuyāti,akasadhatuyati,1,0,1,0,14
417311,ratanattayaguṇānaṃ,ratanattayagunanam,3,3,0,0,18
417312,vijjumālīti,vijjumaliti,1,0,1,0,11
417313,mālāsadisāya,malasadisaya,1,1,0,0,12
417314,vijjulatāya,vijjulataya,2,2,0,0,11
417315,satakūṭo,satakuto,1,1,0,0,8
417316,valāhakakūṭasatena,valahakakutasatena,2,1,1,0,18
417317,bhogaparibyūḷhoti,bhogaparibyulhoti,1,0,1,0,17
417318,dīyamānehi,diyamanehi,1,1,0,0,10
417319,sampāpitoti,sampapitoti,1,1,0,0,11
417320,cundīsuttavaṇṇanā,cundisuttavannana,3,3,0,0,17
417321,rathasatehīti,rathasatehiti,1,0,1,0,13
417322,parivutāti,parivutati,2,1,1,0,10
417323,gandhamālacuṇṇādīni,gandhamalacunnadini,1,1,0,0,19
417324,maggaphalasampayuttāni,maggaphalasampayuttani,2,1,1,0,22
417325,aggappasādasutte,aggappasadasutte,1,1,0,0,16
417326,uggahasuttavaṇṇanā,uggahasuttavannana,3,3,0,0,18
417327,bhaddiyeti,bhaddiyeti,1,0,1,0,10
417328,jātiyāvaneti,jatiyavaneti,1,0,1,0,12
417329,aropite,aropite,12,9,3,0,7
417330,ekābaddhe,ekabaddhe,22,21,1,0,9
417331,attacatutthoti,attacatutthoti,2,0,2,0,14
417332,attacatutthaṃyeva,attacatutthamyeva,2,2,0,0,17
417333,saṃvidhānena,samvidhanena,10,9,1,0,12
417334,parivisantena,parivisantena,1,1,0,0,13
417335,dussaṅgahā,dussangaha,14,11,3,0,10
417336,daharakumārikāyo,daharakumarikayo,1,1,0,0,16
417337,mahābhikkhusaṅghamajjhe,mahabhikkhusanghamajjhe,1,1,0,0,23
417338,ovadante,ovadante,1,1,0,0,8
417339,olīnamanā,olinamana,1,1,0,0,9
417340,attacatutthameva,attacatutthameva,1,1,0,0,16
417341,ovadatūti,ovadatuti,1,1,0,0,9
417342,upayogatthasmiñhi,upayogatthasminhi,1,1,0,0,17
417343,ovādānusāsanaṃ,ovadanusasanam,4,4,0,0,14
417344,gaṇhamānā,ganhamana,6,6,0,0,9
417345,harāyeyyuṃ,harayeyyum,1,1,0,0,10
417346,bhattūti,bhattuti,2,0,2,0,8
417347,pubbuṭṭhāyiniyoti,pubbutthayiniyoti,1,0,1,0,17
417348,uṭṭhānasīlā,utthanasila,2,2,0,0,11
417349,pacchānipātiniyoti,pacchanipatiniyoti,1,0,1,0,18
417350,nipajjanasīlā,nipajjanasila,1,1,0,0,13
417351,gehaparijane,gehaparijane,1,1,0,0,12
417352,upakaraṇabhaṇḍaṃ,upakaranabhandam,5,5,0,0,16
417353,gorūpādīni,gorupadini,1,1,0,0,10
417354,āgatānāgatāni,agatanagatani,1,1,0,0,13
417355,kuñcikāmuddikaṃ,kuncikamuddikam,1,1,0,0,15
417356,nipannāyapi,nipannayapi,3,3,0,0,11
417357,niddāyituṃ,niddayitum,3,3,0,0,10
417358,dāsakammakare,dasakammakare,9,9,0,0,13
417359,duhāpetvā,duhapetva,2,2,0,0,9
417360,paccakkhaṃyeva,paccakkhamyeva,1,1,0,0,14
417361,kiṃkārapaṭissāviniyoti,kimkarapatissaviniyoti,1,0,1,0,22
417362,vicaraṇasīlā,vicaranasila,1,1,0,0,12
417363,manāpacāriniyoti,manapacariniyoti,1,0,1,0,16
417364,karaṇasīlā,karanasila,2,2,0,0,10
417365,piyavādiniyoti,piyavadiniyoti,1,0,1,0,14
417366,piyameva,piyameva,11,11,0,0,8
417367,vādanasīlā,vadanasila,2,2,0,0,10
417368,catupaccayapūjāya,catupaccayapujaya,6,5,1,0,17
417369,pūjayissāma,pujayissama,7,7,0,0,11
417370,abbhāgateti,abbhagateti,1,0,1,0,11
417371,paṭipūjessāmāti,patipujessamati,1,0,1,0,15
417372,pādadhovanaudakena,padadhovanaudakena,3,3,0,0,18
417373,abbhāgatānaṃ,abbhagatanam,5,4,1,0,12
417374,pādadhovanañca,padadhovananca,1,1,0,0,14
417375,eḷakalomaṃ,elakalomam,5,5,0,0,10
417376,vijaṭanadhovanarajanaveṇikaraṇādīsu,vijatanadhovanarajanavenikaranadisu,1,1,0,0,35
417377,kappāsassa,kappasassa,4,4,0,0,10
417378,vaṭṭanapisanaphoṭanakantanādīsu,vattanapisanaphotanakantanadisu,1,1,0,0,31
417379,uṇṇākappāsasaṃvidhāne,unnakappasasamvidhane,2,1,1,0,21
417380,kārāpetumpi,karapetumpi,4,4,0,0,11
417381,akatatoti,akatatoti,1,0,1,0,9
417382,nikkammānaṃ,nikkammanam,1,1,0,0,11
417383,gilānakāle,gilanakale,8,8,0,0,10
417384,bhesajjabhojanādīni,bhesajjabhojanadini,1,1,0,0,19
417385,arogakāle,arogakale,5,5,0,0,9
417386,bhāvampi,bhavampi,1,1,0,0,8
417387,dukkaṭāni,dukkatani,69,67,2,0,9
417388,kātabbañca,katabbanca,2,2,0,0,10
417389,bhojanīyañcassāti,bhojaniyancassati,1,0,1,0,17
417390,khādanīyañca,khadaniyanca,3,3,0,0,12
417391,bhojanīyañca,bhojaniyanca,5,5,0,0,12
417392,paccaṃsenāti,paccamsenati,1,0,1,0,12
417393,paṭilabhitabbena,patilabhitabbena,1,1,0,0,16
417394,laddhabbakoṭṭhāsānurūpenāti,laddhabbakotthasanurupenati,1,1,0,0,27
417395,saṃvibhajissāmāti,samvibhajissamati,1,0,1,0,17
417396,sampādessāmāti,sampadessamati,1,0,1,0,14
417397,sampādayissāma,sampadayissama,1,1,0,0,14
417398,adhuttīti,adhuttiti,1,0,1,0,9
417399,purisadhuttasurādhuttatāvasena,purisadhuttasuradhuttatavasena,1,1,0,0,30
417400,adhuttiyo,adhuttiyo,1,1,0,0,9
417401,athenīti,atheniti,1,0,1,0,8
417402,atheniyo,atheniyo,1,1,0,0,8
417403,acoriyo,acoriyo,1,1,0,0,7
417404,asoṇḍīti,asonditi,1,0,1,0,8
417405,surāsoṇḍatādivasena,surasondatadivasena,1,1,0,0,19
417406,asoṇḍiyo,asondiyo,1,1,0,0,8
417407,sabbadātiādimāha,sabbadatiadimaha,1,0,1,0,16
417408,sotthīti,sotthiti,2,0,2,0,8
417409,suitthī,suitthi,1,1,0,0,7
417410,abhiramaṇato,abhiramanato,1,1,0,0,12
417411,nimmānaratīti,nimmanaratiti,2,1,1,0,13
417412,sīhasenāpatisuttavaṇṇanā,sihasenapatisuttavannana,2,2,0,0,24
417413,dānasūro,danasuro,5,3,2,0,8
417414,saddhāmattakeneva,saddhamattakeneva,11,10,1,0,17
417415,pariccajitumpi,pariccajitumpi,2,2,0,0,14
417416,dānapatīti,danapatiti,7,2,5,0,10
417417,dānasaṅkhātassa,danasankhatassa,5,3,2,0,15
417418,nittejabhūto,nittejabhuto,5,4,1,0,12
417419,ñāṇasomanassappatto,nanasomanassappatto,2,2,0,0,19
417420,katāvakāsāti,katavakasati,2,0,2,0,12
417421,katakusalāti,katakusalati,1,0,1,0,12
417422,modareti,modareti,1,0,1,0,8
417423,asitassāti,asitassati,3,0,3,0,10
417424,dānānisaṃsasuttavaṇṇanā,dananisamsasuttavannana,1,1,0,0,23
417425,akhaṇḍapañcasīlo,akhandapancasilo,3,3,0,0,16
417426,anukkamanto,anukkamanto,3,3,0,0,11
417427,buddhapaccekabuddhatathāgatasāvakā,buddhapaccekabuddhatathagatasavaka,1,1,0,0,34
417428,kāladānasuttavaṇṇanā,kaladanasuttavannana,1,1,0,0,20
417429,kāladānānīti,kaladananiti,1,0,1,0,12
417430,yuttadānāni,yuttadanani,1,1,0,0,11
417431,pattadānāni,pattadanani,1,1,0,0,11
417432,anucchavikadānānīti,anucchavikadananiti,1,1,0,0,19
417433,navasassānīti,navasassaniti,1,0,1,0,13
417434,aggasassāni,aggasassani,1,1,0,0,11
417435,navaphalānīti,navaphalaniti,1,0,1,0,13
417436,ārāmato,aramato,12,12,0,0,7
417437,paṭhamuppannāni,pathamuppannani,1,1,0,0,15
417438,aggaphalāni,aggaphalani,1,1,0,0,11
417439,bhāsitaññū,bhasitannu,2,1,1,0,10
417440,anumodantīti,anumodantiti,4,3,1,0,12
417441,veyyāvaṭikakammaṃ,veyyavatikakammam,1,1,0,0,17
417442,appaṭivānacittoti,appativanacittoti,2,0,2,0,17
417443,anukkaṇṭhitacitto,anukkanthitacitto,1,1,0,0,17
417444,bhojanasuttavaṇṇanā,bhojanasuttavannana,1,1,0,0,19
417445,sarīrathāmaṃ,sarirathamam,2,2,0,0,12
417446,yuttamuttappaṭibhānaṃ,yuttamuttappatibhanam,1,1,0,0,21
417447,saddhasuttavaṇṇanā,saddhasuttavannana,4,4,0,0,18
417448,anukampantīti,anukampantiti,7,3,4,0,13
417449,anuggaṇhanti,anugganhanti,13,12,1,0,12
417450,mahādumoti,mahadumoti,1,0,1,0,10
417451,khandhasampanno,khandhasampanno,1,1,0,0,15
417452,atthikāva,atthikava,2,2,0,0,9
417453,kodhamānathaddhatāya,kodhamanathaddhataya,2,1,1,0,20
417454,sammodakaṃ,sammodakam,2,1,1,0,10
417455,bharissatīti,bharissatiti,1,0,1,0,12
417456,thaññapāyanahatthapādavaḍḍhanādīhi,thannapayanahatthapadavaddhanadihi,1,1,0,0,34
417457,hatthapādadhovananhāpanayāgubhattadānādīhi,hatthapadadhovananhapanayagubhattadanadihi,1,1,0,0,42
417458,rājakulādīsu,rajakuladisu,16,13,3,0,12
417459,khettavatthuhiraññasuvaṇṇādiṃ,khettavatthuhirannasuvannadim,2,2,0,0,29
417460,rakkhante,rakkhante,1,1,0,0,9
417461,salākabhattādīni,salakabhattadini,37,35,2,0,16
417462,pavattessati,pavattessati,9,9,0,0,12
417463,paṭipajjissatīti,patipajjissatiti,3,2,1,0,16
417464,kulavaṃsānurūpāya,kulavamsanurupaya,2,1,1,0,17
417465,dāyajjārahaṃ,dayajjaraham,3,2,1,0,12
417466,tatiyadivasato,tatiyadivasato,10,8,2,0,14
417467,ovādakārīti,ovadakariti,1,0,1,0,11
417468,bhataposīti,bhatapositi,1,0,1,0,11
417469,mahāsālaputtasuttavaṇṇanā,mahasalaputtasuttavannana,1,1,0,0,25
417470,khuddakasākhāhi,khuddakasakhahi,1,1,0,0,15
417471,pattasaṅkhātena,pattasankhatena,1,1,0,0,15
417472,brahāvaneti,brahavaneti,4,0,4,0,11
417473,ādiyasuttavaṇṇanā,adiyasuttavannana,1,1,0,0,17
417474,ādiyāti,adiyati,3,0,3,0,7
417475,ādātabbakāraṇāni,adatabbakaranani,1,1,0,0,16
417476,sañcitehi,sancitehi,1,1,0,0,9
417477,avakkhipetvā,avakkhipetva,1,1,0,0,12
417478,uppāditehi,uppaditehi,1,1,0,0,10
417479,dasakusalakammaṃ,dasakusalakammam,1,1,0,0,16
417480,iṭṭhasuttavaṇṇanā,itthasuttavannana,3,3,0,0,17
417481,dānasīlādikā,danasiladika,1,1,0,0,12
417482,abhisamāgamena,abhisamagamena,1,1,0,0,14
417483,atthappaṭilābhenāti,atthappatilabhenati,2,1,1,0,19
417484,manāpadāyīsuttavaṇṇanā,manapadayisuttavannana,3,3,0,0,22
417485,uggoti,uggoti,2,0,2,0,6
417486,catumadhurayojitena,catumadhurayojitena,1,1,0,0,19
417487,sālipiṭṭhena,salipitthena,3,3,0,0,12
417488,sālapupphasadisaṃ,salapupphasadisam,1,1,0,0,17
417489,paññāyamānavaṇṭapattakesaraṃ,pannayamanavantapattakesaram,1,1,0,0,28
417490,jīrakādisambhārayutte,jirakadisambharayutte,1,1,0,0,21
417491,kolumbe,kolumbe,1,1,0,0,7
417492,gandhavāsaṃ,gandhavasam,1,1,0,0,11
417493,antarabhatte,antarabhatte,5,5,0,0,12
417494,sūkaramaṃsādīnipi,sukaramamsadinipi,1,1,0,0,17
417495,sampannabadaraṃ,sampannabadaram,1,1,0,0,15
417496,madhurarasehi,madhurarasehi,1,1,0,0,13
417497,badarehi,badarehi,1,1,0,0,8
417498,jīrakādisambhārehi,jirakadisambharehi,1,1,0,0,18
417499,ekasaṃvaccharikasūkaramaṃsaṃ,ekasamvaccharikasukaramamsam,1,1,0,0,28
417500,vinivattitatelaṃ,vinivattitatelam,1,1,0,0,16
417501,jīrakādisaṃyutte,jirakadisamyutte,1,1,0,0,16
417502,catumadhurena,catumadhurena,4,4,0,0,13
417503,upabhogaparibhogabhaṇḍaṃ,upabhogaparibhogabhandam,1,1,0,0,24
417504,aḍḍhateyyaratanaṃ,addhateyyaratanam,1,1,0,0,17
417505,sāravarabhaṇḍattā,saravarabhandatta,1,1,0,0,17
417506,añjanapisanatthāya,anjanapisanatthaya,2,2,0,0,18
417507,ujjubhūtesūti,ujjubhutesuti,1,0,1,0,13
417508,ujukesu,ujukesu,2,2,0,0,7
417509,chandasāti,chandasati,3,0,3,0,10
417510,muttacāgatāya,muttacagataya,2,2,0,0,13
417511,anapekkhacittatāya,anapekkhacittataya,1,1,0,0,18
417512,uggahitanti,uggahitanti,2,2,0,0,11
417513,khettūpameti,khettupameti,1,0,1,0,12
417514,khettasadise,khettasadise,1,1,0,0,12
417515,yathādhippāyoti,yathadhippayoti,3,1,2,0,15
417516,yathājjhāsayo,yathajjhasayo,1,1,0,0,13
417517,manussakāle,manussakale,6,5,1,0,11
417518,yatthūpapajjatīti,yatthupapajjatiti,1,0,1,0,17
417519,kulasampattīsu,kulasampattisu,2,2,0,0,14
417520,alabbhanīyaṭhānasuttavaṇṇanā,alabbhaniyathanasuttavannana,1,1,0,0,28
417521,alabbhanīyānīti,alabbhaniyaniti,1,0,1,0,15
417522,aladdhabbāni,aladdhabbani,1,1,0,0,12
417523,nacchādeyyāti,nacchadeyyati,4,0,4,0,13
417524,abbuhīti,abbuhiti,1,0,1,0,8
417525,āpadāsūti,apadasuti,58,3,55,0,9
417526,upaddavesu,upaddavesu,8,8,0,0,10
417527,atthavinicchayaññūti,atthavinicchayannuti,2,0,2,0,20
417528,kāraṇatthavinicchaye,karanatthavinicchaye,1,1,0,0,20
417529,nibbikāratāya,nibbikarataya,23,23,0,0,13
417530,porāṇakameva,poranakameva,1,1,0,0,12
417531,jappenāti,jappenati,3,0,3,0,9
417532,mantenāti,mantenati,4,0,4,0,9
417533,mahānubhāvamantaparivattanena,mahanubhavamantaparivattanena,1,1,0,0,29
417534,subhāsitenāti,subhasitenati,4,1,3,0,13
417535,subhāsitakathanena,subhasitakathanena,1,1,0,0,18
417536,anuppadānenāti,anuppadanenati,2,0,2,0,14
417537,kulavaṃsena,kulavamsena,3,3,0,0,11
417538,paveṇikathanenāti,pavenikathanenati,1,1,0,0,17
417539,jappādīsu,jappadisu,2,2,0,0,9
417540,jarādhammādīnaṃ,jaradhammadinam,1,1,0,0,15
417541,ajīraṇatādiatthaṃ,ajiranatadiattham,1,1,0,0,17
417542,parakkameyyāti,parakkameyyati,7,4,3,0,14
417543,adhivāseyyāti,adhivaseyyati,1,1,0,0,13
417544,kosalasuttavaṇṇanā,kosalasuttavannana,3,3,0,0,18
417545,upakaṇṇaketi,upakannaketi,3,0,3,0,12
417546,patitakkhandho,patitakkhandho,5,5,0,0,14
417547,pajjhāyantoti,pajjhayantoti,1,0,1,0,13
417548,appaṭibhānoti,appatibhanoti,3,0,3,0,13
417549,nippaṭibhāno,nippatibhano,3,3,0,0,12
417550,nāradasuttavaṇṇanā,naradasuttavannana,3,3,0,0,18
417551,ajjhomucchitoti,ajjhomucchitoti,2,0,2,0,15
417552,adhiomucchito,adhiomucchito,1,1,0,0,13
417553,gahaṇasabhāvāya,gahanasabhavaya,1,1,0,0,15
417554,atirekamucchāya,atirekamucchaya,2,1,1,0,15
417555,rājānubhāvenāti,rajanubhavenati,4,1,3,0,15
417556,senīhi,senihi,1,1,0,0,6
417557,pāyāsīti,payasiti,6,5,1,0,8
417558,sokasallaharaṇoti,sokasallaharanoti,1,1,0,0,17
417559,saggaparāyaṇo,saggaparayano,25,25,0,0,13
417560,āvaraṇasuttavaṇṇanā,avaranasuttavannana,2,2,0,0,19
417561,āvaraṇavasena,avaranavasena,1,1,0,0,13
417562,nīvaraṇavasena,nivaranavasena,6,4,2,0,14
417563,ajjhāruhantīti,ajjharuhantiti,1,1,0,0,14
417564,maggapaññañca,maggapannanca,4,4,0,0,13
417565,uppattinivāraṇaṭṭhena,uppattinivaranatthena,1,1,0,0,21
417566,abalāyāti,abalayati,1,0,1,0,9
417567,pañcanīvaraṇapariyonaddhattā,pancanivaranapariyonaddhatta,1,1,0,0,28
417568,apagatabalāya,apagatabalaya,1,1,0,0,13
417569,ñāṇadassanavisesaṃ,nanadassanavisesam,2,2,0,0,18
417570,naṅgalamukhānīti,nangalamukhaniti,2,1,1,0,16
417571,mātikāmukhāni,matikamukhani,1,1,0,0,13
417572,naṅgalasarikkhakattā,nangalasarikkhakatta,1,1,0,0,20
417573,naṅgalamukhānaṃ,nangalamukhanam,1,1,0,0,15
417574,vivaraṇakālo,vivaranakalo,1,1,0,0,12
417575,majjhenadiyā,majjhenadiya,2,2,0,0,12
417576,rukkhapāde,rukkhapade,4,4,0,0,10
417577,palālatiṇamattikāhi,palalatinamattikahi,1,1,0,0,19
417578,vikkhittavisaṭabyādiṇṇakālo,vikkhittavisatabyadinnakalo,1,1,0,0,27
417579,vihatavegassa,vihatavegassa,1,1,0,0,13
417580,tiṇapalālādīni,tinapalaladini,1,1,0,0,14
417581,parikaḍḍhitvā,parikaddhitva,3,3,0,0,13
417582,nibbānasāgaraṃ,nibbanasagaram,9,9,0,0,14
417583,padhāniyaṅgasuttavaṇṇanā,padhaniyangasuttavannana,1,1,0,0,24
417584,padhāniyaṅgānīti,padhaniyanganiti,3,0,3,0,16
417585,padahanabhāvo,padahanabhavo,4,2,2,0,13
417586,padhāniyo,padhaniyo,8,6,2,0,9
417587,padhāniyassa,padhaniyassa,4,4,0,0,12
417588,pasādasaddhāti,pasadasaddhati,3,3,0,0,14
417589,pasāduppatti,pasaduppatti,5,3,2,0,12
417590,appābādhoti,appabadhoti,8,2,6,0,11
417591,appātaṅkoti,appatankoti,6,0,6,0,11
417592,samavepākiniyāti,samavepakiniyati,8,0,8,0,16
417593,samavipākiniyā,samavipakiniya,1,1,0,0,14
417594,gahaṇiyāti,gahaniyati,6,1,5,0,10
417595,kammajatejodhātuyā,kammajatejodhatuya,7,7,0,0,18
417596,nāccuṇhāyāti,naccunhayati,3,0,3,0,12
417597,atisītalaggahaṇiko,atisitalaggahaniko,2,1,1,0,18
417598,sītabhīruko,sitabhiruko,1,1,0,0,11
417599,accuṇhaggahaṇiko,accunhaggahaniko,1,1,0,0,16
417600,uṇhabhīruko,unhabhiruko,1,1,0,0,11
417601,majjhimaggahaṇikassa,majjhimaggahanikassa,1,1,0,0,20
417602,āvikattāti,avikattati,3,0,3,0,10
417603,paññāsalakkhaṇapariggāhakaṃ,pannasalakkhanapariggahakam,2,2,0,0,27
417604,anibbiddhapubbe,anibbiddhapubbe,4,4,0,0,15
417605,lobhakkhandhādayo,lobhakkhandhadayo,4,4,0,0,17
417606,nibbijjhituṃ,nibbijjhitum,6,3,3,0,12
417607,khayagāminiyā,khayagaminiya,3,3,0,0,13
417608,samayasuttavaṇṇanā,samayasuttavannana,4,4,0,0,18
417609,vīriyakaraṇatthāya,viriyakaranatthaya,2,2,0,0,18
417610,mātāputtasuttavaṇṇanā,mataputtasuttavannana,3,3,0,0,21
417611,ugghātitāti,ugghatitati,1,0,1,0,11
417612,uddhumātā,uddhumata,5,5,0,0,9
417613,asihatthenāti,asihatthenati,1,0,1,0,13
417614,sīsacchedanatthāya,sisacchedanatthaya,1,1,0,0,18
417615,āgatenāpi,agatenapi,1,1,0,0,9
417616,pisācenāti,pisacenati,1,0,1,0,10
417617,āgatayakkhenāpi,agatayakkhenapi,1,1,0,0,15
417618,āsīdeti,asideti,3,0,3,0,7
417619,ghaṭṭeyya,ghatteyya,7,7,0,0,9
417620,mañjunāti,manjunati,2,0,2,0,9
417621,kāmoghavuḷhānaṃ,kamoghavulhanam,1,0,1,0,15
417622,kāmoghena,kamoghena,3,3,0,0,9
417623,vuḷhānaṃ,vulhanam,1,1,0,0,8
417624,kaḍḍhitānaṃ,kaddhitanam,1,1,0,0,11
417625,vaṭṭakālaṃ,vattakalam,1,1,0,0,10
417626,punappunabbhave,punappunabbhave,6,5,1,0,15
417627,gatāyeva,gatayeva,1,1,0,0,8
417628,akutobhayāti,akutobhayati,3,0,3,0,12
417629,pāraṅgatāti,parangatati,3,0,3,0,11
417630,upajjhāyasuttavaṇṇanā,upajjhayasuttavannana,3,3,0,0,21
417631,madhurakajātoti,madhurakajatoti,1,0,1,0,15
417632,sañjātagarubhāvo,sanjatagarubhavo,8,4,4,0,16
417633,pakkhāyantīti,pakkhayantiti,5,0,5,0,13
417634,nappaṭibhantīti,nappatibhantiti,2,0,2,0,15
417635,samathavipassanādhammāpi,samathavipassanadhammapi,1,1,0,0,24
417636,avipassantassa,avipassantassa,1,1,0,0,14
417637,anesantassa,anesantassa,1,1,0,0,11
417638,agavesantassāti,agavesantassati,1,1,0,0,15
417639,sattatiṃsadhammānaṃ,sattatimsadhammanam,2,2,0,0,19
417640,abhiṇhapaccavekkhitabbaṭhānasuttavaṇṇanā,abhinhapaccavekkhitabbathanasuttavannana,1,1,0,0,40
417641,jarādhammomhīti,jaradhammomhiti,1,0,1,0,15
417642,antojarāya,antojaraya,1,1,0,0,10
417643,kammassakotiādīsu,kammassakotiadisu,1,0,1,0,17
417644,bandhūti,bandhuti,16,11,5,0,8
417645,kammañātakoti,kammanatakoti,1,1,0,0,13
417646,dinnaphalapaṭiggāhako,dinnaphalapatiggahako,1,1,0,0,21
417647,uppannamado,uppannamado,1,1,0,0,11
417648,byantīhontīti,byantihontiti,6,0,6,0,13
417649,parivaṭumā,parivatuma,1,1,0,0,10
417650,byādhidhammātiādimāha,byadhidhammatiadimaha,1,0,1,0,21
417651,upadhirahitaṃ,upadhirahitam,2,1,1,0,13
417652,adhibhaviṃ,adhibhavim,1,1,0,0,10
417653,ṭhitosmīti,thitosmiti,4,4,0,0,10
417654,khematoti,khematoti,10,0,10,0,9
417655,abhipassatoti,abhipassatoti,1,0,1,0,13
417656,brahmacariyavāsato,brahmacariyavasato,2,2,0,0,18
417657,licchavikumārakasuttavaṇṇanā,licchavikumarakasuttavannana,1,1,0,0,28
417658,dhanūnīti,dhanuniti,1,0,1,0,9
417659,sajiyāni,sajiyani,1,1,0,0,8
417660,āropitadhanūni,aropitadhanuni,1,1,0,0,14
417661,addasūti,addasuti,1,0,1,0,8
417662,vajjirājāno,vajjirajano,7,6,1,0,11
417663,apānubhāti,apanubhati,1,0,1,0,10
417664,avaḍḍhinissitā,avaddhinissita,1,1,0,0,14
417665,mānathaddhā,manathaddha,6,5,1,0,11
417666,raṭṭhikassātiādīsu,ratthikassatiadisu,1,0,1,0,18
417667,pettaniko,pettaniko,1,0,1,0,9
417668,gāmagāmaṇikassāti,gamagamanikassati,1,0,1,0,17
417669,gāmaṇikassa,gamanikassa,1,1,0,0,11
417670,gāmasāmikassāti,gamasamikassati,1,1,0,0,15
417671,pūgagāmaṇikassāti,pugagamanikassati,1,0,1,0,17
417672,gaṇajeṭṭhakassa,ganajetthakassa,2,2,0,0,15
417673,kulesūti,kulesuti,3,0,3,0,8
417674,kārentīti,karentiti,6,1,5,0,9
417675,khettakammantasāmantasabyohāreti,khettakammantasamantasabyohareti,1,0,1,0,32
417676,khettakammantānaṃ,khettakammantanam,1,1,0,0,17
417677,anantarakkhettasāmino,anantarakkhettasamino,1,1,0,0,21
417678,rajjudaṇḍehi,rajjudandehi,1,1,0,0,12
417679,bhūmippamāṇaggāhake,bhumippamanaggahake,1,1,0,0,19
417680,sabbohāre,sabbohare,1,1,0,0,9
417681,kulappaveṇiyā,kulappaveniya,2,2,0,0,13
417682,sakkarotīti,sakkarotiti,1,0,1,0,11
417683,aggayāgubhattādīhi,aggayagubhattadihi,1,1,0,0,18
417684,kiccakaroti,kiccakaroti,1,0,1,0,11
417685,anujīvinoti,anujivinoti,4,0,4,0,11
417686,atītapaccuppanne,atitapaccuppanne,1,1,0,0,16
417687,vittisañjananoti,vittisanjananoti,1,0,1,0,16
417688,tuṭṭhijanano,tutthijanano,1,1,0,0,12
417689,vuḍḍhapabbajitasuttadvayavaṇṇanā,vuddhapabbajitasuttadvayavannana,1,1,0,0,32
417690,para59-60,para59-60,8,8,0,0,9
417691,para59-60_an5,para59-60_an5,1,1,0,0,13
417692,nipuṇoti,nipunoti,7,1,6,0,8
417693,sukhumakāraṇaññū,sukhumakaranannu,1,1,0,0,16
417694,ākappasampannoti,akappasampannoti,2,0,2,0,16
417695,samaṇākappena,samanakappena,2,2,0,0,13
417696,padakkhiṇaggāhīti,padakkhinaggahiti,1,0,1,0,17
417697,padakkhiṇato,padakkhinato,14,14,0,0,12
417698,saññāsuttadvayavaṇṇanā,sannasuttadvayavannana,2,2,0,0,22
417699,para61-62,para61-62,3,3,0,0,9
417700,para61-62_an5,para61-62_an5,1,1,0,0,13
417701,amatogadhāti,amatogadhati,5,0,5,0,12
417702,nibbānapatiṭṭhā,nibbanapatittha,4,4,0,0,15
417703,anabhiratisaññāti,anabhiratisannati,3,0,3,0,17
417704,tedhātusannivese,tedhatusannivese,1,1,0,0,16
417705,ukkaṇṭhitassa,ukkanthitassa,3,3,0,0,13
417706,vaḍḍhasuttadvayavaṇṇanā,vaddhasuttadvayavannana,1,1,0,0,23
417707,para63-64_an5,para63-64_an5,1,1,0,0,13
417708,varādāyīti,varadayiti,1,0,1,0,10
417709,ādāyako,adayako,3,3,0,0,7
417710,sākacchasuttavaṇṇanā,sakacchasuttavannana,1,1,0,0,20
417711,alaṃsākacchoti,alamsakacchoti,1,0,1,0,14
417712,sājīvasuttavaṇṇanā,sajivasuttavannana,1,1,0,0,18
417713,alaṃsājīvoti,alamsajivoti,1,0,1,0,12
417714,sājīvāya,sajivaya,1,1,0,0,8
417715,sājīvoti,sajivoti,4,1,3,0,8
417716,pañhapucchanañceva,panhapucchananceva,2,1,1,0,18
417717,pañhavissajjanañca,panhavissajjananca,1,1,0,0,18
417718,pañhapucchanavissajjanaṃ,panhapucchanavissajjanam,1,1,0,0,24
417719,samānājīvatāya,samanajivataya,1,1,0,0,14
417720,paṭhamaiddhipādasuttādivaṇṇanā,pathamaiddhipadasuttadivannana,1,1,0,0,30
417721,para67-70,para67-70,1,1,0,0,9
417722,para67-70_an5,para67-70_an5,1,1,0,0,13
417723,adhimattavīriyaṃ,adhimattaviriyam,2,2,0,0,16
417724,āgamanaiddhipāde,agamanaiddhipade,1,1,0,0,16
417725,navamadasamesu,navamadasamesu,6,6,0,0,14
417726,paṭhamacetovimuttiphalasuttavaṇṇanā,pathamacetovimuttiphalasuttavannana,1,1,0,0,35
417727,ukkhittapalighoti,ukkhittapalighoti,3,0,3,0,17
417728,avijjāpalighaṃ,avijjapaligham,5,4,1,0,14
417729,saṃkiṇṇaparikhoti,samkinnaparikhoti,2,0,2,0,17
417730,saṃsāraparikhaṃ,samsaraparikham,1,1,0,0,15
417731,saṃkiritvā,samkiritva,7,6,1,0,10
417732,abbūḷhesikoti,abbulhesikoti,3,0,3,0,13
417733,esikāthambhaṃ,esikathambham,3,3,0,0,13
417734,abbuyha,abbuyha,3,2,1,0,7
417735,niraggaḷoti,niraggaloti,4,0,4,0,11
417736,mānaddhajañca,manaddhajanca,1,1,0,0,13
417737,khandhābhisaṅkhārakilesabhārañca,khandhabhisankharakilesabharanca,1,1,0,0,32
417738,vaṭṭena,vattena,9,9,0,0,7
417739,nirodhasayanavaragatassa,nirodhasayanavaragatassa,3,3,0,0,24
417740,nagarāni,nagarani,31,30,1,0,8
417741,coranagaraṃ,coranagaram,15,15,0,0,11
417742,khemanagaraṃ,khemanagaram,13,13,0,0,12
417743,mahāyodhassa,mahayodhassa,3,3,0,0,12
417744,yāvimaṃ,yavimam,4,4,0,0,7
417745,anagaraṃ,anagaram,5,5,0,0,8
417746,esikāthambhe,esikathambhe,4,3,1,0,12
417747,dvārabāhāhi,dvarabahahi,3,3,0,0,11
417748,nagarasobhatthāya,nagarasobhatthaya,1,1,0,0,17
417749,ñātigaṇaparivuto,natiganaparivuto,5,5,0,0,16
417750,surasabhojanaṃ,surasabhojanam,5,5,0,0,14
417751,sakkāyavaṭṭaṃ,sakkayavattam,3,3,0,0,13
417752,dvattiṃsakammakāraṇāaṭṭhanavutirogapañcavīsatimahābhayehi,dvattimsakammakaranaatthanavutirogapancavisatimahabhayehi,1,1,0,0,57
417753,parimuccanaṃ,parimuccanam,3,3,0,0,12
417754,sīlasannāhaṃ,silasannaham,3,3,0,0,12
417755,paññākhaggaṃ,pannakhaggam,3,3,0,0,12
417756,taṇhesikaṃ,tanhesikam,3,3,0,0,10
417757,sadvārabāhakaṃ,sadvarabahakam,4,4,0,0,14
417758,nagarakavāṭaṃ,nagarakavatam,3,3,0,0,13
417759,pañcorambhāgiyasaṃyojanaaggaḷaṃ,pancorambhagiyasamyojanaaggalam,1,1,0,0,31
417760,kammābhisaṅkhāraṃ,kammabhisankharam,4,4,0,0,17
417761,jātisaṃsāraparikhaṃ,jatisamsaraparikham,2,2,0,0,19
417762,sobhatthāya,sobhatthaya,1,1,0,0,11
417763,ussāpitaddhaje,ussapitaddhaje,1,1,0,0,14
417764,mānaddhaje,manaddhaje,3,3,0,0,10
417765,sakkāyanagaraṃ,sakkayanagaram,7,6,1,0,14
417766,khemanagare,khemanagare,2,2,0,0,11
417767,kilesaparinibbānanagaraṃ,kilesaparinibbananagaram,1,1,0,0,24
417768,dutiyacetovimuttiphalasuttavaṇṇanā,dutiyacetovimuttiphalasuttavannana,1,1,0,0,34
417769,abhāvākārena,abhavakarena,11,11,0,0,12
417770,paṭipīḷanākārena,patipilanakarena,6,6,0,0,16
417771,anattasaññāti,anattasannati,5,2,3,0,13
417772,avasavattanākārena,avasavattanakarena,5,4,1,0,18
417773,vipassanāphalaṃ,vipassanaphalam,5,4,1,0,15
417774,paṭhamadhammavihārīsuttavaṇṇanā,pathamadhammaviharisuttavannana,1,1,0,0,31
417775,atināmetīti,atinametiti,1,0,1,0,11
417776,dhammapaññattiyāti,dhammapannattiyati,1,0,1,0,18
417777,navaṅgavasena,navangavasena,1,1,0,0,13
417778,cittasamādhiṃ,cittasamadhim,20,18,2,0,13
417779,samathakammaṭṭhāne,samathakammatthane,3,3,0,0,18
417780,hitesināti,hitesinati,4,0,4,0,10
417781,esantena,esantena,6,4,2,0,8
417782,anukampakenāti,anukampakenati,3,0,3,0,14
417783,paṭiccātipi,paticcatipi,2,2,0,0,11
417784,anukampakassa,anukampakassa,5,5,0,0,13
417785,aviparītadhammadesanā,aviparitadhammadesana,5,5,0,0,21
417786,rukkhamūlānīti,rukkhamulaniti,2,0,2,0,14
417787,suññāgārānīti,sunnagaraniti,3,0,3,0,13
417788,janavivittaṭṭhānaṃ,janavivittatthanam,3,3,0,0,18
417789,senāsanamācikkhati,senasanamacikkhati,1,1,0,0,18
417790,jhāyathāti,jhayathati,4,0,4,0,10
417791,aṭṭhatiṃsārammaṇāni,atthatimsarammanani,3,3,0,0,19
417792,upanijjhāyatha,upanijjhayatha,3,3,0,0,14
417793,samathañca,samathanca,12,12,0,0,10
417794,pamādatthāti,pamadatthati,4,0,4,0,12
417795,ahuvatthāti,ahuvatthati,11,7,4,0,11
417796,ārogyakāle,arogyakale,2,2,0,0,10
417797,sattasappāyādisampattikāle,sattasappayadisampattikale,3,3,0,0,26
417798,sammukhībhāvakāle,sammukhibhavakale,3,3,0,0,17
417799,yonisomanasikāravirahitā,yonisomanasikaravirahita,2,2,0,0,24
417800,maṅkulabhattā,mankulabhatta,1,1,0,0,13
417801,seyyasukhamiddhasukhamanuyuttā,seyyasukhamiddhasukhamanuyutta,1,1,0,0,30
417802,jarākāle,jarakale,6,6,0,0,8
417803,rogakāle,rogakale,3,3,0,0,8
417804,vipattikāle,vipattikale,4,4,0,0,11
417805,sappaṭisandhikālakiriyañca,sappatisandhikalakiriyanca,3,3,0,0,26
417806,pamādatthā,pamadattha,7,7,0,0,10
417807,dutiyadhammavihārīsuttavaṇṇanā,dutiyadhammaviharisuttavannana,1,1,0,0,30
417808,pariyattito,pariyattito,2,2,0,0,11
417809,paṭhamayodhājīvasuttavaṇṇanā,pathamayodhajivasuttavannana,3,3,0,0,28
417810,hatthiassadīnaṃ,hatthiassadinam,1,1,0,0,15
417811,hatthiassarathānañceva,hatthiassarathananceva,1,1,0,0,22
417812,jayakkhandhāvāraṭṭhānaṃ,jayakkhandhavaratthanam,1,1,0,0,23
417813,laddhapahārānaṃ,laddhapaharanam,1,1,0,0,15
417814,ujjhagghatīti,ujjhagghatiti,1,0,1,0,13
417815,vinibbeṭhetvā,vinibbethetva,1,1,0,0,13
417816,dutiyayodhājīvasuttavaṇṇanā,dutiyayodhajivasuttavannana,3,3,0,0,27
417817,asiñca,asinca,13,12,1,0,6
417818,sannayhitvāti,sannayhitvati,7,0,7,0,13
417819,sarakalāpañca,sarakalapanca,2,1,1,0,13
417820,yuddhasannivesavesena,yuddhasannivesavesena,1,1,0,0,21
417821,pariyāpādentīti,pariyapadentiti,4,0,4,0,15
417822,pariyāpādayanti,pariyapadayanti,2,2,0,0,15
417823,upalikkhantīti,upalikkhantiti,1,0,1,0,14
417824,apanentīti,apanentiti,6,5,1,0,10
417825,sakasenaṃ,sakasenam,3,3,0,0,9
417826,nīyamānoti,niyamanoti,1,0,1,0,10
417827,sesañātisantikaṃ,sesanatisantikam,1,1,0,0,16
417828,paricarantīti,paricarantiti,5,2,3,0,13
417829,pahārasodhanavaṇakappanādīni,paharasodhanavanakappanadini,1,1,0,0,28
417830,gopayanti,gopayanti,4,4,0,0,9
417831,supaṭṭhitaṃ,supatthitam,3,3,0,0,11
417832,indriyehīti,indriyehiti,9,2,7,0,11
417833,manacchaṭṭhehi,manacchatthehi,1,1,0,0,14
417834,apihitehi,apihitehi,3,3,0,0,9
417835,agopitehi,agopitehi,1,1,0,0,9
417836,rāgaparetoti,ragaparetoti,2,0,2,0,12
417837,aṭṭhikaṅkalūpamātiādīsu,atthikankalupamatiadisu,2,0,2,0,23
417838,appassādaṭṭhena,appassadatthena,5,5,0,0,15
417839,ussahissāmīti,ussahissamiti,1,0,1,0,13
417840,dhārayissāmīti,dharayissamiti,1,0,1,0,14
417841,samaṇabhāvaṃ,samanabhavam,7,7,0,0,12
417842,dhārayissāmi,dharayissami,5,5,0,0,12
417843,abhiramissāmīti,abhiramissamiti,2,1,1,0,15
417844,ukkaṇṭhissāmi,ukkanthissami,2,2,0,0,13
417845,paṭhamaanāgatabhayasuttavaṇṇanā,pathamaanagatabhayasuttavannana,1,1,0,0,31
417846,āraññakenāti,arannakenati,2,0,2,0,12
417847,jhānavipassanāmaggaphalappabhedassa,jhanavipassanamaggaphalappabhedassa,1,1,0,0,35
417848,saggantarāyo,saggantarayo,10,10,0,0,12
417849,ārabhāmīti,arabhamiti,4,3,1,0,10
417850,satthakāti,satthakati,1,0,1,0,10
417851,sandhibandhanacchedakavātā,sandhibandhanacchedakavata,2,2,0,0,26
417852,vāḷehīti,valehiti,2,0,2,0,8
417853,kakkhaḷehi,kakkhalehi,2,2,0,0,10
417854,māṇavehīti,manavehiti,3,0,3,0,10
417855,akatakammā,akatakamma,13,12,1,0,10
417856,nipphajjissatī,nipphajjissati,4,4,0,0,14
417857,amanussāti,amanussati,6,1,5,0,10
417858,dutiyaanāgatabhayasuttavaṇṇanā,dutiyaanagatabhayasuttavannana,1,1,0,0,30
417859,tatiyaanāgatabhayasuttavaṇṇanā,tatiyaanagatabhayasuttavannana,3,3,0,0,30
417860,vinayasandosoti,vinayasandosoti,1,0,1,0,15
417861,dhammasandosena,dhammasandosena,1,1,0,0,15
417862,aggaṇhantesu,agganhantesu,1,1,0,0,12
417863,vinayasandosenapi,vinayasandosenapi,1,1,0,0,17
417864,sīlādiuttamadhammakathaṃ,siladiuttamadhammakatham,1,1,0,0,24
417865,vedapaṭisaṃyuttaṃ,vedapatisamyuttam,1,1,0,0,17
417866,ñāṇamissakakathaṃ,nanamissakakatham,1,1,0,0,17
417867,okkamamānāti,okkamamanati,1,0,1,0,12
417868,randhagavesitāya,randhagavesitaya,1,1,0,0,16
417869,upārambhapariyesanavasena,uparambhapariyesanavasena,1,1,0,0,25
417870,kāḷakadhammaṃ,kalakadhammam,1,1,0,0,13
417871,ghaṭṭentāpi,ghattentapi,1,1,0,0,11
417872,dahantāpi,dahantapi,1,1,0,0,9
417873,lābhasakkāratthaṃ,labhasakkarattham,4,4,0,0,17
417874,okkamantiyeva,okkamantiyeva,1,1,0,0,13
417875,pāḷigambhīrā,paligambhira,1,1,0,0,12
417876,atthagambhīrā,atthagambhira,2,2,0,0,13
417877,lokuttaradhammadīpakā,lokuttaradhammadipaka,2,1,1,0,21
417878,khandhadhātuāyatanapaccayākārapaṭisaṃyuttā,khandhadhatuayatanapaccayakarapatisamyutta,1,1,0,0,42
417879,upaṭṭhapessantīti,upatthapessantiti,2,0,2,0,17
417880,ṭhapessanti,thapessanti,15,15,0,0,11
417881,vaḷañjetabbe,valanjetabbe,2,1,1,0,12
417882,silokādibandhanavasena,silokadibandhanavasena,1,1,0,0,22
417883,kāveyyāti,kaveyyati,2,1,1,0,9
417884,bāhirasāvakehi,bahirasavakehi,1,1,0,0,14
417885,catutthaanāgatabhayasuttavaṇṇanā,catutthaanagatabhayasuttavannana,3,3,0,0,32
417886,kalyāṇakāmāti,kalyanakamati,1,0,1,0,13
417887,sundarakāmā,sundarakama,1,1,0,0,11
417888,rasaggānīti,rasagganiti,2,0,2,0,11
417889,uttamarasāni,uttamarasani,2,2,0,0,12
417890,sannidhikatassa,sannidhikatassa,4,4,0,0,15
417891,khaṇantopi,khanantopi,2,2,0,0,10
417892,khaṇāhīti,khanahiti,1,1,0,0,9
417893,chindantopi,chindantopi,1,1,0,0,11
417894,haritagge,haritagge,1,1,0,0,9
417895,ājīvatthāya,ajivatthaya,1,1,0,0,11
417896,paṇṇanivāpaādīni,pannanivapaadini,1,1,0,0,16
417897,ocinante,ocinante,3,3,0,0,8
417898,ocināpentena,ocinapentena,1,1,0,0,12
417899,vuddhiparihāni,vuddhiparihani,1,1,0,0,14
417900,rajanīyasuttavaṇṇanā,rajaniyasuttavannana,1,1,0,0,20
417901,vītarāgasuttavaṇṇanā,vitaragasuttavannana,1,1,0,0,20
417902,makkhīti,makkhiti,6,0,6,0,8
417903,guṇamakkhako,gunamakkhako,1,1,0,0,12
417904,paḷāsīti,palasiti,7,0,7,0,8
417905,yugaggāhalakkhaṇena,yugaggahalakkhanena,11,8,3,0,19
417906,kuhakasuttavaṇṇanā,kuhakasuttavannana,3,3,0,0,18
417907,kuhakoti,kuhakoti,1,0,1,0,8
417908,lapakoti,lapakoti,1,0,1,0,8
417909,lābhasannissitāya,labhasannissitaya,1,1,0,0,17
417910,lapanāya,lapanaya,8,8,0,0,8
417911,nemittikoti,nemittikoti,1,0,1,0,11
417912,nimittakiriyakārako,nimittakiriyakarako,1,1,0,0,19
417913,nippesikoti,nippesikoti,1,0,1,0,11
417914,nippesanakatāya,nippesanakataya,1,1,0,0,15
417915,nijigīsitāti,nijigisitati,1,0,1,0,12
417916,lābhagavesako,labhagavesako,1,1,0,0,13
417917,vuttavipallāsavasena,vuttavipallasavasena,3,3,0,0,20
417918,akkhamasuttavaṇṇanā,akkhamasuttavannana,2,2,0,0,19
417919,anadhivāsako,anadhivasako,1,1,0,0,12
417920,tadārammaṇehi,tadarammanehi,2,2,0,0,13
417921,paṭisambhidāppattasuttavaṇṇanā,patisambhidappattasuttavannana,1,1,0,0,30
417922,atthapaṭisambhidāppattoti,atthapatisambhidappattoti,1,0,1,0,25
417923,dhammapaṭisambhidāppattoti,dhammapatisambhidappattoti,1,0,1,0,26
417924,niruttipaṭisambhidāppattoti,niruttipatisambhidappattoti,1,0,1,0,27
417925,dhammaniruttīsu,dhammaniruttisu,1,1,0,0,15
417926,paṭibhānapaṭisambhidāppattoti,patibhanapatisambhidappattoti,1,0,1,0,29
417927,ñāṇāneva,nananeva,2,2,0,0,8
417928,uccāvacānīti,uccavacaniti,13,0,13,0,12
417929,mahantakhuddakāni,mahantakhuddakani,3,3,0,0,17
417930,kiṃkaraṇīyānīti,kimkaraniyaniti,3,0,3,0,15
417931,khīṇāsavasīlameva,khinasavasilameva,1,1,0,0,17
417932,khīṇāsavabāhusaccameva,khinasavabahusaccameva,1,1,0,0,22
417933,kalyāṇavācāva,kalyanavacava,1,1,0,0,13
417934,therasuttavaṇṇanā,therasuttavannana,3,3,0,0,17
417935,thirabhāvappatto,thirabhavappatto,2,2,0,0,16
417936,rattaññūti,rattannuti,2,0,2,0,10
417937,atikkantānaṃ,atikkantanam,1,1,0,0,12
417938,yasanissito,yasanissito,2,1,1,0,11
417939,paṭhamasekhasuttavaṇṇanā,pathamasekhasuttavannana,4,4,0,0,24
417940,sekhassāti,sekhassati,3,0,3,0,10
417941,sikkhakassa,sikkhakassa,1,1,0,0,11
417942,sakaraṇīyassa,sakaraniyassa,3,3,0,0,13
417943,parihānāyāti,parihanayati,5,0,5,0,12
417944,upariguṇehi,uparigunehi,2,2,0,0,11
417945,parihānatthāya,parihanatthaya,1,1,0,0,14
417946,ramanakabhāvo,ramanakabhavo,4,4,0,0,13
417947,ālāpasallāpe,alapasallape,2,2,0,0,12
417948,niddāyane,niddayane,1,1,0,0,9
417949,upariguṇapaṭilābhāya,uparigunapatilabhaya,1,1,0,0,20
417950,parihānikāraṇañca,parihanikarananca,1,1,0,0,17
417951,vuddhikāraṇañca,vuddhikarananca,1,1,0,0,15
417952,parihānakāraṇaṃ,parihanakaranam,1,1,0,0,15
417953,dutiyasekhasuttavaṇṇanā,dutiyasekhasuttavannana,4,4,0,0,23
417954,viyattoti,viyattoti,4,0,4,0,9
417955,kiṃkaraṇīyesūti,kimkaraniyesuti,1,0,1,0,15
417956,samādhikammaṭṭhānaṃ,samadhikammatthanam,1,1,0,0,19
417957,ananulomikenāti,ananulomikenati,3,0,3,0,15
417958,atikālenāti,atikalenati,4,0,4,0,11
417959,atipātova,atipatova,3,3,0,0,9
417960,atidivāti,atidivati,2,0,2,0,9
417961,ābhisallekhikāti,abhisallekhikati,1,0,1,0,16
417962,kilesasallekhikā,kilesasallekhika,1,1,0,0,16
417963,cetovivaraṇasappāyāti,cetovivaranasappayati,3,0,3,0,21
417964,cittavivaraṇasaṅkhātānaṃ,cittavivaranasankhatanam,1,1,0,0,24
417965,kathanakathā,kathanakatha,5,5,0,0,12
417966,santuṭṭhikathāti,santutthikathati,3,0,3,0,16
417967,pavivekakathāti,pavivekakathati,3,0,3,0,15
417968,asaṃsaggakathāti,asamsaggakathati,3,0,3,0,16
417969,vīriyārambhakathāti,viriyarambhakathati,3,0,3,0,19
417970,ārabhathāti,arabhathati,1,1,0,0,11
417971,ekūnavīsatipaccavekkhaṇasaṅkhātaṃ,ekunavisatipaccavekkhanasankhatam,1,1,0,0,33
417972,nikāmalābhītiādīsu,nikamalabhitiadisu,1,0,1,0,18
417973,vipulalābhīti,vipulalabhiti,4,1,3,0,13
417974,sampadāsuttadvayavaṇṇanā,sampadasuttadvayavannana,1,1,0,0,24
417975,para91-92,para91-92,5,5,0,0,9
417976,para91-92_an5,para91-92_an5,1,1,0,0,13
417977,lokikāva,lokikava,1,1,0,0,8
417978,byākaraṇasuttavaṇṇanā,byakaranasuttavannana,2,2,0,0,21
417979,aññābyākaraṇānīti,annabyakarananiti,2,0,2,0,17
417980,arahattabyākaraṇāni,arahattabyakaranani,1,1,0,0,19
417981,mandabhāvena,mandabhavena,7,7,0,0,12
417982,atimūḷhabhāvena,atimulhabhavena,1,1,0,0,15
417983,adhimānenāti,adhimanenati,4,0,4,0,12
417984,adhigatamānena,adhigatamanena,4,4,0,0,14
417985,phāsuvihārasuttādivaṇṇanā,phasuviharasuttadivannana,1,1,0,0,25
417986,para94-95_an5,para94-95_an5,1,1,0,0,13
417987,phāsuvihārāti,phasuviharati,1,0,1,0,13
417988,sukhavihārā,sukhavihara,2,2,0,0,11
417989,sutadharasuttavaṇṇanā,sutadharasuttavannana,1,1,0,0,21
417990,appaṭṭhoti,appatthoti,1,0,1,0,10
417991,appasamārambho,appasamarambho,4,3,1,0,14
417992,appakiccoti,appakiccoti,2,1,1,0,11
417993,appakaraṇīyo,appakaraniyo,1,1,0,0,12
417994,subharoti,subharoti,3,2,1,0,9
417995,suposo,suposo,4,4,0,0,6
417996,susantosoti,susantosoti,1,0,1,0,11
417997,jīvitaparikkhāresūti,jivitaparikkharesuti,1,0,1,0,20
417998,jīvitasambhāresu,jivitasambharesu,1,1,0,0,16
417999,appāhāroti,appaharoti,2,1,1,0,10
418000,mandāhāro,mandaharo,1,1,0,0,9
418001,odarikabhāvaṃ,odarikabhavam,1,1,0,0,13
418002,amahagghasabhāvaṃ,amahagghasabhavam,1,1,0,0,17
418003,appamiddhoti,appamiddhoti,2,0,2,0,12
418004,bahuniddo,bahuniddo,1,1,0,0,9
418005,anavaññāya,anavannaya,1,1,0,0,10
418006,avirajjhitvāva,avirajjhitvava,5,5,0,0,14
418007,katayoggapatho,katayoggapatho,1,1,0,0,14
418008,nassatu,nassatu,20,17,3,0,7
418009,biḷāraṃ,bilaram,8,7,1,0,7
418010,paharī,pahari,7,7,0,0,6
418011,yavabhattaṃ,yavabhattam,3,3,0,0,11
418012,annabhārā,annabhara,1,1,0,0,9
418013,sabbapacchimāya,sabbapacchimaya,1,1,0,0,15
418014,yācakanesādānampi,yacakanesadanampi,1,1,0,0,17
418015,sakkaccameva,sakkaccameva,14,13,1,0,12
418016,kakudhatherasuttavaṇṇanā,kakudhatherasuttavannana,1,1,0,0,24
418017,sarīrapaṭilābho,sarirapatilabho,2,2,0,0,15
418018,gāmakkhettānīti,gamakkhettaniti,1,0,1,0,15
418019,cattālīsanti,cattalisanti,1,1,0,0,12
418020,gāvutanti,gavutanti,4,4,0,0,9
418021,diyaḍḍhagāvutaṃ,diyaddhagavutam,2,2,0,0,15
418022,diyaḍḍhagāvutanti,diyaddhagavutanti,2,2,0,0,17
418023,gāmakkhettena,gamakkhettena,2,2,0,0,13
418024,tigāvutañhissa,tigavutanhissa,2,2,0,0,14
418025,gopayissāmi,gopayissami,3,3,0,0,11
418026,rakkhassu,rakkhassu,5,5,0,0,9
418027,nāssassāti,nassassati,3,0,3,0,10
418028,samudācareyyāmāti,samudacareyyamati,2,0,2,0,17
418029,katheyyāma,katheyyama,6,6,0,0,10
418030,sārajjasuttavaṇṇanā,sarajjasuttavannana,1,1,0,0,19
418031,vesārajjakaraṇāti,vesarajjakaranati,1,0,1,0,17
418032,visāradabhāvāvahā,visaradabhavavaha,1,1,0,0,17
418033,ussaṅkitasuttavaṇṇanā,ussankitasuttavannana,1,1,0,0,21
418034,ussaṅkitaparisaṅkitoti,ussankitaparisankitoti,3,0,3,0,22
418035,ussaṅkito,ussankito,4,4,0,0,9
418036,akuppadhammopīti,akuppadhammopiti,1,0,1,0,16
418037,vesiyāgocarotiādīsu,vesiyagocarotiadisu,1,0,1,0,19
418038,abhiṇhagamanoti,abhinhagamanoti,1,1,0,0,15
418039,vidhavāti,vidhavati,7,0,7,0,9
418040,mahallikakumārikāyo,mahallikakumarikayo,1,1,0,0,19
418041,paṭisantharissāmīti,patisantharissamiti,1,0,1,0,19
418042,sāpateyyato,sapateyyato,1,1,0,0,11
418043,pidahissāmīti,pidahissamiti,1,1,0,0,13
418044,gahaṇānīti,gahananiti,4,3,1,0,10
418045,parasantakānaṃ,parasantakanam,2,2,0,0,14
418046,guyhamantāti,guyhamantati,1,0,1,0,12
418047,guhitabbamantā,guhitabbamanta,1,1,0,0,14
418048,phāsuvihārasuttavaṇṇanā,phasuviharasuttavannana,3,3,0,0,23
418049,sīlānītiādi,silanitiadi,1,0,1,0,11
418050,catupārisuddhisīlavasena,catuparisuddhisilavasena,4,4,0,0,24
418051,samādhisaṃvattanikānīti,samadhisamvattanikaniti,5,0,5,0,23
418052,maggasamādhiphalasamādhinibbattakāni,maggasamadhiphalasamadhinibbattakani,1,1,0,0,36
418053,sīlasāmaññagatoti,silasamannagatoti,2,0,2,0,17
418054,samānasīlataṃ,samanasilatam,3,2,1,0,13
418055,ekasadisasīlo,ekasadisasilo,1,1,0,0,13
418056,vipassanāsammādiṭṭhīti,vipassanasammaditthiti,1,1,0,0,22
418057,sīlabhāvena,silabhavena,2,2,0,0,11
418058,attānupekkhīti,attanupekkhiti,1,0,1,0,14
418059,parānupekkhīti,paranupekkhiti,1,0,1,0,14
418060,katākatesu,katakatesu,1,1,0,0,10
418061,apaññātoti,apannatoti,1,0,1,0,10
418062,apaññātakenāti,apannatakenati,1,0,1,0,14
418063,apaññātabhāvena,apannatabhavena,1,1,0,0,15
418064,apākaṭatāya,apakatataya,3,3,0,0,11
418065,mandapuññatāya,mandapunnataya,3,3,0,0,14
418066,paritāsaṃ,paritasam,5,4,1,0,9
418067,para107-108,para107-108,3,3,0,0,11
418068,para107-108_an5,para107-108_an5,1,1,0,0,15
418069,asekhanti,asekhanti,2,2,0,0,9
418070,cātuddisasuttādivaṇṇanā,catuddisasuttadivannana,1,1,0,0,23
418071,para109-110,para109-110,2,2,0,0,11
418072,para109-110_an5,para109-110_an5,1,1,0,0,15
418073,cātuddisoti,catuddisoti,8,0,8,0,11
418074,kulūpakasuttavaṇṇanā,kulupakasuttavannana,4,4,0,0,20
418075,asanthavavissāsīti,asanthavavissasiti,1,0,1,0,18
418076,akarontesu,akarontesu,7,7,0,0,10
418077,anāpajjantesuyeva,anapajjantesuyeva,1,1,0,0,17
418078,anissaravikappīti,anissaravikappiti,1,0,1,0,17
418079,anissarova,anissarova,1,1,0,0,10
418080,vissaṭṭhupasevīti,vissatthupaseviti,1,0,1,0,17
418081,bhinnakulāni,bhinnakulani,1,1,0,0,12
418082,ghaṭanatthāya,ghatanatthaya,3,3,0,0,13
418083,upakaṇṇakajappīti,upakannakajappiti,1,0,1,0,17
418084,pacchāsamaṇasuttavaṇṇanā,pacchasamanasuttavannana,1,1,0,0,24
418085,āpattivītikkamavacanaṃ,apattivitikkamavacanam,1,1,0,0,22
418086,opātetīti,opatetiti,14,1,13,0,9
418087,jaḍo,jado,1,1,0,0,4
418088,eḷamūgoti,elamugoti,4,0,4,0,9
418089,paggharitakheḷamukho,paggharitakhelamukho,1,1,0,0,20
418090,andhakavindasuttavaṇṇanā,andhakavindasuttavannana,4,4,0,0,24
418091,ārakkhasatinoti,arakkhasatinoti,1,0,1,0,15
418092,dvārarakkhikāya,dvararakkhikaya,1,1,0,0,15
418093,nipakkasatinoti,nipakkasatinoti,1,0,1,0,15
418094,dvārarakkhanakeneva,dvararakkhanakeneva,1,1,0,0,19
418095,samannāgatassatino,samannagatassatino,1,1,0,0,18
418096,appabhassāti,appabhassati,1,0,1,0,12
418097,appakathā,appakatha,1,1,0,0,9
418098,kammassakatajjhānavipassanāmaggaphalavasena,kammassakatajjhanavipassanamaggaphalavasena,1,1,0,0,43
418099,sammādiṭṭhiyevāti,sammaditthiyevati,1,1,0,0,17
418100,maccharinīsuttavaṇṇanā,maccharinisuttavannana,1,1,0,0,22
418101,āvāsamaccharinīti,avasamacchariniti,1,0,1,0,17
418102,maccharāyati,maccharayati,8,8,0,0,12
418103,kulamaccharinīti,kulamacchariniti,1,0,1,0,16
418104,lābhamaccharinīti,labhamacchariniti,1,0,1,0,17
418105,vaṇṇamaccharinīti,vannamacchariniti,1,0,1,0,17
418106,dhammamaccharinīti,dhammamacchariniti,1,0,1,0,18
418107,vaṇṇanāsuttādivaṇṇanā,vannanasuttadivannana,1,1,0,0,21
418108,para116-117,para116-117,1,1,0,0,11
418109,para116-117_an5,para116-117_an5,1,1,0,0,15
418110,vinipātetīti,vinipatetiti,4,2,2,0,12
418111,dinnapiṇḍapātato,dinnapindapatato,2,2,0,0,16
418112,issukinīti,issukiniti,1,0,1,0,10
418113,dutiyaupaṭṭhākasuttavaṇṇanā,dutiyaupatthakasuttavannana,1,1,0,0,27
418114,nappaṭibaloti,nappatibaloti,1,0,1,0,13
418115,āmisantaroti,amisantaroti,3,0,3,0,12
418116,āmisahetuko,amisahetuko,2,2,0,0,11
418117,paccāsīsamāno,paccasisamano,8,8,0,0,13
418118,anāyussāsuttadvayavaṇṇanā,anayussasuttadvayavannana,1,1,0,0,25
418119,para125-126_an5,para125-126_an5,1,1,0,0,15
418120,anāyussāti,anayussati,1,0,1,0,10
418121,āyupacchedanā,ayupacchedana,1,1,0,0,13
418122,āyuvaḍḍhanā,ayuvaddhana,1,1,0,0,11
418123,vapakāsasuttavaṇṇanā,vapakasasuttavannana,1,1,0,0,20
418124,asaṅghasobhanatāya,asanghasobhanataya,1,1,0,0,18
418125,ovādānusāsanippaṭibaddhattā,ovadanusasanippatibaddhatta,1,1,0,0,27
418126,cātuddisattā,catuddisatta,6,6,0,0,12
418127,saṅghasobhanatāya,sanghasobhanataya,1,1,0,0,17
418128,parikuppasuttavaṇṇanā,parikuppasuttavannana,1,1,0,0,21
418129,āpāyikāti,apayikati,5,0,5,0,9
418130,nirayagāmino,nirayagamino,3,3,0,0,12
418131,parikuppāti,parikuppati,1,0,1,0,11
418132,parikuppanasabhāvā,parikuppanasabhava,1,1,0,0,18
418133,purāṇavaṇasadisā,puranavanasadisa,1,1,0,0,16
418134,atekicchāti,atekicchati,1,0,1,0,11
418135,akattabbaparikammā,akattabbaparikamma,1,1,0,0,18
418136,paṭhamacakkānuvattanasuttavaṇṇanā,pathamacakkanuvattanasuttavannana,3,3,0,0,33
418137,dasakusaladhammena,dasakusaladhammena,1,1,0,0,18
418138,atthaññūti,atthannuti,3,0,3,0,10
418139,dhammaññūti,dhammannuti,2,0,2,0,11
418140,paveṇidhammaṃ,pavenidhammam,3,3,0,0,13
418141,balamhi,balamhi,1,1,0,0,7
418142,kālaññūti,kalannuti,3,0,3,0,9
418143,rajjasukhānubhavanakālaṃ,rajjasukhanubhavanakalam,1,1,0,0,24
418144,vinicchayakaraṇakālaṃ,vinicchayakaranakalam,1,1,0,0,21
418145,janapadacārikākālañca,janapadacarikakalanca,1,1,0,0,21
418146,parisaññūti,parisannuti,2,0,2,0,11
418147,brāhmaṇavessasuddasamaṇaparisāti,brahmanavessasuddasamanaparisati,1,1,0,0,32
418148,tathāgatavāre,tathagatavare,1,1,0,0,13
418149,paṭiggahaṇaparibhogamattaṃ,patiggahanaparibhogamattam,2,1,1,0,26
418150,janapadacārikāyāti,janapadacarikayati,1,1,0,0,18
418151,samaṇaparisāti,samanaparisati,1,1,0,0,14
418152,dutiyacakkānuvattanasuttavaṇṇanā,dutiyacakkanuvattanasuttavannana,3,3,0,0,32
418153,kathamesa,kathamesa,4,4,0,0,9
418154,paveṇiyaṃ,paveniyam,2,2,0,0,9
418155,kārentopi,karentopi,1,1,0,0,9
418156,pavattitameva,pavattitameva,2,1,1,0,13
418157,dhammarājāsuttavaṇṇanā,dhammarajasuttavannana,1,1,0,0,22
418158,pacchimapadadvayameva,pacchimapadadvayameva,1,1,0,0,21
418159,yassaṃdisaṃsuttavaṇṇanā,yassamdisamsuttavannana,3,3,0,0,23
418160,saṃsuddhāya,samsuddhaya,3,2,1,0,11
418161,aḍḍhotiādīsu,addhotiadisu,2,0,2,0,12
418162,aḍḍhoyeva,addhoyeva,3,3,0,0,9
418163,aparimāṇasaṅkhena,aparimanasankhena,3,2,1,0,17
418164,paripuṇṇakosakoṭṭhāgāroti,paripunnakosakotthagaroti,4,0,4,0,25
418165,bhaṇḍāgāraṃ,bhandagaram,35,31,4,0,11
418166,paripuṇṇakoso,paripunnakoso,3,3,0,0,13
418167,paripuṇṇakoṭṭhāgāroti,paripunnakotthagaroti,2,2,0,0,21
418168,raṭṭhanti,ratthanti,2,2,0,0,9
418169,koṭṭhāgāraṃ,kotthagaram,21,14,7,0,11
418170,dhanakoṭṭhāgāraṃ,dhanakotthagaram,5,4,1,0,16
418171,dhaññakoṭṭhāgāraṃ,dhannakotthagaram,3,3,0,0,17
418172,vatthakoṭṭhāgāranti,vatthakotthagaranti,2,2,0,0,19
418173,paripuṇṇamassāti,paripunnamassati,7,7,0,0,16
418174,assavāyāti,assavayati,1,0,1,0,10
418175,anassavā,anassava,10,10,0,0,8
418176,adentassāpi,adentassapi,3,3,0,0,11
418177,ovādapaṭikarāyāti,ovadapatikarayati,1,0,1,0,17
418178,dinnaovādakarāya,dinnaovadakaraya,1,1,0,0,16
418179,byattoti,byattoti,15,3,12,0,8
418180,ṭhānuppattikapaññāya,thanuppattikapannaya,2,2,0,0,20
418181,vaḍḍhiatthe,vaddhiatthe,1,1,0,0,11
418182,paccuppannaatthavaseneva,paccuppannaatthavaseneva,1,1,0,0,24
418183,vijitavijayānaṃ,vijitavijayanam,1,1,0,0,15
418184,vimuttīhi,vimuttihi,14,14,0,0,9
418185,vimuttamānasānaṃ,vimuttamanasanam,1,1,0,0,16
418186,patthanāsuttadvayavaṇṇanā,patthanasuttadvayavannana,1,1,0,0,25
418187,para135-136,para135-136,1,1,0,0,11
418188,para135-136_an5,para135-136_an5,1,1,0,0,15
418189,negamajānapadassāti,negamajanapadassati,1,0,1,0,19
418190,hatthiassarathatharudhanulekhamuddāgaṇanādīni,hatthiassarathatharudhanulekhamuddagananadini,1,1,0,0,45
418191,uparājabhāvaṃ,uparajabhavam,1,1,0,0,13
418192,appaṃsupatisuttavaṇṇanā,appamsupatisuttavannana,1,1,0,0,23
418193,purisādhippāyāti,purisadhippayati,2,0,2,0,16
418194,uppannādhippāyā,uppannadhippaya,1,1,0,0,15
418195,purisajjhāsayā,purisajjhasaya,2,2,0,0,14
418196,ādānādhippāyoti,adanadhippayoti,1,0,1,0,15
418197,sakkhissāmīti,sakkhissamiti,5,5,0,0,13
418198,gahaṇādhippāyo,gahanadhippayo,1,1,0,0,14
418199,visaṃyogādhippāyoti,visamyogadhippayoti,1,0,1,0,19
418200,pāpuṇissāmi,papunissami,11,11,0,0,11
418201,nibbānajjhāsayo,nibbanajjhasayo,2,2,0,0,15
418202,bhattādakasuttavaṇṇanā,bhattadakasuttavannana,1,1,0,0,22
418203,bhattādakoti,bhattadakoti,1,0,1,0,12
418204,bhattakkhādako,bhattakkhadako,1,1,0,0,14
418205,bahubhattabhuñjoti,bahubhattabhunjoti,1,1,0,0,18
418206,okāsapharaṇoti,okasapharanoti,1,0,1,0,14
418207,pātetīti,patetiti,13,6,7,0,8
418208,gaṇanakāle,gananakale,1,1,0,0,10
418209,nisīdanasayanavasena,nisidanasayanavasena,1,1,0,0,20
418210,bhikkhugaṇanakāle,bhikkhugananakale,1,1,0,0,17
418211,hatthighaṭaṃ,hatthighatam,1,1,0,0,12
418212,vimānitoti,vimanitoti,1,0,1,0,10
418213,tiṇodakadānena,tinodakadanena,1,1,0,0,14
418214,ekadivasamattaṃ,ekadivasamattam,4,4,0,0,15
418215,aladdhatiṇodakoti,aladdhatinodakoti,1,1,0,0,17
418216,sotasuttavaṇṇanā,sotasuttavannana,3,3,0,0,16
418217,pavattitānaṃ,pavattitanam,15,15,0,0,12
418218,pharusavacanānaṃ,pharusavacananam,1,1,0,0,16
418219,dukkhuppādanākārena,dukkhuppadanakarena,1,1,0,0,19
418220,tāpanasabhāvānaṃ,tapanasabhavanam,1,1,0,0,16
418221,appāyituṃ,appayitum,1,1,0,0,9
418222,sabbasaṅkhārasamathādivasena,sabbasankharasamathadivasena,1,1,0,0,28
418223,apadissatīti,apadissatiti,6,6,0,0,12
418224,avajānātisuttavaṇṇanā,avajanatisuttavannana,3,3,0,0,21
418225,saṃvāsenāti,samvasenati,4,0,4,0,11
418226,ekatovāsena,ekatovasena,2,2,0,0,11
418227,ādeyyamukhoti,adeyyamukhoti,1,0,1,0,13
418228,ādiyanamukho,adiyanamukho,1,1,0,0,12
418229,gahaṇamukhoti,gahanamukhoti,1,1,0,0,13
418230,paṭiggahetumeva,patiggahetumeva,4,4,0,0,15
418231,appamattake,appamattake,11,11,0,0,11
418232,paṭippharituṃ,patippharitum,1,1,0,0,13
418233,saddahanaṭṭhena,saddahanatthena,1,1,0,0,15
418234,ādiyanamukhoti,adiyanamukhoti,1,1,0,0,14
418235,khaṭaāvāṭo,khataavato,1,1,0,0,10
418236,parittakasaddho,parittakasaddho,1,1,0,0,15
418237,jānātītiādīsu,janatitiadisu,4,1,3,0,13
418238,sāvajje,savajje,11,10,1,0,7
418239,sadosadhamme,sadosadhamme,1,1,0,0,12
418240,niddosadhamme,niddosadhamme,1,1,0,0,13
418241,ārabhatisuttavaṇṇanā,arabhatisuttavannana,1,1,0,0,20
418242,āpattivītikkamanavasena,apattivitikkamanavasena,1,1,0,0,23
418243,arahattasamādhiñceva,arahattasamadhinceva,1,1,0,0,20
418244,pañcamanayena,pancamanayena,1,1,0,0,13
418245,vītikkamasambhave,vitikkamasambhave,1,1,0,0,17
418246,āpattidesanāya,apattidesanaya,3,3,0,0,14
418247,āpattivuṭṭhānena,apattivutthanena,1,1,0,0,16
418248,bhāvetūti,bhavetuti,1,0,1,0,9
418249,vipassanācittañca,vipassanacittanca,3,3,0,0,17
418250,upāyeneva,upayeneva,14,14,0,0,9
418251,sārandadasuttavaṇṇanā,sarandadasuttavannana,4,4,0,0,21
418252,navalokuttaradhammatthāya,navalokuttaradhammatthaya,1,1,0,0,25
418253,sahasīlakaṃ,sahasilakam,1,1,0,0,11
418254,paṭipattipūrako,patipattipurako,1,1,0,0,15
418255,tikaṇḍakīsuttavaṇṇanā,tikandakisuttavannana,1,1,0,0,21
418256,appaṭikūleti,appatikuleti,1,0,1,0,12
418257,appaṭikūlārammaṇe,appatikularammane,1,1,0,0,17
418258,paṭikūlanti,patikulanti,5,5,0,0,11
418259,ubhayasmiṃ,ubhayasmim,5,4,1,0,10
418260,purimanayassa,purimanayassa,3,3,0,0,13
418261,pacchimanayassa,pacchimanayassa,3,3,0,0,15
418262,upekkhāsadisā,upekkhasadisa,1,1,0,0,13
418263,khīṇāsavupekkhā,khinasavupekkha,1,1,0,0,15
418264,kiñcanati,kincanati,1,0,1,0,9
418265,paññuttaro,pannuttaro,6,5,1,0,10
418266,bahussutasamaṇopi,bahussutasamanopi,1,1,0,0,17
418267,mittasuttavaṇṇanā,mittasuttavannana,4,4,0,0,17
418268,khettādikammantaṃ,khettadikammantam,1,1,0,0,17
418269,bhikkhūsūti,bhikkhusuti,3,1,2,0,11
418270,disāpāmokkhesu,disapamokkhesu,1,1,0,0,14
418271,paccanīkaggāhitāya,paccanikaggahitaya,1,1,0,0,18
418272,anavatthānacārikaṃ,anavatthanacarikam,1,1,0,0,18
418273,asappurisadānasuttavaṇṇanā,asappurisadanasuttavannana,1,1,0,0,26
418274,chaḍḍetukāmo,chaddetukamo,11,9,2,0,12
418275,āgamanadiṭṭhiṃ,agamanaditthim,1,1,0,0,14
418276,parahatthena,parahatthena,2,2,0,0,12
418277,vicarantena,vicarantena,6,6,0,0,11
418278,aladdhakālassa,aladdhakalassa,1,1,0,0,14
418279,vaṭṭamokkhaṃ,vattamokkham,2,2,0,0,12
418280,bhavanissaraṇaṃ,bhavanissaranam,13,13,0,0,15
418281,āgamanadiṭṭhikoti,agamanaditthikoti,1,0,1,0,17
418282,anāgatabhavassa,anagatabhavassa,3,3,0,0,15
418283,sappurisadānasuttavaṇṇanā,sappurisadanasuttavannana,2,2,0,0,25
418284,dānaphalañca,danaphalanca,3,3,0,0,12
418285,anaggahitacittoti,anaggahitacittoti,1,0,1,0,17
418286,aggahitacitto,aggahitacitto,1,1,0,0,13
418287,anupahaccāti,anupahaccati,6,0,6,0,12
418288,anupaghātetvā,anupaghatetva,1,1,0,0,13
418289,vayovuḍḍhakāle,vayovuddhakale,1,1,0,0,14
418290,yuttappattakāle,yuttappattakale,4,4,0,0,15
418291,paṭhamavayasmiṃyeva,pathamavayasmimyeva,1,1,0,0,19
418292,paṭhamasamayavimuttasuttavaṇṇanā,pathamasamayavimuttasuttavannana,1,1,0,0,32
418293,samayavimuttassāti,samayavimuttassati,2,1,1,0,18
418294,appitappitakkhaṇeyeva,appitappitakkhaneyeva,2,2,0,0,21
418295,vikkhambhitehi,vikkhambhitehi,4,4,0,0,14
418296,samayavimuttisaṅkhātāya,samayavimuttisankhataya,1,1,0,0,23
418297,lokiyavimuttiyā,lokiyavimuttiya,2,2,0,0,15
418298,paṭhamasammattaniyāmasuttavaṇṇanā,pathamasammattaniyamasuttavannana,1,1,0,0,33
418299,sammattabhūtaṃ,sammattabhutam,1,1,0,0,14
418300,paribhotītiādīsu,paribhotitiadisu,1,0,1,0,16
418301,dutiyasammattaniyāmasuttavaṇṇanā,dutiyasammattaniyamasuttavannana,1,1,0,0,32
418302,aññātamānīti,annatamaniti,1,0,1,0,12
418303,aviññātasmiṃyeva,avinnatasmimyeva,1,1,0,0,16
418304,viññātamidaṃ,vinnatamidam,1,1,0,0,12
418305,evaṃmānī,evammani,2,2,0,0,8
418306,tatiyasammattaniyāmasuttavaṇṇanā,tatiyasammattaniyamasuttavannana,1,1,0,0,32
418307,guṇamakkhanacittena,gunamakkhanacittena,1,1,0,0,19
418308,upārambhacittoti,uparambhacittoti,2,0,2,0,16
418309,niggahāropanacitto,niggaharopanacitto,1,1,0,0,18
418310,randhagavesīti,randhagavesiti,2,0,2,0,14
418311,guṇarandhaṃ,gunarandham,1,1,0,0,11
418312,guṇacchiddaṃ,gunacchiddam,1,1,0,0,12
418313,paṭhamasaddhammasammosasuttavaṇṇanā,pathamasaddhammasammosasuttavannana,1,1,0,0,35
418314,sukatakārino,sukatakarino,1,1,0,0,12
418315,vaḷañjantāpi,valanjantapi,1,1,0,0,12
418316,tatiyasaddhammasammosasuttavaṇṇanā,tatiyasaddhammasammosasuttavannana,1,1,0,0,34
418317,suttantassa,suttantassa,9,9,0,0,11
418318,dukkathāsuttavaṇṇanā,dukkathasuttavannana,1,1,0,0,20
418319,kacchamānāyāti,kacchamanayati,2,0,2,0,14
418320,kathiyamānāya,kathiyamanaya,7,6,1,0,13
418321,aṭṭhamañca,atthamanca,4,4,0,0,10
418322,udāyīsuttavaṇṇanā,udayisuttavannana,7,7,0,0,17
418323,dānānantaraṃ,dananantaram,13,11,2,0,12
418324,sīlānantaraṃ,silanantaram,13,13,0,0,12
418325,sagganti,sagganti,1,1,0,0,8
418326,desanānupubbiṃ,desananupubbim,3,3,0,0,14
418327,anurūpakathaṃ,anurupakatham,1,1,0,0,13
418328,pariyāyadassāvīti,pariyayadassaviti,1,0,1,0,17
418329,mahāsambādhappatte,mahasambadhappatte,1,1,0,0,18
418330,sambādhato,sambadhato,1,1,0,0,10
418331,catupaccayalābhaṃ,catupaccayalabham,2,2,0,0,17
418332,anāsīsantoti,anasisantoti,1,1,0,0,12
418333,attukkaṃsanaparavambhanādivasena,attukkamsanaparavambhanadivasena,2,2,0,0,32
418334,anupahantvā,anupahantva,1,1,0,0,11
418335,duppaṭivinodayasuttavaṇṇanā,duppativinodayasuttavannana,1,1,0,0,27
418336,duppaṭivinodayāti,duppativinodayati,2,0,2,0,17
418337,hassādīni,hassadini,1,1,0,0,9
418338,asampattesu,asampattesu,8,8,0,0,11
418339,duvikkhambhayā,duvikkhambhaya,1,1,0,0,14
418340,kathetukāmatā,kathetukamata,2,2,0,0,13
418341,duppaṭivinodayāni,duppativinodayani,1,1,0,0,17
418342,suppaṭivinodayāni,suppativinodayani,1,1,0,0,17
418343,paccavekkhaṇaanusāsanādīhi,paccavekkhanaanusasanadihi,1,1,0,0,26
418344,paṭivinodetunti,pativinodetunti,2,2,0,0,15
418345,paṭhamaāghātapaṭivinayasuttavaṇṇanā,pathamaaghatapativinayasuttavannana,1,1,0,0,35
418346,paṭivinetabboti,pativinetabboti,2,1,1,0,15
418347,paṭivinodetabboti,pativinodetabboti,1,1,0,0,17
418348,asatiamanasikāroti,asatiamanasikaroti,1,0,1,0,18
418349,kuṭṭādīhi,kuttadihi,6,6,0,0,9
418350,dutiyaāghātapaṭivinayasuttavaṇṇanā,dutiyaaghatapativinayasuttavannana,1,1,0,0,34
418351,paṭivinetabbotipi,pativinetabbotipi,1,1,0,0,17
418352,paṭivinayoti,pativinayoti,1,1,0,0,12
418353,paṭivinayavatthūnampi,pativinayavatthunampi,1,1,0,0,21
418354,paṭivinayakāraṇānampi,pativinayakarananampi,1,1,0,0,21
418355,paṭivinayavatthū,pativinayavatthu,1,1,0,0,16
418356,paṭipattiyo,patipattiyo,2,2,0,0,11
418357,paṭivinayakāraṇāni,pativinayakaranani,3,3,0,0,18
418358,samathavipassanācittassa,samathavipassanacittassa,7,7,0,0,24
418359,uppannokāsasaṅkhātaṃ,uppannokasasankhatam,1,1,0,0,20
418360,vivarañceva,vivaranceva,1,1,0,0,11
418361,saddhāsampannabhāvasaṅkhātaṃ,saddhasampannabhavasankhatam,1,1,0,0,28
418362,rathiyāyāti,rathiyayati,1,0,1,0,11
418363,niggahetvāti,niggahetvati,2,0,2,0,12
418364,thiraṭṭhānaṃ,thiratthanam,3,3,0,0,12
418365,paripātetvāti,paripatetvati,1,0,1,0,13
418366,vicaraṇakālo,vicaranakalo,2,2,0,0,12
418367,aparisuddhakāyasamācārataṃ,aparisuddhakayasamacaratam,1,1,0,0,26
418368,parisuddhavacīsamācārataṃ,parisuddhavacisamacaratam,1,1,0,0,25
418369,phāsuvihārakālo,phasuviharakalo,2,2,0,0,15
418370,sevālapaṇakapariyonaddhāti,sevalapanakapariyonaddhati,1,0,1,0,26
418371,udakapappaṭakena,udakapappatakena,1,1,0,0,16
418372,ghammaparetoti,ghammaparetoti,3,0,3,0,14
418373,ghammena,ghammena,7,6,1,0,8
418374,kilantoti,kilantoti,1,0,1,0,9
418375,maggakilanto,maggakilanto,7,7,0,0,12
418376,tasitoti,tasitoti,5,0,5,0,8
418377,taṇhābhibhūto,tanhabhibhuto,1,1,0,0,13
418378,apaviyūhitvāti,apaviyuhitvati,1,0,1,0,14
418379,pivitvāti,pivitvati,4,1,3,0,9
418380,pasannaudakaṃ,pasannaudakam,2,2,0,0,13
418381,apabyūhitvā,apabyuhitva,2,2,0,0,11
418382,pasannodakaṃ,pasannodakam,5,5,0,0,12
418383,aparisuddhavacīsamācārataṃ,aparisuddhavacisamacaratam,1,1,0,0,26
418384,parisuddhakāyasamācārataṃ,parisuddhakayasamacaratam,1,1,0,0,25
418385,khobhessāmīti,khobhessamiti,1,0,1,0,13
418386,cālessāmi,calessami,1,1,0,0,9
418387,loḷessāmīti,lolessamiti,1,0,1,0,11
418388,catukkuṇḍikoti,catukkundikoti,3,0,3,0,14
418389,patiṭṭhānena,patitthanena,4,4,0,0,12
418390,ākaḍḍhento,akaddhento,11,9,2,0,10
418391,gopadaṃ,gopadam,1,1,0,0,7
418392,parittaudakaṃ,parittaudakam,3,3,0,0,13
418393,tassabbhantare,tassabbhantare,5,5,0,0,14
418394,catukkuṇḍikassa,catukkundikassa,1,1,0,0,15
418395,aparisuddhakāyavacīsamācārataṃ,aparisuddhakayavacisamacaratam,1,1,0,0,30
418396,vivarappasādasaṅkhātaṃ,vivarappasadasankhatam,1,1,0,0,22
418397,cittuppādanibbāpanaṃ,cittuppadanibbapanam,1,1,0,0,20
418398,ābādhikoti,abadhikoti,6,0,6,0,10
418399,iriyāpathabhañjanakena,iriyapathabhanjanakena,2,2,0,0,22
418400,visabhāgābādhena,visabhagabadhena,1,1,0,0,16
418401,puratopissāti,puratopissati,1,0,1,0,13
418402,avaḍḍhivināsaṃ,avaddhivinasam,2,2,0,0,14
418403,anāthagilāno,anathagilano,1,1,0,0,12
418404,sabbakaṇhadhammasamannāgato,sabbakanhadhammasamannagato,1,1,0,0,27
418405,addhānamaggo,addhanamaggo,11,7,4,0,12
418406,anamataggasaṃsāro,anamataggasamsaro,1,1,0,0,17
418407,sappāyabhojanānaṃ,sappayabhojananam,1,1,0,0,17
418408,sāmaññaphalabhojanānaṃ,samannaphalabhojananam,1,1,0,0,22
418409,sappāyabhesajjānaṃ,sappayabhesajjanam,1,1,0,0,18
418410,patirūpaupaṭṭhākānaṃ,patirupaupatthakanam,1,1,0,0,20
418411,ovādānusāsanīhi,ovadanusasanihi,5,5,0,0,15
418412,kilesatikicchakānaṃ,kilesatikicchakanam,1,1,0,0,19
418413,gāmantanāyakassa,gamantanayakassa,1,1,0,0,16
418414,aladdhabhāvo,aladdhabhavo,1,1,0,0,12
418415,kāruññupaṭṭhānaṃ,karunnupatthanam,1,1,0,0,16
418416,mettāvihārikassa,mettaviharikassa,1,1,0,0,16
418417,acchodakāti,acchodakati,5,0,5,0,11
418418,pasannodakā,pasannodaka,4,2,2,0,11
418419,sātodakāti,satodakati,4,0,4,0,10
418420,madhurodakā,madhurodaka,6,4,2,0,11
418421,sītodakāti,sitodakati,3,0,3,0,10
418422,tanusītasalilā,tanusitasalila,2,1,1,0,14
418423,setakāti,setakati,3,0,3,0,8
418424,ūmibhijjanaṭṭhānesu,umibhijjanatthanesu,1,1,0,0,19
418425,setavaṇṇā,setavanna,7,7,0,0,9
418426,supatitthāti,supatitthati,4,0,4,0,12
418427,samatitthā,samatittha,2,2,0,0,10
418428,parisuddhasabbadvāro,parisuddhasabbadvaro,1,1,0,0,20
418429,pañhapucchāsuttavaṇṇanā,panhapucchasuttavannana,1,1,0,0,23
418430,paribhavissāmīti,paribhavissamiti,1,1,0,0,16
418431,paribhavanatthāya,paribhavanatthaya,2,2,0,0,17
418432,aññātukāmoti,annatukamoti,2,0,2,0,12
418433,nirodhasuttavaṇṇanā,nirodhasuttavannana,3,3,0,0,19
418434,ārādheyyāti,aradheyyati,4,2,2,0,11
418435,kāmāvacaradevānaṃ,kamavacaradevanam,18,16,2,0,17
418436,suddhāvāsabrahmakāyaṃ,suddhavasabrahmakayam,1,1,0,0,21
418437,paṭikkosantī,patikkosanti,4,4,0,0,12
418438,laddhiuppattipaṭibāhanatthaṃ,laddhiuppattipatibahanattham,1,1,0,0,28
418439,anadhivāsetvā,anadhivasetva,3,3,0,0,13
418440,amarisanatthe,amarisanatthe,1,1,0,0,13
418441,ajjhupekkhissathā,ajjhupekkhissatha,2,2,0,0,17
418442,viheṭhiyamānaṃ,vihethiyamanam,2,2,0,0,14
418443,ajjhupekkhatha,ajjhupekkhatha,2,2,0,0,14
418444,marisayāmi,marisayami,1,1,0,0,10
418445,sahāmi,sahami,3,3,0,0,6
418446,nādhivāsemīti,nadhivasemiti,1,1,0,0,13
418447,ānandatheraṃyeva,anandatheramyeva,1,1,0,0,16
418448,dhammabhaṇḍāgārikattā,dhammabhandagarikatta,1,1,0,0,21
418449,garahāti,garahati,2,1,1,0,8
418450,upavānaṃ,upavanam,2,1,1,0,8
418451,paṭibhāseyyāti,patibhaseyyati,2,0,2,0,14
418452,udāhaṭe,udahate,3,3,0,0,7
418453,āyasmatoyeva,ayasmatoyeva,3,2,1,0,12
418454,upavānassa,upavanassa,1,1,0,0,10
418455,upaṭṭhātūti,upatthatuti,8,3,5,0,11
418456,sīlavātiādīhi,silavatiadihi,1,0,1,0,13
418457,khīṇāsavasīlādīniyeva,khinasavasiladiniyeva,1,1,0,0,21
418458,khaṇḍiccenātiādīni,khandiccenatiadini,1,0,1,0,18
418459,sakkārādīnaṃ,sakkaradinam,2,2,0,0,12
418460,kāraṇapucchāvasena,karanapucchavasena,1,1,0,0,18
418461,khaṇḍiccādīhi,khandiccadihi,9,6,3,0,13
418462,sakkareyyunti,sakkareyyunti,1,1,0,0,13
418463,codanāsuttavaṇṇanā,codanasuttavannana,1,1,0,0,18
418464,codakenāti,codakenati,2,0,2,0,10
418465,vatthusandassanā,vatthusandassana,9,6,3,0,16
418466,āpattisandassanā,apattisandassana,9,6,3,0,16
418467,saṃvāsappaṭikkhepo,samvasappatikkhepo,5,4,1,0,18
418468,sāmīcippaṭikkhepoti,samicippatikkhepoti,4,3,1,0,19
418469,codanāvatthūhi,codanavatthuhi,2,2,0,0,14
418470,codayamānena,codayamanena,2,2,0,0,12
418471,codentena,codentena,5,5,0,0,9
418472,uposathapavāraṇagge,uposathapavaranagge,2,2,0,0,19
418473,āsanasālābhojanasālādīsu,asanasalabhojanasaladisu,2,2,0,0,24
418474,karotāyasmā,karotayasma,2,2,0,0,11
418475,lolapuggalo,lolapuggalo,2,2,0,0,11
418476,okāsakammaṃ,okasakammam,57,50,7,0,11
418477,bhūtenāti,bhutenati,3,0,3,0,9
418478,saṇhenāti,sanhenati,4,0,4,0,9
418479,maṭṭhena,matthena,5,5,0,0,8
418480,atthasaṃhitenāti,atthasamhitenati,1,0,1,0,16
418481,hitakāmatāya,hitakamataya,17,16,1,0,12
418482,upadahātabboti,upadahatabboti,2,0,2,0,14
418483,amaṅkubhāvo,amankubhavo,1,1,0,0,11
418484,avippaṭisārāyāti,avippatisarayati,3,2,1,0,16
418485,amaṅkubhāvāya,amankubhavaya,1,1,0,0,13
418486,atthakusaloti,atthakusaloti,5,0,5,0,13
418487,dhammakusaloti,dhammakusaloti,4,0,4,0,14
418488,niruttikusaloti,niruttikusaloti,3,0,3,0,15
418489,niruttivacanesu,niruttivacanesu,1,1,0,0,15
418490,byañjanakusaloti,byanjanakusaloti,4,0,4,0,16
418491,akkharappabhede,akkharappabhede,1,1,0,0,15
418492,pubbāparakusaloti,pubbaparakusaloti,4,0,4,0,17
418493,atthapubbāparaṃ,atthapubbaparam,1,1,0,0,15
418494,dhammapubbāparaṃ,dhammapubbaparam,1,1,0,0,16
418495,akkharapubbāparaṃ,akkharapubbaparam,1,1,0,0,17
418496,byañjanapubbāparaṃ,byanjanapubbaparam,1,1,0,0,18
418497,anusandhipubbāparanti,anusandhipubbaparanti,1,1,0,0,21
418498,atthapubbāparakusaloti,atthapubbaparakusaloti,1,0,1,0,22
418499,ubhatobhāgesu,ubhatobhagesu,1,1,0,0,13
418500,dhammapubbāparā,dhammapubbapara,1,0,1,0,15
418501,anusandhipubbāpare,anusandhipubbapare,1,0,1,0,18
418502,yathānuparicchedaṃ,yathanuparicchedam,1,1,0,0,18
418503,āgatesupi,agatesupi,4,4,0,0,9
418504,sāraṇīyadhammesu,saraniyadhammesu,4,4,0,0,16
418505,dvattiṃsatiracchānakathāvasena,dvattimsatiracchanakathavasena,1,1,0,0,30
418506,dasakathāvatthūsu,dasakathavatthusu,1,1,0,0,17
418507,bhaddajisuttavaṇṇanā,bhaddajisuttavannana,3,3,0,0,20
418508,anabhibhūtoti,anabhibhutoti,11,0,11,0,13
418509,ekaṃsavacane,ekamsavacane,11,10,1,0,12
418510,vasavattīti,vasavattiti,8,2,6,0,11
418511,suṇatoti,sunatoti,3,0,3,0,8
418512,cakkhuviññāṇānantaraṃ,cakkhuvinnananantaram,3,3,0,0,21
418513,sukhitassāti,sukhitassati,2,0,2,0,12
418514,saññissāti,sannissati,4,0,4,0,10
418515,maggasaññāva,maggasannava,1,1,0,0,12
418516,bhūtassāti,bhutassati,9,0,9,0,10
418517,sārajjasuttādivaṇṇanā,sarajjasuttadivannana,5,5,0,0,21
418518,para171-173,para171-173,2,2,0,0,11
418519,para171-173_an5,para171-173_an5,1,1,0,0,15
418520,paṭhamadutiyatatiyesu,pathamadutiyatatiyesu,3,3,0,0,21
418521,agāriyappaṭipatti,agariyappatipatti,1,1,0,0,17
418522,verasuttavaṇṇanā,verasuttavannana,1,1,0,0,16
418523,cittutrāsabhayāni,cittutrasabhayani,2,2,0,0,17
418524,verānīti,veraniti,6,0,6,0,8
418525,akusalaverānipi,akusalaveranipi,1,1,0,0,15
418526,puggalaverānipi,puggalaveranipi,1,1,0,0,15
418527,cittanissitaṃ,cittanissitam,5,5,0,0,13
418528,kāyapasādavatthukaṃ,kayapasadavatthukam,7,5,2,0,19
418529,domanassavedanaṃ,domanassavedanam,1,1,0,0,16
418530,viratipahānaṃ,viratipahanam,1,1,0,0,13
418531,caṇḍālasuttavaṇṇanā,candalasuttavannana,1,1,0,0,19
418532,upāsakapatikuṭṭhoti,upasakapatikutthoti,1,0,1,0,19
418533,upāsakapacchimako,upasakapacchimako,1,1,0,0,17
418534,kotūhalamaṅgalikoti,kotuhalamangalikoti,1,0,1,0,19
418535,kotūhalasaṅkhātena,kotuhalasankhatena,2,2,0,0,18
418536,diṭṭhasutamutamaṅgalena,ditthasutamutamangalena,9,9,0,0,23
418537,kusalakiccaṃ,kusalakiccam,1,1,0,0,12
418538,pītisuttavaṇṇanā,pitisuttavannana,1,1,0,0,16
418539,paṭhamadutiyajjhānāni,pathamadutiyajjhanani,6,6,0,0,21
418540,uppajjanakapītiṃ,uppajjanakapitim,1,1,0,0,16
418541,kāmanissitaṃ,kamanissitam,3,3,0,0,12
418542,vijjhissāmī,vijjhissami,13,13,0,0,11
418543,viraddhe,viraddhe,2,2,0,0,8
418544,avirajjhantassa,avirajjhantassa,1,1,0,0,15
418545,dānādiupakaraṇānaṃ,danadiupakarananam,1,1,0,0,18
418546,asampattiyā,asampattiya,2,2,0,0,11
418547,vaṇijjāsuttavaṇṇanā,vanijjasuttavannana,1,1,0,0,19
418548,vaṇijjāti,vanijjati,4,0,4,0,9
418549,vāṇijakammāni,vanijakammani,1,1,0,0,13
418550,upāsakenāti,upasakenati,1,0,1,0,11
418551,tisaraṇagatena,tisaranagatena,1,1,0,0,14
418552,satthavaṇijjāti,satthavanijjati,8,0,8,0,15
418553,sattavaṇijjāti,sattavanijjati,5,0,5,0,14
418554,manussavikkayo,manussavikkayo,6,6,0,0,14
418555,maṃsavaṇijjāti,mamsavanijjati,6,0,6,0,14
418556,sūkaramigādayo,sukaramigadayo,3,2,1,0,14
418557,majjavaṇijjāti,majjavanijjati,6,0,6,0,14
418558,visavaṇijjāti,visavanijjati,6,0,6,0,13
418559,rājasuttavaṇṇanā,rajasuttavannana,2,2,0,0,16
418560,pabbājentīti,pabbajentiti,5,4,1,0,12
418561,gihisuttavaṇṇanā,gihisuttavannana,3,3,0,0,16
418562,pihitakammantaṃ,pihitakammantam,1,1,0,0,15
418563,uttamacittanissitānaṃ,uttamacittanissitanam,2,1,1,0,21
418564,maggaphalasīlehi,maggaphalasilehi,1,1,0,0,16
418565,ariyadhammoti,ariyadhammoti,2,2,0,0,13
418566,dhammañcānuvitakkayeti,dhammancanuvitakkayeti,1,0,1,0,22
418567,anussativaseneva,anussativaseneva,1,1,0,0,16
418568,mettādibrahmavihāracittaṃ,mettadibrahmaviharacittam,1,1,0,0,25
418569,bhāvayeti,bhavayeti,11,2,9,0,9
418570,brahmalokatthāya,brahmalokatthaya,1,1,0,0,16
418571,jigīsatoti,jigisatoti,2,0,2,0,10
418572,buddhapaccekabuddhatathāgatasāvakesu,buddhapaccekabuddhatathagatasavakesu,1,1,0,0,36
418573,anupubbenāti,anupubbenati,13,1,12,0,12
418574,sīlapūraṇādinā,silapuranadina,1,1,0,0,14
418575,gavesīsuttavaṇṇanā,gavesisuttavannana,3,3,0,0,18
418576,pātvākāsīti,patvakasiti,17,9,8,0,11
418577,mahāmaggeneva,mahamaggeneva,1,1,0,0,13
418578,sukāraṇaṃ,sukaranam,14,10,4,0,9
418579,sitapātukammaṃ,sitapatukammam,5,5,0,0,14
418580,aggaggadante,aggaggadante,3,3,0,0,12
418581,lokiyamanussā,lokiyamanussa,3,3,0,0,13
418582,paharantā,paharanta,31,31,0,0,9
418583,haṭṭhapahaṭṭhākāramattameva,hatthapahatthakaramattameva,2,2,0,0,27
418584,hasitañca,hasitanca,4,2,2,0,9
418585,somanassasahagatacittehi,somanassasahagatacittehi,2,2,0,0,24
418586,sahetukakiriyacittehi,sahetukakiriyacittehi,2,2,0,0,21
418587,ahetukakiriyacittenāti,ahetukakiriyacittenati,2,2,0,0,22
418588,ñāṇasampayuttacittehi,nanasampayuttacittehi,3,3,0,0,21
418589,duhetukacittadvayena,duhetukacittadvayena,2,2,0,0,20
418590,ahetukacittena,ahetukacittena,2,2,0,0,14
418591,kiriyāhetukamanoviññāṇadhātusomanassasahagatacittaṃ,kiriyahetukamanovinnanadhatusomanassasahagatacittam,3,3,0,0,51
418592,pahaṭṭhākāramattahasitaṃ,pahatthakaramattahasitam,1,1,0,0,24
418593,cātuddīpikamahāmeghamukhato,catuddipikamahameghamukhato,3,1,2,0,27
418594,samosaritā,samosarita,2,1,1,0,10
418595,mahātālakkhandhappamāṇā,mahatalakkhandhappamana,1,1,0,0,23
418596,rasmivaṭṭiyo,rasmivattiyo,2,2,0,0,12
418597,siravaraṃ,siravaram,2,2,0,0,9
418598,dāṭhaggesuyeva,dathaggesuyeva,4,3,1,0,14
418599,gacchamānopi,gacchamanopi,2,2,0,0,12
418600,sitapātubhāvaṃ,sitapatubhavam,2,2,0,0,14
418601,atisamiddhaṃ,atisamiddham,1,1,0,0,12
418602,sabbapāliphullaṃ,sabbapaliphullam,11,7,4,0,16
418603,janasamākulaṃ,janasamakulam,1,1,0,0,13
418604,aparipūrakārīti,aparipurakariti,1,0,1,0,15
418605,asamattakārī,asamattakari,1,1,0,0,12
418606,paṭidesitānīti,patidesitaniti,1,0,1,0,14
418607,samādapitānīti,samadapitaniti,1,0,1,0,14
418608,patiṭṭhāpitānīti,patitthapitaniti,1,1,0,0,16
418609,atirekāyāti,atirekayati,1,0,1,0,11
418610,visesakāraṇatthāya,visesakaranatthaya,1,1,0,0,18
418611,paṭipajjāmīti,patipajjamiti,6,3,3,0,13
418612,samattakārīti,samattakariti,2,1,1,0,13
418613,keneva,keneva,1,1,0,0,6
418614,āraññikasuttavaṇṇanā,arannikasuttavannana,3,3,0,0,20
418615,sambhāvessantī,sambhavessanti,4,4,0,0,14
418616,āraññakaṅgaṃ,arannakangam,2,2,0,0,12
418617,lokāmisanti,lokamisanti,2,2,0,0,11
418618,soṇasuttavaṇṇanā,sonasuttavannana,7,7,0,0,16
418619,brāhmaṇadhammāti,brahmanadhammati,1,0,1,0,16
418620,brāhmaṇasabhāvā,brahmanasabhava,1,1,0,0,15
418621,sunakhesūti,sunakhesuti,1,0,1,0,11
418622,kukkuresu,kukkuresu,1,1,0,0,9
418623,sampavattentīti,sampavattentiti,1,0,1,0,15
418624,pavattayanti,pavattayanti,4,4,0,0,12
418625,avadihitvā,avadihitva,2,1,1,0,10
418626,pakkamantīti,pakkamantiti,12,3,9,0,12
418627,doṇabrāhmaṇasuttavaṇṇanā,donabrahmanasuttavannana,3,3,0,0,24
418628,pavattāroti,pavattaroti,7,0,7,0,11
418629,pavattayitāro,pavattayitaro,8,5,3,0,13
418630,vedasaṅkhātaṃ,vedasankhatam,3,3,0,0,13
418631,mantameva,mantameva,3,3,0,0,9
418632,aṭṭhakādīhi,atthakadihi,18,18,0,0,11
418633,porāṇakabrāhmaṇehi,poranakabrahmanehi,4,4,0,0,18
418634,sarasampattivasena,sarasampattivasena,2,2,0,0,18
418635,vācitanti,vacitanti,4,4,0,0,9
418636,samupabyūḷhaṃ,samupabyulham,8,5,3,0,13
418637,tadanugāyantīti,tadanugayantiti,5,0,5,0,15
418638,anugāyanti,anugayanti,5,5,0,0,10
418639,anusajjhāyanti,anusajjhayanti,8,8,0,0,14
418640,tadanubhāsantīti,tadanubhasantiti,4,0,4,0,16
418641,anubhāsanti,anubhasanti,6,6,0,0,11
418642,bhāsitamanubhāsantīti,bhasitamanubhasantiti,4,0,4,0,21
418643,sajjhāyitamanusajjhāyantīti,sajjhayitamanusajjhayantiti,1,0,1,0,27
418644,vācitamanuvācentīti,vacitamanuvacentiti,4,0,4,0,19
418645,anuvācenti,anuvacenti,5,5,0,0,10
418646,aṭṭhakotiādīni,atthakotiadini,4,0,4,0,14
418647,ganthesuṃ,ganthesum,3,3,0,0,9
418648,adhīyamānoti,adhiyamanoti,1,0,1,0,12
418649,ācariyadakkhiṇaṃ,acariyadakkhinam,1,1,0,0,16
418650,ācariyabhāgaṃ,acariyabhagam,11,11,0,0,13
418651,issatthenāti,issatthenati,2,0,2,0,12
418652,yodhājīvakammena,yodhajivakammena,1,1,0,0,16
418653,rājaporisenāti,rajaporisenati,1,0,1,0,14
418654,rājupaṭṭhākabhāvena,rajupatthakabhavena,1,1,0,0,19
418655,bhikkhācariyāyāti,bhikkhacariyayati,2,0,2,0,17
418656,anatimaññamānoti,anatimannamanoti,1,0,1,0,16
418657,kuladvāresu,kuladvaresu,3,3,0,0,11
418658,cariṃ,carim,11,9,2,0,5
418659,mantāpi,mantapi,2,2,0,0,7
418660,sakalagāmaṃ,sakalagamam,9,9,0,0,11
418661,laddhadhanaṃ,laddhadhanam,4,4,0,0,12
418662,vikkayenāti,vikkayenati,1,0,1,0,11
418663,upassaṭṭhaṃ,upassattham,21,19,2,0,11
418664,ṭhitosī,thitosi,11,11,0,0,7
418665,atimīḷhajoti,atimilhajoti,1,0,1,0,12
418666,atimīḷhe,atimilhe,1,1,0,0,8
418667,mahāgūtharāsimhi,mahagutharasimhi,1,1,0,0,16
418668,davatthāti,davatthati,1,0,1,0,10
418669,kīḷanatthā,kilanattha,1,1,0,0,10
418670,ratatthāti,ratatthati,1,0,1,0,10
418671,kāmaratiatthā,kamaratiattha,1,1,0,0,13
418672,ghaṭīyissatī,ghatiyissati,1,1,0,0,12
418673,dibbavihārehi,dibbaviharehi,1,1,0,0,13
418674,nikāmayamānoti,nikamayamanoti,5,0,5,0,14
418675,puttapemaṃ,puttapemam,10,7,3,0,10
418676,puttassādo,puttassado,1,1,0,0,10
418677,kuṭumbamajjhe,kutumbamajjhe,2,2,0,0,13
418678,paṭhamaññeva,pathamanneva,6,6,0,0,12
418679,kāmarāgapariyuṭṭhitenāti,kamaragapariyutthitenati,4,0,4,0,24
418680,kāmarāgaggahitena,kamaragaggahitena,1,1,0,0,17
418681,kāmarāgaparetenāti,kamaragaparetenati,2,0,2,0,18
418682,kāmarāgānugatena,kamaraganugatena,2,2,0,0,16
418683,vikkhambhananissaraṇaṃ,vikkhambhananissaranam,14,12,2,0,22
418684,tadaṅganissaraṇaṃ,tadanganissaranam,6,6,0,0,17
418685,samucchedanissaraṇanti,samucchedanissarananti,2,2,0,0,22
418686,samucchedanissaraṇaṃ,samucchedanissaranam,10,10,0,0,20
418687,attatthampītiādīsu,attatthampitiadisu,2,0,2,0,18
418688,arahattasaṅkhāto,arahattasankhato,5,4,1,0,16
418689,nissaraṇāni,nissaranani,12,12,0,0,11
418690,vikkhambhananissaraṇañca,vikkhambhananissarananca,2,2,0,0,24
418691,samucchedanissaraṇañca,samucchedanissarananca,2,2,0,0,22
418692,udapattoti,udapattoti,2,0,2,0,10
418693,udakabharitā,udakabharita,3,3,0,0,12
418694,vaṇṇabhedakaraṇavasena,vannabhedakaranavasena,2,2,0,0,22
418695,ukkudhitoti,ukkudhitoti,1,0,1,0,11
418696,kudhito,kudhito,1,1,0,0,7
418697,ussadakajātoti,ussadakajatoti,1,0,1,0,14
418698,sevālapaṇakapariyonaddhoti,sevalapanakapariyonaddhoti,2,0,2,0,26
418699,tilabījakādibhedena,tilabijakadibhedena,3,3,0,0,19
418700,nīlamaṇḍūkapiṭṭhivaṇṇena,nilamandukapitthivannena,5,5,0,0,24
418701,udakapiṭṭhiṃ,udakapitthim,6,6,0,0,12
418702,paṇakena,panakena,2,2,0,0,8
418703,vāteritoti,vateritoti,2,0,2,0,10
418704,erito,erito,6,6,0,0,5
418705,asannisinno,asannisinno,4,2,2,0,11
418706,koṭṭhakantarādibhede,kotthakantaradibhede,1,1,0,0,20
418707,anālokaṭṭhāne,analokatthane,2,2,0,0,13
418708,nivaṭṭetvā,nivattetva,1,1,0,0,10
418709,saraṇamatte,saranamatte,2,2,0,0,11
418710,kāraṇapālīsuttavaṇṇanā,karanapalisuttavannana,3,3,0,0,22
418711,kāraṇapālīti,karanapaliti,1,0,1,0,12
418712,pāloti,paloti,3,1,2,0,6
418713,dvāraṭṭālakapākāre,dvarattalakapakare,2,2,0,0,18
418714,paṭijaggāpeti,patijaggapeti,4,4,0,0,13
418715,divasassāpi,divasassapi,3,3,0,0,11
418716,majjhanhikakāleti,majjhanhikakaleti,1,1,0,0,17
418717,paññāveyyattiyajānane,pannaveyyattiyajanane,1,1,0,0,21
418718,ajānanabhāvaṃ,ajananabhavam,6,5,1,0,13
418719,pametukāmena,pametukamena,2,2,0,0,12
418720,tappamāṇo,tappamano,1,1,0,0,9
418721,jānantenapi,janantenapi,9,9,0,0,11
418722,ñāṇasadisameva,nanasadisameva,2,2,0,0,14
418723,uḷārāyāti,ularayati,3,0,3,0,9
418724,seṭṭhāya,setthaya,3,3,0,0,8
418725,pasaṃsissāmīti,pasamsissamiti,2,0,2,0,14
418726,pasatthappasatthoti,pasatthappasatthoti,2,0,2,0,19
418727,carehi,carehi,1,1,0,0,6
418728,sabbalokapasatthehi,sabbalokapasatthehi,4,4,0,0,19
418729,guṇeheva,guneheva,6,6,0,0,8
418730,pasaṃsanakiccaṃ,pasamsanakiccam,4,4,0,0,15
418731,campakapupphaṃ,campakapuppham,4,4,0,0,14
418732,vaṇṇagandhasiriyāva,vannagandhasiriyava,2,2,0,0,19
418733,pāsādikañceva,pasadikanceva,2,2,0,0,13
418734,vaṇṇagandhehi,vannagandhehi,2,2,0,0,13
418735,thomanakiccaṃ,thomanakiccam,2,2,0,0,13
418736,ālokeneva,alokeneva,2,2,0,0,9
418737,obhāsanakiccaṃ,obhasanakiccam,2,2,0,0,14
418738,pasatthehi,pasatthehi,6,4,2,0,10
418739,pasatthotipi,pasatthotipi,2,2,0,0,12
418740,pasatthappasattho,pasatthappasattho,2,1,1,0,17
418741,kāsikosalavāsikehi,kasikosalavasikehi,2,2,0,0,18
418742,aṅgamagadhavāsīhi,angamagadhavasihi,3,3,0,0,17
418743,vajjitaṭṭhavāsīhi,vajjitatthavasihi,1,1,0,0,17
418744,caṅkiādayo,cankiadayo,1,1,0,0,10
418745,brāhmaṇagaṇehi,brahmanaganehi,2,2,0,0,14
418746,anāthapiṇḍikādayo,anathapindikadayo,4,4,0,0,17
418747,upāsakagaṇehi,upasakaganehi,2,2,0,0,13
418748,visākhāādikā,visakhaadika,1,1,0,0,12
418749,anekasatāhi,anekasatahi,3,3,0,0,11
418750,sakuludāyiādayo,sakuludayiadayo,2,2,0,0,15
418751,uppalavaṇṇattheriādikā,uppalavannattheriadika,1,1,0,0,22
418752,mahāsāvikā,mahasavika,6,6,0,0,10
418753,bhikkhunisatehi,bhikkhunisatehi,3,3,0,0,15
418754,mahābrahmādayo,mahabrahmadayo,2,2,0,0,14
418755,atthānisaṃsaṃ,atthanisamsam,6,3,3,0,13
418756,pasādakāraṇaṃ,pasadakaranam,2,2,0,0,13
418757,purisotiādimāha,purisotiadimaha,1,0,1,0,15
418758,aggarasaparitittoti,aggarasaparitittoti,1,0,1,0,19
418759,bhojanarasesu,bhojanarasesu,1,1,0,0,13
418760,sneharasesu,sneharasesu,1,1,0,0,11
418761,gosappi,gosappi,8,8,0,0,7
418762,kasāvarasesu,kasavarasesu,1,1,0,0,12
418763,khuddakamadhu,khuddakamadhu,1,1,0,0,13
418764,madhurarasesu,madhurarasesu,1,1,0,0,13
418765,sakkarāti,sakkarati,1,1,0,0,9
418766,aggarasā,aggarasa,1,1,0,0,8
418767,parititto,parititto,1,1,0,0,9
418768,ākaṇṭhappamāṇaṃ,akanthappamanam,1,1,0,0,15
418769,aggarasehi,aggarasehi,1,1,0,0,10
418770,hīnarasānaṃ,hinarasanam,1,1,0,0,11
418771,suttasoti,suttasoti,5,0,5,0,9
418772,suttabhāvenāti,suttabhavenati,1,1,0,0,14
418773,sesupi,sesupi,1,1,0,0,6
418774,suttādīsu,suttadisu,20,20,0,0,9
418775,puthusamaṇabrāhmaṇāppavādānaṃ,puthusamanabrahmanappavadanam,1,0,1,0,29
418776,laddhisaṅkhātappavādā,laddhisankhatappavada,1,1,0,0,21
418777,pihetīti,pihetiti,2,1,1,0,8
418778,sotumpi,sotumpi,7,7,0,0,7
418779,jighacchādubbalyaparetoti,jighacchadubbalyaparetoti,1,0,1,0,25
418780,sālipiṭṭhaṃ,salipittham,1,1,0,0,11
418781,baddhasattupiṇḍikaṃ,baddhasattupindikam,1,1,0,0,19
418782,madhurapūvameva,madhurapuvameva,1,1,0,0,15
418783,adhigaccheyyāti,adhigaccheyyati,5,4,1,0,15
418784,madhurabhāvakaraṇatthāya,madhurabhavakaranatthaya,1,1,0,0,24
418785,anāsittakaṃ,anasittakam,5,4,1,0,11
418786,paṇītarasaṃ,panitarasam,2,2,0,0,11
418787,haricandanassāti,haricandanassati,1,0,1,0,16
418788,suvaṇṇavaṇṇacandanassa,suvannavannacandanassa,1,1,0,0,22
418789,lohitacandanassāti,lohitacandanassati,1,0,1,0,18
418790,rattavaṇṇacandanassa,rattavannacandanassa,1,1,0,0,20
418791,darathā,daratha,48,46,2,0,7
418792,vaṭṭadarathā,vattadaratha,1,1,0,0,12
418793,vaṭṭakilamathā,vattakilamatha,1,1,0,0,14
418794,vaṭṭapariḷāhā,vattaparilaha,1,1,0,0,13
418795,avasekoti,avasekoti,3,3,0,0,9
418796,piṅgiyānīsuttavaṇṇanā,pingiyanisuttavannana,3,3,0,0,21
418797,nīlāti,nilati,10,2,8,0,6
418798,sabbasaṅgāhikaṃ,sabbasangahikam,14,9,5,0,15
418799,nīlavaṇṇātiādi,nilavannatiadi,4,0,4,0,14
418800,vibhāgadassanaṃ,vibhagadassanam,6,3,3,0,15
418801,nīlavilepanavilittattā,nilavilepanavilittatta,3,3,0,0,22
418802,nīlavatthāti,nilavatthati,3,0,3,0,12
418803,paṭadukūlakoseyyādīnipi,patadukulakoseyyadinipi,3,3,0,0,23
418804,nīlāneva,nilaneva,3,3,0,0,8
418805,nīlālaṅkārāti,nilalankarati,3,0,3,0,13
418806,nīlapupphehi,nilapupphehi,3,3,0,0,12
418807,hatthālaṅkāraassālaṅkārarathālaṅkārasāṇivitānakañcukāpi,hatthalankaraassalankararathalankarasanivitanakancukapi,1,1,0,0,55
418808,nīlāyeva,nilayeva,1,1,0,0,8
418809,suriyuggamanakāle,suriyuggamanakale,1,1,0,0,17
418810,avigatagandhaṃ,avigatagandham,3,2,1,0,14
418811,aṅgamaṅgehi,angamangehi,16,16,0,0,11
418812,aṅgīrasoti,angirasoti,3,2,1,0,10
418813,ālokakaraṇavasena,alokakaranavasena,1,1,0,0,17
418814,mahāsupinasuttavaṇṇanā,mahasupinasuttavannana,3,3,0,0,22
418815,mahāsupināti,mahasupinati,2,1,1,0,12
418816,mahantānañca,mahantananca,3,3,0,0,12
418817,khobhakaraṇapaccayappayogena,khobhakaranapaccayappayogena,1,1,0,0,28
418818,sekhaputhujjanāva,sekhaputhujjanava,2,2,0,0,17
418819,kapimiddhaparetoti,kapimiddhaparetoti,5,0,5,0,18
418820,abbohārikāva,abboharikava,3,3,0,0,12
418821,supinantacetanā,supinantacetana,3,3,0,0,15
418822,kālavasenapi,kalavasenapi,1,1,0,0,12
418823,asitapītakhāyite,asitapitakhayite,1,1,0,0,16
418824,uggacchamāneva,uggacchamaneva,1,1,0,0,14
418825,iṭṭhanimittaṃ,itthanimittam,2,2,0,0,13
418826,sabbaññubodhisattoyeva,sabbannubodhisattoyeva,2,2,0,0,22
418827,rattivibhāyanakāle,rattivibhayanakale,4,4,0,0,18
418828,terasiyantipi,terasiyantipi,1,1,0,0,13
418829,katheyyaṃ,katheyyam,18,17,1,0,9
418830,paṭigaṇhissāmī,patiganhissami,1,1,0,0,14
418831,uruvelagāme,uruvelagame,4,3,1,0,11
418832,makulabuddhakāle,makulabuddhakale,1,1,0,0,16
418833,mahāpathavīti,mahapathaviti,5,3,2,0,13
418834,ohitoti,ohitoti,5,1,4,0,7
418835,udakasmiṃyeva,udakasmimyeva,1,1,0,0,13
418836,pācīnasamuddassa,pacinasamuddassa,2,2,0,0,16
418837,uparūparibhāgena,uparuparibhagena,2,2,0,0,16
418838,pācīnacakkavāḷamatthake,pacinacakkavalamatthake,1,1,0,0,23
418839,samuddeti,samuddeti,2,1,1,0,9
418840,tiṇajātīti,tinajatiti,1,0,1,0,10
418841,naṅgalamattena,nangalamattena,2,2,0,0,14
418842,rattadaṇḍena,rattadandena,2,2,0,0,12
418843,byāmamattaṃ,byamamattam,8,8,0,0,11
418844,yaṭṭhimattaṃ,yatthimattam,2,2,0,0,12
418845,gāvutamattaṃ,gavutamattam,10,10,0,0,12
418846,aḍḍhayojanamattaṃ,addhayojanamattam,5,4,1,0,17
418847,yojanamattanti,yojanamattanti,2,2,0,0,14
418848,anekayojanasahassaṃ,anekayojanasahassam,3,3,0,0,19
418849,nānāvaṇṇāti,nanavannati,2,0,2,0,11
418850,pītavaṇṇo,pitavanno,1,1,0,0,9
418851,lohitavaṇṇo,lohitavanno,8,8,0,0,11
418852,paṇḍupalāsavaṇṇoti,pandupalasavannoti,2,2,0,0,18
418853,mīḷhapabbatassāti,milhapabbatassati,1,0,1,0,17
418854,tiyojanubbedhassa,tiyojanubbedhassa,1,1,0,0,17
418855,gūthapabbatassa,guthapabbatassa,1,1,0,0,15
418856,caṅkamatīti,cankamatiti,6,1,5,0,11
418857,dīghāyukabuddhā,dighayukabuddha,1,1,0,0,15
418858,mīḷhapabbate,milhapabbate,1,1,0,0,12
418859,pubbanimittehi,pubbanimittehi,1,1,0,0,14
418860,sabbaguṇadāyakattā,sabbagunadayakatta,3,3,0,0,18
418861,cakkavāḷamahāpathaviṃ,cakkavalamahapathavim,2,2,0,0,21
418862,sirisayanabhūtaṃ,sirisayanabhutam,2,2,0,0,16
418863,buddhabhāvassa,buddhabhavassa,15,15,0,0,14
418864,himavantapabbatarājānaṃ,himavantapabbatarajanam,1,1,0,0,23
418865,sabbaññutaññāṇabimbohanassa,sabbannutannanabimbohanassa,2,2,0,0,27
418866,cakkavāḷamatthake,cakkavalamatthake,2,2,0,0,17
418867,appaṭivattiyabhāve,appativattiyabhave,2,2,0,0,18
418868,avakujjānaṃ,avakujjanam,2,2,0,0,11
418869,uttānamukhabhāvassa,uttanamukhabhavassa,2,2,0,0,19
418870,dibbacakkhupaṭilābhassa,dibbacakkhupatilabhassa,6,6,0,0,23
418871,vassasuttavaṇṇanā,vassasuttavannana,5,5,0,0,17
418872,nemittāti,nemittati,1,0,1,0,9
418873,nimittapāṭhakā,nimittapathaka,4,4,0,0,14
418874,pakuppatīti,pakuppatiti,3,0,3,0,11
418875,tiyojanasatena,tiyojanasatena,1,1,0,0,14
418876,vippavuṭṭhasatino,vippavutthasatino,1,1,0,0,17
418877,ramāmā,ramama,2,2,0,0,6
418878,akālepi,akalepi,6,6,0,0,7
418879,nissāraṇīyasuttavaṇṇanā,nissaraniyasuttavannana,6,6,0,0,23
418880,nissāraṇīyāti,nissaraniyati,1,0,1,0,13
418881,visaññuttā,visannutta,7,7,0,0,10
418882,attasuññasabhāvā,attasunnasabhava,4,2,2,0,16
418883,asubhajjhānato,asubhajjhanato,2,2,0,0,14
418884,vīmaṃsanatthaṃ,vimamsanattham,36,33,3,0,14
418885,kāmābhimukhaṃ,kamabhimukham,4,4,0,0,13
418886,pesentassāti,pesentassati,3,2,1,0,12
418887,nappavisati,nappavisati,4,4,0,0,11
418888,nappatiṭṭhahati,nappatitthahati,1,1,0,0,15
418889,paṭilīyati,patiliyati,7,7,0,0,10
418890,saṃpasārīyati,sampasariyati,2,2,0,0,13
418891,asubhajjhānacittaṃ,asubhajjhanacittam,2,2,0,0,18
418892,ahānabhāgiyattā,ahanabhagiyatta,2,2,0,0,15
418893,kāmahetukā,kamahetuka,2,2,0,0,10
418894,vighātāti,vighatati,2,0,2,0,9
418895,pariḷāhāti,parilahati,6,2,4,0,10
418896,kāmarāgapariḷāhā,kamaragaparilaha,2,2,0,0,16
418897,kāmavedanaṃ,kamavedanam,3,2,1,0,11
418898,vighātapariḷāhavedanañca,vighataparilahavedananca,2,2,0,0,24
418899,tatiyamaggaṃ,tatiyamaggam,9,9,0,0,12
418900,accantanissaraṇameva,accantanissaranameva,2,2,0,0,20
418901,mettājhānāni,mettajhanani,3,3,0,0,12
418902,karuṇājhānāni,karunajhanani,2,2,0,0,13
418903,accantanissaraṇañcettha,accantanissaranancettha,2,1,1,0,23
418904,pañcupādānakkhandhābhimukhaṃ,pancupadanakkhandhabhimukham,2,2,0,0,28
418905,arahattaphalasamāpatticittaṃ,arahattaphalasamapatticittam,2,2,0,0,28
418906,sakkāyanissaraṇaṃ,sakkayanissaranam,2,1,1,0,17
418907,nānusetītiādimāha,nanusetitiadimaha,1,0,1,0,17
418908,ananusayāti,ananusayati,1,0,1,0,11
418909,kimilasuttavaṇṇanā,kimilasuttavannana,3,3,0,0,18
418910,niculavaneti,niculavaneti,2,0,2,0,12
418911,mucalindavane,mucalindavane,1,1,0,0,13
418912,nivutthaṃ,nivuttham,12,9,3,0,9
418913,sāsanosakkanakāle,sasanosakkanakale,3,3,0,0,17
418914,karontīsu,karontisu,2,2,0,0,9
418915,nivutthabhāvaṃ,nivutthabhavam,1,1,0,0,14
418916,appatissāti,appatissati,8,0,8,0,11
418917,gāravañceva,garavanceva,1,1,0,0,11
418918,jeṭṭhakabhāvañca,jetthakabhavanca,4,2,2,0,16
418919,nānappakārañca,nanappakaranca,3,3,0,0,14
418920,niratthakakathaṃ,niratthakakatham,13,13,0,0,16
418921,dhammassavanagge,dhammassavanagge,3,3,0,0,16
418922,aparipūrento,aparipurento,8,8,0,0,12
418923,kalahabhaṇḍanādīni,kalahabhandanadini,1,1,0,0,18
418924,para203-204,para203-204,1,1,0,0,11
418925,para203-204_an5,para203-204_an5,1,1,0,0,15
418926,ujubhāvena,ujubhavena,6,6,0,0,10
418927,avaṅkagamanena,avankagamanena,1,1,0,0,14
418928,padajavena,padajavena,3,3,0,0,10
418929,maddavenāti,maddavenati,1,0,1,0,11
418930,sarīramudutāya,sariramudutaya,1,1,0,0,14
418931,sucisīlatāya,sucisilataya,1,1,0,0,12
418932,ujukagamanaṃ,ujukagamanam,1,1,0,0,12
418933,gamanabhāvo,gamanabhavo,1,1,0,0,11
418934,sīlamaddavaṃ,silamaddavam,4,3,1,0,12
418935,adhivāsanakkhantiyeva,adhivasanakkhantiyeva,1,1,0,0,21
418936,sucisīlatāyeva,sucisilatayeva,1,1,0,0,14
418937,cetokhilasuttavaṇṇanā,cetokhilasuttavannana,6,6,0,0,21
418938,dvattiṃsavarapurisalakkhaṇapaṭimaṇḍitaṃ,dvattimsavarapurisalakkhanapatimanditam,1,1,0,0,39
418939,ātappāyāti,atappayati,5,0,5,0,10
418940,kilesasantāpakavīriyakaraṇatthāya,kilesasantapakaviriyakaranatthaya,2,2,0,0,33
418941,anuyogāyāti,anuyogayati,4,0,4,0,11
418942,yogāya,yogaya,3,3,0,0,6
418943,sātaccāyāti,sataccayati,4,1,3,0,11
418944,satatakiriyāya,satatakiriyaya,3,2,1,0,14
418945,padahanatthāya,padahanatthaya,5,5,0,0,14
418946,cetokhiloti,cetokhiloti,4,1,3,0,11
418947,vicikicchāsaṅkhāto,vicikicchasankhato,4,4,0,0,18
418948,magganissandaṃ,magganissandam,1,1,0,0,14
418949,adhicittaadhipaññāsikkhā,adhicittaadhipannasikkha,4,4,0,0,24
418950,pañcamoti,pancamoti,5,1,4,0,9
418951,kopasaṅkhāto,kopasankhato,3,3,0,0,12
418952,kacavarabhāvo,kacavarabhavo,4,4,0,0,13
418953,khāṇukabhāvo,khanukabhavo,3,3,0,0,12
418954,vinibandhasuttavaṇṇanā,vinibandhasuttavannana,1,1,0,0,22
418955,vinibandhitvā,vinibandhitva,3,2,1,0,13
418956,bahiddhārūpe,bahiddharupe,13,12,1,0,12
418957,dakkhiṇapassa,dakkhinapassa,1,1,0,0,13
418958,vāmapassānaṃ,vamapassanam,1,1,0,0,12
418959,yāgusuttādivaṇṇanā,yagusuttadivannana,1,1,0,0,18
418960,para207-208,para207-208,4,4,0,0,11
418961,para207-208_an5,para207-208_an5,1,1,0,0,15
418962,anulometvā,anulometva,3,3,0,0,10
418963,dhamaniyo,dhamaniyo,2,2,0,0,9
418964,āmāvasesakaṃ,amavasesakam,2,2,0,0,12
418965,gītassarasuttavaṇṇanā,gitassarasuttavannana,1,1,0,0,21
418966,āyatakenāti,ayatakenati,2,0,2,0,11
418967,paripuṇṇapadabyañjanakaṃ,paripunnapadabyanjanakam,1,1,0,0,24
418968,gāthāvattañca,gathavattanca,1,1,0,0,13
418969,nikāmayamānassāti,nikamayamanassati,1,0,1,0,17
418970,sarakiriyaṃ,sarakiriyam,3,2,1,0,11
418971,patthayamānassa,patthayamanassa,25,21,4,0,15
418972,muṭṭhassatisuttavaṇṇanā,mutthassatisuttavannana,1,1,0,0,23
418973,paṭibujjhantopi,patibujjhantopi,2,2,0,0,15
418974,akkosakasuttavaṇṇanā,akkosakasuttavannana,2,2,0,0,20
418975,chinnaparipanthoti,chinnaparipanthoti,1,0,1,0,18
418976,lokuttaraparipanthassa,lokuttaraparipanthassa,2,1,1,0,22
418977,kicchajīvikāyāvahanato,kicchajivikayavahanato,1,1,0,0,22
418978,bhaṇḍanakārakasuttavaṇṇanā,bhandanakarakasuttavannana,1,1,0,0,26
418979,adhikaraṇakārakoti,adhikaranakarakoti,1,0,1,0,18
418980,appattavisesaṃ,appattavisesam,1,1,0,0,14
418981,asīlo,asilo,5,3,2,0,5
418982,sīlavipannoti,silavipannoti,4,0,4,0,13
418983,vipannasīlo,vipannasilo,7,7,0,0,11
418984,bhinnasaṃvaro,bhinnasamvaro,10,10,0,0,13
418985,pamādakāraṇā,pamadakarana,8,8,0,0,12
418986,sippaṭṭhānena,sippatthanena,11,11,0,0,13
418987,māghātakālepi,maghatakalepi,1,1,0,0,13
418988,daṇḍavasena,dandavasena,5,5,0,0,11
418989,sattaariyadhanato,sattaariyadhanato,4,4,0,0,17
418990,asukakule,asukakule,16,16,0,0,9
418991,pariccattaidhalokaparaloko,pariccattaidhalokaparaloko,4,4,0,0,26
418992,salākabhattamattampi,salakabhattamattampi,5,5,0,0,20
418993,vejjakammādīhi,vejjakammadihi,4,4,0,0,14
418994,agāravehi,agaravehi,5,5,0,0,9
418995,avisāradoti,avisaradoti,4,0,4,0,11
418996,niggaṇhissanti,nigganhissanti,1,1,0,0,14
418997,pavāraṇampi,pavaranampi,7,7,0,0,11
418998,nikkaḍḍhissantī,nikkaddhissanti,5,5,0,0,15
418999,dappito,dappito,10,10,0,0,7
419000,dussīlakammaṃ,dussilakammam,8,8,0,0,13
419001,vattitaṭṭhānaṃ,vattitatthanam,2,1,1,0,14
419002,sattisatena,sattisatena,24,24,0,0,11
419003,pahariyamāno,pahariyamano,5,5,0,0,12
419004,vāretha,varetha,8,8,0,0,7
419005,vārethā,varetha,6,6,0,0,7
419006,pañcamapadaṃ,pancamapadam,4,2,2,0,12
419007,ānisaṃsakathā,anisamsakatha,7,5,2,0,13
419008,bahubhāṇisuttavaṇṇanā,bahubhanisuttavannana,1,1,0,0,21
419009,bhaṇante,bhanante,12,12,0,0,8
419010,paṭhamaakkhantisuttavaṇṇanā,pathamaakkhantisuttavannana,1,1,0,0,27
419011,puggalaverenapi,puggalaverenapi,1,1,0,0,15
419012,akusalaverenapi,akusalaverenapi,1,1,0,0,15
419013,dosabahulo,dosabahulo,1,1,0,0,10
419014,dutiyaakkhantisuttavaṇṇanā,dutiyaakkhantisuttavannana,1,1,0,0,26
419015,maṅkubhāvena,mankubhavena,3,3,0,0,12
419016,paṭhamaapāsādikasuttavaṇṇanā,pathamaapasadikasuttavannana,1,1,0,0,28
419017,apāsādiketi,apasadiketi,1,0,1,0,11
419018,apāsādikehi,apasadikehi,1,1,0,0,11
419019,pāsādiketi,pasadiketi,4,1,3,0,10
419020,pasādāvahe,pasadavahe,5,5,0,0,10
419021,parisuddhasamācāre,parisuddhasamacare,1,1,0,0,18
419022,madhurāsuttavaṇṇanā,madhurasuttavannana,1,1,0,0,19
419023,madhurānagaraṃ,madhuranagaram,1,1,0,0,14
419024,acelā,acela,1,1,0,0,5
419025,nillāletvā,nillaletva,3,3,0,0,10
419026,khādanīyabhojanīyañceva,khadaniyabhojaniyanceva,2,2,0,0,23
419027,sakkārasammānañca,sakkarasammananca,2,2,0,0,17
419028,niggaṇhanatthāya,nigganhanatthaya,2,2,0,0,16
419029,samatalā,samatala,3,3,0,0,8
419030,bahurajāti,bahurajati,1,0,1,0,10
419031,vātapaharaṇakāle,vatapaharanakale,1,1,0,0,16
419032,rajakkhandhena,rajakkhandhena,1,1,0,0,14
419033,paṭhamadīghacārikasuttavaṇṇanā,pathamadighacarikasuttavannana,1,1,0,0,30
419034,avavatthitacārikaṃ,avavatthitacarikam,1,1,0,0,18
419035,pariyodapetīti,pariyodapetiti,1,0,1,0,14
419036,pariyodapetuṃ,pariyodapetum,1,1,0,0,13
419037,thokathokena,thokathokena,1,1,0,0,12
419038,vijjamānenāpi,vijjamanenapi,1,1,0,0,13
419039,samavatthacāreti,samavatthacareti,1,0,1,0,16
419040,samavatthitacāre,samavatthitacare,1,1,0,0,16
419041,atinivāsasuttādivaṇṇanā,atinivasasuttadivannana,1,1,0,0,23
419042,para223-224,para223-224,1,1,0,0,11
419043,para223-224_an5,para223-224_an5,1,1,0,0,15
419044,bahubhaṇḍoti,bahubhandoti,1,0,1,0,12
419045,bahuparikkhāro,bahuparikkharo,10,10,0,0,14
419046,bahubhesajjoti,bahubhesajjoti,1,0,1,0,14
419047,sappinavanītādīnaṃ,sappinavanitadinam,3,3,0,0,18
419048,vaṇṇamaccharīti,vannamacchariti,1,0,1,0,15
419049,guṇamaccharī,gunamacchari,1,1,0,0,12
419050,dhammamaccharīti,dhammamacchariti,1,0,1,0,16
419051,pariyattimaccharī,pariyattimacchari,1,1,0,0,17
419052,kulūpakasuttādivaṇṇanā,kulupakasuttadivannana,3,3,0,0,22
419053,para225-226,para225-226,1,1,0,0,11
419054,para225-226_an5,para225-226_an5,1,1,0,0,15
419055,nisajjāyātiādīnipi,nisajjayatiadinipi,1,0,1,0,18
419056,atikkantapamāṇakālaṃ,atikkantapamanakalam,1,1,0,0,20
419057,ussūrabhattasuttavaṇṇanā,ussurabhattasuttavannana,1,1,0,0,24
419058,ussūrabhatteti,ussurabhatteti,1,0,1,0,14
419059,atidivāpacanabhatte,atidivapacanabhatte,1,1,0,0,19
419060,paṭipūjentīti,patipujentiti,2,0,2,0,13
419061,yāgukāle,yagukale,1,1,0,0,8
419062,khajjakakāle,khajjakakale,1,1,0,0,12
419063,apacantā,apacanta,1,1,0,0,8
419064,yuttappayuttakālassa,yuttappayuttakalassa,1,1,0,0,20
419065,atināmitattā,atinamitatta,1,1,0,0,12
419066,kulapaveṇiyā,kulapaveniya,3,3,0,0,12
419067,labhamānāyeva,labhamanayeva,1,1,0,0,13
419068,samaṇabrāhmaṇāpi,samanabrahmanapi,2,2,0,0,16
419069,maṅgalāmaṅgalesu,mangalamangalesu,5,5,0,0,16
419070,paṭhamakaṇhasappasuttavaṇṇanā,pathamakanhasappasuttavannana,1,1,0,0,29
419071,sabhīrūti,sabhiruti,1,0,1,0,9
419072,saniddo,saniddo,1,1,0,0,7
419073,mahāniddaṃ,mahaniddam,9,9,0,0,10
419074,sappaṭibhayoti,sappatibhayoti,2,0,2,0,14
419075,mittadubbhīti,mittadubbhiti,2,0,2,0,13
419076,pānabhojanadāyakampi,panabhojanadayakampi,1,1,0,0,20
419077,mātugāmepi,matugamepi,1,1,0,0,10
419078,dutiyakaṇhasappasuttavaṇṇanā,dutiyakanhasappasuttavannana,1,1,0,0,28
419079,kakkhaḷaviso,kakkhalaviso,2,2,0,0,12
419080,dujjivhoti,dujjivhoti,1,0,1,0,10
419081,bhinnajivho,bhinnajivho,1,1,0,0,11
419082,ghoravisatāti,ghoravisatati,1,0,1,0,13
419083,ghoravisatāya,ghoravisataya,2,2,0,0,13
419084,āvāsikasuttavaṇṇanā,avasikasuttavannana,1,1,0,0,19
419085,vaḍḍhanīyo,vaddhaniyo,1,1,0,0,10
419086,bahūpakārasuttavaṇṇanā,bahupakarasuttavannana,1,1,0,0,22
419087,patitaṭṭhānañca,patitatthananca,1,1,0,0,15
419088,bhinnaṭṭhānañca,bhinnatthananca,1,1,0,0,15
419089,paṭisaṅkharotīti,patisankharotiti,1,0,1,0,16
419090,pavāritakulānaṃ,pavaritakulanam,1,1,0,0,15
419091,anukampasuttavaṇṇanā,anukampasuttavannana,1,1,0,0,20
419092,adhisīlesūti,adhisilesuti,1,0,1,0,12
419093,nivesetīti,nivesetiti,6,1,5,0,10
419094,catusaccadhammadassane,catusaccadhammadassane,1,1,0,0,22
419095,sabbasakkārānaṃ,sabbasakkaranam,1,1,0,0,15
419096,ratanattayeva,ratanattayeva,1,1,0,0,13
419097,garucittīkāraṃ,garucittikaram,9,7,2,0,14
419098,upaṭṭhapethāti,upatthapethati,3,2,1,0,14
419099,dutiyaavaṇṇārahasuttavaṇṇanā,dutiyaavannarahasuttavannana,1,1,0,0,28
419100,āvāsapaligedhīti,avasapaligedhiti,1,0,1,0,16
419101,balavagiddhivasena,balavagiddhivasena,1,1,0,0,18
419102,paṭhamaduccaritasuttavaṇṇanā,pathamaduccaritasuttavannana,1,1,0,0,28
419103,sucariteti,sucariteti,1,0,1,0,10
419104,kāyaduccaritetiādi,kayaduccaritetiadi,1,0,1,0,18
419105,kāyadvārādīnaṃ,kayadvaradinam,1,1,0,0,14
419106,asaddhammeti,asaddhammeti,1,0,1,0,12
419107,akusalakammapathasaṅkhāte,akusalakammapathasankhate,1,1,0,0,25
419108,assaddhamme,assaddhamme,1,1,0,0,11
419109,sivathikasuttavaṇṇanā,sivathikasuttavannana,1,1,0,0,21
419110,sivathikāyāti,sivathikayati,1,0,1,0,13
419111,ārodanāti,arodanati,1,0,1,0,9
419112,ārodanaṭṭhānaṃ,arodanatthanam,1,1,0,0,14
419113,jigucchanīyena,jigucchaniyena,1,1,0,0,14
419114,puggalappasādasuttavaṇṇanā,puggalappasadasuttavannana,1,1,0,0,26
419115,puggalappasādeti,puggalappasadeti,1,0,1,0,16
419116,ekapuggalasmiṃ,ekapuggalasmim,1,1,0,0,14
419117,uppannappasāde,uppannappasade,1,1,0,0,14
419118,nisīdāpetīti,nisidapetiti,3,1,2,0,12
419119,āsanapariyante,asanapariyante,13,13,0,0,14
419120,upasampādetabbasuttādivaṇṇanā,upasampadetabbasuttadivannana,1,1,0,0,29
419121,para251-253,para251-253,1,1,0,0,11
419122,para251-253_an5,para251-253_an5,1,1,0,0,15
419123,upaṭṭhāpetabboti,upatthapetabboti,10,3,7,0,16
419124,khīṇāsavavasena,khinasavavasena,7,7,0,0,15
419125,catutthādīni,catutthadini,14,14,0,0,12
419126,anupadavaṇṇanāto,anupadavannanato,1,1,0,0,16
419127,sammutipeyyālādivaṇṇanā,sammutipeyyaladivannana,1,1,0,0,23
419128,bhattuddesakādīnaṃ,bhattuddesakadinam,1,1,0,0,18
419129,pesetabboti,pesetabboti,1,0,1,0,11
419130,uddisāhī,uddisahi,2,2,0,0,8
419131,sāṭiyaggāhāpakoti,satiyaggahapakoti,2,0,2,0,17
419132,vassikasāṭikāya,vassikasatikaya,34,34,0,0,15
419133,pattaggāhāpakoti,pattaggahapakoti,1,0,1,0,16
419134,pattapariyanto,pattapariyanto,7,5,2,0,14
419135,padātabbo,padatabbo,17,15,2,0,9
419136,vuttapattaggāhāpako,vuttapattaggahapako,1,1,0,0,19
419137,para293-302,para293-302,1,1,0,0,11
419138,para293-302_an5,para293-302_an5,1,1,0,0,15
419139,ājīvakoti,ajivakoti,4,1,3,0,9
419140,naggaparibbājako,naggaparibbajako,6,5,1,0,16
419141,nigaṇṭhoti,niganthoti,5,1,4,0,10
419142,purimabhāgappaṭicchanno,purimabhagappaticchanno,1,1,0,0,23
419143,muṇḍasāvakoti,mundasavakoti,1,0,1,0,13
419144,jaṭilakoti,jatilakoti,1,0,1,0,10
419145,māgaṇḍikā,magandika,1,0,1,0,9
419146,para0_an6,para0_an6,2,2,0,0,9
419147,chakkanipātaaṭṭhakathā,chakkanipataatthakatha,1,1,0,0,22
419148,paṭhamaāhuneyyasuttavaṇṇanā,pathamaahuneyyasuttavannana,3,3,0,0,27
419149,chakkanipātassa,chakkanipatassa,3,3,0,0,15
419150,rāgasahagatena,ragasahagatena,1,1,0,0,14
419151,dosasahagatena,dosasahagatena,1,1,0,0,14
419152,upekkhakabhāvaṃ,upekkhakabhavam,1,1,0,0,15
419153,satatavihāro,satataviharo,6,5,1,0,12
419154,dutiyaāhuneyyasuttavaṇṇanā,dutiyaahuneyyasuttavannana,1,1,0,0,26
419155,para2-4,para2-4,2,2,0,0,7
419156,para2-4_an6,para2-4_an6,1,1,0,0,11
419157,ājānīyasuttattayavaṇṇanā,ajaniyasuttattayavannana,1,1,0,0,24
419158,para5-7,para5-7,5,5,0,0,7
419159,para5-7_an6,para5-7_an6,1,1,0,0,11
419160,khamoti,khamoti,6,0,6,0,7
419161,adhivāsako,adhivasako,2,2,0,0,10
419162,anuttariyasuttādivaṇṇanā,anuttariyasuttadivannana,1,1,0,0,24
419163,para8-9,para8-9,5,5,0,0,7
419164,para8-9_an6,para8-9_an6,1,1,0,0,11
419165,anuttariyānīti,anuttariyaniti,5,0,5,0,14
419166,uttaritarena,uttaritarena,2,2,0,0,12
419167,niruttarāni,niruttarani,1,1,0,0,11
419168,rūpadassanesu,rupadassanesu,1,1,0,0,13
419169,hatthiratanādīnañhi,hatthiratanadinanhi,1,1,0,0,19
419170,niviṭṭhasaddhassa,nivitthasaddhassa,4,4,0,0,17
419171,niviṭṭhapemavasena,nivitthapemavasena,4,4,0,0,18
419172,kasiṇaasubhanimittādīnaṃ,kasinaasubhanimittadinam,1,1,0,0,24
419173,guṇakathāsavanaṃ,gunakathasavanam,4,4,0,0,16
419174,tepiṭakabuddhavacanasavanaṃ,tepitakabuddhavacanasavanam,2,2,0,0,27
419175,maṇiratanādīnaṃ,maniratanadinam,1,1,0,0,15
419176,sattavidhaariyadhanalābho,sattavidhaariyadhanalabho,2,2,0,0,25
419177,hatthisippādisikkhanaṃ,hatthisippadisikkhanam,2,2,0,0,22
419178,sikkhāttayassa,sikkhattayassa,2,1,1,0,14
419179,mahānāmasuttavaṇṇanā,mahanamasuttavannana,3,3,0,0,20
419180,mahānāmoti,mahanamoti,4,0,4,0,10
419181,cūḷapitu,culapitu,12,12,0,0,8
419182,dāsaparijanaparivuto,dasaparijanaparivuto,1,1,0,0,20
419183,sikkhāttayasāsanaṃ,sikkhattayasasanam,1,1,0,0,18
419184,ujugataṃ,ujugatam,6,4,2,0,8
419185,buddhānussatikammaṭṭhāne,buddhanussatikammatthane,1,1,0,0,24
419186,pamuditassāti,pamuditassati,2,0,2,0,13
419187,darathapaṭippassaddhiyā,darathapatippassaddhiya,3,3,0,0,23
419188,rāgadosamohavisamagatesu,ragadosamohavisamagatesu,1,1,0,0,24
419189,samappattoti,samappattoti,1,0,1,0,12
419190,sabyāpajjhāyāti,sabyapajjhayati,1,0,1,0,15
419191,sadukkhāya,sadukkhaya,1,1,0,0,10
419192,vipassanāsaṅkhātaṃ,vipassanasankhatam,4,4,0,0,18
419193,paṭhamasāraṇīyasuttavaṇṇanā,pathamasaraniyasuttavannana,3,3,0,0,27
419194,sāraṇīyāti,saraniyati,5,0,5,0,10
419195,saritabbayuttakā,saritabbayuttaka,1,1,0,0,16
419196,gihīsupi,gihisupi,7,7,0,0,8
419197,bhikkhūnañhi,bhikkhunanhi,9,9,0,0,12
419198,ābhisamācārikadhammapūraṇaṃ,abhisamacarikadhammapuranam,4,3,1,0,27
419199,saṅghanimantanatthāya,sanghanimantanatthaya,5,5,0,0,21
419200,anugamananti,anugamananti,8,8,0,0,12
419201,ācārapaṇṇattisikkhāpanaṃ,acarapannattisikkhapanam,1,1,0,0,24
419202,kammaṭṭhānakathanaṃ,kammatthanakathanam,4,4,0,0,19
419203,cetiyavandanāya,cetiyavandanaya,5,5,0,0,15
419204,bodhivandanāya,bodhivandanaya,2,2,0,0,14
419205,dīpamālāpupphapūjaṃ,dipamalapupphapujam,2,2,0,0,19
419206,vattissāma,vattissama,6,6,0,0,10
419207,khādanīyādīni,khadaniyadini,8,8,0,0,13
419208,saṃvidahatha,samvidahatha,10,10,0,0,12
419209,upaṭṭhāpetha,upatthapetha,3,3,0,0,12
419210,itiādivacanakāle,itiadivacanakale,2,2,0,0,16
419211,cetiyaṅgaṇavattādīni,cetiyanganavattadini,8,8,0,0,20
419212,abyāpajjhā,abyapajjha,11,11,0,0,10
419213,sahāyabhāvagamanaṃ,sahayabhavagamanam,7,5,2,0,18
419214,pādadhovanadānādibhedaṃ,padadhovanadanadibhedam,1,1,0,0,23
419215,ubhayehipi,ubhayehipi,11,11,0,0,10
419216,dunnikkhittānaṃ,dunnikkhittanam,11,11,0,0,15
419217,dārubhaṇḍādīnaṃ,darubhandadinam,5,5,0,0,15
419218,avaññaṃ,avannam,7,6,1,0,7
419219,paṭipucchantassa,patipucchantassa,4,4,0,0,16
419220,mamāyanavacanaṃ,mamayanavacanam,8,4,4,0,15
419221,mettāsinehasiniddhāni,mettasinehasiniddhani,5,5,0,0,21
419222,samannāharaṇaṃ,samannaharanam,6,5,1,0,14
419223,kuhanādibhedaṃ,kuhanadibhedam,4,4,0,0,14
419224,bhikkhācariyavattena,bhikkhacariyavattena,5,5,0,0,20
419225,pattapariyāpannamattampīti,pattapariyapannamattampiti,4,0,4,0,26
419226,dvattikaṭacchubhikkhāmattampi,dvattikatacchubhikkhamattampi,3,3,0,0,29
419227,appaṭivibhattabhogīti,appativibhattabhogiti,4,0,4,0,21
419228,paṭivibhattāni,pativibhattani,5,3,2,0,14
419229,āmisapaṭivibhattaṃ,amisapativibhattam,6,5,1,0,18
419230,puggalapaṭivibhattañca,puggalapativibhattanca,3,3,0,0,22
419231,paṭivibhajanaṃ,pativibhajanam,1,1,0,0,14
419232,puggalapaṭivibhattaṃ,puggalapativibhattam,3,2,1,0,20
419233,appaṭivibhattaṃ,appativibhattam,19,14,5,0,15
419234,sādhāraṇabhogīti,sadharanabhogiti,4,0,4,0,16
419235,sādhāraṇabhogino,sadharanabhogino,4,4,0,0,16
419236,lābhenalābhaṃnijigīsanatāmukhena,labhenalabhamnijigisanatamukhena,1,1,0,0,32
419237,ghaṇṭiṃ,ghantim,44,43,1,0,7
419238,saṅghasantakaṃ,sanghasantakam,24,23,1,0,14
419239,akhaṇḍento,akhandento,5,4,1,0,10
419240,ācariyupajjhāyādīnaṃ,acariyupajjhayadinam,10,10,0,0,20
419241,palibodhajagganaṃ,palibodhajagganam,6,4,2,0,17
419242,muttapalibodhassa,muttapalibodhassa,2,1,1,0,17
419243,gilānagilānupaṭṭhākaāgantukagamikānañceva,gilanagilanupatthakaagantukagamikananceva,4,4,0,0,41
419244,navapabbajitassa,navapabbajitassa,6,6,0,0,16
419245,saṅghāṭipattaggahaṇaṃ,sanghatipattaggahanam,4,4,0,0,21
419246,sīlavantehī,silavantehi,5,5,0,0,11
419247,adātumpi,adatumpi,6,6,0,0,8
419248,susikkhitāya,susikkhitaya,11,9,2,0,12
419249,supūro,supuro,5,5,0,0,6
419250,piṇḍapātapūraṃ,pindapatapuram,4,4,0,0,14
419251,kasseso,kasseso,13,13,0,0,7
419252,sāraṇīyadhammapūrakassā,saraniyadhammapurakassa,3,3,0,0,23
419253,rittapattaṃ,rittapattam,6,6,0,0,11
419254,paribhuñjiṃsū,paribhunjimsu,11,11,0,0,13
419255,pūretabbo,puretabbo,7,7,0,0,9
419256,titthiyaparivāsasadiso,titthiyaparivasasadiso,4,4,0,0,22
419257,pūretabbova,puretabbova,4,4,0,0,11
419258,pūritasāraṇīyadhammassa,puritasaraniyadhammassa,4,4,0,0,23
419259,sulabhapaccayo,sulabhapaccayo,6,4,2,0,14
419260,pattagatamassa,pattagatamassa,5,4,1,0,14
419261,bhājanīyabhaṇḍaṭṭhāne,bhajaniyabhandatthane,10,8,2,0,21
419262,aggabhaṇḍaṃ,aggabhandam,14,9,5,0,11
419263,senagirivāsī,senagirivasi,2,1,1,0,12
419264,mahāgirigāmaṃ,mahagirigamam,3,3,0,0,13
419265,vicarimhā,vicarimha,9,9,0,0,9
419266,pattatemanamattampi,pattatemanamattampi,4,4,0,0,19
419267,nevāsikā,nevasika,26,26,0,0,8
419268,alabhantāpi,alabhantapi,6,6,0,0,11
419269,bhikkhācāramaggasabhāgaṃ,bhikkhacaramaggasabhagam,5,3,2,0,24
419270,dhurageheyeva,dhurageheyeva,5,5,0,0,13
419271,khīrabhattaṃ,khirabhattam,21,20,1,0,12
419272,olokanākāreneva,olokanakareneva,4,4,0,0,15
419273,nikkukkuccā,nikkukkucca,5,5,0,0,11
419274,paṭivijjhī,pativijjhi,9,5,4,0,10
419275,jhānalābhīsi,jhanalabhisi,4,4,0,0,12
419276,pūritakālato,puritakalato,8,8,0,0,12
419277,anucchavikamidaṃ,anucchavikamidam,8,8,0,0,16
419278,giribhaṇḍamahāpūjāya,giribhandamahapujaya,4,4,0,0,20
419279,dānaṭṭhānaṃ,danatthanam,6,6,0,0,11
419280,varabhaṇḍaṃ,varabhandam,9,7,2,0,11
419281,sukhumasāṭakā,sukhumasataka,3,3,0,0,13
419282,vaṭṭantī,vattanti,63,50,13,0,8
419283,ṭhapitāpi,thapitapi,11,11,0,0,9
419284,paṭivijjhitthā,pativijjhittha,4,4,0,0,14
419285,avadanto,avadanto,6,6,0,0,8
419286,avacutthāti,avacutthati,4,4,0,0,11
419287,bhātaragāmavāsino,bhataragamavasino,4,4,0,0,17
419288,nāgattheriyā,nagattheriya,4,4,0,0,12
419289,anārocetvāva,anarocetvava,26,24,2,0,12
419290,appanigghoso,appanigghoso,6,6,0,0,12
419291,uddesaparipucchāyonisomanasikāresuyeva,uddesaparipucchayonisomanasikaresuyeva,4,4,0,0,38
419292,attadvādasamā,attadvadasama,4,4,0,0,13
419293,nāgatthero,nagatthero,10,10,0,0,10
419294,attadvādasamova,attadvadasamova,3,3,0,0,15
419295,vasanaṭṭhānā,vasanatthana,19,19,0,0,12
419296,bhātaragāmaṃ,bhataragamam,4,4,0,0,12
419297,gamissathā,gamissatha,26,26,0,0,10
419298,paribhuñjathāti,paribhunjathati,12,11,1,0,15
419299,therīti,theriti,5,4,1,0,7
419300,sattatālamatte,sattatalamatte,6,6,0,0,14
419301,bhikkhunībhattameva,bhikkhunibhattameva,3,3,0,0,19
419302,piṇḍapātika,pindapatika,4,4,0,0,11
419303,bhikkhunībhattaṃ,bhikkhunibhattam,3,3,0,0,16
419304,vītināmayitthā,vitinamayittha,4,4,0,0,14
419305,anuvadiyamāno,anuvadiyamano,4,4,0,0,13
419306,rukkhadevatāpi,rukkhadevatapi,7,7,0,0,14
419307,paribhuñjissati,paribhunjissati,15,15,0,0,15
419308,nivattessāmi,nivattessami,7,7,0,0,12
419309,nivattessāmī,nivattessami,8,8,0,0,12
419310,cintayamānā,cintayamana,9,9,0,0,11
419311,sāraṇīyadhammapūrikā,saraniyadhammapurika,8,6,2,0,20
419312,akhaṇḍānītiādīsu,akhandanitiadisu,5,0,5,0,16
419313,aññataravaṇṇā,annataravanna,3,3,0,0,13
419314,āpannapubbo,apannapubbo,4,4,0,0,11
419315,disābhāgesu,disabhagesu,5,5,0,0,11
419316,viharantehi,viharantehi,6,6,0,0,11
419317,samānabhāvūpagatasīlo,samanabhavupagatasilo,7,4,3,0,21
419318,sotāpannādīnañhi,sotapannadinanhi,4,4,0,0,16
419319,samuddantarepi,samuddantarepi,4,4,0,0,14
419320,maggasīle,maggasile,6,4,2,0,9
419321,sabbadukkhakkhayatthaṃ,sabbadukkhakkhayattham,4,4,0,0,22
419322,diṭṭhisāmaññagatoti,ditthisamannagatoti,5,0,5,0,19
419323,samānadiṭṭhibhāvaṃ,samanaditthibhavam,8,5,3,0,18
419324,dutiyasāraṇīyasuttavaṇṇanā,dutiyasaraniyasuttavannana,3,3,0,0,26
419325,saṅgahāyāti,sangahayati,4,0,4,0,11
419326,avivādāyāti,avivadayati,3,0,3,0,11
419327,avivadanatthāya,avivadanatthaya,1,1,0,0,15
419328,sāmaggiyāti,samaggiyati,4,0,4,0,11
419329,samaggabhāvatthāya,samaggabhavatthaya,2,2,0,0,18
419330,ekībhāvāyāti,ekibhavayati,4,0,4,0,12
419331,ekabhāvatthāya,ekabhavatthaya,1,1,0,0,14
419332,ninnānākaraṇāya,ninnanakaranaya,2,2,0,0,15
419333,nissaraṇadhātuyova,nissaranadhatuyova,1,1,0,0,18
419334,tikacatukkajjhānikā,tikacatukkajjhanika,1,1,0,0,19
419335,bahulīkatāti,bahulikatati,7,0,7,0,12
419336,yānīkatāti,yanikatati,10,0,10,0,10
419337,yuttayānasadisā,yuttayanasadisa,4,3,1,0,15
419338,vatthukatāti,vatthukatati,13,0,13,0,12
419339,anuṭṭhitāti,anutthitati,11,0,11,0,11
419340,adhiṭṭhitā,adhitthita,26,26,0,0,10
419341,ācitā,acita,4,4,0,0,5
419342,upacitā,upacita,4,3,1,0,7
419343,suppaguṇakaraṇena,suppagunakaranena,1,1,0,0,17
419344,hevantissa,hevantissa,5,0,5,0,10
419345,vacanīyoti,vacaniyoti,19,5,14,0,10
419346,abhūtabyākaraṇaṃ,abhutabyakaranam,3,2,1,0,16
419347,bhaṇī,bhani,11,11,0,0,5
419348,mettācetovimuttīti,mettacetovimuttiti,3,0,3,0,18
419349,tikacatukkajjhānato,tikacatukkajjhanato,3,3,0,0,19
419350,tatiyaphalena,tatiyaphalena,2,2,0,0,13
419351,accantanissaraṇaṃ,accantanissaranam,2,2,0,0,17
419352,animittācetovimuttīti,animittacetovimuttiti,1,0,1,0,21
419353,arahattaphalasamāpattīti,arahattaphalasamapattiti,2,2,0,0,24
419354,rāganimittādīnañceva,raganimittadinanceva,2,2,0,0,20
419355,rūpanimittādīnañca,rupanimittadinanca,2,2,0,0,18
419356,nimittānusārīti,nimittanusariti,4,0,4,0,15
419357,anusaraṇasabhāvaṃ,anusaranasabhavam,2,1,1,0,17
419358,vicikicchābhūtaṃ,vicikicchabhutam,2,2,0,0,16
419359,kathaṃkathāsallaṃ,kathamkathasallam,12,12,0,0,17
419360,arahattabyākaraṇaṃ,arahattabyakaranam,2,2,0,0,18
419361,mānasamugghātoti,manasamugghatoti,1,0,1,0,16
419362,arahattamaggaphalavasena,arahattamaggaphalavasena,2,2,0,0,24
419363,bhaddakasuttavaṇṇanā,bhaddakasuttavannana,1,1,0,0,20
419364,bhītabhīto,bhitabhito,1,1,0,0,10
419365,kammārāmotiādīsu,kammaramotiadisu,1,0,1,0,16
419366,vihārakaraṇādimhi,viharakaranadimhi,1,1,0,0,17
419367,ālāpasallāpo,alapasallapo,5,5,0,0,12
419368,saṅgaṇikāti,sanganikati,6,1,5,0,11
419369,tatiyako,tatiyako,5,4,1,0,8
419370,dassanasavanasamullāpasambhogakāyasaṃsaggavasena,dassanasavanasamullapasambhogakayasamsaggavasena,1,1,0,0,48
419371,saṃsaṭṭhabhāvo,samsatthabhavo,3,3,0,0,14
419372,taṇhādiṭṭhimānavasena,tanhaditthimanavasena,2,2,0,0,21
419373,madanākārasaṇṭhito,madanakarasanthito,1,1,0,0,18
419374,kilesapapañco,kilesapapanco,1,1,0,0,13
419375,sakalavaṭṭadukkhassa,sakalavattadukkhassa,8,8,0,0,20
419376,parivaṭumaparicchedakaraṇatthaṃ,parivatumaparicchedakaranattham,1,1,0,0,31
419377,nippapañcapadeti,nippapancapadeti,1,0,1,0,16
419378,ārādhayīti,aradhayiti,1,0,1,0,10
419379,sampādesīti,sampadesiti,1,1,0,0,11
419380,anutappiyasuttavaṇṇanā,anutappiyasuttavannana,1,1,0,0,22
419381,anutappāti,anutappati,1,0,1,0,10
419382,anusocitabbā,anusocitabba,1,1,0,0,12
419383,nakulapitusuttavaṇṇanā,nakulapitusuttavannana,6,6,0,0,22
419384,bāḷhagilānoti,balhagilanoti,6,0,6,0,13
419385,adhimattagilāno,adhimattagilano,6,5,1,0,15
419386,sāpekkhoti,sapekkhoti,2,0,2,0,10
419387,sataṇho,satanho,10,9,1,0,7
419388,nakulamātāti,nakulamatati,5,2,3,0,12
419389,sakkhatīti,sakkhatiti,3,2,1,0,10
419390,santharituṃ,santharitum,9,8,1,0,11
419391,nicchiddaṃ,nicchiddam,2,2,0,0,10
419392,saṇṭhapetunti,santhapetunti,1,1,0,0,13
419393,soḷasavassamatthake,solasavassamatthake,1,1,0,0,19
419394,gahaṭṭhabrahmacariyavāso,gahatthabrahmacariyavaso,1,1,0,0,24
419395,dassanakāmatarāti,dassanakamatarati,1,0,1,0,17
419396,sīlādiguṇehipi,siladigunehipi,2,2,0,0,14
419397,tetiādimāha,tetiadimaha,5,0,5,0,11
419398,paripūrakārinīti,paripurakariniti,3,0,3,0,16
419399,samattakārinī,samattakarini,1,1,0,0,13
419400,ogādhappattāti,ogadhappattati,1,0,1,0,14
419401,ogādhaṃ,ogadham,1,1,0,0,7
419402,anuppavesaṃ,anuppavesam,3,3,0,0,11
419403,patigādhappattāti,patigadhappattati,1,0,1,0,17
419404,patigādhaṃ,patigadham,1,1,0,0,10
419405,assāsappattāti,assasappattati,2,0,2,0,14
419406,vesārajjappattāti,vesarajjappattati,2,0,2,0,17
419407,somanassañāṇaṃ,somanassananam,1,1,0,0,14
419408,aparappaccayāti,aparappaccayati,2,0,2,0,15
419409,parappaccayo,parappaccayo,5,5,0,0,12
419410,parasaddhā,parasaddha,1,1,0,0,10
419411,parapattiyāyanā,parapattiyayana,1,1,0,0,15
419412,yattikāyo,yattikayo,1,1,0,0,9
419413,anukampikāti,anukampikati,4,0,4,0,12
419414,hitānukampikā,hitanukampika,1,1,0,0,13
419415,ovādikāti,ovadikati,1,0,1,0,9
419416,ovādadāyikā,ovadadayika,1,1,0,0,11
419417,anusāsikāti,anusasikati,1,0,1,0,11
419418,anusiṭṭhidāyikā,anusitthidayika,1,1,0,0,15
419419,soppasuttavaṇṇanā,soppasuttavannana,3,3,0,0,17
419420,dhammanijjhānakkhantito,dhammanijjhanakkhantito,2,2,0,0,23
419421,phalasamāpattivihārato,phalasamapattiviharato,1,1,0,0,22
419422,vasanavihāraṃ,vasanaviharam,4,4,0,0,13
419423,kākasaddaṃ,kakasaddam,2,2,0,0,10
419424,seyyasukhā,seyyasukha,1,0,1,0,10
419425,raṭṭhikoti,ratthikoti,1,0,1,0,10
419426,pettaṇikoti,pettanikoti,1,0,1,0,11
419427,bhuttānubhuttaṃ,bhuttanubhuttam,1,1,0,0,15
419428,senāpatikoti,senapatikoti,1,0,1,0,12
419429,gāmagāmaṇikoti,gamagamanikoti,1,0,1,0,14
419430,pūgagāmaṇikoti,pugagamanikoti,1,0,1,0,14
419431,anesako,anesako,1,1,0,0,7
419432,agavesako,agavesako,1,1,0,0,9
419433,macchabandhasuttavaṇṇanā,macchabandhasuttavannana,3,3,0,0,24
419434,macchaghātakaṃ,macchaghatakam,2,1,1,0,14
419435,vajjheti,vajjheti,1,0,1,0,8
419436,vadhitabbe,vadhitabbe,1,1,0,0,10
419437,vadhāyanīteti,vadhayaniteti,1,0,1,0,13
419438,lāmakena,lamakena,7,7,0,0,8
419439,vadhāyupanīteti,vadhayupaniteti,1,1,0,0,15
419440,māgavikoti,magavikoti,1,0,1,0,10
419441,migaghātako,migaghatako,1,1,0,0,11
419442,anupekkhati,anupekkhati,2,2,0,0,11
419443,aniṭṭhaphalabhāvaṃ,anitthaphalabhavam,1,1,0,0,18
419444,akusalapakkhova,akusalapakkhova,1,1,0,0,15
419445,paṭhamamaraṇassatisuttavaṇṇanā,pathamamaranassatisuttavannana,3,3,0,0,30
419446,nātiketi,natiketi,2,0,2,0,8
419447,giñjakāvasatheti,ginjakavasatheti,6,0,6,0,16
419448,iṭṭhakāmaye,itthakamaye,7,4,3,0,11
419449,nibbānogadhā,nibbanogadha,3,3,0,0,12
419450,nibbānapatiṭṭhāti,nibbanapatitthati,1,1,0,0,17
419451,maraṇassatikammaṭṭhānaṃ,maranassatikammatthanam,2,2,0,0,23
419452,patthanatthe,patthanatthe,5,4,1,0,12
419453,paviṭṭhavāto,pavitthavato,2,1,1,0,12
419454,asīghappavattaṃ,asighappavattam,1,1,0,0,15
419455,dutiyamaraṇassatisuttavaṇṇanā,dutiyamaranassatisuttavannana,3,3,0,0,29
419456,patigatāyāti,patigatayati,2,0,2,0,12
419457,paṭipannāya,patipannaya,7,7,0,0,11
419458,samaṇadhammantarāyo,samanadhammantarayo,1,1,0,0,19
419459,ajiṇṇakādivasena,ajinnakadivasena,1,1,0,0,16
419460,payogavīriyaṃ,payogaviriyam,2,1,1,0,13
419461,ussāpanavīriyaṃ,ussapanaviriyam,1,1,0,0,15
419462,sampādanavīriyaṃ,sampadanaviriyam,1,1,0,0,16
419463,anukkaṇṭhanā,anukkanthana,2,1,1,0,12
419464,appaṭisaṅgharaṇā,appatisangharana,2,1,1,0,16
419465,sāmakasuttādivaṇṇanā,samakasuttadivannana,3,3,0,0,20
419466,para21-22_an6,para21-22_an6,2,2,0,0,13
419467,sāmagāmaketi,samagamaketi,1,0,1,0,12
419468,sāmakānaṃ,samakanam,1,1,0,0,9
419469,evaṃladdhanāme,evamladdhaname,11,11,0,0,14
419470,pokkharaṇiyānāmake,pokkharaniyanamake,1,1,0,0,18
419471,abhikkantaatimanāpavaṇṇā,abhikkantaatimanapavanna,1,1,0,0,24
419472,pokkharaṇiyānāmakaṃ,pokkharaniyanamakam,1,1,0,0,19
419473,samānaanuñño,samanaanunno,1,1,0,0,12
419474,samānacitto,samanacitto,2,1,1,0,11
419475,lāmakamittatā,lamakamittata,1,1,0,0,13
419476,parihāniyadhammāva,parihaniyadhammava,1,1,0,0,18
419477,aparihāniyadhammā,aparihaniyadhamma,1,1,0,0,17
419478,kāmarāgaratto,kamaragaratto,1,1,0,0,13
419479,chandarāgavinibaddhoti,chandaragavinibaddhoti,2,0,2,0,22
419480,cittutrāsabhayā,cittutrasabhaya,1,1,0,0,15
419481,paṅkāti,pankati,1,0,1,0,7
419482,kilesapaṅkato,kilesapankato,2,2,0,0,13
419483,jātimaraṇānaṃ,jatimarananam,4,3,1,0,13
419484,saṅkhayasaṅkhāte,sankhayasankhate,3,2,1,0,16
419485,arahattameva,arahattameva,29,29,0,0,12
419486,khemappattātiādimāha,khemappattatiadimaha,1,0,1,0,20
419487,khemappattāti,khemappattati,1,0,1,0,13
419488,kilesābhāvena,kilesabhavena,11,11,0,0,13
419489,diṭṭhadhammeyeva,ditthadhammeyeva,4,4,0,0,16
419490,abhinibbutā,abhinibbuta,3,3,0,0,11
419491,vaṭṭavivaṭaṃ,vattavivatam,1,1,0,0,12
419492,himavantasuttavaṇṇanā,himavantasuttavannana,6,6,0,0,21
419493,padāleyyāti,padaleyyati,5,1,4,0,11
419494,lāmikāya,lamikaya,4,4,0,0,8
419495,āhārasappāyautusappāyāni,aharasappayautusappayani,1,1,0,0,24
419496,ṭhitikusaloti,thitikusaloti,3,0,3,0,13
419497,vuṭṭhānakusaloti,vutthanakusaloti,2,0,2,0,16
419498,kallitakusaloti,kallitakusaloti,2,0,2,0,15
419499,kallatāya,kallataya,2,2,0,0,9
419500,samādhicittaṃ,samadhicittam,2,2,0,0,13
419501,hāsetuṃ,hasetum,5,4,1,0,7
419502,gocarakusaloti,gocarakusaloti,4,0,4,0,14
419503,anupakārake,anupakarake,2,1,1,0,11
419504,sevantopi,sevantopi,1,1,0,0,9
419505,samādhinimittārammaṇo,samadhinimittarammano,1,1,0,0,21
419506,lakkhaṇārammaṇo,lakkhanarammano,1,1,0,0,15
419507,abhinīhārakusaloti,abhiniharakusaloti,2,0,2,0,18
419508,upariuparisamāpattisamāpajjanatthāya,upariuparisamapattisamapajjanatthaya,1,1,0,0,36
419509,paṭhamajjhānādisamādhiṃ,pathamajjhanadisamadhim,3,2,1,0,23
419510,anussatiṭṭhānasuttavaṇṇanā,anussatitthanasuttavannana,5,5,0,0,26
419511,anussatiṭṭhānānīti,anussatitthananiti,3,0,3,0,18
419512,anussatikāraṇāni,anussatikaranani,1,1,0,0,16
419513,bhagavātiādīni,bhagavatiadini,3,0,3,0,14
419514,paramavisuddhiṃ,paramavisuddhim,3,3,0,0,15
419515,mahākaccānasuttavaṇṇanā,mahakaccanasuttavannana,3,3,0,0,23
419516,pañcakāmaguṇasambādhe,pancakamagunasambadhe,2,2,0,0,21
419517,okāsādhigamoti,okasadhigamoti,7,1,6,0,14
419518,sokānañca,sokananca,1,1,0,0,9
419519,paridevānañca,paridevananca,1,1,0,0,13
419520,sahavipassanakassa,sahavipassanakassa,4,2,2,0,18
419521,paccakkhakiriyatthāya,paccakkhakiriyatthaya,2,2,0,0,21
419522,ākāsasamenāti,akasasamenati,1,0,1,0,13
419523,apalibuddhaṭṭhena,apalibuddhatthena,1,1,0,0,17
419524,ākāsasadisena,akasasadisena,1,1,0,0,13
419525,mahaggatenāti,mahaggatenati,3,0,3,0,13
419526,paṭipannenāti,patipannenati,1,1,0,0,13
419527,appamāṇenāti,appamanenati,6,0,6,0,12
419528,pharaṇaappamāṇatāya,pharanaappamanataya,5,5,0,0,19
419529,averenāti,averenati,3,0,3,0,9
419530,akusalaverapuggalaverarahitena,akusalaverapuggalaverarahitena,2,2,0,0,30
419531,abyāpajjhenāti,abyapajjhenati,2,0,2,0,14
419532,kodhadukkhavajjitena,kodhadukkhavajjitena,1,1,0,0,20
419533,buddhānussaticittameva,buddhanussaticittameva,1,1,0,0,22
419534,paṭhamasamayasuttavaṇṇanā,pathamasamayasuttavannana,3,3,0,0,25
419535,manobhāvanīyassāti,manobhavaniyassati,1,0,1,0,18
419536,kāmarāgappajahanatthāya,kamaragappajahanatthaya,1,1,0,0,23
419537,dutiyavārādīsu,dutiyavaradisu,3,3,0,0,14
419538,byāpādappahānāya,byapadappahanaya,1,1,0,0,16
419539,mettākammaṭṭhānaṃ,mettakammatthanam,14,12,2,0,17
419540,thinamiddhappahānāya,thinamiddhappahanaya,1,1,0,0,20
419541,thinamiddhavinodanakammaṭṭhānaṃ,thinamiddhavinodanakammatthanam,2,1,1,0,31
419542,vīriyārambhavatthuādīnaṃ,viriyarambhavatthuadinam,2,1,1,0,24
419543,uddhaccakukkuccappahānāya,uddhaccakukkuccappahanaya,1,1,0,0,25
419544,vicikicchāpahānāya,vicikicchapahanaya,1,1,0,0,18
419545,dutiyasamayasuttavaṇṇanā,dutiyasamayasuttavannana,3,3,0,0,24
419546,maṇḍalamāḷeti,mandalamaleti,5,1,4,0,13
419547,cārittakilamathoti,carittakilamathoti,1,0,1,0,18
419548,piṇḍapātacariyāya,pindapatacariyaya,1,1,0,0,17
419549,purimadivasabhāge,purimadivasabhage,1,1,0,0,17
419550,samudācaratīti,samudacaratiti,12,5,7,0,14
419551,divāvihāre,divavihare,7,7,0,0,10
419552,ojaṭṭhāyīti,ojatthayiti,1,0,1,0,11
419553,phāsukassa,phasukassa,1,0,1,0,10
419554,lāḷudāyittheraṃ,laludayittheram,5,5,0,0,15
419555,upaparikkhāmīti,upaparikkhamiti,5,4,1,0,15
419556,samādhivipassanācittaṃ,samadhivipassanacittam,1,1,0,0,22
419557,jhānattayasaṅkhātaṃ,jhanattayasankhatam,1,1,0,0,19
419558,anussatikāraṇaṃ,anussatikaranam,1,1,0,0,15
419559,ālokanimitte,alokanimitte,2,2,0,0,12
419560,uppannasaññaṃ,uppannasannam,1,1,0,0,13
419561,yathānena,yathanena,6,5,1,0,9
419562,vivaṭenāti,vivatenati,3,0,3,0,10
419563,apariyonaddhenāti,apariyonaddhenati,7,0,7,0,17
419564,anonaddhena,anonaddhena,2,2,0,0,11
419565,dibbacakkhuñāṇatthāya,dibbacakkhunanatthaya,2,2,0,0,21
419566,sahobhāsakaṃ,sahobhasakam,2,1,1,0,12
419567,thinamiddhavinodanālokasaññaṃ,thinamiddhavinodanalokasannam,1,1,0,0,29
419568,dibbacakkhuñāṇālokanti,dibbacakkhunanalokanti,1,1,0,0,22
419569,dibbacakkhusaṅkhātassa,dibbacakkhusankhatassa,1,1,0,0,22
419570,ñāṇadassanassa,nanadassanassa,17,17,0,0,14
419571,kāyagatāsatikammaṭṭhāne,kayagatasatikammatthane,6,6,0,0,23
419572,kāmarāgappahānāyāti,kamaragappahanayati,1,0,1,0,19
419573,viparibhinnavaṇṇaṃ,viparibhinnavannam,4,4,0,0,18
419574,paribhinnaṭṭhānehi,paribhinnatthanehi,6,3,3,0,18
419575,evaṃanatītoti,evamanatitoti,4,2,2,0,13
419576,ṭhānagamanādikhamo,thanagamanadikhamo,3,3,0,0,18
419577,vigamā,vigama,9,9,0,0,6
419578,evaṃpūtikasabhāvoyevāti,evamputikasabhavoyevati,1,1,0,0,23
419579,evaṃbhāvīti,evambhaviti,4,1,3,0,11
419580,uddhumātādibhedo,uddhumatadibhedo,4,2,2,0,16
419581,uddhumātādibhāvaṃ,uddhumatadibhavam,3,3,0,0,17
419582,udaramaṃsaoṭṭhamaṃsaakkhikamaṃsādīni,udaramamsaotthamamsaakkhikamamsadini,1,1,0,0,36
419583,khādiyamānaṃ,khadiyamanam,10,10,0,0,12
419584,sesāvasesamaṃsalohitayuttaṃ,sesavasesamamsalohitayuttam,4,2,2,0,27
419585,khīṇepi,khinepi,3,3,0,0,7
419586,disābhāgena,disabhagena,47,46,1,0,11
419587,catusaṭṭhibhedampi,catusatthibhedampi,3,3,0,0,18
419588,vippakiṇṇaṃ,vippakinnam,13,11,2,0,11
419589,pādaṭṭhikā,padatthika,2,0,2,0,10
419590,terovassikānīti,terovassikaniti,7,1,6,0,15
419591,atikkantasaṃvaccharāni,atikkantasamvaccharani,3,3,0,0,22
419592,pūtīnīti,putiniti,7,0,7,0,8
419593,vātātapavuṭṭhisamphassena,vatatapavutthisamphassena,3,3,0,0,25
419594,terovassikāneva,terovassikaneva,3,3,0,0,15
419595,antobhūmigatāni,antobhumigatani,3,3,0,0,15
419596,cuṇṇakajātānīti,cunnakajataniti,4,1,3,0,15
419597,khajjamānādīnaṃ,khajjamanadinam,4,3,1,0,15
419598,samugghātatthāya,samugghatatthaya,3,3,0,0,16
419599,anekadhātupaṭivedhāyāti,anekadhatupativedhayati,1,0,1,0,23
419600,anekadhātūnaṃ,anekadhatunam,2,1,1,0,13
419601,samannāgatova,samannagatova,2,2,0,0,13
419602,paṭinivattantopi,patinivattantopi,1,1,0,0,16
419603,anuttariyasuttavaṇṇanā,anuttariyasuttavannana,5,5,0,0,22
419604,mahantakhuddakaṃ,mahantakhuddakam,2,2,0,0,16
419605,uccanīcaṃ,uccanicam,3,2,1,0,9
419606,gāmavāsikānaṃ,gamavasikanam,2,1,1,0,13
419607,atthasannissitaṃ,atthasannissitam,7,5,2,0,16
419608,appavattinirodhāya,appavattinirodhaya,1,1,0,0,18
419609,sambodhisaṅkhātassa,sambodhisankhatassa,1,1,0,0,19
419610,niviṭṭhasaddhoti,nivitthasaddhoti,1,0,1,0,16
419611,niviṭṭhapemoti,nivitthapemoti,2,1,1,0,14
419612,patiṭṭhitapemo,patitthitapemo,3,3,0,0,14
419613,ekantagatoti,ekantagatoti,1,0,1,0,12
419614,hatthinimittaṃ,hatthinimittam,3,2,1,0,14
419615,hatthisippaṃ,hatthisippam,11,10,1,0,12
419616,pāricariyeti,paricariyeti,2,0,2,0,12
419617,nibbānanissitaṃ,nibbananissitam,2,2,0,0,15
419618,amatagāminaṃ,amatagaminam,6,3,3,0,12
419619,nibbānagāminaṃ,nibbanagaminam,1,1,0,0,14
419620,pamoditāti,pamoditati,5,0,5,0,10
419621,avippavāsasaṅkhāte,avippavasasankhate,1,1,0,0,18
419622,nipakāti,nipakati,6,0,6,0,8
419623,sīlasaṃvutāti,silasamvutati,1,0,1,0,13
419624,paccentīti,paccentiti,9,2,7,0,10
419625,uparūpariguṇaparihānāya,uparuparigunaparihanaya,1,1,0,0,23
419626,aparihānasuttadvayavaṇṇanā,aparihanasuttadvayavannana,1,1,0,0,26
419627,para32-33,para32-33,9,9,0,0,9
419628,para32-33_an6,para32-33_an6,1,1,0,0,13
419629,satthugāravatāti,satthugaravatati,1,0,1,0,16
419630,dhammagāravatāti,dhammagaravatati,1,0,1,0,16
419631,saṅghagāravatāti,sanghagaravatati,1,0,1,0,16
419632,sikkhāgāravatāti,sikkhagaravatati,1,0,1,0,16
419633,appamādagāravatāti,appamadagaravatati,1,0,1,0,18
419634,paṭisanthāragāravatāti,patisantharagaravatati,1,0,1,0,22
419635,dhammāmisavasena,dhammamisavasena,6,6,0,0,16
419636,tibbagāravoti,tibbagaravoti,1,0,1,0,13
419637,bahalagāravo,bahalagaravo,1,1,0,0,12
419638,sappatissoti,sappatissoti,6,0,6,0,12
419639,sajeṭṭhako,sajetthako,3,2,1,0,10
419640,anupharaṇaṭṭhena,anupharanatthena,1,1,0,0,16
419641,pariyāyamakāsīti,pariyayamakasiti,4,0,4,0,16
419642,piyasamudāhāravacanaṃ,piyasamudaharavacanam,2,2,0,0,21
419643,anāgatapubbampi,anagatapubbampi,3,3,0,0,15
419644,manāpajātiyaṃ,manapajatiyam,2,2,0,0,13
419645,idhāgamanamaggo,idhagamanamaggo,3,3,0,0,15
419646,maggamūḷhosī,maggamulhosi,3,3,0,0,12
419647,āgatapubbattāyeva,agatapubbattayeva,2,2,0,0,17
419648,idhāgamanāyāti,idhagamanayati,2,0,2,0,14
419649,brahmapallaṅkaṃ,brahmapallankam,1,1,0,0,15
419650,aveccappasādenāti,aveccappasadenati,14,0,14,0,17
419651,maggappasādena,maggappasadena,1,1,0,0,14
419652,vijjābhāgiyasuttavaṇṇanā,vijjabhagiyasuttavannana,3,3,0,0,24
419653,aniccānupassanāñāṇe,aniccanupassananane,4,3,1,0,19
419654,dukkhānupassanāñāṇe,dukkhanupassananane,2,2,0,0,19
419655,anattānupassanāñāṇe,anattanupassananane,2,2,0,0,19
419656,pahānasaññāti,pahanasannati,2,0,2,0,13
419657,pahānānupassanāñāṇe,pahananupassananane,2,2,0,0,19
419658,virāgasaññāti,viragasannati,6,4,2,0,13
419659,virāgānupassanāñāṇe,viraganupassananane,2,2,0,0,19
419660,nirodhasaññāti,nirodhasannati,2,1,1,0,14
419661,nirodhānupassanāñāṇe,nirodhanupassananane,3,3,0,0,20
419662,vivādamūlasuttavaṇṇanā,vivadamulasuttavannana,3,3,0,0,22
419663,vivādamūlānīti,vivadamulaniti,5,2,3,0,14
419664,kujjhanalakkhaṇena,kujjhanalakkhanena,6,6,0,0,18
419665,upanāhīti,upanahiti,10,0,10,0,9
419666,veraappaṭinissaggalakkhaṇena,veraappatinissaggalakkhanena,4,4,0,0,28
419667,āpannesu,apannesu,9,9,0,0,8
419668,dhammavādiniyo,dhammavadiniyo,5,5,0,0,14
419669,adhammavādiniyo,adhammavadiniyo,5,5,0,0,15
419670,ārakkhadevatānaṃ,arakkhadevatanam,10,10,0,0,16
419671,dhammavādīhi,dhammavadihi,7,7,0,0,12
419672,adhammavādinova,adhammavadinova,6,6,0,0,15
419673,abbhantaraparisāya,abbhantaraparisaya,3,3,0,0,18
419674,guṇamakkhanalakkhaṇena,gunamakkhanalakkhanena,4,4,0,0,22
419675,issukīti,issukiti,5,0,5,0,8
419676,sakkārādīni,sakkaradini,10,10,0,0,11
419677,issāyanalakkhaṇāya,issayanalakkhanaya,3,3,0,0,18
419678,āvāsamacchariyādīhi,avasamacchariyadihi,5,5,0,0,19
419679,māyāvīti,mayaviti,9,1,8,0,8
419680,katapaṭicchādako,katapaticchadako,3,3,0,0,16
419681,asantasambhāvanicchako,asantasambhavanicchako,4,4,0,0,22
419682,natthikavādī,natthikavadi,6,4,2,0,12
419683,ahetuvādī,ahetuvadi,1,1,0,0,9
419684,sandiṭṭhiparāmāsīti,sanditthiparamasiti,7,1,6,0,19
419685,ādhānaggāhīti,adhanaggahiti,6,0,6,0,13
419686,daḷhaggāhī,dalhaggahi,8,7,1,0,10
419687,duppaṭinissaggīti,duppatinissaggiti,4,0,4,0,17
419688,dānasuttavaṇṇanā,danasuttavannana,3,3,0,0,16
419689,veḷukaṇḍakīti,velukandakiti,2,0,2,0,13
419690,veḷukaṇḍakanagaravāsinī,velukandakanagaravasini,1,1,0,0,23
419691,māsaḍḍhamāsato,masaddhamasato,1,1,0,0,14
419692,pubbecetanā,pubbecetana,1,1,0,0,11
419693,cittuppādakālato,cittuppadakalato,1,1,0,0,16
419694,khettaggahaṇaṃ,khettaggahanam,2,2,0,0,14
419695,dānakāleyeva,danakaleyeva,5,5,0,0,12
419696,aparacetanā,aparacetana,4,4,0,0,11
419697,vītarāgāti,vitaragati,11,2,9,0,10
419698,vigatarāgā,vigataraga,4,4,0,0,10
419699,rāgavinayapaṭipadaṃ,ragavinayapatipadam,2,1,1,0,19
419700,ukkaṭṭhadesanā,ukkatthadesana,1,1,0,0,14
419701,anāgāmisakadāgāmisotāpannānampi,anagamisakadagamisotapannanampi,1,1,0,0,31
419702,tadahupabbajitassa,tadahupabbajitassa,2,2,0,0,18
419703,bhaṇḍagāhakasāmaṇerassāpi,bhandagahakasamanerassapi,1,1,0,0,25
419704,chaḷaṅgasamannāgatāva,chalangasamannagatava,1,1,0,0,21
419705,sotāpattimaggatthameva,sotapattimaggatthameva,1,1,0,0,22
419706,sīlasaññamena,silasannamena,2,2,0,0,13
419707,ācamayitvānāti,acamayitvanati,1,0,1,0,14
419708,pāṇibhīti,panibhiti,6,0,6,0,9
419709,sayehītipi,sayehitipi,1,1,0,0,10
419710,ratanattayaguṇe,ratanattayagune,12,12,0,0,15
419711,lābhamacchariyādīhi,labhamacchariyadihi,1,1,0,0,19
419712,uḷārasukhasomanassaṃ,ularasukhasomanassam,1,1,0,0,20
419713,attakārīsuttavaṇṇanā,attakarisuttavannana,1,1,0,0,20
419714,ārabhanavasena,arabhanavasena,2,1,1,0,14
419715,nikkhamanasabhāvaṃ,nikkhamanasabhavam,2,1,1,0,18
419716,parakkamasabhāvo,parakkamasabhavo,1,1,0,0,16
419717,thāmadhātūti,thamadhatuti,1,0,1,0,12
419718,thāmasabhāvo,thamasabhavo,1,1,0,0,12
419719,ṭhitidhātūti,thitidhatuti,1,0,1,0,12
419720,upakkamadhātūti,upakkamadhatuti,1,0,1,0,15
419721,upakkamasabhāvo,upakkamasabhavo,1,1,0,0,15
419722,nidānasuttādivaṇṇanā,nidanasuttadivannana,1,1,0,0,20
419723,para39-40_an6,para39-40_an6,1,1,0,0,13
419724,lobhajenāti,lobhajenati,1,0,1,0,11
419725,mahāmucalindavane,mahamucalindavane,1,1,0,0,17
419726,sāsanasaddhammo,sasanasaddhammo,1,1,0,0,15
419727,dārukkhandhasuttavaṇṇanā,darukkhandhasuttavannana,1,1,0,0,24
419728,cittavasibhāvaṃ,cittavasibhavam,1,1,0,0,15
419729,adhimucceyyāti,adhimucceyyati,2,0,2,0,14
419730,thaddhākārā,thaddhakara,1,1,0,0,11
419731,yūsākārā,yusakara,1,1,0,0,8
419732,uṇhākārā,unhakara,1,1,0,0,8
419733,vitthambhanākārā,vitthambhanakara,1,1,0,0,16
419734,rattavaṇṇamhi,rattavannamhi,1,1,0,0,13
419735,padumapupphavaṇṇā,padumapupphavanna,4,4,0,0,17
419736,pūtibhūte,putibhute,3,3,0,0,9
419737,cuṇṇe,cunne,5,5,0,0,5
419738,pheggupapaṭikāsu,pheggupapatikasu,1,1,0,0,16
419739,amanuññavaṇṇā,amanunnavanna,1,1,0,0,13
419740,sallakkheyyāti,sallakkheyyati,1,1,0,0,14
419741,missakavihāro,missakaviharo,1,1,0,0,13
419742,gāmantasenāsanavāsiṃ,gamantasenasanavasim,1,1,0,0,20
419743,cāvessatīti,cavessatiti,1,0,1,0,11
419744,uṭṭhāpessati,utthapessati,1,1,0,0,12
419745,sakamano,sakamano,11,10,1,0,8
419746,ekasabhāvaṃ,ekasabhavam,9,7,2,0,11
419747,ekaggatābhūtaṃ,ekaggatabhutam,1,1,0,0,14
419748,anurakkhissatīti,anurakkhissatiti,1,0,1,0,16
419749,anuggaṇhissati,anugganhissati,3,3,0,0,14
419750,vimocessatīti,vimocessatiti,1,0,1,0,13
419751,vimocayissati,vimocayissati,1,1,0,0,13
419752,paṭipaṇāmetvāti,patipanametvati,4,0,4,0,15
419753,uccārapassāvakammāyāti,uccarapassavakammayati,1,0,1,0,22
419754,uccārapassāvakaraṇatthāya,uccarapassavakaranatthaya,1,1,0,0,25
419755,araññasenāsanassa,arannasenasanassa,3,3,0,0,17
419756,āyāmānandā,ayamananda,1,1,0,0,10
419757,anūnehi,anunehi,3,2,1,0,7
419758,parisiñcitvāti,parisincitvati,2,1,1,0,14
419759,vohāravacanametaṃ,voharavacanametam,7,6,1,0,17
419760,nhāyitvāti,nhayitvati,1,1,0,0,10
419761,pubbāpayamānoti,pubbapayamanoti,5,0,5,0,15
419762,rattadupaṭṭaṃ,rattadupattam,10,10,0,0,13
419763,uttarāsaṅgacīvaraṃ,uttarasangacivaram,4,4,0,0,18
419764,pacchimalokadhātuṃ,pacchimalokadhatum,4,4,0,0,18
419765,vodakabhāvena,vodakabhavena,1,1,0,0,13
419766,pubbasadisāni,pubbasadisani,4,3,1,0,13
419767,satthāraṃyeva,sattharamyeva,7,7,0,0,13
419768,rattasuvaṇṇakuṇḍalaṃ,rattasuvannakundalam,1,1,0,0,20
419769,parisuddharajatamaṇḍalo,parisuddharajatamandalo,1,1,0,0,23
419770,majjhaṭṭhānepi,majjhatthanepi,1,1,0,0,14
419771,pubbakoṭṭhakanadītīre,pubbakotthakanaditire,1,1,0,0,21
419772,alaṅkurumāno,alankurumano,1,1,0,0,12
419773,mahātūriyatāḷitavāditenāti,mahaturiyatalitavaditenati,1,0,1,0,26
419774,tūriyatāḷitavāditena,turiyatalitavaditena,1,1,0,0,20
419775,hatthidassanatthaṃ,hatthidassanattham,1,1,0,0,18
419776,sannipatitamahājano,sannipatitamahajano,1,1,0,0,19
419777,bahitīre,bahitire,11,9,2,0,8
419778,vodakāni,vodakani,2,2,0,0,8
419779,hatthālaṅkārena,hatthalankarena,1,1,0,0,15
419780,pasaṃsāvacanamāha,pasamsavacanamaha,1,1,0,0,17
419781,kāyupapannoti,kayupapannoti,1,0,1,0,13
419782,sarīrasampattiyā,sarirasampattiya,4,4,0,0,16
419783,paripuṇṇaṅgapaccaṅgoti,paripunnangapaccangoti,1,1,0,0,22
419784,bhaṇantaṃ,bhanantam,17,14,3,0,9
419785,nibbattahatthino,nibbattahatthino,1,1,0,0,16
419786,buddhahatthissa,buddhahatthissa,1,1,0,0,15
419787,ārohasampannaṃ,arohasampannam,1,1,0,0,14
419788,pariṇāhasampannaṃ,parinahasampannam,1,1,0,0,17
419789,nāgasaddo,nagasaddo,2,2,0,0,9
419790,hatthimhiceva,hatthimhiceva,1,1,0,0,13
419791,assagoṇauragarukkhamanussesu,assagonauragarukkhamanussesu,1,1,0,0,28
419792,brūmīti,brumiti,43,10,33,0,7
419793,dvādasannañca,dvadasannanca,1,1,0,0,13
419794,anumodāmīti,anumodamiti,1,0,1,0,11
419795,catusaṭṭhipadāhi,catusatthipadahi,1,1,0,0,16
419796,abhinandāmi,abhinandami,20,17,3,0,11
419797,devādibhāvaṃ,devadibhavam,2,2,0,0,12
419798,manussameva,manussameva,2,2,0,0,11
419799,uppāditeneva,uppaditeneva,1,1,0,0,12
419800,maggadamathena,maggadamathena,1,1,0,0,14
419801,sotatopi,sotatopi,3,3,0,0,8
419802,ghānatopi,ghanatopi,3,3,0,0,9
419803,jivhātopi,jivhatopi,3,3,0,0,9
419804,manatopīti,manatopiti,3,1,2,0,10
419805,viharamānaṃ,viharamanam,3,3,0,0,11
419806,brahmapatheti,brahmapatheti,2,0,2,0,13
419807,seṭṭhapathe,setthapathe,1,1,0,0,11
419808,amatapathe,amatapathe,1,1,0,0,10
419809,nibbānapathe,nibbanapathe,1,1,0,0,12
419810,abhirataṃ,abhiratam,15,15,0,0,9
419811,dhammānudhammapaṭipattiyā,dhammanudhammapatipattiya,12,12,0,0,25
419812,sabbadhammānapāraguṃ,sabbadhammanaparagum,1,0,1,0,20
419813,khandhāyatanadhātudhammānaṃ,khandhayatanadhatudhammanam,1,1,0,0,27
419814,pāragataṃ,paragatam,7,6,1,0,9
419815,subrahmadevaputtādayo,subrahmadevaputtadayo,2,1,1,0,21
419816,sukhappattā,sukhappatta,11,11,0,0,11
419817,dasasahassacakkavāḷavāsino,dasasahassacakkavalavasino,2,2,0,0,26
419818,laddhavohārānaṃ,laddhavoharanam,4,4,0,0,15
419819,dasavidhasaṃyojanāni,dasavidhasamyojanani,2,2,0,0,20
419820,nibbanamāgataṃ,nibbanamagatam,9,6,3,0,14
419821,kilesavanato,kilesavanato,4,4,0,0,12
419822,nibbanaṃ,nibbanam,2,2,0,0,8
419823,kilesavanarahitaṃ,kilesavanarahitam,1,1,0,0,17
419824,seladhātuto,seladhatuto,1,1,0,0,11
419825,kañcanasadisaṃ,kancanasadisam,1,1,0,0,14
419826,accarucīti,accaruciti,3,0,3,0,10
419827,pavattaruci,pavattaruci,2,2,0,0,11
419828,aṭṭhamakañhi,atthamakanhi,1,1,0,0,12
419829,pavattarucitāya,pavattarucitaya,4,4,0,0,15
419830,accaruci,accaruci,5,4,1,0,8
419831,himavāvaññe,himavavanne,4,2,2,0,11
419832,atirocatīti,atirocatiti,8,4,4,0,11
419833,saccanāmoti,saccanamoti,4,0,4,0,11
419834,tacchanāmo,tacchanamo,1,1,0,0,10
419835,bhūtanāmo,bhutanamo,1,1,0,0,9
419836,avitathanāmo,avitathanamo,5,5,0,0,12
419837,sucisīlaṃ,sucisilam,2,2,0,0,9
419838,purimapādā,purimapada,1,1,0,0,10
419839,dhutasamādānaṃ,dhutasamadanam,1,1,0,0,14
419840,ariyamaggasīlaṃ,ariyamaggasilam,1,1,0,0,15
419841,tyāpareti,tyapareti,1,0,1,0,9
419842,pacchimapādā,pacchimapada,1,1,0,0,12
419843,saddhāhatthoti,saddhahatthoti,1,0,1,0,14
419844,saddhāmayāya,saddhamayaya,1,1,0,0,12
419845,upekkhāsetadantavāti,upekkhasetadantavati,1,0,1,0,20
419846,chaḷaṅgupekkhāmayehi,chalangupekkhamayehi,1,1,0,0,20
419847,setadantehi,setadantehi,1,1,0,0,11
419848,gīvāti,givati,13,7,6,0,6
419849,aṅgapaccaṅgasmiṃ,angapaccangasmim,1,1,0,0,16
419850,sirājālānaṃ,sirajalanam,1,1,0,0,11
419851,soraccādīnaṃ,soraccadinam,1,1,0,0,12
419852,dhammacintanāti,dhammacintanati,2,0,2,0,15
419853,aggasoṇḍo,aggasondo,1,1,0,0,9
419854,khāditabbākhāditabbañca,khaditabbakhaditabbanca,1,1,0,0,23
419855,dhammakoṭṭhāsaparicchedakañāṇasaṅkhātā,dhammakotthasaparicchedakananasankhata,1,1,0,0,38
419856,dhammakucchisamātapoti,dhammakucchisamatapoti,1,0,1,0,22
419857,kucchiyeva,kucchiyeva,1,1,0,0,10
419858,samātapo,samatapo,2,2,0,0,8
419859,kucchisamātapo,kucchisamatapo,2,2,0,0,14
419860,samātapanaṭṭhānaṃ,samatapanatthanam,1,1,0,0,17
419861,catutthajjhānasamādhismiṃ,catutthajjhanasamadhismim,1,1,0,0,25
419862,iddhividhādidhammā,iddhividhadidhamma,1,1,0,0,18
419863,kucchisamātapoti,kucchisamatapoti,1,1,0,0,16
419864,kāyacittaupadhiviveko,kayacittaupadhiviveko,1,1,0,0,21
419865,gahaṭṭhapabbajite,gahatthapabbajite,1,1,0,0,17
419866,vāladhīti,valadhiti,3,1,2,0,9
419867,assāsaratoti,assasaratoti,2,0,2,0,12
419868,uppannabhojanāni,uppannabhojanani,2,2,0,0,16
419869,sāvajjānīti,savajjaniti,1,0,1,0,11
419870,pañcavidhamicchājīvavasena,pancavidhamicchajivavasena,2,2,0,0,26
419871,aṇuṃthūlaṃ,anumthulam,1,0,1,0,10
419872,taṇhāmānadiṭṭhilepehi,tanhamanaditthilepehi,1,1,0,0,21
419873,mahāginīti,mahaginiti,1,0,1,0,10
419874,mahāaggi,mahaaggi,1,1,0,0,8
419875,kāḷudāyittherova,kaludayittherova,1,1,0,0,16
419876,udāyittheranāgena,udayittheranagena,1,1,0,0,17
419877,buddhanāgaṃ,buddhanagam,8,8,0,0,11
419878,parinibbissatīti,parinibbissatiti,1,0,1,0,16
419879,yamakasālantare,yamakasalantare,1,1,0,0,15
419880,piviṃsūti,pivimsuti,4,3,1,0,9
419881,migasālāsuttavaṇṇanā,migasalasuttavannana,4,4,0,0,20
419882,aññeyyoti,anneyyoti,1,0,1,0,9
419883,ājānitabbo,ajanitabbo,1,1,0,0,10
419884,samasamagatikāti,samasamagatikati,1,0,1,0,16
419885,samagatikā,samagatika,2,1,1,0,10
419886,tusitabhavaneyeva,tusitabhavaneyeva,1,1,0,0,17
419887,ammakapaññāti,ammakapannati,1,0,1,0,13
419888,itthisaññāya,itthisannaya,7,6,1,0,12
419889,purisapuggalaparopariyañāṇeti,purisapuggalaparopariyananeti,1,0,1,0,29
419890,purisapuggalaparopariyañāṇaṃ,purisapuggalaparopariyananam,1,1,0,0,28
419891,purisapuggalānaṃ,purisapuggalanam,3,3,0,0,16
419892,tikkhamuduvasena,tikkhamuduvasena,1,1,0,0,16
419893,indriyaparopariyañāṇaṃ,indriyaparopariyananam,2,2,0,0,22
419894,indriyaparopariyañāṇe,indriyaparopariyanane,1,1,0,0,21
419895,appaṭihatavisayā,appatihatavisaya,1,1,0,0,16
419896,suvidūreti,suvidureti,3,1,2,0,10
419897,suratotipi,suratotipi,1,1,0,0,10
419898,ekattavāsenāti,ekattavasenati,1,0,1,0,14
419899,ekantavāsenātipi,ekantavasenatipi,1,1,0,0,16
419900,satatavāsenāti,satatavasenati,1,1,0,0,14
419901,sotabbayuttakaṃ,sotabbayuttakam,6,6,0,0,15
419902,paṭivijjhitabbaṃ,pativijjhitabbam,10,7,3,0,16
419903,parihānimeva,parihanimeva,1,1,0,0,12
419904,pamāṇikāti,pamanikati,5,0,5,0,10
419905,pamāṇaggāhakā,pamanaggahaka,2,2,0,0,13
419906,paminantīti,paminantiti,1,0,1,0,11
419907,pamāṇakaraṇaṃ,pamanakaranam,2,2,0,0,13
419908,nibbahatīti,nibbahatiti,2,0,2,0,11
419909,pavattamānavipassanāñāṇaṃ,pavattamanavipassanananam,1,1,0,0,25
419910,kodhamānoti,kodhamanoti,1,0,1,0,11
419911,lobhadhammāti,lobhadhammati,2,0,2,0,13
419912,vacīsaṅkhārāti,vacisankharati,3,0,3,0,14
419913,ālāpasallāpavasena,alapasallapavasena,6,6,0,0,18
419914,vacanāneva,vacananeva,1,1,0,0,10
419915,mādisoti,madisoti,2,1,1,0,8
419916,guṇakhaṇanaṃ,gunakhananam,2,2,0,0,12
419917,soratā,sorata,14,14,0,0,6
419918,adhigatakodhamānalobhadhammā,adhigatakodhamanalobhadhamma,1,1,0,0,28
419919,adhigatakodhamānavacīsaṅkhārāti,adhigatakodhamanavacisankharati,1,1,0,0,31
419920,ñāṇagatiṃ,nanagatim,7,5,2,0,9
419921,ekaṅgahīnāti,ekangahinati,1,0,1,0,12
419922,paññāṭhāne,pannathane,1,1,0,0,10
419923,sīlaṭṭhāne,silatthane,1,1,0,0,10
419924,iṇasuttavaṇṇanā,inasuttavannana,1,1,0,0,15
419925,daliddabhāvo,daliddabhavo,2,2,0,0,12
419926,kāmabhoginoti,kamabhoginoti,42,39,3,0,13
419927,bhuñjanakasattassa,bhunjanakasattassa,1,1,0,0,18
419928,anāḷhikoti,analhikoti,1,0,1,0,10
419929,paṭissuṇātīti,patissunatiti,1,0,1,0,13
419930,parisamajjhagaṇamajjhādīsu,parisamajjhaganamajjhadisu,1,1,0,0,26
419931,ātapaṭhapanapaṃsuokiraṇādīhi,atapathapanapamsuokiranadihi,1,1,0,0,28
419932,okappanakasaddhāmattakampi,okappanakasaddhamattakampi,1,1,0,0,26
419933,hirīyanākāramattakampi,hiriyanakaramattakampi,1,1,0,0,22
419934,bhāyanākāramattakampi,bhayanakaramattakampi,1,1,0,0,21
419935,kāyikavīriyamattakampi,kayikaviriyamattakampi,1,1,0,0,22
419936,kammassakatapaññāmattakampi,kammassakatapannamattakampi,1,1,0,0,27
419937,iṇaggahaṇaṃ,inaggahanam,2,1,1,0,11
419938,dhanadaliddabhāvo,dhanadaliddabhavo,1,1,0,0,17
419939,kāmalābhaṃ,kamalabham,1,1,0,0,10
419940,pāpakammavinibbayoti,papakammavinibbayoti,1,0,1,0,20
419941,pāpakammavaḍḍhako,papakammavaddhako,1,1,0,0,17
419942,paripphandati,paripphandati,5,5,0,0,13
419943,kaṭaggāhoti,kataggahoti,3,0,3,0,11
419944,jayaggāho,jayaggaho,7,5,2,0,9
419945,anaparādhaggāho,anaparadhaggaho,1,1,0,0,15
419946,gharamesinoti,gharamesinoti,5,0,5,0,13
419947,vasamānassa,vasamanassa,8,8,0,0,11
419948,cāgoti,cagoti,6,2,4,0,6
419949,patiṭṭhitasaddhā,patitthitasaddha,3,3,0,0,16
419950,hirimanoti,hirimanoti,2,0,2,0,10
419951,hirisampayuttacitto,hirisampayuttacitto,2,1,1,0,19
419952,catutthajjhānupekkhaṃ,catutthajjhanupekkham,8,7,1,0,21
419953,paripuṇṇapaggahitavīriyo,paripunnapaggahitaviriyo,1,1,0,0,24
419954,kammassakatañāṇasatīhi,kammassakatananasatihi,1,1,0,0,22
419955,sabbasaṃyojanakkhayeti,sabbasamyojanakkhayeti,2,0,2,0,22
419956,sabbasaṃyojanakkhayasaṅkhāte,sabbasamyojanakkhayasankhate,1,1,0,0,28
419957,sabbasaṃyojanakkhayaṃ,sabbasamyojanakkhayam,14,9,5,0,21
419958,sabbasaṃyojanakkhayasaṅkhātaṃ,sabbasamyojanakkhayasankhatam,3,3,0,0,29
419959,vimuttassāti,vimuttassati,5,1,4,0,12
419960,taṃsaṇṭhitassa,tamsanthitassa,2,2,0,0,14
419961,akuppāti,akuppati,8,0,8,0,8
419962,akuppārammaṇattā,akupparammanatta,2,1,1,0,16
419963,kuppakāraṇānaṃ,kuppakarananam,1,1,0,0,14
419964,maggavimuttipi,maggavimuttipi,1,1,0,0,14
419965,phalavimuttipi,phalavimuttipi,1,1,0,0,14
419966,bhavasaṃyojanakkhayeti,bhavasamyojanakkhayeti,1,0,1,0,22
419967,bhavasaṃyojanakkhayasaṅkhāte,bhavasamyojanakkhayasankhate,1,1,0,0,28
419968,bhavasaṃyojanānañca,bhavasamyojanananca,1,1,0,0,19
419969,khayante,khayante,19,18,1,0,8
419970,paramañāṇaṃ,paramananam,1,1,0,0,11
419971,āṇaṇyamuttamaṃ,ananyamuttamam,1,0,1,0,14
419972,aṇaṇānaṃ,anananam,1,1,0,0,8
419973,uttamaaṇaṇo,uttamaanano,2,1,1,0,11
419974,āṇaṇyamuttamanti,ananyamuttamanti,1,1,0,0,16
419975,mahācundasuttavaṇṇanā,mahacundasuttavannana,2,2,0,0,21
419976,cetīsūti,cetisuti,2,0,2,0,8
419977,cetiraṭṭhe,cetiratthe,5,5,0,0,10
419978,mahācundoti,mahacundoti,3,0,3,0,11
419979,apasādentīti,apasadentiti,1,0,1,0,12
419980,pajjhāyantītiādīni,pajjhayantitiadini,2,0,2,0,18
419981,khandhadhātuāyatanādiatthaṃ,khandhadhatuayatanadiattham,1,1,0,0,27
419982,sammasanapaṭivedhapaññāpi,sammasanapativedhapannapi,2,2,0,0,25
419983,sandiṭṭhikasuttadvayavaṇṇanā,sanditthikasuttadvayavannana,1,1,0,0,28
419984,para47-48_an6,para47-48_an6,1,1,0,0,13
419985,lobhotiādīhi,lobhotiadihi,1,0,1,0,12
419986,lobhadhammātiādīhi,lobhadhammatiadihi,1,0,1,0,18
419987,dussanākāraṃ,dussanakaram,3,2,1,0,12
419988,khemasuttavaṇṇanā,khemasuttavannana,5,5,0,0,17
419989,vutthabrahmacariyavāso,vutthabrahmacariyavaso,3,3,0,0,22
419990,abhisaṅkhārabhārañca,abhisankharabharanca,2,2,0,0,20
419991,khīṇabhavabandhano,khinabhavabandhano,3,3,0,0,18
419992,seyyotiādīhipi,seyyotiadihipi,1,0,1,0,14
419993,seyyādayo,seyyadayo,1,1,0,0,9
419994,acirapakkantesūti,acirapakkantesuti,1,0,1,0,17
419995,nopanīyareti,nopaniyareti,1,0,1,0,12
419996,ussāti,ussati,1,0,1,0,6
419997,ussitatā,ussitata,1,1,0,0,8
419998,seyyapuggalā,seyyapuggala,1,1,0,0,12
419999,samattoti,samattoti,5,2,3,0,9
