50000,nekasatthantaro,nekasatthantaro,1,1,0,0,15
50001,sammoha,sammoha,6,5,1,0,7
50002,bbhāhatā,bbhahata,1,1,0,0,8
50003,nāvabujjhanti,navabujjhanti,9,7,2,0,13
50004,pādasussūsā,padasussusa,7,3,4,0,11
50005,garūni,garuni,6,6,0,0,6
50006,tappādarajokiṇṇā,tappadarajokinna,5,3,2,0,16
50007,vivekino,vivekino,8,3,5,0,8
50008,kabba,kabba,3,0,3,0,5
50009,nāṭaka,nataka,5,4,1,0,6
50010,nikkhitta,nikkhitta,3,3,0,0,9
50011,nettacittā,nettacitta,1,1,0,0,10
50012,kavijjanā,kavijjana,3,1,2,0,9
50013,racayante,racayante,2,1,1,0,9
50014,teye,teye,4,1,3,0,4
50015,paṭibhāvento,patibhavento,1,1,0,0,12
50016,savimhayo,savimhayo,4,1,3,0,9
50017,tosenti,tosenti,20,15,5,0,7
50018,pya,pya,22,21,1,0,3
50019,vihitā,vihita,47,39,8,0,6
50020,darā,dara,8,8,0,0,4
50021,sadda,sadda,50,40,10,0,5
50022,tthā,ttha,18,16,2,0,4
50023,dosavajjitā,dosavajjita,4,1,3,0,11
50024,vimissānaṃ,vimissanam,1,0,1,0,10
50025,bhedenā,bhedena,3,2,1,0,7
50026,nibandho,nibandho,10,2,8,0,8
50027,niruppate,niruppate,6,1,5,0,9
50028,pāpentya,papentya,2,1,1,0,8
50029,vindanīyatarattanaṃ,vindaniyatarattanam,6,2,4,0,19
50030,mukhambhoja,mukhambhoja,1,1,0,0,11
50031,ambhojaṃ,ambhojam,7,5,2,0,8
50032,vārijavācakaṃ,varijavacakam,1,1,0,0,13
50033,sakkaṭaganthato,sakkataganthato,1,1,0,0,15
50034,anītaṃ,anitam,1,1,0,0,6
50035,manavajjā,manavajja,2,2,0,0,9
50036,sobhante,sobhante,13,7,6,0,8
50037,nira,nira,1,1,0,0,4
50038,laṅkatā,lankata,3,3,0,0,7
50039,garūpadesaṃ,garupadesam,1,1,0,0,11
50040,laṅkattu,lankattu,1,1,0,0,8
50041,micchati,micchati,10,10,0,0,8
50042,hassabhāvaṃ,hassabhavam,4,1,3,0,11
50043,ganthopi,ganthopi,9,7,2,0,8
50044,kavivācāna,kavivacana,1,1,0,0,10
50045,malaṅkāra,malankara,1,1,0,0,9
50046,ppakāsako,ppakasako,1,1,0,0,9
50047,tabbacanīyattaṃ,tabbacaniyattam,4,1,3,0,15
50048,bbohārū,bboharu,1,1,0,0,7
50049,pacārato,pacarato,1,1,0,0,8
50050,dvippakārā,dvippakara,23,20,3,0,10
50051,alaṅkārā,alankara,41,33,8,0,8
50052,ttha,ttha,114,92,22,0,4
50053,bhedato,bhedato,104,94,10,0,7
50054,saddatthā,saddattha,16,13,3,0,9
50055,taṃsajjita,tamsajjita,1,1,0,0,10
50056,tadāvali,tadavali,1,1,0,0,8
50057,guṇālaṅkārasaṃyuttā,gunalankarasamyutta,4,2,2,0,19
50058,dosalava,dosalava,1,1,0,0,8
50059,ṅkitā,nkita,1,1,0,0,5
50060,pasaṃsiyā,pasamsiya,15,10,5,0,9
50061,tādisī,tadisi,60,54,6,0,6
50062,dosanirāso,dosaniraso,1,1,0,0,10
50063,mahussāhena,mahussahena,21,18,3,0,11
50064,sādhiyo,sadhiyo,13,10,3,0,7
50065,niddosā,niddosa,36,29,7,0,7
50066,saguṇā,saguna,10,2,8,0,6
50067,laṅkāraviyuttā,lankaraviyutta,1,1,0,0,14
50068,guṇayuttā,gunayutta,8,3,5,0,9
50069,manoharā,manohara,31,25,6,0,8
50070,dosarahitā,dosarahita,7,4,3,0,10
50071,tadatthe,tadatthe,53,46,7,0,8
50072,dosā,dosa,218,205,13,0,4
50073,dāharaṇa,daharana,1,1,0,0,8
50074,metesaṃ,metesam,4,4,0,0,7
50075,kathayāmya,kathayamya,2,1,1,0,10
50076,padadosa,padadosa,2,2,0,0,8
50077,uddesa,uddesa,7,6,1,0,6
50078,viruddhatthantarā,viruddhatthantara,1,1,0,0,17
50079,jhattha,jhattha,2,1,1,0,7
50080,kiliṭṭhāni,kilitthani,6,6,0,0,10
50081,visesanāpekkhaṃ,visesanapekkham,8,2,6,0,15
50082,hīnatthaka,hinatthaka,1,1,0,0,10
50083,manatthakaṃ,manatthakam,2,2,0,0,11
50084,vākyadosa,vakyadosa,3,3,0,0,9
50085,padāna,padana,5,2,3,0,6
50086,vākyāna,vakyana,1,1,0,0,7
50087,mekatthaṃ,mekattham,2,1,1,0,9
50088,bhaggarītikaṃ,bhaggaritikam,4,1,3,0,13
50089,byākiṇṇa,byakinna,1,1,0,0,8
50090,gāmmāni,gammani,1,1,0,0,7
50091,yatihīnaṃ,yatihinam,7,1,6,0,9
50092,kamaccutaṃ,kamaccutam,5,2,3,0,10
50093,ativutta,ativutta,1,1,0,0,8
50094,mapetatthaṃ,mapetattham,1,1,0,0,11
50095,sabandhapharusaṃ,sabandhapharusam,2,1,1,0,16
50096,vākyatthadosauddesa,vakyatthadosauddesa,2,2,0,0,19
50097,cityahīnaṃ,cityahinam,4,2,2,0,10
50098,bhaggarīti,bhaggariti,9,4,5,0,10
50099,sasaṃsayaṃ,sasamsayam,10,6,4,0,10
50100,gāmmaṃ,gammam,16,5,11,0,6
50101,duṭṭhālaṅkatīti,dutthalankatiti,2,1,1,0,15
50102,vākyatthanissitā,vakyatthanissita,2,1,1,0,16
50103,padadosaniddesa,padadosaniddesa,1,1,0,0,15
50104,viruddhatthantaraṃ,viruddhatthantaram,10,3,7,0,18
50105,ññattho,nnattho,2,1,1,0,7
50106,sukhaye,sukhaye,8,4,4,0,7
50107,visesya,visesya,1,1,0,0,7
50108,madhikaṃ,madhikam,3,2,1,0,8
50109,yenā,yena,48,28,20,0,4
50110,obhāsitā,obhasita,13,11,2,0,8
50111,sesadiso,sesadiso,1,0,1,0,8
50112,khajjoto,khajjoto,19,10,9,0,8
50113,virājate,virajate,12,8,4,0,8
50114,vagamo,vagamo,2,2,0,0,6
50115,dukkho,dukkho,252,245,7,0,6
50116,pakatyā,pakatya,2,2,0,0,7
50117,divibhāgato,divibhagato,1,1,0,0,11
50118,māliṅgyate,malingyate,1,1,0,0,10
50119,dikaṃ,dikam,6,6,0,0,5
50120,kiliṭṭhapadadose,kilitthapadadose,2,2,0,0,16
50121,medisaṃ,medisam,5,3,2,0,7
50122,abyapetaṃ,abyapetam,5,1,4,0,9
50123,byapeta,byapeta,2,0,2,0,7
50124,māvuttā,mavutta,1,1,0,0,7
50125,nekavaṇṇajaṃ,nekavannajam,1,1,0,0,12
50126,pādāna,padana,1,1,0,0,6
50127,mādi,madi,4,4,0,0,4
50128,gocaraṃ,gocaram,259,245,14,0,7
50129,abyapeta,abyapeta,12,12,0,0,8
50130,paṭhamapādādi,pathamapadadi,1,1,0,0,13
50131,sujanā,sujana,22,14,8,0,6
50132,guṇenāpi,gunenapi,5,4,1,0,8
50133,vivekaṃ,vivekam,102,78,24,0,7
50134,samāyanti,samayanti,7,4,3,0,9
50135,avivekijanantike,avivekijanantike,3,1,2,0,16
50136,pādādi,padadi,2,2,0,0,6
50137,pabalā,pabala,8,4,4,0,6
50138,thavā,thava,6,5,1,0,5
50139,yātā,yata,36,30,6,0,4
50140,hosittaṃ,hosittam,2,1,1,0,8
50141,sukhadukkhappadā,sukhadukkhappada,4,1,3,0,16
50142,tatiyapādādi,tatiyapadadi,1,1,0,0,12
50143,sādaraṃ,sadaram,32,27,5,0,7
50144,daraṃ,daram,55,42,13,0,5
50145,vandanāmāna,vandanamana,2,2,0,0,11
50146,ratanattaye,ratanattaye,132,125,7,0,11
50147,catukkapādādi,catukkapadadi,1,1,0,0,13
50148,vanado,vanado,5,2,3,0,6
50149,mbaraṃ,mbaram,4,3,1,0,6
50150,abyapetādiyamaka,abyapetadiyamaka,1,1,0,0,16
50151,sseso,sseso,1,1,0,0,5
50152,māyeva,mayeva,2,1,1,0,6
50153,yamakānipi,yamakanipi,3,1,2,0,10
50154,accantabahavo,accantabahavo,4,1,3,0,13
50155,sambhedayoniyo,sambhedayoniyo,4,1,3,0,14
50156,sukarā,sukara,98,91,7,0,6
50157,accantadukkarā,accantadukkara,4,2,2,0,14
50158,pahelī,paheli,1,0,1,0,6
50159,paheḷi,paheli,2,1,1,0,6
50160,nekantamadhurāni,nekantamadhurani,2,1,1,0,16
50161,upekkhiyanti,upekkhiyanti,3,2,1,0,12
50162,sissakhedabhayā,sissakhedabhaya,4,2,2,0,15
50163,desakālakalāloka,desakalakalaloka,1,1,0,0,16
50164,ñāyāgamavirodhi,nayagamavirodhi,1,1,0,0,15
50165,virodhipadaṃ,virodhipadam,5,1,4,0,12
50166,mudāharaṇato,mudaharanato,1,1,0,0,12
50167,dappatīta,dappatita,2,1,1,0,9
50168,mānīya,maniya,4,2,2,0,6
50169,neyya,neyya,3,1,2,0,5
50170,māhu,mahu,60,51,9,0,4
50171,sabbāpi,sabbapi,616,592,24,0,7
50172,dhavalā,dhavala,15,4,11,0,7
50173,rocanti,rocanti,8,3,5,0,7
50174,nedisaṃ,nedisam,5,4,1,0,7
50175,maññanti,mannanti,276,263,13,0,8
50176,viññuno,vinnuno,20,14,6,0,7
50177,vagatī,vagati,2,1,1,0,6
50178,sāmatthiyavilaṅghinī,samatthiyavilanghini,1,1,0,0,20
50179,sātthakaṃ,satthakam,81,71,10,0,9
50180,visesyaṃ,visesyam,10,5,5,0,8
50181,hīnatthaṃ,hinattham,6,3,3,0,9
50182,nippabhī,nippabhi,1,0,1,0,8
50183,samudeti,samudeti,79,72,7,0,8
50184,pādapūraṇamattaṃ,padapuranamattam,4,2,2,0,16
50185,anattha,anattha,6,5,1,0,7
50186,pādapaṅkeruhaṃ,padapankeruham,5,3,2,0,14
50187,niddesa,niddesa,22,22,0,0,7
50188,bhiyyopi,bhiyyopi,80,76,4,0,8
50189,vārido,varido,7,1,6,0,6
50190,titthiyaṅkurabījāni,titthiyankurabijani,3,1,2,0,19
50191,diṭṭhigatāni,ditthigatani,177,161,16,0,12
50192,pasādeti,pasadeti,44,37,7,0,8
50193,pasanne,pasanne,42,38,4,0,7
50194,mahājane,mahajane,69,67,2,0,8
50195,āraddhakkamavicchedā,araddhakkamaviccheda,3,1,2,0,20
50196,kāpi,kapi,11,1,10,0,4
50197,kopi,kopi,14,6,8,0,4
50198,pakatīpi,pakatipi,4,1,3,0,8
50199,dubbinikkhepā,dubbinikkhepa,4,1,3,0,13
50200,byāmoho,byamoho,4,1,3,0,7
50201,byākiṇṇaṃ,byakinnam,4,1,3,0,9
50202,tadudāharaṇaṃ,tadudaharanam,8,4,4,0,13
50203,bahuguṇe,bahugune,7,3,4,0,8
50204,paṇamati,panamati,9,5,4,0,8
50205,dujjanānaṃ,dujjananam,6,3,3,0,10
50206,pyayaṃ,pyayam,2,0,2,0,6
50207,pamudito,pamudito,65,58,7,0,8
50208,samanussaraṃ,samanussaram,8,3,5,0,12
50209,visiṭṭhavacanā,visitthavacana,2,1,1,0,14
50210,petaṃ,petam,271,259,12,0,5
50211,bhimataṃ,bhimatam,6,3,3,0,8
50212,kaññe,kanne,28,25,3,0,5
50213,kāmayasi,kamayasi,4,2,2,0,8
50214,kiṃnvi,kimnvi,1,1,0,0,6
50215,padasandhānato,padasandhanato,4,1,3,0,14
50216,duppatītikaraṃ,duppatitikaram,5,2,3,0,14
50217,yābhavato,yabhavato,4,0,4,0,9
50218,vuttesu,vuttesu,323,311,12,0,7
50219,sūcite,sucite,4,1,3,0,6
50220,ṭṭhāne,tthane,7,6,1,0,6
50221,sabbatthapādante,sabbatthapadante,1,0,1,0,16
50222,vuttaḍḍhe,vuttaddhe,5,1,4,0,9
50223,pubbāparānekavaṇṇa,pubbaparanekavanna,1,1,0,0,18
50224,padamajjhe,padamajjhe,5,4,1,0,10
50225,tatthodāharaṇapaccudāharaṇāni,tatthodaharanapaccudaharanani,2,2,0,0,29
50226,cāmi,cami,1,0,1,0,4
50227,karavaṇṇaṃ,karavannam,1,0,1,0,10
50228,sakalāpi,sakalapi,28,24,4,0,8
50229,siñca,sinca,15,12,3,0,5
50230,tiva,tiva,5,3,2,0,4
50231,soṇṇarasehi,sonnarasehi,3,1,2,0,11
50232,sandhimhi,sandhimhi,10,7,3,0,9
50233,pubbanto,pubbanto,20,12,8,0,8
50234,vibhattiyā,vibhattiya,47,46,1,0,10
50235,ññathā,nnatha,9,7,2,0,6
50236,desādi,desadi,3,3,0,0,6
50237,pubbapadantā,pubbapadanta,1,1,0,0,12
50238,pubbapadassitā,pubbapadassita,3,1,2,0,14
50239,niccasambandhā,niccasambandha,8,5,3,0,14
50240,parādīva,paradiva,4,1,3,0,8
50241,sabbatthodāharaṇāni,sabbatthodaharanani,2,2,0,0,19
50242,tītaṃ,titam,2,1,1,0,5
50243,lokaggataṃ,lokaggatam,4,3,1,0,10
50244,sso,sso,19,8,11,0,3
50245,vandā,vanda,4,2,2,0,5
50246,nantamati,nantamati,2,0,2,0,9
50247,nissīmāti,nissimati,3,0,3,0,9
50248,vijambhati,vijambhati,18,16,2,0,10
50249,cādipādīsu,cadipadisu,3,2,1,0,10
50250,paccudāharaṇāni,paccudaharanani,2,2,0,0,15
50251,mahāmettā,mahametta,3,2,1,0,9
50252,paramodayā,paramodaya,3,1,2,0,10
50253,varaguṇā,varaguna,1,1,0,0,8
50254,padatthakkamato,padatthakkamato,4,2,2,0,15
50255,kamaccuta,kamaccuta,1,0,1,0,9
50256,lokiyattha,lokiyattha,3,1,2,0,10
50257,matikkantaṃ,matikkantam,2,1,1,0,11
50258,ativuttaṃ,ativuttam,5,1,4,0,9
50259,atisambādha,atisambadha,3,1,2,0,11
50260,mākāsa,makasa,1,0,1,0,6
50261,metissā,metissa,1,0,1,0,7
50262,thanajambhane,thanajambhane,3,0,3,0,13
50263,samudāyatthato,samudayatthato,6,4,2,0,14
50264,apetatthakaṃ,apetatthakam,3,0,3,0,12
50265,gāviputto,gaviputto,4,2,2,0,9
50266,balibaddho,balibaddho,1,0,1,0,10
50267,khādī,khadi,7,5,2,0,5
50268,pivī,pivi,6,4,2,0,4
50269,bandhe,bandhe,41,34,7,0,6
50270,pharusatā,pharusata,6,4,2,0,9
50271,bandhapharusaṃ,bandhapharusam,5,1,4,0,14
50272,khilā,khila,24,18,6,0,5
50273,parikkhīṇā,parikkhina,158,141,17,0,10
50274,phalatya,phalatya,2,0,2,0,8
50275,vākyatthadosa,vakyatthadosa,1,1,0,0,13
50276,manvattha,manvattha,1,1,0,0,9
50277,pakkamādinaṃ,pakkamadinam,2,0,2,0,12
50278,udāharaṇa,udaharana,3,3,0,0,9
50279,sandassayāmya,sandassayamya,2,1,1,0,13
50280,pakkamaṃ,pakkamam,3,3,0,0,8
50281,sampāditāni,sampaditani,10,5,5,0,11
50282,bhoga,bhoga,7,4,3,0,5
50283,saggādi,saggadi,2,0,2,0,7
50284,sādhanāni,sadhanani,6,6,0,0,9
50285,ocityahīnaṃ,ocityahinam,8,4,4,0,11
50286,pūjanīyataro,pujaniyataro,10,5,5,0,12
50287,meko,meko,9,7,2,0,4
50288,mayekasmiṃ,mayekasmim,2,0,2,0,10
50289,ahuṃ,ahum,207,184,23,0,4
50290,dajjāmya,dajjamya,1,0,1,0,8
50291,puttadānena,puttadanena,4,2,2,0,11
50292,vedhate,vedhate,3,0,3,0,7
50293,dujjanāna,dujjanana,1,0,1,0,9
50294,vissāso,vissaso,73,66,7,0,7
50295,nopapajjate,nopapajjate,5,2,3,0,11
50296,vise,vise,20,15,5,0,4
50297,siṅgimhi,singimhi,4,1,3,0,8
50298,rājakulamhi,rajakulamhi,8,6,2,0,11
50299,munindacandimā,munindacandima,2,2,0,0,14
50300,saralolavilocano,saralolavilocano,1,1,0,0,16
50301,vakkantapantho,vakkantapantho,4,2,2,0,14
50302,padassanapīṇito,padassanapinito,1,1,0,0,15
50303,vākyatthato,vakyatthato,4,2,2,0,11
50304,duppatīti,duppatiti,1,1,0,0,9
50305,vissamī,vissami,3,3,0,0,7
50306,duṭṭhālaṅkaraṇaṃ,dutthalankaranam,7,3,4,0,16
50307,tetaṃ,tetam,15,12,3,0,5
50308,tvethaṃ,tvetham,1,1,0,0,7
50309,laṅkāradūsanaṃ,lankaradusanam,1,1,0,0,14
50310,laṅkāraniddese,lankaraniddese,1,1,0,0,14
50311,māvi,mavi,2,2,0,0,4
50312,saṅkhepanayā,sankhepanaya,7,3,4,0,12
50313,dosāna,dosana,1,1,0,0,6
50314,mesaṃ,mesam,8,8,0,0,5
50315,vibhāgo,vibhago,167,156,11,0,7
50316,bodhayituṃ,bodhayitum,5,3,2,0,10
50317,tamatthi,tamatthi,3,2,1,0,8
50318,khedakaraṃ,khedakaram,5,2,3,0,10
50319,parampi,parampi,160,153,7,0,7
50320,saṅgharakkhitamahāsāmiviracite,sangharakkhitamahasamiviracite,3,3,0,0,30
50321,dosāvabodho,dosavabodho,2,2,0,0,11
50322,dosaparihārāvabodhadutiyapariccheda,dosapariharavabodhadutiyapariccheda,1,1,0,0,35
50323,kavikosallā,kavikosalla,3,1,2,0,11
50324,sakalo,sakalo,82,79,3,0,6
50325,dosasaṅkhya,dosasankhya,1,1,0,0,11
50326,matikkamma,matikkamma,2,2,0,0,10
50327,guṇavīthiṃ,gunavithim,3,1,2,0,10
50328,vuttavirodhāna,vuttavirodhana,1,1,0,0,14
50329,mavirodho,mavirodho,1,1,0,0,9
50330,dosaparihārā,dosaparihara,2,2,0,0,12
50331,vabodho,vabodho,2,2,0,0,7
50332,viruddhatthantarassa,viruddhatthantarassa,4,4,0,0,20
50333,vindantaṃ,vindantam,5,3,2,0,9
50334,pākasālīnaṃ,pakasalinam,3,1,2,0,11
50335,mahāmati,mahamati,42,38,4,0,8
50336,ajha,ajha,1,1,0,0,4
50337,tthassa,tthassa,8,7,1,0,7
50338,tādiguṇābhāve,tadigunabhave,5,3,2,0,13
50339,toseti,toseti,55,52,3,0,6
50340,dujjano,dujjano,25,23,2,0,7
50341,obhāsitāsesadiso,obhasitasesadiso,6,2,4,0,16
50342,pahelikāya,pahelikaya,1,1,0,0,10
50343,paheḷikāya,pahelikaya,8,8,0,0,10
50344,māruḷhā,marulha,1,1,0,0,7
50345,kiliṭṭhatā,kilitthata,8,5,3,0,10
50346,liṅgitaṃ,lingitam,2,1,1,0,8
50347,māliṅgati,malingati,1,1,0,0,9
50348,payojeyya,payojeyya,11,10,1,0,9
50349,kiliṭṭhapada,kilitthapada,2,1,1,0,12
50350,micchite,micchite,2,1,1,0,8
50351,maññaṃ,mannam,31,21,10,0,6
50352,metaṃmayaṃ,metammayam,1,1,0,0,10
50353,desavirodhino,desavirodhino,2,2,0,0,13
50354,bodhisattappabhāvena,bodhisattappabhavena,3,1,2,0,20
50355,thalepi,thalepi,14,12,2,0,7
50356,jalajānya,jalajanya,2,0,2,0,9
50357,huṃ,hum,17,13,4,0,3
50358,nudantāni,nudantani,3,1,2,0,9
50359,sucirā,sucira,1,1,0,0,6
50360,vāsaklesaṃ,vasaklesam,1,1,0,0,10
50361,kālavirodhino,kalavirodhino,2,2,0,0,13
50362,mahānubhāva,mahanubhava,56,56,0,0,11
50363,pisuno,pisuno,2,1,1,0,6
50364,sabbotukamayaṃ,sabbotukamayam,2,0,2,0,14
50365,vāyi,vayi,33,30,3,0,4
50366,dhunanto,dhunanto,19,16,3,0,8
50367,kalāvirodhino,kalavirodhino,2,2,0,0,13
50368,nimuggamānaso,nimuggamanaso,1,1,0,0,13
50369,pañcasikhassapi,pancasikhassapi,3,2,1,0,15
50370,tantissara,tantissara,1,0,1,0,10
50371,sampīṇeti,sampineti,9,6,3,0,9
50372,lokavirodhino,lokavirodhino,2,2,0,0,13
50373,candanāyapi,candanayapi,3,2,1,0,11
50374,paditta,paditta,1,0,1,0,7
50375,ṅgārapūritaṃ,ngarapuritam,1,0,1,0,12
50376,ñāyavirodhino,nayavirodhino,2,2,0,0,13
50377,pariccattabhavo,pariccattabhavo,1,0,1,0,15
50378,mupanītabhavo,mupanitabhavo,1,1,0,0,13
50379,acintyaguṇasārāya,acintyagunasaraya,4,2,2,0,17
50380,āgamavirodhino,agamavirodhino,2,2,0,0,14
50381,nevā,neva,9,9,0,0,4
50382,kenā,kena,19,18,1,0,4
50383,vacīviññattito,vacivinnattito,5,1,4,0,14
50384,sampajānamusāvādā,sampajanamusavada,3,1,2,0,17
50385,phuseyyā,phuseyya,16,16,0,0,8
50386,pattidukkaṭaṃ,pattidukkatam,1,1,0,0,13
50387,neyyassa,neyyassa,35,34,1,0,8
50388,marīcicandanā,maricicandana,1,1,0,0,13
50389,lepa,lepa,2,2,0,0,4
50390,lābhā,labha,276,258,18,0,5
50391,sītamarīcino,sitamaricino,5,2,3,0,12
50392,manonurañjano,manonuranjano,6,1,5,0,13
50393,ṅganāsiṅgāravibbhamo,nganasingaravibbhamo,1,1,0,0,20
50394,jinenā,jinena,2,1,1,0,6
50395,samanuññāto,samanunnato,9,8,1,0,11
50396,visesanāpekkhassa,visesanapekkhassa,2,2,0,0,17
50397,apayātā,apayata,1,1,0,0,7
50398,parādhampi,paradhampi,1,1,0,0,10
50399,kodhapāṭalabhūtena,kodhapatalabhutena,3,1,2,0,18
50400,hīnatthassa,hinatthassa,2,2,0,0,11
50401,appakānampi,appakanampi,13,10,3,0,11
50402,pāpānaṃ,papanam,60,48,12,0,7
50403,pabhāvaṃ,pabhavam,11,7,4,0,8
50404,nāsaye,nasaye,4,1,3,0,6
50405,nippabhātā,nippabhata,1,0,1,0,10
50406,nīta,nita,2,1,1,0,4
50407,anatthassa,anatthassa,41,41,0,0,10
50408,pādapūraṇatthāya,padapuranatthaya,3,2,1,0,16
50409,bhayakodhapasaṃsādi,bhayakodhapasamsadi,3,2,1,0,19
50410,tādiso,tadiso,520,499,21,0,6
50411,kāmīyate,kamiyate,9,3,6,0,8
50412,tatthe,tatthe,15,13,2,0,6
50413,katthatākato,katthatakato,2,1,1,0,12
50414,nivattatu,nivattatu,4,1,3,0,9
50415,jīvitukāmo,jivitukamo,30,27,3,0,10
50416,mupasappasi,mupasappasi,1,1,0,0,11
50417,bhaggarītino,bhaggaritino,2,2,0,0,12
50418,tisayo,tisayo,3,3,0,0,6
50419,buddhamaho,buddhamaho,1,1,0,0,10
50420,abyāmohakaraṃ,abyamohakaram,3,1,2,0,13
50421,bandhaṃ,bandham,64,56,8,0,7
50422,abyākiṇṇaṃ,abyakinnam,4,1,3,0,10
50423,manoharaṃ,manoharam,49,44,5,0,9
50424,adūrapada,adurapada,1,1,0,0,9
50425,vinyāsaṃ,vinyasam,1,1,0,0,8
50426,pasaṃsanti,pasamsanti,168,159,9,0,10
50427,kavissarā,kavissara,3,1,2,0,9
50428,nīluppalā,niluppala,1,0,1,0,9
50429,bandhukaruciro,bandhukaruciro,3,0,3,0,14
50430,ṅkuso,nkuso,1,0,1,0,5
50431,samatikkanta,samatikkanta,1,1,0,0,12
50432,gāmmattaṃ,gammattam,7,3,4,0,9
50433,bhisaṅkhataṃ,bhisankhatam,1,1,0,0,12
50434,rasahetuttā,rasahetutta,3,1,2,0,11
50435,ativattati,ativattati,41,37,4,0,10
50436,dunoti,dunoti,8,2,6,0,6
50437,kāmacaṇḍālo,kamacandalo,4,1,3,0,11
50438,sadaya,sadaya,4,1,3,0,6
50439,niddayo,niddayo,10,7,3,0,7
50440,byasanā,byasana,13,12,1,0,7
50441,sukhīpi,sukhipi,7,5,2,0,7
50442,mupekkhase,mupekkhase,1,1,0,0,10
50443,yatihīnaparihāro,yatihinapariharo,3,0,3,0,16
50444,pune,pune,3,2,1,0,4
50445,savanu,savanu,1,1,0,0,6
50446,bbegaṃ,bbegam,1,1,0,0,6
50447,vicāritaṃ,vicaritam,53,41,12,0,9
50448,kamaccutassa,kamaccutassa,3,3,0,0,12
50449,udāracarito,udaracarito,2,1,1,0,11
50450,tene,tene,19,17,2,0,4
50451,rādhanā,radhana,2,1,1,0,7
50452,ativuttassa,ativuttassa,4,3,1,0,11
50453,munindacandasambhūta,munindacandasambhuta,2,1,1,0,20
50454,yasorāsimarīcinaṃ,yasorasimaricinam,2,1,1,0,17
50455,sakalopya,sakalopya,3,0,3,0,9
50456,mākāso,makaso,1,0,1,0,6
50457,vakāso,vakaso,2,0,2,0,6
50458,vijambhane,vijambhane,5,1,4,0,10
50459,byāpannacittānaṃ,byapannacittanam,4,2,2,0,16
50460,apetatthaṃ,apetattham,6,1,5,0,10
50461,aninditaṃ,aninditam,7,3,4,0,9
50462,tenu,tenu,2,1,1,0,4
50463,mmattādikānaṃ,mmattadikanam,2,1,1,0,13
50464,ññatra,nnatra,17,14,3,0,6
50465,pīyate,piyate,18,16,2,0,6
50466,jarāturo,jaraturo,6,3,3,0,8
50467,gajjanti,gajjanti,11,8,3,0,8
50468,sakkasse,sakkasse,2,0,2,0,8
50469,rāvaṇo,ravano,2,0,2,0,6
50470,sukhumālā,sukhumala,21,19,2,0,9
50471,virodhitta,virodhitta,1,1,0,0,10
50472,dittabhāvappabhāvitaṃ,dittabhavappabhavitam,1,1,0,0,21
50473,bandhapharusa,bandhapharusa,1,0,1,0,13
50474,saṃdūsayeyya,samdusayeyya,4,1,3,0,12
50475,passantā,passanta,91,79,12,0,8
50476,rūpavibhavaṃ,rupavibhavam,6,1,5,0,12
50477,giraṃ,giram,139,114,25,0,5
50478,keḷiparammukhā,keliparammukha,6,0,6,0,14
50479,apakkamassa,apakkamassa,2,2,0,0,11
50480,uddiṭṭhavisayo,udditthavisayo,3,1,2,0,14
50481,ddiṭṭhesu,dditthesu,1,1,0,0,9
50482,kamavilaṅghane,kamavilanghane,3,2,1,0,14
50483,abyā,abya,1,0,1,0,4
50484,miccesu,miccesu,3,2,1,0,7
50485,pacchimaṃ,pacchimam,508,470,38,0,9
50486,abyākataṃ,abyakatam,1051,1021,30,0,9
50487,pākadaṃ,pakadam,8,0,8,0,7
50488,paṭhamadvayaṃ,pathamadvayam,6,2,4,0,13
50489,saguṇānā,sagunana,2,1,1,0,8
50490,vikaraṇe,vikarane,3,2,1,0,8
50491,ocityahīnatā,ocityahinata,1,1,0,0,12
50492,bhūtatthasaṃsino,bhutatthasamsino,3,1,2,0,16
50493,ocityaṃ,ocityam,16,14,2,0,7
50494,vikhyāta,vikhyata,2,2,0,0,8
50495,mādarā,madara,1,1,0,0,6
50496,tattho,tattho,9,7,2,0,6
50497,padesapabhavā,padesapabhava,2,1,1,0,13
50498,kavipuṅgavā,kavipungava,7,4,3,0,11
50499,viññātocityavibhavo,vinnatocityavibhavo,3,1,2,0,19
50500,parihare,parihare,8,5,3,0,8
50501,cityassa,cityassa,2,1,1,0,8
50502,sampose,sampose,4,1,3,0,7
50503,rasaposo,rasaposo,3,1,2,0,8
50504,māsanna,masanna,1,0,1,0,7
50505,māsannavijayu,masannavijayu,1,0,1,0,13
50506,ssavo,ssavo,3,1,2,0,5
50507,tiṇāyapi,tinayapi,30,26,4,0,8
50508,maññittha,mannittha,28,24,4,0,9
50509,detu,detu,80,76,4,0,4
50510,āraddhakattukammādi,araddhakattukammadi,1,1,0,0,19
50511,tikkamalaṅghane,tikkamalanghane,1,1,0,0,15
50512,bhaggarītivirodho,bhaggaritivirodho,3,2,1,0,17
50513,kvā,kva,6,6,0,0,3
50514,ññāna,nnana,1,0,1,0,5
50515,mitthīnaṃ,mitthinam,2,0,2,0,9
50516,papajjate,papajjate,4,3,1,0,9
50517,siṅgino,singino,9,6,3,0,7
50518,nadīrājakulassa,nadirajakulassa,1,0,1,0,15
50519,buddhādiratanattaye,buddhadiratanattaye,3,2,1,0,19
50520,mācare,macare,3,2,1,0,6
50521,saguṇe,sagune,4,2,2,0,6
50522,sasaṃsayassa,sasamsayassa,4,4,0,0,12
50523,vilocano,vilocano,2,2,0,0,8
50524,dassanapīṇito,dassanapinito,1,1,0,0,13
50525,saṃsayāye,samsayaye,1,1,0,0,9
50526,kīḷādihetunā,kiladihetuna,4,3,1,0,12
50527,sasaṃsayasamappito,sasamsayasamappito,3,1,2,0,18
50528,nilayaṃ,nilayam,9,4,5,0,7
50529,garumhi,garumhi,8,7,1,0,7
50530,sakagehato,sakagehato,9,3,6,0,10
50531,pāpuṇeyyāma,papuneyyama,4,3,1,0,11
50532,majjhayanā,majjhayana,1,1,0,0,10
50533,subhagā,subhaga,15,9,6,0,7
50534,etassi,etassi,3,2,1,0,6
50535,ccevamādikaṃ,ccevamadikam,2,1,1,0,12
50536,gāmma,gamma,2,1,1,0,5
50537,sakalehipi,sakalehipi,3,2,1,0,10
50538,laṅkāravigame,lankaravigame,1,1,0,0,13
50539,laṅkatikkamo,lankatikkamo,1,1,0,0,12
50540,alaṅkāraparicchede,alankaraparicchede,3,1,2,0,18
50541,āvibhāvaṃ,avibhavam,57,47,10,0,9
50542,gamissati,gamissati,237,234,3,0,9
50543,parīharitu,pariharitu,1,1,0,0,10
50544,mesa,mesa,6,5,1,0,4
50545,satthantarānusaraṇena,satthantaranusaranena,3,1,2,0,21
50546,mayevaṃ,mayevam,2,1,1,0,7
50547,viññāyi,vinnayi,2,1,1,0,7
50548,garuvarāna,garuvarana,1,1,0,0,10
50549,dhika,dhika,4,3,1,0,5
50550,ppasādā,ppasada,1,1,0,0,7
50551,parihareyya,parihareyya,24,21,3,0,11
50552,yasobhilāsī,yasobhilasi,4,1,3,0,11
50553,dosaparihārāvabodho,dosapariharavabodho,4,2,2,0,19
50554,guṇāvabodhatatiyapariccheda,gunavabodhatatiyapariccheda,1,1,0,0,27
50555,anusandhi,anusandhi,111,99,12,0,9
50556,sambhavanti,sambhavanti,306,301,5,0,11
50557,dosāne,dosane,2,1,1,0,6
50558,matikkame,matikkame,4,3,1,0,9
50559,dassessaṃ,dassessam,5,2,3,0,9
50560,sambhūsayanti,sambhusayanti,4,1,3,0,13
50561,saddālaṅkāra,saddalankara,3,3,0,0,12
50562,daratā,darata,1,1,0,0,6
50563,guṇehe,gunehe,2,1,1,0,6
50564,kavimanoharo,kavimanoharo,4,1,3,0,12
50565,sampādiyati,sampadiyati,3,3,0,0,11
50566,kattūnaṃ,kattunam,14,11,3,0,8
50567,maccantanimmalaṃ,maccantanimmalam,1,1,0,0,16
50568,adūrāhitasambandha,adurahitasambandha,1,1,0,0,18
50569,supasiddhā,supasiddha,1,1,0,0,10
50570,bhidheyyā,bhidheyya,1,1,0,0,9
50571,janaye,janaye,8,5,3,0,6
50572,alaṅkarontā,alankaronta,9,6,3,0,11
50573,dhararaṃsiyo,dhararamsiyo,2,0,2,0,12
50574,ruṇaraṃsī,runaramsi,2,1,1,0,9
50575,sampatantā,sampatanta,7,4,3,0,10
50576,mbujo,mbujo,2,2,0,0,5
50577,dare,dare,2,2,0,0,4
50578,samāsabāhulya,samasabahulya,2,1,1,0,13
50579,gajjassa,gajjassa,5,2,3,0,8
50580,pajjepya,pajjepya,2,1,1,0,8
50581,kulo,kulo,9,8,1,0,4
50582,sañjāta,sanjata,5,4,1,0,7
50583,candana,candana,6,5,1,0,7
50584,limpitā,limpita,3,0,3,0,7
50585,pallavā,pallava,7,4,3,0,7
50586,tasse,tasse,17,14,3,0,5
50587,veko,veko,3,3,0,0,4
50588,dharapallavo,dharapallavo,2,1,1,0,12
50589,bhidheyyavisayaṃ,bhidheyyavisayam,1,1,0,0,16
50590,samāsa,samasa,17,12,5,0,6
50591,byāsa,byasa,1,1,0,0,5
50592,pāriṇatyaṃ,parinatyam,5,2,3,0,10
50593,jotayitvāna,jotayitvana,15,12,3,0,11
50594,santāretvā,santaretva,20,16,4,0,10
50595,jalitvā,jalitva,35,31,4,0,7
50596,aggikhandho,aggikhandho,3,1,2,0,11
50597,sasāvako,sasavako,53,50,3,0,8
50598,matthakaṭṭhī,matthakatthi,4,0,4,0,12
50599,matassā,matassa,1,0,1,0,7
50600,rajobhāvaṃ,rajobhavam,4,0,4,0,10
50601,vajantu,vajantu,6,2,4,0,7
50602,sentu,sentu,3,2,1,0,5
50603,mbujadvaye,mbujadvaye,1,0,1,0,10
50604,niccappaṇati,niccappanati,1,1,0,0,12
50605,gedho,gedho,55,47,8,0,5
50606,padissati,padissati,49,46,3,0,9
50607,paññānamabhiyogato,pannanamabhiyogato,1,1,0,0,18
50608,madhurattaṃ,madhurattam,10,6,4,0,11
50609,padāsatti,padasatti,8,7,1,0,9
50610,nuppāsavasā,nuppasavasa,1,1,0,0,11
50611,samasuti,samasuti,4,3,1,0,8
50612,bhisambodhiṃ,bhisambodhim,2,0,2,0,12
50613,mahu,mahu,2,1,1,0,4
50614,nda,nda,4,0,4,0,3
50615,hāsā,hasa,4,4,0,0,4
50616,havibbhamā,havibbhama,1,1,0,0,10
50617,manudhāvaṃ,manudhavam,1,1,0,0,10
50618,sabbakomalavaṇṇehi,sabbakomalavannehi,4,2,2,0,18
50619,nuppāso,nuppaso,2,0,2,0,7
50620,pasaṃsiyo,pasamsiyo,24,21,3,0,9
50621,mālatīmālā,malatimala,4,0,4,0,10
50622,lina,lina,1,0,1,0,4
50623,lolā,lola,13,12,1,0,4
50624,limālinī,limalini,1,0,1,0,8
50625,mudūhi,muduhi,20,13,7,0,6
50626,kevalehi,kevalehi,13,7,6,0,8
50627,phuṭehi,phutehi,4,1,3,0,7
50628,missehi,missehi,4,1,3,0,7
50629,vaṇṇehi,vannehi,30,27,3,0,7
50630,kevalamudusamatā,kevalamudusamata,2,2,0,0,16
50631,kokilā,kokila,40,34,6,0,6
50632,lāpasaṃvādī,lapasamvadi,1,0,1,0,11
50633,munindā,muninda,1,0,1,0,7
50634,lāpavibbhamo,lapavibbhamo,1,0,1,0,12
50635,hadayaṅgamataṃ,hadayangamatam,4,0,4,0,14
50636,nibbutiṃ,nibbutim,132,106,26,0,8
50637,kevalaphuṭasamatā,kevalaphutasamata,2,2,0,0,17
50638,sambhāvanīyasambhāvaṃ,sambhavaniyasambhavam,3,0,3,0,21
50639,bhavantaguṃ,bhavantagum,4,1,3,0,11
50640,bhavantasādhanā,bhavantasadhana,1,0,1,0,15
50641,kaṅkhī,kankhi,26,18,8,0,6
50642,sambhāvaye,sambhavaye,4,0,4,0,10
50643,vibhuṃ,vibhum,5,2,3,0,6
50644,missakasamatā,missakasamata,2,2,0,0,13
50645,laddhacandanasaṃsagga,laddhacandanasamsagga,1,0,1,0,21
50646,malayā,malaya,4,3,1,0,6
50647,māyāti,mayati,11,3,8,0,6
50648,bhīto,bhito,285,276,9,0,5
50649,munindamukhamārutā,munindamukhamaruta,3,0,3,0,18
50650,aniṭṭhura,anitthura,1,1,0,0,9
50651,kkhara,kkhara,3,3,0,0,6
50652,ppāyā,ppaya,1,1,0,0,5
50653,sabbakomala,sabbakomala,1,1,0,0,11
50654,nissaṭā,nissata,36,30,6,0,7
50655,kicchamuccāraṇā,kicchamuccarana,1,1,0,0,15
50656,peta,peta,6,6,0,0,4
50657,byañjanā,byanjana,52,43,9,0,8
50658,sīchandhānurakkhaṇatthaṃ,sichandhanurakkhanattham,1,1,0,0,24
50659,alaṅkāravihīnā,alankaravihina,1,1,0,0,14
50660,sammukhate,sammukhate,2,1,1,0,10
50661,ārohati,arohati,66,63,3,0,7
50662,ramaṇīyā,ramaniya,77,68,9,0,8
50663,dujjalā,dujjala,1,1,0,0,7
50664,romañca,romanca,1,0,1,0,7
50665,piñcha,pincha,5,3,2,0,6
50666,racanā,racana,9,7,2,0,6
50667,vādāhitaddhanī,vadahitaddhani,1,0,1,0,14
50668,munimeghu,munimeghu,1,0,1,0,9
50669,mmadā,mmada,1,0,1,0,5
50670,sikhāvalā,sikhavala,4,1,3,0,9
50671,sukhumālatta,sukhumalatta,3,1,2,0,12
50672,matthe,matthe,7,7,0,0,6
50673,padatthavisayampi,padatthavisayampi,3,1,2,0,17
50674,matādisaddesu,matadisaddesu,2,1,1,0,13
50675,kittisesā,kittisesa,3,0,3,0,9
50676,dikittanaṃ,dikittanam,1,1,0,0,10
50677,siliṭṭha,silittha,1,1,0,0,8
50678,saṃsagga,samsagga,4,4,0,0,8
50679,ramaṇīya,ramaniya,4,2,2,0,8
50680,sabandhagāravo,sabandhagaravo,3,1,2,0,14
50681,bāli,bali,1,0,1,0,4
50682,nduvibbhama,nduvibbhama,1,0,1,0,11
50683,cchedi,cchedi,1,0,1,0,6
50684,nakharā,nakhara,1,0,1,0,7
50685,kantibhi,kantibhi,3,0,3,0,8
50686,munindapada,munindapada,1,0,1,0,11
50687,mbhoja,mbhoja,3,2,1,0,6
50688,valitā,valita,5,1,4,0,6
50689,ukkaṃsavanto,ukkamsavanto,6,2,4,0,12
50690,patīyate,patiyate,43,37,6,0,8
50691,udāro,udaro,10,3,7,0,5
50692,sanāthā,sanatha,12,8,4,0,7
50693,bandhapaddhati,bandhapaddhati,8,3,5,0,14
50694,pādambhoja,padambhoja,1,0,1,0,10
50695,litta,litta,1,0,1,0,5
50696,gattā,gatta,6,5,1,0,5
50697,jantavo,jantavo,26,23,3,0,7
50698,nirajattanaṃ,nirajattanam,4,0,4,0,12
50699,nubhāvassa,nubhavassa,1,1,0,0,10
50700,samukkaṃso,samukkamso,4,1,3,0,10
50701,cintaye,cintaye,21,18,3,0,7
50702,mīdisaṃ,midisam,8,7,1,0,7
50703,kīḷāsaro,kilasaro,3,0,3,0,8
50704,hemaṅgadā,hemangada,1,0,1,0,9
50705,tikkantā,tikkanta,3,3,0,0,8
50706,sabbajanānapi,sabbajananapi,2,1,1,0,13
50707,tivuttassa,tivuttassa,2,1,1,0,10
50708,parihārato,pariharato,7,5,2,0,10
50709,atthabyattā,atthabyatta,2,0,2,0,11
50710,bhidheyyassā,bhidheyyassa,2,1,1,0,12
50711,neyyatā,neyyata,4,3,1,0,7
50712,tthato,tthato,2,1,1,0,6
50713,tadubhayā,tadubhaya,5,3,2,0,9
50714,parihāre,parihare,7,6,1,0,8
50715,padassitā,padassita,4,1,3,0,9
50716,marīciccādi,mariciccadi,1,0,1,0,11
50717,sabhāvā,sabhava,36,32,4,0,7
50718,malatā,malata,1,0,1,0,6
50719,pādanakhesu,padanakhesu,4,2,2,0,11
50720,vanatā,vanata,3,2,1,0,6
50721,moḷicchāyā,molicchaya,2,0,2,0,10
50722,bandhasāro,bandhasaro,3,1,2,0,10
50723,samaggāpi,samaggapi,4,2,2,0,9
50724,vasaraṃ,vasaram,2,2,0,0,7
50725,aññadhammo,annadhammo,6,4,2,0,10
50726,ññattha,nnattha,6,5,1,0,7
50727,lokasīmā,lokasima,1,1,0,0,8
50728,nurodhato,nurodhato,1,1,0,0,9
50729,ādhīyate,adhiyate,8,3,5,0,8
50730,cce,cce,3,1,2,0,3
50731,samādhī,samadhi,114,89,25,0,7
50732,niruccati,niruccati,3,1,2,0,9
50733,apāṇe,apane,11,6,5,0,5
50734,nirūpe,nirupe,5,3,2,0,6
50735,rūpayuttassa,rupayuttassa,5,3,2,0,12
50736,nirase,nirase,5,3,2,0,6
50737,sarasassa,sarasassa,8,6,2,0,9
50738,adrave,adrave,5,3,2,0,6
50739,dravayuttassa,dravayuttassa,5,3,2,0,13
50740,akattaripi,akattaripi,9,7,2,0,10
50741,kattutā,kattuta,10,8,2,0,7
50742,kaṭhinassā,kathinassa,3,2,1,0,10
50743,samādhiniddesa,samadhiniddesa,2,2,0,0,14
50744,puṇṇi,punni,1,1,0,0,5
50745,ndunā,nduna,2,2,0,0,5
50746,divāpi,divapi,40,39,1,0,6
50747,saṅgamā,sangama,5,1,4,0,7
50748,viniddā,vinidda,4,0,4,0,7
50749,sampamodanti,sampamodanti,6,2,4,0,12
50750,kumudinī,kumudini,11,8,3,0,8
50751,nirupe,nirupe,1,1,0,0,6
50752,dayārasesu,dayarasesu,4,0,4,0,10
50753,mujjantā,mujjanta,5,2,3,0,8
50754,matarasesvi,matarasesvi,2,0,2,0,11
50755,sukhitā,sukhita,187,172,15,0,7
50756,hatadosā,hatadosa,3,1,2,0,8
50757,mbujā,mbuja,1,1,0,0,5
50758,ppasīdanti,ppasidanti,1,1,0,0,10
50759,kīdisī,kidisi,50,49,1,0,6
50760,manasovutti,manasovutti,1,1,0,0,11
50761,khāraguṇāna,kharagunana,1,0,1,0,11
50762,sabbatthasiddha,sabbatthasiddha,3,1,2,0,15
50763,cūḷaka,culaka,1,0,1,0,6
50764,puṭapeyyā,putapeyya,1,0,1,0,9
50765,mahāguṇā,mahaguna,11,8,3,0,8
50766,kundasobhā,kundasobha,1,1,0,0,10
50767,mārā,mara,20,15,5,0,4
50768,ribala,ribala,1,0,1,0,6
50769,vissaṭṭhā,vissattha,51,50,1,0,9
50770,kuṇṭhā,kuntha,7,3,4,0,6
50771,yudhā,yudha,5,2,3,0,5
50772,lajjamānā,lajjamana,19,15,4,0,9
50773,ññavesena,nnavesena,2,1,1,0,9
50774,munindabhāṇumā,munindabhanuma,2,1,1,0,14
50775,bodho,bodho,18,13,5,0,5
50776,saddhammaraṃsinā,saddhammaramsina,4,1,3,0,16
50777,bhinda,bhinda,13,12,1,0,6
50778,mandatamaṃ,mandatamam,1,1,0,0,10
50779,vamanu,vamanu,1,0,1,0,6
50780,ggiranādye,ggiranadye,1,0,1,0,10
50781,guṇavutya,gunavutya,1,1,0,0,9
50782,pariccutaṃ,pariccutam,1,1,0,0,10
50783,atisundara,atisundara,1,1,0,0,10
50784,gāmmataṃ,gammatam,4,0,4,0,8
50785,kantīnaṃ,kantinam,7,4,3,0,8
50786,vamanabyājā,vamanabyaja,4,0,4,0,11
50787,munipādanakhā,munipadanakha,1,1,0,0,13
50788,candakantī,candakanti,6,3,3,0,10
50789,pivantī,pivanti,5,4,1,0,7
50790,nippabhaṃ,nippabham,11,7,4,0,9
50791,karontiyo,karontiyo,23,20,3,0,9
50792,acittakattukaṃ,acittakattukam,4,1,3,0,14
50793,rucya,rucya,1,1,0,0,5
50794,rucca,rucca,1,1,0,0,5
50795,guṇakammataṃ,gunakammatam,1,1,0,0,12
50796,sacittakattukaṃ,sacittakattukam,2,1,1,0,15
50797,guṇakammaṃ,gunakammam,7,3,4,0,10
50798,yadu,yadu,2,1,1,0,4
50799,ttamaṃ,ttamam,9,8,1,0,6
50800,uggiranto,uggiranto,6,3,3,0,9
50801,sasneha,sasneha,2,1,1,0,7
50802,sappīṇaye,sappinaye,1,1,0,0,9
50803,saddasatthakusalo,saddasatthakusalo,5,2,3,0,17
50804,nighaṇḍu,nighandu,14,10,4,0,8
50805,chandoalaṅkatisu,chandoalankatisu,2,1,1,0,16
50806,niccakatā,niccakata,1,1,0,0,9
50807,bhiyogo,bhiyogo,1,1,0,0,7
50808,kavittavikalopi,kavittavikalopi,5,2,3,0,15
50809,kavīsu,kavisu,5,2,3,0,6
50810,saṅkhya,sankhya,2,1,1,0,7
50811,moggayha,moggayha,2,2,0,0,8
50812,mamandarūpaṃ,mamandarupam,3,2,1,0,12
50813,guṇāvabodho,gunavabodho,2,2,0,0,11
50814,atthālaṅkārāvabodhacatutthapariccheda,atthalankaravabodhacatutthapariccheda,1,1,0,0,37
50815,atthālaṅkārasahitā,atthalankarasahita,4,1,3,0,18
50816,accantakantā,accantakanta,5,2,3,0,12
50817,sabhāva,sabhava,36,27,9,0,7
50818,vaṅkavuttīnaṃ,vankavuttinam,1,0,1,0,13
50819,alaṃkriyā,alamkriya,4,1,3,0,9
50820,nānāvatthā,nanavattha,1,1,0,0,10
50821,vibhāvinī,vibhavini,6,5,1,0,9
50822,vikanti,vikanti,1,0,1,0,7
50823,thira,thira,5,3,2,0,5
50824,vilokano,vilokano,4,3,1,0,8
50825,bodhisattaṅkuro,bodhisattankuro,4,0,4,0,15
50826,bhāsaṃ,bhasam,44,35,9,0,6
50827,viroci,viroci,11,7,4,0,6
50828,vāca,vaca,1,0,1,0,4
50829,māsabhiṃ,masabhim,3,2,1,0,8
50830,vatthusabhāvassa,vatthusabhavassa,3,1,2,0,16
50831,nantavikappattā,nantavikappatta,2,1,1,0,15
50832,bījo,bijo,1,1,0,0,4
50833,padassanaṃ,padassanam,3,3,0,0,10
50834,vaṅkavutti,vankavutti,5,5,0,0,10
50835,atthālaṅkāra,atthalankara,2,1,1,0,12
50836,tisaya,tisaya,3,3,0,0,6
50837,rūpakā,rupaka,2,2,0,0,6
50838,akkhepo,akkhepo,11,6,5,0,7
50839,tthantaranyāso,tthantaranyaso,2,1,1,0,14
50840,byatireko,byatireko,18,14,4,0,9
50841,vibhāvanā,vibhavana,87,80,7,0,9
50842,kkamo,kkamo,1,1,0,0,5
50843,piyataraṃ,piyataram,35,30,5,0,9
50844,parikappanā,parikappana,24,20,4,0,11
50845,pariyāya,pariyaya,28,11,17,0,8
50846,byājopavaṇṇanaṃ,byajopavannanam,1,1,0,0,15
50847,visesa,visesa,24,21,3,0,6
50848,ruḷhāhaṅkārā,rulhahankara,2,1,1,0,12
50849,tulyayogitā,tulyayogita,6,3,3,0,11
50850,mahantattaṃ,mahantattam,30,29,1,0,11
50851,vañcanā,vancana,26,20,6,0,7
50852,ppakatatthuti,ppakatatthuti,2,1,1,0,13
50853,ekāvali,ekavali,7,5,2,0,7
50854,sahavutti,sahavutti,5,4,1,0,9
50855,virodhitā,virodhita,7,3,4,0,9
50856,parivutti,parivutti,4,4,0,0,9
50857,bbhamo,bbhamo,2,1,1,0,6
50858,missa,missa,8,6,2,0,5
50859,māsī,masi,3,1,2,0,4
50860,rasī,rasi,6,4,2,0,4
50861,samuddiṭṭhā,samuddittha,4,2,2,0,11
50862,vaṅkavuttīsu,vankavuttisu,5,2,3,0,12
50863,posesi,posesi,59,58,1,0,6
50864,tisayavutti,tisayavutti,2,0,2,0,11
50865,tikkantavisayā,tikkantavisaya,1,1,0,0,14
50866,lokiyātisayasse,lokiyatisayasse,2,0,2,0,15
50867,jātiādayo,jatiadayo,27,23,4,0,9
50868,lokātikkantagocarā,lokatikkantagocara,4,1,3,0,18
50869,dehakantī,dehakanti,4,0,4,0,9
50870,nettañjalipuṭena,nettanjaliputena,4,0,4,0,16
50871,jine,jine,83,80,3,0,4
50872,taṇhāharopi,tanhaharopi,4,0,4,0,11
50873,upamāno,upamano,8,5,3,0,7
50874,pameyyānaṃ,pameyyanam,5,5,0,0,10
50875,siyo,siyo,12,7,5,0,4
50876,tthagammā,tthagamma,3,1,2,0,9
50877,vākyattha,vakyattha,1,1,0,0,9
50878,bhidhā,bhidha,1,0,1,0,6
50879,saddagammā,saddagamma,6,4,2,0,10
50880,samāsena,samasena,60,52,8,0,8
50881,nano,nano,100,99,1,0,4
50882,āyādī,ayadi,3,1,2,0,5
50883,paṅkajāyate,pankajayate,4,0,4,0,11
50884,munindanayana,munindanayana,1,0,1,0,13
50885,nīluppaladalīyati,niluppaladaliyati,3,0,3,0,17
50886,ivādī,ivadi,3,0,3,0,5
50887,sarī,sari,7,6,1,0,4
50888,sarikkha,sarikkha,1,1,0,0,8
50889,saṃvādī,samvadi,4,2,2,0,7
50890,sapakkho,sapakkho,9,9,0,0,8
50891,pamito,pamito,2,1,1,0,6
50892,paṭibimba,patibimba,2,1,1,0,9
50893,paṭicchanna,paticchanna,4,2,2,0,11
50894,sarūpa,sarupa,3,2,1,0,6
50895,samitā,samita,33,32,1,0,6
50896,savaṇṇā,savanna,23,19,4,0,7
50897,sadhammā,sadhamma,1,1,0,0,8
50898,salakkhaṇā,salakkhana,20,18,2,0,10
50899,jayatya,jayatya,2,1,1,0,7
50900,kkosati,kkosati,3,2,1,0,7
50901,patigajjati,patigajjati,2,1,1,0,11
50902,dūbhati,dubhati,5,3,2,0,7
50903,usūyatya,usuyatya,2,1,1,0,8
50904,vajānāti,vajanati,2,1,1,0,8
50905,nindati,nindati,27,21,6,0,7
50906,ssati,ssati,16,12,4,0,5
50907,coreti,coreti,15,11,4,0,6
50908,sobhaggaṃ,sobhaggam,7,6,1,0,9
50909,kantiṃ,kantim,11,7,4,0,6
50910,vilumpati,vilumpati,18,17,1,0,9
50911,vivadati,vivadati,156,151,5,0,8
50912,tulyaṃ,tulyam,40,36,4,0,6
50913,dhirohati,dhirohati,1,1,0,0,9
50914,manvetya,manvetya,1,1,0,0,8
50915,nubandhati,nubandhati,2,1,1,0,10
50916,taṃsīlaṃ,tamsilam,2,1,1,0,8
50917,taṃnisedheti,tamnisedheti,1,1,0,0,12
50918,nukaroti,nukaroti,1,1,0,0,8
50919,vibhāvibhi,vibhavibhi,11,11,0,0,10
50920,upamābhedā,upamabheda,3,2,1,0,10
50921,niyyanti,niyyanti,82,76,6,0,8
50922,vikāsipadumaṃ,vikasipadumam,2,0,2,0,13
50923,sugatā,sugata,86,79,7,0,6
50924,nanaṃ,nanam,4,2,2,0,5
50925,dhammopamā,dhammopama,5,2,3,0,10
50926,tulyadhammanidassanā,tulyadhammanidassana,3,1,2,0,20
50927,dhammahīnā,dhammahina,4,1,3,0,10
50928,viparīto,viparito,47,45,2,0,8
50929,mānanena,mananena,1,1,0,0,8
50930,mbujaṃ,mbujam,10,6,4,0,6
50931,tavā,tava,39,36,3,0,4
50932,nana,nana,31,30,1,0,4
50933,miva,miva,13,7,6,0,4
50934,mbhojaṃ,mbhojam,5,2,3,0,7
50935,ambhoja,ambhoja,4,0,4,0,7
50936,aññamaññopamā,annamannopama,3,1,2,0,13
50937,aññamaññopamānato,annamannopamanato,3,1,2,0,17
50938,bbhamuvibbhamaṃ,bbhamuvibbhamam,1,1,0,0,15
50939,dhāretuṃ,dharetum,184,174,10,0,8
50940,abbhutopamā,abbhutopama,4,1,3,0,11
50941,sambandhī,sambandhi,23,22,1,0,9
50942,mbujaṃve,mbujamve,2,1,1,0,8
50943,silesopamā,silesopama,5,2,3,0,10
50944,sarūpasaddavāccattā,sarupasaddavaccatta,3,1,2,0,19
50945,santānopamā,santanopama,5,3,2,0,11
50946,yyānamālā,yyanamala,2,0,2,0,9
50947,lakā,laka,5,4,1,0,4
50948,nanasobhinī,nanasobhini,1,0,1,0,11
50949,khayī,khayi,5,0,5,0,5
50950,bahurajaṃ,bahurajam,4,1,3,0,9
50951,samānampi,samanampi,15,11,4,0,9
50952,samukkaṃsi,samukkamsi,3,0,3,0,10
50953,nindopamā,nindopama,5,3,2,0,9
50954,asamattho,asamattho,70,61,9,0,9
50955,mukheni,mukheni,2,0,2,0,7
50956,ndu,ndu,3,1,2,0,3
50957,paṭigajjituṃ,patigajjitum,5,1,4,0,12
50958,jaḷo,jalo,31,26,5,0,4
50959,kalaṅkī,kalanki,4,0,4,0,7
50960,paṭisedhopamā,patisedhopama,5,3,2,0,13
50961,candāravindānaṃ,candaravindanam,4,2,2,0,15
50962,jāta,jata,16,6,10,0,4
50963,mitya,mitya,1,1,0,0,5
50964,sādhāraṇopamā,sadharanopama,2,0,2,0,13
50965,ppabhāsāro,ppabhasaro,1,1,0,0,10
50966,rāsibhūto,rasibhuto,10,7,3,0,9
50967,vibhātī,vibhati,2,2,0,0,7
50968,hotā,hota,10,8,2,0,4
50969,bhūtopamā,bhutopama,2,0,2,0,9
50970,saddasāmatthiyā,saddasamatthiya,3,1,2,0,15
50971,ppaccaye,ppaccaye,67,67,0,0,8
50972,vādi,vadi,1,1,0,0,4
50973,saddayogaṃ,saddayogam,1,1,0,0,10
50974,bhiṅgāne,bhingane,2,0,2,0,8
50975,māni,mani,10,8,2,0,4
50976,cakkhūni,cakkhuni,151,142,9,0,8
50977,mevi,mevi,3,1,2,0,4
50978,subyattasadisattena,subyattasadisattena,3,1,2,0,19
50979,sarūpopamā,sarupopama,4,2,2,0,10
50980,maye,maye,12,10,2,0,4
50981,mukhasobhā,mukhasobha,6,4,2,0,10
50982,sse,sse,47,33,14,0,3
50983,tyala,tyala,1,1,0,0,5
50984,mindu,mindu,2,2,0,0,5
50985,vikatthanā,vikatthana,6,5,1,0,10
50986,mbujepi,mbujepi,1,1,0,0,7
50987,tthīti,tthiti,3,2,1,0,6
50988,parikappopamā,parikappopama,6,4,2,0,13
50989,ntobhantāli,ntobhantali,2,1,1,0,11
50990,lolanayanaṃ,lolanayanam,3,1,2,0,11
50991,dolāyate,dolayate,5,2,3,0,8
50992,micca,micca,5,4,1,0,5
50993,saṃsayopamā,samsayopama,5,2,3,0,11
50994,padassetvā,padassetva,5,4,1,0,10
50995,sadhammassā,sadhammassa,2,1,1,0,11
50996,bhidhānato,bhidhanato,3,2,1,0,10
50997,sāmyappatītisabbhāvā,samyappatitisabbhava,3,1,2,0,20
50998,pativatthupamā,pativatthupama,1,0,1,0,14
50999,jāyamānesu,jayamanesu,7,5,2,0,10
51000,jinasādiso,jinasadiso,4,0,4,0,10
51001,natthe,natthe,4,3,1,0,6
51002,pārijātassa,parijatassa,5,1,4,0,11
51003,vākyatthene,vakyatthene,1,1,0,0,11
51004,vākyattho,vakyattho,14,10,4,0,9
51005,kocū,kocu,1,1,0,0,4
51006,pamīyate,pamiyate,4,3,1,0,8
51007,ivayuttā,ivayutta,2,2,0,0,8
51008,viyuttattā,viyuttatta,1,1,0,0,10
51009,vākyatthopamā,vakyatthopama,5,2,3,0,13
51010,saṃklesatattānaṃ,samklesatattanam,3,0,3,0,16
51011,janāna,janana,4,2,2,0,6
51012,ghammasantāpatattānaṃ,ghammasantapatattanam,3,1,2,0,21
51013,ghammakāle,ghammakale,11,7,4,0,10
51014,mbudo,mbudo,3,1,2,0,5
51015,ivaviyuttā,ivaviyutta,1,1,0,0,10
51016,munindānana,munindanana,4,1,3,0,11
51017,mābhāti,mabhati,4,2,2,0,7
51018,vilāsekamanoharaṃ,vilasekamanoharam,3,0,3,0,17
51019,samuggatassā,samuggatassa,1,0,1,0,12
51020,vijambhanā,vijambhana,13,6,7,0,10
51021,samubbejeti,samubbejeti,6,1,5,0,11
51022,dhīmantaṃ,dhimantam,4,1,3,0,9
51023,bhinnaliṅgādikaṃ,bhinnalingadikam,6,4,2,0,16
51024,upamādūsanāyā,upamadusanaya,2,1,1,0,13
51025,bhinna,bhinna,8,6,2,0,6
51026,liṅgā,linga,13,9,4,0,5
51027,vijāti,vijati,2,1,1,0,6
51028,hīnā,hina,255,226,29,0,4
51029,dhipe,dhipe,2,1,1,0,5
51030,bhāṇumālī,bhanumali,1,1,0,0,9
51031,vibhāti,vibhati,15,11,4,0,7
51032,dhikopamā,dhikopama,2,0,2,0,9
51033,aphuṭṭhatthā,aphutthattha,3,0,3,0,12
51034,balambodhi,balambodhi,1,1,0,0,10
51035,saṃkhubhi,samkhubhi,2,1,1,0,9
51036,pamāpekkhinī,pamapekkhini,2,0,2,0,12
51037,khaṇḍitā,khandita,10,6,4,0,8
51038,keravā,kerava,1,1,0,0,6
51039,sakalaṅko,sakalanko,4,1,3,0,9
51040,iccevamādirūpesu,iccevamadirupesu,2,1,1,0,16
51041,de,de,7,4,3,0,2
51042,itthīyaṃ,itthiyam,1,0,1,0,8
51043,vadatye,vadatye,1,0,1,0,7
51044,pāṇā,pana,260,243,17,0,4
51045,ivā,iva,17,12,5,0,3
51046,ccitā,ccita,2,0,2,0,5
51047,mahīpāla,mahipala,3,0,3,0,8
51048,virocate,virocate,12,8,4,0,8
51049,maṃsumato,mamsumato,2,0,2,0,9
51050,rohituṃ,rohitum,3,1,2,0,7
51051,abhedassa,abhedassa,12,9,3,0,9
51052,nirūpanā,nirupana,6,3,3,0,8
51053,tirobhūta,tirobhuta,1,1,0,0,9
51054,rūpaka,rupaka,3,0,3,0,6
51055,asesa,asesa,5,3,2,0,5
51056,ekadesa,ekadesa,4,1,3,0,7
51057,vivutti,vivutti,1,0,1,0,7
51058,vivatti,vivatti,1,1,0,0,7
51059,samāsādivasā,samasadivasa,4,1,3,0,12
51060,asesavatthuvisayasamāsa,asesavatthuvisayasamasa,2,2,0,0,23
51061,aṅgulidala,angulidala,1,1,0,0,10
51062,saṃsobhiṃ,samsobhim,3,2,1,0,9
51063,nakhadīdhiti,nakhadidhiti,2,2,0,0,12
51064,kesaraṃ,kesaram,18,16,2,0,7
51065,pilandhanti,pilandhanti,1,1,0,0,11
51066,asesavatthuvisayaasamāsa,asesavatthuvisayaasamasa,2,2,0,0,24
51067,gambhīratta,gambhiratta,3,2,1,0,11
51068,magādhattaṃ,magadhattam,1,1,0,0,11
51069,mbudhi,mbudhi,2,1,1,0,6
51070,asesavatthuvisayamissaka,asesavatthuvisayamissaka,2,2,0,0,24
51071,mandahāsā,mandahasa,6,4,2,0,9
51072,nduno,nduno,2,2,0,0,5
51073,pabodhayatya,pabodhayatya,2,1,1,0,12
51074,kumuda,kumuda,4,3,1,0,6
51075,asesavatthuvisaye,asesavatthuvisaye,3,1,2,0,17
51076,pabhedo,pabhedo,113,99,14,0,7
51077,rūpake,rupake,7,6,1,0,6
51078,ekadesavivuttimhi,ekadesavivuttimhi,1,0,1,0,17
51079,pavuccati,pavuccati,431,420,11,0,9
51080,ekadesavivuttisamāsa,ekadesavivuttisamasa,1,1,0,0,20
51081,pallavaṃ,pallavam,9,9,0,0,8
51082,ekadesavivuttiasamāsa,ekadesavivuttiasamasa,1,1,0,0,21
51083,pādadvandaṃ,padadvandam,5,3,2,0,11
51084,vijayaṃ,vijayam,10,7,3,0,7
51085,nakharaṃsī,nakharamsi,4,2,2,0,10
51086,pāpajayaddhajā,papajayaddhaja,3,1,2,0,14
51087,ekadesavivuttimissaka,ekadesavivuttimissaka,1,1,0,0,21
51088,sunimmalakapolassa,sunimmalakapolassa,3,2,1,0,18
51089,ppabuddha,ppabuddha,1,1,0,0,9
51090,kerava,kerava,1,1,0,0,6
51091,rūpakāni,rupakani,13,9,4,0,8
51092,bahūnye,bahunye,1,1,0,0,7
51093,ṭīkāyaṃ,tikayam,80,41,39,0,7
51094,uddhaṭaṃ,uddhatam,103,98,5,0,8
51095,yuttarūpakaṃ,yuttarupakam,3,3,0,0,12
51096,sitapupphujalaṃ,sitapupphujalam,1,1,0,0,15
51097,nettabhiṅga,nettabhinga,1,1,0,0,11
51098,nākaḍḍhati,nakaddhati,10,10,0,0,10
51099,yuttādi,yuttadi,1,0,1,0,7
51100,etthe,etthe,5,4,1,0,5
51101,ntogadhāni,ntogadhani,2,1,1,0,10
51102,kāsapaduma,kasapaduma,1,1,0,0,10
51103,miccetaṃ,miccetam,2,2,0,0,8
51104,khaṇḍarūpakaṃ,khandarupakam,5,2,3,0,13
51105,duṭṭha,duttha,12,10,2,0,6
51106,mamboruhavanaṃ,mamboruhavanam,1,1,0,0,14
51107,ccā,cca,1,1,0,0,3
51108,vikappānaṃ,vikappanam,17,12,5,0,10
51109,rūpakasso,rupakasso,2,1,1,0,9
51110,pamāya,pamaya,21,16,5,0,6
51111,avutta,avutta,3,1,2,0,6
51112,manumānato,manumanato,2,1,1,0,10
51113,muccāraṇaṃ,muccaranam,1,1,0,0,10
51114,yamatthassa,yamatthassa,1,1,0,0,11
51115,ubhayesañca,ubhayesanca,4,3,1,0,11
51116,māvutti,mavutti,3,0,3,0,7
51117,atthāvutti,atthavutti,3,3,0,0,10
51118,nimmalattañca,nimmalattanca,3,1,2,0,13
51119,yasorāsi,yasorasi,4,3,1,0,8
51120,padāvutti,padavutti,5,5,0,0,9
51121,vibhāsenti,vibhasenti,6,0,6,0,10
51122,dehakantiyo,dehakantiyo,4,3,1,0,11
51123,vibhā,vibha,11,7,4,0,5
51124,hatā,hata,118,106,12,0,4
51125,ubhayāvutti,ubhayavutti,4,4,0,0,11
51126,jitvā,jitva,13,10,3,0,5
51127,klesa,klesa,1,1,0,0,5
51128,viharatya,viharatya,1,0,1,0,9
51129,rivaggo,rivaggo,2,1,1,0,7
51130,vattamānampi,vattamanampi,11,8,3,0,12
51131,sabbavākyo,sabbavakyo,1,1,0,0,10
51132,pakārakaṃ,pakarakam,2,2,0,0,9
51133,cādi,cadi,32,31,1,0,4
51134,ntavisayaṃ,ntavisayam,1,1,0,0,10
51135,dīpaka,dipaka,2,2,0,0,6
51136,veneyya,veneyya,6,6,0,0,7
51137,bandhūna,bandhuna,1,1,0,0,8
51138,mamito,mamito,1,1,0,0,6
51139,nekatitthiyamaddanaṃ,nekatitthiyamaddanam,1,1,0,0,20
51140,tada,tada,13,11,2,0,4
51141,ññesaṃ,nnesam,2,2,0,0,6
51142,patāpanaṃ,patapanam,4,4,0,0,9
51143,antadīpaka,antadipaka,2,2,0,0,10
51144,lāvaṇya,lavanya,1,1,0,0,7
51145,candā,canda,39,38,1,0,5
51146,nani,nani,1,1,0,0,4
51147,mālādīpaka,maladipaka,2,2,0,0,10
51148,vippaṭisārāya,vippatisaraya,20,19,1,0,13
51149,pāmojjahetu,pamojjahetu,3,1,2,0,11
51150,pītihetu,pitihetu,3,1,2,0,8
51151,passaddhyā,passaddhya,1,1,0,0,10
51152,pasiddhiyā,pasiddhiya,9,8,1,0,10
51153,iccā,icca,11,9,2,0,4
51154,didīpakattepi,didipakattepi,2,1,1,0,13
51155,mapekkhinī,mapekkhini,1,1,0,0,10
51156,vākyamālā,vakyamala,3,1,2,0,9
51157,pavattāti,pavattati,139,129,10,0,9
51158,mālādīpakaṃ,maladipakam,5,3,2,0,11
51159,anene,anene,2,2,0,0,5
51160,ppakārena,ppakarena,1,1,0,0,9
51161,sesāna,sesana,2,1,1,0,6
51162,mapi,mapi,15,13,2,0,4
51163,vidhātabbā,vidhatabba,5,3,2,0,10
51164,nugati,nugati,1,1,0,0,6
51165,suddhabuddhibhi,suddhabuddhibhi,4,1,3,0,15
51166,vacani,vacani,1,1,0,0,6
51167,cchāyaṃ,cchayam,6,5,1,0,7
51168,nisedhavacanaṃ,nisedhavacanam,3,1,2,0,14
51169,soyañca,soyanca,1,1,0,0,7
51170,kālappabhedato,kalappabhedato,4,1,3,0,14
51171,nekasenaṃ,nekasenam,2,1,1,0,9
51172,mathavā,mathava,3,3,0,0,7
51173,pāramībala,paramibala,1,1,0,0,10
51174,atītakkhepo,atitakkhepo,3,3,0,0,11
51175,jāsamugghātaṃ,jasamugghatam,2,1,1,0,13
51176,apatto,apatto,28,27,1,0,6
51177,smīti,smiti,2,2,0,0,5
51178,khijjase,khijjase,5,4,1,0,8
51179,sakimpi,sakimpi,81,73,8,0,7
51180,sugate,sugate,173,170,3,0,6
51181,vattamānakkhepo,vattamanakkhepo,4,4,0,0,15
51182,gamissanti,gamissanti,170,159,11,0,10
51183,sujanagocaraṃ,sujanagocaram,4,2,2,0,13
51184,parikkanta,parikkanta,1,1,0,0,10
51185,parikanta,parikanta,1,1,0,0,9
51186,sudujjanā,sudujjana,3,2,1,0,9
51187,anāgatakkhepo,anagatakkhepo,4,4,0,0,13
51188,atthantaranyāso,atthantaranyaso,12,11,1,0,15
51189,ññavākyatthasādhano,nnavakyatthasadhano,2,1,1,0,19
51190,sabbabyāpī,sabbabyapi,10,8,2,0,10
51191,visesaṭṭho,visesattho,8,6,2,0,10
51192,hivisiṭṭha,hivisittha,2,1,1,0,10
51193,rahita,rahita,2,2,0,0,6
51194,lokahitā,lokahita,2,2,0,0,8
51195,laṅghyate,langhyate,4,1,3,0,9
51196,sassatā,sassata,81,76,5,0,7
51197,visesaṭṭha,visesattha,2,2,0,0,10
51198,saṃsārakantārā,samsarakantara,7,7,0,0,14
51199,pāpesi,papesi,84,83,1,0,6
51200,vesārajja,vesarajja,1,1,0,0,9
51201,samaṅginaṃ,samanginam,2,2,0,0,10
51202,surattaṃ,surattam,18,13,5,0,8
51203,dharaphuṭaṃ,dharaphutam,1,1,0,0,11
51204,rāgaparītā,ragaparita,3,1,2,0,10
51205,rañjenti,ranjenti,5,3,2,0,8
51206,vācce,vacce,9,4,5,0,5
51207,gamme,gamme,7,4,3,0,5
51208,sadisatte,sadisatte,18,15,3,0,9
51209,pabhedanaṃ,pabhedanam,31,19,12,0,10
51210,mapye,mapye,3,2,1,0,5
51211,bhayabhedā,bhayabheda,2,1,1,0,10
51212,vāccaekabyatireka,vaccaekabyatireka,2,2,0,0,17
51213,mahattādi,mahattadi,1,1,0,0,9
51214,jaladhinā,jaladhina,4,2,2,0,9
51215,sarīrene,sarirene,2,1,1,0,8
51216,disena,disena,2,1,1,0,6
51217,vācca,vacca,1,1,0,0,5
51218,ubhayabyatireka,ubhayabyatireka,1,1,0,0,15
51219,mahāsattā,mahasatta,18,16,2,0,9
51220,tigambhīrā,tigambhira,2,1,1,0,10
51221,sugatopi,sugatopi,7,6,1,0,8
51222,ñjanasaṅkāso,njanasankaso,2,1,1,0,12
51223,cāmīkarajjuti,camikarajjuti,4,1,3,0,13
51224,gamma,gamma,23,23,0,0,5
51225,ekabyatireka,ekabyatireka,1,1,0,0,12
51226,santāpāpahaṃ,santapapaham,4,1,3,0,12
51227,nevi,nevi,4,3,1,0,4
51228,cchitadaṃ,cchitadam,1,1,0,0,9
51229,migalocanaṃ,migalocanam,3,1,2,0,11
51230,nayanadvandaṃ,nayanadvandam,3,2,1,0,13
51231,tagguṇa,tagguna,1,1,0,0,7
51232,bhūsitaṃ,bhusitam,9,9,0,0,8
51233,gammaubhayabyatireka,gammaubhayabyatireka,2,2,0,0,20
51234,mambhoja,mambhoja,1,1,0,0,8
51235,nānatta,nanatta,4,2,2,0,7
51236,suvuttā,suvutta,12,8,4,0,7
51237,matasandāyī,matasandayi,2,2,0,0,11
51238,nivattetvā,nivattetva,148,140,8,0,10
51239,ñākāraṇaṃ,nakaranam,1,1,0,0,9
51240,sābhāvikatta,sabhavikatta,2,1,1,0,12
51241,vibhābyaṃ,vibhabyam,5,2,3,0,9
51242,kāraṇantaravibhāvanā,karanantaravibhavana,5,5,0,0,20
51243,anañjitā,ananjita,2,0,2,0,8
51244,rañjitā,ranjita,7,5,2,0,7
51245,ruṇo,runo,3,1,2,0,4
51246,samānatā,samanata,14,9,5,0,8
51247,nāvañcitā,navancita,1,0,1,0,9
51248,sābhāvika,sabhavika,1,1,0,0,9
51249,dujjanya,dujjanya,2,2,0,0,8
51250,dujjanasaṅgame,dujjanasangame,3,1,2,0,14
51251,sabhāvanimmalatare,sabhavanimmalatare,4,2,2,0,18
51252,sādhujantūna,sadhujantuna,2,1,1,0,12
51253,ñāpako,napako,24,21,3,0,6
51254,hetavo,hetavo,52,44,8,0,6
51255,paṭisaṅkharaṇaṃ,patisankharanam,14,8,6,0,15
51256,alaṅkāratāyo,alankaratayo,1,1,0,0,12
51257,ditaṃ,ditam,7,6,1,0,5
51258,bhāvā,bhava,72,59,13,0,5
51259,kiccavasā,kiccavasa,1,1,0,0,9
51260,cittahetuvasāpi,cittahetuvasapi,3,1,2,0,15
51261,nantā,nanta,6,5,1,0,5
51262,mukhamatta,mukhamatta,1,1,0,0,10
51263,para254,para254,114,114,0,0,7
51264,paramatthapakāse,paramatthapakase,1,1,0,0,16
51265,sabbamanoharā,sabbamanohara,4,1,3,0,13
51266,bhāvakicco,bhavakicco,8,7,1,0,10
51267,kārakahetu,karakahetu,10,8,2,0,10
51268,para255,para255,116,116,0,0,7
51269,dhīrehi,dhirehi,22,14,8,0,7
51270,saṃvāsā,samvasa,15,12,3,0,7
51271,saddhammassā,saddhammassa,2,1,1,0,12
51272,bhiyogato,bhiyogato,3,2,1,0,9
51273,niggaheni,niggaheni,2,1,1,0,9
51274,ndriyānañca,ndriyananca,2,1,1,0,11
51275,dukkhassu,dukkhassu,2,1,1,0,9
51276,pasamo,pasamo,3,2,1,0,6
51277,abhāvakicco,abhavakicco,4,3,1,0,11
51278,saṃvādi,samvadi,1,1,0,0,7
51279,kantabhāvo,kantabhavo,2,2,0,0,10
51280,pasobhinā,pasobhina,1,1,0,0,9
51281,mukhene,mukhene,1,1,0,0,7
51282,bhinissaṭaṃ,bhinissatam,1,1,0,0,11
51283,ñāpakahetu,napakahetu,13,13,0,0,10
51284,sādhuhatthā,sadhuhattha,1,1,0,0,11
51285,ravindāni,ravindani,2,2,0,0,9
51286,saṅkocayati,sankocayati,3,1,2,0,11
51287,caraṇadvanda,caranadvanda,2,2,0,0,12
51288,rāgabālā,ragabala,1,1,0,0,8
51289,phusaṃ,phusam,13,8,5,0,6
51290,ayuttakārī,ayuttakari,6,6,0,0,10
51291,cittahetu,cittahetu,8,8,0,0,9
51292,saṅkocayanti,sankocayanti,6,3,3,0,12
51293,pāṇipaṅkeruhāni,panipankeruhani,3,2,1,0,15
51294,candāna,candana,1,1,0,0,7
51295,maṃsavo,mamsavo,2,1,1,0,7
51296,yuttakārī,yuttakari,6,6,0,0,9
51297,uddiṭṭhānaṃ,udditthanam,22,19,3,0,11
51298,anuddeso,anuddeso,12,9,3,0,8
51299,saṅkhyāna,sankhyana,4,2,2,0,9
51300,ālāpa,alapa,2,1,1,0,5
51301,līḷāhi,lilahi,1,0,1,0,6
51302,vijayā,vijaya,15,11,4,0,6
51303,pasevante,pasevante,2,1,1,0,9
51304,attharūpassa,attharupassa,4,1,3,0,12
51305,piyassā,piyassa,2,1,1,0,7
51306,tisayene,tisayene,2,1,1,0,8
51307,paṭipādanaṃ,patipadanam,20,16,4,0,11
51308,samuppannā,samuppanna,44,42,2,0,10
51309,sandassanā,sandassana,12,8,4,0,10
51310,kālenā,kalena,17,8,9,0,6
51311,vaṇṇiteno,vanniteno,2,1,1,0,9
51312,pamānena,pamanena,2,1,1,0,8
51313,vutyā,vutya,4,1,3,0,5
51314,dhippeta,dhippeta,1,1,0,0,8
51315,samāsavutti,samasavutti,11,9,2,0,11
51316,rūpato,rupato,88,76,12,0,6
51317,visesyamattena,visesyamattena,4,2,2,0,14
51318,bhinnavisesanā,bhinnavisesana,3,0,3,0,14
51319,abhinnavisesana,abhinnavisesana,2,2,0,0,15
51320,visuddhā,visuddha,40,39,1,0,8
51321,pasattharatanā,pasattharatana,1,1,0,0,14
51322,mambodhi,mambodhi,1,1,0,0,8
51323,pādito,padito,21,18,3,0,6
51324,bhinnābhinnavisesana,bhinnabhinnavisesana,2,2,0,0,20
51325,icchita,icchita,6,5,1,0,7
51326,tthapado,tthapado,1,1,0,0,8
51327,phalapuppho,phalapuppho,1,1,0,0,11
51328,pasobhito,pasobhito,3,3,0,0,9
51329,sacchāyo,sacchayo,6,2,4,0,8
51330,mapubbova,mapubbova,3,1,2,0,9
51331,samuṭṭhito,samutthito,48,45,3,0,10
51332,sāgarattena,sagarattena,4,1,3,0,11
51333,saddhammo,saddhammo,155,145,10,0,9
51334,rukkhatteno,rukkhatteno,2,1,1,0,11
51335,pubbatrā,pubbatra,2,1,1,0,8
51336,ttayaṃ,ttayam,7,6,1,0,6
51337,ññappakārena,nnappakarena,2,1,1,0,12
51338,parikappīyate,parikappiyate,8,7,1,0,13
51339,bbhantarattena,bbhantarattena,1,1,0,0,14
51340,kiriyādivasena,kiriyadivasena,4,3,1,0,14
51341,kameno,kameno,2,1,1,0,6
51342,dāharissāmi,daharissami,2,1,1,0,11
51343,upamābbhantaraparikappanā,upamabbhantaraparikappana,3,3,0,0,25
51344,icchābhaṅgā,icchabhanga,1,1,0,0,11
51345,turā,tura,4,3,1,0,4
51346,sīnā,sina,2,1,1,0,4
51347,tiniccala,tiniccala,2,1,1,0,9
51348,maccharā,macchara,3,2,1,0,8
51349,nenti,nenti,52,51,1,0,5
51350,kriyāparikappanā,kriyaparikappana,4,4,0,0,16
51351,gajaṃ,gajam,31,27,4,0,5
51352,samāruḷho,samarulho,20,15,5,0,9
51353,ccanta,ccanta,2,1,1,0,6
51354,munnataṃ,munnatam,2,1,1,0,8
51355,manvesatī,manvesati,1,1,0,0,9
51356,jinabhīto,jinabhito,2,1,1,0,9
51357,palāyituṃ,palayitum,70,67,3,0,9
51358,guṇaparikappanā,gunaparikappana,4,4,0,0,15
51359,pādadvande,padadvande,5,4,1,0,10
51360,rājiva,rajiva,1,1,0,0,6
51361,sammadda,sammadda,1,1,0,0,8
51362,jātasoṇena,jatasonena,1,1,0,0,10
51363,soṇimā,sonima,4,1,3,0,6
51364,saṅke,sanke,8,7,1,0,5
51365,micceva,micceva,47,47,0,0,7
51366,mādihi,madihi,1,1,0,0,6
51367,byañjīyate,byanjiyate,4,1,3,0,10
51368,vākyena,vakyena,45,42,3,0,7
51369,gammaparikappanā,gammaparikappana,2,2,0,0,16
51370,para274,para274,114,114,0,0,7
51371,sarasā,sarasa,5,5,0,0,6
51372,nikkhantakantiyo,nikkhantakantiyo,4,2,2,0,16
51373,pīṇentā,pinenta,4,2,2,0,7
51374,sarasataṃ,sarasatam,6,3,3,0,9
51375,nayuṃ,nayum,11,8,3,0,5
51376,para275,para275,96,96,0,0,7
51377,ārabbhantassa,arabbhantassa,1,1,0,0,13
51378,puññavasā,punnavasa,4,1,3,0,9
51379,sādhana,sadhana,5,5,0,0,7
51380,ntaralābho,ntaralabho,1,1,0,0,10
51381,ribhaṅgā,ribhanga,1,0,1,0,8
51382,bhimukha,bhimukha,1,0,1,0,8
51383,satthuno,satthuno,537,523,14,0,8
51384,mahāmahī,mahamahi,17,14,3,0,8
51385,mahāravaṃ,maharavam,23,22,1,0,9
51386,mupakārikā,mupakarika,2,0,2,0,10
51387,avatvā,avatva,868,854,14,0,6
51388,siddhiyā,siddhiya,33,30,3,0,8
51389,dassana,dassana,23,18,5,0,7
51390,vuttī,vutti,10,8,2,0,5
51391,sucibuddhayo,sucibuddhayo,4,3,1,0,12
51392,vivaṭa,vivata,3,1,2,0,6
51393,ṅgaṇanikkhittaṃ,ngananikkhittam,1,0,1,0,15
51394,mārakkha,marakkha,1,0,1,0,8
51395,dhanakāma,dhanakama,3,0,3,0,9
51396,yathākāmaṃ,yathakamam,80,74,6,0,10
51397,tuvaṃ,tuvam,765,691,74,0,5
51398,yadicchasi,yadicchasi,12,11,1,0,10
51399,para279,para279,111,111,0,0,7
51400,thutiṃ,thutim,78,74,4,0,6
51401,nindanto,nindanto,19,16,3,0,8
51402,byājavaṇṇanaṃ,byajavannanam,6,4,2,0,13
51403,para280,para280,113,113,0,0,7
51404,sañcāletu,sancaletu,4,0,4,0,9
51405,kuvalayā,kuvalaya,2,0,2,0,8
51406,visesi,visesi,32,18,14,0,6
51407,vekalladassanaṃ,vekalladassanam,3,1,2,0,15
51408,para282,para282,107,107,0,0,7
51409,mātaṅgā,matanga,30,27,3,0,7
51410,padātayo,padatayo,4,3,1,0,8
51411,sambhārāvajjanena,sambharavajjanena,3,1,2,0,17
51412,dabbavisesavutti,dabbavisesavutti,4,3,1,0,16
51413,para283,para283,104,104,0,0,7
51414,bhūkuṭi,bhukuti,3,1,2,0,7
51415,phurito,phurito,4,1,3,0,7
51416,mārāribhaṅgaṃ,mararibhangam,1,1,0,0,13
51417,kāsi,kasi,107,104,3,0,4
51418,kriyāvisesavutti,kriyavisesavutti,3,2,1,0,16
51419,byāttā,byatta,1,1,0,0,6
51420,lokapatthaṭo,lokapatthato,3,1,2,0,12
51421,tathāpya,tathapya,2,1,1,0,8
51422,ndhatamaharaṃ,ndhatamaharam,2,1,1,0,13
51423,sādhusubhāsitaṃ,sadhusubhasitam,4,2,2,0,15
51424,jātivisesavutti,jativisesavutti,3,2,1,0,15
51425,gāḷhaṃ,galham,112,98,14,0,6
51426,khaṇati,khanati,68,63,5,0,7
51427,nimmūlaṃ,nimmulam,6,4,2,0,8
51428,janatāmadaṃ,janatamadam,3,1,2,0,11
51429,guṇavisesavutti,gunavisesavutti,3,2,1,0,15
51430,para286,para286,99,99,0,0,7
51431,tirittaṃ,tirittam,2,2,0,0,8
51432,sūravīrattanaṃ,suravirattanam,3,1,2,0,14
51433,viññūvacanaṃ,vinnuvacanam,2,2,0,0,12
51434,ruḷhāhaṅkāra,rulhahankara,1,0,1,0,12
51435,para287,para287,99,99,0,0,7
51436,nandopanandassa,nandopanandassa,13,10,3,0,15
51437,byāpāradassanā,byaparadassana,4,0,4,0,14
51438,pādasambhattā,padasambhatta,4,0,4,0,13
51439,nekā,neka,12,10,2,0,4
51440,bhidheyye,bhidheyye,8,7,1,0,9
51441,kapadāyutaṃ,kapadayutam,2,1,1,0,11
51442,abhinnapadavākyādi,abhinnapadavakyadi,2,1,1,0,18
51443,tedhā,tedha,11,9,2,0,5
51444,mīrito,mirito,12,8,4,0,6
51445,andhatamaharo,andhatamaharo,1,1,0,0,13
51446,mahodayaṃ,mahodayam,7,3,4,0,9
51447,bodhayaṃ,bodhayam,7,4,3,0,8
51448,abhinnapadavākyasileso,abhinnapadavakyasileso,4,2,2,0,22
51449,sāradā,sarada,3,3,0,0,6
51450,malakā,malaka,1,1,0,0,6
51451,bhāso,bhaso,5,5,0,0,5
51452,samānīta,samanita,1,1,0,0,8
51453,parikkhayo,parikkhayo,20,18,2,0,10
51454,kumudā,kumuda,10,10,0,0,6
51455,karasambodho,karasambodho,1,1,0,0,12
51456,bhinnapadavākyasileso,bhinnapadavakyasileso,5,3,2,0,21
51457,ttavinayo,ttavinayo,1,1,0,0,9
51458,ahīna,ahina,1,1,0,0,5
51459,maddano,maddano,2,2,0,0,7
51460,visadaṃ,visadam,59,52,7,0,7
51461,bhinnābhinnapadavākyasileso,bhinnabhinnapadavakyasileso,3,2,1,0,27
51462,para292,para292,84,84,0,0,7
51463,viruddhā,viruddha,44,43,1,0,8
51464,kammā,kamma,57,55,2,0,5
51465,niyamavā,niyamava,4,2,2,0,8
51466,niyama,niyama,3,3,0,0,6
51467,kkhepavacano,kkhepavacano,1,1,0,0,12
51468,avirodhi,avirodhi,2,1,1,0,8
51469,virodhya,virodhya,2,1,1,0,8
51470,para293,para293,98,98,0,0,7
51471,ocitya,ocitya,2,1,1,0,6
51472,samposakādi,samposakadi,1,1,0,0,11
51473,padajā,padaja,1,1,0,0,6
51474,padajāti,padajati,1,1,0,0,8
51475,nidassanesve,nidassanesve,1,1,0,0,12
51476,viruddhakammasilesa,viruddhakammasilesa,2,2,0,0,19
51477,savase,savase,13,8,5,0,6
51478,vattayaṃ,vattayam,5,3,2,0,8
51479,kallaviggaho,kallaviggaho,3,1,2,0,12
51480,parābhavati,parabhavati,9,6,3,0,11
51481,vijambhate,vijambhate,6,2,4,0,10
51482,aviruddhakammasilesa,aviruddhakammasilesa,2,2,0,0,20
51483,sabhāvamadhuraṃ,sabhavamadhuram,4,2,2,0,15
51484,passanti,passanti,551,542,9,0,8
51485,abhinnakammasilesa,abhinnakammasilesa,2,2,0,0,18
51486,andhakārā,andhakara,31,26,5,0,9
51487,pahārāya,paharaya,1,1,0,0,8
51488,madhurāya,madhuraya,10,10,0,0,9
51489,bhāya,bhaya,10,8,2,0,5
51490,niyamavantasilesa,niyamavantasilesa,2,2,0,0,17
51491,kkhīnaṃ,kkhinam,1,1,0,0,7
51492,kaṇhattaṃ,kanhattam,6,5,1,0,9
51493,bhamūnaṃyeva,bhamunamyeva,3,3,0,0,12
51494,vaṅkatā,vankata,13,12,1,0,7
51495,pāṇipādā,panipada,2,2,0,0,8
51496,dharānaṃ,dharanam,1,1,0,0,8
51497,munindassā,munindassa,3,2,1,0,10
51498,bhirattatā,bhirattata,1,1,0,0,10
51499,niyamakkhepasilesa,niyamakkhepasilesa,2,2,0,0,18
51500,dharesve,dharesve,1,1,0,0,8
51501,sārāgo,sarago,204,196,8,0,6
51502,sādhuguṇesva,sadhugunesva,1,1,0,0,12
51503,avirodhisilesa,avirodhisilesa,2,2,0,0,14
51504,salakkhaṇo,salakkhano,9,4,5,0,10
51505,tisubhago,tisubhago,2,1,1,0,9
51506,niyato,niyato,304,287,17,0,6
51507,jitasaṃkleso,jitasamkleso,3,1,2,0,12
51508,samaṇissaro,samanissaro,8,6,2,0,11
51509,virodhisilesa,virodhisilesa,2,2,0,0,13
51510,asamopi,asamopi,4,1,3,0,7
51511,lokesopi,lokesopi,3,1,2,0,8
51512,sadayo,sadayo,3,1,2,0,6
51513,ocityasamposakapadasilesa,ocityasamposakapadasilesa,2,2,0,0,25
51514,saṃsāradukkho,samsaradukkho,1,1,0,0,13
51515,pahatā,pahata,11,11,0,0,6
51516,micchita,micchita,3,2,1,0,8
51517,maccantaṃ,maccantam,7,6,1,0,9
51518,guṇayuttehi,gunayuttehi,4,1,3,0,11
51519,saṃkittanaṃ,samkittanam,4,2,2,0,11
51520,sampattasammado,sampattasammado,3,0,3,0,15
51521,sampattā,sampatta,99,95,4,0,8
51522,lokasampado,lokasampado,1,0,1,0,11
51523,sādhayatā,sadhayata,4,1,3,0,9
51524,asantaṃ,asantam,255,227,28,0,7
51525,asantaphalanidassana,asantaphalanidassana,2,2,0,0,20
51526,udayā,udaya,23,16,7,0,5
51527,samaṇindassa,samanindassa,5,2,3,0,12
51528,parābhavaṃ,parabhavam,8,4,4,0,10
51529,dhammarājaviruddhānaṃ,dhammarajaviruddhanam,3,1,2,0,21
51530,sūcayantā,sucayanta,3,1,2,0,9
51531,dura,dura,2,2,0,0,4
51532,ntataṃ,ntatam,1,1,0,0,6
51533,santaphalanidassana,santaphalanidassana,2,2,0,0,19
51534,cchariyāna,cchariyana,3,2,1,0,10
51535,mbujāna,mbujana,2,1,1,0,7
51536,bbhutataṃ,bbhutatam,1,1,0,0,9
51537,viññāpeta,vinnapeta,2,1,1,0,9
51538,ttano,ttano,19,18,1,0,5
51539,adhippāyassa,adhippayassa,28,25,3,0,12
51540,paramukkaṃsataṃ,paramukkamsatam,6,3,3,0,15
51541,yātaṃ,yatam,28,23,5,0,5
51542,mahantatta,mahantatta,2,0,2,0,10
51543,vibhūtimahantatta,vibhutimahantatta,2,2,0,0,17
51544,kirīṭa,kirita,4,3,1,0,6
51545,cchāyā,cchaya,1,1,0,0,6
51546,nuviddhā,nuviddha,1,1,0,0,8
51547,vindi,vindi,11,8,3,0,5
51548,bhinikkhamā,bhinikkhama,2,1,1,0,11
51549,adhippāyamahantatta,adhippayamahantatta,2,2,0,0,19
51550,sambodhiyaṃ,sambodhiyam,46,39,7,0,11
51551,sattahitāya,sattahitaya,9,7,2,0,11
51552,sneharasābandha,sneharasabandha,1,1,0,0,15
51553,rāhulamātaraṃ,rahulamataram,8,5,3,0,13
51554,gopetvā,gopetva,36,31,5,0,7
51555,vaṇṇanīyaṃ,vannaniyam,7,4,3,0,10
51556,asamavañcanā,asamavancana,3,3,0,0,12
51557,sahassesu,sahassesu,23,20,3,0,9
51558,pañcesu,pancesu,4,1,3,0,7
51559,paresu,paresu,242,235,7,0,6
51560,dasavaḍḍhitaṃ,dasavaddhitam,4,1,3,0,13
51561,samavañcanā,samavancana,3,3,0,0,11
51562,vivāda,vivada,5,2,3,0,6
51563,manuyuñjanto,manuyunjanto,2,1,1,0,12
51564,munindavadani,munindavadani,1,1,0,0,13
51565,chatta,chatta,8,6,2,0,6
51566,manobhuno,manobhuno,9,4,5,0,9
51567,parānuvattanādīhi,paranuvattanadihi,3,1,2,0,17
51568,nibbindeni,nibbindeni,2,1,1,0,10
51569,ppakate,ppakate,2,1,1,0,7
51570,appakatatthuti,appakatatthuti,4,2,2,0,14
51571,hariṇā,harina,4,1,3,0,6
51572,vanesva,vanesva,2,0,2,0,7
51573,parasevino,parasevino,2,0,2,0,10
51574,anāyāso,anayaso,4,3,1,0,7
51575,palābhehi,palabhehi,2,1,1,0,9
51576,jaladabbhaṅkurādibhi,jaladabbhankuradibhi,1,0,1,0,20
51577,pubbapubbavisesanaṃ,pubbapubbavisesanam,3,1,2,0,19
51578,nisedhato,nisedhato,3,3,0,0,9
51579,vidhiekāvali,vidhiekavali,4,4,0,0,12
51580,nakhāli,nakhali,2,2,0,0,7
51581,bhāsurā,bhasura,12,10,2,0,7
51582,raṃsītamopahāne,ramsitamopahane,1,1,0,0,15
51583,nisedhaekāvali,nisedhaekavali,4,4,0,0,14
51584,asantuṭṭho,asantuttho,86,80,6,0,10
51585,layāhato,layahato,2,1,1,0,8
51586,bhūsiya,bhusiya,2,2,0,0,7
51587,bhūsattaṃ,bhusattam,1,1,0,0,9
51588,vatthunaṃ,vatthunam,4,2,2,0,9
51589,sadisattaṃ,sadisattam,22,21,1,0,10
51590,aññamaññavibhūsanaṃ,annamannavibhusanam,3,1,2,0,19
51591,para319,para319,93,93,0,0,7
51592,byāmaṃ,byamam,6,5,1,0,6
51593,lokabandhunā,lokabandhuna,3,1,2,0,12
51594,mahantiṃ,mahantim,8,5,3,0,8
51595,vindatī,vindati,23,14,9,0,7
51596,tādisiṃ,tadisim,11,9,2,0,7
51597,para320,para320,96,96,0,0,7
51598,sahabhāvassa,sahabhavassa,8,6,2,0,12
51599,sahavuttī,sahavutti,1,0,1,0,9
51600,dudāharaṇaṃ,dudaharanam,1,1,0,0,11
51601,kriyāsahavutti,kriyasahavutti,4,4,0,0,14
51602,candaraṃsīhi,candaramsihi,3,3,0,0,12
51603,nakhaṃ,nakham,19,18,1,0,6
51604,savo,savo,4,4,0,0,4
51605,candena,candena,18,17,1,0,7
51606,tammukhacandimā,tammukhacandima,3,2,1,0,15
51607,guṇasahavutti,gunasahavutti,4,4,0,0,13
51608,dayena,dayena,2,2,0,0,6
51609,malīnaṃ,malinam,13,13,0,0,7
51610,dujjana,dujjana,3,3,0,0,7
51611,suvimalā,suvimala,4,1,3,0,8
51612,sajjana,sajjana,1,1,0,0,7
51613,virodhīnaṃ,virodhinam,5,2,3,0,10
51614,tthānaṃ,tthanam,2,2,0,0,7
51615,saṃsaggadassanaṃ,samsaggadassanam,3,1,2,0,16
51616,samukkaṃsā,samukkamsa,1,1,0,0,10
51617,bhidhānatthaṃ,bhidhanattham,1,1,0,0,13
51618,bandhuno,bandhuno,2,1,1,0,8
51619,sevitā,sevita,12,8,4,0,6
51620,pāpa,papa,31,23,8,0,4
51621,sevīnaṃ,sevinam,1,0,1,0,7
51622,sampadūsenti,sampadusenti,4,0,4,0,12
51623,dānena,danena,236,224,12,0,6
51624,visiṭṭhassa,visitthassa,31,29,2,0,11
51625,mādānaṃ,madanam,2,1,1,0,7
51626,parivuttī,parivutti,1,0,1,0,9
51627,nayanādikaṃ,nayanadikam,3,1,2,0,11
51628,samanuppattā,samanuppatta,4,2,2,0,12
51629,sabbaññutāsirī,sabbannutasiri,3,0,3,0,14
51630,samanuppatto,samanuppatto,2,2,0,0,12
51631,sabbaññutāsiriṃ,sabbannutasirim,2,2,0,0,15
51632,viññātā,vinnata,67,62,5,0,7
51633,taṃsamaṃ,tamsamam,6,2,4,0,8
51634,saṃsayā,samsaya,2,2,0,0,7
51635,pagataṃ,pagatam,2,2,0,0,7
51636,para328,para328,101,101,0,0,7
51637,jjalāsu,jjalasu,2,0,2,0,7
51638,sunā,suna,6,5,1,0,4
51639,abhinandanti,abhinandanti,69,64,5,0,12
51640,manā,mana,33,30,3,0,4
51641,para329,para329,104,104,0,0,7
51642,pavuccate,pavuccate,47,42,5,0,9
51643,nāmādi,namadi,8,7,1,0,6
51644,bhāvabodhanaṃ,bhavabodhanam,4,1,3,0,13
51645,sāgarā,sagara,13,9,4,0,6
51646,kulācalā,kulacala,6,2,4,0,8
51647,manampi,manampi,6,3,3,0,7
51648,mariyādaṃ,mariyadam,120,108,12,0,9
51649,saṃvaṭṭepi,samvattepi,5,1,4,0,10
51650,aṅgaṅgi,angangi,1,1,0,0,7
51651,sadisa,sadisa,17,15,2,0,6
51652,balabhāvā,balabhava,1,1,0,0,9
51653,saṃsaggo,samsaggo,71,67,4,0,8
51654,laṅkatīnaṃ,lankatinam,2,1,1,0,10
51655,missaṃ,missam,80,71,9,0,6
51656,aṅgaṅgībhāvamissa,angangibhavamissa,1,1,0,0,17
51657,nimuggepi,nimuggepi,5,4,1,0,9
51658,sukhayatye,sukhayatye,2,1,1,0,10
51659,para333,para333,94,94,0,0,7
51660,netta,netta,5,4,1,0,5
51661,rasāyanaṃ,rasayanam,9,9,0,0,9
51662,madhū,madhu,6,3,3,0,5
51663,para334,para334,100,100,0,0,7
51664,iṭṭhassā,itthassa,3,2,1,0,8
51665,sīsanaṃ,sisanam,2,1,1,0,7
51666,kagati,kagati,1,0,1,0,6
51667,mapāyato,mapayato,2,0,2,0,8
51668,ppatīti,ppatiti,1,1,0,0,7
51669,rasavantaṃ,rasavantam,13,12,1,0,10
51670,rasavanta,rasavanta,1,1,0,0,9
51671,dharāya,dharaya,7,3,4,0,7
51672,tilokagaruno,tilokagaruno,2,1,1,0,12
51673,bandharāgā,bandharaga,1,0,1,0,10
51674,niccasarasena,niccasarasena,5,2,3,0,13
51675,sañcumbayanti,sancumbayanti,4,1,3,0,13
51676,satatā,satata,2,1,1,0,6
51677,hita,hita,9,8,1,0,4
51678,sambhamena,sambhamena,1,0,1,0,10
51679,para337,para337,93,93,0,0,7
51680,nugamma,nugamma,2,1,1,0,7
51681,purimācariyā,purimacariya,1,1,0,0,12
51682,nubhāvaṃ,nubhavam,1,1,0,0,8
51683,nigadito,nigadito,4,1,3,0,8
51684,malaṅkatīnaṃ,malankatinam,4,3,1,0,12
51685,parūpari,parupari,3,2,1,0,8
51686,vikappiyānaṃ,vikappiyanam,4,1,3,0,12
51687,passitu,passitu,2,1,1,0,7
51688,tāsa,tasa,9,5,4,0,4
51689,saṅgharakkhitamahāsāmi,sangharakkhitamahasami,1,1,0,0,22
51690,viracite,viracite,31,31,0,0,8
51691,atthālaṅkārāvabodho,atthalankaravabodho,2,2,0,0,19
51692,bhāvāvabodhapañcamapariccheda,bhavavabodhapancamapariccheda,1,1,0,0,29
51693,para338,para338,96,96,0,0,7
51694,paṭibhānavatā,patibhanavata,6,1,5,0,13
51695,manusārinā,manusarina,2,2,0,0,10
51696,citya,citya,1,1,0,0,5
51697,samullāsa,samullasa,1,1,0,0,9
51698,vedinā,vedina,1,1,0,0,6
51699,kavinā,kavina,26,23,3,0,6
51700,para339,para339,96,96,0,0,7
51701,ṭhāyisambandhino,thayisambandhino,1,1,0,0,16
51702,nubhāvakā,nubhavaka,1,1,0,0,9
51703,sambajjhanti,sambajjhanti,2,2,0,0,12
51704,nibandhā,nibandha,8,4,4,0,8
51705,ssādāya,ssadaya,1,1,0,0,7
51706,sādhunaṃ,sadhunam,5,3,2,0,8
51707,bhāvaadhippāya,bhavaadhippaya,2,2,0,0,14
51708,bhāvayanti,bhavayanti,15,9,6,0,10
51709,ratyādayo,ratyadayo,12,8,4,0,9
51710,ṭhāyībhāvaadhippāya,thayibhavaadhippaya,2,2,0,0,19
51711,virodhinā,virodhina,5,2,3,0,9
51712,ññabhāvena,nnabhavena,2,1,1,0,10
51713,tirohito,tirohito,11,8,3,0,8
51714,cceso,cceso,1,1,0,0,5
51715,ṭhāyībhāvo,thayibhavo,17,15,2,0,10
51716,saddito,saddito,5,2,3,0,7
51717,ṭhāyībhāvappabhedauddesa,thayibhavappabhedauddesa,2,2,0,0,24
51718,hasso,hasso,13,10,3,0,5
51719,ssāhā,ssaha,1,1,0,0,5
51720,ṭhāyino,thayino,8,6,2,0,7
51721,byabhicārībhāvaadhippāya,byabhicaribhavaadhippaya,2,2,0,0,24
51722,tirobhāvā,tirobhava,2,1,1,0,9
51723,visesanā,visesana,3,3,0,0,8
51724,bhimukhyato,bhimukhyato,2,1,1,0,11
51725,byabhicāribhāvapabheda,byabhicaribhavapabheda,1,1,0,0,22
51726,para344,para344,109,109,0,0,7
51727,dīnatu,dinatu,1,1,0,0,6
51728,ggā,gga,4,4,0,0,3
51729,lasattaṃ,lasattam,1,1,0,0,8
51730,gilānu,gilanu,2,1,1,0,6
51731,ssuka,ssuka,1,1,0,0,5
51732,harisa,harisa,2,1,1,0,6
51733,visādā,visada,2,2,0,0,6
51734,gabbā,gabba,3,2,1,0,5
51735,pamāro,pamaro,2,1,1,0,6
51736,matu,matu,1,1,0,0,4
51737,mmāda,mmada,1,1,0,0,5
51738,vegā,vega,5,5,0,0,4
51739,sabilaṃ,sabilam,1,1,0,0,7
51740,maraṇa,marana,27,22,5,0,6
51741,capalatā,capalata,9,7,2,0,8
51742,sacapalā,sacapala,1,1,0,0,8
51743,tettiṃsa,tettimsa,145,137,8,0,8
51744,sattikabhāvaadhippāya,sattikabhavaadhippaya,1,1,0,0,21
51745,para345,para345,109,109,0,0,7
51746,ppabhavaṃ,ppabhavam,1,1,0,0,9
51747,teno,teno,5,4,1,0,4
51748,papāditā,papadita,2,1,1,0,8
51749,sattikā,sattika,3,2,1,0,7
51750,sātvikā,satvika,1,1,0,0,7
51751,nubhāvatte,nubhavatte,2,1,1,0,10
51752,sattikabhāvappabheda,sattikabhavappabheda,1,1,0,0,20
51753,paḷaya,palaya,2,2,0,0,6
51754,romañcā,romanca,5,4,1,0,7
51755,seda,seda,2,2,0,0,4
51756,ssu,ssu,19,13,6,0,3
51757,vevaṇṇiyaṃ,vevanniyam,17,14,3,0,10
51758,visaratā,visarata,1,1,0,0,8
51759,ṭṭhe,tthe,7,3,4,0,4
51760,ṭhitisīlā,thitisila,3,1,2,0,9
51761,ppattiyu,ppattiyu,2,1,1,0,8
51762,ddīpane,ddipane,2,1,1,0,7
51763,nekahetuṃ,nekahetum,4,1,3,0,9
51764,manovutti,manovutti,1,1,0,0,9
51765,visesañca,visesanca,4,4,0,0,9
51766,vibhāvituṃ,vibhavitum,6,3,3,0,10
51767,nubhāvā,nubhava,7,1,6,0,7
51768,vaṇṇiyā,vanniya,6,2,4,0,7
51769,savibhāvā,savibhava,6,4,2,0,9
51770,nubhāvehi,nubhavehi,2,2,0,0,9
51771,vaṇṇanīyā,vannaniya,11,9,2,0,9
51772,yatho,yatho,5,5,0,0,5
51773,cityaṃ,cityam,1,1,0,0,6
51774,lokarūpā,lokarupa,1,1,0,0,8
51775,nugāminā,nugamina,1,1,0,0,8
51776,visesattā,visesatta,5,4,1,0,9
51777,ṅgato,ngato,2,1,1,0,5
51778,nissaṭa,nissata,1,1,0,0,7
51779,sedādi,sedadi,3,3,0,0,6
51780,anubhāvehi,anubhavehi,12,12,0,0,10
51781,rasaadhippāya,rasaadhippaya,2,2,0,0,13
51782,sāmājikāna,samajikana,1,1,0,0,10
51783,mānando,manando,5,2,3,0,7
51784,bandhatthā,bandhattha,1,1,0,0,10
51785,nusārinaṃ,nusarinam,1,1,0,0,9
51786,rasīyatīti,rasiyatiti,2,1,1,0,10
51787,taññūhi,tannuhi,7,4,3,0,7
51788,rasappabheda,rasappabheda,2,2,0,0,12
51789,sattika,sattika,1,1,0,0,7
51790,byabhicāribhi,byabhicaribhi,2,2,0,0,13
51791,assādiyatta,assadiyatta,2,1,1,0,11
51792,ṭhāye,thaye,1,1,0,0,5
51793,rudda,rudda,1,1,0,0,5
51794,ṭhāyīna,thayina,2,1,1,0,7
51795,nukkamā,nukkama,2,1,1,0,7
51796,para355,para355,91,91,0,0,7
51797,dukkharūpe,dukkharupe,4,1,3,0,10
51798,karuṇādike,karunadike,4,2,2,0,10
51799,sotūnamānando,sotunamanando,1,0,1,0,13
51800,vessantarassa,vessantarassa,74,70,4,0,13
51801,ṭhāyībhāva,thayibhava,1,1,0,0,10
51802,ratiṭṭhāyībhāva,ratitthayibhava,1,1,0,0,15
51803,para356,para356,91,91,0,0,7
51804,desa,desa,18,16,2,0,4
51805,vesādi,vesadi,1,1,0,0,6
51806,paṭisevanā,patisevana,20,17,3,0,10
51807,yuvāna,yuvana,4,3,1,0,6
51808,ññoññarattānaṃ,nnonnarattanam,2,1,1,0,14
51809,pamodo,pamodo,16,14,2,0,6
51810,yutyā,yutya,7,2,5,0,5
51811,bhāvānubhāvā,bhavanubhava,4,1,3,0,12
51812,posayanti,posayanti,7,5,2,0,9
51813,sopya,sopya,2,2,0,0,5
51814,yoga,yoga,9,7,2,0,4
51815,vippayoga,vippayoga,1,1,0,0,9
51816,sambhogānaṃ,sambhoganam,3,2,1,0,11
51817,hassaṭṭhāyībhāva,hassatthayibhava,1,1,0,0,16
51818,katiādīhi,katiadihi,1,1,0,0,9
51819,lasya,lasya,2,2,0,0,5
51820,mucchādi,mucchadi,1,1,0,0,8
51821,paripose,paripose,4,3,1,0,8
51822,tthipabhutīnaṃ,tthipabhutinam,1,1,0,0,14
51823,hassappabheda,hassappabheda,2,2,0,0,13
51824,vikāsi,vikasi,3,1,2,0,6
51825,kiñcā,kinca,8,7,1,0,5
51826,lakkhiya,lakkhiya,1,1,0,0,8
51827,dijaṃ,dijam,14,12,2,0,5
51828,hasitaṃ,hasitam,43,39,4,0,7
51829,madhurassaraṃ,madhurassaram,23,21,2,0,13
51830,aṃsasirokampa,amsasirokampa,1,1,0,0,13
51831,mupahasitaṃ,mupahasitam,1,0,1,0,11
51832,apahasitaṃ,apahasitam,4,2,2,0,10
51833,sajala,sajala,2,2,0,0,6
51834,kkhi,kkhi,5,4,1,0,4
51835,vikkhittaṅgaṃ,vikkhittangam,3,1,2,0,13
51836,bhavatya,bhavatya,3,2,1,0,8
51837,tihasitaṃ,tihasitam,2,0,2,0,9
51838,jeṭṭhe,jetthe,8,7,1,0,6
51839,dhameti,dhameti,5,1,4,0,7
51840,adhameti,adhameti,1,1,0,0,8
51841,dhame,dhame,17,13,4,0,5
51842,kamaso,kamaso,4,1,3,0,6
51843,karuṇaṭṭhāyībhāva,karunatthayibhava,1,1,0,0,17
51844,sokarūpo,sokarupo,5,2,3,0,8
51845,niṭṭhappatti,nitthappatti,1,1,0,0,12
51846,nāsato,nasato,52,52,0,0,6
51847,rudita,rudita,2,1,1,0,6
51848,tthambhakādayo,tthambhakadayo,1,1,0,0,14
51849,ruddaṭṭhāyībhāva,ruddatthayibhava,1,1,0,0,16
51850,macchariyā,macchariya,5,5,0,0,10
51851,madādibhi,madadibhi,1,1,0,0,9
51852,nayanā,nayana,6,5,1,0,6
51853,ruṇatādīhi,runatadihi,1,1,0,0,10
51854,vīraṭṭhāyībhāva,viratthayibhava,1,1,0,0,15
51855,patāpa,patapa,2,1,1,0,6
51856,vikkamā,vikkama,3,3,0,0,7
51857,dīhu,dihu,1,1,0,0,4
51858,ssāho,ssaho,1,1,0,0,5
51859,dayāyogā,dayayoga,1,1,0,0,8
51860,tevā,teva,3,2,1,0,4
51861,tyā,tya,27,9,18,0,3
51862,bhayaṭṭhāyībhāva,bhayatthayibhava,1,1,0,0,16
51863,sani,sani,2,1,1,0,4
51864,bhayu,bhayu,1,1,0,0,5
51865,kkaṃso,kkamso,2,1,1,0,6
51866,nubhāve,nubhave,2,0,2,0,7
51867,tāsā,tasa,3,3,0,0,4
51868,jigucchāṭṭhāyībhāva,jigucchatthayibhava,1,1,0,0,19
51869,rudhirā,rudhira,1,1,0,0,7
51870,pūtyā,putya,1,1,0,0,5
51871,virāgato,viragato,9,7,2,0,8
51872,khobhanu,khobhanu,2,1,1,0,8
51873,bbegī,bbegi,2,1,1,0,5
51874,karuṇāyuto,karunayuto,4,2,2,0,10
51875,vikūṇanādīhi,vikunanadihi,1,1,0,0,12
51876,saṅkādīhi,sankadihi,3,1,2,0,9
51877,vimhayaṭṭhāyībhāva,vimhayatthayibhava,1,1,0,0,18
51878,padatthehi,padatthehi,2,2,0,0,10
51879,bbhuto,bbhuto,5,2,3,0,6
51880,sādhuvādā,sadhuvada,1,1,0,0,9
51881,vega,vega,2,2,0,0,4
51882,ppaññā,ppanna,1,1,0,0,6
51883,honte,honte,24,23,1,0,5
51884,samaṭṭhāyībhāva,samatthayibhava,1,1,0,0,15
51885,modā,moda,5,4,1,0,4
51886,bhāvādīhi,bhavadihi,4,2,2,0,9
51887,dukkaṃso,dukkamso,1,1,0,0,8
51888,nisevito,nisevito,4,4,0,0,8
51889,saṅgharakkhita,sangharakkhita,9,9,0,0,14
51890,mahāsāmiviracite,mahasamiviracite,1,1,0,0,16
51891,rasabhāvā,rasabhava,1,1,0,0,9
51892,samatto,samatto,103,99,4,0,7
51893,subodhālaṅkāraṭīkā,subodhalankaratika,2,2,0,0,18
51894,ganthārambhakathā,gantharambhakatha,123,123,0,0,17
51895,pādanīrajavarodararādhitena,padanirajavarodararadhitena,1,1,0,0,27
51896,rādikena,radikena,1,1,0,0,8
51897,lokattayena,lokattayena,1,1,0,0,11
51898,vikalena,vikalena,2,2,0,0,8
51899,nirākulena,nirakulena,1,1,0,0,10
51900,viññāpayī,vinnapayi,3,3,0,0,9
51901,nirupameyyatamattano,nirupameyyatamattano,1,1,0,0,20
51902,munindamabhivandiya,munindamabhivandiya,1,1,0,0,19
51903,vandanīyaṃ,vandaniyam,1,1,0,0,10
51904,sapattavijayo,sapattavijayo,1,1,0,0,13
51905,jayabodhimūle,jayabodhimule,1,1,0,0,13
51906,saddhammarājapadaviṃ,saddhammarajapadavim,1,1,0,0,20
51907,yadanuggahena,yadanuggahena,1,1,0,0,13
51908,sattāpasatta,sattapasatta,1,1,0,0,12
51909,sattappasattha,sattappasattha,1,1,0,0,14
51910,vipulāmalasagguṇassa,vipulamalasaggunassa,1,1,0,0,20
51911,saddhammasāraratanassa,saddhammasararatanassa,1,1,0,0,22
51912,bhājanattamabhisambhuṇi,bhajanattamabhisambhuni,1,1,0,0,23
51913,sagguṇassa,saggunassa,1,1,0,0,10
51914,dhammaratanassa,dhammaratanassa,16,16,0,0,15
51915,mahārahassa,maharahassa,1,1,0,0,11
51916,sambhāvitaṃ,sambhavitam,8,8,0,0,11
51917,sasirasāhitasannatehi,sasirasahitasannatehi,1,1,0,0,21
51918,sambhāvayāmi,sambhavayami,1,1,0,0,12
51919,gaṇamuttamaṃ,ganamuttamam,1,1,0,0,12
51920,nantatantaratanākaramanthanena,nantatantaratanakaramanthanena,2,2,0,0,30
51921,manthā,mantha,5,4,1,0,6
51922,calollasitañāṇavarena,calollasitananavarena,1,1,0,0,21
51923,sārā,sara,17,17,0,0,4
51924,sukhayanti,sukhayanti,4,4,0,0,10
51925,jayanti,jayanti,12,12,0,0,7
51926,guravo,guravo,7,7,0,0,6
51927,dosāvabodha,dosavabodha,1,1,0,0,11
51928,paṭhamapariccheda,pathamapariccheda,1,1,0,0,17
51929,ratanattayappaṇāmavaṇṇanā,ratanattayappanamavannana,1,1,0,0,25
51930,munindavadanambhojagabbhasambhavasundarī,munindavadanambhojagabbhasambhavasundari,1,0,1,0,40
51931,athāyaṃ,athayam,83,78,5,0,7
51932,ganthārambhe,gantharambhe,10,10,0,0,12
51933,pubbapayogānubandhasabhāvasiddhikaviguṇopetānaṃ,pubbapayoganubandhasabhavasiddhikavigunopetanam,1,1,0,0,47
51934,yatipotānaṃ,yatipotanam,3,3,0,0,11
51935,tadupāyantaraviratā,tadupayantaravirata,1,1,0,0,19
51936,kamantarāpetaparakkamasambhavenādhigatabyasanasatamupalabbha,kamantarapetaparakkamasambhavenadhigatabyasanasatamupalabbha,1,1,0,0,60
51937,dayāsañjātarasarasahadayatāya,dayasanjatarasarasahadayataya,1,1,0,0,29
51938,tadupāyabhūtaṃ,tadupayabhutam,2,2,0,0,14
51939,bandhalakkhaṇaṃ,bandhalakkhanam,2,2,0,0,15
51940,viracayitukāmobhimatasiddhinimittamattanodhigatasaddhammadevatānussaraṇaṃ,viracayitukamobhimatasiddhinimittamattanodhigatasaddhammadevatanussaranam,1,1,0,0,73
51941,muninde,muninde,7,2,5,0,7
51942,viracayitukāmo,viracayitukamo,1,1,0,0,14
51943,kimettha,kimettha,73,70,3,0,8
51944,lakkhaṇakaraṇena,lakkhanakaranena,1,1,0,0,16
51945,adiṭṭhalakkhaṇāpi,aditthalakkhanapi,1,1,0,0,17
51946,bandhantāti,bandhantati,1,1,0,0,11
51947,ghuṇakkharappakāsā,ghunakkharappakasa,1,1,0,0,18
51948,tabbidūnaṃ,tabbidunam,1,1,0,0,10
51949,payogānusārino,payoganusarino,1,1,0,0,14
51950,katasatthaparicayā,katasatthaparicaya,1,1,0,0,18
51951,pīṇayatanti,pinayatanti,1,1,0,0,11
51952,vāṇīti,vaniti,2,0,2,0,6
51953,sarassatyaparanāmadheyyā,sarassatyaparanamadheyya,1,1,0,0,24
51954,sabbāvadātā,sabbavadata,1,1,0,0,11
51955,yathicchitatthasādhanapuṇḍarīkagabbhe,yathicchitatthasadhanapundarikagabbhe,1,1,0,0,37
51956,nisīdatīti,nisidatiti,32,23,9,0,10
51957,lokavādo,lokavado,3,3,0,0,8
51958,paccuhavirahenābhimatasiddhinibandhanekatāṇo,paccuhavirahenabhimatasiddhinibandhanekatano,1,1,0,0,44
51959,sammāsambuddhabhāsito,sammasambuddhabhasito,1,1,0,0,21
51960,tatoyevāyaṃ,tatoyevayam,3,3,0,0,11
51961,ruppate,ruppate,1,1,0,0,7
51962,sarassatiyā,sarassatiya,1,1,0,0,11
51963,jātāya,jataya,20,20,0,0,6
51964,manosampīṇananti,manosampinananti,1,1,0,0,16
51965,saddhammadevatāya,saddhammadevataya,1,1,0,0,17
51966,manopīṇanaṃ,manopinanam,1,1,0,0,11
51967,sabbavajjarahitāyaccantanimmalāya,sabbavajjarahitayaccantanimmalaya,1,1,0,0,33
51968,nirantaratthanekatāṇappavattiyā,nirantaratthanekatanappavattiya,1,1,0,0,31
51969,sampīṇanaṃ,sampinanam,1,1,0,0,10
51970,samādhisambhavena,samadhisambhavena,1,1,0,0,17
51971,yathābhūtāvabodhasambhavato,yathabhutavabodhasambhavato,1,1,0,0,27
51972,vicittānekasaddatthavisesā,vicittanekasaddatthavisesa,1,1,0,0,26
51973,paṭibhantyanāyāsena,patibhantyanayasena,1,1,0,0,19
51974,yathicchitasiddhinipphattīti,yathicchitasiddhinipphattiti,1,1,0,0,28
51975,vaṅkavuttiyā,vankavuttiya,10,10,0,0,12
51976,tappasādamāsīsati,tappasadamasisati,1,1,0,0,17
51977,kiṃvisiṭṭhoccāha,kimvisitthoccaha,1,1,0,0,16
51978,sabbatthāti,sabbatthati,288,23,265,0,11
51979,tatoyaṃ,tatoyam,8,8,0,0,7
51980,nimittakasaññā,nimittakasanna,1,1,0,0,14
51981,vijjamānesupi,vijjamanesupi,45,45,0,0,13
51982,pariyāyasaddesvaññesu,pariyayasaddesvannesu,1,1,0,0,21
51983,kavikāmitassatthassekantavācakatteno,kavikamitassatthassekantavacakatteno,1,1,0,0,36
51984,cityasamposakoyaṃ,cityasamposakoyam,1,1,0,0,17
51985,ubhayalokajānanena,ubhayalokajananena,1,1,0,0,18
51986,paramissariyapuggalānampi,paramissariyapuggalanampi,1,1,0,0,25
51987,hetubhāvena,hetubhavena,83,80,3,0,11
51988,tre,tre,6,3,3,0,3
51989,citameva,citameva,2,2,0,0,8
51990,padantarānampi,padantaranampi,1,1,0,0,14
51991,vadanāravindodare,vadanaravindodare,1,1,0,0,17
51992,pīṇetīti,pinetiti,24,20,4,0,8
51993,munindavadanaṃ,munindavadanam,1,0,1,0,14
51994,lakkhisaṃyogitādisadhammena,lakkhisamyogitadisadhammena,1,1,0,0,27
51995,sambhavena,sambhavena,14,12,2,0,10
51996,uppattiyā,uppattiya,238,229,9,0,9
51997,niravajjā,niravajja,5,5,0,0,9
51998,dosalesenāpa,dosalesenapa,1,1,0,0,12
51999,samphuṭṭhāva,samphutthava,2,2,0,0,12
52000,tatovāyaṃ,tatovayam,1,1,0,0,9
52001,paṭibhānādiguṇavisesāvahattamattena,patibhanadigunavisesavahattamattena,1,1,0,0,35
52002,paṭisaraṇabhūtā,patisaranabhuta,3,3,0,0,15
52003,sabbupaddavanivāraṇena,sabbupaddavanivaranena,1,1,0,0,22
52004,sabbahitasukhasampadāsampādanenaccantapaṭisaraṇabhūtā,sabbahitasukhasampadasampadanenaccantapatisaranabhuta,1,1,0,0,53
52005,sabhāvanapuṃsakattā,sabhavanapumsakatta,1,1,0,0,19
52006,liṅgaparivattanaṃ,lingaparivattanam,7,7,0,0,17
52007,mayhanti,mayhanti,41,41,0,0,8
52008,ekavacanenattano,ekavacanenattano,1,1,0,0,16
52009,nirabhimānata,nirabhimanata,1,1,0,0,13
52010,māneti,maneti,32,32,0,0,6
52011,sajjanamācāraṃ,sajjanamacaram,1,1,0,0,14
52012,abhinnapadasileso,abhinnapadasileso,1,1,0,0,17
52013,sabbatthevāvīkatasaddappayogato,sabbatthevavikatasaddappayogato,1,1,0,0,31
52014,vitthāranayena,vittharanayena,5,5,0,0,14
52015,nānappakārenattho,nanappakarenattho,1,1,0,0,17
52016,saṃvaṇṇetuṃ,samvannetum,17,17,0,0,11
52017,ganthagāravopi,ganthagaravopi,1,1,0,0,14
52018,pakāroyamevabbhupagato,pakaroyamevabbhupagato,1,1,0,0,22
52019,suparisuddhabuddhigocaraparamavicittaganthakārakoyamācariya,suparisuddhabuddhigocaraparamavicittaganthakarakoyamacariya,1,1,0,0,59
52020,saṅgharakkhitamahāsāmipādo,sangharakkhitamahasamipado,1,1,0,0,26
52021,sapiṭakattayasabbasatthapārāvataraṇena,sapitakattayasabbasatthaparavataranena,1,1,0,0,38
52022,sañjātānappakapītisukhamanubhavaṃ,sanjatanappakapitisukhamanubhavam,1,1,0,0,33
52023,paṭipattipaṭivedhasāsanadvayassa,patipattipativedhasasanadvayassa,1,1,0,0,32
52024,pariyattimūlakattā,pariyattimulakatta,1,1,0,0,18
52025,pariyattiyā,pariyattiya,76,72,4,0,11
52026,atthāvabodhena,atthavabodhena,1,1,0,0,14
52027,appeva,appeva,341,305,36,0,6
52028,sādhujanaṃ,sadhujanam,9,7,2,0,10
52029,paritoseyya,paritoseyya,4,4,0,0,11
52030,tadadhigamopāyabhūtamidaṃ,tadadhigamopayabhutamidam,1,1,0,0,25
52031,pakaraṇamārabhanto,pakaranamarabhanto,1,1,0,0,18
52032,iṭṭhadevatāya,itthadevataya,1,1,0,0,13
52033,paṇāmakaraṇaṃ,panamakaranam,7,6,1,0,13
52034,satācārānurakkhaṇatthaṃ,satacaranurakkhanattham,1,1,0,0,23
52035,sadācārānurakkhaṇatthaṃ,sadacaranurakkhanattham,1,1,0,0,23
52036,abhimataganthassānantarāyena,abhimataganthassanantarayena,1,1,0,0,28
52037,parisamattiyā,parisamattiya,2,2,0,0,13
52038,kāraṇamiti,karanamiti,3,3,0,0,10
52039,iṭṭhadevatānussaraṇaṃ,itthadevatanussaranam,1,1,0,0,21
52040,ganthantarārambhapaṭikkhepakajanapaṭibāhanapubbakāni,ganthantararambhapatikkhepakajanapatibahanapubbakani,1,1,0,0,52
52041,abhidhānābhidheyyakaraṇappakārapayojanāni,abhidhanabhidheyyakaranappakarapayojanani,1,1,0,0,41
52042,gāthattayamāha,gathattayamaha,7,7,0,0,14
52043,iṭṭhadevatāsaṅkhātaratanattayappaṇāmo,itthadevatasankhataratanattayappanamo,1,1,0,0,37
52044,ārambhapaṭikkhepakajanā,arambhapatikkhepakajana,1,1,0,0,23
52045,nisedhitā,nisedhita,2,2,0,0,9
52046,lokuttaradhammanissitapariyattisaṅkhātasabbaññubhāratiyā,lokuttaradhammanissitapariyattisankhatasabbannubharatiya,1,1,0,0,56
52047,manosampīṇanāsīsanāpadesena,manosampinanasisanapadesena,1,1,0,0,27
52048,nissesadhammaratane,nissesadhammaratane,1,1,0,0,19
52049,dhammappasādo,dhammappasado,1,1,0,0,13
52050,tadavinābhāvato,tadavinabhavato,59,59,0,0,15
52051,buddhasaṅghesupi,buddhasanghesupi,1,1,0,0,16
52052,siddhoti,siddhoti,82,80,2,0,8
52053,ratanattayavisayaṃ,ratanattayavisayam,2,2,0,0,18
52054,rāmasammādyalaṅkāresu,ramasammadyalankaresu,1,1,0,0,21
52055,piṭṭhapisanaṃ,pitthapisanam,1,1,0,0,13
52056,hotīdaṃ,hotidam,2,2,0,0,7
52057,alaṅkārakaraṇanti,alankarakarananti,1,1,0,0,17
52058,vadantā,vadanta,127,127,0,0,7
52059,viruddhavādino,viruddhavadino,1,1,0,0,14
52060,rāmasammādīnamatthibhāvaṃ,ramasammadinamatthibhavam,1,1,0,0,25
52061,ubbhāvetvā,ubbhavetva,1,1,0,0,10
52062,abhyupagametvā,abhyupagametva,1,1,0,0,14
52063,vaḷañjentīti,valanjentiti,4,3,1,0,12
52064,paṭisiddhā,patisiddha,28,22,6,0,10
52065,nirākaraṇaphalañhi,nirakaranaphalanhi,1,1,0,0,18
52066,niddosabhāvova,niddosabhavova,1,1,0,0,14
52067,apica,apica,1887,1844,43,0,5
52068,saddālaṅkāraatthālaṅkāradīpakena,saddalankaraatthalankaradipakena,1,1,0,0,32
52069,ganthasarīrasaṅkhātasaññino,ganthasarirasankhatasannino,1,1,0,0,27
52070,saññāsaṅkhātaabhidhānañca,sannasankhataabhidhananca,1,1,0,0,25
52071,saddālaṅkārādyabhidheyyañca,saddalankaradyabhidheyyanca,1,1,0,0,27
52072,suddhamāgadhikattaṃ,suddhamagadhikattam,1,1,0,0,19
52073,visesanabhūtaanurūpasaddopādānena,visesanabhutaanurupasaddopadanena,1,1,0,0,33
52074,buddhavacanassa,buddhavacanassa,49,48,1,0,15
52075,upayogattaṃ,upayogattam,1,1,0,0,11
52076,māgadhikavohārena,magadhikavoharena,1,1,0,0,17
52077,karaṇappakārañca,karanappakaranca,1,1,0,0,16
52078,alaṅkāraganthappavattiyā,alankaraganthappavattiya,1,1,0,0,24
52079,atthālaṅkārādinissitattā,atthalankaradinissitatta,1,1,0,0,24
52080,saddeneva,saddeneva,11,11,0,0,9
52081,alaṅkārasaṅkharaṇasaṅkhātappayojanañca,alankarasankharanasankhatappayojananca,1,1,0,0,38
52082,satthappayojanānaṃ,satthappayojananam,2,2,0,0,18
52083,sādhyasādhanalakkhaṇo,sadhyasadhanalakkhano,1,1,0,0,21
52084,nissayabhūtasatthappayojanānaṃ,nissayabhutasatthappayojananam,1,1,0,0,30
52085,dassaneneva,dassaneneva,47,46,1,0,11
52086,tannissitattā,tannissitatta,12,12,0,0,13
52087,payojanañceva,payojananceva,3,3,0,0,13
52088,sambandhanissayā,sambandhanissaya,5,4,1,0,16
52089,taṃvuttiyāyeva,tamvuttiyayeva,2,1,1,0,14
52090,tannissitopi,tannissitopi,2,2,0,0,12
52091,ādhārabhūtā,adharabhuta,10,9,1,0,11
52092,payojanañca,payojananca,14,12,2,0,11
52093,ubhinnaṃ,ubhinnam,710,637,73,0,8
52094,kathaneneva,kathaneneva,4,4,0,0,11
52095,tannissito,tannissito,10,8,2,0,10
52096,abhidhānakathanaṃ,abhidhanakathanam,2,2,0,0,17
52097,abhidheyyādikathanaṃ,abhidheyyadikathanam,1,1,0,0,20
52098,yuttānaṃyeva,yuttanamyeva,1,1,0,0,12
52099,ganthānaṃ,ganthanam,31,31,0,0,9
52100,subuddhipubbakādīnaṃ,subuddhipubbakadinam,1,1,0,0,20
52101,upādeyyattañca,upadeyyattanca,1,1,0,0,14
52102,tabbiparītānaṃ,tabbiparitanam,4,4,0,0,14
52103,ummattakavacanādīnamivaanupādeyyattañca,ummattakavacanadinamivaanupadeyyattanca,1,1,0,0,39
52104,pakāsanatthanti,pakasanatthanti,1,1,0,0,15
52105,sambandhānuguṇopāyaṃ,sambandhanugunopayam,3,2,1,0,20
52106,sambandhyanuguṇopāyaṃ,sambandhyanugunopayam,1,1,0,0,21
52107,purisatthābhidhāyakaṃ,purisatthabhidhayakam,3,2,1,0,21
52108,vīmaṃsādhigataṃ,vimamsadhigatam,3,2,1,0,15
52109,vīmaṃsādhikataṃ,vimamsadhikatam,1,1,0,0,15
52110,vākyamatonadhigataṃ,vakyamatonadhigatam,2,2,0,0,19
52111,nadhikataṃ,nadhikatam,1,1,0,0,10
52112,sādhiyasādhanalakkhaṇasambandhassa,sadhiyasadhanalakkhanasambandhassa,1,1,0,0,34
52113,nissayabhūtavāccavācakānaṃ,nissayabhutavaccavacakanam,1,1,0,0,26
52114,sambandhibhūtānaṃ,sambandhibhutanam,1,1,0,0,17
52115,aññamaññānurūpaguṇaparijānane,annamannanurupagunaparijanane,1,1,0,0,29
52116,catubbidhadhammaatthakāmamokkhasaṅkhātānaṃ,catubbidhadhammaatthakamamokkhasankhatanam,1,1,0,0,42
52117,purisatthānaṃ,purisatthanam,1,1,0,0,13
52118,vācakabhūtaṃ,vacakabhutam,1,1,0,0,12
52119,padaccayo,padaccayo,3,3,0,0,9
52120,vuttalakkhaṇamajjhapatitavākyasamudāyopetaṃ,vuttalakkhanamajjhapatitavakyasamudayopetam,1,1,0,0,43
52121,mahāvākyasarūpasatthaṃ,mahavakyasarupasattham,1,1,0,0,22
52122,ñāṇagatilakkhaṇaupaparikkhāya,nanagatilakkhanaupaparikkhaya,1,1,0,0,29
52123,vuttalakkhaṇasatthato,vuttalakkhanasatthato,1,1,0,0,21
52124,anadhigataṃ,anadhigatam,48,44,4,0,11
52125,nādhippetanti,nadhippetanti,7,7,0,0,13
52126,nikkhepappayojanaṃ,nikkhepappayojanam,15,15,0,0,18
52127,padumagabbhe,padumagabbhe,23,20,3,0,12
52128,vasantiyā,vasantiya,37,36,1,0,9
52129,sabbaṅgadhavalāya,sabbangadhavalaya,1,1,0,0,17
52130,yathicchitatthasādhikāya,yathicchitatthasadhikaya,1,1,0,0,24
52131,sarassatīnāmikāya,sarassatinamikaya,1,1,0,0,17
52132,devatāya,devataya,279,275,4,0,8
52133,yojetvā,yojetva,800,786,14,0,7
52134,abhinnapadasilesālaṅkāravasena,abhinnapadasilesalankaravasena,1,1,0,0,30
52135,sobhāsugandhādiguṇayogato,sobhasugandhadigunayogato,1,1,0,0,25
52136,mukhasadisassa,mukhasadisassa,1,1,0,0,14
52137,mukhasaṅkhātaambhojassa,mukhasankhataambhojassa,1,1,0,0,23
52138,ahitāpanayanahitāvahatthena,ahitapanayanahitavahatthena,1,1,0,0,27
52139,paṭissaraṇabhūtā,patissaranabhuta,1,1,0,0,16
52140,yathāvuttaguṇopetā,yathavuttagunopeta,1,1,0,0,18
52141,sarassatīdevatā,sarassatidevata,1,1,0,0,15
52142,sabbaññubhāratīti,sabbannubharatiti,1,1,0,0,17
52143,vuttasaddhammaratanaṃ,vuttasaddhammaratanam,1,1,0,0,21
52144,ganthaviracane,ganthaviracane,1,1,0,0,14
52145,byāvaṭassa,byavatassa,8,8,0,0,10
52146,abhimatatthasampādanena,abhimatatthasampadanena,1,1,0,0,23
52147,pīṇayatūti,pinayatuti,1,1,0,0,10
52148,ubhayalokajānanato,ubhayalokajananato,1,1,0,0,18
52149,indabhāvapavattanato,indabhavapavattanato,1,1,0,0,20
52150,kammadhārayena,kammadharayena,1,1,0,0,14
52151,agāriyamunianagāriyamunisekhamuniasekhamunīnaṃ,agariyamunianagariyamunisekhamuniasekhamuninam,1,1,0,0,46
52152,chaṭṭhītappurisena,chatthitappurisena,1,1,0,0,18
52153,devatāpakkhe,devatapakkhe,1,1,0,0,12
52154,vadanamiva,vadanamiva,1,1,0,0,10
52155,ambhoje,ambhoje,1,1,0,0,7
52156,saddhammapakkhe,saddhammapakkhe,2,2,0,0,15
52157,ambhojamiva,ambhojamiva,3,3,0,0,11
52158,vadanambhojamiti,vadanambhojamiti,1,1,0,0,16
52159,gabbhoti,gabbhoti,24,18,6,0,8
52160,sambhavoti,sambhavoti,78,66,12,0,10
52161,sundarīti,sundariti,7,2,5,0,9
52162,vāṇiyā,vaniya,3,3,0,0,6
52163,visesanattepi,visesanattepi,1,1,0,0,13
52164,ekantanapuṃsakattā,ekantanapumsakatta,1,1,0,0,18
52165,saraṇa,sarana,17,16,1,0,6
52166,liṅgaparivattanabhāvo,lingaparivattanabhavo,1,1,0,0,21
52167,byabhicārattā,byabhicaratta,1,1,0,0,13
52168,ekavacanena,ekavacanena,34,34,0,0,11
52169,sādhuguṇodayakāraṇaṃ,sadhugunodayakaranam,1,1,0,0,20
52170,niratimānataṃ,niratimanatam,2,2,0,0,13
52171,jinapariyāyesu,jinapariyayesu,1,1,0,0,14
52172,iṭṭhamanosampīṇanaambhojatulyatāsundarittasaraṇattasaṅkhātānaṃ,itthamanosampinanaambhojatulyatasundarittasaranattasankhatanam,1,1,0,0,62
52173,atthantarānaṃ,atthantaranam,1,1,0,0,13
52174,posetīti,posetiti,16,14,2,0,8
52175,payutto,payutto,61,60,1,0,7
52176,ambhojatulyaṃ,ambhojatulyam,1,1,0,0,13
52177,mukhodare,mukhodare,1,1,0,0,9
52178,manosampīṇane,manosampinane,1,1,0,0,13
52179,paṭuttaṃ,patuttam,5,4,1,0,8
52180,subyattamiti,subyattamiti,1,1,0,0,12
52181,patthaṭamidamocityamādaraṇīyaṃ,patthatamidamocityamadaraniyam,1,1,0,0,30
52182,tasmiñhi,tasminhi,153,150,3,0,8
52183,uttamakavayoyeva,uttamakavayoyeva,1,1,0,0,16
52184,upadesakāti,upadesakati,1,1,0,0,11
52185,vikhyātamādarā,vikhyatamadara,2,1,1,0,14
52186,tatthopadesappabhavā,tatthopadesappabhava,1,1,0,0,20
52187,nimittavaṇṇanā,nimittavannana,1,1,0,0,14
52188,rāmasammādyalaṅkārā,ramasammadyalankara,2,0,2,0,19
52189,athevamabhigatāmitasiddhisampadāpādanekacaturaparamiṭṭhadevatā,athevamabhigatamitasiddhisampadapadanekacaturaparamitthadevata,1,1,0,0,62
52190,bhāvarūpitasaddhammaratanasso,bhavarupitasaddhammaratanasso,1,1,0,0,29
52191,padassitanipaccakārena,padassitanipaccakarena,1,1,0,0,22
52192,iṭṭhadevatāpūjaṃ,itthadevatapujam,1,1,0,0,16
52193,bandhalakkhaṇamatthiyeva,bandhalakkhanamatthiyeva,1,1,0,0,24
52194,pubbakaṃ,pubbakam,20,17,3,0,8
52195,kimanena,kimanena,5,5,0,0,8
52196,piṭṭhapisanene,pitthapisanene,1,1,0,0,14
52197,lakkhaṇantarārambhapaṭikkhepakajanapaṭibāhanapubbakamabhidheyyappayojana,lakkhanantararambhapatikkhepakajanapatibahanapubbakamabhidheyyappayojana,1,1,0,0,72
52198,rāmasamme,ramasamme,1,0,1,0,9
52199,rāmasammādīnaṃ,ramasammadinam,1,1,0,0,14
52200,rāmasammapabhutīnaṃ,ramasammapabhutinam,1,1,0,0,19
52201,rāmasammādayo,ramasammadayo,2,2,0,0,13
52202,taṃsambandhato,tamsambandhato,5,5,0,0,14
52203,tabbohāro,tabboharo,26,26,0,0,9
52204,vejjasatthaṃ,vejjasattham,1,1,0,0,12
52205,bimbisāro,bimbisaro,173,169,4,0,9
52206,bhūsāvisesā,bhusavisesa,2,2,0,0,11
52207,bandhālaṅkārapaṭipādakatthena,bandhalankarapatipadakatthena,1,1,0,0,29
52208,alaṅkārakhyā,alankarakhya,1,1,0,0,12
52209,ganthavisesā,ganthavisesa,2,2,0,0,12
52210,pubbakāle,pubbakale,33,28,5,0,9
52211,porāṇikā,poranika,17,17,0,0,8
52212,yajjapi,yajjapi,13,13,0,0,7
52213,nipātasamudāyoyaṃ,nipatasamudayoyam,3,3,0,0,17
52214,visesābhidhānārambhe,visesabhidhanarambhe,1,1,0,0,20
52215,santepīti,santepiti,29,3,26,0,9
52216,suddhamāgadhikāti,suddhamagadhikati,1,0,1,0,17
52217,magadhesu,magadhesu,109,103,6,0,9
52218,viditā,vidita,271,254,17,0,6
52219,niyuttāti,niyuttati,40,40,0,0,9
52220,māgadhikā,magadhika,10,8,2,0,9
52221,sakkaṭādibhāsitakālusiyābhāvena,sakkatadibhasitakalusiyabhavena,1,1,0,0,31
52222,asammissā,asammissa,16,16,0,0,9
52223,aparicitattā,aparicitatta,6,6,0,0,12
52224,yatipotā,yatipota,1,1,0,0,8
52225,yathāvutte,yathavutte,147,143,4,0,10
52226,ābharaṇavisese,abharanavisese,1,1,0,0,14
52227,pasādhanavisese,pasadhanavisese,1,1,0,0,15
52228,nānubhavanti,nanubhavanti,20,17,3,0,12
52229,ganthavisese,ganthavisese,3,3,0,0,12
52230,uggahaṇadhāraṇādivasena,uggahanadharanadivasena,2,2,0,0,23
52231,suddhamāgadhikattā,suddhamagadhikatta,1,1,0,0,18
52232,rāmasammādīnañca,ramasammadinanca,1,1,0,0,16
52233,sakkaṭādibhāvatoti,sakkatadibhavatoti,1,1,0,0,18
52234,bhāvatthalesopettha,bhavatthalesopettha,1,1,0,0,19
52235,paripūrati,paripurati,31,30,1,0,10
52236,tathāvidhapatītiyogato,tathavidhapatitiyogato,1,1,0,0,22
52237,parisuddhabhāvena,parisuddhabhavena,5,5,0,0,17
52238,sobhanāpi,sobhanapi,1,1,0,0,9
52239,malaggahitabhāvappattā,malaggahitabhavappatta,1,1,0,0,22
52240,malaggahitehi,malaggahitehi,1,1,0,0,13
52241,amhādisānaṃ,amhadisanam,6,6,0,0,11
52242,suddhasattānaṃ,suddhasattanam,11,10,1,0,14
52243,patīyamānaṃ,patiyamanam,3,2,1,0,11
52244,attheva,attheva,367,361,6,0,7
52245,vāṇīsu,vanisu,3,2,1,0,6
52246,mahākavīnaṃ,mahakavinam,4,3,1,0,11
52247,pasiddhāvayavātiritta,pasiddhavayavatiritta,2,2,0,0,21
52248,lāvaṇyamivaṅganāsū,lavanyamivanganasu,2,2,0,0,18
52249,pasatthattā,pasatthatta,11,10,1,0,11
52250,pubbakālasambhūtā,pubbakalasambhuta,1,1,0,0,17
52251,rāmasammādīhi,ramasammadihi,1,1,0,0,13
52252,ācariyehi,acariyehi,95,91,4,0,9
52253,viracitattā,viracitatta,2,2,0,0,11
52254,tabbohārasadisanāmattā,tabboharasadisanamatta,1,1,0,0,22
52255,kismiñci,kisminci,237,228,9,0,8
52256,vejjasatthe,vejjasatthe,2,2,0,0,11
52257,alaṅkārattapaṭipādanato,alankarattapatipadanato,1,1,0,0,23
52258,alaṅkāranāmikā,alankaranamika,1,1,0,0,14
52259,santepi,santepi,451,445,6,0,7
52260,sakkaṭapākatādīsu,sakkatapakatadisu,1,1,0,0,17
52261,aññabhāsāsu,annabhasasu,1,1,0,0,11
52262,paricayābhāvato,paricayabhavato,5,5,0,0,15
52263,kevalamāgadhikā,kevalamagadhika,1,1,0,0,15
52264,rāmasammādike,ramasammadike,1,1,0,0,13
52265,pasādhanavasena,pasadhanavasena,2,2,0,0,15
52266,magadhavisesano,magadhavisesano,1,1,0,0,15
52267,māgadhikavisesano,magadhikavisesano,1,1,0,0,17
52268,saddānaṃ,saddanam,290,285,5,0,8
52269,tādisapatītivisesayogato,tadisapatitivisesayogato,1,1,0,0,24
52270,bhāvatthalesopi,bhavatthalesopi,2,2,0,0,15
52271,vinyāsena,vinyasena,1,1,0,0,9
52272,sobhanatte,sobhanatte,1,1,0,0,10
52273,purātanattā,puratanatta,1,1,0,0,11
52274,aparisuddhoti,aparisuddhoti,7,5,2,0,13
52275,avamaññamānā,avamannamana,3,3,0,0,12
52276,vatticchitassatthassa,vatticchitassatthassa,1,1,0,0,21
52277,upatthambhakabhūto,upatthambhakabhuto,1,1,0,0,18
52278,vacanesuyeva,vacanesuyeva,1,1,0,0,12
52279,pūjitakavīnaṃ,pujitakavinam,1,1,0,0,13
52280,vacanavisesesu,vacanavisesesu,3,3,0,0,14
52281,gammamānaṃ,gammamanam,4,4,0,0,10
52282,atthaleso,atthaleso,1,1,0,0,9
52283,aṅganāsu,anganasu,1,0,1,0,8
52284,vanitāsu,vanitasu,3,3,0,0,8
52285,pasiddhāvayavātirittaṃ,pasiddhavayavatirittam,2,0,2,0,22
52286,hatthapādādipākaṭasarīrāvayavato,hatthapadadipakatasariravayavato,1,1,0,0,32
52287,lāvaṇyamiva,lavanyamiva,1,0,1,0,11
52288,manogocarībhūtasundarattaṃ,manogocaribhutasundarattam,1,1,0,0,26
52289,pakāsasaddāvayavato,pakasasaddavayavato,1,1,0,0,19
52290,ābhāti,abhati,17,4,13,0,6
52291,abhidhānādivaṇṇanā,abhidhanadivannana,1,1,0,0,18
52292,toseyyamete,toseyyamete,1,0,1,0,11
52293,laṅkārene,lankarene,1,0,1,0,9
52294,sameso,sameso,1,0,1,0,6
52295,alaṅkāravajjite,alankaravajjite,2,0,2,0,15
52296,ābharaṇehi,abharanehi,13,13,0,0,10
52297,ganthavisesehi,ganthavisesehi,2,2,0,0,14
52298,yathāvuttavajjitā,yathavuttavajjita,1,1,0,0,17
52299,yatipote,yatipote,1,1,0,0,8
52300,anurūpena,anurupena,40,36,4,0,9
52301,viraciyamānattābhinavabhāvato,viraciyamanattabhinavabhavato,1,1,0,0,29
52302,dasabalavadanakamalamajjhavāsitabhāsitaviracitabhāvato,dasabalavadanakamalamajjhavasitabhasitaviracitabhavato,1,1,0,0,54
52303,anucchavikena,anucchavikena,8,8,0,0,13
52304,ābharaṇena,abharanena,4,4,0,0,10
52305,alaṅkārasatthena,alankarasatthena,1,1,0,0,16
52306,toseyyaṃ,toseyyam,2,0,2,0,8
52307,apināma,apinama,4,2,2,0,7
52308,yathicchitapasādhanavasena,yathicchitapasadhanavasena,1,1,0,0,26
52309,savanadhāraṇādivasena,savanadharanadivasena,4,4,0,0,21
52310,vaḷañjanena,valanjanena,2,2,0,0,11
52311,santuṭṭhe,santutthe,6,6,0,0,9
52312,yannūnāti,yannunati,5,1,4,0,9
52313,tādisasantuṭṭhijanakālaṅkārapakaraṇappayogo,tadisasantutthijanakalankarapakaranappayogo,1,1,0,0,43
52314,alaṅkaronti,alankaronti,15,15,0,0,11
52315,attabhāvamanenāti,attabhavamanenati,1,1,0,0,17
52316,hārakeyūrādi,harakeyuradi,2,2,0,0,12
52317,bandhasarīramanenāti,bandhasariramanenati,1,1,0,0,20
52318,pasādādayo,pasadadayo,5,5,0,0,10
52319,saddālaṅkārā,saddalankara,4,4,0,0,12
52320,sabhāvavutyādayo,sabhavavutyadayo,3,3,0,0,16
52321,atthālaṅkārā,atthalankara,6,6,0,0,12
52322,nānappakārā,nanappakara,75,74,1,0,11
52323,saddatthasaṅkhātaṃ,saddatthasankhatam,1,1,0,0,18
52324,bandhasarīraṃ,bandhasariram,9,9,0,0,13
52325,purisasarīre,purisasarire,1,1,0,0,12
52326,hārakeyūrādyalaṅkāro,harakeyuradyalankaro,1,1,0,0,20
52327,nyasyate,nyasyate,1,1,0,0,8
52328,bandhasarīrepi,bandhasarirepi,1,1,0,0,14
52329,nikkhipīyanti,nikkhipiyanti,2,2,0,0,13
52330,pāpentulaṅkārā,papentulankara,1,1,0,0,14
52331,atthālaṅkārasahite,atthalankarasahite,1,1,0,0,18
52332,ccādikañca,ccadikanca,2,2,0,0,10
52333,alaṅkāravidhānabhāvena,alankaravidhanabhavena,1,1,0,0,22
52334,bandhasarīrampi,bandhasarirampi,1,1,0,0,15
52335,tappaṭipādakaṃ,tappatipadakam,1,1,0,0,14
52336,subodhālaṅkāranāmadheyyasatthaṃ,subodhalankaranamadheyyasattham,1,1,0,0,31
52337,alaṅkatapaṭipādakattena,alankatapatipadakattena,1,1,0,0,23
52338,maṅgalasuttanti,mangalasuttanti,1,1,0,0,15
52339,kavivācānamalaṅkārappakāsako,kavivacanamalankarappakasako,2,1,1,0,28
52340,mukhyolaṅkārasaddoyaṃ,mukhyolankarasaddoyam,2,2,0,0,21
52341,saddatthālaṅkatissito,saddatthalankatissito,2,2,0,0,21
52342,sāmatthiyā,samatthiya,79,79,0,0,10
52343,tvadhiṭṭhāne,tvadhitthane,2,2,0,0,12
52344,satthepi,satthepi,4,4,0,0,8
52345,tabbatī,tabbati,4,4,0,0,7
52346,anenassābhidheyyādīni,anenassabhidheyyadini,1,1,0,0,21
52347,abhidheyyaṃ,abhidheyyam,12,12,0,0,11
52348,satthena,satthena,205,202,3,0,8
52349,vacanīyattho,vacaniyattho,5,4,1,0,12
52350,sarīrālaṅkāravibhāgakappanāya,sariralankaravibhagakappanaya,1,1,0,0,29
52351,subodhālaṅkārena,subodhalankarena,1,1,0,0,16
52352,paṭipādīyanti,patipadiyanti,2,2,0,0,13
52353,paṭipādīyati,patipadiyati,4,4,0,0,12
52354,abhidheyyasatthopi,abhidheyyasatthopi,1,1,0,0,18
52355,dassitameva,dassitameva,46,46,0,0,11
52356,sarīrālaṅkārasaṅkharaṇaṃ,sariralankarasankharanam,1,1,0,0,24
52357,subodhālaṅkārappavattito,subodhalankarappavattito,1,1,0,0,24
52358,yamuddissa,yamuddissa,4,4,0,0,10
52359,kavittakittipasiddhādilakkhaṇaṃ,kavittakittipasiddhadilakkhanam,1,1,0,0,31
52360,paramparāya,paramparaya,110,110,0,0,11
52361,tadatthatāya,tadatthataya,7,7,0,0,12
52362,subodhālaṅkārasaṅkharaṇassa,subodhalankarasankharanassa,1,1,0,0,27
52363,satthapayojanānaṃ,satthapayojananam,1,1,0,0,17
52364,sādhiyasādhanalakkhaṇo,sadhiyasadhanalakkhano,2,2,0,0,22
52365,nissayapadassinā,nissayapadassina,1,1,0,0,16
52366,dassitoyeva,dassitoyeva,21,20,1,0,11
52367,vuttātaṃvuttiyāyeva,vuttatamvuttiyayeva,1,1,0,0,19
52368,abhidheyyādikathanañca,abhidheyyadikathananca,1,1,0,0,22
52369,taṃsamaṅgisseva,tamsamangisseva,1,1,0,0,15
52370,vīmaṃsāvisesasamaṅgīnamupādīyamānattā,vimamsavisesasamanginamupadiyamanatta,1,1,0,0,37
52371,aññādisassa,annadisassa,1,1,0,0,11
52372,ummattakavacanādino,ummattakavacanadino,1,1,0,0,19
52373,heyyattā,heyyatta,3,3,0,0,8
52374,vākyanti,vakyanti,17,17,0,0,8
52375,vākyalakkhaṇopetamantaravākyasannicayaṃ,vakyalakkhanopetamantaravakyasannicayam,1,1,0,0,39
52376,mahāvākyasarūpaṃ,mahavakyasarupam,1,1,0,0,16
52377,satthamevādhippetaṃ,satthamevadhippetam,1,1,0,0,19
52378,ābharaṇavisesehi,abharanavisesehi,1,1,0,0,16
52379,vajjite,vajjite,4,4,0,0,7
52380,virahite,virahite,3,3,0,0,8
52381,suddhamāgadhike,suddhamagadhike,1,1,0,0,15
52382,suddhamāgadhikānaṃ,suddhamagadhikanam,2,2,0,0,18
52383,abhinavabhāvato,abhinavabhavato,2,2,0,0,15
52384,māgadhikasarūpaṃ,magadhikasarupam,1,1,0,0,16
52385,anugatarūpena,anugatarupena,1,1,0,0,13
52386,dasabalabhāsitaviracitattā,dasabalabhasitaviracitatta,1,1,0,0,26
52387,anukūlena,anukulena,3,3,0,0,9
52388,ābharaṇavisesena,abharanavisesena,2,2,0,0,16
52389,ganthavisesena,ganthavisesena,1,1,0,0,14
52390,alaṅkāravaḷañjāpanena,alankaravalanjapanena,1,1,0,0,21
52391,ganthavisaye,ganthavisaye,2,2,0,0,12
52392,uggahaṇadhāraṇādikārāpanena,uggahanadharanadikarapanena,1,1,0,0,27
52393,yaṃnūna,yamnuna,130,128,2,0,7
52394,sundaramiti,sundaramiti,1,1,0,0,11
52395,alaṅkārapakaraṇappayogo,alankarapakaranappayogo,1,1,0,0,23
52396,apināmāti,apinamati,1,0,1,0,9
52397,tisaddo,tisaddo,6,6,0,0,7
52398,gamyamāno,gamyamano,1,1,0,0,9
52399,alaṅkārehi,alankarehi,19,19,0,0,10
52400,vajjitā,vajjita,14,14,0,0,7
52401,anugataṃ,anugatam,43,39,4,0,8
52402,attabhāvamaneneti,attabhavamaneneti,1,1,0,0,17
52403,ābharaṇapakkhe,abharanapakkhe,1,1,0,0,14
52404,ganthapakkhe,ganthapakkhe,1,1,0,0,12
52405,bandhasarīramaneneti,bandhasariramaneneti,1,1,0,0,20
52406,mukhyabhāvena,mukhyabhavena,4,4,0,0,13
52407,pasādādisaddālaṅkārā,pasadadisaddalankara,2,2,0,0,20
52408,sabhāvavutyādiatthālaṅkārā,sabhavavutyadiatthalankara,2,2,0,0,26
52409,pavuccanti,pavuccanti,31,30,1,0,10
52410,amukhyato,amukhyato,1,1,0,0,9
52411,alaṅkārānamadhiṭṭhānabhūtabandhasarīrampi,alankaranamadhitthanabhutabandhasarirampi,1,1,0,0,41
52412,maṅgalasuttaratanasuttādivohāro,mangalasuttaratanasuttadivoharo,1,1,0,0,31
52413,alaṅkārapakāsakaṃ,alankarapakasakam,1,1,0,0,17
52414,laddhasubodhālaṅkāravaranāmadheyyasatthampi,laddhasubodhalankaravaranamadheyyasatthampi,1,1,0,0,43
52415,vuttamidameva,vuttamidameva,1,1,0,0,13
52416,tadādhāratappaṭipādakattavohārato,tadadharatappatipadakattavoharato,1,1,0,0,33
52417,tadādheyyatappaṭipādanīyaṃ,tadadheyyatappatipadaniyam,1,1,0,0,26
52418,aññathānupapattilakkhaṇamevāti,annathanupapattilakkhanamevati,1,1,0,0,30
52419,paññānekasatthantarocitā,pannanekasatthantarocita,1,0,1,0,24
52420,sammohabbhāhatāve,sammohabbhahatave,1,0,1,0,17
52421,gurūnī,guruni,1,0,1,0,6
52422,garūniha,garuniha,1,1,0,0,8
52423,sādhūvivekino,sadhuvivekino,2,1,1,0,13
52424,para4-5,para4-5,9,9,0,0,7
52425,lakkhaṇārambhapaṭikkhepakajanapaṭibāhanapubbakamabhidheyyādikaṃ,lakkhanarambhapatikkhepakajanapatibahanapubbakamabhidheyyadikam,1,1,0,0,63
52426,satthatova,satthatova,1,1,0,0,10
52427,guṇadosavivecanaṃ,gunadosavivecanam,5,5,0,0,17
52428,satthatoyeva,satthatoyeva,4,4,0,0,12
52429,kimatodhikaṃ,kimatodhikam,3,3,0,0,12
52430,guṇadosavibhāgavicāraṇaṃ,gunadosavibhagavicaranam,1,1,0,0,24
52431,tabbidūnaṃyeva,tabbidunamyeva,1,1,0,0,14
52432,nāsatthaññūnaṃ,nasatthannunam,1,1,0,0,14
52433,purisapasūnaṃ,purisapasunam,1,1,0,0,13
52434,cāha,caha,137,132,5,0,4
52435,guṇadosamasatthaññū,gunadosamasatthannu,3,3,0,0,19
52436,vibhajate,vibhajate,9,8,1,0,9
52437,kimandhassa,kimandhassa,3,3,0,0,11
52438,rūpabhedopaladdhiyaṃ,rupabhedopaladdhiyam,4,3,1,0,20
52439,kābyādāsa,kabyadasa,13,13,0,0,9
52440,yenevaṃ,yenevam,15,15,0,0,7
52441,tenettha,tenettha,45,45,0,0,8
52442,guṇadosadassane,gunadosadassane,1,1,0,0,15
52443,pasannānekasatthacakkhuyevādhigato,pasannanekasatthacakkhuyevadhigato,1,1,0,0,34
52444,nañño,nanno,4,4,0,0,5
52445,tabbiparītotyanvayabyatirekavasena,tabbiparitotyanvayabyatirekavasena,1,1,0,0,34
52446,itiādigāthādvayamāha,itiadigathadvayamaha,4,4,0,0,20
52447,aniyamuddeso,aniyamuddeso,4,4,0,0,12
52448,yehīti,yehiti,30,9,21,0,6
52449,rāsikatā,rasikata,5,5,0,0,8
52450,nānāsantānavuttinīpi,nanasantanavuttinipi,1,1,0,0,20
52451,ekattanayena,ekattanayena,19,18,1,0,12
52452,naparibhāvitāti,naparibhavitati,1,1,0,0,15
52453,heyyopādeyyavivekarūpā,heyyopadeyyavivekarupa,1,1,0,0,22
52454,kīdisīti,kidisiti,4,3,1,0,8
52455,anekasatthantarocitā,anekasatthantarocita,1,0,1,0,20
52456,anekasmiṃ,anekasmim,4,3,1,0,9
52457,tipiṭakatakkabyākaraṇālaṅkārasatthādike,tipitakatakkabyakaranalankarasatthadike,1,1,0,0,39
52458,satthantare,satthantare,3,3,0,0,11
52459,ucitā,ucita,2,0,2,0,5
52460,paricitā,paricita,158,155,3,0,8
52461,sañcitāti,sancitati,1,1,0,0,9
52462,yathāuddiṭṭhānaṃ,yathaudditthanam,3,3,0,0,16
52463,niyamavacanaṃ,niyamavacanam,10,10,0,0,13
52464,sammohabbhāhatāti,sammohabbhahatati,1,0,1,0,17
52465,yathāvuttāyātisayavatiyā,yathavuttayatisayavatiya,1,1,0,0,24
52466,paññāyābhāvato,pannayabhavato,1,1,0,0,14
52467,balappattena,balappattena,3,3,0,0,12
52468,mohena,mohena,163,162,1,0,6
52469,abbhāhatā,abbhahata,8,8,0,0,9
52470,evasadditā,evasaddita,1,1,0,0,10
52471,tasmāpi,tasmapi,110,109,1,0,7
52472,heyyopādeyyarūpaṃ,heyyopadeyyarupam,1,1,0,0,17
52473,kiñcideva,kincideva,215,205,10,0,9
52474,aṭṭhānāniyojakatādisagurupādasussūsānissayapaṭiladdhavivekapaññāti,atthananiyojakatadisagurupadasussusanissayapatiladdhavivekapannati,1,1,0,0,66
52475,sayālābhena,sayalabhena,1,1,0,0,11
52476,jānantītyattho,janantityattho,1,1,0,0,14
52477,ālasiyādidosalesapariggahopi,alasiyadidosalesapariggahopi,1,1,0,0,28
52478,satatācariyasevanavasena,satatacariyasevanavasena,1,1,0,0,24
52479,sirovikiṇṇatādisagurupādapaṅkajambujaparāyano,sirovikinnatadisagurupadapankajambujaparayano,1,1,0,0,45
52480,cirenapi,cirenapi,2,2,0,0,8
52481,nānāvidhasatthantarakataparicayabalena,nanavidhasatthantarakataparicayabalena,1,1,0,0,38
52482,paññāveyattiyaṃ,pannaveyattiyam,2,2,0,0,15
52483,nihīyati,nihiyati,37,34,3,0,8
52484,nihīnasevī,nihinasevi,10,10,0,0,10
52485,hāyetha,hayetha,26,26,0,0,7
52486,tulyasevī,tulyasevi,8,8,0,0,9
52487,seṭṭhamupanamaṃ,setthamupanamam,6,5,1,0,15
52488,uttaritaraṃ,uttaritaram,100,91,9,0,11
52489,bhajethā,bhajetha,5,5,0,0,8
52490,paññavāyevettha,pannavayevettha,1,1,0,0,15
52491,guṇadosavibhāgavivecane,gunadosavibhagavivecane,1,1,0,0,23
52492,adhikārī,adhikari,1,1,0,0,8
52493,purisapasūti,purisapasuti,1,1,0,0,12
52494,ayametthādhippāyo,ayametthadhippayo,35,35,0,0,17
52495,ruḷho,rulho,8,8,0,0,5
52496,atthaviseso,atthaviseso,25,24,1,0,11
52497,gurūnihā,guruniha,1,0,1,0,8
52498,gurūnaṃ,gurunam,6,4,2,0,7
52499,pādaparicariyā,padaparicariya,2,2,0,0,14
52500,paññāveyattiyarasānabhiññehi,pannaveyattiyarasanabhinnehi,1,1,0,0,28
52501,lesamattampi,lesamattampi,8,8,0,0,12
52502,anadhigatāyevettha,anadhigatayevettha,1,1,0,0,18
52503,byatirekamukhena,byatirekamukhena,68,68,0,0,16
52504,katapuññatādisampattisampannā,katapunnatadisampattisampanna,1,1,0,0,29
52505,tappādarajehi,tappadarajehi,1,0,1,0,13
52506,pādadhūlīhi,padadhulihi,1,1,0,0,11
52507,onaddhā,onaddha,12,10,2,0,7
52508,gavacchitā,gavacchita,2,2,0,0,10
52509,teva,teva,187,177,10,0,4
52510,paññāveyattiyena,pannaveyattiyena,1,1,0,0,16
52511,abhiññātā,abhinnata,145,136,9,0,9
52512,heyyopādeyyaguṇadosavibhāganiyamanapaññāsampattisamaṅgino,heyyopadeyyagunadosavibhaganiyamanapannasampattisamangino,1,1,0,0,57
52513,teyevettha,teyevettha,1,1,0,0,10
52514,guṇadosavivecane,gunadosavivecane,1,1,0,0,16
52515,adhigatāti,adhigatati,12,10,2,0,10
52516,gurupādasussūsā,gurupadasussusa,1,1,0,0,15
52517,visiṭṭhādarena,visitthadarena,1,1,0,0,14
52518,karaṇīyāti,karaniyati,11,5,6,0,10
52519,tadabhyāse,tadabhyase,1,1,0,0,10
52520,sādhujane,sadhujane,5,5,0,0,9
52521,sakalasatthaparicitaññāṇapāṭavā,sakalasatthaparicitannanapatava,1,1,0,0,31
52522,dosamāropayanti,dosamaropayanti,1,1,0,0,15
52523,taddosanirākaraṇaṃ,taddosanirakaranam,1,1,0,0,18
52524,padesāvabodhanamattena,padesavabodhanamattena,1,1,0,0,22
52525,paṇḍitamānīnaṃ,panditamaninam,4,4,0,0,14
52526,vacanassāgurukaraṇaṃ,vacanassagurukaranam,1,1,0,0,20
52527,taṃdvāreneva,tamdvareneva,1,1,0,0,12
52528,anaññasādhāraṇagurugāravataṃ,anannasadharanagurugaravatam,1,1,0,0,28
52529,sādhujanehi,sadhujanehi,8,8,0,0,11
52530,paramādarena,paramadarena,1,1,0,0,12
52531,sampādetabbamiti,sampadetabbamiti,1,1,0,0,16
52532,kino,kino,1,0,1,0,4
52533,gāthādvayamāha,gathadvayamaha,150,150,0,0,14
52534,anekasatthānaṃ,anekasatthanam,1,0,1,0,14
52535,tipiṭakatakkabyākaraṇādīnaṃ,tipitakatakkabyakaranadinam,1,1,0,0,27
52536,tatvatthasaṅkhātaabbhantare,tatvatthasankhataabbhantare,1,1,0,0,27
52537,savanauggahaṇadhāraṇādivasena,savanauggahanadharanadivasena,1,1,0,0,29
52538,sutamayā,sutamaya,27,22,5,0,8
52539,dvinnamekakkhaṇe,dvinnamekakkhane,1,1,0,0,16
52540,pavattiyābhāvepi,pavattiyabhavepi,1,1,0,0,16
52541,upacitasamūhabhāvato,upacitasamuhabhavato,1,1,0,0,20
52542,pubbakālikapaññāya,pubbakalikapannaya,1,1,0,0,18
52543,aparakālikapaññāya,aparakalikapannaya,1,1,0,0,18
52544,anantaraāsevanādipaccayalābhato,anantaraasevanadipaccayalabhato,1,1,0,0,31
52545,avatthabāhullapavattito,avatthabahullapavattito,1,1,0,0,23
52546,sañcitabbāpi,sancitabbapi,1,1,0,0,12
52547,īdisapaññāpāṭavarahitā,idisapannapatavarahita,1,1,0,0,22
52548,sammohabbhāhatā,sammohabbhahata,1,0,1,0,15
52549,paññāpāṭavābhāvato,pannapatavabhavato,1,1,0,0,18
52550,heyyopādeyyaṃ,heyyopadeyyam,2,2,0,0,13
52551,aneketi,aneketi,2,1,1,0,7
52552,tesamantaramiti,tesamantaramiti,1,1,0,0,15
52553,ucitāti,ucitati,2,2,0,0,7
52554,sammohena,sammohena,11,10,1,0,9
52555,abbhāhatāti,abbhahatati,2,1,1,0,11
52556,asatthaññū,asatthannu,1,1,0,0,10
52557,guṇadosaṃ,gunadosam,11,11,0,0,9
52558,nīlapītādirūpavisesāvabodhane,nilapitadirupavisesavabodhane,1,1,0,0,29
52559,abhimukhakaraṇaṃ,abhimukhakaranam,1,1,0,0,16
52560,bhavatyeva,bhavatyeva,10,10,0,0,10
52561,anekasatthantaragatasuppasannapaññācakkhunā,anekasatthantaragatasuppasannapannacakkhuna,1,1,0,0,43
52562,tadabhāve,tadabhave,61,61,0,0,9
52563,satthocitatādisapaññaṃ,satthocitatadisapannam,1,1,0,0,22
52564,guṇāguṇavibhāgaṃ,gunagunavibhagam,1,1,0,0,16
52565,atodhikaṃ,atodhikam,1,0,1,0,9
52566,anupaparikkhanakiriyā,anupaparikkhanakiriya,1,1,0,0,21
52567,akatapuññānaṃ,akatapunnanam,17,15,2,0,13
52568,niyojako,niyojako,23,22,1,0,8
52569,niddiṭṭhaguṇopetānaṃ,nidditthagunopetanam,1,1,0,0,20
52570,ācariyānaṃ,acariyanam,187,175,12,0,10
52571,katapuññā,katapunna,27,26,1,0,9
52572,pādarajehi,padarajehi,1,1,0,0,10
52573,kalyāṇamittagurupāsanāhi,kalyanamittagurupasanahi,1,1,0,0,24
52574,adhigatavisiṭṭhavivekabuddhino,adhigatavisitthavivekabuddhino,1,1,0,0,30
52575,kattabbapādaparicariyāpi,kattabbapadaparicariyapi,1,1,0,0,24
52576,sussūsāti,sussusati,7,4,3,0,9
52577,pādāti,padati,17,10,7,0,6
52578,rajānīti,rajaniti,5,2,3,0,8
52579,okiṇṇāti,okinnati,1,1,0,0,8
52580,sakalābhibuddhiyā,sakalabhibuddhiya,1,1,0,0,17
52581,gurupaṭibaddhattā,gurupatibaddhatta,1,1,0,0,17
52582,adhikatarāyeva,adhikatarayeva,1,1,0,0,14
52583,sevitabbā,sevitabba,112,106,6,0,9
52584,kabbanāṭakanikkhittanettacittā,kabbanatakanikkhittanettacitta,3,1,2,0,30
52585,paṭibhāvanto,patibhavanto,3,0,3,0,12
52586,viññūye,vinnuye,1,0,1,0,7
52587,tatthāpya,tatthapya,1,0,1,0,9
52588,vihitādarā,vihitadara,1,0,1,0,10
52589,para6-7,para6-7,5,5,0,0,7
52590,evametthānvayabyatirekavasenādhigate,evametthanvayabyatirekavasenadhigate,1,1,0,0,36
52591,kabbanāṭakaparicayābhāveracanāvisesābhiyogopajanitaparissamenā,kabbanatakaparicayabhaveracanavisesabhiyogopajanitaparissamena,1,1,0,0,62
52592,olīnavuttino,olinavuttino,1,1,0,0,12
52593,sotujane,sotujane,3,3,0,0,8
52594,samussāheti,samussaheti,3,3,0,0,11
52595,kabbanāṭakā,kabbanataka,2,0,2,0,11
52596,itiādinā,itiadina,7577,7569,8,0,8
52597,kavippayogasaṅkhāto,kavippayogasankhato,1,1,0,0,19
52598,bandhova,bandhova,1,1,0,0,8
52599,kabbaṃ,kabbam,27,21,6,0,6
52600,muttakādivākyasvamuttikādyavayavasabhāvā,muttakadivakyasvamuttikadyavayavasabhava,1,1,0,0,40
52601,antaravākyasamudāyasampannaṃ,antaravakyasamudayasampannam,1,1,0,0,28
52602,vuttajātibhedabhinnaṃ,vuttajatibhedabhinnam,1,1,0,0,21
52603,pajjamayaṃ,pajjamayam,2,2,0,0,10
52604,gajjamayaṃ,gajjamayam,2,2,0,0,10
52605,pajjagajjamayaṃ,pajjagajjamayam,2,2,0,0,15
52606,campūnāmakañca,campunamakanca,1,1,0,0,14
52607,mahāvākyarūpaṃ,mahavakyarupam,1,1,0,0,14
52608,mahākabbañca,mahakabbanca,1,1,0,0,12
52609,mahākabbaṃ,mahakabbam,2,1,1,0,10
52610,saggehi,saggehi,1,1,0,0,7
52611,sagganāmakehi,sagganamakehi,1,1,0,0,13
52612,paricchedavisesehi,paricchedavisesehi,2,2,0,0,18
52613,bandhyate,bandhyate,1,1,0,0,9
52614,saggabandhoti,saggabandhoti,1,1,0,0,13
52615,saggabandhassa,saggabandhassa,1,1,0,0,14
52616,iṭṭhāsīsanaṃ,itthasisanam,1,1,0,0,12
52617,bandhasambandhino,bandhasambandhino,1,1,0,0,17
52618,anekadhā,anekadha,138,135,3,0,8
52619,vaṇṇenti,vannenti,89,89,0,0,8
52620,saggabandho,saggabandho,3,2,1,0,11
52621,mahākabbamuccate,mahakabbamuccate,2,2,0,0,16
52622,tvassa,tvassa,3,3,0,0,6
52623,vatthuniddeso,vatthuniddeso,4,3,1,0,13
52624,āsīsāpi,asisapi,3,2,1,0,7
52625,tammukhaṃ,tammukham,6,5,1,0,9
52626,itihāsakathubbhūtaṃ,itihasakathubbhutam,4,2,2,0,19
52627,santasannissayampi,santasannissayampi,3,2,1,0,18
52628,catuvaggaphalāyattaṃ,catuvaggaphalayattam,4,2,2,0,20
52629,caturodāttanāyakaṃ,caturodattanayakam,4,2,2,0,18
52630,puraṇṇavutuselindusavitūdayavaṇṇanaṃ,purannavutuselindusavitudayavannanam,3,2,1,0,36
52631,uyyānasalilakkīḷā,uyyanasalilakkila,2,2,0,0,17
52632,madhupānaratussavaṃ,madhupanaratussavam,2,2,0,0,19
52633,vippalambhavivāhehi,vippalambhavivahehi,3,2,1,0,19
52634,kumārodayavaḍḍhihi,kumarodayavaddhihi,3,2,1,0,18
52635,mantadūtappayānājināyakābhyūdayehipi,mantadutappayanajinayakabhyudayehipi,2,2,0,0,36
52636,alaṅkatamasaṃkhittarasabhāvanirantaraṃ,alankatamasamkhittarasabhavanirantaram,2,2,0,0,38
52637,nātivitthiṇṇasaggehi,nativitthinnasaggehi,3,2,1,0,20
52638,piyavuttasusandhibhi,piyavuttasusandhibhi,3,2,1,0,20
52639,bhinnasaggantehupetaṃ,bhinnasaggantehupetam,2,2,0,0,21
52640,lokarañjakaṃ,lokaranjakam,4,3,1,0,12
52641,kappantaraṭṭhāyi,kappantaratthayi,3,2,1,0,16
52642,sādhvalaṅkatī,sadhvalankati,2,2,0,0,13
52643,purāvuttakathāsannissayaṃ,puravuttakathasannissayam,2,2,0,0,25
52644,santasannissayaṃ,santasannissayam,1,0,1,0,16
52645,itarasobhanādhikaraṇaguṇarājacaritādinissayaṃ,itarasobhanadhikaranagunarajacaritadinissayam,1,1,0,0,45
52646,dhammādicatuvaggaphalāyattaṃ,dhammadicatuvaggaphalayattam,1,1,0,0,28
52647,abbhūdayanibbānahetuko,abbhudayanibbanahetuko,1,1,0,0,22
52648,vijjābhumyādīnaṃ,vijjabhumyadinam,1,1,0,0,16
52649,yathāññāyamajjanaṃ,yathannayamajjanam,1,1,0,0,18
52650,ajjitānañca,ajjitananca,1,1,0,0,11
52651,sabbasaṃsāradukkhanivatti,sabbasamsaradukkhanivatti,1,1,0,0,25
52652,ussāhasattimantasattipabhūsattiyogena,ussahasattimantasattipabhusattiyogena,1,1,0,0,37
52653,cāgātisayādiyogena,cagatisayadiyogena,2,2,0,0,18
52654,udātto,udatto,2,2,0,0,6
52655,vippalambho,vippalambho,3,2,1,0,11
52656,viraho,viraho,2,2,0,0,6
52657,nītivedīhi,nitivedihi,1,1,0,0,10
52658,kārīyanicchayo,kariyanicchayo,1,1,0,0,14
52659,dūto,duto,142,133,9,0,4
52660,sandhānappavatto,sandhanappavatto,1,1,0,0,16
52661,payānaṃ,payanam,2,0,2,0,7
52662,saṅgāmādinimittagamanaṃ,sangamadinimittagamanam,1,1,0,0,23
52663,sandhyābhāve,sandhyabhave,1,1,0,0,12
52664,asaṅkhattarasabhāvanirantaraṃ,asankhattarasabhavanirantaram,1,0,1,0,29
52665,asaṃkhittā,asamkhitta,2,2,0,0,10
52666,siṅgāravīrādayo,singaraviradayo,1,1,0,0,15
52667,ratiussāhādayo,ratiussahadayo,2,2,0,0,14
52668,patthaṭaṃ,patthatam,18,18,0,0,9
52669,piyavuttasusandhibhīti,piyavuttasusandhibhiti,1,0,1,0,22
52670,piyāni,piyani,61,54,7,0,6
52671,sutisubhagāni,sutisubhagani,1,1,0,0,13
52672,indavajirādīni,indavajiradini,1,1,0,0,14
52673,aññamaññasambandhasaṃsaggatāya,annamannasambandhasamsaggataya,1,1,0,0,30
52674,aññamaññasaṅgahā,annamannasangaha,1,1,0,0,16
52675,saggānaṃ,sagganam,11,11,0,0,8
52676,tehīti,tehiti,88,13,75,0,6
52677,nagaravaṇṇanādīsu,nagaravannanadisu,1,1,0,0,17
52678,madhupānādirahitampi,madhupanadirahitampi,1,1,0,0,20
52679,taññūnaṃ,tannunam,2,2,0,0,8
52680,upādiyateva,upadiyateva,4,4,0,0,11
52681,dussataṅgehi,dussatangehi,2,2,0,0,12
52682,nyūnamapyatra,nyunamapyatra,2,2,0,0,13
52683,bandhaṅgasampadā,bandhangasampada,3,2,1,0,16
52684,taññū,tannu,4,3,1,0,5
52685,kāmamārādhayanti,kamamaradhayanti,2,2,0,0,16
52686,nirākaraṇamiccesa,nirakaranamiccesa,2,2,0,0,17
52687,pakatisundaro,pakatisundaro,2,2,0,0,13
52688,vaṃsavīrasutādīni,vamsavirasutadini,2,2,0,0,17
52689,vaṇṇayitvā,vannayitva,9,9,0,0,10
52690,ripussapi,ripussapi,2,2,0,0,9
52691,tajjayā,tajjaya,2,2,0,0,7
52692,nāyakukkaṃsakathanañca,nayakukkamsakathananca,2,2,0,0,22
52693,sukheti,sukheti,114,108,6,0,7
52694,sabbampetaṃ,sabbampetam,90,88,2,0,11
52695,saddhammāmatarasapānasarasahadayānaṃ,saddhammamatarasapanasarasahadayanam,1,1,0,0,36
52696,samphappalāpavipulavisappavesopaddutakabbanāṭakaparammukhānaṃ,samphappalapavipulavisappavesopaddutakabbanatakaparammukhanam,1,1,0,0,61
52697,satatacaritasañcaritaratanabhājanānaṃ,satatacaritasancaritaratanabhajananam,1,1,0,0,37
52698,hadayakhedopajanitaparissameneti,hadayakhedopajanitaparissameneti,1,1,0,0,32
52699,tadanurūpamevopadassitanti,tadanurupamevopadassitanti,1,1,0,0,26
52700,nāṭakaṃ,natakam,19,14,5,0,7
52701,bharatādināṭyasatthe,bharatadinatyasatthe,1,1,0,0,20
52702,nānappakāranirūpitarūpaṃ,nanappakaranirupitarupam,1,1,0,0,24
52703,taṃlakkhaṇekadesabhūtalakkhaṇāni,tamlakkhanekadesabhutalakkhanani,1,1,0,0,32
52704,pakaraṇādīni,pakaranadini,1,1,0,0,12
52705,nāṭikā,natika,3,3,0,0,6
52706,etthevāvarumbhanti,etthevavarumbhanti,1,1,0,0,18
52707,kabbañca,kabbanca,3,3,0,0,8
52708,nāṭakañca,natakanca,2,2,0,0,9
52709,nikkhittaṃ,nikkhittam,224,212,12,0,10
52710,nettañca,nettanca,6,5,1,0,8
52711,nikkhittanettacitta,nikkhittanettacitta,1,0,1,0,19
52712,cintanañca,cintananca,1,1,0,0,10
52713,ūhāpohamukhena,uhapohamukhena,1,1,0,0,14
52714,yathuggahitaniyāmaṃ,yathuggahitaniyamam,1,1,0,0,19
52715,aviparītatthanicchayanaṃ,aviparitatthanicchayanam,1,1,0,0,24
52716,nicchitassa,nicchitassa,1,1,0,0,11
52717,nirantarābhiyogo,nirantarabhiyogo,2,2,0,0,16
52718,kabbanāṭaka,kabbanataka,1,0,1,0,11
52719,cintitaṃ,cintitam,79,74,5,0,8
52720,bhāvitañca,bhavitanca,1,1,0,0,10
52721,dassite,dassite,104,104,0,0,7
52722,tannissayaṃ,tannissayam,3,3,0,0,11
52723,sutamayañāṇampi,sutamayananampi,1,1,0,0,15
52724,sutacintābhāvanānukkamena,sutacintabhavananukkamena,1,1,0,0,25
52725,sampāditapaññāpāṭavānaṃ,sampaditapannapatavanam,1,1,0,0,23
52726,kabbaracanāya,kabbaracanaya,1,1,0,0,13
52727,tādisānaṃ,tadisanam,98,94,4,0,9
52728,taṃsutādi,tamsutadi,1,1,0,0,9
52729,bandhanakāraṇaṃ,bandhanakaranam,2,2,0,0,15
52730,sābhāvikī,sabhaviki,4,3,1,0,9
52731,sutañca,sutanca,71,66,5,0,7
52732,nimmalaṃ,nimmalam,47,44,3,0,8
52733,amando,amando,4,3,1,0,6
52734,cābhiyogoyaṃ,cabhiyogoyam,2,2,0,0,12
52735,hotiha,hotiha,3,3,0,0,6
52736,yaṃkiñcīti,yamkinciti,15,3,12,0,10
52737,cittāruḷhaṃ,cittarulham,1,1,0,0,11
52738,bandhajātaṃ,bandhajatam,2,2,0,0,11
52739,aniyamavacanena,aniyamavacanena,4,4,0,0,15
52740,ādarābhāvaṃ,adarabhavam,1,1,0,0,11
52741,racayanti,racayanti,2,0,2,0,9
52742,accantameva,accantameva,110,105,5,0,11
52743,tādisopāyasampattisampannassa,tadisopayasampattisampannassa,1,1,0,0,29
52744,upeyyasampattisabbhāvato,upeyyasampattisabbhavato,1,1,0,0,24
52745,anacchariyamevāti,anacchariyamevati,1,1,0,0,17
52746,kabbanāṭakesu,kabbanatakesu,5,5,0,0,13
52747,racanāvisesaekantopāyabhūtesu,racanavisesaekantopayabhutesu,1,1,0,0,29
52748,avihitādarāapi,avihitadaraapi,1,0,1,0,14
52749,sutādivasena,sutadivasena,1,1,0,0,12
52750,akatādarāpi,akatadarapi,1,1,0,0,11
52751,bandhavisesena,bandhavisesena,1,1,0,0,14
52752,guṇadosaviduno,gunadosaviduno,1,1,0,0,14
52753,satthaññuno,satthannuno,1,1,0,0,11
52754,paṇḍitajane,panditajane,2,2,0,0,11
52755,pīṇenti,pinenti,21,21,0,0,7
52756,tosentiyeva,tosentiyeva,1,1,0,0,11
52757,sābhāvikipaṭibhāvirahepi,sabhavikipatibhavirahepi,1,1,0,0,24
52758,etādisesu,etadisesu,4,4,0,0,9
52759,sutacintābhāvanāvasena,sutacintabhavanavasena,1,1,0,0,22
52760,vāyamantā,vayamanta,18,18,0,0,9
52761,pubbavāsanā,pubbavasana,2,2,0,0,11
52762,guṇānubandhi,gunanubandhi,2,2,0,0,12
52763,paṭibhānamabbhutaṃ,patibhanamabbhutam,2,2,0,0,18
52764,vācu,vacu,2,2,0,0,4
52765,ssahanenupāsitā,ssahanenupasita,2,2,0,0,15
52766,karotyeva,karotyeva,4,4,0,0,9
52767,kamapyanuggahaṃ,kamapyanuggaham,2,2,0,0,15
52768,heyyopādeyyaparicchedalakkhaṇapaññāya,heyyopadeyyaparicchedalakkhanapannaya,1,1,0,0,37
52769,kīdisāyaṃ,kidisayam,1,1,0,0,9
52770,tādisopāyantararahitānampi,tadisopayantararahitanampi,1,1,0,0,26
52771,vimhayena,vimhayena,4,4,0,0,9
52772,vattamānopi,vattamanopi,14,14,0,0,11
52773,tādisopāyasampattivirahenopeyyasampattiyā,tadisopayasampattivirahenopeyyasampattiya,1,1,0,0,41
52774,sabbhāvato,sabbhavato,73,72,1,0,10
52775,nāññoti,nannoti,10,10,0,0,7
52776,aparicitānamamhākaṃ,aparicitanamamhakam,1,1,0,0,19
52777,gantharacanāsabhāvāvabodhova,gantharacanasabhavavabodhova,1,1,0,0,28
52778,kutoti,kutoti,20,9,11,0,6
52779,osakkante,osakkante,6,6,0,0,9
52780,digāthādvayena,digathadvayena,1,1,0,0,14
52781,sutānulokanacintābhāvanāvasena,sutanulokanacintabhavanavasena,1,1,0,0,30
52782,ṭhapitanettacittā,thapitanettacitta,1,1,0,0,17
52783,kabbakārakā,kabbakaraka,1,1,0,0,11
52784,abhimataṃ,abhimatam,13,10,3,0,9
52785,acchariyakaraṃ,acchariyakaram,1,1,0,0,14
52786,nirantarābhiyogato,nirantarabhiyogato,1,1,0,0,18
52787,siddhopāyamūlapaññāsampadāya,siddhopayamulapannasampadaya,1,1,0,0,28
52788,upeyyabhūtaganthasaṅkharaṇaṃ,upeyyabhutaganthasankharanam,1,1,0,0,28
52789,bhavatyevāti,bhavatyevati,1,1,0,0,12
52790,naṭakassa,natakassa,1,1,0,0,9
52791,naccagītādi,naccagitadi,1,1,0,0,11
52792,tappaṭipādakakathāpakāsakagantho,tappatipadakakathapakasakagantho,1,1,0,0,32
52793,nāṭakañcāti,natakancati,1,1,0,0,11
52794,nettacittaṃ,nettacittam,1,1,0,0,11
52795,avihitādarāpi,avihitadarapi,1,0,1,0,13
52796,akatasambhamā,akatasambhama,1,1,0,0,13
52797,gantharacanāvisesena,gantharacanavisesena,1,1,0,0,20
52798,paṭibhānasaṅkhātapaññavanto,patibhanasankhatapannavanto,1,1,0,0,27
52799,uppajjamānavimhayena,uppajjamanavimhayena,1,1,0,0,20
52800,avihito,avihito,1,1,0,0,7
52801,bāhirasatthābhiyogābhāvepi,bahirasatthabhiyogabhavepi,1,1,0,0,26
52802,pubbavāsanābhāvepi,pubbavasanabhavepi,1,1,0,0,18
52803,nirantarābhiyogaṃ,nirantarabhiyogam,1,1,0,0,17
52804,tādisasāmatthiyaṃ,tadisasamatthiyam,1,1,0,0,17
52805,pubbavāsanāguṇānubandhī,pubbavasanagunanubandhi,1,0,1,0,23
52806,atītajātiyā,atitajatiya,4,4,0,0,11
52807,paricayavāsanāguṇassa,paricayavasanagunassa,1,1,0,0,21
52808,vijjatipi,vijjatipi,1,1,0,0,9
52809,savanena,savanena,45,44,1,0,8
52810,ussahanena,ussahanena,1,0,1,0,10
52811,paguṇakaraṇādivācussahanena,pagunakaranadivacussahanena,1,1,0,0,27
52812,upāsitā,upasita,7,5,2,0,7
52813,katagurupāsanā,katagurupasana,1,1,0,0,14
52814,kamapi,kamapi,5,4,1,0,6
52815,paññāpāṭavaṃ,pannapatavam,6,6,0,0,12
52816,evāti,evati,1147,1065,82,0,5
52817,muttakakulakādivākyavasena,muttakakulakadivakyavasena,1,1,0,0,26
52818,avayavasabhāvehi,avayavasabhavehi,1,1,0,0,16
52819,antaravākyāvayavasamūhehi,antaravakyavayavasamuhehi,1,1,0,0,25
52820,vuttavisesehi,vuttavisesehi,1,1,0,0,13
52821,pabhedagataṃ,pabhedagatam,76,74,2,0,12
52822,campūtikhyātapajjagajjamayaṃ,camputikhyatapajjagajjamayam,1,1,0,0,28
52823,mahāvākyasabhāvena,mahavakyasabhavena,1,1,0,0,18
52824,bharatādinaṭasatthagatanānappakāradassitasabhāvaṃ,bharatadinatasatthagatananappakaradassitasabhavam,1,1,0,0,49
52825,dassitalakkhaṇato,dassitalakkhanato,1,1,0,0,17
52826,ekadesayuttappakaraṇādinavarūpakāni,ekadesayuttappakaranadinavarupakani,1,1,0,0,35
52827,kabbalakkhaṇaṃ,kabbalakkhanam,1,1,0,0,14
52828,saggasaṅkhātehi,saggasankhatehi,1,1,0,0,15
52829,kākakkhigoḷakanayena,kakakkhigolakanayena,2,1,1,0,20
52830,kabbassa,kabbassa,1,1,0,0,8
52831,devatānamassanaṃ,devatanamassanam,1,1,0,0,16
52832,astyuttarasyāṃ,astyuttarasyam,1,1,0,0,14
52833,digi,digi,1,1,0,0,4
52834,devatātma,devatatma,1,1,0,0,9
52835,himālayo,himalayo,2,2,0,0,8
52836,nagādhirāja,nagadhiraja,1,1,0,0,11
52837,pūvāpareṅa,puvaparena,1,1,0,0,10
52838,vārinidhī,varinidhi,1,1,0,0,9
52839,vigāhya,vigahya,1,1,0,0,7
52840,sthita,sthita,1,1,0,0,6
52841,pathijhā,pathijha,1,1,0,0,8
52842,mānadaṇḍa,manadanda,1,1,0,0,9
52843,kumārasambhava,kumarasambhava,1,1,0,0,14
52844,iccādibandhasambandhino,iccadibandhasambandhino,1,1,0,0,23
52845,miccādiiṭṭhāsīsanaṃ,miccadiitthasisanam,1,1,0,0,19
52846,sobhanānampi,sobhananampi,1,1,0,0,12
52847,rājacariyādinissayaṃ,rajacariyadinissayam,1,1,0,0,20
52848,lokiyalokuttarasukhakāraṇaṃ,lokiyalokuttarasukhakaranam,1,1,0,0,27
52849,vijjābhūmiādīnaṃ,vijjabhumiadinam,1,1,0,0,16
52850,sañcitānaṃ,sancitanam,1,1,0,0,10
52851,apāyasaṃvattanikapañcakāmaguṇasaṅkhāto,apayasamvattanikapancakamagunasankhato,1,1,0,0,38
52852,nivattihetu,nivattihetu,1,1,0,0,11
52853,catuvaggaphalādhīnaṃ,catuvaggaphaladhinam,1,1,0,0,20
52854,ussāhasattimantasattipabhūsattiyogato,ussahasattimantasattipabhusattiyogato,1,1,0,0,37
52855,uḷāro,ularo,136,122,14,0,5
52856,aṇṇavaṃ,annavam,33,24,9,0,7
52857,sāgaraṃ,sagaram,62,57,5,0,7
52858,hemantavasantādiutu,hemantavasantadiutu,1,1,0,0,19
52859,selaṃ,selam,43,36,7,0,5
52860,indusavitūdayo,indusavitudayo,1,0,1,0,14
52861,candasūriyānaṃ,candasuriyanam,7,7,0,0,14
52862,savitāti,savitati,1,0,1,0,8
52863,uyyānasalilakkīḷāmadhupānaratussavaṃ,uyyanasalilakkilamadhupanaratussavam,1,0,1,0,36
52864,uyyānakīḷāsurāpānaratikīḷāsaṅkhāto,uyyanakilasurapanaratikilasankhato,1,1,0,0,34
52865,dārāviyogadārapariggahehi,daraviyogadarapariggahehi,1,1,0,0,25
52866,kumāruppattikumāravaḍḍhīhi,kumaruppattikumaravaddhihi,1,1,0,0,26
52867,mantadūtappayānājināyakābhyūdayehi,mantadutappayanajinayakabhyudayehi,1,0,1,0,34
52868,nītijānanapaññā,nitijananapanna,1,1,0,0,15
52869,sandhānakārako,sandhanakarako,1,1,0,0,14
52870,yuddhābhigamanaṃ,yuddhabhigamanam,1,1,0,0,16
52871,yuddhasaṅkhāto,yuddhasankhato,1,1,0,0,14
52872,sapakkhanāyakassa,sapakkhanayakassa,1,1,0,0,17
52873,abhivaḍḍhisaṅkhāto,abhivaddhisankhato,1,1,0,0,18
52874,abhyūdayo,abhyudayo,1,0,1,0,9
52875,sajjitaṃ,sajjitam,42,39,3,0,8
52876,asaṃkhitta,asamkhitta,1,0,1,0,10
52877,ntaraṃ,ntaram,4,3,1,0,6
52878,vitthārā,vitthara,14,14,0,0,8
52879,sutisubhagehi,sutisubhagehi,1,1,0,0,13
52880,indavajirādīhi,indavajiradihi,1,1,0,0,14
52881,pubbāparasambandhaparicchedatāya,pubbaparasambandhaparicchedataya,1,1,0,0,32
52882,bhinnasaggantehi,bhinnasaggantehi,1,0,1,0,16
52883,bhinnasaggā,bhinnasagga,1,1,0,0,11
52884,pariyosānā,pariyosana,45,44,1,0,10
52885,nātivitthārasaggasaṅkhātehi,nativittharasaggasankhatehi,1,1,0,0,27
52886,paricchedehi,paricchedehi,17,17,0,0,12
52887,sādhvalaṅkati,sadhvalankati,1,0,1,0,13
52888,sobhanālaṅkāravantaṃ,sobhanalankaravantam,1,1,0,0,20
52889,kappanirantaraṭṭhāyi,kappanirantaratthayi,1,1,0,0,20
52890,kappantare,kappantare,1,1,0,0,10
52891,ṭhāyi,thayi,5,1,4,0,5
52892,madhupānādirahitapuravaṇṇanādayopi,madhupanadirahitapuravannanadayopi,1,1,0,0,34
52893,ārādheti,aradheti,137,136,1,0,8
52894,taṃpyaduṭṭhaṃ,tampyaduttham,1,1,0,0,13
52895,kabbaṅgesu,kabbangesu,1,1,0,0,10
52896,nyūnamapi,nyunamapi,1,0,1,0,9
52897,ūnamapi,unamapi,1,1,0,0,7
52898,saddotratabbhāve,saddotratabbhave,1,1,0,0,16
52899,racitapuravaṇṇanādiaṅgasampadā,racitapuravannanadiangasampada,1,1,0,0,30
52900,kabbaññū,kabbannu,1,1,0,0,8
52901,icchānurūpaṃ,icchanurupam,16,16,0,0,12
52902,ārādhayanti,aradhayanti,2,1,1,0,11
52903,nāyakavaṇṇanāsu,nayakavannanasu,1,1,0,0,15
52904,sapakkhanāyakaṃ,sapakkhanayakam,1,1,0,0,15
52905,nirākaraṇabhāvampi,nirakaranabhavampi,1,1,0,0,18
52906,paccatthikaṃ,paccatthikam,21,21,0,0,12
52907,nāyakena,nayakena,3,3,0,0,8
52908,tassābhibhavanampi,tassabhibhavanampi,1,1,0,0,18
52909,vaṇṇetuṃ,vannetum,9,9,0,0,8
52910,pajjagajjavimissānaṃ,pajjagajjavimissanam,3,0,3,0,20
52911,evametehi,evametehi,21,21,0,0,9
52912,sotujanasamussāhanaṃ,sotujanasamussahanam,3,3,0,0,20
52913,kattumicchitabandhoti,kattumicchitabandhoti,1,1,0,0,21
52914,bandhassa,bandhassa,29,26,3,0,9
52915,kattumārabhate,kattumarabhate,2,2,0,0,14
52916,saddanissitehi,saddanissitehi,1,1,0,0,14
52917,atthanissitehi,atthanissitehi,1,1,0,0,14
52918,virodhehi,virodhehi,1,1,0,0,9
52919,ekībhūtā,ekibhuta,7,7,0,0,8
52920,vuttalakkhaṇā,vuttalakkhana,20,18,2,0,13
52921,sahitānaṃ,sahitanam,36,36,0,0,9
52922,sahadayahilādakāraṇaṃ,sahadayahiladakaranam,1,1,0,0,21
52923,sādhyaṃ,sadhyam,2,2,0,0,7
52924,sāhiccaṃ,sahiccam,1,1,0,0,8
52925,dosavajjite,dosavajjite,3,3,0,0,11
52926,pasiddhabhāvena,pasiddhabhavena,3,3,0,0,15
52927,anuvaditvā,anuvaditva,13,13,0,0,10
52928,sabhāvavuttivaṅkavuttialaṅkāravuttivasena,sabhavavuttivankavuttialankaravuttivasena,1,1,0,0,41
52929,tividhopīti,tividhopiti,1,1,0,0,11
52930,appasiddhaṃ,appasiddham,8,8,0,0,11
52931,vidhīyate,vidhiyate,58,58,0,0,9
52932,saddovattabbantarassa,saddovattabbantarassa,1,1,0,0,21
52933,samuccayo,samuccayo,40,35,5,0,9
52934,kiñcīti,kinciti,164,57,107,0,7
52935,jātiguṇakriyādabbalakkhaṇo,jatigunakriyadabbalakkhano,1,1,0,0,26
52936,saddānamattho,saddanamattho,3,3,0,0,13
52937,mukhyassatthassa,mukhyassatthassa,1,1,0,0,16
52938,catubbidhattā,catubbidhatta,13,13,0,0,13
52939,tividhesu,tividhesu,18,18,0,0,9
52940,saddesu,saddesu,90,81,9,0,7
52941,tabbācako,tabbacako,2,2,0,0,9
52942,guṇasaddo,gunasaddo,12,12,0,0,9
52943,kriyāsaddo,kriyasaddo,3,3,0,0,10
52944,dabbasaddoti,dabbasaddoti,1,1,0,0,12
52945,lakkhaṇiko,lakkhaniko,9,9,0,0,10
52946,byañjakoti,byanjakoti,3,3,0,0,10
52947,byāpārabhedena,byaparabhedena,2,2,0,0,14
52948,tthappatītikārittameva,tthappatitikarittameva,1,1,0,0,22
52949,byañjanasabhāvo,byanjanasabhavo,4,4,0,0,15
52950,jātyādinirantaratthavisayo,jatyadinirantaratthavisayo,1,1,0,0,26
52951,saddabyāpāro,saddabyaparo,4,4,0,0,12
52952,abhidhāti,abhidhati,2,2,0,0,9
52953,taṃbyāpāravā,tambyaparava,1,1,0,0,12
52954,abyavahitajātyādisakehi,abyavahitajatyadisakehi,1,1,0,0,23
52955,goādiko,goadiko,1,1,0,0,7
52956,saddantaratthavisayaniddiṭṭho,saddantaratthavisayaniddittho,1,1,0,0,29
52957,upacāramissā,upacaramissa,2,2,0,0,12
52958,muccatu,muccatu,10,9,1,0,7
52959,mañcā,manca,57,57,0,0,5
52960,ugghosenti,ugghosenti,5,5,0,0,10
52961,gottasāmaññamevoccate,gottasamannamevoccate,1,1,0,0,21
52962,gobyatti,gobyatti,2,2,0,0,8
52963,visesyaṃnābhidhā,visesyamnabhidha,1,1,0,0,16
52964,gacche,gacche,124,117,7,0,6
52965,khīṇasatti,khinasatti,3,2,1,0,10
52966,kābyappakāse,kabyappakase,2,2,0,0,12
52967,dutiyaullāse,dutiyaullase,2,2,0,0,12
52968,āgatanyāyo,agatanyayo,2,2,0,0,10
52969,sāmaññassa,samannassa,40,39,1,0,10
52970,byāpakattā,byapakatta,3,3,0,0,10
52971,asarīrattā,asariratta,1,1,0,0,10
52972,bandhanamocanāni,bandhanamocanani,1,1,0,0,16
52973,sambhavantīti,sambhavantiti,73,63,10,0,13
52974,ākaḍḍhīyate,akaddhiyate,1,1,0,0,11
52975,mañcānamugghosanaṃ,mancanamugghosanam,1,1,0,0,18
52976,sambhavatīti,sambhavatiti,281,273,8,0,12
52977,ugghosanakriyāsiddhyatthaṃ,ugghosanakriyasiddhyattham,1,1,0,0,26
52978,mañcasamaṅgino,mancasamangino,1,1,0,0,14
52979,ākaḍḍhīyanti,akaddhiyanti,1,1,0,0,12
52980,gaṅgāsaddavāccassa,gangasaddavaccassa,1,1,0,0,18
52981,jalappavāhassa,jalappavahassa,1,1,0,0,14
52982,ghosappatyākaratā,ghosappatyakarata,1,1,0,0,17
52983,attanobhidheyyassodakappavāhassa,attanobhidheyyassodakappavahassa,1,1,0,0,32
52984,nikaṭaṃ,nikatam,1,1,0,0,7
52985,taṭaṃ,tatam,14,11,3,0,5
52986,lakkheti,lakkheti,3,3,0,0,8
52987,upacārassānekappakārattā,upacarassanekappakaratta,1,1,0,0,24
52988,lakkhaṇāpyanekadhā,lakkhanapyanekadha,1,1,0,0,18
52989,kārīyamupacariyate,kariyamupacariyate,1,1,0,0,18
52990,kāraṇakāriyānamabhedo,karanakariyanamabhedo,2,2,0,0,21
52991,āyuyevedaṃ,ayuyevedam,1,1,0,0,10
52992,upameyyamupacarīyate,upameyyamupacariyate,1,1,0,0,20
52993,bāhiko,bahiko,7,7,0,0,6
52994,goyevāyaṃ,goyevayam,2,2,0,0,9
52995,taṃbyapadeso,tambyapadeso,4,4,0,0,12
52996,padīpaṭṭhā,padipattha,2,2,0,0,10
52997,kapallikā,kapallika,9,8,1,0,9
52998,taṃkammasambandhā,tamkammasambandha,1,1,0,0,17
52999,avaḍḍhakīpi,avaddhakipi,2,2,0,0,11
53000,saṃsāmisambandhā,samsamisambandha,1,1,0,0,16
53001,rājasambandhī,rajasambandhi,1,1,0,0,13
53002,rājāyaṃ,rajayam,3,3,0,0,7
53003,samudāyabyapadeso,samudayabyapadeso,2,2,0,0,17
53004,paṭekadese,patekadese,1,1,0,0,10
53005,paṭasaddo,patasaddo,1,1,0,0,9
53006,lakkhaṇāya,lakkhanaya,1,1,0,0,10
53007,parapariyāyo,parapariyayo,1,1,0,0,12
53008,byañjanako,byanjanako,3,3,0,0,10
53009,vācco,vacco,4,4,0,0,5
53010,lakkhaṇiyo,lakkhaniyo,5,5,0,0,10
53011,byaṅgyoti,byangyoti,1,1,0,0,9
53012,byaṅgyoyevattho,byangyoyevattho,1,1,0,0,15
53013,bandhasatthā,bandhasattha,1,1,0,0,12
53014,padhānabyaṅgyo,padhanabyangyo,1,1,0,0,14
53015,apadhānabyaṅgyo,apadhanabyangyo,1,1,0,0,15
53016,abyaṅgyo,abyangyo,1,1,0,0,8
53017,byaṅgyena,byangyena,1,1,0,0,9
53018,nijjīvo,nijjivo,3,3,0,0,7
53019,sabhāvavutti,sabhavavutti,8,8,0,0,12
53020,bandhopi,bandhopi,1,1,0,0,8
53021,nijjīvoti,nijjivoti,1,1,0,0,9
53022,nāsaṅkanīyo,nasankaniyo,1,1,0,0,11
53023,lokavohārakosallaṃ,lokavoharakosallam,1,1,0,0,18
53024,sabhāvavuttiyeva,sabhavavuttiyeva,1,1,0,0,16
53025,sakalalokaṭṭhitiṃ,sakalalokatthitim,1,1,0,0,17
53026,kaviyeva,kaviyeva,2,2,0,0,8
53027,athettha,athettha,92,83,9,0,8
53028,tividhampi,tividhampi,113,110,3,0,10
53029,tādisajanāvabodhatthaṃ,tadisajanavabodhattham,1,1,0,0,22
53030,samudāharissāma,samudaharissama,1,1,0,0,15
53031,munindavadanambhoje,munindavadanambhoje,2,1,1,0,19
53032,saddhammasaṅkhāto,saddhammasankhato,2,2,0,0,17
53033,devatatthaṃ,devatattham,1,1,0,0,11
53034,nāropyate,naropyate,1,1,0,0,9
53035,tappatī,tappati,10,9,1,0,7
53036,manosampīṇanaāsīsanā,manosampinanaasisana,1,1,0,0,20
53037,saṃgacchatīti,samgacchatiti,2,2,0,0,13
53038,vākyasāmatthiyāyeva,vakyasamatthiyayeva,1,1,0,0,19
53039,vāṇiyaṃ,vaniyam,1,1,0,0,7
53040,sāyamocityabhedena,sayamocityabhedena,1,1,0,0,18
53041,āropitottho,aropitottho,1,1,0,0,11
53042,vadana,vadana,8,4,4,0,6
53043,samāropitottho,samaropitottho,1,1,0,0,14
53044,manosampīṇanassa,manosampinanassa,1,1,0,0,16
53045,anupapattiyā,anupapattiya,1,1,0,0,12
53046,passaddhyādikkamena,passaddhyadikkamena,1,1,0,0,19
53047,yathābhūtāvabodhasambhavā,yathabhutavabodhasambhava,1,1,0,0,25
53048,anāyāsena,anayasena,7,6,1,0,9
53049,vicittānekasaddatthapaṭibhānena,vicittanekasaddatthapatibhanena,1,1,0,0,31
53050,ganthaparisamattisaṅkhātā,ganthaparisamattisankhata,1,1,0,0,25
53051,yathicchitatthanipphatti,yathicchitatthanipphatti,1,1,0,0,24
53052,hoteva,hoteva,83,82,1,0,6
53053,byaṅgyattho,byangyattho,1,1,0,0,11
53054,tabbācakā,tabbacaka,3,3,0,0,9
53055,vācakalakkhaṇikabyañjakā,vacakalakkhanikabyanjaka,1,1,0,0,24
53056,saddatthavicāro,saddatthavicaro,2,2,0,0,15
53057,tamevaṃ,tamevam,7,7,0,0,7
53058,yathāvuttabandhasarīraṃ,yathavuttabandhasariram,1,1,0,0,23
53059,katividhamiccāha,katividhamiccaha,1,1,0,0,16
53060,yathāvutto,yathavutto,128,127,1,0,10
53061,tippakārena,tippakarena,7,7,0,0,11
53062,nādhikaṃ,nadhikam,3,3,0,0,8
53063,nāpyūnaṃ,napyunam,1,1,0,0,8
53064,pajjasabhāvādīnaṃ,pajjasabhavadinam,1,1,0,0,17
53065,amhehiyeva,amhehiyeva,3,3,0,0,10
53066,viracitavuttodayākhye,viracitavuttodayakhye,1,1,0,0,21
53067,nirūpitā,nirupita,1,1,0,0,8
53068,vuttajātippabhedā,vuttajatippabheda,1,1,0,0,17
53069,catuppadikatthā,catuppadikattha,1,1,0,0,15
53070,nirūpito,nirupito,1,1,0,0,8
53071,muttakādipi,muttakadipi,1,1,0,0,11
53072,vuttajātippakāroyeva,vuttajatippakaroyeva,1,1,0,0,20
53073,tenevettha,tenevettha,73,73,0,0,10
53074,tesamadassanaṃ,tesamadassanam,1,1,0,0,14
53075,ekagāthā,ekagatha,2,1,1,0,8
53076,niṭṭhitatthā,nitthitattha,3,3,0,0,12
53077,sappadhānā,sappadhana,4,4,0,0,10
53078,gāthantarānirapekkhā,gathantaranirapekkha,1,1,0,0,20
53079,muttakaṃ,muttakam,4,2,2,0,8
53080,ekakriyādānena,ekakriyadanena,1,1,0,0,14
53081,aññamaññasāpekkhā,annamannasapekkha,2,2,0,0,17
53082,aniṭṭhitatthā,anitthitattha,1,1,0,0,13
53083,nānābhittiyo,nanabhittiyo,1,1,0,0,12
53084,bhinnakiriyo,bhinnakiriyo,1,1,0,0,12
53085,ekabhittipadosādikaṃ,ekabhittipadosadikam,1,1,0,0,20
53086,samudāyena,samudayena,11,10,1,0,10
53087,bhinnakriyā,bhinnakriya,1,1,0,0,11
53088,pajjappakāro,pajjappakaro,1,1,0,0,12
53089,yathāvuttasaggabandhovāti,yathavuttasaggabandhovati,1,1,0,0,25
53090,viññātabbaṃ,vinnatabbam,81,75,6,0,11
53091,gajjaṃ,gajjam,4,2,2,0,6
53092,pādasanniṭṭhānarahito,padasannitthanarahito,1,1,0,0,21
53093,syādyantatyādyantappabandho,syadyantatyadyantappabandho,1,1,0,0,27
53094,ākhyāyikā,akhyayika,1,1,0,0,9
53095,vimissaṃ,vimissam,6,5,1,0,8
53096,nāṭakappakaraṇādi,natakappakaranadi,1,1,0,0,17
53097,campū,campu,1,1,0,0,5
53098,jātakamālādikā,jatakamaladika,1,1,0,0,14
53099,sañjānanābhilāsīnaṃ,sanjananabhilasinam,1,1,0,0,19
53100,alaṅkāranissitaṃ,alankaranissitam,1,1,0,0,16
53101,bandhoti,bandhoti,13,5,8,0,8
53102,adhikataṃ,adhikatam,12,12,0,0,9
53103,pasiddhakuṇḍalittānuvādena,pasiddhakundalittanuvadena,1,1,0,0,26
53104,appasiddhassa,appasiddhassa,1,1,0,0,13
53105,devadattattavidhānaṃ,devadattattavidhanam,1,1,0,0,20
53106,saddatthanissitadosehi,saddatthanissitadosehi,1,1,0,0,22
53107,tādisā,tadisa,160,155,5,0,6
53108,aññamaññānurūpatthena,annamannanurupatthena,1,1,0,0,21
53109,sahabhāvaṃ,sahabhavam,27,21,6,0,10
53110,evaṃpakārehi,evampakarehi,1,1,0,0,12
53111,īdisasaddatthānaṃ,idisasaddatthanam,1,1,0,0,17
53112,viññūnaṃ,vinnunam,271,262,9,0,8
53113,tuṭṭhijanakaaññamaññānurūpaguṇasahitānaṃ,tutthijanakaannamannanurupagunasahitanam,1,1,0,0,40
53114,bhāvoti,bhavoti,153,125,28,0,7
53115,sāhicca,sahicca,1,1,0,0,7
53116,saddatthāti,saddatthati,1,0,1,0,11
53117,saddatthānaṃ,saddatthanam,11,11,0,0,12
53118,nānākaraṇanti,nanakarananti,32,32,0,0,13
53119,atthappatītiyaṃ,atthappatitiyam,3,3,0,0,15
53120,mukhyabyāpāraṃ,mukhyabyaparam,1,1,0,0,14
53121,lakkhaṇabyāpāraṃ,lakkhanabyaparam,1,1,0,0,16
53122,byañjanasabhāvabyāpārañceti,byanjanasabhavabyaparanceti,1,1,0,0,27
53123,byaṅgyo,byangyo,2,2,0,0,7
53124,cebhi,cebhi,1,1,0,0,5
53125,dīpetabbamukhyatthassa,dipetabbamukhyatthassa,1,1,0,0,22
53126,jātiguṇakriyādabbabhedena,jatigunakriyadabbabhedena,2,2,0,0,25
53127,jātiguṇakriyādabbasaddavasena,jatigunakriyadabbasaddavasena,1,1,0,0,29
53128,vācakasaddassa,vacakasaddassa,1,1,0,0,14
53129,mukhyabyāpāro,mukhyabyaparo,3,3,0,0,13
53130,abhidhā,abhidha,3,2,1,0,7
53131,voharīyati,vohariyati,68,66,2,0,10
53132,abyavahitattheva,abyavahitattheva,1,1,0,0,16
53133,pācako,pacako,16,16,0,0,6
53134,visāṇi,visani,1,1,0,0,6
53135,ccādo,ccado,13,13,0,0,5
53136,goādisaddānaṃ,goadisaddanam,1,1,0,0,13
53137,gopiṇḍanīlapaṭapācakakattusiṅgīti,gopindanilapatapacakakattusingiti,1,1,0,0,33
53138,dabbānaṃ,dabbanam,5,5,0,0,8
53139,visesanabhūtajātiguṇakriyādabbesveva,visesanabhutajatigunakriyadabbesveva,1,1,0,0,36
53140,jātyādīnaṃ,jatyadinam,5,5,0,0,10
53141,nissayabhūtagopiṇḍādīsūti,nissayabhutagopindadisuti,1,1,0,0,25
53142,nābhidhā,nabhidha,1,1,0,0,8
53143,visesanabhūtajātyādimhi,visesanabhutajatyadimhi,1,1,0,0,23
53144,khīṇabyāpāravatī,khinabyaparavati,1,1,0,0,16
53145,mukhyabyāpārova,mukhyabyaparova,1,1,0,0,15
53146,nissayagopiṇḍādikaṃ,nissayagopindadikam,1,1,0,0,19
53147,evañca,evanca,1888,1808,80,0,6
53148,nivāseti,nivaseti,83,81,2,0,8
53149,jātyādivisiṭṭhagopiṇḍādīnaṃ,jatyadivisitthagopindadinam,1,1,0,0,27
53150,goādisaddassa,goadisaddassa,1,1,0,0,13
53151,vācakattaṃ,vacakattam,2,2,0,0,10
53152,dabbādhīnajātiguṇādīsu,dabbadhinajatigunadisu,1,1,0,0,22
53153,tabbisiṭṭhassa,tabbisitthassa,1,1,0,0,14
53154,suddhalakkhaṇabyāpārasseva,suddhalakkhanabyaparasseva,1,1,0,0,26
53155,lakkhaṇabyāpāropi,lakkhanabyaparopi,1,1,0,0,17
53156,upacāramissoti,upacaramissoti,1,1,0,0,14
53157,lakkhaṇabyāpāro,lakkhanabyaparo,1,1,0,0,15
53158,jātyādivajjitatthavisayo,jatyadivajjitatthavisayo,1,1,0,0,24
53159,jātiguṇakriyāsiṅgadabbamañcagaṅgādīnaṃ,jatigunakriyasingadabbamancagangadinam,1,1,0,0,38
53160,gamanādīhi,gamanadihi,4,4,0,0,10
53161,yogāsambhavato,yogasambhavato,1,1,0,0,14
53162,jātiguṇādayo,jatigunadayo,1,1,0,0,12
53163,gamananivāsanaāgamanadhāvanaugghosanaghosādīnaṃ,gamananivasanaagamanadhavanaugghosanaghosadinam,1,1,0,0,47
53164,nissayabhūtagopiṇḍādayo,nissayabhutagopindadayo,1,1,0,0,23
53165,misso,misso,18,16,2,0,5
53166,upacārabhedena,upacarabhedena,1,1,0,0,14
53167,kāriyamupacarīyate,kariyamupacariyate,1,1,0,0,18
53168,āyughataṃ,ayughatam,1,1,0,0,9
53169,āyuvaḍḍhanakāraṇabhūte,ayuvaddhanakaranabhute,1,1,0,0,22
53170,kāriyabhūtaāyuno,kariyabhutaayuno,1,1,0,0,16
53171,uparipi,uparipi,62,62,0,0,7
53172,ataṃsabhāve,atamsabhave,2,2,0,0,11
53173,taṃsabhāvāropanaṃ,tamsabhavaropanam,1,1,0,0,17
53174,āyuyeva,ayuyeva,1,1,0,0,7
53175,upameyyaupamānopacāro,upameyyaupamanopacaro,1,1,0,0,21
53176,upamānaupameyyānamabhedo,upamanaupameyyanamabhedo,1,1,0,0,24
53177,tadūpacāro,tadupacaro,1,1,0,0,10
53178,kriyāsambandhena,kriyasambandhena,1,1,0,0,16
53179,saṃsāmisambandhena,samsamisambandhena,1,1,0,0,18
53180,rājavallabhopi,rajavallabhopi,1,1,0,0,14
53181,daḍḍho,daddho,58,56,2,0,6
53182,upacārabhedo,upacarabhedo,2,2,0,0,12
53183,byañjanasabhāvabyāpāro,byanjanasabhavabyaparo,1,1,0,0,22
53184,tatiyabyāpārassa,tatiyabyaparassa,1,1,0,0,16
53185,tādisavākyameva,tadisavakyameva,1,1,0,0,15
53186,byaṅgyatthaṃ,byangyattham,1,1,0,0,12
53187,jīvitamiti,jivitamiti,3,3,0,0,10
53188,byaṅgyatthapadhānaṃ,byangyatthapadhanam,1,1,0,0,19
53189,bandhamuttamanti,bandhamuttamanti,1,1,0,0,16
53190,byaṅgyatthapadhānarahitaṃ,byangyatthapadhanarahitam,1,1,0,0,25
53191,majjhimanti,majjhimanti,5,5,0,0,11
53192,abyaṅgyabandhaṃ,abyangyabandham,1,1,0,0,15
53193,adhamamiti,adhamamiti,1,1,0,0,10
53194,lakkhaṇabyañjanasabhāvo,lakkhanabyanjanasabhavo,1,1,0,0,23
53195,abhidhāparapariyāyo,abhidhaparapariyayo,1,1,0,0,19
53196,dhanantāparapariyāyo,dhanantaparapariyayo,1,1,0,0,20
53197,nirantaratthesu,nirantaratthesu,1,1,0,0,15
53198,tirohite,tirohite,2,2,0,0,8
53199,vākyassa,vakyassa,36,34,2,0,8
53200,attheyeva,attheyeva,2,2,0,0,9
53201,byāpārassa,byaparassa,9,9,0,0,10
53202,tadatthopi,tadatthopi,5,5,0,0,10
53203,byaṅgyoccevaṃ,byangyoccevam,1,1,0,0,13
53204,vāccatthassa,vaccatthassa,3,3,0,0,12
53205,catuddhāva,catuddhava,2,2,0,0,10
53206,bhinnattā,bhinnatta,62,60,2,0,9
53207,jātiādito,jatiadito,5,5,0,0,9
53208,upacārabahuttena,upacarabahuttena,1,1,0,0,16
53209,anaññattā,anannatta,34,34,0,0,9
53210,lakkhaṇato,lakkhanato,146,137,9,0,10
53211,tyādigāthāyaṃ,tyadigathayam,2,2,0,0,13
53212,mukhattho,mukhattho,1,1,0,0,9
53213,āropitaambhojattho,aropitaambhojattho,1,1,0,0,18
53214,lakkhaṇiyattho,lakkhaniyattho,3,3,0,0,14
53215,padumattho,padumattho,1,1,0,0,10
53216,upacaritamukhattho,upacaritamukhattho,1,1,0,0,18
53217,vāṇi,vani,3,2,1,0,4
53218,āropitadevatāattho,aropitadevataattho,1,1,0,0,18
53219,āsīsanā,asisana,16,13,3,0,7
53220,puññātisayatā,punnatisayata,1,1,0,0,13
53221,abhimatatthabādhakākusalanivāraṇañca,abhimatatthabadhakakusalanivarananca,1,1,0,0,36
53222,kusalānamanubalappadānañca,kusalanamanubalappadananca,1,1,0,0,26
53223,kāyacittapīḷāvigamo,kayacittapilavigamo,1,1,0,0,19
53224,sukhappaṭilābho,sukhappatilabho,1,1,0,0,15
53225,cittasamādhānañca,cittasamadhananca,2,2,0,0,17
53226,anekavidhatthāvabodho,anekavidhatthavabodho,1,1,0,0,21
53227,abhimataganthaparisamatti,abhimataganthaparisamatti,1,1,0,0,25
53228,bhavatītyayaṃ,bhavatityayam,1,1,0,0,13
53229,vākyasāmatthiyato,vakyasamatthiyato,1,1,0,0,17
53230,laddhattho,laddhattho,1,1,0,0,10
53231,byaṅgyatto,byangyatto,1,1,0,0,10
53232,taṃtaṃatthappakāsakā,tamtamatthappakasaka,1,1,0,0,20
53233,vācakalakkhaṇikabyañjanakā,vacakalakkhanikabyanjanaka,1,1,0,0,26
53234,saddasaddatthavicāro,saddasaddatthavicaro,1,1,0,0,20
53235,pakāsitabandhassa,pakasitabandhassa,1,1,0,0,17
53236,bhedaṃ,bhedam,169,146,23,0,6
53237,pajjā,pajja,4,3,1,0,5
53238,vuttalakkhaṇo,vuttalakkhano,24,23,1,0,13
53239,gāthācuṇṇiyatadubhayamissānaṃ,gathacunniyatadubhayamissanam,1,1,0,0,29
53240,itā,ita,29,29,0,0,3
53241,pattāti,pattati,63,52,11,0,7
53242,pajjañca,pajjanca,4,4,0,0,8
53243,gajjañca,gajjanca,1,1,0,0,8
53244,vimissañceti,vimissanceti,1,1,0,0,12
53245,muttakakulakakosakasaṅghātavasena,muttakakulakakosakasanghatavasena,1,1,0,0,33
53246,catuppabhedaṃ,catuppabhedam,3,3,0,0,13
53247,niddiṭṭhavuttavisesaviracitaṃ,nidditthavuttavisesaviracitam,1,1,0,0,29
53248,catuppadikagāthābandhaṃ,catuppadikagathabandham,1,1,0,0,23
53249,paccekamaniṭṭhitatthā,paccekamanitthitattha,1,1,0,0,21
53250,ekakriyādvārikā,ekakriyadvarika,1,1,0,0,15
53251,nānāgāthā,nanagatha,1,1,0,0,9
53252,kosako,kosako,5,4,1,0,6
53253,nānāvidhavaṇṇanābhūmikā,nanavidhavannanabhumika,1,1,0,0,23
53254,bhinnakriyādvārappavattā,bhinnakriyadvarappavatta,1,1,0,0,24
53255,gāthārāsi,gatharasi,1,1,0,0,9
53256,sañcyākālādiekavaṇṇanābhūminissitā,sancyakaladiekavannanabhuminissita,1,1,0,0,34
53257,bhinnakriyāsamudāyena,bhinnakriyasamudayena,1,1,0,0,21
53258,aniyatapado,aniyatapado,1,1,0,0,11
53259,ākhyāyikākathāvasena,akhyayikakathavasena,1,1,0,0,20
53260,dvippabhedo,dvippabhedo,1,1,0,0,11
53261,syādyantatyādyanto,syadyantatyadyanto,1,1,0,0,18
53262,vacanappabandho,vacanappabandho,2,2,0,0,15
53263,saṃmisso,sammisso,1,1,0,0,8
53264,nāṭakapakaraṇādi,natakapakaranadi,1,1,0,0,16
53265,jātakamālādicampū,jatakamaladicampu,1,1,0,0,17
53266,tippakāraṃ,tippakaram,7,7,0,0,10
53267,nibandhocā,nibandhoca,1,0,1,0,10
53268,pajjamayabandho,pajjamayabandho,1,1,0,0,15
53269,dvippakārena,dvippakarena,5,5,0,0,12
53270,tadekadesabhūtehi,tadekadesabhutehi,1,1,0,0,17
53271,muttakādīhi,muttakadihi,2,2,0,0,11
53272,saggabandhādivasena,saggabandhadivasena,1,1,0,0,19
53273,anibandho,anibandho,3,1,2,0,9
53274,muttakavasenāti,muttakavasenati,1,1,0,0,15
53275,tassetassa,tassetassa,1,1,0,0,10
53276,yathāvuttavātimayassa,yathavuttavatimayassa,1,1,0,0,21
53277,sakkaṭaṃ,sakkatam,4,2,2,0,8
53278,apabbhaṃso,apabbhamso,3,1,2,0,10
53279,pesācikaṃ,pesacikam,3,1,2,0,9
53280,missañceti,missanceti,1,1,0,0,10
53281,pañcavidhattaṃ,pancavidhattam,4,4,0,0,14
53282,devatābhāsā,devatabhasa,2,2,0,0,11
53283,sakkaṭehi,sakkatehi,1,1,0,0,9
53284,vaṇṇaññattamattena,vannannattamattena,2,2,0,0,18
53285,mahindasindhavādi,mahindasindhavadi,2,2,0,0,17
53286,tassamaṃ,tassamam,6,5,1,0,8
53287,hiriharakamalādi,hiriharakamaladi,2,2,0,0,16
53288,mahāraṭṭhādidesapasiddhaṃ,maharatthadidesapasiddham,1,1,0,0,25
53289,desīyaṃ,desiyam,1,1,0,0,7
53290,tabbhavādīhi,tabbhavadihi,3,3,0,0,12
53291,sammissaṃ,sammissam,13,13,0,0,9
53292,ābhīrādīnaṃ,abhiradinam,1,1,0,0,11
53293,nāgaraupanāgaravuddhabhedena,nagaraupanagaravuddhabhedena,2,2,0,0,28
53294,pisācānaṃ,pisacanam,2,2,0,0,9
53295,sakkaṭādīnaṃ,sakkatadinam,1,1,0,0,12
53296,siṅgārappadhānanaccasaṅkhātalāsyādīnaṃ,singarappadhananaccasankhatalasyadinam,1,1,0,0,38
53297,paṭipādakatthena,patipadakatthena,1,1,0,0,16
53298,lāsyādikamabhinayappadhānattā,lasyadikamabhinayappadhanatta,1,1,0,0,29
53299,dassanīyaṃ,dassaniyam,62,60,2,0,10
53300,savanīyaṃ,savaniyam,6,5,1,0,9
53301,bhāsābhedena,bhasabhedena,1,1,0,0,12
53302,viniyogabhedena,viniyogabhedena,1,1,0,0,15
53303,duvidhattañca,duvidhattanca,1,1,0,0,13
53304,tadevamidhānupayogitāya,tadevamidhanupayogitaya,1,1,0,0,23
53305,evamalaṅkārādhiṭṭhānabhāvena,evamalankaradhitthanabhavena,1,1,0,0,28
53306,hārakeyūrādinā,harakeyuradina,1,1,0,0,14
53307,purisasarīramiva,purisasariramiva,1,1,0,0,16
53308,saddālaṅkāraatthālaṅkārehi,saddalankaraatthalankarehi,4,4,0,0,26
53309,vindanīyataraṃ,vindaniyataram,1,1,0,0,14
53310,visesavacanicchāyaṃ,visesavacanicchayam,3,1,2,0,19
53311,alaṅkariyati,alankariyati,1,1,0,0,12
53312,bandhasarīrametehīti,bandhasarirametehiti,1,1,0,0,20
53313,vindanīyabhāvaṃ,vindaniyabhavam,1,1,0,0,15
53314,assādanīyabhāvaṃ,assadaniyabhavam,1,1,0,0,16
53315,pāpenti,papenti,71,66,5,0,7
53316,niddosabhūtānaṃ,niddosabhutanam,1,1,0,0,15
53317,aññamaññānurūpato,annamannanurupato,1,1,0,0,17
53318,sahitabhāvena,sahitabhavena,3,3,0,0,13
53319,vaṇṇapokkharatāya,vannapokkharataya,106,98,8,0,17
53320,tādisapurisasarīramiva,tadisapurisasariramiva,1,1,0,0,22
53321,vindanīyampi,vindaniyampi,1,1,0,0,12
53322,pasādhite,pasadhite,1,1,0,0,9
53323,vindanīyaṃ,vindaniyam,1,1,0,0,10
53324,kathetuṃ,kathetum,486,461,25,0,8
53325,dimāha,dimaha,2,2,0,0,6
53326,avinābhāvato,avinabhavato,49,48,1,0,12
53327,mahākabbādisabhāvena,mahakabbadisabhavena,2,2,0,0,20
53328,muttakattā,muttakatta,1,1,0,0,10
53329,anirantaraṃ,anirantaram,1,1,0,0,11
53330,sakkaṭapākataapabbhaṃ,sakkatapakataapabbham,1,1,0,0,21
53331,sapesācikamissabhāsābhedena,sapesacikamissabhasabhedena,1,1,0,0,27
53332,siṅgārapadhānanaccasaṅkhātalāsyādīnaṃ,singarapadhananaccasankhatalasyadinam,1,1,0,0,37
53333,dassanappadhānattā,dassanappadhanatta,1,1,0,0,18
53334,naccaṃdassanīyaṃ,naccamdassaniyam,1,1,0,0,16
53335,savanīyamiti,savaniyamiti,1,1,0,0,12
53336,vaḷañjanabhedato,valanjanabhedato,1,1,0,0,16
53337,payojanābhāvato,payojanabhavato,26,26,0,0,15
53338,akkharehi,akkharehi,63,52,11,0,9
53339,tabbhavatassamadesiyamissavasena,tabbhavatassamadesiyamissavasena,1,1,0,0,32
53340,sakkaṭato,sakkatato,1,1,0,0,9
53341,desiyaṃ,desiyam,2,0,2,0,7
53342,gopālakādīnaṃ,gopalakadinam,1,1,0,0,13
53343,sakkaṭādīhi,sakkatadihi,1,1,0,0,11
53344,īdisappabhedavantabandhassa,idisappabhedavantabandhassa,1,1,0,0,27
53345,sobhanattaṃ,sobhanattam,2,2,0,0,11
53346,atisayapasādanīyattaṃ,atisayapasadaniyattam,1,1,0,0,21
53347,nibandhoti,nibandhoti,1,0,1,0,10
53348,anibandhoti,anibandhoti,1,0,1,0,11
53349,vindanīyo,vindaniyo,1,1,0,0,9
53350,vindanīyataro,vindaniyataro,1,1,0,0,13
53351,mukhambhojamanavajjā,mukhambhojamanavajja,1,0,1,0,20
53352,alaṅkatāva,alankatava,5,2,3,0,10
53353,niralaṅkatā,niralankata,4,1,3,0,11
53354,anavajja,anavajja,7,4,3,0,8
53355,aññamaññānurūpādhikatanettakaṇṇādiavayavena,annamannanurupadhikatanettakannadiavayavena,1,1,0,0,43
53356,piḷakatilakakāḷakādyanāhatāya,pilakatilakakalakadyanahataya,1,1,0,0,29
53357,sundarabhāvato,sundarabhavato,2,2,0,0,14
53358,agarahitaṃ,agarahitam,1,1,0,0,10
53359,mukhambhojaṃ,mukhambhojam,1,0,1,0,12
53360,vadanāravindañca,vadanaravindanca,1,1,0,0,16
53361,anavajjā,anavajja,95,89,6,0,8
53362,padādidosānabhibhūtāya,padadidosanabhibhutaya,1,1,0,0,22
53363,sundarabhāvena,sundarabhavena,5,5,0,0,14
53364,agarahitā,agarahita,6,6,0,0,9
53365,tappaṭipādanīyo,tappatipadaniyo,1,1,0,0,15
53366,tilakatāḍaṅkādinālaṅkārena,tilakatadankadinalankarena,1,1,0,0,26
53367,pasādhitā,pasadhita,4,4,0,0,9
53368,sajjitā,sajjita,14,14,0,0,7
53369,apasādhitā,apasadhita,1,1,0,0,10
53370,asajjitā,asajjita,1,1,0,0,8
53371,sobhantevāti,sobhantevati,1,1,0,0,12
53372,vitakkemīti,vitakkemiti,1,1,0,0,11
53373,vaṇṇasaṇṭhānādiavayavasampattiyā,vannasanthanadiavayavasampattiya,1,1,0,0,32
53374,piḷakatilakakāḷakādidosarahitattā,pilakatilakakalakadidosarahitatta,1,1,0,0,33
53375,mukhambhojañca,mukhambhojanca,1,0,1,0,14
53376,padadosavākyadosaatthadosehi,padadosavakyadosaatthadosehi,1,1,0,0,28
53377,amissattā,amissatta,4,4,0,0,9
53378,tappaṭipādanīyattho,tappatipadaniyattho,1,1,0,0,19
53379,kuṇḍalatilakādiābharaṇehi,kundalatilakadiabharanehi,1,1,0,0,25
53380,avibhūsitā,avibhusita,1,1,0,0,10
53381,sobhanteti,sobhanteti,1,1,0,0,10
53382,avajjamassāti,avajjamassati,1,1,0,0,13
53383,mukhameva,mukhameva,6,6,0,0,9
53384,ambhojamiti,ambhojamiti,1,1,0,0,11
53385,vitakketi,vitakketi,105,94,11,0,9
53386,gurūpadesaṃ,gurupadesam,2,0,2,0,11
53387,laṅkattumicchati,lankattumicchati,1,0,1,0,16
53388,alaṅkaraṇañca,alankarananca,1,1,0,0,13
53389,gurūpadesena,gurupadesena,1,1,0,0,12
53390,pahāsaṃ,pahasam,1,1,0,0,7
53391,nāparaṃ,naparam,342,320,22,0,7
53392,visesamadhigacchatīti,visesamadhigacchatiti,16,12,4,0,21
53393,silesālaṅkāramāha,silesalankaramaha,1,1,0,0,17
53394,pasādhanopāyopadesakānaṃ,pasadhanopayopadesakanam,1,1,0,0,24
53395,alaṅkārakāraṇopāyopadesakānaṃ,alankarakaranopayopadesakanam,1,1,0,0,29
53396,upadesaṃ,upadesam,26,24,2,0,8
53397,sobheyyā,sobheyya,28,28,0,0,8
53398,upadisanaṃ,upadisanam,3,3,0,0,10
53399,pariccajja,pariccajja,5,5,0,0,10
53400,mukhassa,mukhassa,34,33,1,0,8
53401,alaṅkaraṇānabhiññatāya,alankarananabhinnataya,1,1,0,0,22
53402,aññāṇako,annanako,3,3,0,0,8
53403,alaṅkattuṃ,alankattum,7,0,7,0,10
53404,anurūpavasena,anurupavasena,33,33,0,0,13
53405,sajjetuṃ,sajjetum,8,8,0,0,8
53406,adhippeti,adhippeti,1,1,0,0,9
53407,aññāṇapuggalo,annanapuggalo,6,6,0,0,13
53408,tabbidūhi,tabbiduhi,1,1,0,0,9
53409,paṇḍitajanehi,panditajanehi,1,1,0,0,13
53410,avahāsaṃ,avahasam,3,3,0,0,8
53411,sampāpuṇeyya,sampapuneyya,13,12,1,0,12
53412,aññāṇapurisena,annanapurisena,1,1,0,0,14
53413,kariyatī,kariyati,5,5,0,0,8
53414,hasantevāti,hasantevati,1,1,0,0,11
53415,padādidosarahitabandhasarīrassa,padadidosarahitabandhasarirassa,1,1,0,0,31
53416,bhūsanamapi,bhusanamapi,1,1,0,0,11
53417,gurūpadesasahitameva,gurupadesasahitameva,1,1,0,0,20
53418,seṭṭhanti,setthanti,34,33,1,0,9
53419,gurūpadesa,gurupadesa,1,0,1,0,10
53420,miccādisilesālaṅkāramāha,miccadisilesalankaramaha,1,1,0,0,24
53421,mukhādisarīrālaṅkāre,mukhadisariralankare,1,1,0,0,20
53422,bandhālaṅkāre,bandhalankare,1,1,0,0,13
53423,sarīrālaṅkārakaraṇassa,sariralankarakaranassa,1,1,0,0,22
53424,bandhālaṅkārakaraṇassa,bandhalankarakaranassa,1,1,0,0,22
53425,anurūpopadesamantarena,anurupopadesamantarena,1,1,0,0,22
53426,tilakatāḍaṅkādīhi,tilakatadankadihi,1,1,0,0,17
53427,tadubhayaññūhi,tadubhayannuhi,1,1,0,0,14
53428,avahasitabbataṃ,avahasitabbatam,1,1,0,0,15
53429,pāpuṇātyeva,papunatyeva,1,1,0,0,11
53430,gurūhi,guruhi,1,1,0,0,6
53431,sādarato,sadarato,1,1,0,0,8
53432,kattabbanti,kattabbanti,68,64,4,0,11
53433,tabbohārūpacārato,tabboharupacarato,5,2,3,0,17
53434,atthagammā,atthagamma,4,2,2,0,10
53435,alaṅkārāti,alankarati,4,2,2,0,10
53436,ganthopī,ganthopi,1,0,1,0,8
53437,kavivācānaṃ,kavivacanam,2,0,2,0,11
53438,kavippayogānaṃ,kavippayoganam,2,2,0,0,14
53439,samudāyarūpānaṃ,samudayarupanam,1,1,0,0,15
53440,paṭipādanīyatāya,patipadaniyataya,1,1,0,0,16
53441,tabbacanīyānañca,tabbacaniyananca,1,1,0,0,16
53442,alaṅkārappakāsako,alankarappakasako,2,0,2,0,17
53443,alaṅkārānaṃ,alankaranam,10,10,0,0,11
53444,yathāvuttānaṃ,yathavuttanam,87,87,0,0,13
53445,vibhāvito,vibhavito,98,97,1,0,9
53446,kiriyākappasaṅkhātaṃ,kiriyakappasankhatam,2,2,0,0,20
53447,satthampi,satthampi,4,4,0,0,9
53448,vāccataṃ,vaccatam,1,1,0,0,8
53449,kinti,kinti,612,575,37,0,5
53450,katavohārassa,katavoharassa,2,2,0,0,13
53451,maṇḍanavisese,mandanavisese,1,1,0,0,13
53452,alaṅkāravohārassa,alankaravoharassa,1,1,0,0,17
53453,upacaraṇaṃ,upacaranam,4,4,0,0,10
53454,soyamityabhedena,soyamityabhedena,2,2,0,0,16
53455,parikappanaṃ,parikappanam,12,11,1,0,12
53456,paṭipādanīyapaṭipādakānaṃ,patipadaniyapatipadakanam,1,1,0,0,25
53457,abhedavasena,abhedavasena,4,4,0,0,12
53458,kārīyassa,kariyassa,1,1,0,0,9
53459,upacariyatoti,upacariyatoti,1,1,0,0,13
53460,saddālaṅkāraatthālaṅkāragantho,saddalankaraatthalankaragantho,1,1,0,0,30
53461,kathamalaṅkāroti,kathamalankaroti,1,1,0,0,16
53462,vuttavākyasaṅkhātānaṃ,vuttavakyasankhatanam,1,1,0,0,21
53463,tappaṭipādanīyaatthasaṅkhātānañca,tappatipadaniyaatthasankhatananca,1,1,0,0,33
53464,saddatthālaṅkārappakāsako,saddatthalankarappakasako,1,1,0,0,25
53465,ganthoapi,ganthoapi,1,0,1,0,9
53466,kārīyūpacārena,kariyupacarena,1,1,0,0,14
53467,vattabbataṃ,vattabbatam,274,263,11,0,11
53468,alaṅkāramapekkhati,alankaramapekkhati,1,1,0,0,18
53469,pakāsakoti,pakasakoti,3,3,0,0,10
53470,vacanīyo,vacaniyo,313,302,11,0,8
53471,vāccavācakasambandho,vaccavacakasambandho,1,1,0,0,20
53472,saddādialaṅkārassa,saddadialankarassa,1,1,0,0,18
53473,vohāroti,voharoti,25,14,11,0,8
53474,tabbohārassa,tabboharassa,2,2,0,0,12
53475,upacāroti,upacaroti,23,17,6,0,9
53476,saddatthabhedato,saddatthabhedato,2,0,2,0,16
53477,bandhanāmāva,bandhanamava,2,1,1,0,12
53478,taṃsajjitatadāvali,tamsajjitatadavali,3,0,3,0,18
53479,yathāvuttaalaṅkārānaṃ,yathavuttaalankaranam,2,2,0,0,21
53480,pabhedaṃ,pabhedam,76,72,4,0,8
53481,tappasaṅkañca,tappasankanca,1,1,0,0,13
53482,taṃbandhasarīrañca,tambandhasariranca,1,1,0,0,18
53483,sambandhetvā,sambandhetva,1,1,0,0,12
53484,kiriyākappasaṅkhāte,kiriyakappasankhate,2,2,0,0,19
53485,bandhālaṅkārādhikāre,bandhalankaradhikare,1,1,0,0,20
53486,saddabhedato,saddabhedato,3,3,0,0,12
53487,atthabhedato,atthabhedato,1,1,0,0,12
53488,atthālaṅkārāti,atthalankarati,1,1,0,0,14
53489,āvaliyā,avaliya,1,1,0,0,7
53490,bandhanāmā,bandhanama,1,0,1,0,10
53491,taṃsajjitā,tamsajjita,1,1,0,0,10
53492,samudāyā,samudaya,3,3,0,0,8
53493,mahāvākyaṃ,mahavakyam,3,3,0,0,10
53494,antaravākyaṃ,antaravakyam,1,1,0,0,12
53495,muttakādayovayavā,muttakadayovayava,1,1,0,0,17
53496,antaravākyāni,antaravakyani,1,1,0,0,13
53497,taṃsajjitatadāvalikaṃ,tamsajjitatadavalikam,1,1,0,0,21
53498,appasiddhā,appasiddha,2,2,0,0,10
53499,vidhīyante,vidhiyante,9,9,0,0,10
53500,avuttabhedañca,avuttabhedanca,1,1,0,0,14
53501,tadādhārādhikataṃ,tadadharadhikatam,1,1,0,0,17
53502,yathāvuttabandhasarīrañca,yathavuttabandhasariranca,1,1,0,0,25
53503,dvippakāre,dvippakare,1,0,1,0,10
53504,alaṅkāraganthe,alankaraganthe,1,1,0,0,14
53505,alaṅkārādhikāre,alankaradhikare,1,1,0,0,15
53506,vakkhamānālaṅkārā,vakkhamanalankara,1,1,0,0,17
53507,saddālaṅkāraatthālaṅkārabhedena,saddalankaraatthalankarabhedena,1,1,0,0,31
53508,saddatthālaṅkārehi,saddatthalankarehi,2,2,0,0,18
53509,mahākabbādisamudāyarūpā,mahakabbadisamudayarupa,1,1,0,0,23
53510,paṭipāṭibandhoti,patipatibandhoti,1,1,0,0,16
53511,sajjitāti,sajjitati,1,1,0,0,9
53512,āvalīti,avaliti,2,2,0,0,7
53513,dosalavaṅkitā,dosalavankita,3,1,2,0,13
53514,sajjitāpi,sajjitapi,2,2,0,0,9
53515,saddatthāvali,saddatthavali,8,8,0,0,13
53516,appakenapi,appakenapi,20,19,1,0,10
53517,asamphusitabbāva,asamphusitabbava,1,1,0,0,16
53518,saddālaṅkārākhyena,saddalankarakhyena,1,1,0,0,18
53519,atthālaṅkārena,atthalankarena,4,4,0,0,14
53520,saṃyuttāpi,samyuttapi,1,0,1,0,10
53521,dosalavena,dosalavena,1,0,1,0,10
53522,dosalesenāpi,dosalesenapi,1,1,0,0,12
53523,abhilañchitā,abhilanchita,1,1,0,0,12
53524,guṇadosavibhāgavidūhi,gunadosavibhagaviduhi,1,1,0,0,21
53525,paṇḍitapurisehi,panditapurisehi,6,6,0,0,15
53526,pasaṃsitabbā,pasamsitabba,9,9,0,0,12
53527,kāviyāti,kaviyati,1,1,0,0,8
53528,viyatādisī,viyatadisi,1,0,1,0,10
53529,dasavassikā,dasavassika,4,4,0,0,11
53530,sannaddhayobbanābhimukhabhāvena,sannaddhayobbanabhimukhabhavena,1,1,0,0,31
53531,jananayanamanovilubbhinīguṇena,jananayanamanovilubbhinigunena,1,1,0,0,30
53532,cālaṅkatā,calankata,1,1,0,0,9
53533,kuṭṭhadosalesena,kutthadosalesena,1,1,0,0,16
53534,asamphusanīyā,asamphusaniya,1,1,0,0,13
53535,pagevāparā,pagevapara,1,1,0,0,10
53536,saddatthāvalipi,saddatthavalipi,2,2,0,0,15
53537,saddarūpena,saddarupena,4,4,0,0,11
53538,atthalakkhaṇena,atthalakkhanena,1,1,0,0,15
53539,kuṭṭhakappena,kutthakappena,1,1,0,0,13
53540,vajjanīyā,vajjaniya,25,22,3,0,9
53541,bahunāti,bahunati,4,1,3,0,8
53542,guṇībhūtehi,gunibhutehi,1,1,0,0,11
53543,padādidosena,padadidosena,2,2,0,0,12
53544,abhilakkhitā,abhilakkhita,13,13,0,0,12
53545,appasatthāti,appasatthati,1,1,0,0,12
53546,guṇālaṅkāri,gunalankari,1,0,1,0,11
53547,saddālaṅkārasaṅkhātaguṇena,saddalankarasankhatagunena,1,1,0,0,26
53548,yuttāpi,yuttapi,6,6,0,0,7
53549,padadosādinā,padadosadina,1,1,0,0,12
53550,aṇumattenapi,anumattenapi,2,2,0,0,12
53551,guṇālaṅkārasaṃyuttāpi,gunalankarasamyuttapi,1,1,0,0,21
53552,yobbanappattā,yobbanappatta,9,8,1,0,13
53553,vanitāva,vanitava,1,1,0,0,8
53554,guṇadosaparikkhakehi,gunadosaparikkhakehi,2,2,0,0,20
53555,piyasabhāvasaṇṭhitā,piyasabhavasanthita,1,1,0,0,19
53556,manuññehi,manunnehi,2,2,0,0,9
53557,sobhanānurūpagīveyyādiābharaṇavisesehi,sobhananurupagiveyyadiabharanavisesehi,1,1,0,0,38
53558,dissamānena,dissamanena,32,31,1,0,11
53559,setakuṭṭhalavena,setakutthalavena,1,1,0,0,16
53560,dassanīyā,dassaniya,96,90,6,0,9
53561,vuttappakārāpi,vuttappakarapi,1,1,0,0,14
53562,kuṭṭhatulyena,kutthatulyena,1,1,0,0,13
53563,assādanīyāti,assadaniyati,1,1,0,0,12
53564,dosānaṃ,dosanam,55,46,9,0,7
53565,aṅkitāti,ankitati,1,1,0,0,8
53566,tādīsīti,tadisiti,1,0,1,0,8
53567,dosanirāsova,dosanirasova,2,0,2,0,12
53568,mahatā,mahata,533,507,26,0,6
53569,vāyāmena,vayamena,55,54,1,0,8
53570,padadosādīnamanatthanimittānaṃ,padadosadinamanatthanimittanam,1,1,0,0,30
53571,nirāsova,nirasova,5,4,1,0,8
53572,satthadiṭṭhiyā,satthaditthiya,2,2,0,0,14
53573,satthappabhāvato,satthappabhavato,1,1,0,0,16
53574,pariccāgoyeva,pariccagoyeva,2,2,0,0,13
53575,sādhetabbo,sadhetabbo,19,19,0,0,10
53576,dosanirāse,dosanirase,1,1,0,0,10
53577,upalabbhatīti,upalabbhatiti,259,239,20,0,13
53578,sabbappakārena,sabbappakarena,80,80,0,0,14
53579,saddālaṅkārasaṅkhātehi,saddalankarasankhatehi,3,3,0,0,22
53580,guṇarahitaṃ,gunarahitam,1,1,0,0,11
53581,taṃalaṅkatamanupādeyyaṃ,tamalankatamanupadeyyam,1,1,0,0,23
53582,dosayuttā,dosayutta,1,1,0,0,9
53583,anupādeyyā,anupadeyya,1,1,0,0,10
53584,adhikavāyāmena,adhikavayamena,1,1,0,0,14
53585,padadosādīnaṃ,padadosadinam,3,3,0,0,13
53586,nirākaraṇameva,nirakaranameva,1,1,0,0,14
53587,anekasatthavisayāya,anekasatthavisayaya,1,1,0,0,19
53588,nirāsoti,nirasoti,12,1,11,0,8
53589,vattamānāti,vattamanati,13,8,5,0,11
53590,laṅkāraviyuttāpi,lankaraviyuttapi,1,0,1,0,16
53591,kiṃkāraṇamevaṃbhūto,kimkaranamevambhuto,1,1,0,0,19
53592,dosapariccāgena,dosapariccagena,2,2,0,0,15
53593,guṇādānena,gunadanena,1,1,0,0,10
53594,viyuttāpi,viyuttapi,1,1,0,0,9
53595,janānamānandasandohābhisandanekahetutāya,jananamanandasandohabhisandanekahetutaya,1,1,0,0,40
53596,santikamākaḍḍhatīti,santikamakaddhatiti,1,1,0,0,19
53597,tatthodāharaṇamāha,tatthodaharanamaha,1,1,0,0,18
53598,viyā,viya,386,180,206,0,4
53599,kenacipi,kenacipi,55,55,0,0,8
53600,manāpacāritādīhi,manapacaritadihi,1,1,0,0,16
53601,guṇavisesehi,gunavisesehi,15,15,0,0,12
53602,amaṇḍitā,amandita,2,2,0,0,8
53603,apasādhitāpi,apasadhitapi,1,1,0,0,12
53604,evamayaṃ,evamayam,253,244,9,0,8
53605,guṇādāne,gunadane,1,1,0,0,8
53606,laṅkāraviyutte,lankaraviyutte,1,0,1,0,14
53607,viyuttā,viyutta,6,6,0,0,7
53608,satīpi,satipi,12,12,0,0,6
53609,guṇībhūtā,gunibhuta,8,8,0,0,9
53610,dubbaṇṇadussaṇṭhānādidosehi,dubbannadussanthanadidosehi,1,1,0,0,27
53611,hadayaṅgamaguṇayuttā,hadayangamagunayutta,1,1,0,0,20
53612,sodāharaṇametesaṃ,sodaharanametesam,3,2,1,0,17
53613,guṇālaṅkārasaṃyuttāyapi,gunalankarasamyuttayapi,1,1,0,0,23
53614,dosalavaṅkitāya,dosalavankitaya,1,1,0,0,15
53615,viññūnamanādaraṇīyatā,vinnunamanadaraniyata,1,1,0,0,21
53616,alaṅkāraviyuttāpi,alankaraviyuttapi,1,1,0,0,17
53617,dosābhāvena,dosabhavena,1,1,0,0,11
53618,guṇayuttāya,gunayuttaya,1,1,0,0,11
53619,manoharatā,manoharata,1,1,0,0,10
53620,evamanatthāvahassāpi,evamanatthavahassapi,1,1,0,0,20
53621,pariharitabbatā,pariharitabbata,1,1,0,0,15
53622,vākyānaṃ,vakyanam,16,13,3,0,8
53623,tadattho,tadattho,53,50,3,0,8
53624,lakkhyabhāvenāti,lakkhyabhavenati,1,1,0,0,16
53625,udāharaṇehīti,udaharanehiti,1,1,0,0,13
53626,sodāharaṇaṃ,sodaharanam,5,2,3,0,11
53627,lakkhiyamanenāti,lakkhiyamanenati,2,2,0,0,16
53628,alaṅkārayuttāpi,alankarayuttapi,1,1,0,0,15
53629,appakena,appakena,33,33,0,0,8
53630,yuttabandhassa,yuttabandhassa,1,1,0,0,14
53631,anupādeyyattā,anupadeyyatta,2,2,0,0,13
53632,alaṅkāraalaṅkaraṇe,alankaraalankarane,1,1,0,0,18
53633,asatipi,asatipi,152,151,1,0,7
53634,dosarahite,dosarahite,1,1,0,0,10
53635,upādeyyattā,upadeyyatta,1,1,0,0,11
53636,mukhyassa,mukhyassa,3,3,0,0,9
53637,dosaparihārassa,dosapariharassa,1,1,0,0,15
53638,kattabbattā,kattabbatta,38,36,2,0,11
53639,adhigatadose,adhigatadose,1,1,0,0,12
53640,nāmādicatubbidhapade,namadicatubbidhapade,1,1,0,0,20
53641,syādyantatyādyantānaṃ,syadyantatyadyantanam,1,1,0,0,21
53642,sakārakakiriyā,sakarakakiriya,1,1,0,0,14
53643,vuttalakkhaṇe,vuttalakkhane,20,20,0,0,13
53644,padavākyānaṃ,padavakyanam,3,3,0,0,12
53645,anekappakārā,anekappakara,31,29,2,0,12
53646,dosabhāvena,dosabhavena,1,1,0,0,11
53647,padādidosānaṃ,padadidosanam,1,1,0,0,13
53648,udāharaṇasahitaṃ,udaharanasahitam,1,1,0,0,16
53649,kathayāmi,kathayami,3,3,0,0,9
53650,nāmākhyātopasaggikaṃ,namakhyatopasaggikam,1,1,0,0,20
53651,nipātakañca,nipatakanca,1,1,0,0,11
53652,khalvābhidhāvatī,khalvabhidhavati,1,1,0,0,16
53653,rūpabhiddhiṭīkāyaṃ,rupabhiddhitikayam,1,1,0,0,18
53654,nāmakaṇḍe,namakande,1,1,0,0,9
53655,vuttaniyāmena,vuttaniyamena,16,16,0,0,13
53656,udāharīyanti,udahariyanti,2,2,0,0,12
53657,lakkhiyabhāvenāti,lakkhiyabhavenati,1,1,0,0,17
53658,udāharaṇānīti,udaharananiti,1,0,1,0,13
53659,udāharaṇenāti,udaharanenati,1,1,0,0,13
53660,padadosauddesa,padadosauddesa,1,1,0,0,14
53661,viruddhatthantarājhatthakiliṭṭhāni,viruddhatthantarajhatthakilitthani,1,0,1,0,34
53662,hīnatthakamanatthakaṃ,hinatthakamanatthakam,1,0,1,0,21
53663,vākyadosauddesa,vakyadosauddesa,1,1,0,0,15
53664,vākyānamekatthaṃ,vakyanamekattham,1,0,1,0,16
53665,byākiṇṇagāmmāni,byakinnagammani,1,0,1,0,15
53666,ativuttamapetatthaṃ,ativuttamapetattham,1,0,1,0,19
53667,padadosādiuddesavaṇṇanā,padadosadiuddesavannana,1,1,0,0,23
53668,para18-19-20,para18-19-20,2,2,0,0,12
53669,yathāpaṭiññāte,yathapatinnate,4,4,0,0,14
53670,uddisati,uddisati,71,69,2,0,8
53671,viruddhatthantara,viruddhatthantara,1,0,1,0,17
53672,iccādinā,iccadina,171,171,0,0,8
53673,evamuparipi,evamuparipi,155,155,0,0,11
53674,visesyassa,visesyassa,11,11,0,0,10
53675,adhyatthaṃ,adhyattham,1,0,1,0,10
53676,nīyati,niyati,88,82,6,0,6
53677,avutto,avutto,26,24,2,0,6
53678,ānīyatīti,aniyatiti,2,2,0,0,9
53679,duṭṭhāni,dutthani,24,23,1,0,8
53680,viruddhatthantaratādayo,viruddhatthantaratadayo,1,1,0,0,23
53681,dosāti,dosati,13,5,8,0,6
53682,apakkamatādayo,apakkamatadayo,1,1,0,0,14
53683,vākyatthadosā,vakyatthadosa,2,1,1,0,13
53684,vākyatthānaṃ,vakyatthanam,1,1,0,0,12
53685,dosato,dosato,23,22,1,0,6
53686,vākyameva,vakyameva,25,25,0,0,9
53687,visesyate,visesyate,1,1,0,0,9
53688,napuṃsakaliṅgena,napumsakalingena,23,23,0,0,16
53689,kathetabbabhāvena,kathetabbabhavena,6,4,2,0,17
53690,paṭiññāte,patinnate,12,12,0,0,9
53691,uddisanto,uddisanto,10,10,0,0,9
53692,viruddha,viruddha,9,4,5,0,8
53693,icchitatthato,icchitatthato,2,2,0,0,13
53694,viruddho,viruddho,37,36,1,0,8
53695,aññattho,annattho,20,19,1,0,8
53696,padassāti,padassati,10,4,6,0,9
53697,adhikatthabhāvakaraṇato,adhikatthabhavakaranato,1,1,0,0,23
53698,ajhatthaṃ,ajhattham,4,2,2,0,9
53699,icchitatthassāvīkaraṇe,icchitatthassavikarane,1,1,0,0,22
53700,avisadattā,avisadatta,2,2,0,0,10
53701,desakālakalādīnaṃ,desakalakaladinam,1,1,0,0,17
53702,aññamāharitvā,annamaharitva,1,1,0,0,13
53703,vattabbato,vattabbato,79,75,4,0,10
53704,patvāva,patvava,23,23,0,0,7
53705,sātthakabhāvappattito,satthakabhavappattito,1,1,0,0,21
53706,hīnatāpādanato,hinatapadanato,1,1,0,0,14
53707,hīnatthakaṃ,hinatthakam,1,0,1,0,11
53708,attharahitattā,attharahitatta,2,2,0,0,14
53709,anatthakaṃ,anatthakam,5,4,1,0,10
53710,padanissitattā,padanissitatta,1,1,0,0,14
53711,padadosā,padadosa,1,0,1,0,8
53712,vuttatthasseva,vuttatthasseva,1,1,0,0,14
53713,bhinnakkamattā,bhinnakkamatta,1,1,0,0,14
53714,sammohakāraṇattā,sammohakaranatta,1,1,0,0,16
53715,visiṭṭhavacanavirahato,visitthavacanavirahato,1,1,0,0,22
53716,yatisampattivirahato,yatisampattivirahato,1,1,0,0,20
53717,cutattā,cutatta,5,5,0,0,7
53718,vohāramatikkamma,voharamatikkamma,1,1,0,0,16
53719,apagatattā,apagatatta,11,11,0,0,10
53720,bandhapharusayuttattā,bandhapharusayuttatta,1,1,0,0,21
53721,sabandhapharusanti,sabandhapharusanti,1,1,0,0,18
53722,upasaṃharati,upasamharati,218,213,5,0,12
53723,apagatakkamattā,apagatakkamatta,1,1,0,0,15
53724,apakkamaṃ,apakkamam,2,0,2,0,9
53725,ucitabhāvassa,ucitabhavassa,1,1,0,0,13
53726,parihīnattā,parihinatta,18,17,1,0,11
53727,bhinnavibhattikkamattā,bhinnavibhattikkamatta,1,1,0,0,22
53728,saṃsayajananato,samsayajananato,1,1,0,0,15
53729,duppatītikarattā,duppatitikaratta,2,2,0,0,16
53730,dūsitālaṅkārattā,dusitalankaratta,1,1,0,0,16
53731,duṭṭhālaṅkati,dutthalankati,1,0,1,0,13
53732,nāmātime,namatime,1,1,0,0,8
53733,vākyatthanissitattā,vakyatthanissitatta,1,1,0,0,19
53734,atthantaro,atthantaro,8,7,1,0,10
53735,dosapakāsakapadampi,dosapakasakapadampi,1,1,0,0,19
53736,abyatirittattā,abyatirittatta,2,2,0,0,14
53737,esevanayo,esevanayo,22,21,1,0,9
53738,paresupi,paresupi,108,108,0,0,8
53739,malaggahito,malaggahito,1,1,0,0,11
53740,kiliṭṭhattā,kilitthatta,1,1,0,0,11
53741,mukhādīnaṃ,mukhadinam,1,1,0,0,10
53742,avisado,avisado,10,10,0,0,7
53743,evamadhippetatthappakāsane,evamadhippetatthappakasane,1,1,0,0,26
53744,apekkhā,apekkha,85,81,4,0,7
53745,padadosānaṃ,padadosanam,1,1,0,0,11
53746,anaññattepi,anannattepi,12,12,0,0,11
53747,vikappanābhedato,vikappanabhedato,1,1,0,0,16
53748,silāputtakassa,silaputtakassa,19,19,0,0,14
53749,eseva,eseva,3480,3277,203,0,5
53750,bhaggārīti,bhaggariti,1,1,0,0,10
53751,ākiṇṇaṃ,akinnam,31,28,3,0,7
53752,gāmmo,gammo,5,2,3,0,5
53753,abyattānaṃ,abyattanam,2,2,0,0,10
53754,tappakāsakapadampi,tappakasakapadampi,1,1,0,0,18
53755,saṃsayena,samsayena,8,8,0,0,9
53756,vuttanayameva,vuttanayameva,643,637,6,0,13
53757,dūsitā,dusita,17,17,0,0,6
53758,alaṅkati,alankati,4,2,2,0,8
53759,tannissitā,tannissita,14,14,0,0,10
53760,vākyatthanissitāti,vakyatthanissitati,1,0,1,0,18
53761,anatthakāpetatthadosadvayaṃ,anatthakapetatthadosadvayam,1,1,0,0,27
53762,padavākyato,padavakyato,2,2,0,0,11
53763,bhaggarītidosadvayaṃ,bhaggaritidosadvayam,1,1,0,0,20
53764,gāmmadvayaṃ,gammadvayam,1,1,0,0,11
53765,kamaccutaapakkamadvayañca,kamaccutaapakkamadvayanca,1,1,0,0,25
53766,vākyavākyatthato,vakyavakyatthato,1,1,0,0,16
53767,padadosaniddesavaṇṇanā,padadosaniddesavannana,2,2,0,0,22
53768,athoddesakkamena,athoddesakkamena,1,1,0,0,16
53769,padādidose,padadidose,1,1,0,0,10
53770,udāharati,udaharati,91,91,0,0,9
53771,viruddhi,viruddhi,3,1,2,0,8
53772,pasiddhiyaṃ,pasiddhiyam,11,11,0,0,11
53773,adhippetato,adhippetato,3,3,0,0,11
53774,virujjhatīti,virujjhatiti,102,97,5,0,12
53775,yathe,yathe,41,12,29,0,5
53776,tyudāharati,tyudaharati,16,16,0,0,11
53777,tvidameveti,tvidameveti,1,1,0,0,11
53778,jananti,jananti,7,7,0,0,7
53779,vārivaho,varivaho,12,12,0,0,8
53780,kavicchitattho,kavicchitattho,1,1,0,0,14
53781,garaḷassa,garalassa,2,2,0,0,9
53782,garaḷado,garalado,1,1,0,0,8
53783,mārayati,marayati,7,7,0,0,8
53784,visesanapadassa,visesanapadassa,1,1,0,0,15
53785,viruddhatā,viruddhata,3,3,0,0,10
53786,uddiṭṭhānukkamena,udditthanukkamena,6,6,0,0,17
53787,viruddhatthantarādīnaṃ,viruddhatthantaradinam,2,2,0,0,22
53788,salakkhaṇalakkhiyaṃ,salakkhanalakkhiyam,1,1,0,0,19
53789,kavicchitatthato,kavicchitatthato,1,1,0,0,16
53790,icchitatthe,icchitatthe,3,3,0,0,11
53791,virujjhatī,virujjhati,25,20,5,0,10
53792,pakāsetvā,pakasetva,345,341,4,0,9
53793,pakāsitatthavisaye,pakasitatthavisaye,1,1,0,0,18
53794,hī,hi,1063,169,894,0,2
53795,yojitattā,yojitatta,24,23,1,0,9
53796,anuvaditabbaappasiddhaviruddhatthantaraṃ,anuvaditabbaappasiddhaviruddhatthantaram,1,1,0,0,40
53797,pasiddhānuvādena,pasiddhanuvadena,2,2,0,0,16
53798,appasiddhavidhānameva,appasiddhavidhanameva,1,1,0,0,21
53799,lakkhiyaṃ,lakkhiyam,11,11,0,0,9
53800,evamīdisamaññampi,evamidisamannampi,1,1,0,0,17
53801,imassudāharaṇaṃ,imassudaharanam,1,1,0,0,15
53802,ccādimeva,ccadimeva,1,1,0,0,9
53803,saddapariyāyatthepi,saddapariyayatthepi,1,1,0,0,19
53804,udāharaṇattho,udaharanattho,2,2,0,0,13
53805,uparipyevaṃ,uparipyevam,1,1,0,0,11
53806,visasaṅkhātaṃ,visasankhatam,2,2,0,0,13
53807,adhippetattho,adhippetattho,9,9,0,0,13
53808,garaḷasaṅkhātasappavisavācakattā,garalasankhatasappavisavacakatta,1,1,0,0,32
53809,udakavisānaṃ,udakavisanam,1,1,0,0,12
53810,visadāyako,visadayako,1,1,0,0,10
53811,nāsetiyeva,nasetiyeva,2,2,0,0,10
53812,adhippetassa,adhippetassa,17,16,1,0,12
53813,sukhakāraṇassa,sukhakaranassa,1,1,0,0,14
53814,meghavisesana,meghavisesana,1,1,0,0,13
53815,viruddhaaññatthatāti,viruddhaannatthatati,1,1,0,0,20
53816,viruddhatthantaradosena,viruddhatthantaradosena,1,1,0,0,23
53817,duṭṭhanti,dutthanti,2,2,0,0,9
53818,visesyamadhikaṃ,visesyamadhikam,1,0,1,0,15
53819,dhyatthametaṃ,dhyatthametam,1,0,1,0,13
53820,syaṃ,syam,1,1,0,0,4
53821,visesitabbaṃ,visesitabbam,19,19,0,0,12
53822,atthavasena,atthavasena,138,136,2,0,11
53823,bhavatītyanuvaditvā,bhavatityanuvaditva,1,1,0,0,19
53824,obhāsite,obhasite,1,0,1,0,8
53825,nikhilā,nikhila,4,4,0,0,7
53826,disāyena,disayena,1,1,0,0,8
53827,khajjotassākhiladisābhāgāvabhāsanamativuttīti,khajjotassakhiladisabhagavabhasanamativuttiti,1,1,0,0,45
53828,adhikatthaṃ,adhikattham,2,2,0,0,11
53829,visesanapadena,visesanapadena,1,1,0,0,14
53830,yathāvuttalakkhaṇopetaṃ,yathavuttalakkhanopetam,1,1,0,0,23
53831,padadoso,padadoso,1,1,0,0,8
53832,tassudāharaṇamevaṃ,tassudaharanamevam,2,2,0,0,18
53833,jotitasabbadiso,jotitasabbadiso,1,1,0,0,15
53834,jotiriṅgaṇo,jotiringano,1,1,0,0,11
53835,khajjotassa,khajjotassa,3,3,0,0,11
53836,sakaladisobhāsanassa,sakaladisobhasanassa,1,1,0,0,20
53837,ajhatthattā,ajhatthatta,1,1,0,0,11
53838,atyuttattā,atyuttatta,1,1,0,0,10
53839,visesanapadaṃ,visesanapadam,11,11,0,0,13
53840,ajhatthapadadoso,ajhatthapadadoso,1,1,0,0,16
53841,asesadisā,asesadisa,2,2,0,0,9
53842,tthāvagamo,tthavagamo,1,0,1,0,10
53843,pakatyādivibhāgato,pakatyadivibhagato,3,1,2,0,18
53844,yamāliṅgyate,yamalingyate,1,0,1,0,12
53845,pakatyādivibhāgatoti,pakatyadivibhagatoti,1,0,1,0,20
53846,pakatyādīnaṃvibhāgato,pakatyadinamvibhagato,1,1,0,0,21
53847,vibhajanato,vibhajanato,5,5,0,0,11
53848,ayamādeso,ayamadeso,2,2,0,0,9
53849,pakatipaccayavibhāgakappanatoti,pakatipaccayavibhagakappanatoti,1,1,0,0,31
53850,vallabhāya,vallabhaya,4,4,0,0,10
53851,āliṅgyate,alingyate,2,0,2,0,9
53852,silissate,silissate,3,3,0,0,9
53853,atthāvagamo,atthavagamo,4,3,1,0,11
53854,atthāvabodho,atthavabodho,4,4,0,0,12
53855,pakatyādīnaṃ,pakatyadinam,1,1,0,0,12
53856,vibhajanajānanena,vibhajanajananena,1,1,0,0,17
53857,pakatyādi,pakatyadi,1,1,0,0,9
53858,vanitāya,vanitaya,13,13,0,0,8
53859,piyāsaṅkhātāya,piyasankhataya,1,1,0,0,14
53860,mandābhidheyyaṃ,mandabhidheyyam,3,0,3,0,15
53861,yamakādikamanadhippetampi,yamakadikamanadhippetampi,1,1,0,0,25
53862,kiliṭṭheyeva,kilittheyeva,1,1,0,0,12
53863,aniyamavacanaṃ,aniyamavacanam,13,13,0,0,14
53864,yamakādikanti,yamakadikanti,1,1,0,0,13
53865,yamakamādi,yamakamadi,1,1,0,0,10
53866,paheḷikājātassa,pahelikajatassa,2,2,0,0,15
53867,kīdisanti,kidisanti,14,14,0,0,9
53868,appatītadosasabhāve,appatitadosasabhave,1,1,0,0,19
53869,ṭhitatāya,thitataya,9,9,0,0,9
53870,malitānyavisadāni,malitanyavisadani,1,1,0,0,17
53871,appako,appako,17,16,1,0,6
53872,abhidheyyo,abhidheyyo,21,18,3,0,10
53873,kiliṭṭhapadadoseyeva,kilitthapadadoseyeva,2,1,1,0,20
53874,vidhīyati,vidhiyati,15,15,0,0,9
53875,pakkhipīyati,pakkhipiyati,2,2,0,0,12
53876,kiliṭṭhapadadosato,kilitthapadadosato,2,2,0,0,18
53877,byatiriccatīti,byatiriccatiti,2,2,0,0,14
53878,anadhippetamapi,anadhippetamapi,1,1,0,0,15
53879,yamakādiṃ,yamakadim,1,1,0,0,9
53880,kiliṭṭhadoseyeva,kilitthadoseyeva,1,1,0,0,16
53881,antokaraṇabyājena,antokaranabyajena,1,1,0,0,17
53882,āvīkaronto,avikaronto,2,2,0,0,10
53883,kiliṭṭhe,kilitthe,5,4,1,0,8
53884,appatītadosena,appatitadosena,1,1,0,0,14
53885,avisadapadaṃ,avisadapadam,1,1,0,0,12
53886,appakābhidheyyaṃ,appakabhidheyyam,1,1,0,0,16
53887,yamakappaheḷikājātamatthi,yamakappahelikajatamatthi,1,1,0,0,25
53888,yathāvuttakiliṭṭhapadadoseyeva,yathavuttakilitthapadadoseyeva,1,1,0,0,30
53889,abyatirittanti,abyatirittanti,2,2,0,0,14
53890,kiliṭṭhapadānaṃ,kilitthapadanam,1,1,0,0,15
53891,dosoti,dosoti,170,138,32,0,6
53892,kāmamanabhimatamedisaṃ,kamamanabhimatamedisam,1,1,0,0,22
53893,kiñcarahi,kincarahi,66,66,0,0,9
53894,abhimatanti,abhimatanti,2,2,0,0,11
53895,patīti,patiti,50,28,22,0,6
53896,vacanīyatthappatītavasena,vacaniyatthappatitavasena,1,1,0,0,25
53897,vācakāpi,vacakapi,1,1,0,0,8
53898,patītāyeva,patitayeva,1,1,0,0,10
53899,patītehi,patitehi,2,2,0,0,8
53900,pasiddhehi,pasiddhehi,2,2,0,0,10
53901,pāṭipadikehi,patipadikehi,9,9,0,0,12
53902,siliṭṭhā,silittha,6,6,0,0,8
53903,aññamaññāliṅganena,annamannalinganena,1,1,0,0,18
53904,maṭṭhā,mattha,16,15,1,0,6
53905,syādyantādīnaṃ,syadyantadinam,2,2,0,0,14
53906,sandhanā,sandhana,1,1,0,0,8
53907,sammadevopetaṃ,sammadevopetam,1,1,0,0,14
53908,edisaṃ,edisam,96,84,12,0,6
53909,yathāvuttaguṇāsayaṃ,yathavuttagunasayam,1,1,0,0,19
53910,adhigatesu,adhigatesu,2,2,0,0,10
53911,yamakesu,yamakesu,23,23,0,0,8
53912,yamakamiṭṭhamiti,yamakamitthamiti,1,1,0,0,16
53913,upadisanto,upadisanto,14,13,1,0,10
53914,patīte,patite,4,3,1,0,6
53915,imassatthassāyaṃ,imassatthassayam,1,1,0,0,16
53916,syādyantādipadānaṃ,syadyantadipadanam,1,1,0,0,18
53917,pasādasaṅkhātena,pasadasankhatena,1,1,0,0,16
53918,saddālaṅkāraguṇena,saddalankaragunena,1,1,0,0,18
53919,evaṃbhūtaṃ,evambhutam,21,19,2,0,10
53920,guṇādhikato,gunadhikato,1,1,0,0,11
53921,vakkhamānayamakasadisaṃ,vakkhamanayamakasadisam,1,1,0,0,23
53922,patītā,patita,27,27,0,0,6
53923,pasādoti,pasadoti,30,15,15,0,8
53924,saddālaṅkāro,saddalankaro,1,1,0,0,12
53925,saṃyuttanti,samyuttanti,1,1,0,0,11
53926,ññamāvuttānekavaṇṇajaṃ,nnamavuttanekavannajam,1,0,1,0,22
53927,pādānamādimajjhantagocaraṃ,padanamadimajjhantagocaram,1,0,1,0,26
53928,yathāvuttamabhimataṃ,yathavuttamabhimatam,1,1,0,0,20
53929,dassetumupakkamate,dassetumupakkamate,2,2,0,0,18
53930,abyapete,abyapete,3,0,3,0,8
53931,āvuttā,avutta,1,0,1,0,6
53932,adhivuttā,adhivutta,1,1,0,0,9
53933,punappunuccāraṇupetā,punappunuccaranupeta,1,1,0,0,20
53934,patirūpattā,patirupatta,1,1,0,0,11
53935,bahuvaṇṇā,bahuvanna,1,1,0,0,9
53936,sarabyañjanarūpā,sarabyanjanarupa,1,1,0,0,16
53937,tassānuppāsattā,tassanuppasatta,1,1,0,0,15
53938,vaṇṇāvutti,vannavutti,3,2,1,0,10
53939,yamakanti,yamakanti,5,5,0,0,9
53940,katividhaṃ,katividham,12,9,3,0,10
53941,vikappīyatīti,vikappiyatiti,1,1,0,0,13
53942,byapetaññaṃ,byapetannam,1,0,1,0,11
53943,vaṇṇantarābyavahitaṃ,vannantarabyavahitam,1,1,0,0,20
53944,vaṇṇasamudāyena,vannasamudayena,1,1,0,0,15
53945,tadabyapetaṃ,tadabyapetam,1,0,1,0,12
53946,byavahitaṃ,byavahitam,7,7,0,0,10
53947,byapetaṃ,byapetam,4,0,4,0,8
53948,ubhayamissaṃ,ubhayamissam,1,1,0,0,12
53949,abyapetabyapetaṃ,abyapetabyapetam,2,1,1,0,16
53950,vikappīyate,vikappiyate,1,1,0,0,11
53951,tametaṃ,tametam,11,11,0,0,7
53952,visayavibhāganirūpanāyaṃ,visayavibhaganirupanayam,1,1,0,0,24
53953,ādimajjhantagocaraṃ,adimajjhantagocaram,1,0,1,0,19
53954,pādānaṃ,padanam,119,110,9,0,7
53955,catunnaṃgāthāvayavānaṃ,catunnamgathavayavanam,1,1,0,0,22
53956,sāpekkhattepi,sapekkhattepi,4,4,0,0,13
53957,gammakattā,gammakatta,1,1,0,0,10
53958,pādacatukkassa,padacatukkassa,2,2,0,0,14
53959,ādimajjhantabhāvīnaṃ,adimajjhantabhavinam,1,1,0,0,20
53960,yamakānaṃ,yamakanam,22,20,2,0,9
53961,yāvanto,yavanto,23,23,0,0,7
53962,mūlā,mula,78,70,8,0,4
53963,ekasmiṃyeva,ekasmimyeva,216,209,7,0,11
53964,ādiyamakaṃ,adiyamakam,1,1,0,0,10
53965,majjhayamakaṃ,majjhayamakam,1,1,0,0,13
53966,antayamakaṃ,antayamakam,1,1,0,0,11
53967,majjhantayamakaṃ,majjhantayamakam,2,2,0,0,16
53968,majjhādiyamakaṃ,majjhadiyamakam,2,2,0,0,15
53969,ādyantayamakaṃ,adyantayamakam,2,2,0,0,14
53970,sabbayamakanti,sabbayamakanti,1,1,0,0,14
53971,mūlabhūtā,mulabhuta,45,44,1,0,9
53972,pādādiyamakañca,padadiyamakanca,1,1,0,0,15
53973,paṭhamapādādiyamakamabyapetaṃ,pathamapadadiyamakamabyapetam,2,2,0,0,29
53974,dutiyatatiyacatutthapādādiyamakamabyapetaṃ,dutiyatatiyacatutthapadadiyamakamabyapetam,1,1,0,0,42
53975,paṭhamadutiyapādādiyamakamabyapetaṃ,pathamadutiyapadadiyamakamabyapetam,2,2,0,0,35
53976,paṭhamatatiyapādādiyamakamabyapetaṃ,pathamatatiyapadadiyamakamabyapetam,1,1,0,0,35
53977,paṭhamacatutthapādādiyamakamabyapetantiādinā,pathamacatutthapadadiyamakamabyapetantiadina,1,1,0,0,44
53978,sabbatoyamakaṃ,sabbatoyamakam,1,1,0,0,14
53979,mahāyamakādayo,mahayamakadayo,1,1,0,0,14
53980,vikappā,vikappa,19,19,0,0,7
53981,jāyantīti,jayantiti,56,43,13,0,9
53982,abhimatayamakaṃ,abhimatayamakam,1,1,0,0,15
53983,āvuttehi,avuttehi,1,1,0,0,8
53984,anekavaṇṇehi,anekavannehi,4,4,0,0,12
53985,samudāyarūpattā,samudayarupatta,1,1,0,0,15
53986,sarabyañjanasarīrehi,sarabyanjanasarirehi,1,1,0,0,20
53987,abyavahitattā,abyavahitatta,3,3,0,0,13
53988,vaṇṇantarehi,vannantarehi,1,1,0,0,12
53989,byavahitattā,byavahitatta,11,11,0,0,12
53990,ubhayamissakattā,ubhayamissakatta,2,2,0,0,16
53991,abyapetabyapetañcāti,abyapetabyapetancati,1,0,1,0,20
53992,visayavibhāganiyamena,visayavibhaganiyamena,1,1,0,0,21
53993,gāthāpādānaṃ,gathapadanam,3,3,0,0,12
53994,ādigocaraṃ,adigocaram,1,1,0,0,10
53995,majjhagocaraṃ,majjhagocaram,1,1,0,0,13
53996,antagocaramiti,antagocaramiti,1,1,0,0,14
53997,vattabbantare,vattabbantare,1,1,0,0,13
53998,vattabbantaraṃ,vattabbantaram,1,1,0,0,14
53999,yathāvuttaabyapetādibhedato,yathavuttaabyapetadibhedato,1,1,0,0,27
54000,vattabbatāya,vattabbataya,22,22,0,0,12
54001,samukhībhūtaṃ,samukhibhutam,1,1,0,0,13
54002,ādimajjhāvasānantaraṃ,adimajjhavasanantaram,1,1,0,0,21
54003,upanyāso,upanyaso,4,4,0,0,8
54004,vākyārambhoti,vakyarambhoti,1,1,0,0,13
54005,etasseva,etasseva,117,109,8,0,8
54006,visadisena,visadisena,2,2,0,0,10
54007,tabbiparītama,tabbiparitama,1,1,0,0,13
54008,abyapetañca,abyapetanca,2,2,0,0,11
54009,byapetañca,byapetanca,2,2,0,0,10
54010,aññañcāti,annancati,3,1,2,0,9
54011,āvuttāyeva,avuttayeva,1,1,0,0,10
54012,anekavaṇṇā,anekavanna,13,11,2,0,10
54013,ādimajjhāvasānesu,adimajjhavasanesu,1,1,0,0,17
54014,labbhamānayamakabhedā,labbhamanayamakabheda,1,1,0,0,21
54015,pādādiyamakaṃ,padadiyamakam,8,8,0,0,13
54016,pādamajjhayamakaṃ,padamajjhayamakam,1,1,0,0,17
54017,pādantayamakaṃ,padantayamakam,1,1,0,0,14
54018,sabbatoyamakanti,sabbatoyamakanti,1,1,0,0,16
54019,mūlabhūtayamakā,mulabhutayamaka,1,1,0,0,15
54020,aṭṭhavīsa,atthavisa,23,22,1,0,9
54021,pādādiyamakādikampi,padadiyamakadikampi,1,1,0,0,19
54022,abyapetapaṭhamapādādiyamakaṃ,abyapetapathamapadadiyamakam,2,2,0,0,28
54023,dutiyatatiyacatutthapādādiyamakamiti,dutiyatatiyacatutthapadadiyamakamiti,1,1,0,0,36
54024,abyapetapaṭhamadutiyapādādiyamakaṃ,abyapetapathamadutiyapadadiyamakam,2,2,0,0,34
54025,paṭhamatatiyapādādiyamakaṃ,pathamatatiyapadadiyamakam,1,1,0,0,26
54026,paṭhamacatutthapādādiyamakamiti,pathamacatutthapadadiyamakamiti,1,1,0,0,31
54027,abyapetadutiyatatiyapādādiyamakaṃ,abyapetadutiyatatiyapadadiyamakam,1,1,0,0,33
54028,dutiyacatutthapādādiyamakamiti,dutiyacatutthapadadiyamakamiti,1,1,0,0,30
54029,abyapetatatiyacatutthapādādiyamakamiti,abyapetatatiyacatutthapadadiyamakamiti,1,1,0,0,38
54030,evamabyapetapādādiyamakā,evamabyapetapadadiyamaka,1,1,0,0,24
54031,byapetāpi,byapetapi,1,1,0,0,9
54032,dasāti,dasati,203,175,28,0,6
54033,abyapetapaṭhamapādamajjhayamakaṃ,abyapetapathamapadamajjhayamakam,1,1,0,0,32
54034,dutiyapādamajjhayamakamiccādinā,dutiyapadamajjhayamakamiccadina,1,1,0,0,31
54035,majjhayamakampi,majjhayamakampi,1,1,0,0,15
54036,vīsatividhaṃ,visatividham,8,8,0,0,12
54037,abyapetapaṭhamapādantayamakaṃ,abyapetapathamapadantayamakam,1,1,0,0,29
54038,dutiyapādantayamakamiccādinā,dutiyapadantayamakamiccadina,1,1,0,0,28
54039,antayamakampi,antayamakampi,1,1,0,0,13
54040,saṃsaggabhedato,samsaggabhedato,4,2,2,0,15
54041,anekavidhaṃ,anekavidham,76,70,6,0,11
54042,abyapetapaṭhamapādādiyamakavaṇṇanā,abyapetapathamapadadiyamakavannana,1,1,0,0,34
54043,asujanā,asujana,2,0,2,0,7
54044,asajjanāti,asajjanati,1,1,0,0,10
54045,ubhayapakkhapātino,ubhayapakkhapatino,1,1,0,0,18
54046,sīlādinā,siladina,11,11,0,0,8
54047,vivekinopi,vivekinopi,2,1,1,0,10
54048,labbhamānānamasādhūsvanupalabbhanato,labbhamananamasadhusvanupalabbhanato,1,1,0,0,36
54049,puthubhūtāpi,puthubhutapi,2,2,0,0,12
54050,avivekīnaṃ,avivekinam,1,1,0,0,10
54051,napāpuṇanti,napapunanti,2,2,0,0,11
54052,vibhāgavijānanapaññāvekallena,vibhagavijananapannavekallena,1,1,0,0,29
54053,abyapetapaṭhamapādādiyamakassa,abyapetapathamapadadiyamakassa,1,1,0,0,30
54054,mukhamattaṃ,mukhamattam,22,21,1,0,11
54055,sujani,sujani,2,1,1,0,6
54056,sādhujanā,sadhujana,2,2,0,0,9
54057,asādhujanā,asadhujana,1,1,0,0,10
54058,ubhayapakkhikā,ubhayapakkhika,3,3,0,0,14
54059,pāṇātipātādinā,panatipatadina,5,5,0,0,14
54060,pāṇātipātādīnaṃ,panatipatadinam,59,58,1,0,15
54061,asādhūsu,asadhusu,1,1,0,0,8
54062,sīlādīnaṃ,siladinam,38,37,1,0,9
54063,appavattito,appavattito,33,33,0,0,11
54064,vivekañāṇarahitānaṃ,vivekananarahitanam,1,1,0,0,19
54065,vinābhavanametesamatthīti,vinabhavanametesamatthiti,1,1,0,0,25
54066,visayopacārena,visayopacarena,2,2,0,0,14
54067,vivekoti,vivekoti,19,4,15,0,8
54068,vivekinoti,vivekinoti,3,3,0,0,10
54069,avivekino,avivekino,1,1,0,0,9
54070,antikamiti,antikamiti,1,1,0,0,10
54071,abyapetapaṭhamadutiyapādādiyamakavaṇṇanā,abyapetapathamadutiyapadadiyamakavannana,1,1,0,0,40
54072,āsevanappaṭilābhavasena,asevanappatilabhavasena,1,1,0,0,23
54073,anantaratthe,anantaratthe,10,10,0,0,12
54074,apabalā,apabala,2,0,2,0,7
54075,tadabhāvato,tadabhavato,204,204,0,0,11
54076,dubbalā,dubbala,166,153,13,0,7
54077,yattakaṃ,yattakam,264,250,14,0,8
54078,ahosittaṃ,ahosittam,3,0,3,0,9
54079,uppattimattaṃ,uppattimattam,2,2,0,0,13
54080,phaladānāsambhavato,phaladanasambhavato,2,2,0,0,19
54081,vacanīyatthanimittamattakammabhāvena,vacaniyatthanimittamattakammabhavena,1,1,0,0,36
54082,ahosikammattaṃ,ahosikammattam,1,1,0,0,14
54083,tattakaṃ,tattakam,207,204,3,0,8
54084,padantīti,padantiti,1,1,0,0,9
54085,saṃsārapavatti,samsarapavatti,6,5,1,0,14
54086,sukhadukkhadāyakā,sukhadukkhadayaka,1,1,0,0,17
54087,āsevanādipaccayalābhena,asevanadipaccayalabhena,1,1,0,0,23
54088,tadabhāvena,tadabhavena,70,70,0,0,11
54089,phaladānābhāvato,phaladanabhavato,2,2,0,0,16
54090,pavattimattataṃ,pavattimattatam,1,1,0,0,15
54091,appattā,appatta,59,55,4,0,7
54092,sukhadukkhapadāyino,sukhadukkhapadayino,1,1,0,0,19
54093,kusalapaṭipakkhā,kusalapatipakkha,4,4,0,0,16
54094,ehipassiko,ehipassiko,70,66,4,0,10
54095,kriyāpadatopi,kriyapadatopi,1,1,0,0,13
54096,ṇā,na,29,8,21,0,2
54097,dipaccayā,dipaccaya,1,1,0,0,9
54098,abyapetapaṭhamadutiyatatiyapādādiyamakavaṇṇanā,abyapetapathamadutiyatatiyapadadiyamakavannana,1,1,0,0,46
54099,vandanāmānabhājane,vandanamanabhajane,2,0,2,0,18
54100,dvārattayopadassiyamānā,dvarattayopadassiyamana,1,1,0,0,23
54101,pūjā,puja,151,139,12,0,4
54102,ratijananādinā,ratijananadina,1,1,0,0,14
54103,ratanasaṅkhātānaṃ,ratanasankhatanam,2,2,0,0,17
54104,buddhādīnaṃ,buddhadinam,129,124,5,0,11
54105,taye,taye,3,3,0,0,4
54106,samūhabhūte,samuhabhute,2,2,0,0,11
54107,ādarasahitaṃ,adarasahitam,3,3,0,0,12
54108,alaṃsaṃsāradukkhavisaṭanirākaraṇato,alamsamsaradukkhavisatanirakaranato,1,1,0,0,35
54109,padhyā,padhya,1,1,0,0,6
54110,darathaṃ,daratham,18,17,1,0,8
54111,kāyacittapariḷāhaṃ,kayacittaparilaham,1,1,0,0,18
54112,hiṃsatu,himsatu,2,2,0,0,7
54113,mayāti,mayati,167,108,59,0,6
54114,paṭhamadutiyatatiyapādādiyamakamabyapetaṃ,pathamadutiyatatiyapadadiyamakamabyapetam,1,1,0,0,41
54115,dvārattayena,dvarattayena,2,2,0,0,12
54116,vidhiyamānapaṇāmapūjānaṃ,vidhiyamanapanamapujanam,1,1,0,0,24
54117,ratijananādiatthena,ratijananadiatthena,1,1,0,0,19
54118,sampattisādhanato,sampattisadhanato,1,1,0,0,17
54119,kāyacittadarathaṃ,kayacittadaratham,4,4,0,0,17
54120,vināsetu,vinasetu,1,1,0,0,8
54121,abyapetapaṭhamadutiyatatiyapādādiyamakaṃ,abyapetapathamadutiyatatiyapadadiyamakam,1,1,0,0,40
54122,niddiṭṭhakaraṇaṃ,nidditthakaranam,1,1,0,0,16
54123,karaṇañhi,karananhi,3,3,0,0,9
54124,vuttakammattepi,vuttakammattepi,1,1,0,0,15
54125,aññathānupapattilakkhaṇasāmatthiyato,annathanupapattilakkhanasamatthiyato,1,1,0,0,36
54126,bhijjitvā,bhijjitva,137,132,5,0,9
54127,akāsiṃ,akasim,186,175,11,0,6
54128,sambandhamupentaṃ,sambandhamupentam,1,1,0,0,17
54129,vihitassa,vihitassa,8,8,0,0,9
54130,napuṃsakattā,napumsakatta,7,7,0,0,12
54131,napuṃsakañca,napumsakanca,1,1,0,0,12
54132,sattāya,sattaya,10,10,0,0,7
54133,ekattā,ekatta,75,71,4,0,6
54134,ekavacanañca,ekavacananca,7,7,0,0,12
54135,tabbisesanattā,tabbisesanatta,1,1,0,0,14
54136,napuṃsakadutiyekavacano,napumsakadutiyekavacano,1,1,0,0,23
54137,liṅgasaṅkhyāvibhattiyo,lingasankhyavibhattiyo,1,1,0,0,22
54138,tulyādhikaraṇe,tulyadhikarane,36,29,7,0,14
54139,sambandhacinto,sambandhacinto,1,1,0,0,14
54140,bhedacintā,bhedacinta,2,2,0,0,10
54141,kriyāvisesane,kriyavisesane,4,4,0,0,13
54142,tatiyantassa,tatiyantassa,1,1,0,0,12
54143,paṭhamantattaṃ,pathamantattam,1,1,0,0,14
54144,paṭhamantassa,pathamantassa,5,5,0,0,13
54145,chaṭṭhuntañca,chatthuntanca,1,1,0,0,13
54146,tayaṃ,tayam,58,53,5,0,5
54147,tayanti,tayanti,2,2,0,0,7
54148,abyapetacatukkapādādiyamakavaṇṇanā,abyapetacatukkapadadiyamakavannana,1,1,0,0,34
54149,kattuṃvanado,kattumvanado,1,0,1,0,12
54150,sajjanatthāya,sajjanatthaya,1,1,0,0,13
54151,vikasitāravindasandohasambhāvitodakassa,vikasitaravindasandohasambhavitodakassa,1,1,0,0,39
54152,vāpādīsu,vapadisu,1,1,0,0,8
54153,tādisaramaṇīyattasampattisambhavato,tadisaramaniyattasampattisambhavato,1,1,0,0,35
54154,avanaṃ,avanam,2,2,0,0,6
54155,rakkhaṃ,rakkham,130,119,11,0,7
54156,sassasampatyādikāraṇabhāvenāti,sassasampatyadikaranabhavenati,1,1,0,0,30
54157,avanado,avanado,2,0,2,0,7
54158,tucchoti,tucchoti,9,5,4,0,8
54159,jaladhārabhārabharitambarakuharassa,jaladharabharabharitambarakuharassa,1,1,0,0,35
54160,dassanīyatāguṇayogato,dassaniyatagunayogato,1,1,0,0,21
54161,alaṃkattunti,alamkattunti,1,1,0,0,12
54162,sampuṇṇaṃ,sampunnam,30,29,1,0,9
54163,abhivuddhiṃ,abhivuddhim,3,3,0,0,11
54164,nekkhammādinā,nekkhammadina,4,4,0,0,13
54165,kāmacchandādike,kamacchandadike,6,6,0,0,15
54166,savāsanasakalakilese,savasanasakalakilese,1,1,0,0,20
54167,samucchinditvā,samucchinditva,37,37,0,0,14
54168,nibbānapuraṃ,nibbanapuram,17,15,2,0,12
54169,aparimitapāramitāsimpakacagalitatilakabhāvena,aparimitaparamitasimpakacagalitatilakabhavena,1,1,0,0,45
54170,alaṃkaraṇāyāti,alamkaranayati,1,1,0,0,14
54171,pādacatukkādiyamakamabyapetaṃ,padacatukkadiyamakamabyapetam,1,1,0,0,29
54172,pañcavidhapadumasañchannassa,pancavidhapadumasanchannassa,1,1,0,0,28
54173,ramaṇīyattā,ramaniyatta,1,1,0,0,11
54174,vuṭṭhisampadāya,vutthisampadaya,1,1,0,0,15
54175,sassasampadādīnaṃ,sassasampadadinam,1,1,0,0,17
54176,ārakkhaṃ,arakkham,260,254,6,0,8
54177,dento,dento,271,267,4,0,5
54178,jaladhārabhārabharitambarakucchiyā,jaladharabharabharitambarakucchiya,1,1,0,0,34
54179,dassanīyattā,dassaniyatta,1,1,0,0,12
54180,abhivuḍḍhiṃ,abhivuddhim,2,2,0,0,11
54181,citrakathī,citrakathi,12,12,0,0,10
54182,citrakathādikāraṇehi,citrakathadikaranehi,1,1,0,0,20
54183,lokarāmaṇeyyassābhāvā,lokaramaneyyassabhava,1,1,0,0,21
54184,sabbapadatthānaṃ,sabbapadatthanam,3,3,0,0,16
54185,sattābyabhicārittā,sattabyabhicaritta,1,1,0,0,18
54186,paṭhamantabhavanakriyāya,pathamantabhavanakriyaya,1,1,0,0,24
54187,yujjantīti,yujjantiti,18,14,4,0,10
54188,abyapetacatukkapādādiyamakaṃ,abyapetacatukkapadadiyamakam,1,1,0,0,28
54189,abyapetādiyamakasseso,abyapetadiyamakasseso,1,0,1,0,21
54190,iccevamabhimatayamake,iccevamabhimatayamake,1,1,0,0,21
54191,abyapetapādādiyamakassa,abyapetapadadiyamakassa,2,2,0,0,23
54192,disāmattaṃ,disamattam,3,3,0,0,10
54193,abyapetassa,abyapetassa,1,0,1,0,11
54194,abyavahitassa,abyavahitassa,2,2,0,0,13
54195,ādo,ado,51,45,6,0,3
54196,ādibhūtassa,adibhutassa,8,8,0,0,11
54197,yamakassa,yamakassa,10,10,0,0,9
54198,kocideva,kocideva,134,127,7,0,8
54199,vikappito,vikappito,1,1,0,0,9
54200,aparānipi,aparanipi,80,78,2,0,9
54201,vikappiyantīticeti,vikappiyantiticeti,1,1,0,0,18
54202,maggeneva,maggeneva,66,64,2,0,9
54203,aññāni,annani,206,194,12,0,6
54204,vuttato,vuttato,23,23,0,0,7
54205,aparāni,aparani,73,66,7,0,7
54206,dutiyapādādiyamakatatiyapādādiyamakacatutthapādādiyamakādīni,dutiyapadadiyamakatatiyapadadiyamakacatutthapadadiyamakadini,1,1,0,0,60
54207,abyapetānipi,abyapetanipi,1,1,0,0,12
54208,paṭhamadutiyapādādiyamakapaṭhamatatiyapādādiyamakānipi,pathamadutiyapadadiyamakapathamatatiyapadadiyamakanipi,1,1,0,0,54
54209,byapetāni,byapetani,1,1,0,0,9
54210,paṭhamacatutthadutiyatatiyapādādiyamakādīnipi,pathamacatutthadutiyatatiyapadadiyamakadinipi,1,1,0,0,45
54211,abyapetabyapetāni,abyapetabyapetani,2,2,0,0,17
54212,majjhantapādayamakāni,majjhantapadayamakani,1,1,0,0,21
54213,jānitabbāni,janitabbani,37,35,2,0,11
54214,tādisāya,tadisaya,53,52,1,0,8
54215,dassitattāti,dassitattati,7,6,1,0,12
54216,guṇāguṇena,gunagunena,3,2,1,0,10
54217,vigāhante,vigahante,3,2,1,0,9
54218,dutiyapādādiyamakādīni,dutiyapadadiyamakadini,1,1,0,0,22
54219,abyapetāni,abyapetani,2,2,0,0,10
54220,ppiyabhāṇino,ppiyabhanino,2,2,0,0,12
54221,pādānate,padanate,3,3,0,0,8
54222,ppiyaṃ,ppiyam,1,1,0,0,6
54223,paṭhamadutiyapādādiyamakādīni,pathamadutiyapadadiyamakadini,1,1,0,0,29
54224,suciraṃsuci,suciramsuci,3,2,1,0,11
54225,raṃjaye,ramjaye,3,2,1,0,7
54226,suciraṃ,suciram,34,30,4,0,7
54227,suciraṃgaṃ,suciramgam,3,2,1,0,10
54228,samalaṃbhi,samalambhi,3,2,1,0,10
54229,paṭhamacatutthadutiyatatiyapādādiyamakādīni,pathamacatutthadutiyatatiyapadadiyamakadini,1,1,0,0,43
54230,klesaṃ,klesam,5,4,1,0,6
54231,cetobhavaṃ,cetobhavam,3,3,0,0,10
54232,pāramīsārāmatabhāvitamosadhaṃ,paramisaramatabhavitamosadham,1,1,0,0,29
54233,majjhapādayamakāni,majjhapadayamakani,1,1,0,0,18
54234,sādhunā,sadhuna,38,33,5,0,7
54235,raṃjaya,ramjaya,3,2,1,0,7
54236,jayaddhaninā,jayaddhanina,3,2,1,0,12
54237,jinavaraṃ,jinavaram,14,14,0,0,9
54238,dhīramatthakāmosi,dhiramatthakamosi,2,2,0,0,17
54239,antapādayamakāni,antapadayamakani,1,1,0,0,16
54240,abhimatayamakena,abhimatayamakena,1,1,0,0,16
54241,abyapetayamakānamupāyādīni,abyapetayamakanamupayadini,1,1,0,0,26
54242,nigamento,nigamento,43,43,0,0,9
54243,abyapeti,abyapeti,1,0,1,0,8
54244,abyapetādiyamakassa,abyapetadiyamakassa,1,0,1,0,19
54245,visadisavaṇṇehi,visadisavannehi,2,2,0,0,15
54246,abyavahitādiyamakassa,abyavahitadiyamakassa,1,1,0,0,21
54247,ccādiko,ccadiko,1,1,0,0,7
54248,appakodāharaṇanayo,appakodaharananayo,1,1,0,0,18
54249,imāyeva,imayeva,10,9,1,0,7
54250,nayeneva,nayeneva,29,29,0,0,8
54251,ñātabbāni,natabbani,7,7,0,0,9
54252,ādibhūtaṃ,adibhutam,21,21,0,0,9
54253,ādiyamakañcāti,adiyamakancati,1,1,0,0,14
54254,dassitena,dassitena,18,18,0,0,9
54255,abyapetadutiyapādādiyamakādayo,abyapetadutiyapadadiyamakadayo,1,1,0,0,30
54256,abyapetadutiyapādādiyamakamevaṃ,abyapetadutiyapadadiyamakamevam,1,1,0,0,31
54257,asādhavo,asadhavo,3,2,1,0,8
54258,sakasakaguṇena,sakasakagunena,1,1,0,0,14
54259,aguṇena,agunena,1,1,0,0,7
54260,sujanadujjanesu,sujanadujjanesu,1,1,0,0,15
54261,samamettā,samametta,1,1,0,0,9
54262,acchariyāti,acchariyati,3,3,0,0,11
54263,abyapetapaṭhamadutiyapādādiyamakamevaṃ,abyapetapathamadutiyapadadiyamakamevam,1,1,0,0,38
54264,ppīyaṃ,ppiyam,1,1,0,0,6
54265,appiyabhāṇinopi,appiyabhaninopi,1,1,0,0,15
54266,saddapariyāyassa,saddapariyayassa,2,2,0,0,16
54267,yatibhaṅgo,yatibhango,2,2,0,0,10
54268,paṭhamacatutthadutiyatatiyapādādiabyapetabyapetayamakamevaṃ,pathamacatutthadutiyatatiyapadadiabyapetabyapetayamakamevam,1,1,0,0,59
54269,pubbaparayugaḷaṃ,pubbaparayugalam,2,2,0,0,16
54270,pubbaparayugaḷadvayaṃ,pubbaparayugaladvayam,2,2,0,0,21
54271,bhinnavaṇṇehi,bhinnavannehi,2,2,0,0,13
54272,sobhanaraṃsinā,sobhanaramsina,1,1,0,0,14
54273,uci,uci,1,1,0,0,3
54274,alabhi,alabhi,18,18,0,0,6
54275,visuddhadehaṃ,visuddhadeham,1,1,0,0,13
54276,jallikāsaṅkhātena,jallikasankhatena,5,5,0,0,17
54277,rāgādikucchitasaṅkhātena,ragadikucchitasankhatena,1,1,0,0,24
54278,malena,malena,11,11,0,0,6
54279,alaṃkattuṃ,alamkattum,1,0,1,0,10
54280,sucirakālaṃ,sucirakalam,5,5,0,0,11
54281,abhiramāpeyya,abhiramapeyya,2,2,0,0,13
54282,pādamajjhayamakamevaṃ,padamajjhayamakamevam,1,1,0,0,21
54283,pāramīsārāmatabhāvitamosadhanti,paramisaramatabhavitamosadhanti,1,1,0,0,31
54284,apanaya,apanaya,2,2,0,0,7
54285,pāramīsārāmatabhāvitaṃ,paramisaramatabhavitam,1,1,0,0,22
54286,dibbosadhaṃ,dibbosadham,2,2,0,0,11
54287,pādantayamakamevaṃ,padantayamakamevam,1,1,0,0,18
54288,tuvanti,tuvanti,7,7,0,0,7
54289,veneyyajayaghosena,veneyyajayaghosena,1,1,0,0,18
54290,āpūrayi,apurayi,1,1,0,0,7
54291,sappurisa,sappurisa,47,46,1,0,9
54292,abhiramāpehi,abhiramapehi,1,1,0,0,12
54293,niddiṭṭhayamakeheva,nidditthayamakeheva,1,1,0,0,19
54294,tatiyapādādiyamakādayo,tatiyapadadiyamakadayo,1,1,0,0,22
54295,sākallena,sakallena,9,9,0,0,9
54296,vikappitānīti,vikappitaniti,1,1,0,0,13
54297,accanti,accanti,3,1,2,0,7
54298,missattamuccāraṇappakāro,missattamuccaranappakaro,1,1,0,0,24
54299,vikappesupi,vikappesupi,1,1,0,0,11
54300,karīyanti,kariyanti,46,46,0,0,9
54301,payujjantīti,payujjantiti,2,2,0,0,12
54302,sukarānaṃ,sukaranam,1,1,0,0,9
54303,abhimatayamakānaṃ,abhimatayamakanam,1,1,0,0,17
54304,dukkarānaṃ,dukkaranam,1,1,0,0,10
54305,sabbamevaṃ,sabbamevam,1,1,0,0,10
54306,samunnatena,samunnatena,3,2,1,0,11
54307,natenatepi,natenatepi,1,1,0,0,10
54308,nate,nate,11,10,1,0,4
54309,pādacatukkamajjhayamakamabyapetabyapetamekarūpaṃ,padacatukkamajjhayamakamabyapetabyapetamekarupam,1,1,0,0,48
54310,vibhūsitā,vibhusita,17,16,1,0,9
54311,tathāsurā,tathasura,2,2,0,0,9
54312,surāparājitā,suraparajita,3,2,1,0,12
54313,sabhāsu,sabhasu,8,7,1,0,7
54314,rājāpi,rajapi,250,247,3,0,6
54315,surājito,surajito,3,2,1,0,8
54316,surājanti,surajanti,3,2,1,0,9
54317,surāvinissaṭā,suravinissata,3,2,1,0,13
54318,catukkapādamajjhayamakamekarūpabyapetaṃ,catukkapadamajjhayamakamekarupabyapetam,1,1,0,0,39
54319,sabbamidamanuddisitvā,sabbamidamanuddisitva,1,1,0,0,21
54320,lakkhaṇātidesena,lakkhanatidesena,1,1,0,0,16
54321,nigamanaṃ,nigamanam,138,132,6,0,9
54322,kimatthamiccāsaṅkāyamāha,kimatthamiccasankayamaha,1,1,0,0,24
54323,accante,accante,2,0,2,0,7
54324,pabheduppattikāraṇabhūtā,pabheduppattikaranabhuta,1,1,0,0,24
54325,uccāvacapakārā,uccavacapakara,1,1,0,0,14
54326,susādhiyā,susadhiya,2,2,0,0,9
54327,dussādhiyā,dussadhiya,1,1,0,0,10
54328,sukarassa,sukarassa,2,2,0,0,9
54329,upadisitattā,upadisitatta,1,1,0,0,12
54330,dukkarayamakapavesopāyamattamupadisīyate,dukkarayamakapavesopayamattamupadisiyate,1,1,0,0,40
54331,dadeyya,dadeyya,409,394,15,0,7
54332,pīṇayata,pinayata,1,1,0,0,8
54333,manaṃpa,manampa,1,1,0,0,7
54334,sādhupujjaṃ,sadhupujjam,2,1,1,0,11
54335,pādacatukkādiyamakamekarūpaṃ,padacatukkadiyamakamekarupam,1,1,0,0,28
54336,pīṇayati,pinayati,4,3,1,0,8
54337,manaṃpi,manampi,2,1,1,0,7
54338,muhuttampi,muhuttampi,53,52,1,0,10
54339,natepi,natepi,2,1,1,0,6
54340,pādacatukkamajjhayamakamekarūpamabyapetabyapetaṃ,padacatukkamajjhayamakamekarupamabyapetabyapetam,1,1,0,0,48
54341,sobhanena,sobhanena,8,8,0,0,9
54342,unnatena,unnatena,2,2,0,0,8
54343,avanatepi,avanatepi,1,1,0,0,9
54344,anatepi,anatepi,1,0,1,0,7
54345,anavanatepi,anavanatepi,1,1,0,0,11
54346,bhavanteva,bhavanteva,9,8,1,0,10
54347,avanate,avanate,1,1,0,0,7
54348,paṇāmonatasajjanaṃ,panamonatasajjanam,2,1,1,0,18
54349,nivesentamasajjanaṃ,nivesentamasajjanam,1,1,0,0,19
54350,veneyyanette,veneyyanette,2,2,0,0,12
54351,guṇabhājanaṃ,gunabhajanam,2,1,1,0,12
54352,mamentaṃ,mamentam,2,1,1,0,8
54353,pādacatukkantayamakamekarūpamabyapetabyapetayamakaṃ,padacatukkantayamakamekarupamabyapetabyapetayamakam,1,1,0,0,51
54354,paṇāmitukāmonatasādhujanavantaṃ,panamitukamonatasadhujanavantam,1,1,0,0,31
54355,veneyyajanaṃ,veneyyajanam,7,7,0,0,12
54356,asajja,asajja,1,0,1,0,6
54357,pamādamakatvā,pamadamakatva,1,1,0,0,13
54358,sīlādiguṇe,siladigune,13,13,0,0,10
54359,nivesentaṃ,nivesentam,1,0,1,0,10
54360,niyojentaṃ,niyojentam,2,2,0,0,10
54361,añjanaṃ,anjanam,49,36,13,0,7
54362,añjanabhūtaṃ,anjanabhutam,2,2,0,0,12
54363,guṇānamādhārabhūtaṃ,gunanamadharabhutam,1,1,0,0,19
54364,sādhujanānaṃ,sadhujananam,8,7,1,0,12
54365,mamāyantaṃ,mamayantam,1,1,0,0,10
54366,sābhāsu,sabhasu,2,1,1,0,7
54367,sābhā,sabha,4,2,2,0,5
54368,sābhāya,sabhaya,4,2,2,0,7
54369,bhāsatiyeva,bhasatiyeva,6,5,1,0,11
54370,sasābhānamaticca,sasabhanamaticca,1,1,0,0,16
54371,bhātī,bhati,2,1,1,0,5
54372,pādacatukkādiyamakekarūpabyapetaṃ,padacatukkadiyamakekarupabyapetam,1,1,0,0,33
54373,vijjamānābhāsu,vijjamanabhasu,1,1,0,0,14
54374,vijjamānāya,vijjamanaya,19,19,0,0,11
54375,sobhanāya,sobhanaya,7,7,0,0,9
54376,ābhāya,abhaya,59,54,5,0,6
54377,ābhāto,abhato,1,1,0,0,6
54378,dippateva,dippateva,1,1,0,0,9
54379,jinābhā,jinabha,1,1,0,0,7
54380,vijjamānābhāto,vijjamanabhato,1,1,0,0,14
54381,sasābhānaṃ,sasabhanam,1,0,1,0,10
54382,vijjamānasobhanābhānaṃ,vijjamanasobhanabhanam,1,1,0,0,22
54383,brahmādīnaṃ,brahmadinam,1,1,0,0,11
54384,sobhanābhāyo,sobhanabhayo,1,1,0,0,12
54385,aticca,aticca,43,36,7,0,6
54386,pādacatukkamajjhayamakekarūpabyapetaṃ,padacatukkamajjhayamakekarupabyapetam,1,1,0,0,37
54387,surāpānato,surapanato,4,4,0,0,10
54388,sobhamānā,sobhamana,16,16,0,0,9
54389,surāpānahetu,surapanahetu,1,1,0,0,12
54390,parājitabhāvaṃ,parajitabhavam,5,5,0,0,14
54391,vepacittiādayo,vepacittiadayo,1,1,0,0,14
54392,asurāpi,asurapi,2,2,0,0,7
54393,alaṅkato,alankato,94,87,7,0,8
54394,jināṇattiyaṃ,jinanattiyam,2,1,1,0,12
54395,hitāsā,hitasa,1,1,0,0,6
54396,sitāsā,sitasa,2,1,1,0,6
54397,avassaṃva,avassamva,3,2,1,0,9
54398,hontya,hontya,3,3,0,0,6
54399,hatāsā,hatasa,2,1,1,0,6
54400,sabbapāpe,sabbapape,2,1,1,0,9
54401,satāsā,satasa,2,1,1,0,6
54402,vatāsā,vatasa,1,1,0,0,6
54403,karonteva,karonteva,4,4,0,0,9
54404,santissitā,santissita,2,1,1,0,10
54405,sāmitāsā,samitasa,2,1,1,0,8
54406,pādacatukkantayamakamekarūpabyapetaṃ,padacatukkantayamakamekarupabyapetam,1,1,0,0,36
54407,vinayapaññattisaṅkhātāṇattiyaṃ,vinayapannattisankhatanattiyam,1,1,0,0,30
54408,ohitāsā,ohitasa,1,0,1,0,7
54409,avītikkamavasena,avitikkamavasena,11,11,0,0,16
54410,patiṭṭhitaāsā,patitthitaasa,1,1,0,0,13
54411,parisuddhāsā,parisuddhasa,1,1,0,0,12
54412,hatataṇhā,hatatanha,1,1,0,0,9
54413,ekanteneva,ekanteneva,147,142,5,0,10
54414,atāsā,atasa,1,0,1,0,5
54415,bhayarahitā,bhayarahita,1,1,0,0,11
54416,sabbākusale,sabbakusale,8,8,0,0,11
54417,bhayasahitā,bhayasahita,1,1,0,0,11
54418,vatāsāva,vatasava,1,0,1,0,8
54419,niravajjavatābhilāsavanto,niravajjavatabhilasavanto,1,1,0,0,25
54420,santinissitāyo,santinissitayo,1,1,0,0,14
54421,sāmibhāvāsāyo,samibhavasayo,1,1,0,0,13
54422,paheḷī,paheli,1,0,1,0,6
54423,sāmatthiyavisesasūcakanti,samatthiyavisesasucakanti,1,1,0,0,25
54424,sopayogaṃ,sopayogam,1,1,0,0,9
54425,paheḷikā,pahelika,10,9,1,0,8
54426,sopayogā,sopayoga,1,1,0,0,8
54427,kīḷāvinodane,kilavinodane,2,2,0,0,12
54428,sambādhaṭṭhānamantane,sambadhatthanamantane,1,1,0,0,21
54429,parabyāmohane,parabyamohane,2,2,0,0,13
54430,paramabyāmohane,paramabyamohane,1,1,0,0,15
54431,kathamupekkhā,kathamupekkha,1,1,0,0,13
54432,bhavatoti,bhavatoti,3,1,2,0,9
54433,yamakañca,yamakanca,3,2,1,0,9
54434,sukaradukkarappabhedaṃ,sukaradukkarappabhedam,1,1,0,0,22
54435,niddiṭṭhā,niddittha,256,251,5,0,9
54436,samāgatāvañcitādikā,samagatavancitadika,1,1,0,0,19
54437,tatthidaṃ,tatthidam,3,3,0,0,9
54438,guḷhatthā,gulhattha,3,2,1,0,9
54439,padasandhinā,padasandhina,3,2,1,0,12
54440,vañcitā,vancita,18,12,6,0,7
54441,ruḷhena,rulhena,9,8,1,0,7
54442,ukkantā,ukkanta,14,8,6,0,7
54443,tibyavahitappayogā,tibyavahitappayoga,2,2,0,0,18
54444,mohakārinī,mohakarini,3,2,1,0,10
54445,pamussitā,pamussita,4,0,4,0,9
54446,dubbodhatthā,dubbodhattha,4,3,1,0,12
54447,padāvali,padavali,8,4,4,0,8
54448,samānarūpā,samanarupa,10,6,4,0,10
54449,mukhyatthāropāhitapadā,mukhyattharopahitapada,2,2,0,0,22
54450,pharusā,pharusa,140,125,15,0,7
54451,paccayādīhi,paccayadihi,4,3,1,0,11
54452,jātasaddā,jatasadda,3,2,1,0,9
54453,saṅkhyātā,sankhyata,6,2,4,0,9
54454,saṅkhyānaṃ,sankhyanam,34,33,1,0,10
54455,byāmohakāraṇaṃ,byamohakaranam,3,3,0,0,14
54456,pakappitā,pakappita,39,23,16,0,9
54457,nāmantarikā,namantarika,5,1,4,0,11
54458,nānatthakappanā,nanatthakappana,4,3,1,0,15
54459,nibhūtā,nibhuta,5,1,4,0,7
54460,vaṭṭhitaññatthā,vatthitannattha,2,2,0,0,15
54461,tulyatthasutihetuto,tulyatthasutihetuto,3,2,1,0,19
54462,samānasaddā,samanasadda,5,1,4,0,11
54463,iṭṭhasaddapariyāyasādhitā,itthasaddapariyayasadhita,3,2,1,0,25
54464,sammuḷhā,sammulha,6,2,4,0,8
54465,mūḷhatāyeva,mulhatayeva,3,2,1,0,11
54466,niddiṭṭhatthāpi,nidditthatthapi,3,2,1,0,15
54467,sambandhabāhulyā,sambandhabahulya,3,2,1,0,16
54468,pārihārikī,parihariki,5,1,4,0,10
54469,ekacchannā,ekacchanna,6,2,4,0,10
54470,byañjādheyyaṃ,byanjadheyyam,2,2,0,0,13
54471,nissayagopanā,nissayagopana,3,2,1,0,13
54472,ubhayacchannā,ubhayacchanna,5,1,4,0,13
54473,ubhayagopanā,ubhayagopana,3,2,1,0,12
54474,saṃkiṇṇā,samkinna,18,11,7,0,8
54475,nānālakkhaṇasaṅkaroti,nanalakkhanasankaroti,2,2,0,0,21
54476,dosattepi,dosattepi,1,1,0,0,9
54477,ukkantādīsu,ukkantadisu,1,1,0,0,11
54478,dosabhāve,dosabhave,1,1,0,0,9
54479,nāropitabbā,naropitabba,1,1,0,0,11
54480,manasoti,manasoti,3,2,1,0,8
54481,vākyasaṃkiṇṇanāmena,vakyasamkinnanamena,1,1,0,0,19
54482,saṃsayadosaparihārena,samsayadosapariharena,1,1,0,0,21
54483,natavittiṇṇā,natavittinna,3,2,1,0,12
54484,jayataṃ,jayatam,10,6,4,0,7
54485,pahutaphalasādhanī,pahutaphalasadhani,1,1,0,0,18
54486,bhaddamevo,bhaddamevo,2,2,0,0,10
54487,paseveyya,paseveyya,3,3,0,0,9
54488,vidhūtamadakibbisaṃ,vidhutamadakibbisam,3,2,1,0,19
54489,sampāpaye,sampapaye,2,2,0,0,9
54490,ttanisevinaṃ,ttanisevinam,1,1,0,0,12
54491,pamussitādayo,pamussitadayo,1,1,0,0,13
54492,lakkhaṇānusārena,lakkhananusarena,2,2,0,0,16
54493,tatthodāharaṇānusārena,tatthodaharananusarena,1,1,0,0,22
54494,parikappitā,parikappita,5,5,0,0,11
54495,niyamena,niyamena,65,65,0,0,8
54496,madhurāni,madhurani,33,32,1,0,9
54497,attharasassa,attharasassa,19,19,0,0,12
54498,saddarasassa,saddarasassa,2,2,0,0,12
54499,abhāvena,abhavena,533,531,2,0,8
54500,assāditabbāni,assaditabbani,1,1,0,0,13
54501,sissāna,sissana,3,2,1,0,7
54502,muppanno,muppanno,1,1,0,0,8
54503,khedato,khedato,1,1,0,0,7
54504,uppannabhayato,uppannabhayato,2,2,0,0,14
54505,upekkhiyantīti,upekkhiyantiti,1,1,0,0,14
54506,sambandhanīyaṃ,sambandhaniyam,36,36,0,0,14
54507,sukaradukkaravasena,sukaradukkaravasena,1,1,0,0,19
54508,duvidhattaṃ,duvidhattam,1,1,0,0,11
54509,sāmatthiyappakāsane,samatthiyappakasane,1,1,0,0,19
54510,sappayojanayamakānañca,sappayojanayamakananca,1,1,0,0,22
54511,sambādhaṭṭhānasammantane,sambadhatthanasammantane,1,1,0,0,24
54512,sappayojanānañca,sappayojanananca,1,1,0,0,16
54513,paheḷikānamavacane,pahelikanamavacane,1,1,0,0,18
54514,niddisati,niddisati,182,165,17,0,9
54515,sukaradukkarādibhedaṃ,sukaradukkaradibhedam,1,1,0,0,21
54516,yamakajātañca,yamakajatanca,1,1,0,0,13
54517,samāgabhādikā,samagabhadika,1,1,0,0,13
54518,ekantamadhurāni,ekantamadhurani,1,0,1,0,15
54519,assādetabbassa,assadetabbassa,2,2,0,0,14
54520,amadhurāni,amadhurani,3,3,0,0,10
54521,asahanasaṅkhātāya,asahanasankhataya,1,1,0,0,17
54522,asahanena,asahanena,4,4,0,0,9
54523,bhītiyā,bhitiya,2,2,0,0,7
54524,upekkhīyanti,upekkhiyanti,1,1,0,0,12
54525,khedoyeva,khedoyeva,1,1,0,0,9
54526,sissakhedato,sissakhedato,1,1,0,0,12
54527,vañcitukkantā,vancitukkanta,1,1,0,0,13
54528,pamussitāpi,pamussitapi,1,1,0,0,11
54529,athopi,athopi,171,158,13,0,6
54530,ekacchannobhayacchannā,ekacchannobhayacchanna,1,1,0,0,22
54531,saṃkiṇṇāti,samkinnati,1,1,0,0,10
54532,soḷasāti,solasati,14,9,5,0,8
54533,tatridaṃ,tatridam,343,312,31,0,8
54534,sandhānato,sandhanato,3,3,0,0,10
54535,apākaṭatthā,apakatattha,1,1,0,0,11
54536,guḷhatthāti,gulhatthati,1,0,1,0,11
54537,apasiddhā,apasiddha,1,1,0,0,9
54538,anuvādānuvādyabhāvo,anuvadanuvadyabhavo,1,1,0,0,19
54539,paheḷikāyaṃ,pahelikayam,5,4,1,0,11
54540,pasiddhena,pasiddhena,4,4,0,0,10
54541,ruḷhisaddena,rulhisaddena,8,7,1,0,12
54542,atibyavahitappayogā,atibyavahitappayoga,1,0,1,0,19
54543,antaritapayujjamānapadayuttā,antaritapayujjamanapadayutta,1,1,0,0,28
54544,sammohakārikā,sammohakarika,1,1,0,0,13
54545,padapanti,padapanti,3,3,0,0,9
54546,duranubodhābhidheyyā,duranubodhabhidheyya,1,1,0,0,20
54547,amukhyatthāropāhitapadā,amukhyattharopahitapada,1,0,1,0,23
54548,appadhānatthe,appadhanatthe,1,1,0,0,13
54549,mukhyatthapakāsakasaddānaṃ,mukhyatthapakasakasaddanam,1,1,0,0,26
54550,sadhammaṃ,sadhammam,2,2,0,0,9
54551,āropanato,aropanato,1,1,0,0,9
54552,upaṭṭhitapadayuttā,upatthitapadayutta,1,1,0,0,18
54553,paccayādesādīhi,paccayadesadihi,1,1,0,0,15
54554,nipphannasaddā,nipphannasadda,1,1,0,0,14
54555,gaṇanaṃ,gananam,114,108,6,0,7
54556,vuttamapi,vuttamapi,1,1,0,0,9
54557,samudāyattho,samudayattho,15,14,1,0,12
54558,ābhāsate,abhasate,1,0,1,0,8
54559,payuttābhidhāne,payuttabhidhane,1,1,0,0,15
54560,vividhābhidheyyakappanā,vividhabhidheyyakappana,1,1,0,0,23
54561,samānatthasaddānaṃ,samanatthasaddanam,1,1,0,0,18
54562,payogahetuyā,payogahetuya,1,1,0,0,12
54563,avaṭṭhitaññatthā,avatthitannattha,1,0,1,0,16
54564,patiṭṭhitaaññatthā,patitthitaannattha,1,1,0,0,18
54565,icchitatthasaddassa,icchitatthasaddassa,1,1,0,0,19
54566,vevacanehi,vevacanehi,14,13,1,0,10
54567,nipphāditā,nipphadita,11,11,0,0,10
54568,dassitaatthayuttāpiyā,dassitaatthayuttapiya,1,1,0,0,21
54569,sammohabhāvatthaṃ,sammohabhavattham,1,1,0,0,17
54570,viracane,viracane,1,1,0,0,8
54571,dassiyamānaṃ,dassiyamanam,6,6,0,0,12
54572,bahulabhāvato,bahulabhavato,8,8,0,0,13
54573,ādheyyaṃ,adheyyam,10,6,4,0,8
54574,byañja,byanja,2,1,1,0,6
54575,abhibyañjiya,abhibyanjiya,1,1,0,0,12
54576,ādhāragutti,adharagutti,1,1,0,0,11
54577,ubhinnamādhārādheyyānaṃ,ubhinnamadharadheyyanam,1,1,0,0,23
54578,gopanā,gopana,5,5,0,0,6
54579,nānālakkhaṇasaṅkaro,nanalakkhanasankaro,1,0,1,0,19
54580,samāgatādinānāvidhalakkhaṇānaṃ,samagatadinanavidhalakkhananam,1,1,0,0,30
54581,samāgatādīnaṃ,samagatadinam,2,2,0,0,13
54582,pahutaphalasādhinī,pahutaphalasadhini,2,1,1,0,18
54583,pabhavato,pabhavato,23,23,0,0,9
54584,oṇatavasena,onatavasena,1,1,0,0,11
54585,patthaṭā,patthata,21,21,0,0,8
54586,pabhava,pabhava,4,2,2,0,7
54587,pakaṭṭhatta,pakatthatta,1,1,0,0,11
54588,sobhāvanta,sobhavanta,1,1,0,0,10
54589,mahantī,mahanti,29,29,0,0,7
54590,ānatavittiṇṇā,anatavittinna,1,0,1,0,13
54591,natesu,natesu,1,1,0,0,6
54592,bahulatthanipphādanī,bahulatthanipphadani,1,1,0,0,20
54593,ukkaṃsabhāvena,ukkamsabhavena,1,1,0,0,14
54594,pabhavaānataitisandhinā,pabhavaanataitisandhina,1,1,0,0,23
54595,ttanisevitaṃ,ttanisevitam,1,1,0,0,12
54596,vināsitamadadosaṃ,vinasitamadadosam,1,1,0,0,17
54597,bhaddameva,bhaddameva,3,1,2,0,10
54598,mandapiya,mandapiya,1,1,0,0,9
54599,pindapissa,pindapissa,1,1,0,0,10
54600,bhaddajātikesu,bhaddajatikesu,1,1,0,0,14
54601,hatthīsu,hatthisu,10,10,0,0,8
54602,bhaddajātikahatthimeva,bhaddajatikahatthimeva,1,1,0,0,22
54603,upaseveyyāti,upaseveyyati,1,1,0,0,12
54604,uttamapurisameva,uttamapurisameva,1,1,0,0,16
54605,seveyyāti,seveyyati,16,5,11,0,9
54606,sevanaṃ,sevanam,29,23,6,0,7
54607,kimatthanti,kimatthanti,21,21,0,0,11
54608,hatthipakkhe,hatthipakkhe,1,1,0,0,12
54609,sikkhito,sikkhito,33,30,3,0,8
54610,attanisevitaṃ,attanisevitam,2,0,2,0,13
54611,sampāpeti,sampapeti,10,10,0,0,9
54612,purisapakkhe,purisapakkhe,1,1,0,0,12
54613,ariyapuggalo,ariyapuggalo,31,31,0,0,12
54614,attānamupasevitaṃ,attanamupasevitam,1,1,0,0,17
54615,niddukkhaṃ,niddukkham,14,13,1,0,10
54616,kavicchitauttamatthato,kavicchitauttamatthato,1,1,0,0,22
54617,hatthiatthe,hatthiatthe,1,1,0,0,11
54618,dujjanānaṃpyayaṃ,dujjananampyayam,1,1,0,0,16
54619,imassattho,imassattho,5,4,1,0,10
54620,āgamissati,agamissati,225,223,2,0,10
54621,byākiṇṇadosatte,byakinnadosatte,1,1,0,0,15
54622,paheḷikāruḷhattā,pahelikarulhatta,1,1,0,0,16
54623,paheḷikāyamāruḷhā,pahelikayamarulha,3,2,1,0,17
54624,sambandhīpadānaṃ,sambandhipadanam,1,1,0,0,16
54625,aṭṭhānaṭṭhāpanena,atthanatthapanena,1,1,0,0,17
54626,byavahitattaṃ,byavahitattam,1,1,0,0,13
54627,niyuruggatthanunnataṃ,niyuruggatthanunnatam,2,1,1,0,21
54628,paṭaccarī,pataccari,4,3,1,0,9
54629,bhīruyā,bhiruya,5,4,1,0,7
54630,dhārayantiyā,dharayantiya,4,3,1,0,12
54631,tilakādiṃ,tilakadim,1,1,0,0,9
54632,evaṃnāmakaṃ,evamnamakam,53,52,1,0,11
54633,niyuraṃ,niyuram,2,2,0,0,7
54634,payodharapaṭaṃ,payodharapatam,1,1,0,0,14
54635,unnataṃ,unnatam,18,16,2,0,7
54636,nalāṭapaṭādikaṃ,nalatapatadikam,1,1,0,0,15
54637,unnatābharaṇañca,unnatabharananca,1,1,0,0,16
54638,jiṇṇavatthanivāsī,jinnavatthanivasi,1,1,0,0,17
54639,bahupayogarahitehi,bahupayogarahitehi,1,1,0,0,18
54640,duravabodhatā,duravabodhata,1,1,0,0,13
54641,ggaratanāna,ggaratanana,1,1,0,0,11
54642,smiṃ,smim,113,53,60,0,4
54643,ratanākare,ratanakare,2,2,0,0,10
54644,purisānettha,purisanettha,1,1,0,0,12
54645,aṭṭhā,attha,33,29,4,0,5
54646,aggaratanāni,aggaratanani,1,1,0,0,12
54647,ratanesu,ratanesu,44,43,1,0,8
54648,lokuttarāni,lokuttarani,47,45,2,0,11
54649,cittīkatādiatthena,cittikatadiatthena,4,4,0,0,18
54650,ratanānī,ratanani,4,4,0,0,8
54651,tappabhavo,tappabhavo,4,4,0,0,10
54652,kappitoti,kappitoti,1,1,0,0,9
54653,amukhyatthesu,amukhyatthesu,1,1,0,0,13
54654,ratanādisaddānamāropanaṃ,ratanadisaddanamaropanam,1,1,0,0,24
54655,devagandhabbā,devagandhabba,3,2,1,0,13
54656,himavantamahātale,himavantamahatale,3,2,1,0,17
54657,rasavante,rasavante,3,1,2,0,9
54658,nāgāpi,nagapi,5,4,1,0,6
54659,uposathā,uposatha,71,67,4,0,8
54660,himālayassa,himalayassa,1,1,0,0,11
54661,sodake,sodake,2,2,0,0,6
54662,anotattādike,anotattadike,1,1,0,0,12
54663,ayamaparattho,ayamaparattho,2,2,0,0,13
54664,candaraṃsiyutte,candaramsiyutte,1,1,0,0,15
54665,mahāpāsādatale,mahapasadatale,1,1,0,0,14
54666,kīḷamānā,kilamana,20,18,2,0,8
54667,madhuraguṇayutte,madhuragunayutte,1,1,0,0,16
54668,chajjādike,chajjadike,1,1,0,0,10
54669,ariyāpi,ariyapi,12,12,0,0,7
54670,uposathāpi,uposathapi,1,0,1,0,10
54671,upavutthāpi,upavutthapi,1,1,0,0,11
54672,etesamatthīti,etesamatthiti,28,28,0,0,13
54673,uposathāti,uposathati,10,6,4,0,10
54674,lakkhaṇakkamato,lakkhanakkamato,1,1,0,0,15
54675,pasiddhapacurapayogato,pasiddhapacurapayogato,1,1,0,0,22
54676,aññadatthā,annadattha,1,1,0,0,10
54677,lesena,lesena,68,67,1,0,6
54678,jātasaddassa,jatasaddassa,4,4,0,0,12
54679,atthitā,atthita,64,63,1,0,7
54680,gītasadde,gitasadde,5,5,0,0,9
54681,chajjaññatra,chajjannatra,1,1,0,0,12
54682,chassarā,chassara,2,1,1,0,8
54683,pañcavaṇṇaṃ,pancavannam,12,11,1,0,11
54684,chajja,chajja,2,1,1,0,6
54685,chajjato,chajjato,1,1,0,0,8
54686,nisādoti,nisadoti,4,4,0,0,8
54687,yugaḷato,yugalato,3,3,0,0,8
54688,chasaravanto,chasaravanto,1,1,0,0,12
54689,kārasaradvayasabbhāvato,karasaradvayasabbhavato,1,1,0,0,23
54690,tividhattā,tividhatta,3,3,0,0,10
54691,cakkhū,cakkhu,35,28,7,0,6
54692,sarabyañjanavasena,sarabyanjanavasena,1,1,0,0,18
54693,pañcavaṇṇānaṃ,pancavannanam,15,11,4,0,13
54694,vuttasaṅkhyāgītādisaddasanniṭṭhānato,vuttasankhyagitadisaddasannitthanato,1,1,0,0,36
54695,sammohakārinī,sammohakarini,2,2,0,0,13
54696,sirimā,sirima,88,85,3,0,6
54697,rattamaṇḍalo,rattamandalo,4,2,2,0,12
54698,sakantigahanakkhattasaṅghayutto,sakantigahanakkhattasanghayutto,3,1,2,0,31
54699,sulakkhaṇo,sulakkhano,3,1,2,0,10
54700,sirimanto,sirimanto,5,5,0,0,9
54701,anurattajanapadamaṇḍalo,anurattajanapadamandalo,1,1,0,0,23
54702,anurattaamaccamaṇḍalo,anurattaamaccamandalo,1,1,0,0,21
54703,gahanehi,gahanehi,2,2,0,0,8
54704,aviraḷehi,aviralehi,1,1,0,0,9
54705,khattasaṅghehi,khattasanghehi,1,1,0,0,14
54706,khattiyasamūhehi,khattiyasamuhehi,2,2,0,0,16
54707,pasatthapurisalakkhaṇo,pasatthapurisalakkhano,1,1,0,0,22
54708,tumhe,tumhe,3494,3431,63,0,5
54709,rakkhatūti,rakkhatuti,5,5,0,0,10
54710,anadhippetattho,anadhippetattho,4,4,0,0,15
54711,vāsaṭṭhānattā,vasatthanatta,1,1,0,0,13
54712,kantisahitehi,kantisahitehi,1,1,0,0,13
54713,gahanakkhattatāragaṇehi,gahanakkhattataraganehi,1,1,0,0,23
54714,sasalakkhaṇo,sasalakkhano,3,3,0,0,12
54715,pātūti,patuti,1,0,1,0,6
54716,ubhayapakkhassa,ubhayapakkhassa,1,1,0,0,15
54717,sādhāraṇaguṇaguṇīpadapariggahena,sadharanagunagunipadapariggahena,1,1,0,0,32
54718,vākyatthassa,vakyatthassa,2,2,0,0,12
54719,dissamānatā,dissamanata,1,1,0,0,11
54720,vuccatā,vuccata,2,2,0,0,7
54721,isitye,isitye,1,1,0,0,6
54722,sumahantopakāravā,sumahantopakarava,2,1,1,0,17
54723,atimahantopakārasamannāgato,atimahantopakarasamannagato,1,1,0,0,27
54724,mittopi,mittopi,2,2,0,0,7
54725,sassatopi,sassatopi,1,1,0,0,9
54726,gamyamānattho,gamyamanattho,3,3,0,0,13
54727,sumahā,sumaha,10,9,1,0,6
54728,atimahanto,atimahanto,7,7,0,0,10
54729,nāmādimhi,namadimhi,1,1,0,0,9
54730,isīti,isiti,20,7,13,0,5
54731,pakāravā,pakarava,1,0,1,0,8
54732,isipi,isipi,1,1,0,0,5
54733,nātano,natano,1,0,1,0,6
54734,tanaiti,tanaiti,1,1,0,0,7
54735,akkharadvayarahito,akkharadvayarahito,1,1,0,0,18
54736,ādimajjhānaṃ,adimajjhanam,1,1,0,0,12
54737,isipatanavihāro,isipatanaviharo,1,0,1,0,15
54738,isipatananāmena,isipatananamena,1,1,0,0,15
54739,isiādīnaṃ,isiadinam,1,1,0,0,9
54740,gamyamānatthattā,gamyamanatthatta,1,1,0,0,16
54741,dhāvantaṃ,dhavantam,18,16,2,0,9
54742,nivattati,nivattati,125,120,5,0,9
54743,ādiccamaṇḍalaṃ,adiccamandalam,1,1,0,0,14
54744,javantaṃ,javantam,1,1,0,0,8
54745,muhuttakālaṃ,muhuttakalam,1,1,0,0,12
54746,punāvattati,punavattati,1,1,0,0,11
54747,candamaṇḍalampi,candamandalampi,1,1,0,0,15
54748,ādiccamaṇḍalampi,adiccamandalampi,1,1,0,0,16
54749,paṭisandhito,patisandhito,81,78,3,0,12
54750,yāvacuti,yavacuti,2,2,0,0,8
54751,āyukiccato,ayukiccato,1,1,0,0,10
54752,āyucandādīnamatthānaṃ,ayucandadinamatthanam,1,1,0,0,21
54753,tappakāsakasaddānañca,tappakasakasaddananca,1,1,0,0,21
54754,tulyattā,tulyatta,3,3,0,0,8
54755,patiṭṭhitacandādiatthantarānaṃ,patitthitacandadiatthantaranam,1,1,0,0,30
54756,kittimahīnāmaṃ,kittimahinamam,2,1,1,0,14
54757,kaḷāratthavhayaṃ,kalaratthavhayam,2,1,1,0,16
54758,puriṃ,purim,3,2,1,0,5
54759,karontopyu,karontopyu,1,1,0,0,10
54760,yyamavhayaṃ,yyamavhayam,1,1,0,0,11
54761,karontomuttamavhayanti,karontomuttamavhayanti,1,1,0,0,22
54762,kittimahīnaṃ,kittimahinam,1,1,0,0,12
54763,aggamahesiṃ,aggamahesim,62,62,0,0,11
54764,kaḷāraatthānaṃ,kalaraatthanam,1,1,0,0,14
54765,nagarañca,nagaranca,13,13,0,0,9
54766,uyyamavhayaṃ,uyyamavhayam,1,0,1,0,12
54767,uyyamanāmena,uyyamanamena,1,1,0,0,12
54768,nānusari,nanusari,1,1,0,0,8
54769,yasodharādeviñca,yasodharadevinca,1,1,0,0,16
54770,kapilavatthupuriñca,kapilavatthupurinca,1,1,0,0,19
54771,vīriyasaṅkhātapadhānaṃ,viriyasankhatapadhanam,1,1,0,0,22
54772,etthābhimata,etthabhimata,1,1,0,0,12
54773,pariyāyehi,pariyayehi,66,64,2,0,10
54774,kittimahī,kittimahi,1,0,1,0,9
54775,saddādīhi,saddadihi,21,20,1,0,9
54776,racitatā,racitata,1,1,0,0,8
54777,catuddisāmukhā,catuddisamukha,2,1,1,0,14
54778,bandhā,bandha,23,22,1,0,6
54779,sindhavā,sindhava,34,33,1,0,8
54780,paribhuñjanti,paribhunjanti,173,171,2,0,13
54781,catuddisāsammukhā,catuddisasammukha,1,1,0,0,17
54782,sammukhaṃ,sammukham,13,12,1,0,9
54783,catuddisāmukhābandhā,catuddisamukhabandha,1,1,0,0,20
54784,niddiṭṭhattā,nidditthatta,73,69,4,0,12
54785,bandhāti,bandhati,3,3,0,0,8
54786,sammuḷhatā,sammulhata,1,1,0,0,10
54787,jīvanajānandakarabandhussa,jivanajanandakarabandhussa,2,1,1,0,26
54788,sakkarontova,sakkarontova,1,1,0,0,12
54789,puññārikkhayagocare,punnarikkhayagocare,2,1,1,0,19
54790,jīvanato,jivanato,22,22,0,0,8
54791,jātānaṃ,jatanam,149,138,11,0,7
54792,padumānaṃ,padumanam,10,10,0,0,9
54793,ānandakarassa,anandakarassa,2,2,0,0,13
54794,bandhussa,bandhussa,3,3,0,0,9
54795,sakkaronto,sakkaronto,24,22,2,0,10
54796,pūjento,pujento,35,35,0,0,7
54797,puññārisaṅkhātānaṃ,punnarisankhatanam,1,1,0,0,18
54798,akusalānaṃ,akusalanam,633,606,27,0,10
54799,nimittabhūtaṃ,nimittabhutam,19,19,0,0,13
54800,nibbānamārammaṇaṃ,nibbanamarammanam,4,3,1,0,17
54801,maggaphale,maggaphale,9,9,0,0,10
54802,jīvanajānaṃ,jivanajanam,1,1,0,0,11
54803,bandhusseti,bandhusseti,1,1,0,0,11
54804,puññārīnaṃ,punnarinam,1,1,0,0,10
54805,khayanimittaṃ,khayanimittam,1,1,0,0,13
54806,maggaphalā,maggaphala,1,1,0,0,10
54807,pārampariyena,parampariyena,3,3,0,0,13
54808,sambandhānaṃ,sambandhanam,8,8,0,0,12
54809,bāhullabhāvo,bahullabhavo,2,2,0,0,12
54810,catuppadassa,catuppadassa,6,6,0,0,12
54811,kassāpi,kassapi,3,3,0,0,7
54812,kaṇṇoyaṃ,kannoyam,1,1,0,0,8
54813,kilāphalo,kilaphalo,1,1,0,0,9
54814,vibhūsanampi,vibhusanampi,1,1,0,0,12
54815,aphalo,aphalo,46,41,5,0,6
54816,saphalato,saphalato,1,1,0,0,9
54817,tadādhārassa,tadadharassa,7,7,0,0,12
54818,avacanato,avacanato,23,23,0,0,9
54819,nissayagutti,nissayagutti,1,1,0,0,12
54820,alaṅkaronto,alankaronto,5,5,0,0,11
54821,sadevakaṃ,sadevakam,238,207,31,0,9
54822,sañjātasaṃvaddho,sanjatasamvaddho,2,2,0,0,16
54823,nupalimpatī,nupalimpati,1,1,0,0,11
54824,alaṅkarontoti,alankarontoti,1,1,0,0,13
54825,bhuvanasaṅkhātaṃ,bhuvanasankhatam,1,1,0,0,16
54826,lakkhiyasamannāgato,lakkhiyasamannagato,1,1,0,0,19
54827,kataro,kataro,70,69,1,0,6
54828,padumoti,padumoti,3,2,1,0,8
54829,padumo,padumo,70,58,12,0,6
54830,puṃnapuṃsakaliṅgo,pumnapumsakalingo,2,2,0,0,17
54831,jalapadumānaṃ,jalapadumanam,1,1,0,0,13
54832,chāditattā,chaditatta,7,7,0,0,10
54833,majjhimassādi,majjhimassadi,1,1,0,0,13
54834,siddhantādīsu,siddhantadisu,2,1,1,0,13
54835,vattantaṃ,vattantam,16,16,0,0,9
54836,asaṅkhatapadaṃ,asankhatapadam,4,3,1,0,14
54837,vadā,vada,16,16,0,0,4
54838,avasāne,avasane,225,214,11,0,7
54839,ādopi,adopi,3,3,0,0,5
54840,tādīsu,tadisu,1,0,1,0,6
54841,ariyesu,ariyesu,30,29,1,0,7
54842,sakāro,sakaro,12,12,0,0,6
54843,yakāroyeva,yakaroyeva,1,1,0,0,10
54844,majjhimavaṇṇo,majjhimavanno,1,1,0,0,13
54845,matasamayakālādīsu,matasamayakaladisu,1,1,0,0,18
54846,vācakabhāvena,vacakabhavena,9,9,0,0,13
54847,pavattantaṃ,pavattantam,8,8,0,0,11
54848,saṅkhatato,sankhatato,26,23,3,0,10
54849,aññattā,annatta,28,28,0,0,7
54850,asaṅkhatabhūtaṃ,asankhatabhutam,1,1,0,0,15
54851,samayasaddo,samayasaddo,16,16,0,0,11
54852,siddhanta,siddhanta,1,0,1,0,9
54853,saṅgahitattā,sangahitatta,150,145,5,0,12
54854,tādiattho,tadiattho,1,1,0,0,9
54855,guḷhatāya,gulhataya,1,1,0,0,9
54856,samāgatālakkhaṇena,samagatalakkhanena,1,1,0,0,18
54857,aññattharuḷhasaddena,annattharulhasaddena,1,1,0,0,20
54858,vañcitattā,vancitatta,3,3,0,0,10
54859,vañcitālakkhaṇena,vancitalakkhanena,1,1,0,0,17
54860,nānatthakappanato,nanatthakappanato,1,1,0,0,17
54861,nāmantarikālakkhaṇena,namantarikalakkhanena,1,1,0,0,21
54862,tīhipi,tihipi,149,140,9,0,6
54863,missitoti,missitoti,1,1,0,0,9
54864,sesesupi,sesesupi,656,648,8,0,8
54865,saṃkiṇṇattaṃ,samkinnattam,1,1,0,0,12
54866,vuttalakkhaṇānusāreneva,vuttalakkhananusareneva,1,1,0,0,23
54867,anvatthasaññatā,anvatthasannata,2,2,0,0,15
54868,desakālakalālokañāyāgamavirodhi,desakalakalalokanayagamavirodhi,1,0,1,0,31
54869,tamudāharaṇato,tamudaharanato,1,0,1,0,14
54870,thalajaladesādi,thalajaladesadi,1,1,0,0,15
54871,rattindivo,rattindivo,36,36,0,0,10
54872,naccagītādayo,naccagitadayo,1,1,0,0,13
54873,carācarabhūtappavatti,caracarabhutappavatti,1,1,0,0,21
54874,sutidhammasaṃhitā,sutidhammasamhita,1,1,0,0,17
54875,etañca,etanca,90,79,11,0,6
54876,udāharaṇato,udaharanato,4,2,2,0,11
54877,lakkhiyato,lakkhiyato,2,2,0,0,10
54878,jalajādīnaṃ,jalajadinam,1,1,0,0,11
54879,thalādīsu,thaladisu,2,2,0,0,9
54880,pātubhāvādi,patubhavadi,1,1,0,0,11
54881,ratyādīsu,ratyadisu,1,1,0,0,9
54882,sambhavantānaṃ,sambhavantanam,16,16,0,0,14
54883,kusumādīnaṃ,kusumadinam,1,1,0,0,11
54884,divādīsu,divadisu,2,2,0,0,8
54885,naccagītādicatusaṭṭhiyā,naccagitadicatusatthiya,2,2,0,0,23
54886,kalāsu,kalasu,7,7,0,0,6
54887,bhinnachajjo,bhinnachajjo,1,1,0,0,12
54888,sattasaro,sattasaro,1,1,0,0,9
54889,kalāsatthābhihitalakkhaṇātikkamavirodho,kalasatthabhihitalakkhanatikkamavirodho,1,1,0,0,39
54890,aggisītalo,aggisitalo,1,1,0,0,10
54891,nissāro,nissaro,31,31,0,0,7
54892,lokasīmātikkamo,lokasimatikkamo,1,1,0,0,15
54893,vuttāyapā,vuttayapa,1,1,0,0,9
54894,naruppattasamuppattiyā,naruppattasamuppattiya,1,1,0,0,22
54895,middhassa,middhassa,32,31,1,0,9
54896,rūpabhāvāpādanādiñāyavirodho,rupabhavapadanadinayavirodho,1,1,0,0,28
54897,yathāsakamāgamena,yathasakamagamena,1,1,0,0,17
54898,pākaṭattā,pakatatta,89,88,1,0,9
54899,viññātuṃ,vinnatum,149,143,6,0,8
54900,nodāhaṭanti,nodahatanti,2,2,0,0,11
54901,yamakapaheḷikānamadassane,yamakapahelikanamadassane,1,1,0,0,25
54902,uddesakkamena,uddesakkamena,18,18,0,0,13
54903,sampattavirodhidosaṃ,sampattavirodhidosam,1,1,0,0,20
54904,desakāli,desakali,1,0,1,0,8
54905,thalajalapabbatādi,thalajalapabbatadi,1,1,0,0,18
54906,hemantādivasena,hemantadivasena,2,2,0,0,15
54907,vasantādivasena,vasantadivasena,1,1,0,0,15
54908,chabbidho,chabbidho,65,61,4,0,9
54909,naccagītādicatusaṭṭhi,naccagitadicatusatthi,1,1,0,0,21
54910,thāvarajaṅgamabhūtapavattisaṅkhāto,thavarajangamabhutapavattisankhato,1,1,0,0,34
54911,sutidhammasaṃhito,sutidhammasamhito,1,1,0,0,17
54912,vassikajātisumanādīnaṃ,vassikajatisumanadinam,1,1,0,0,22
54913,jalajādibhāvo,jalajadibhavo,1,1,0,0,13
54914,padumakumudādīnaṃ,padumakumudadinam,1,1,0,0,17
54915,thalajādibhāvo,thalajadibhavo,1,1,0,0,14
54916,rattiādīsu,rattiadisu,2,2,0,0,10
54917,labbhamānānaṃ,labbhamananam,16,14,2,0,13
54918,kumudādīnaṃ,kumudadinam,1,1,0,0,11
54919,dassitasattasarānamekadesassa,dassitasattasaranamekadesassa,1,1,0,0,29
54920,bhinnasattasaro,bhinnasattasaro,1,1,0,0,15
54921,samudāyavasena,samudayavasena,21,20,1,0,14
54922,vohārakaraṇādīhi,voharakaranadihi,1,1,0,0,16
54923,satthāgatataṃ,satthagatatam,1,1,0,0,13
54924,lakkhaṇātikkamañca,lakkhanatikkamanca,1,1,0,0,18
54925,uṇhaṃ,unham,276,246,30,0,5
54926,khadirarukkho,khadirarukkho,1,1,0,0,13
54927,sasāro,sasaro,1,1,0,0,6
54928,lokamariyādātikkamo,lokamariyadatikkamo,1,1,0,0,19
54929,arūpabhāvupapattiyā,arupabhavupapattiya,1,1,0,0,19
54930,vuttāyapi,vuttayapi,5,5,0,0,9
54931,rūpabhāvasādhanasadisayuttivirodhikathanañca,rupabhavasadhanasadisayuttivirodhikathananca,1,1,0,0,44
54932,yathāsakamāgamamatikkamma,yathasakamagamamatikkamma,1,1,0,0,25
54933,kathanañcāti,kathanancati,1,1,0,0,12
54934,viruddhasabhāvassa,viruddhasabhavassa,1,1,0,0,18
54935,dassayissāmāti,dassayissamati,3,3,0,0,14
54936,imesameva,imesameva,2,2,0,0,9
54937,desādivirodhīnamaviruddhattaṃ,desadivirodhinamaviruddhattam,1,1,0,0,29
54938,ettheva,ettheva,351,336,15,0,7
54939,virodhipadadosaparihāre,virodhipadadosaparihare,1,1,0,0,23
54940,bodhisattappabhāvenā,bodhisattappabhavena,2,2,0,0,20
54941,ticcādinā,ticcadina,2,2,0,0,9
54942,gamehi,gamehi,3,3,0,0,6
54943,ayamassatthīti,ayamassatthiti,1,1,0,0,14
54944,vivacchitā,vivacchita,2,2,0,0,10
54945,neyyamāhu,neyyamahu,3,1,2,0,9
54946,appatītaṃ,appatitam,5,2,3,0,9
54947,nahyaññathāvagamo,nahyannathavagamo,1,1,0,0,17
54948,ganthantarābhāvato,ganthantarabhavato,1,1,0,0,18
54949,dullabhāvagatī,dullabhavagati,3,3,0,0,14
54950,saddasāmatthiyavilaṅghinī,saddasamatthiyavilanghini,7,3,4,0,25
54951,samānīya,samaniya,1,1,0,0,8
54952,pubbadisādayo,pubbadisadayo,1,1,0,0,13
54953,rajanyaṃ,rajanyam,2,2,0,0,8
54954,ujjalā,ujjala,6,5,1,0,6
54955,ettake,ettake,196,188,8,0,6
54956,niddiṭṭhe,nidditthe,35,33,2,0,9
54957,candamarīcino,candamaricino,1,1,0,0,13
54958,neyyattaṃ,neyyattam,1,1,0,0,9
54959,neyyadosamudāharati,neyyadosamudaharati,1,1,0,0,19
54960,padantarena,padantarena,23,23,0,0,11
54961,tenābhihitatthena,tenabhihitatthena,1,1,0,0,17
54962,imassatthoya,imassatthoya,1,1,0,0,12
54963,padantaramānīya,padantaramaniya,1,1,0,0,15
54964,neyyadoso,neyyadoso,3,3,0,0,9
54965,tatthodāharaṇamīdisaṃ,tatthodaharanamidisam,1,1,0,0,21
54966,pubbadakkhiṇādayo,pubbadakkhinadayo,1,1,0,0,17
54967,dhavalaguṇaṃ,dhavalagunam,1,1,0,0,12
54968,kelāsakūṭasudhābhitticandaraṃsiādīsu,kelasakutasudhabhitticandaramsiadisu,1,1,0,0,36
54969,sañjātamiti,sanjatamiti,1,1,0,0,11
54970,anicchitattā,anicchitatta,14,14,0,0,12
54971,aññanivattanatthaṃ,annanivattanattham,1,1,0,0,18
54972,candakiraṇādivācakapadaṃ,candakiranadivacakapadam,1,1,0,0,24
54973,dhavalatā,dhavalata,1,1,0,0,9
54974,imineti,imineti,1,1,0,0,7
54975,vattabbattā,vattabbatta,305,304,1,0,11
54976,dhavala,dhavala,1,0,1,0,7
54977,neyyadosena,neyyadosena,1,1,0,0,11
54978,patītaṃ,patitam,3,2,1,0,7
54979,viññātaṃ,vinnatam,214,189,25,0,8
54980,pasajjapaṭisedhe,pasajjapatisedhe,3,3,0,0,16
54981,nicchanti,nicchanti,6,6,0,0,9
54982,viññūti,vinnuti,9,3,6,0,7
54983,ñeyyavidū,neyyavidu,1,1,0,0,9
54984,gajjādike,gajjadike,1,1,0,0,9
54985,sambhāventi,sambhaventi,13,13,0,0,11
54986,nappayujjanti,nappayujjanti,1,1,0,0,13
54987,bahumaññantīti,bahumannantiti,2,2,0,0,14
54988,avagatī,avagati,2,0,2,0,7
54989,vācakaṃ,vacakam,16,16,0,0,7
54990,sāmatthiyañca,samatthiyanca,3,2,1,0,13
54991,ñāyaṃ,nayam,75,66,9,0,5
54992,vilaṅghayati,vilanghayati,2,1,1,0,12
54993,cajati,cajati,14,14,0,0,6
54994,anupadassanatoti,anupadassanatoti,1,1,0,0,16
54995,labhyate,labhyate,1,1,0,0,8
54996,ñāyopattho,nayopattho,1,1,0,0,10
54997,saddopattho,saddopattho,1,1,0,0,11
54998,yottho,yottho,11,11,0,0,6
54999,nappatīyate,nappatiyate,6,6,0,0,11
55000,avaṭṭhitamattenāti,avatthitamattenati,1,1,0,0,18
55001,patītabbamaneyyaṃ,patitabbamaneyyam,1,1,0,0,17
55002,tabbiparītaṃ,tabbiparitam,16,16,0,0,12
55003,neyyanti,neyyanti,4,4,0,0,8
55004,appatītapadaṃ,appatitapadam,1,1,0,0,13
55005,nābhimatanti,nabhimatanti,1,1,0,0,12
55006,nedisa,nedisa,1,0,1,0,6
55007,yathāvuttappakāraṃ,yathavuttappakaram,8,8,0,0,18
55008,gajjapajjādike,gajjapajjadike,1,1,0,0,14
55009,nappayojenti,nappayojenti,1,1,0,0,12
55010,saddasaṅkhātavācakañca,saddasankhatavacakanca,1,1,0,0,22
55011,sāmatthiyasaṅkhātañāyañca,samatthiyasankhatanayanca,1,1,0,0,25
55012,pavattinī,pavattini,26,22,4,0,9
55013,tādisapayogābhāvato,tadisapayogabhavato,1,1,0,0,19
55014,saddāgato,saddagato,1,1,0,0,9
55015,ñāyāgato,nayagato,4,4,0,0,8
55016,patiṭṭhitamattena,patitthitamattena,1,1,0,0,17
55017,neyyadosamiti,neyyadosamiti,1,1,0,0,13
55018,pariharantīti,pariharantiti,18,7,11,0,13
55019,bahumānaṃ,bahumanam,9,9,0,0,9
55020,saddasāmatthiyaṃ,saddasamatthiyam,1,1,0,0,16
55021,nibbisesanantu,nibbisesanantu,1,1,0,0,14
55022,vuttatthameva,vuttatthameva,150,143,7,0,13
55023,passatī,passati,341,309,32,0,7
55024,labbhateva,labbhateva,125,123,2,0,10
55025,atthasahitaṃ,atthasahitam,2,2,0,0,12
55026,tassodāharaṇamevaṃ,tassodaharanamevam,1,1,0,0,18
55027,yebhuyyasā,yebhuyyasa,1,1,0,0,10
55028,vutteyeva,vutteyeva,29,29,0,0,9
55029,cakkhunāti,cakkhunati,21,4,17,0,10
55030,visesyapadaṃ,visesyapadam,1,1,0,0,12
55031,laddhāva,laddhava,8,8,0,0,8
55032,sātthakamiti,satthakamiti,1,1,0,0,12
55033,nippabhīkatakhajjoto,nippabhikatakhajjoto,4,3,1,0,20
55034,hīna,hina,17,15,2,0,4
55035,ityādinā,ityadina,19,19,0,0,8
55036,nippabhīkato,nippabhikato,1,1,0,0,12
55037,khajjotappabhāpaharaṇe,khajjotappabhapaharane,1,1,0,0,22
55038,divākarassāti,divakarassati,1,1,0,0,13
55039,tatthodāharaṇamevaṃ,tatthodaharanamevam,2,2,0,0,19
55040,pabhārahitakatā,pabharahitakata,1,1,0,0,15
55041,khajjotā,khajjota,4,4,0,0,8
55042,uggacchati,uggacchati,110,106,4,0,10
55043,visesanena,visesanena,39,39,0,0,10
55044,lāmakālokaladdhayuttassa,lamakalokaladdhayuttassa,1,1,0,0,24
55045,khajjopanakassa,khajjopanakassa,3,3,0,0,15
55046,abhibhavanappakāsanaṃ,abhibhavanappakasanam,1,1,0,0,21
55047,sahassaraṃsino,sahassaramsino,1,1,0,0,14
55048,nindāyeva,nindayeva,1,1,0,0,9
55049,thutīti,thutiti,3,2,1,0,7
55050,nippabhā,nippabha,13,13,0,0,8
55051,nippabhīkatā,nippabhikata,1,1,0,0,12
55052,anatthamiti,anatthamiti,2,0,2,0,11
55053,pādapaṅkeruhampica,padapankeruhampica,1,0,1,0,18
55054,pādapūraṇamattattā,padapuranamattatta,1,1,0,0,18
55055,anatthakattaṃ,anatthakattam,3,3,0,0,13
55056,visesanavisesyapadadoso,visesanavisesyapadadoso,2,2,0,0,23
55057,pādapūraṇi,padapurani,1,0,1,0,10
55058,catutthaṃsasaṅkhātassa,catutthamsasankhatassa,1,1,0,0,22
55059,pūraṇamattameva,puranamattameva,1,1,0,0,15
55060,vuttattho,vuttattho,8,8,0,0,9
55061,pādambujaṃ,padambujam,3,3,0,0,10
55062,apicāti,apicati,15,2,13,0,7
55063,samattanādiatthesu,samattanadiatthesu,1,1,0,0,18
55064,pādapūraṇamattato,padapuranamattato,1,1,0,0,17
55065,vākyadosaniddesavaṇṇanā,vakyadosaniddesavannana,2,2,0,0,23
55066,tamekatthaṃ,tamekattham,1,0,1,0,11
55067,vāridovārido,varidovarido,1,0,1,0,12
55068,tasmiṃyevatthe,tasmimyevatthe,2,2,0,0,14
55069,abhidheyyena,abhidheyyena,2,2,0,0,12
55070,pubbapaṭipādikasseva,pubbapatipadikasseva,1,1,0,0,20
55071,vatthussāvisesena,vatthussavisesena,1,1,0,0,17
55072,paṭipādanato,patipadanato,4,4,0,0,12
55073,payuttaṃ,payuttam,35,24,11,0,8
55074,padattharūpaṃ,padattharupam,3,3,0,0,13
55075,tamekatthanti,tamekatthanti,1,1,0,0,13
55076,jaladānamattāpekkhāya,jaladanamattapekkhaya,1,1,0,0,21
55077,uddiṭṭhakkamena,udditthakkamena,3,3,0,0,15
55078,vākyadosaṃ,vakyadosam,1,1,0,0,10
55079,yujjate,yujjate,15,15,0,0,7
55080,yathi,yathi,8,2,6,0,5
55081,jaladāyako,jaladayako,4,4,0,0,10
55082,sampattisādhakaṃ,sampattisadhakam,1,1,0,0,16
55083,ccādivisesanaṃ,ccadivisesanam,1,1,0,0,14
55084,jaladānamattassa,jaladanamattassa,1,1,0,0,16
55085,titthiyasaṅkhātānaṃ,titthiyasankhatanam,2,2,0,0,19
55086,aṅkurānaṃ,ankuranam,2,2,0,0,9
55087,uppattihetubhūtāni,uppattihetubhutani,1,1,0,0,18
55088,dūrīkaronto,durikaronto,1,1,0,0,11
55089,pasādabahule,pasadabahule,7,7,0,0,12
55090,pasādetīti,pasadetiti,18,16,2,0,10
55091,aparamudāharaṇaṃ,aparamudaharanam,3,3,0,0,16
55092,pasādasaṅkhātassa,pasadasankhatassa,2,2,0,0,17
55093,pasādetī,pasadeti,2,1,1,0,8
55094,idamatthato,idamatthato,1,1,0,0,11
55095,titthiyi,titthiyi,1,0,1,0,8
55096,uppattikāraṇabhūtāni,uppattikaranabhutani,1,1,0,0,20
55097,sassatādibhedabhinnā,sassatadibhedabhinna,1,1,0,0,20
55098,dvāsaṭṭhidiṭṭhiyo,dvasatthiditthiyo,10,7,3,0,17
55099,apanento,apanento,17,17,0,0,8
55100,pasanna,pasanna,5,3,2,0,7
55101,vuttappasādasaṅkhātassa,vuttappasadasankhatassa,1,1,0,0,23
55102,kriyāpadenapi,kriyapadenapi,1,1,0,0,13
55103,bhinnepi,bhinnepi,4,4,0,0,8
55104,ekanti,ekanti,144,132,12,0,6
55105,ekatthassudāharaṇaṃ,ekatthassudaharanam,1,1,0,0,19
55106,titthiyā,titthiya,285,263,22,0,8
55107,aṅkurāni,ankurani,2,2,0,0,8
55108,diṭṭhīsu,ditthisu,92,75,17,0,8
55109,gatāni,gatani,55,52,3,0,6
55110,gatānīti,gataniti,5,4,1,0,8
55111,āraddho,araddho,252,237,15,0,7
55112,vattumupakkamanto,vattumupakkamanto,1,1,0,0,17
55113,vacanapaṭipāṭi,vacanapatipati,1,1,0,0,14
55114,vicchedo,vicchedo,18,17,1,0,8
55115,avuttassapi,avuttassapi,2,2,0,0,11
55116,pasādavasā,pasadavasa,1,1,0,0,10
55117,ajjhāhāroti,ajjhaharoti,1,1,0,0,11
55118,sātisayattā,satisayatta,34,34,0,0,11
55119,aniddhāritaṃ,aniddharitam,1,1,0,0,12
55120,sabhāvavisesā,sabhavavisesa,1,1,0,0,13
55121,kāciyeva,kaciyeva,1,1,0,0,8
55122,pavattamānāyapi,pavattamanayapi,4,4,0,0,15
55123,vasabhāvassāniddhāritattā,vasabhavassaniddharitatta,1,1,0,0,25
55124,kopīti,kopiti,2,0,2,0,6
55125,sabbanāmapadakkamassa,sabbanamapadakkamassa,1,1,0,0,21
55126,pakatīti,pakatiti,15,10,5,0,8
55127,vicchinnattā,vicchinnatta,1,1,0,0,12
55128,āraddhakkami,araddhakkami,1,0,1,0,12
55129,vatthumāraddhapadakkamassa,vatthumaraddhapadakkamassa,1,1,0,0,26
55130,vicchedahetu,vicchedahetu,1,1,0,0,12
55131,bhaggarītivākyadoso,bhaggaritivakyadoso,1,1,0,0,19
55132,sātisayabhūtā,satisayabhuta,1,1,0,0,13
55133,vacanavisayātikkantattā,vacanavisayatikkantatta,2,2,0,0,23
55134,kāpiyeva,kapiyeva,3,3,0,0,8
55135,sīlasamādhiādianaññasādhāraṇaguṇasamūho,silasamadhiadianannasadharanagunasamuho,1,1,0,0,39
55136,pamāṇapariggahassa,pamanapariggahassa,1,1,0,0,18
55137,lesenapi,lesenapi,5,5,0,0,8
55138,kattumasakkuṇeyyattā,kattumasakkuneyyatta,1,1,0,0,20
55139,kopiyeva,kopiyeva,2,2,0,0,8
55140,acinteyyabhūtā,acinteyyabhuta,1,1,0,0,14
55141,vijjamānānaṃyeva,vijjamananamyeva,2,2,0,0,16
55142,paññādīnaṃ,pannadinam,6,6,0,0,10
55143,sabhāvāvabodhassa,sabhavavabodhassa,1,1,0,0,17
55144,dukkaratā,dukkarata,3,3,0,0,9
55145,acchariyā,acchariya,127,119,8,0,9
55146,padakkamassa,padakkamassa,1,1,0,0,12
55147,pakatī,pakati,15,11,4,0,6
55148,suññattā,sunnatta,23,23,0,0,8
55149,rītibhaṅgo,ritibhango,2,2,0,0,10
55150,āraddhoyeva,araddhoyeva,1,1,0,0,11
55151,byākiṇṇanti,byakinnanti,2,1,1,0,11
55152,syādyantākhyātikānaṃ,syadyantakhyatikanam,1,1,0,0,20
55153,duṭṭhapanato,dutthapanato,3,3,0,0,12
55154,saṃmuḷhatā,sammulhata,1,1,0,0,10
55155,byākiṇṇassa,byakinnassa,1,1,0,0,11
55156,aññampīti,annampiti,22,10,12,0,9
55157,syādyantatyādyantapadānaṃ,syadyantatyadyantapadanam,1,1,0,0,25
55158,saṃmoho,sammoho,1,1,0,0,7
55159,byākiṇṇadosoti,byakinnadosoti,1,1,0,0,14
55160,byākiṇṇadosassa,byakinnadosassa,1,1,0,0,15
55161,vakkhamānanayena,vakkhamananayena,59,59,0,0,16
55162,bahuanantattā,bahuanantatta,1,1,0,0,13
55163,bahubhūte,bahubhute,2,2,0,0,9
55164,sammadeva,sammadeva,804,800,4,0,9
55165,samuṭṭhāya,samutthaya,79,76,3,0,10
55166,guṇavisayasatiṃ,gunavisayasatim,1,1,0,0,15
55167,paccupaṭṭhāpento,paccupatthapento,1,1,0,0,16
55168,haṭṭhapahaṭṭho,hatthapahattho,40,40,0,0,14
55169,sujanetarānampi,sujanetaranampi,1,1,0,0,15
55170,devadattādīnaṃ,devadattadinam,13,13,0,0,14
55171,sammāsambuddhaṃ,sammasambuddham,210,205,5,0,15
55172,namassatīti,namassatiti,9,5,4,0,11
55173,kavivañcito,kavivancito,1,1,0,0,11
55174,paṇamatī,panamati,1,1,0,0,8
55175,byavahitapadappayogā,byavahitapadappayoga,1,1,0,0,20
55176,sīlasamādhiādiguṇe,silasamadhiadigune,1,1,0,0,18
55177,sattanikāyo,sattanikayo,17,17,0,0,11
55178,dujjanānampi,dujjananampi,1,0,1,0,12
55179,asappurisānampi,asappurisanampi,1,1,0,0,15
55180,mittabhūtaṃ,mittabhutam,1,1,0,0,11
55181,aṭṭhānapayogato,atthanapayogato,1,1,0,0,15
55182,byākiṇṇattaṃ,byakinnattam,1,1,0,0,12
55183,padatthānusāreneva,padatthanusareneva,1,1,0,0,18
55184,nvi,nvi,1,0,1,0,3
55185,pariccattaṃ,pariccattam,89,87,2,0,11
55186,ityāmantanaṃ,ityamantanam,1,1,0,0,12
55187,icchāmi,icchami,178,177,1,0,7
55188,nicchasi,nicchasi,2,2,0,0,8
55189,gāmikajanavacanattā,gamikajanavacanatta,1,1,0,0,19
55190,kaññi,kanni,1,0,1,0,5
55191,ccādikaṃ,ccadikam,6,6,0,0,8
55192,visiṭṭhavacanāpetaṃ,visitthavacanapetam,1,0,1,0,19
55193,piyabhūtena,piyabhutena,1,1,0,0,11
55194,uttivisesena,uttivisesena,1,1,0,0,12
55195,visesitabbassa,visesitabbassa,2,2,0,0,14
55196,parihīnaṃ,parihinam,44,42,2,0,9
55197,gāmmadosaṃ,gammadosam,1,1,0,0,10
55198,icchayamānaṃ,icchayamanam,1,1,0,0,12
55199,icchasi,icchasi,189,184,5,0,7
55200,icchāvighāte,icchavighate,1,1,0,0,12
55201,vuccamāne,vuccamane,189,186,3,0,9
55202,madīyā,madiya,1,1,0,0,6
55203,kāraṇāyaṃ,karanayam,2,2,0,0,9
55204,nipphalataṃ,nipphalatam,2,2,0,0,11
55205,māninimānabhaṅge,maninimanabhange,1,1,0,0,16
55206,manmathonyatra,manmathonyatra,1,1,0,0,14
55207,piyatthassa,piyatthassa,1,1,0,0,11
55208,kathanābhāvato,kathanabhavato,1,1,0,0,14
55209,milakkhukānaṃ,milakkhukanam,1,1,0,0,13
55210,vacanattā,vacanatta,3,3,0,0,9
55211,dasavassikāya,dasavassikaya,1,1,0,0,13
55212,apetanti,apetanti,1,1,0,0,8
55213,gāmmaṃtya,gammamtya,1,0,1,0,9
55214,sandhivasena,sandhivasena,48,48,0,0,12
55215,asutisubhagaṃ,asutisubhagam,1,1,0,0,13
55216,patītimavabodhaṃ,patitimavabodham,1,1,0,0,16
55217,gāmmantyabhimataṃ,gammantyabhimatam,1,1,0,0,17
55218,vanitā,vanita,13,13,0,0,6
55219,ekottho,ekottho,2,2,0,0,7
55220,yabha,yabha,8,3,5,0,5
55221,yabhanaṃ,yabhanam,2,2,0,0,8
55222,yābho,yabho,2,2,0,0,5
55223,yābhavā,yabhava,2,0,2,0,7
55224,ityapi,ityapi,1,1,0,0,6
55225,padasandhāni,padasandhani,1,0,1,0,12
55226,pubbāparapadānaṃ,pubbaparapadanam,2,2,0,0,16
55227,ghaṭanato,ghatanato,1,1,0,0,9
55228,asabbhabhūtaduṭṭhatthassa,asabbhabhutadutthatthassa,1,1,0,0,25
55229,pakāsako,pakasako,10,10,0,0,8
55230,gāmmanti,gammanti,2,1,1,0,8
55231,yathāvuttagāmmadosena,yathavuttagammadosena,1,1,0,0,21
55232,dūsitanti,dusitanti,3,3,0,0,9
55233,duppasitanti,duppasitanti,1,1,0,0,12
55234,yathāti,yathati,190,28,162,0,7
55235,bhavantassa,bhavantassa,18,18,0,0,11
55236,icchitattho,icchitattho,3,3,0,0,11
55237,methunavantassa,methunavantassa,1,1,0,0,15
55238,piyātipi,piyatipi,1,1,0,0,8
55239,yābhavatoti,yabhavatoti,1,1,0,0,11
55240,asotabbattā,asotabbatta,1,1,0,0,11
55241,duppatītikaratā,duppatitikarata,1,1,0,0,15
55242,duṭṭhāyeva,dutthayeva,1,1,0,0,10
55243,avabodho,avabodho,44,42,2,0,8
55244,yatihīnanti,yatihinanti,1,0,1,0,11
55245,vuttesvi,vuttesvi,1,0,1,0,8
55246,chandosatthapariniddiṭṭhesu,chandosatthaparinidditthesu,1,1,0,0,27
55247,anuṭṭhubhādīsu,anutthubhadisu,1,1,0,0,14
55248,etthayatī,etthayati,1,1,0,0,9
55249,chandovicitiyā,chandovicitiya,1,1,0,0,14
55250,pakāsitaṭṭhāne,pakasitatthane,1,1,0,0,14
55251,syādyantānaṃ,syadyantanam,4,4,0,0,12
55252,vicchiti,vicchiti,1,1,0,0,8
55253,yatiyā,yatiya,12,12,0,0,6
55254,yamanaṃ,yamanam,6,6,0,0,7
55255,virāmo,viramo,4,4,0,0,6
55256,panāti,panati,662,37,625,0,6
55257,vuttesva,vuttesva,1,0,1,0,8
55258,chandosatthe,chandosatthe,1,1,0,0,12
55259,niddiṭṭhaanuṭṭhubhādīsu,nidditthaanutthubhadisu,1,1,0,0,23
55260,pakāsite,pakasite,40,37,3,0,8
55261,syādyantatyādyantādīnaṃ,syadyantatyadyantadinam,1,1,0,0,23
55262,abhimataṭṭhāne,abhimatatthane,1,1,0,0,14
55263,vaṇṇavicchedena,vannavicchedena,1,1,0,0,15
55264,yatihīnadosena,yatihinadosena,1,1,0,0,14
55265,pādante,padante,3,0,3,0,7
55266,pubbāparānekavaṇṇapadamajjhepi,pubbaparanekavannapadamajjhepi,3,1,2,0,30
55267,catutthaṃsasaṅkhātānaṃ,catutthamsasankhatanam,1,1,0,0,22
55268,pādadvayasaṅkhāte,padadvayasankhate,2,2,0,0,17
55269,aḍḍhe,addhe,38,36,2,0,5
55270,tadavasāne,tadavasane,7,7,0,0,10
55271,hotevāti,hotevati,17,15,2,0,8
55272,pubbāpare,pubbapare,15,10,5,0,9
55273,padañca,padanca,29,28,1,0,7
55274,majjhepi,majjhepi,11,11,0,0,8
55275,yatimhi,yatimhi,1,1,0,0,7
55276,labbhamānaṃ,labbhamanam,104,103,1,0,11
55277,sabbavisayaṃ,sabbavisayam,2,2,0,0,12
55278,catutthaṃsasaṅkhātagāthāpādānaṃ,catutthamsasankhatagathapadanam,1,1,0,0,31
55279,pubbāparabhūtaanekavaṇṇasamannāgatapadānaṃ,pubbaparabhutaanekavannasamannagatapadanam,1,1,0,0,42
55280,padacchedassa,padacchedassa,2,2,0,0,13
55281,saṅkāpariharaṇatthaṃ,sankapariharanattham,1,1,0,0,20
55282,pubbāparānekavaṇṇapadamajjhe,pubbaparanekavannapadamajjhe,2,2,0,0,28
55283,pādanto,padanto,2,2,0,0,7
55284,vuttaḍḍho,vuttaddho,1,1,0,0,9
55285,padamajjhañca,padamajjhanca,1,1,0,0,13
55286,yatiṭṭhānanti,yatitthananti,1,1,0,0,13
55287,padamajjheyeva,padamajjheyeva,1,1,0,0,14
55288,labbhamānā,labbhamana,49,48,1,0,10
55289,dvakkharatyakkharapadamajjhe,dvakkharatyakkharapadamajjhe,1,1,0,0,28
55290,cāmīkaravaṇṇaṃ,camikaravannam,5,3,2,0,14
55291,siñcatīva,sincativa,3,0,3,0,9
55292,soṇṇarasehiyo,sonnarasehiyo,1,0,1,0,13
55293,udāharīyatīti,udahariyatiti,4,2,2,0,13
55294,paṭipakkhamudāharaṇaṃ,patipakkhamudaharanam,1,1,0,0,21
55295,paccudāharaṇaṃ,paccudaharanam,11,10,1,0,14
55296,cāmīkarasseva,camikarasseva,1,1,0,0,13
55297,sabbāyeva,sabbayeva,3,3,0,0,9
55298,cāmīkaravaṇṇattā,camikaravannatta,1,1,0,0,16
55299,rasehi,rasehi,50,49,1,0,6
55300,suvaṇṇarasehi,suvannarasehi,1,1,0,0,13
55301,tathāgatanti,tathagatanti,4,4,0,0,12
55302,apekkhate,apekkhate,3,3,0,0,9
55303,pubbapādante,pubbapadante,1,1,0,0,12
55304,niyatā,niyata,224,206,18,0,6
55305,cāmīkara,camikara,2,1,1,0,8
55306,caturakkharo,caturakkharo,1,1,0,0,12
55307,pubbabhāgo,pubbabhago,59,56,3,0,10
55308,pubbāparānekavaṇṇapadamajjhattābhāvā,pubbaparanekavannapadamajjhattabhava,1,1,0,0,36
55309,ityatra,ityatra,1,1,0,0,7
55310,duṭṭhāti,dutthati,5,3,2,0,8
55311,pādantavuttaḍḍhesu,padantavuttaddhesu,1,1,0,0,18
55312,udāharaṇapaccudāharaṇāni,udaharanapaccudaharanani,1,0,1,0,24
55313,iṭṭhodāharaṇapaṭipakkhodāharaṇāni,itthodaharanapatipakkhodaharanani,1,1,0,0,33
55314,suvaṇṇarasadhārāhi,suvannarasadharahi,3,3,0,0,18
55315,siñcati,sincati,30,28,2,0,7
55316,suvaṇṇavaṇṇasadisachavivaṇṇaṃ,suvannavannasadisachavivannam,1,1,0,0,29
55317,cāmīti,camiti,1,0,1,0,6
55318,akkharadvayamatikkamma,akkharadvayamatikkamma,1,1,0,0,22
55319,antepi,antepi,3,3,0,0,6
55320,akkharadvayenānūnattā,akkharadvayenanunatta,1,1,0,0,21
55321,pubbāparavaṇṇānamanekattamitiṭṭhodāharaṇaṃ,pubbaparavannanamanekattamititthodaharanam,1,1,0,0,42
55322,siñcāti,sincati,3,1,2,0,7
55323,vaṇṇadvayamatikkamma,vannadvayamatikkamma,1,1,0,0,20
55324,dissamānattepiti,dissamanattepiti,1,1,0,0,16
55325,parabhāge,parabhage,37,33,4,0,9
55326,ekavaṇṇattā,ekavannatta,3,3,0,0,11
55327,anekavaṇṇābhāvoti,anekavannabhavoti,1,1,0,0,17
55328,anekavaṇṇattaṃ,anekavannattam,1,1,0,0,14
55329,padavaseneva,padavaseneva,1,1,0,0,12
55330,cāmīkarassa,camikarassa,3,3,0,0,11
55331,yādesādi,yadesadi,3,0,3,0,8
55332,parādi,paradi,2,1,1,0,6
55333,saṃhitāyaṃ,samhitayam,4,4,0,0,10
55334,parapadādibhūto,parapadadibhuto,1,1,0,0,15
55335,antabhūto,antabhuto,1,1,0,0,9
55336,anekavaṇṇattābhāvepi,anekavannattabhavepi,2,2,0,0,20
55337,vihitayatiyā,vihitayatiya,1,1,0,0,12
55338,nevatthi,nevatthi,87,85,2,0,8
55339,bhaṅgoti,bhangoti,17,15,2,0,8
55340,alope,alope,5,5,0,0,5
55341,pubbapadantabhūto,pubbapadantabhuto,2,2,0,0,17
55342,parapadassādisaro,parapadassadisaro,1,1,0,0,17
55343,katayatiyā,katayatiya,1,1,0,0,10
55344,yatiyaṃ,yatiyam,2,2,0,0,7
55345,ivaṇṇādīnaṃ,ivannadinam,2,2,0,0,11
55346,kārādesādi,karadesadi,2,2,0,0,10
55347,parādiva,paradiva,2,0,2,0,8
55348,parapadassa,parapadassa,6,6,0,0,11
55349,ādisaro,adisaro,3,3,0,0,7
55350,desādisahitaṃ,desadisahitam,1,1,0,0,13
55351,vuttassa,vuttassa,328,326,2,0,8
55352,viruddhattepi,viruddhattepi,1,1,0,0,13
55353,yatibhaṅgābhāvaṃ,yatibhangabhavam,1,1,0,0,16
55354,sandhisaro,sandhisaro,1,1,0,0,10
55355,kattabba,kattabba,14,13,1,0,8
55356,pubbantasadisasaramatikkamitvāpi,pubbantasadisasaramatikkamitvapi,1,1,0,0,32
55357,parapadādisarasadisavaṇṇamāgamma,parapadadisarasadisavannamagamma,1,1,0,0,32
55358,anatikkamitvāpi,anatikkamitvapi,2,2,0,0,15
55359,parapadādisarasadisayādesādimatikkamitvāpi,parapadadisarasadisayadesadimatikkamitvapi,1,1,0,0,42
55360,payuttāya,payuttaya,1,1,0,0,9
55361,pubbassa,pubbassa,127,125,2,0,8
55362,antoti,antoti,94,50,44,0,6
55363,makārādinoti,makaradinoti,1,1,0,0,12
55364,ādīti,aditi,21,10,11,0,5
55365,cādī,cadi,5,2,3,0,4
55366,pubbapadantāva,pubbapadantava,2,0,2,0,14
55367,pādayo,padayo,24,21,3,0,6
55368,pubbapadaṃ,pubbapadam,13,12,1,0,10
55369,kārādayo,karadayo,7,7,0,0,8
55370,nipātā,nipata,30,29,1,0,6
55371,kātabbāti,katabbati,143,123,20,0,9
55372,parapadena,parapadena,28,28,0,0,10
55373,satatayogino,satatayogino,1,1,0,0,12
55374,aṭṭhānappayutto,atthanappayutto,30,30,0,0,15
55375,pubbapadante,pubbapadante,1,1,0,0,12
55376,kārādinipātā,karadinipata,1,1,0,0,12
55377,nirantarayogino,nirantarayogino,1,1,0,0,15
55378,avayavāviya,avayavaviya,1,1,0,0,11
55379,katvāpi,katvapi,147,143,4,0,7
55380,yatibhaṅgoti,yatibhangoti,1,1,0,0,12
55381,coādi,coadi,1,1,0,0,5
55382,sitāti,sitati,9,2,7,0,6
55383,sambandhāti,sambandhati,6,6,0,0,11
55384,tagguṇasaṃviññāṇattā,taggunasamvinnanatta,1,1,0,0,20
55385,cakārapakārādīnampi,cakarapakaradinampi,1,1,0,0,19
55386,sabbopamātītaṃ,sabbopamatitam,2,1,1,0,14
55387,pattasso,pattasso,1,0,1,0,8
55388,vandāmya,vandamya,1,0,1,0,8
55389,para52-53,para52-53,3,3,0,0,9
55390,pubbantasadisādīsu,pubbantasadisadisu,1,1,0,0,18
55391,itiādigāthādvaye,itiadigathadvaye,2,2,0,0,16
55392,sabbopamātīto,sabbopamatito,1,1,0,0,13
55393,paññāmettā,pannametta,1,1,0,0,10
55394,nirantaramiva,nirantaramiva,1,1,0,0,13
55395,anantamati,anantamati,1,1,0,0,10
55396,samāsaṃ,samasam,25,24,1,0,7
55397,vibhattilope,vibhattilope,13,13,0,0,12
55398,saṃhitāyañca,samhitayanca,2,2,0,0,12
55399,parapadādiukāro,parapadadiukaro,1,1,0,0,15
55400,pubbapadantabbakāraṭṭha,pubbapadantabbakarattha,1,1,0,0,23
55401,pādantayati,padantayati,3,3,0,0,11
55402,pattassopamā,pattassopama,1,0,1,0,12
55403,yakārādesassa,yakaradesassa,1,1,0,0,13
55404,parādisadisabhāvo,paradisadisabhavo,2,2,0,0,17
55405,parapadādi,parapadadi,1,1,0,0,10
55406,taṃvibhattiyā,tamvibhattiya,1,1,0,0,13
55407,vandāmyananta,vandamyananta,1,0,1,0,13
55408,kārādesassa,karadesassa,1,1,0,0,11
55409,vihitoti,vihitoti,7,7,0,0,8
55410,pubbapadassitānaṃ,pubbapadassitanam,1,1,0,0,17
55411,pubbapadantasadisatā,pubbapadantasadisata,1,1,0,0,20
55412,aparapadasambandhā,aparapadasambandha,1,1,0,0,18
55413,parapadādisadisā,parapadadisadisa,1,1,0,0,16
55414,yathāvuttapubbantasadisasarādīsu,yathavuttapubbantasadisasaradisu,1,1,0,0,32
55415,udāharaṇāniyathā,udaharananiyatha,1,1,0,0,16
55416,sakalapadatthānaṃ,sakalapadatthanam,1,1,0,0,17
55417,pubbapadantasarasadisattā,pubbapadantasarasadisatta,1,1,0,0,25
55418,parāya,paraya,23,23,0,0,6
55419,ssopamāti,ssopamati,1,0,1,0,9
55420,parapadādisadisaṃ,parapadadisadisam,1,1,0,0,17
55421,vaṇṇamanatikkamma,vannamanatikkamma,1,1,0,0,17
55422,ṭhitāya,thitaya,120,120,0,0,7
55423,sambuddhassa,sambuddhassa,62,62,0,0,12
55424,canissīmā,canissima,1,0,1,0,9
55425,anantasattaanantañeyyavisayakaraṇato,anantasattaanantaneyyavisayakaranato,1,1,0,0,36
55426,sīmārahitā,simarahita,1,1,0,0,10
55427,ativijambhati,ativijambhati,1,1,0,0,13
55428,anantamatiṃ,anantamatim,1,0,1,0,11
55429,udayabbayasambhavepi,udayabbayasambhavepi,1,1,0,0,20
55430,ñeyyassānantattā,neyyassanantatta,1,1,0,0,16
55431,visayavohārena,visayavoharena,2,2,0,0,14
55432,anantapaññāya,anantapannaya,1,1,0,0,13
55433,pavaraṃ,pavaram,120,106,14,0,7
55434,desassa,desassa,23,23,0,0,7
55435,parādisadisattā,paradisadisatta,1,1,0,0,15
55436,tamanāgamma,tamanagamma,1,1,0,0,11
55437,mettācanissīmāti,mettacanissimati,1,0,1,0,16
55438,pubbapadantasadisattāca,pubbapadantasadisattaca,1,1,0,0,23
55439,parapadādisadisattā,parapadadisadisatta,1,1,0,0,19
55440,imesampi,imesampi,49,48,1,0,8
55441,varaguṇālayaṃ,varagunalayam,3,1,2,0,13
55442,paramodayāti,paramodayati,1,0,1,0,12
55443,mahāmettādayo,mahamettadayo,1,1,0,0,13
55444,ukkaṭṭhābhivuḍḍhiyo,ukkatthabhivuddhiyo,2,2,0,0,19
55445,jinanti,jinanti,19,18,1,0,7
55446,pubbapadanissitaṃ,pubbapadanissitam,1,1,0,0,17
55447,cakāraṃ,cakaram,11,11,0,0,7
55448,parapadādibhūtaṃ,parapadadibhutam,1,1,0,0,16
55449,parapadādisambandhapakāraṃ,parapadadisambandhapakaram,1,1,0,0,26
55450,pubbapadantabhūtaṃ,pubbapadantabhutam,1,1,0,0,18
55451,pakārato,pakarato,76,76,0,0,8
55452,viruddhāti,viruddhati,6,3,3,0,10
55453,visayabhūtesu,visayabhutesu,14,14,0,0,13
55454,mahāmetti,mahametti,1,0,1,0,9
55455,uttamaguṇākaraṃ,uttamagunakaram,1,1,0,0,15
55456,parapadādiṃ,parapadadim,1,1,0,0,11
55457,pakāraṃ,pakaram,60,60,0,0,7
55458,pubbapadantaṃ,pubbapadantam,1,1,0,0,13
55459,tidvayamapi,tidvayamapi,1,1,0,0,11
55460,kamaccutamidaṃ,kamaccutamidam,1,1,0,0,14
55461,atthakkamato,atthakkamato,3,3,0,0,12
55462,kamaccutamidanti,kamaccutamidanti,1,1,0,0,16
55463,arucitoyaṃ,arucitoyam,1,1,0,0,10
55464,yācanakkamo,yacanakkamo,2,2,0,0,11
55465,vattuno,vattuno,15,15,0,0,7
55466,aviññutaṃ,avinnutam,4,4,0,0,9
55467,khettampi,khettampi,2,2,0,0,9
55468,nicchati,nicchati,8,8,0,0,8
55469,gāmādikaṃ,gamadikam,2,2,0,0,9
55470,dassatīti,dassatiti,23,18,5,0,9
55471,padatthi,padatthi,1,0,1,0,8
55472,janapadaṃ,janapadam,207,204,3,0,9
55473,khetta,khetta,8,6,2,0,6
55474,aviññubhāvaṃ,avinnubhavam,1,1,0,0,12
55475,ucitapadatthakkamaṃ,ucitapadatthakkamam,1,1,0,0,19
55476,nappakāseti,nappakaseti,2,2,0,0,11
55477,khettamapi,khettamapi,1,1,0,0,10
55478,dātumanicchanto,datumanicchanto,1,1,0,0,15
55479,gāmanigamajanapadādiṃ,gamanigamajanapadadim,1,1,0,0,21
55480,kamahāni,kamahani,1,1,0,0,8
55481,mākāsametissā,makasametissa,1,0,1,0,13
55482,thanajumbhane,thanajumbhane,1,1,0,0,13
55483,loki,loki,1,0,1,0,4
55484,lokiyo,lokiyo,196,184,12,0,6
55485,mabhidheyyaṃ,mabhidheyyam,1,1,0,0,12
55486,ananuvuttaṃ,ananuvuttam,1,1,0,0,11
55487,thanānaṃ,thananam,23,22,1,0,8
55488,payodharānaṃ,payodharanam,2,2,0,0,12
55489,jambhane,jambhane,2,1,1,0,8
55490,atisambādhaṃ,atisambadham,18,13,5,0,12
55491,accantappakaṃ,accantappakam,1,1,0,0,13
55492,lokiyatthi,lokiyatthi,1,0,1,0,10
55493,lokiyatthaṃ,lokiyattham,1,0,1,0,11
55494,pasiddhamabhidheyyaṃ,pasiddhamabhidheyyam,1,1,0,0,20
55495,kathanākārena,kathanakarena,1,1,0,0,13
55496,atikkamitaṃ,atikkamitam,1,1,0,0,11
55497,ativuttamiti,ativuttamiti,1,1,0,0,12
55498,anokāsaṃ,anokasam,40,38,2,0,8
55499,vadāmāti,vadamati,19,17,2,0,8
55500,mahantanti,mahantanti,24,24,0,0,10
55501,gaganamapi,gaganamapi,1,1,0,0,10
55502,atikkantattā,atikkantatta,27,27,0,0,12
55503,vākyamativuttadosena,vakyamativuttadosena,1,1,0,0,20
55504,dūsitaṃ,dusitam,11,11,0,0,7
55505,balībaddho,balibaddho,4,3,1,0,10
55506,samudāyi,samudayi,2,0,2,0,8
55507,samudāyassa,samudayassa,70,68,2,0,11
55508,pakaraṇato,pakaranato,72,71,1,0,10
55509,padasandhino,padasandhino,1,1,0,0,12
55510,aṅgaṅgibhūtaṃ,angangibhutam,1,1,0,0,13
55511,kriyākārakasambandhīvisesalakkhaṇaṃ,kriyakarakasambandhivisesalakkhanam,1,1,0,0,35
55512,saṃvohārikaṃ,samvoharikam,2,2,0,0,12
55513,padatthamattena,padatthamattena,2,2,0,0,15
55514,byabhicārābhāvato,byabhicarabhavato,12,12,0,0,17
55515,etādisaṃ,etadisam,106,94,12,0,8
55516,tamapetatthakanti,tamapetatthakanti,1,1,0,0,17
55517,visesanavisesyabhūtakriyākārakasambandhehi,visesanavisesyabhutakriyakarakasambandhehi,1,1,0,0,42
55518,yuttavākyasaṅkhātapadasamudāyassa,yuttavakyasankhatapadasamudayassa,1,1,0,0,33
55519,sambandhapadattā,sambandhapadatta,1,1,0,0,16
55520,vohārānurūpaatthato,voharanurupaatthato,1,1,0,0,19
55521,avayavatthamattassa,avayavatthamattassa,1,1,0,0,19
55522,labbhamānattā,labbhamanatta,60,60,0,0,13
55523,khādi,khadi,94,91,3,0,5
55524,avayavatthamattena,avayavatthamattena,1,1,0,0,18
55525,gamyamānassa,gamyamanassa,2,2,0,0,12
55526,visesatthassa,visesatthassa,2,2,0,0,13
55527,iccādikaṃ,iccadikam,13,13,0,0,9
55528,sutisubhagattābhāvato,sutisubhagattabhavato,1,1,0,0,21
55529,kakkasā,kakkasa,28,25,3,0,7
55530,khāṇukādayo,khanukadayo,2,2,0,0,11
55531,kedāre,kedare,22,22,0,0,6
55532,vākyadoso,vakyadoso,2,2,0,0,9
55533,bandhasarīre,bandhasarire,2,2,0,0,12
55534,sutisukhatābhāvato,sutisukhatabhavato,1,1,0,0,18
55535,pharusabhāvo,pharusabhavo,6,6,0,0,12
55536,vākyatthadosaniddesavaṇṇanā,vakyatthadosaniddesavannana,1,1,0,0,27
55537,lakkhaṇamanvatthavasenā,lakkhanamanvatthavasena,1,0,1,0,23
55538,udāharaṇametesaṃ,udaharanametesam,1,0,1,0,16
55539,ñeyya,neyya,10,5,5,0,5
55540,apakkamādīnaṃ,apakkamadinam,4,3,1,0,13
55541,udāharaṇamanenāti,udaharanamanenati,1,1,0,0,17
55542,anvatthavasena,anvatthavasena,11,9,2,0,14
55543,apakkamantiādinā,apakkamantiadina,1,1,0,0,16
55544,atthānugamanavasena,atthanugamanavasena,1,1,0,0,19
55545,vākyadose,vakyadose,2,2,0,0,9
55546,niddisitvā,niddisitva,65,64,1,0,10
55547,avasarappatte,avasarappatte,1,1,0,0,13
55548,sandassayāmi,sandassayami,2,1,1,0,12
55549,pakāsessāmi,pakasessami,10,10,0,0,11
55550,apakkamādiatthadosāni,apakkamadiatthadosani,1,1,0,0,21
55551,apakkamocityahīnādīnaṃ,apakkamocityahinadinam,1,1,0,0,22
55552,apakkamādivisayabuddhiyā,apakkamadivisayabuddhiya,1,1,0,0,24
55553,aviparītavuttiyā,aviparitavuttiya,2,2,0,0,16
55554,pavattikāraṇaṃ,pavattikaranam,6,6,0,0,14
55555,yatthiccādivacanatthānugatañāṇavasena,yatthiccadivacanatthanugatananavasena,1,1,0,0,37
55556,atthānugatamanvatthaṃ,atthanugatamanvattham,1,1,0,0,21
55557,anvatthassa,anvatthassa,2,2,0,0,11
55558,vasoti,vasoti,15,12,3,0,6
55559,tatthāpakkamaṃ,tatthapakkamam,1,1,0,0,14
55560,bhāvanādānasīlāni,bhavanadanasilani,5,3,2,0,17
55561,bhogasaggādinibbānasādhanāni,bhogasaggadinibbanasadhanani,2,0,2,0,28
55562,alobhādihetusampattiyā,alobhadihetusampattiya,2,2,0,0,22
55563,nipphāditāni,nipphaditani,4,4,0,0,12
55564,bhogasaggādinibbānānaṃ,bhogasaggadinibbananam,1,1,0,0,22
55565,dānasīlabhāvanāyo,danasilabhavanayo,2,2,0,0,17
55566,apakkamādīsu,apakkamadisu,1,1,0,0,12
55567,apakkamassodāharaṇamevaṃ,apakkamassodaharanamevam,1,1,0,0,24
55568,bhāvani,bhavani,1,0,1,0,7
55569,rāsikatāni,rasikatani,4,4,0,0,10
55570,upabhogaparibhogāni,upabhogaparibhogani,2,2,0,0,19
55571,sagguppattiāyuārogyādīni,sagguppattiayuarogyadini,1,1,0,0,24
55572,nibbānañceti,nibbananceti,3,3,0,0,12
55573,sādhakāni,sadhakani,24,22,2,0,9
55574,sadisavisadisavipākadāne,sadisavisadisavipakadane,1,1,0,0,24
55575,bhogasagganibbānānaṃ,bhogasagganibbananam,1,1,0,0,20
55576,hetubhūtā,hetubhuta,32,31,1,0,9
55577,phalakkamassa,phalakkamassa,1,1,0,0,13
55578,hetukkamaṃ,hetukkamam,1,1,0,0,10
55579,viruddhamiti,viruddhamiti,1,1,0,0,12
55580,kamāpetaṃ,kamapetam,1,1,0,0,9
55581,pūjanīyi,pujaniyi,1,0,1,0,8
55582,kevale,kevale,9,9,0,0,6
55583,rāsibhūtā,rasibhuta,23,23,0,0,9
55584,kevalo,kevalo,88,87,1,0,6
55585,ahameva,ahameva,753,742,11,0,7
55586,pujjoti,pujjoti,2,1,1,0,7
55587,evamattapasaṃsanamarucitaṃ,evamattapasamsanamarucitam,1,1,0,0,26
55588,sappurisassa,sappurisassa,4,4,0,0,12
55589,pūjanīyatare,pujaniyatare,1,0,1,0,12
55590,adutiye,adutiye,1,1,0,0,7
55591,attappasaṃsanato,attappasamsanato,1,1,0,0,16
55592,ucitatāya,ucitataya,1,1,0,0,9
55593,parihānīti,parihaniti,29,23,6,0,10
55594,yācitohaṃ,yacitoham,2,1,1,0,9
55595,dajjāmyapi,dajjamyapi,1,0,1,0,10
55596,yāciṃsu,yacimsu,135,135,0,0,7
55597,jīvitampi,jivitampi,57,54,3,0,9
55598,dajjāmī,dajjami,4,4,0,0,7
55599,dassitodāratāyānucitaṃ,dassitodaratayanucitam,1,1,0,0,22
55600,puttadāne,puttadane,2,2,0,0,9
55601,hadayapavedhanakathanaṃ,hadayapavedhanakathanam,1,1,0,0,23
55602,yajjevamavoca,yajjevamavoca,1,1,0,0,13
55603,ocityahīnassa,ocityahinassa,1,1,0,0,13
55604,yācakehi,yacakehi,4,4,0,0,8
55605,jīvitamapi,jivitamapi,2,2,0,0,10
55606,dajjāmi,dajjami,14,14,0,0,7
55607,dānajjhāsaye,danajjhasaye,2,2,0,0,12
55608,kampate,kampate,2,2,0,0,7
55609,yāceyyuṃ,yaceyyum,2,2,0,0,8
55610,katapaṭiññāya,katapatinnaya,2,2,0,0,13
55611,hadayakampanassa,hadayakampanassa,1,1,0,0,16
55612,cāgātisayayogasaṅkhātaudāraguṇassa,cagatisayayogasankhataudaragunassa,1,1,0,0,34
55613,ananucchavikanti,ananucchavikanti,5,5,0,0,16
55614,dujjanānañca,dujjanananca,5,4,1,0,12
55615,rājakulamhī,rajakulamhi,1,0,1,0,11
55616,itthīna,itthina,3,1,2,0,7
55617,pariccāgena,pariccagena,26,26,0,0,11
55618,sattamīniddeso,sattaminiddeso,1,1,0,0,14
55619,attharītiyā,attharitiya,1,1,0,0,11
55620,kārapariccāgā,karapariccaga,1,1,0,0,13
55621,saddarītiyā,saddaritiya,2,2,0,0,11
55622,rītīnaṃ,ritinam,2,2,0,0,7
55623,bhaṅgāpyanantā,bhangapyananta,1,1,0,0,14
55624,itthīnañca,itthinanca,11,11,0,0,10
55625,sahavāsādīhi,sahavasadihi,1,1,0,0,12
55626,anatthasaṃsayānivattikāraṇattā,anatthasamsayanivattikaranatta,1,1,0,0,30
55627,garaḷe,garale,1,1,0,0,6
55628,siṅgavati,singavati,1,1,0,0,9
55629,sādo,sado,2,1,1,0,4
55630,nadiyañca,nadiyanca,2,2,0,0,9
55631,vaḍḍhamānake,vaddhamanake,5,5,0,0,12
55632,vadhabandhanādikārake,vadhabandhanadikarake,1,1,0,0,21
55633,rājakule,rajakule,106,105,1,0,8
55634,ārabhitvā,arabhitva,197,197,0,0,9
55635,attharīti,atthariti,2,2,0,0,9
55636,ādimajjhesu,adimajjhesu,2,2,0,0,11
55637,saddapariccāgato,saddapariccagato,1,1,0,0,16
55638,saddarīti,saddariti,1,1,0,0,9
55639,payuñjantena,payunjantena,1,1,0,0,12
55640,yojetabbaṃ,yojetabbam,1221,1188,33,0,10
55641,īdiso,idiso,124,120,4,0,5
55642,rītibhaṅgadosāpi,ritibhangadosapi,1,1,0,0,16
55643,bahuvidhā,bahuvidha,32,31,1,0,9
55644,mukhamattanidassanaṃ,mukhamattanidassanam,27,20,7,0,20
55645,munindacandimālokarasalolavilocano,munindacandimalokarasalolavilocano,2,0,2,0,34
55646,gopadassanapīṇito,gopadassanapinito,2,0,2,0,17
55647,munindi,munindi,8,1,7,0,7
55648,munindoyeva,munindoyeva,3,3,0,0,11
55649,ālokanaṃ,alokanam,10,8,2,0,8
55650,anurāgo,anurago,3,3,0,0,7
55651,lolāni,lolani,5,4,1,0,6
55652,capalāni,capalani,2,2,0,0,8
55653,locanāni,locanani,7,6,1,0,8
55654,avakkanto,avakkanto,3,2,1,0,9
55655,okkanto,okkanto,78,73,5,0,7
55656,paviṭṭho,pavittho,449,442,7,0,8
55657,avakkantapantho,avakkantapantho,1,1,0,0,15
55658,raṃsīnaṃ,ramsinam,5,5,0,0,8
55659,iṭṭhatthanipphattisūcakabhāvena,itthatthanipphattisucakabhavena,1,1,0,0,31
55660,padassanena,padassanena,1,1,0,0,11
55661,pīṇito,pinito,13,12,1,0,6
55662,muditoti,muditoti,4,2,2,0,8
55663,gorūpassa,gorupassa,10,10,0,0,9
55664,padassanenātipi,padassanenatipi,1,1,0,0,15
55665,sandeho,sandeho,19,18,1,0,7
55666,munindasaṅkhātassa,munindasankhatassa,1,1,0,0,18
55667,candimassa,candimassa,1,1,0,0,10
55668,ālayena,alayena,13,12,1,0,7
55669,cañcalanetto,cancalanetto,1,1,0,0,12
55670,avakkantapanthova,avakkantapanthova,1,0,1,0,17
55671,otiṇṇamaggova,otinnamaggova,1,1,0,0,13
55672,dassanatthāya,dassanatthaya,110,106,4,0,13
55673,maggamotiṇṇoti,maggamotinnoti,1,1,0,0,14
55674,gosaṅkhātaraṃsipadassanena,gosankhataramsipadassanena,1,1,0,0,26
55675,abhimaṅgalasammatagopadassanena,abhimangalasammatagopadassanena,1,1,0,0,31
55676,gopadassanenāti,gopadassanenati,1,1,0,0,15
55677,gāvassa,gavassa,25,25,0,0,7
55678,padassananti,padassananti,1,1,0,0,12
55679,gopadassanena,gopadassanena,1,1,0,0,13
55680,pīṇitoti,pinitoti,2,1,1,0,8
55681,vīriyavāso,viriyavaso,2,1,1,0,10
55682,hantvāna,hantvana,33,28,5,0,8
55683,vissami,vissami,6,2,4,0,7
55684,vākya,vakya,9,6,3,0,5
55685,sattuṃ,sattum,33,32,1,0,6
55686,vissattho,vissattho,69,67,2,0,9
55687,duppatīto,duppatito,1,1,0,0,9
55688,ucitasambhavo,ucitasambhavo,1,1,0,0,13
55689,vissamīti,vissamiti,1,1,0,0,9
55690,duppatītoyamattho,duppatitoyamattho,1,1,0,0,17
55691,apākaṭattā,apakatatta,24,24,0,0,10
55692,salakkhaṇaṃ,salakkhanam,24,23,1,0,11
55693,lakkhiyamudāharati,lakkhiyamudaharati,3,3,0,0,18
55694,viruddhappakāsakaṃ,viruddhappakasakam,1,1,0,0,18
55695,māretvāna,maretvana,2,2,0,0,9
55696,vigataparissamo,vigataparissamo,2,2,0,0,15
55697,vītikkamaṃ,vitikkamam,93,88,5,0,10
55698,upacitasambhavo,upacitasambhavo,1,1,0,0,15
55699,upacitasukko,upacitasukko,1,1,0,0,12
55700,vigatavāyāmo,vigatavayamo,1,1,0,0,12
55701,imassatthassa,imassatthassa,41,41,0,0,13
55702,asabbhārahattā,asabbharahatta,1,1,0,0,14
55703,yatthālaṅkāradūsanaṃ,yatthalankaradusanam,2,2,0,0,20
55704,tassālaṅkāraniddese,tassalankaraniddese,2,1,1,0,19
55705,rūpamāvībhavissati,rupamavibhavissati,1,0,1,0,18
55706,dūsanaṃ,dusanam,8,6,2,0,7
55707,vikaṭatā,vikatata,1,1,0,0,8
55708,etantu,etantu,1,1,0,0,6
55709,duṭṭhālaṅkārassa,dutthalankarassa,2,2,0,0,16
55710,alaṅkāraniddese,alankaraniddese,2,0,2,0,15
55711,taṃnāmake,tamnamake,1,1,0,0,9
55712,āvībhavissati,avibhavissati,2,1,1,0,13
55713,pakāsissati,pakasissati,1,1,0,0,11
55714,dassayissāmīti,dassayissamiti,5,4,1,0,14
55715,duṭṭhālaṅkari,dutthalankari,1,0,1,0,13
55716,alaṅkāradūsanaṃ,alankaradusanam,1,0,1,0,15
55717,vākyatthanissitaṃ,vakyatthanissitam,1,1,0,0,17
55718,duṭṭhālaṅkāro,dutthalankaro,1,1,0,0,13
55719,duṭṭhālaṅkaraṇadosopalakkhitavākyassa,dutthalankaranadosopalakkhitavakyassa,1,1,0,0,37
55720,nidassanaṭṭhānabhūte,nidassanatthanabhute,1,1,0,0,20
55721,duṭṭhālaṅkatī,dutthalankati,1,1,0,0,13
55722,alaṅkaraṇaalaṅkāra,alankaranaalankara,1,0,1,0,18
55723,tulyatthattā,tulyatthatta,1,1,0,0,12
55724,dosānamesaṃ,dosanamesam,1,0,1,0,11
55725,saṅgharakkhitamahāsāmipādaviracite,sangharakkhitamahasamipadaviracite,5,5,0,0,34
55726,kathayāmyahaṃ,kathayamyaham,2,2,0,0,13
55727,katapaṭiññānurūpaṃ,katapatinnanurupam,2,2,0,0,18
55728,paṭipajja,patipajja,35,31,4,0,9
55729,katotri,katotri,1,0,1,0,7
55730,nikkhipananayaṃ,nikkhipananayam,1,1,0,0,15
55731,saṅkhipati,sankhipati,5,5,0,0,10
55732,adhikāre,adhikare,42,41,1,0,8
55733,vibhajanaṃ,vibhajanam,65,57,8,0,10
55734,saṅkhepakkamena,sankhepakkamena,2,2,0,0,15
55735,aparisaṅkhyeyyānaṃ,aparisankhyeyyanam,1,1,0,0,18
55736,niṭṭhāpito,nitthapito,8,8,0,0,10
55737,purātanehi,puratanehi,8,8,0,0,10
55738,purātarehi,puratarehi,1,1,0,0,10
55739,vitthārakkamassa,vittharakkamassa,1,1,0,0,16
55740,anadhippetattā,anadhippetatta,49,47,2,0,14
55741,nihantu,nihantu,2,2,0,0,7
55742,aripāvakaṃ,aripavakam,2,2,0,0,10
55743,itiādīnaṃ,itiadinam,215,215,0,0,9
55744,akkhamatthantarādikaṃ,akkhamatthantaradikam,2,0,2,0,21
55745,viruddhatthantarānugatanti,viruddhatthantaranugatanti,1,1,0,0,26
55746,pataṅga,patanga,2,0,2,0,7
55747,jotiriṅgaṇasaṅkhātamatthantaramasamatthamicchitatthe,jotiringanasankhatamatthantaramasamatthamicchitatthe,1,1,0,0,52
55748,vacanti,vacanti,6,6,0,0,7
55749,gaṇḍā,ganda,15,14,1,0,5
55750,tyevamādikaṃ,tyevamadikam,1,1,0,0,12
55751,amaṅgalaapayuttapadādikaṃ,amangalaapayuttapadadikam,1,1,0,0,25
55752,gajahesādi,gajahesadi,1,1,0,0,10
55753,sambandhadūsitaṃ,sambandhadusitam,1,1,0,0,16
55754,lokavirodhi,lokavirodhi,1,1,0,0,11
55755,sogatāgamādīsu,sogatagamadisu,1,1,0,0,14
55756,rūpakkhandhādikamaññatra,rupakkhandhadikamannatra,1,1,0,0,24
55757,āgamavirodhiiti,agamavirodhiiti,1,1,0,0,15
55758,sambandhadūsitappatītādikaṃ,sambandhadusitappatitadikam,1,1,0,0,27
55759,virodhimhi,virodhimhi,1,1,0,0,10
55760,paviṭṭhanti,pavitthanti,5,5,0,0,11
55761,ānetabbahetuttā,anetabbahetutta,2,2,0,0,15
55762,hetvapekkhaṃ,hetvapekkham,2,1,1,0,12
55763,neyyato,neyyato,2,2,0,0,7
55764,voharatu,voharatu,2,2,0,0,8
55765,rāhukhinno,rahukhinno,3,3,0,0,10
55766,asāmatthyābhidheyyādikaṃ,asamatthyabhidheyyadikam,1,1,0,0,24
55767,ocityahīne,ocityahine,2,2,0,0,10
55768,jigucchaasabbhasaṃsūcakaatthantarakañca,jigucchaasabbhasamsucakaatthantarakanca,1,1,0,0,39
55769,duppatītikare,duppatitikare,1,1,0,0,13
55770,saṅgayhatīti,sangayhatiti,27,26,1,0,12
55771,duruccāraṇaṃ,duruccaranam,5,4,1,0,12
55772,sabandhapharusameveti,sabandhapharusameveti,1,1,0,0,21
55773,ocityahīnaduppatītikarānaṃ,ocityahinaduppatitikaranam,2,2,0,0,26
55774,vākyatthadosattepi,vakyatthadosattepi,1,1,0,0,18
55775,phandhapharusassa,phandhapharusassa,1,1,0,0,17
55776,vākyadosatte,vakyadosatte,2,2,0,0,12
55777,padapadatthānaṃ,padapadatthanam,1,1,0,0,15
55778,vākyañca,vakyanca,8,8,0,0,8
55779,viriccate,viriccate,1,1,0,0,9
55780,duṭṭhe,dutthe,13,12,1,0,6
55781,duṭṭho,duttho,170,158,12,0,6
55782,padadosato,padadosato,1,1,0,0,10
55783,vākyavākyatthānaṃ,vakyavakyatthanam,1,1,0,0,17
55784,nānābhāvābhāvañāpanatthaṃ,nanabhavabhavanapanattham,1,1,0,0,25
55785,asāmatthiyābhidheyyādikaṃ,asamatthiyabhidheyyadikam,1,1,0,0,25
55786,ocityahīnādivākyatthadosādīsu,ocityahinadivakyatthadosadisu,1,1,0,0,29
55787,viruddhatthantarādīhi,viruddhatthantaradihi,1,1,0,0,21
55788,viracitaṃ,viracitam,8,8,0,0,9
55789,viruddhantiādinā,viruddhantiadina,2,2,0,0,16
55790,vākyāni,vakyani,17,16,1,0,7
55791,dassitāni,dassitani,141,139,2,0,9
55792,harisamānayī,harisamanayi,2,2,0,0,12
55793,mānayīti,manayiti,1,1,0,0,8
55794,icchitatthā,icchitattha,1,1,0,0,11
55795,bhaṭṭhaṃ,bhattham,17,13,4,0,8
55796,nānatthamappasiddhehi,nanatthamappasiddhehi,1,1,0,0,21
55797,guḷhaṃ,gulham,16,15,1,0,6
55798,sahassagū,sahassagu,2,2,0,0,9
55799,bhaṭṭhaguḷhatthādayo,bhatthagulhatthadayo,1,1,0,0,20
55800,pasādālaṅkāraviruddhāti,pasadalankaraviruddhati,1,1,0,0,23
55801,vākyepi,vakyepi,4,4,0,0,7
55802,visandhika,visandhika,1,0,1,0,10
55803,mihānupayogīti,mihanupayogiti,1,1,0,0,14
55804,vākyantaropagataṃ,vakyantaropagatam,1,1,0,0,17
55805,vākyagabbhaṃ,vakyagabbham,1,0,1,0,12
55806,vākyantarapadasammissaṃ,vakyantarapadasammissam,2,2,0,0,23
55807,apāthyameso,apathyameso,2,2,0,0,11
55808,vejjaṃ,vejjam,37,35,2,0,6
55809,khādatyanārata,khadatyanarata,1,1,0,0,14
55810,miccādikaṃ,miccadikam,3,3,0,0,10
55811,vākyasaṃkiṇṇañca,vakyasamkinnanca,1,0,1,0,16
55812,byākiṇṇe,byakinne,2,2,0,0,8
55813,samohitanti,samohitanti,1,1,0,0,11
55814,kācuyyāne,kacuyyane,2,2,0,0,9
55815,pañcapallavā,pancapallava,2,2,0,0,12
55816,kusumamañcarī,kusumamancari,2,2,0,0,13
55817,ida,ida,25,24,1,0,3
55818,mavācakaṃ,mavacakam,2,0,2,0,9
55819,pamussitāsannissitanti,pamussitasannissitanti,1,1,0,0,22
55820,latāvācinā,latavacina,1,1,0,0,10
55821,karacaraṇadasanacchadā,karacaranadasanacchada,1,1,0,0,22
55822,mañcarī,mancari,2,0,2,0,7
55823,nakhasobhā,nakhasobha,1,1,0,0,10
55824,dantakantiyo,dantakantiyo,1,1,0,0,12
55825,vattumicchitā,vattumicchita,2,2,0,0,13
55826,vākyatthepi,vakyatthepi,1,1,0,0,11
55827,paduminīnaṃ,padumininam,3,3,0,0,11
55828,rattiyamunniddatādikaṃ,rattiyamunniddatadikam,1,1,0,0,22
55829,virodhinilīnanti,virodhinilinanti,1,1,0,0,16
55830,nātyanuññātā,natyanunnata,1,1,0,0,12
55831,esova,esova,33,29,4,0,5
55832,paṇḍitajanānaṃ,panditajananam,4,4,0,0,14
55833,bandhepīdisaṃ,bandhepidisam,1,1,0,0,13
55834,santī,santi,62,48,14,0,5
55835,evamāsuhanopajanaṃ,evamasuhanopajanam,1,1,0,0,18
55836,padadose,padadose,1,1,0,0,8
55837,asādhusandiddhapariyāya,asadhusandiddhapariyaya,1,1,0,0,23
55838,ñeyyaappatītatthaappayojaka,neyyaappatitatthaappayojaka,1,1,0,0,27
55839,dubbodhadesiyādikaṃ,dubbodhadesiyadikam,1,1,0,0,19
55840,adhikaūnabhaggacchandādikaṃ,adhikaunabhaggacchandadikam,1,1,0,0,27
55841,vākyatthadose,vakyatthadose,2,2,0,0,13
55842,upakkamopasaṃhāravisamañceti,upakkamopasamharavisamanceti,1,1,0,0,28
55843,iccevamādikamaparampi,iccevamadikamaparampi,1,1,0,0,21
55844,bodhayitu,bodhayitu,1,0,1,0,9
55845,mavagametuṃ,mavagametum,1,1,0,0,11
55846,yathāvuttadosānusārena,yathavuttadosanusarena,1,1,0,0,22
55847,buddhimantehi,buddhimantehi,2,2,0,0,13
55848,ūhitunti,uhitunti,1,1,0,0,8
55849,vadato,vadato,130,120,10,0,6
55850,ganthakārassāyamadhippāyo,ganthakarassayamadhippayo,1,1,0,0,25
55851,vibhāgaso,vibhagaso,10,10,0,0,9
55852,ganthagāravabhayā,ganthagaravabhaya,1,1,0,0,17
55853,saṅkhepitā,sankhepita,1,1,0,0,10
55854,tesamantaṃ,tesamantam,1,1,0,0,10
55855,jahāpeti,jahapeti,4,4,0,0,8
55856,saddasatthaviruddha,saddasatthaviruddha,2,2,0,0,19
55857,masādhu,masadhu,3,1,2,0,7
55858,kriyādinimittamupādāya,kriyadinimittamupadaya,1,1,0,0,22
55859,atthantarepi,atthantarepi,1,1,0,0,12
55860,saññābhāveneva,sannabhaveneva,1,1,0,0,14
55861,sandiddhaṃ,sandiddham,5,2,3,0,10
55862,ravimhihimahā,ravimhihimaha,1,1,0,0,13
55863,visesanatthe,visesanatthe,5,5,0,0,12
55864,pasiddhasaññāsaddassa,pasiddhasannasaddassa,2,2,0,0,21
55865,pariyāyantarena,pariyayantarena,35,35,0,0,15
55866,parikappitapadaṃ,parikappitapadam,1,1,0,0,16
55867,pariyāyañeyyaṃ,pariyayaneyyam,2,0,2,0,14
55868,vaḷavāmukhene,valavamukhene,1,1,0,0,13
55869,assavanitānanena,assavanitananena,1,1,0,0,16
55870,accantābyabhicārībhāvena,accantabyabhicaribhavena,1,1,0,0,24
55871,appatītatthaṃ,appatitattham,2,1,1,0,13
55872,kaṇhamasī,kanhamasi,2,2,0,0,9
55873,adhigatatthānupayogaṃ,adhigatatthanupayogam,1,1,0,0,21
55874,appayojakaṃ,appayojakam,2,0,2,0,11
55875,atiphenilaṃ,atiphenilam,2,2,0,0,11
55876,sāgaramalaṅghī,sagaramalanghi,2,2,0,0,14
55877,manuññaddhanayo,manunnaddhanayo,3,2,1,0,15
55878,khādayo,khadayo,4,3,1,0,7
55879,kani,kani,4,3,1,0,4
55880,iccādiko,iccadiko,2,2,0,0,8
55881,dubbodho,dubbodho,1,0,1,0,8
55882,gaggharikā,gaggharika,2,2,0,0,10
55883,lāvaṇyatallā,lavanyatalla,3,2,1,0,12
55884,gallā,galla,3,2,1,0,5
55885,lolavilocane,lolavilocane,3,3,0,0,12
55886,desiyo,desiyo,1,0,1,0,6
55887,tallo,tallo,1,1,0,0,5
55888,jalāsayaviseso,jalasayaviseso,2,2,0,0,14
55889,gallo,gallo,1,1,0,0,5
55890,saggasevīnaṃ,saggasevinam,2,2,0,0,12
55891,ripūnamitthīnamakaṅkaṇo,ripunamitthinamakankano,1,1,0,0,23
55892,nettamanañjanaṃ,nettamananjanam,3,3,0,0,15
55893,itiādikaṃ,itiadikam,375,375,0,0,9
55894,akaṅkaṇo,akankano,3,3,0,0,8
55895,vedhabyassa,vedhabyassa,1,1,0,0,11
55896,gammamānattā,gammamanatta,6,6,0,0,12
55897,adhikanti,adhikanti,20,20,0,0,9
55898,ūnatā,unata,37,37,0,0,5
55899,tilokatilakaṃ,tilokatilakam,5,5,0,0,13
55900,vandāmī,vandami,8,8,0,0,7
55901,chandobhaṅgānvitaṃ,chandobhanganvitam,1,1,0,0,18
55902,bhaggacchandaṃ,bhaggacchandam,2,0,2,0,14
55903,ārambhāvasānena,arambhavasanena,1,1,0,0,15
55904,upakkamopasaṃhāravisamaṃ,upakkamopasamharavisamam,2,0,2,0,24
55905,āraddhakkamapariccāgenāparena,araddhakkamapariccagenaparena,1,1,0,0,29
55906,nikkhipanaṃ,nikkhipanam,45,45,0,0,11
55907,mahāsāmināmikāṭīkāyaṃ,mahasaminamikatikayam,1,1,0,0,21
55908,dosāvabodhaparicchedo,dosavabodhaparicchedo,1,1,0,0,21
55909,sampādetvā,sampadetva,217,213,4,0,10
55910,katotre,katotre,1,0,1,0,7
55911,yathāvuttapadadosādīnaṃ,yathavuttapadadosadinam,1,1,0,0,23
55912,lakkhaṇāvirodhalakkhiyato,lakkhanavirodhalakkhiyato,1,1,0,0,25
55913,asaṅkarato,asankarato,103,101,2,0,10
55914,vitthārāpaniyasaṅkhepakkamena,vittharapaniyasankhepakkamena,1,1,0,0,29
55915,saṅkhepakkamo,sankhepakkamo,1,1,0,0,13
55916,viracayantānaṃ,viracayantanam,1,1,0,0,14
55917,īdisappayogaṃ,idisappayogam,1,1,0,0,13
55918,pavattakhedamuppādayantaṃ,pavattakhedamuppadayantam,1,1,0,0,25
55919,asādhusandiddhādi,asadhusandiddhadi,1,1,0,0,17
55920,dūsanamatthi,dusanamatthi,1,1,0,0,12
55921,bodhetuṃ,bodhetum,33,32,1,0,8
55922,avuttopi,avuttopi,31,30,1,0,8
55923,ihāniddiṭṭhaṃ,ihaniddittham,1,1,0,0,13
55924,viruddhatthantare,viruddhatthantare,1,1,0,0,17
55925,anupatattā,anupatatta,1,1,0,0,10
55926,sūriyavācako,suriyavacako,1,1,0,0,12
55927,jotiriṅgaṇavācakopi,jotiringanavacakopi,1,1,0,0,19
55928,vattumicchitaamittaggivināse,vattumicchitaamittaggivinase,1,1,0,0,28
55929,asamatthaññattho,asamatthannattho,1,1,0,0,16
55930,gaṇḍi,gandi,2,2,0,0,5
55931,lakkhaṇamattena,lakkhanamattena,3,3,0,0,15
55932,sādhiyaṃ,sadhiyam,3,3,0,0,8
55933,appayuttapadādi,appayuttapadadi,1,0,1,0,15
55934,antogadho,antogadho,19,18,1,0,9
55935,gajahesāturaṅgakoñcanādādi,gajahesaturangakoncanadadi,1,1,0,0,26
55936,sambandhadūsita,sambandhadusita,1,0,1,0,15
55937,jināgamādīsu,jinagamadisu,1,1,0,0,12
55938,pasiddharūpakkhandhādikamaññatra,pasiddharupakkhandhadikamannatra,1,1,0,0,32
55939,payutta,payutta,3,3,0,0,7
55940,mappatīta,mappatita,1,0,1,0,9
55941,nnāmātīdaṃ,nnamatidam,1,1,0,0,10
55942,lokavirodhamāgamavirodhañca,lokavirodhamagamavirodhanca,1,1,0,0,27
55943,virodhipade,virodhipade,1,1,0,0,11
55944,neyye,neyye,3,3,0,0,5
55945,asamatthābhidhāyi,asamatthabhidhayi,2,1,1,0,17
55946,rāhugahito,rahugahito,1,1,0,0,10
55947,kilesāpanayane,kilesapanayane,1,1,0,0,14
55948,asamatthoti,asamatthoti,14,10,4,0,11
55949,tamasāmatthiyaṃ,tamasamatthiyam,1,1,0,0,15
55950,visesanabhūtena,visesanabhutena,7,7,0,0,15
55951,jigucchāvamaṅgalaasabbhānaṃ,jigucchavamangalaasabbhanam,1,0,1,0,27
55952,tiṇṇamaññatrassa,tinnamannatrassa,1,1,0,0,16
55953,jotakaṃ,jotakam,8,7,1,0,7
55954,vākyatthagāmmadoseyeva,vakyatthagammadoseyeva,1,1,0,0,22
55955,duruccāraṇa,duruccarana,1,0,1,0,11
55956,bhūtalakkhaṇaṃ,bhutalakkhanam,6,3,3,0,14
55957,bandhapharusato,bandhapharusato,1,1,0,0,15
55958,hapubbaṃ,hapubbam,1,1,0,0,8
55959,mānayiiccādikaṃ,manayiiccadikam,1,1,0,0,15
55960,paribhaṭṭhattā,paribhatthatta,1,1,0,0,14
55961,bhaṭṭha,bhattha,1,0,1,0,7
55962,apasiddhavisaye,apasiddhavisaye,1,1,0,0,15
55963,pariyuttaguḷhañceti,pariyuttagulhanceti,1,1,0,0,19
55964,atthaguḷhādayo,atthagulhadayo,1,1,0,0,14
55965,pasādālaṅkāraviruddhattā,pasadalankaraviruddhatta,1,1,0,0,24
55966,pasādaguṇādāneneva,pasadagunadaneneva,1,1,0,0,18
55967,pariccattāti,pariccattati,3,3,0,0,12
55968,sahassagūti,sahassaguti,1,1,0,0,11
55969,vākyadosepi,vakyadosepi,1,1,0,0,11
55970,visandhivākyaṃ,visandhivakyam,1,0,1,0,14
55971,anupayogittā,anupayogitta,1,1,0,0,12
55972,vākyamajjhapatitavākyayuttaṃ,vakyamajjhapatitavakyayuttam,1,1,0,0,28
55973,vākyagabbhañca,vakyagabbhanca,1,1,0,0,14
55974,khādatyanārataṃ,khadatyanaratam,1,1,0,0,15
55975,vākyasaṃkiṇṇa,vakyasamkinna,1,0,1,0,13
55976,apāthyaṃ,apathyam,2,0,2,0,8
55977,rogassa,rogassa,40,39,1,0,7
55978,ahitaṃ,ahitam,37,33,4,0,6
55979,rogī,rogi,3,3,0,0,4
55980,kujjhati,kujjhati,65,63,2,0,8
55981,anekavākyehipi,anekavakyehipi,1,1,0,0,14
55982,sandhivākyaṃ,sandhivakyam,1,1,0,0,12
55983,saṃkiṇṇaṃ,samkinnam,7,7,0,0,9
55984,paheḷikāsu,pahelikasu,1,1,0,0,10
55985,pamussitāsannissitamiti,pamussitasannissitamiti,1,1,0,0,23
55986,adassitattā,adassitatta,18,16,2,0,11
55987,avācakassa,avacakassa,1,1,0,0,10
55988,pamussitāya,pamussitaya,1,1,0,0,11
55989,antogadhakaraṇaṃ,antogadhakaranam,1,1,0,0,16
55990,asiddhena,asiddhena,2,2,0,0,9
55991,asiddhasādhananti,asiddhasadhananti,1,1,0,0,17
55992,nayidamevaṃ,nayidamevam,53,53,0,0,11
55993,kiliṭṭhapadadosaparihāre,kilitthapadadosaparihare,1,1,0,0,24
55994,niddiṭṭhasoḷasapaheḷikāyopi,nidditthasolasapahelikayopi,1,1,0,0,27
55995,dassitāti,dassitati,147,139,8,0,9
55996,siddhena,siddhena,24,24,0,0,8
55997,asiddhasādhanaṃ,asiddhasadhanam,1,1,0,0,15
55998,gehañca,gehanca,10,10,0,0,7
55999,latāpariyāya,latapariyaya,1,1,0,0,12
56000,karacaraṇādharā,karacaranadhara,1,1,0,0,15
56001,nakhadantakantiyo,nakhadantakantiyo,1,1,0,0,17
56002,vākyatthadosepi,vakyatthadosepi,1,1,0,0,15
56003,pabujjhanādikaṃ,pabujjhanadikam,1,1,0,0,15
56004,virodhipadeyeva,virodhipadeyeva,1,1,0,0,15
56005,pariccattattāti,pariccattattati,1,1,0,0,15
56006,vākyatthadosatte,vakyatthadosatte,1,1,0,0,16
56007,bandhapharusassa,bandhapharusassa,1,1,0,0,16
56008,virodhino,virodhino,9,9,0,0,9
56009,padadosatte,padadosatte,1,1,0,0,11
56010,ādipadaṃ,adipadam,10,10,0,0,8
56011,jigucchādittayapakāsakā,jigucchadittayapakasaka,1,1,0,0,23
56012,dipadaṃ,dipadam,2,2,0,0,7
56013,kaṭṭhapadaṃ,katthapadam,1,1,0,0,11
56014,phullatādi,phullatadi,1,1,0,0,10
56015,dunniddatādi,dunniddatadi,1,1,0,0,12
56016,vākyatthañceti,vakyatthanceti,1,1,0,0,14
56017,bhinnajātikesu,bhinnajatikesu,2,2,0,0,14
56018,ocityādīsu,ocityadisu,1,1,0,0,10
56019,duṭṭhatte,dutthatte,1,1,0,0,9
56020,vākyavākyatthānamaduṭṭhatā,vakyavakyatthanamadutthata,1,1,0,0,26
56021,padadosena,padadosena,1,1,0,0,10
56022,sandhivākyavākyatthadosānamanaññattaṃ,sandhivakyavakyatthadosanamanannattam,1,1,0,0,37
56023,ñāpanatthaṃ,napanattham,67,66,1,0,11
56024,padadosādikaṃ,padadosadikam,1,1,0,0,13
56025,vākyatthadosādīsu,vakyatthadosadisu,1,1,0,0,17
56026,imināyeva,iminayeva,18,17,1,0,9
56027,viruddhatthantarādipadehi,viruddhatthantaradipadehi,1,1,0,0,25
56028,vicaritaṃ,vicaritam,5,5,0,0,9
56029,dassitānīti,dassitaniti,20,17,3,0,11
56030,imissāyeva,imissayeva,34,33,1,0,10
56031,parampī,parampi,1,1,0,0,7
56032,saddenaasādhusandiddhapariyāyañeyyāppatītatthaappayojaka,saddenaasadhusandiddhapariyayaneyyappatitatthaappayojaka,1,1,0,0,56
56033,dubbodhadesiyādipadadose,dubbodhadesiyadipadadose,1,1,0,0,24
56034,adhikaūnabhaggacchandādivākyadose,adhikaunabhaggacchandadivakyadose,1,1,0,0,33
56035,upakkamopasaṃhāravisamasaṅkhāte,upakkamopasamharavisamasankhate,1,1,0,0,31
56036,pariggaṇhāti,parigganhati,135,131,4,0,12
56037,kriyānipphattikāraṇamupādāya,kriyanipphattikaranamupadaya,1,1,0,0,28
56038,pavattanāmaṃ,pavattanamam,1,1,0,0,12
56039,visesanatthena,visesanatthena,2,2,0,0,14
56040,saññābhājane,sannabhajane,1,1,0,0,12
56041,ravimhi,ravimhi,2,2,0,0,7
56042,himahā,himaha,2,2,0,0,6
56043,pariyāyanāmena,pariyayanamena,1,1,0,0,14
56044,kappitapadaṃ,kappitapadam,1,1,0,0,12
56045,vaḷavāmukhassa,valavamukhassa,1,1,0,0,14
56046,assavanitānanaṃ,assavanitananam,1,1,0,0,15
56047,atisayā,atisaya,2,2,0,0,7
56048,bhāvitatthena,bhavitatthena,1,1,0,0,13
56049,guṇavācakaṃ,gunavacakam,1,1,0,0,11
56050,adhigatattānupayogipadaṃ,adhigatattanupayogipadam,1,1,0,0,24
56051,appasiddhavacanaṃ,appasiddhavacanam,1,1,0,0,17
56052,dubbodhaṃ,dubbodham,1,0,1,0,9
56053,tavapāde,tavapade,1,1,0,0,8
56054,manoharasaddasamannāgatā,manoharasaddasamannagata,1,1,0,0,24
56055,deseyeva,deseyeva,1,1,0,0,8
56056,siddhanāmaṃ,siddhanamam,3,3,0,0,11
56057,kapolā,kapola,1,1,0,0,6
56058,manuññatallā,manunnatalla,1,1,0,0,12
56059,jalāsayavisesā,jalasayavisesa,1,1,0,0,14
56060,pakāsitamatthamupādāya,pakasitamatthamupadaya,1,1,0,0,22
56061,rājinda,rajinda,2,2,0,0,7
56062,ripūnaṃ,ripunam,1,1,0,0,7
56063,saggasevinaṃ,saggasevinam,2,2,0,0,12
56064,imināyevathīnaṃ,iminayevathinam,1,1,0,0,15
56065,vidhavattaṃ,vidhavattam,1,1,0,0,11
56066,gamyamānaṃ,gamyamanam,1,1,0,0,10
56067,tappakāsanatthaṃ,tappakasanattham,2,2,0,0,16
56068,vattabbayuttato,vattabbayuttato,1,1,0,0,15
56069,avuttattā,avuttatta,160,159,1,0,9
56070,chandohānisaṃyuttaṃ,chandohanisamyuttam,1,1,0,0,19
56071,akkharagaṇanato,akkharagananato,1,1,0,0,15
56072,ūnādhikavasena,unadhikavasena,1,1,0,0,14
56073,ādyantato,adyantato,1,1,0,0,9
56074,āraddhakkamaṃ,araddhakkamam,1,1,0,0,13
56075,kamantarena,kamantarena,1,1,0,0,11
56076,niyamanti,niyamanti,5,5,0,0,9
56077,subodhālaṅkāranissaye,subodhalankaranissaye,5,5,0,0,21
56078,dosaparihārāvabodhaparicchedavaṇṇanā,dosapariharavabodhaparicchedavannana,1,1,0,0,36
56079,dosasaṅkhyamatikkamma,dosasankhyamatikkamma,1,0,1,0,21
56080,vuttavirodhānamavirodho,vuttavirodhanamavirodho,1,0,1,0,23
56081,para68-69,para68-69,5,5,0,0,9
56082,dosavibhāgaṃ,dosavibhagam,2,2,0,0,12
56083,paricchijja,paricchijja,101,99,2,0,11
56084,yathāvuttadosaparihārakkamamupadisitumāha,yathavuttadosapariharakkamamupadisitumaha,1,1,0,0,41
56085,kadācī,kadaci,18,11,7,0,6
56086,sakalopi,sakalopi,62,59,3,0,8
56087,viruddhatthantarādikato,viruddhatthantaradikato,1,1,0,0,23
56088,dosesu,dosesu,16,16,0,0,6
56089,dosabhāvaṃ,dosabhavam,2,2,0,0,10
56090,padaviṃ,padavim,4,4,0,0,7
56091,guṇasabhāvataṃ,gunasabhavatam,1,1,0,0,14
56092,abbhupagacchati,abbhupagacchati,2,2,0,0,15
56093,payujjakassa,payujjakassa,1,1,0,0,12
56094,kosallā,kosalla,1,1,0,0,7
56095,tādisavisayapariggahalakkhaṇanepuññakāraṇā,tadisavisayapariggahalakkhananepunnakarana,1,1,0,0,42
56096,virodhānaṃ,virodhanam,1,1,0,0,10
56097,avirodho,avirodho,43,37,6,0,8
56098,niddosatā,niddosata,3,3,0,0,9
56099,dūrīkaraṇaṃ,durikaranam,2,2,0,0,11
56100,avabujjhati,avabujjhati,7,7,0,0,11
56101,tannāmiko,tannamiko,1,1,0,0,9
56102,ānīyate,aniyate,3,3,0,0,7
56103,yathāvuttadosānaṃ,yathavuttadosanam,3,3,0,0,17
56104,parihāratthamārabhanto,pariharatthamarabhanto,1,1,0,0,22
56105,padadosādiko,padadosadiko,1,1,0,0,12
56106,dosasaṅkhyaṃ,dosasankhyam,1,0,1,0,12
56107,byākaraṇābhidhānachandoalaṅkatiādīsu,byakaranabhidhanachandoalankatiadisu,1,1,0,0,36
56108,paricayalakkhaṇena,paricayalakkhanena,1,1,0,0,18
56109,paññāpāṭavena,pannapatavena,1,1,0,0,13
56110,guṇapadaviṃ,gunapadavim,1,1,0,0,11
56111,guṇasabhāvaṃ,gunasabhavam,1,1,0,0,12
56112,vuttavirodhānaṃ,vuttavirodhanam,1,0,1,0,15
56113,yathāvuttapadadosādivirodhānaṃ,yathavuttapadadosadivirodhanam,1,1,0,0,30
56114,aviruddhatā,aviruddhata,1,1,0,0,11
56115,yathāvuttapadadosādisambandhino,yathavuttapadadosadisambandhino,1,1,0,0,31
56116,pariharaṇakkamassa,pariharanakkamassa,1,1,0,0,18
56117,avabodhakāraṇattā,avabodhakaranatta,1,1,0,0,17
56118,tannāmikaparicchedo,tannamikaparicchedo,1,1,0,0,19
56119,laddhāvasare,laddhavasare,2,2,0,0,12
56120,yathāvuttadosā,yathavuttadosa,1,1,0,0,14
56121,kavisāmatthiyena,kavisamatthiyena,1,1,0,0,16
56122,niddosattaṃ,niddosattam,1,1,0,0,11
56123,sāmatthiyassa,samatthiyassa,8,8,0,0,13
56124,dassāmāti,dassamati,21,21,0,0,9
56125,padadosaparihāravaṇṇanā,padadosapariharavannana,2,2,0,0,23
56126,vindanta,vindanta,1,0,1,0,8
56127,pākena,pakena,24,22,2,0,6
56128,pariṇatabhāvena,parinatabhavena,1,1,0,0,15
56129,yuttānaṃ,yuttanam,27,25,2,0,8
56130,manuññānaṃ,manunnanam,2,2,0,0,10
56131,rattasāliādīnaṃ,rattasaliadinam,2,2,0,0,15
56132,sālijātīnaṃ,salijatinam,1,1,0,0,11
56133,somanassaṃ,somanassam,552,519,33,0,10
56134,sukhayeti,sukhayeti,2,2,0,0,9
56135,asukhappadānaṃ,asukhappadanam,1,1,0,0,14
56136,meghassānurūpanti,meghassanurupanti,1,1,0,0,17
56137,viruddhatthantaratā,viruddhatthantarata,1,1,0,0,19
56138,parihaṭā,parihata,1,1,0,0,8
56139,pariṇāmena,parinamena,4,4,0,0,10
56140,dassanahetu,dassanahetu,14,14,0,0,11
56141,cetasikasomanassaṃ,cetasikasomanassam,1,1,0,0,18
56142,anubhontaṃ,anubhontam,2,2,0,0,10
56143,kassakajanaṃ,kassakajanam,1,1,0,0,12
56144,sukhayateva,sukhayateva,1,1,0,0,11
56145,dukkhadānaṃ,dukkhadanam,1,1,0,0,11
56146,garaḷadāyakassa,garaladayakassa,1,1,0,0,15
56147,meghassāpi,meghassapi,1,1,0,0,10
56148,anurūpamiti,anurupamiti,1,1,0,0,11
56149,viruddhaññattho,viruddhannattho,1,1,0,0,15
56150,apanīto,apanito,28,28,0,0,7
56151,sālinoti,salinoti,4,1,3,0,8
56152,vināyakopi,vinayakopi,4,0,4,0,10
56153,nāgosi,nagosi,5,3,2,0,6
56154,gotamopi,gotamopi,7,4,3,0,8
56155,paṇītopi,panitopi,3,0,3,0,8
56156,rasāpeto,rasapeto,4,0,4,0,8
56157,vīnaṃ,vinam,8,7,1,0,5
56158,vinetīti,vinetiti,60,55,5,0,8
56159,pannagosīti,pannagositi,1,1,0,0,11
56160,tvaviruddhaṃ,tvaviruddham,2,2,0,0,12
56161,āgussa,agussa,3,3,0,0,6
56162,rāgādino,ragadino,1,1,0,0,8
56163,hīnapasu,hinapasu,2,2,0,0,8
56164,gotamavaṃsāvatiṇṇattā,gotamavamsavatinnatta,1,1,0,0,21
56165,accantahīnapasuno,accantahinapasuno,1,1,0,0,17
56166,mahatiyā,mahatiya,255,244,11,0,8
56167,byāghāto,byaghato,1,1,0,0,8
56168,madhurarasato,madhurarasato,2,2,0,0,13
56169,apagatosīti,apagatositi,1,1,0,0,11
56170,siṅgārādīhi,singaradihi,1,1,0,0,11
56171,apetoti,apetoti,8,8,0,0,7
56172,sāmīti,samiti,61,52,9,0,6
56173,abbhutāti,abbhutati,2,2,0,0,9
56174,virodhālaṅkāraṃ,virodhalankaram,2,2,0,0,15
56175,silāghanīyanti,silaghaniyanti,1,1,0,0,14
56176,parihaṭaṃ,parihatam,4,4,0,0,9
56177,uttadosassa,uttadosassa,1,1,0,0,11
56178,garuḷopi,garulopi,1,1,0,0,8
56179,vinento,vinento,16,16,0,0,7
56180,nikkileso,nikkileso,58,54,4,0,9
56181,pasutamopi,pasutamopi,1,1,0,0,10
56182,mahāpaññavāsi,mahapannavasi,2,2,0,0,13
56183,gottato,gottato,20,20,0,0,7
56184,gotamoyeva,gotamoyeva,2,2,0,0,10
56185,madhuropi,madhuropi,2,2,0,0,9
56186,apagatosi,apagatosi,2,2,0,0,9
56187,siṅgārādirasato,singaradirasato,1,1,0,0,15
56188,nāgattañca,nagattanca,1,1,0,0,10
56189,pasutamassa,pasutamassa,1,1,0,0,11
56190,paññavantattañca,pannavantattanca,1,1,0,0,16
56191,paṇītassa,panitassa,60,60,0,0,9
56192,nirasattañca,nirasattanca,1,1,0,0,12
56193,aññapakkhassa,annapakkhassa,1,1,0,0,13
56194,aviruddhattā,aviruddhatta,7,7,0,0,12
56195,viruddhatthantaradoso,viruddhatthantaradoso,1,1,0,0,21
56196,pasatthena,pasatthena,1,1,0,0,10
56197,viruddhālaṅkārena,viruddhalankarena,1,1,0,0,17
56198,nirākato,nirakato,8,8,0,0,8
56199,gunnamatisayena,gunnamatisayena,1,1,0,0,15
56200,padhānattaṃ,padhanattam,3,3,0,0,11
56201,nīto,nito,84,76,8,0,4
56202,rasato,rasato,10,10,0,0,6
56203,ajhatthassa,ajhatthassa,2,1,1,0,11
56204,tādīnaṃ,tadinam,7,6,1,0,7
56205,vuttamevatthantarena,vuttamevatthantarena,1,1,0,0,20
56206,tathāvidho,tathavidho,74,64,10,0,10
56207,adhikatthabhāvena,adhikatthabhavena,1,1,0,0,17
56208,obhāsitāsesadisattadoso,obhasitasesadisattadoso,1,1,0,0,23
56209,itiādivacobhaṅgiyā,itiadivacobhangiya,1,1,0,0,18
56210,parihaṭo,parihato,7,7,0,0,8
56211,guṇahīnajano,gunahinajano,1,1,0,0,12
56212,santosajananakāraṇānaṃ,santosajananakarananam,1,1,0,0,22
56213,sīlādiguṇānaṃ,siladigunanam,12,12,0,0,13
56214,avijjamānatte,avijjamanatte,2,2,0,0,13
56215,tosetiyeva,tosetiyeva,1,1,0,0,10
56216,sakaladisobhāsanasaṅkhātamadhikatthadoso,sakaladisobhasanasankhatamadhikatthadoso,1,1,0,0,40
56217,ccādivākyalīlāya,ccadivakyalilaya,1,1,0,0,16
56218,tādī,tadi,219,199,20,0,4
56219,kamāliṅgati,kamalingati,2,1,1,0,11
56220,kiliṭṭhapadadoso,kilitthapadadoso,1,1,0,0,16
56221,āruḷhā,arulha,38,37,1,0,6
56222,sahī,sahi,2,2,0,0,4
56223,āliṅgitaṃ,alingitam,2,0,2,0,9
56224,āliṅgati,alingati,3,1,2,0,8
56225,saṃyujjati,samyujjati,15,14,1,0,10
56226,parivitakke,parivitakke,9,9,0,0,11
56227,piyāti,piyati,29,11,18,0,6
56228,samāropena,samaropena,1,1,0,0,10
56229,paheḷike,pahelike,1,0,1,0,8
56230,kiliṭṭhapadadosasaṅkhātā,kilitthapadadosasankhata,1,1,0,0,24
56231,kimudāharaṇaṃ,kimudaharanam,1,1,0,0,13
56232,sukhāliṅgitaṃ,sukhalingitam,1,1,0,0,13
56233,nidassanatthattā,nidassanatthatta,1,1,0,0,16
56234,sesaudāharaṇānametamupalakkhaṇanti,sesaudaharananametamupalakkhananti,1,1,0,0,34
56235,evaṃpakārānamudāharaṇānamapariggahetabbattā,evampakaranamudaharananamapariggahetabbatta,1,1,0,0,43
56236,pakāratthoti,pakaratthoti,2,2,0,0,12
56237,upaguhitaṃ,upaguhitam,1,1,0,0,10
56238,kāyikamānasikaṃ,kayikamanasikam,2,2,0,0,15
56239,āliṅgatevāti,alingatevati,1,1,0,0,12
56240,paheḷikāyamāropanena,pahelikayamaropanena,1,1,0,0,20
56241,nirākataṃ,nirakatam,6,6,0,0,9
56242,sabbametaṃmayaṃ,sabbametammayam,1,0,1,0,15
56243,icchitayamakato,icchitayamakato,1,1,0,0,15
56244,visesajotako,visesajotako,5,5,0,0,12
56245,etaṃmayaṃ,etammayam,2,0,2,0,9
56246,kiliṭṭhapadena,kilitthapadena,1,1,0,0,14
56247,icchite,icchite,15,14,1,0,7
56248,iṭṭhayamake,itthayamake,1,1,0,0,11
56249,nappayujjeyya,nappayujjeyya,1,1,0,0,13
56250,iṭṭhayamakato,itthayamakato,1,1,0,0,13
56251,kiliṭṭhapadadosena,kilitthapadadosena,1,1,0,0,18
56252,iṭṭhayamakaṃ,itthayamakam,1,1,0,0,12
56253,etaṃmayanti,etammayanti,1,1,0,0,11
56254,sucirāvāsaklesaṃ,suciravasaklesam,2,0,2,0,16
56255,bodhisatte,bodhisatte,82,81,1,0,10
56256,māyādeviyā,mayadeviya,4,4,0,0,10
56257,vakkhamānassa,vakkhamanassa,35,35,0,0,13
56258,taduppannadine,taduppannadine,1,1,0,0,14
56259,pabhāvena,pabhavena,10,9,1,0,9
56260,puññappabhāvato,punnappabhavato,1,1,0,0,15
56261,jalajāni,jalajani,3,1,2,0,8
56262,ambujāni,ambujani,2,2,0,0,8
56263,acintanīyattā,acintaniyatta,2,2,0,0,13
56264,puññappabhāvassa,punnappabhavassa,2,2,0,0,16
56265,vāpyādīsu,vapyadisu,1,1,0,0,9
56266,karontāva,karontava,9,9,0,0,9
56267,sabbadāva,sabbadava,3,3,0,0,9
56268,āvasana,avasana,1,1,0,0,7
56269,māvāso,mavaso,2,1,1,0,6
56270,kleso,kleso,3,3,0,0,5
56271,nudantāniva,nudantaniva,1,0,1,0,11
56272,jahantāniveti,jahantaniveti,1,1,0,0,13
56273,īdisampi,idisampi,7,7,0,0,8
56274,acchariyamahosīti,acchariyamahositi,1,1,0,0,17
56275,desavirodho,desavirodho,1,1,0,0,11
56276,acinteyyānubhāvena,acinteyyanubhavena,2,2,0,0,18
56277,jalajasadisattā,jalajasadisatta,1,1,0,0,15
56278,tannāmakāni,tannamakani,1,1,0,0,11
56279,padumakeravādīni,padumakeravadini,1,1,0,0,16
56280,visayattena,visayattena,2,2,0,0,11
56281,aticiraṃ,aticiram,38,37,1,0,8
56282,nivāsato,nivasato,8,8,0,0,8
56283,jātaāyāsaṃ,jataayasam,1,1,0,0,10
56284,cajantāni,cajantani,1,1,0,0,9
56285,vāpiādīsu,vapiadisu,4,4,0,0,9
56286,jalajānaṃ,jalajanam,3,3,0,0,9
56287,thaluppattikathanasaṅkhātaṃ,thaluppattikathanasankhatam,1,1,0,0,27
56288,desavirodhaṃ,desavirodham,1,1,0,0,12
56289,acinteyyapuññappabhāvena,acinteyyapunnappabhavena,1,1,0,0,24
56290,īdisānaṃ,idisanam,8,8,0,0,8
56291,acchariyānaṃ,acchariyanam,7,4,3,0,12
56292,pātubhāvato,patubhavato,8,8,0,0,11
56293,nirākaroti,nirakaroti,8,8,0,0,10
56294,bodhiyaṃ,bodhiyam,18,18,0,0,8
56295,catumaggapaññāyaṃ,catumaggapannayam,1,1,0,0,17
56296,sattoti,sattoti,113,90,23,0,7
56297,pabhāvoti,pabhavoti,2,1,1,0,9
56298,āvāsoti,avasoti,13,3,10,0,7
56299,klesoti,klesoti,1,1,0,0,7
56300,mahānubhāvapisuno,mahanubhavapisuno,3,1,2,0,17
56301,mandamāruto,mandamaruto,2,0,2,0,11
56302,mudubhūto,mudubhuto,2,2,0,0,9
56303,sabbotukaṃ,sabbotukam,11,6,5,0,10
56304,utūsu,utusu,13,13,0,0,5
56305,pupphanakaṃ,pupphanakam,3,3,0,0,11
56306,vikiranto,vikiranto,9,9,0,0,9
56307,munisadisattā,munisadisatta,1,1,0,0,13
56308,bhavissantamunibhāvena,bhavissantamunibhavena,1,1,0,0,22
56309,muninoyeva,muninoyeva,1,1,0,0,10
56310,sammāsambodhisamadhigamasamaye,sammasambodhisamadhigamasamaye,2,2,0,0,30
56311,mahānubhāvassa,mahanubhavassa,20,20,0,0,14
56312,pavāyatīti,pavayatiti,4,1,3,0,10
56313,yadyapekadā,yadyapekada,1,1,0,0,11
56314,sabbotukāsambhavo,sabbotukasambhavo,1,1,0,0,17
56315,nānāutūsu,nanautusu,1,1,0,0,9
56316,nānākusumassa,nanakusumassa,1,1,0,0,13
56317,mahānubhāvapisunamīdisamekapadikaṃ,mahanubhavapisunamidisamekapadikam,1,1,0,0,34
56318,kālavirodho,kalavirodho,1,1,0,0,11
56319,mahānubhāve,mahanubhave,85,82,3,0,11
56320,acaṇḍasamīraṇo,acandasamirano,1,1,0,0,14
56321,vasantādīsu,vasantadisu,1,1,0,0,11
56322,sabbautūsu,sabbautusu,5,5,0,0,10
56323,vikasantaṃ,vikasantam,1,1,0,0,10
56324,pupphajātaṃ,pupphajatam,4,4,0,0,11
56325,kampento,kampento,18,18,0,0,8
56326,ekantabhāvittā,ekantabhavitta,1,1,0,0,14
56327,munisaṅkhātassa,munisankhatassa,1,1,0,0,15
56328,bhūtattā,bhutatta,15,14,1,0,8
56329,sabbaññuno,sabbannuno,40,40,0,0,10
56330,puññappabhāvaṃ,punnappabhavam,1,1,0,0,14
56331,sampavāyīti,sampavayiti,1,1,0,0,11
56332,nānākāle,nanakale,3,3,0,0,8
56333,sambhavantānampi,sambhavantanampi,1,1,0,0,16
56334,kusumānaṃ,kusumanam,7,7,0,0,9
56335,ekakāle,ekakale,10,10,0,0,7
56336,sambhavassa,sambhavassa,24,23,1,0,11
56337,kālavirodhattepi,kalavirodhattepi,1,1,0,0,16
56338,puññānubhāvo,punnanubhavo,2,2,0,0,12
56339,tādisamacchariyamekakkhaṇe,tadisamacchariyamekakkhane,1,1,0,0,26
56340,janetuṃ,janetum,71,71,0,0,7
56341,kālavirodhaṃ,kalavirodham,2,2,0,0,12
56342,mahānubhāvaṃ,mahanubhavam,43,43,0,0,12
56343,pisunoti,pisunoti,1,1,0,0,8
56344,nimuggamanaso,nimuggamanaso,4,2,2,0,13
56345,tantissaravirodho,tantissaravirodho,2,0,2,0,17
56346,nimuggi,nimuggi,2,0,2,0,7
56347,aparimāṇe,aparimane,13,13,0,0,9
56348,nimuggaṃ,nimuggam,21,21,0,0,8
56349,ogāḷhaṃ,ogalham,12,11,1,0,7
56350,gandhabbadevaputtassapi,gandhabbadevaputtassapi,1,1,0,0,23
56351,tantiyā,tantiya,82,80,2,0,7
56352,kiriyākālamānalakkhaṇavilambitadutamajjhabhedabhinno,kiriyakalamanalakkhanavilambitadutamajjhabhedabhinno,1,1,0,0,52
56353,chajjādiko,chajjadiko,1,1,0,0,10
56354,kalāsatthapariniddiṭṭhakamavesamaṃ,kalasatthaparinidditthakamavesamam,1,1,0,0,34
56355,pīṇetiyeva,pinetiyeva,1,1,0,0,10
56356,lokiyaguṇānubandhabuddhīnaṃ,lokiyagunanubandhabuddhinam,1,1,0,0,27
56357,vikkhepappavattipi,vikkhepappavattipi,1,1,0,0,18
56358,tathāvidhaṃ,tathavidham,64,59,5,0,11
56359,kalāvirodho,kalavirodho,1,1,0,0,11
56360,vimhayajanakasīlādiguṇasambhāre,vimhayajanakasiladigunasambhare,1,1,0,0,31
56361,otiṇṇacittassa,otinnacittassa,1,1,0,0,14
56362,gandhabbadevaputtassāpi,gandhabbadevaputtassapi,1,1,0,0,23
56363,ghaṭṭanakiriyā,ghattanakiriya,1,1,0,0,14
56364,addhamattikādikālo,addhamattikadikalo,1,1,0,0,18
56365,sannivesalakkhaṇo,sannivesalakkhano,1,1,0,0,17
56366,mānoti,manoti,38,17,21,0,6
56367,yuttassa,yuttassa,41,39,2,0,8
56368,mandasīghamajjhimappamāṇehi,mandasighamajjhimappamanehi,1,1,0,0,27
56369,chajjādisattasarassa,chajjadisattasarassa,1,1,0,0,20
56370,kalāsatthāgatakkamassa,kalasatthagatakkamassa,1,1,0,0,22
56371,vināsasaṅkhāto,vinasasankhato,1,1,0,0,14
56372,akantiyā,akantiya,1,1,0,0,8
56373,kalāsatthāgatakkamabhaṅgo,kalasatthagatakkamabhango,1,1,0,0,25
56374,lokuttarabuddhaguṇānugatabuddhiyā,lokuttarabuddhagunanugatabuddhiya,1,1,0,0,33
56375,kāraṇameveti,karanameveti,1,1,0,0,12
56376,nimuggo,nimuggo,73,69,4,0,7
56377,saroti,saroti,18,11,7,0,6
56378,virodhoti,virodhoti,24,21,3,0,9
56379,sambodhisattahadayo,sambodhisattahadayo,2,0,2,0,19
56380,padittaṅgārapūritaṃ,padittangarapuritam,3,1,2,0,19
56381,candanāya,candanaya,1,1,0,0,9
56382,kintaṃ,kintam,30,29,1,0,6
56383,sabbaññutaññāṇe,sabbannutannane,20,18,2,0,15
56384,paribaddhaṃ,paribaddham,1,1,0,0,11
56385,sabbaññutaññāṇānubandhabuddhino,sabbannutannananubandhabuddhino,1,1,0,0,31
56386,manobandhoti,manobandhoti,1,1,0,0,12
56387,lokavirodho,lokavirodho,1,1,0,0,11
56388,āsattacitto,asattacitto,1,1,0,0,11
56389,ādittaṅgārehi,adittangarehi,1,1,0,0,13
56390,cakkavāḷagabbhaṃ,cakkavalagabbham,9,9,0,0,16
56391,candanato,candanato,1,1,0,0,9
56392,atisītalaṃ,atisitalam,4,4,0,0,10
56393,cinteyyāti,cinteyyati,6,4,2,0,10
56394,iṭṭhatthaluddhassa,itthatthaluddhassa,1,1,0,0,18
56395,cittappavattiyā,cittappavattiya,17,17,0,0,15
56396,īdisattā,idisatta,1,1,0,0,8
56397,candanatopi,candanatopi,1,1,0,0,11
56398,adhikasītattakappanā,adhikasitattakappana,1,1,0,0,20
56399,pavattalokasīmāya,pavattalokasimaya,1,1,0,0,17
56400,sattahadayaṃ,sattahadayam,1,1,0,0,12
56401,padittāni,padittani,1,1,0,0,9
56402,aṅgārānīti,angaraniti,1,1,0,0,10
56403,pūritanti,puritanti,2,2,0,0,9
56404,pariccattabhavopi,pariccattabhavopi,3,0,3,0,17
56405,tvamupanītabhavo,tvamupanitabhavo,1,0,1,0,16
56406,pariccatte,pariccatte,7,5,2,0,10
56407,pariccatto,pariccatto,35,35,0,0,10
56408,sugatiduggatisaṅkhāto,sugatiduggatisankhato,1,1,0,0,21
56409,upanīto,upanito,23,23,0,0,7
56410,pavattito,pavattito,207,201,6,0,9
56411,upanītabhavo,upanitabhavo,2,0,2,0,12
56412,atthūti,atthuti,14,12,2,0,7
56413,ñāyaviruddhamevaṃvidhattā,nayaviruddhamevamvidhatta,1,1,0,0,25
56414,munipuṅgavassa,munipungavassa,4,4,0,0,14
56415,muniseṭṭha,munisettha,1,1,0,0,10
56416,apanītasugatiduggatibhavopi,apanitasugatiduggatibhavopi,1,1,0,0,27
56417,lokassānītaabhivuddhiko,lokassanitaabhivuddhiko,1,1,0,0,23
56418,bhavasi,bhavasi,36,36,0,0,7
56419,cintāvisayātikkantasāraguṇassa,cintavisayatikkantasaragunassa,1,1,0,0,30
56420,sabbākārato,sabbakarato,121,120,1,0,11
56421,pariccattattā,pariccattatta,22,19,3,0,13
56422,avijjamānaṃ,avijjamanam,76,68,8,0,11
56423,sugatibhavaṃ,sugatibhavam,2,2,0,0,12
56424,ñāyāgataṃ,nayagatam,9,9,0,0,9
56425,paṭibhāti,patibhati,129,123,6,0,9
56426,sabbaññūnaṃ,sabbannunam,3,3,0,0,11
56427,īdisāyevāti,idisayevati,1,1,0,0,11
56428,ñāyavirodho,nayavirodho,1,1,0,0,11
56429,acintyā,acintya,1,1,0,0,7
56430,guṇasārā,gunasara,1,1,0,0,8
56431,nevālapati,nevalapati,3,0,3,0,10
56432,phuseyyāpattidukkaṭaṃ,phuseyyapattidukkatam,1,0,1,0,21
56433,neve,neve,1,0,1,0,4
56434,vadatyeva,vadatyeva,1,1,0,0,9
56435,copanavācāsaṅkhātena,copanavacasankhatena,1,1,0,0,20
56436,vacīviññattihetunā,vacivinnattihetuna,1,1,0,0,18
56437,sampajānantassa,sampajanantassa,11,11,0,0,15
56438,musāvādato,musavadato,5,5,0,0,10
56439,āpattidukkaṭaṃ,apattidukkatam,2,0,2,0,14
56440,sampajānamusāvādassa,sampajanamusavadassa,13,11,2,0,20
56441,vuttadukkaṭāpatti,vuttadukkatapatti,1,1,0,0,17
56442,phuseyya,phuseyya,50,44,6,0,8
56443,anālapato,analapato,1,1,0,0,9
56444,vacīviññattiyā,vacivinnattiya,7,7,0,0,14
56445,musāvādoti,musavadoti,18,9,9,0,10
56446,abhidhammāpannavirodho,abhidhammapannavirodho,2,2,0,0,22
56447,aparavacanatthe,aparavacanatthe,1,1,0,0,15
56448,tvīdiso,tvidiso,1,1,0,0,7
56449,copanavācāsaṅkhātaviññattikāraṇā,copanavacasankhatavinnattikarana,1,1,0,0,32
56450,musābhaṇanato,musabhananato,1,1,0,0,13
56451,dukkaṭāpattiṃ,dukkatapattim,19,19,0,0,13
56452,āpajjeyyāti,apajjeyyati,159,133,26,0,11
56453,anālapantassa,analapantassa,1,1,0,0,13
56454,musāvādo,musavado,255,229,26,0,8
56455,āpattiṃ,apattim,2172,2103,69,0,7
56456,nāvikareyya,navikareyya,7,7,0,0,11
56457,sampajānamusāvāda,sampajanamusavada,1,1,0,0,17
56458,nidānuddese,nidanuddese,14,13,1,0,11
56459,niddiṭṭhavacīdvāre,nidditthavacidvare,1,1,0,0,18
56460,akiriyasamuṭṭhānā,akiriyasamutthana,13,12,1,0,17
56461,dukkaṭāpatti,dukkatapatti,50,47,3,0,12
56462,āgamavirodho,agamavirodho,4,4,0,0,12
56463,musābhaṇanaṃ,musabhananam,1,1,0,0,12
56464,āpatti,apatti,6876,6701,175,0,6
56465,avassamānameghato,avassamanameghato,1,1,0,0,17
56466,sañjātadubbhikkhaṃ,sanjatadubbhikkham,1,1,0,0,18
56467,meghakataṃ,meghakatam,1,1,0,0,10
56468,kathetabbakāle,kathetabbakale,1,1,0,0,14
56469,akathanato,akathanato,3,3,0,0,10
56470,vacīdvāre,vacidvare,93,88,5,0,9
56471,dukkaṭāpattipi,dukkatapattipi,1,1,0,0,14
56472,sañjātāti,sanjatati,4,4,0,0,9
56473,āpattiyeva,apattiyeva,147,143,4,0,10
56474,dukkaṭanti,dukkatanti,251,249,2,0,10
56475,marīcicandanālepalābhā,maricicandanalepalabha,3,1,2,0,22
56476,sitamarīcino,sitamaricino,1,1,0,0,12
56477,marīcī,marici,8,6,2,0,6
56478,marīciyo,mariciyo,3,2,1,0,8
56479,dīdhitiyo,didhitiyo,2,1,1,0,9
56480,ālepo,alepo,1,0,1,0,5
56481,upadeho,upadeho,1,1,0,0,7
56482,lābhena,labhena,136,124,12,0,7
56483,nibbhara,nibbhara,2,0,2,0,8
56484,matisayaṃ,matisayam,3,3,0,0,9
56485,rocantīti,rocantiti,2,2,0,0,9
56486,natthettha,natthettha,87,85,2,0,10
56487,marīciyā,mariciya,10,10,0,0,8
56488,saddopāttatthāya,saddopattatthaya,1,1,0,0,16
56489,marīcisaṅkhātacandanālepassa,maricisankhatacandanalepassa,1,1,0,0,28
56490,paṭilābhato,patilabhato,18,16,2,0,11
56491,dhavalakāraṇassa,dhavalakaranassa,1,1,0,0,16
56492,candanamiva,candanamiva,2,2,0,0,11
56493,marīciyoyeva,mariciyoyeva,1,1,0,0,12
56494,candanamiti,candanamiti,1,1,0,0,11
56495,ālepoti,alepoti,1,1,0,0,7
56496,lābhoti,labhoti,33,11,22,0,7
56497,māraṅganāsiṅgāravibbhamo,maranganasingaravibbhamo,2,0,2,0,24
56498,hadayānalo,hadayanalo,4,1,3,0,10
56499,passantānamanussarantānañca,passantanamanussarantananca,1,1,0,0,27
56500,anurañjetīti,anuranjetiti,2,2,0,0,12
56501,māraṅganānaṃ,marangananam,5,5,0,0,12
56502,siṅgārakato,singarakato,1,1,0,0,11
56503,asamanuññāto,asamanunnato,2,0,2,0,12
56504,abbhupagato,abbhupagato,2,2,0,0,11
56505,vasavattino,vasavattino,31,27,4,0,11
56506,hadayaggi,hadayaggi,2,2,0,0,9
56507,analatthe,analatthe,1,1,0,0,9
56508,niruppito,niruppito,1,1,0,0,9
56509,tādisatthānativattanato,tadisatthanativattanato,1,1,0,0,23
56510,kāraṇantupacārenāti,karanantupacarenati,1,1,0,0,19
56511,māraṅganāparājayo,maranganaparajayo,2,2,0,0,17
56512,saddopāttattho,saddopattattho,1,1,0,0,14
56513,siṅgāravibbhamo,singaravibbhamo,2,2,0,0,15
56514,hadayaggī,hadayaggi,1,1,0,0,9
56515,tathāvidhassa,tathavidhassa,38,35,3,0,13
56516,mārasokassa,marasokassa,1,1,0,0,11
56517,māraṅganāparājayābyabhicārato,maranganaparajayabyabhicarato,1,1,0,0,29
56518,nevedisassa,nevedisassa,1,1,0,0,11
56519,vaṅkavuttīdisī,vankavuttidisi,1,1,0,0,14
56520,guṇoyeva,gunoyeva,1,1,0,0,8
56521,ñāyopāttattā,nayopattatta,1,1,0,0,12
56522,neyyadosaparihāratthamudāharati,neyyadosapariharatthamudaharati,1,1,0,0,31
56523,dassanasavanānussaraṇaṃ,dassanasavananussaranam,1,1,0,0,23
56524,karontānaṃ,karontanam,145,138,7,0,10
56525,cittamattani,cittamattani,1,1,0,0,12
56526,anurañjanto,anuranjanto,4,4,0,0,11
56527,māravadhūnaṃ,maravadhunam,1,1,0,0,12
56528,ratikīḷāhetubhūtakāmapatthanāsaṅkhātasiṅgārena,ratikilahetubhutakamapatthanasankhatasingarena,1,1,0,0,46
56529,katalīlā,katalila,1,1,0,0,8
56530,jitapañcamārena,jitapancamarena,1,1,0,0,15
56531,satthunā,satthuna,67,58,9,0,8
56532,anabbhupagato,anabbhupagato,1,1,0,0,13
56533,asampaṭicchito,asampaticchito,3,3,0,0,14
56534,analattena,analattena,1,1,0,0,10
56535,kappitakāriyabhūto,kappitakariyabhuto,1,1,0,0,18
56536,māraṅganāsiṅgāravibbhamasaṅkhātakāraṇena,maranganasingaravibbhamasankhatakaranena,1,1,0,0,40
56537,abhedakappanāya,abhedakappanaya,2,2,0,0,15
56538,analattakappanāya,analattakappanaya,1,1,0,0,17
56539,semhaṃ,semham,76,68,8,0,6
56540,tipusaṃ,tipusam,5,5,0,0,7
56541,tulyādhikaraṇabhāvena,tulyadhikaranabhavena,2,2,0,0,21
56542,parājayavācako,parajayavacako,1,1,0,0,14
56543,māraṅganāparājayaṃ,maranganaparajayam,1,1,0,0,18
56544,tādisasokuppattikāraṇassa,tadisasokuppattikaranassa,1,1,0,0,25
56545,anadhigatattā,anadhigatatta,58,57,1,0,13
56546,aññathānupapattilakkhaṇasāmatthiyena,annathanupapattilakkhanasamatthiyena,1,1,0,0,36
56547,īdisavaṅkavuttiyā,idisavankavuttiya,1,1,0,0,17
56548,bandhaguṇattā,bandhagunatta,1,1,0,0,13
56549,siṅgāroti,singaroti,1,1,0,0,9
56550,vibbhamoti,vibbhamoti,2,2,0,0,10
56551,apayātāparādhampi,apayataparadhampi,3,1,2,0,17
56552,apayāte,apayate,2,1,1,0,7
56553,apayāto,apayato,2,2,0,0,7
56554,kodhena,kodhena,84,80,4,0,7
56555,pāṭalabhūtena,patalabhutena,1,1,0,0,13
56556,setarattena,setarattena,1,1,0,0,11
56557,visesanāpekkhadoso,visesanapekkhadoso,2,2,0,0,18
56558,apayāti,apayati,3,2,1,0,7
56559,apagatāparādhampi,apagataparadhampi,1,1,0,0,17
56560,bhūtasetalohitavaṇṇayuttena,bhutasetalohitavannayuttena,1,1,0,0,27
56561,vijjamānattepi,vijjamanattepi,5,5,0,0,14
56562,visesyavacanaṃ,visesyavacanam,1,1,0,0,14
56563,kodhapāṭalabhūtenā,kodhapatalabhutena,1,1,0,0,18
56564,visesanassa,visesanassa,48,48,0,0,11
56565,nirākatoti,nirakatoti,3,3,0,0,10
56566,pāṭalabhūtanti,patalabhutanti,1,1,0,0,14
56567,nippabhatānīta,nippabhatanita,1,0,1,0,14
56568,appakāna,appakana,1,0,1,0,8
56569,paṇḍitaposo,panditaposo,1,1,0,0,11
56570,appakānaṃ,appakanam,5,5,0,0,9
56571,pāpānampi,papanampi,1,1,0,0,9
56572,kimutamadhikānaṃ,kimutamadhikanam,1,1,0,0,16
56573,ānubhāvaṃ,anubhavam,112,106,6,0,9
56574,appavattiṃ,appavattim,57,49,8,0,10
56575,pāpeyya,papeyya,6,6,0,0,7
56576,atthantaranyāsena,atthantaranyasena,1,1,0,0,17
56577,nippabhataṃ,nippabhatam,2,2,0,0,11
56578,jotiriṅgaṇampi,jotiringanampi,1,1,0,0,14
56579,nopekkhati,nopekkhati,1,1,0,0,10
56580,cakkavāḷakuharānucaritamahānubhāvopīti,cakkavalakuharanucaritamahanubhavopiti,1,1,0,0,38
56581,apī,api,11,8,3,0,3
56582,vacobhaṅgiyā,vacobhangiya,1,1,0,0,12
56583,hīnatthadoso,hinatthadoso,1,1,0,0,12
56584,appakāni,appakani,2,1,1,0,8
56585,atimandānampi,atimandanampi,1,1,0,0,13
56586,vipākadānasāmatthiyasaṅkhātānubhāvaṃ,vipakadanasamatthiyasankhatanubhavam,1,1,0,0,36
56587,ahosikammatāpādanena,ahosikammatapadanena,1,1,0,0,20
56588,nāseyya,naseyya,14,14,0,0,7
56589,vattabbameva,vattabbameva,302,293,9,0,12
56590,tamatthamatthantaranyāsālaṅkārena,tamatthamatthantaranyasalankarena,1,1,0,0,33
56591,nippabhatānītakhajjoto,nippabhatanitakhajjoto,2,1,1,0,22
56592,nippabhatamāpāditajotiriṅgaṇehi,nippabhatamapaditajotiringanehi,1,1,0,0,31
56593,samannāgatopi,samannagatopi,6,4,2,0,13
56594,hīnapabhāvo,hinapabhavo,1,1,0,0,11
56595,khajjopanake,khajjopanake,2,2,0,0,12
56596,nippabhati,nippabhati,1,0,1,0,10
56597,ccādivacanavilāsavasena,ccadivacanavilasavasena,1,1,0,0,23
56598,hīnapakkhaṃ,hinapakkham,1,1,0,0,11
56599,gahetvāpi,gahetvapi,52,52,0,0,9
56600,sūriyaudārattasseva,suriyaudarattasseva,1,1,0,0,19
56601,positattā,positatta,3,3,0,0,9
56602,hīnatthadosaṃ,hinatthadosam,1,1,0,0,13
56603,ānītā,anita,72,72,0,0,5
56604,iccādo,iccado,10,10,0,0,6
56605,pādapūraṇassa,padapuranassa,1,1,0,0,13
56606,anatthābhāvo,anatthabhavo,1,1,0,0,12
56607,pādi,padi,8,7,1,0,4
56608,pūraṇasaṅkhātapayojanatthāya,puranasankhatapayojanatthaya,1,1,0,0,28
56609,nāmādikaṃ,namadikam,4,4,0,0,9
56610,niratthakapadāyojane,niratthakapadayojane,1,1,0,0,20
56611,udāharaṇamevaṃ,udaharanamevam,3,3,0,0,14
56612,duṭṭhodāharaṇe,dutthodaharane,1,1,0,0,14
56613,pādapūraṇatthaṃ,padapuranattham,1,1,0,0,15
56614,ayojitattā,ayojitatta,1,1,0,0,10
56615,sātthakapadehi,satthakapadehi,1,1,0,0,14
56616,niratthakadoso,niratthakadoso,1,1,0,0,14
56617,mudunimmalasobhādisādhāraṇaguṇayogato,mudunimmalasobhadisadharanagunayogato,1,1,0,0,37
56618,paṅkeruhasadisaṃ,pankeruhasadisam,1,1,0,0,16
56619,pādameva,padameva,1,1,0,0,8
56620,paṅkeruhanti,pankeruhanti,1,1,0,0,12
56621,visesanavisesyapadadosaparihāro,visesanavisesyapadadosapariharo,1,1,0,0,31
56622,pasaṃsā,pasamsa,75,72,3,0,7
56623,turitādino,turitadino,1,1,0,0,10
56624,icchīyate,icchiyate,2,2,0,0,9
56625,bhayādivisese,bhayadivisese,2,2,0,0,13
56626,ekatthatāya,ekatthataya,5,5,0,0,11
56627,ekatthabhāvena,ekatthabhavena,2,2,0,0,14
56628,vākyadosaparihāratthamārabhati,vakyadosapariharatthamarabhati,1,1,0,0,30
56629,bhayakodhe,bhayakodhe,1,0,1,0,10
56630,cittutrāsapaṭighathutiādīhi,cittutrasapatighathutiadihi,1,1,0,0,27
56631,bhayakodhādike,bhayakodhadike,1,1,0,0,14
56632,ekatthatākato,ekatthatakato,1,0,1,0,13
56633,pubbuccāritapadassa,pubbuccaritapadassa,1,1,0,0,19
56634,punuccāraṇe,punuccarane,1,1,0,0,11
56635,ekatthadoso,ekatthadoso,1,1,0,0,11
56636,bhayañca,bhayanca,40,35,5,0,8
56637,turitakotūhalaaccharāhāsasokapasādasaṅkhātassa,turitakotuhalaaccharahasasokapasadasankhatassa,1,1,0,0,46
56638,atthavisesasseti,atthavisesasseti,1,1,0,0,16
56639,tagguṇasaṃviññāṇaaññapadatthasamāsattā,taggunasamvinnanaannapadatthasamasatta,2,2,0,0,38
56640,bhayādīsu,bhayadisu,3,3,0,0,9
56641,kathitamapi,kathitamapi,1,1,0,0,11
56642,kathanamavirodhaṃ,kathanamavirodham,1,1,0,0,17
56643,padādīnaṃ,padadinam,31,30,1,0,9
56644,ekatthā,ekattha,100,97,3,0,7
56645,ekatthatā,ekatthata,10,10,0,0,9
56646,tamupasappasi,tamupasappasi,1,0,1,0,13
56647,bhayenāmeḍitaṃ,bhayenameditam,1,1,0,0,14
56648,handāti,handati,37,2,35,0,7
56649,bhavanto,bhavanto,284,275,9,0,8
56650,gatamaggābhimukho,gatamaggabhimukho,1,1,0,0,17
56651,āvattatu,avattatu,2,2,0,0,8
56652,ekatthatādoso,ekatthatadoso,2,2,0,0,13
56653,bhayenāmeḍitappayogato,bhayenameditappayogato,1,1,0,0,22
56654,ṭhānato,thanato,121,117,4,0,7
56655,kathamupasappasi,kathamupasappasi,1,0,1,0,16
56656,kathamupagacchasīti,kathamupagacchasiti,1,1,0,0,19
56657,āmeḍitavacanattā,ameditavacanatta,1,1,0,0,16
56658,jīvitukāmosīti,jivitukamositi,2,2,0,0,14
56659,vākyadosaparihāravaṇṇanā,vakyadosapariharavannana,2,2,0,0,24
56660,rūpātisayo,rupatisayo,2,0,2,0,10
56661,vilāsātisayo,vilasatisayo,2,0,2,0,12
56662,buddhamahodayo,buddhamahodayo,2,0,2,0,14
56663,anubyañjanehi,anubyanjanehi,15,15,0,0,13
56664,anubyañjitabāttiṃsavarapurisalakkhaṇopasobhitassa,anubyanjitabattimsavarapurisalakkhanopasobhitassa,1,1,0,0,49
56665,byāmappabhāketumālāvirājitassa,byamappabhaketumalavirajitassa,1,1,0,0,30
56666,ādhikkaṃ,adhikkam,4,4,0,0,8
56667,vācāgocarabhāvātikkamena,vacagocarabhavatikkamena,1,1,0,0,24
56668,avacanīyattā,avacaniyatta,8,7,1,0,12
56669,kociyeva,kociyeva,4,4,0,0,8
56670,anekalokassa,anekalokassa,1,1,0,0,12
56671,cittamavaharantī,cittamavaharanti,1,1,0,0,16
56672,avacanapathā,avacanapatha,1,1,0,0,12
56673,vilāsassa,vilasassa,1,0,1,0,9
56674,gatyādino,gatyadino,1,1,0,0,9
56675,vacanapathātikkanto,vacanapathatikkanto,1,1,0,0,19
56676,abhivuḍḍhi,abhivuddhi,1,1,0,0,10
56677,abbhutoti,abbhutoti,4,1,3,0,9
56678,kiṃsaddenāraddhā,kimsaddenaraddha,1,1,0,0,16
56679,suppahiṭṭhitapādatādidvattiṃsapurisalakkhaṇehi,suppahitthitapadatadidvattimsapurisalakkhanehi,1,1,0,0,46
56680,sobhitassa,sobhitassa,22,20,2,0,10
56681,cittaṅgulitādiasītianubyañjanehi,cittangulitadiasitianubyanjanehi,1,1,0,0,32
56682,alaṅkatassa,alankatassa,1,1,0,0,11
56683,byāmappabhāketumālāhi,byamappabhaketumalahi,1,1,0,0,21
56684,ujjalassa,ujjalassa,1,1,0,0,9
56685,ādhikyaṃ,adhikyam,2,2,0,0,8
56686,manogocarabhāvaṃ,manogocarabhavam,1,1,0,0,16
56687,harantī,haranti,15,15,0,0,7
56688,vacīvisayātikkantattā,vacivisayatikkantatta,1,1,0,0,21
56689,visayabhūtapiyabhāvasaṅkhātassa,visayabhutapiyabhavasankhatassa,1,1,0,0,31
56690,gamanādivilāsassa,gamanadivilasassa,1,1,0,0,17
56691,ādhikyampi,adhikyampi,1,1,0,0,10
56692,vuttakāraṇenevakopiyeva,vuttakaranenevakopiyeva,1,1,0,0,23
56693,mahābhivuddhisaṅkhāto,mahabhivuddhisankhato,1,1,0,0,21
56694,acchariyoti,acchariyoti,5,3,2,0,11
56695,sabbanāmikena,sabbanamikena,1,1,0,0,13
56696,vattumāraddhakkamo,vattumaraddhakkamo,1,1,0,0,18
56697,bhinnoti,bhinnoti,21,11,10,0,8
56698,bhaggarītidoso,bhaggaritidoso,1,1,0,0,14
56699,adūrapadavinyāsaṃ,adurapadavinyasam,2,0,2,0,17
56700,abyāmoha,abyamoha,1,0,1,0,8
56701,dūramesanti,duramesanti,1,1,0,0,11
56702,adūrāni,adurani,1,1,0,0,7
56703,tāniyeva,taniyeva,129,121,8,0,8
56704,abyākiṇṇo,abyakinno,3,2,1,0,9
56705,asammisso,asammisso,16,16,0,0,9
56706,abyākiṇṇatāya,abyakinnataya,1,1,0,0,13
56707,byāmohaṃ,byamoham,2,2,0,0,8
56708,abyāmohakaro,abyamohakaro,2,1,1,0,12
56709,pasādālaṅkārālaṅkitaṃ,pasadalankaralankitam,1,1,0,0,21
56710,issarā,issara,128,119,9,0,6
56711,padhānā,padhana,38,37,1,0,7
56712,kaniṭṭhaṅguligaṇanāniṭṭhā,kanitthanguliganananittha,1,1,0,0,25
56713,thuvanti,thuvanti,1,1,0,0,8
56714,tādisabandhaguṇassātisayapasaṃsārahabhāvena,tadisabandhagunassatisayapasamsarahabhavena,1,1,0,0,43
56715,abyāmohe,abyamohe,1,0,1,0,8
56716,nāmādipadānaṃ,namadipadanam,1,1,0,0,13
56717,vohārakāle,voharakale,1,1,0,0,10
56718,adūrasambandho,adurasambandho,1,1,0,0,14
56719,paṭipāṭiyā,patipatiya,567,554,13,0,10
56720,padaṭṭhapanena,padatthapanena,1,1,0,0,14
56721,aññasambandhīpadehi,annasambandhipadehi,1,1,0,0,19
56722,cittamārādhentaṃ,cittamaradhentam,1,1,0,0,16
56723,saṃsayamanuppādentaṃ,samsayamanuppadentam,1,1,0,0,20
56724,pasādālaṅkārasaṃyuttaṃ,pasadalankarasamyuttam,1,1,0,0,22
56725,paṇḍibhajanā,pandibhajana,1,1,0,0,12
56726,kaniṭṭhaṅguliyā,kanitthanguliya,2,2,0,0,15
56727,gaṇitabbā,ganitabba,1,1,0,0,9
56728,aggakavinoti,aggakavinoti,1,1,0,0,12
56729,thomenti,thomenti,27,26,1,0,8
56730,ākiṇṇo,akinno,54,52,2,0,6
56731,byākiṇṇo,byakinno,2,2,0,0,8
56732,bandhassāti,bandhassati,1,1,0,0,11
56733,nīluppalābhaṃ,niluppalabham,5,2,3,0,13
56734,hemaṅkuso,hemankuso,3,0,3,0,9
56735,jinoyaṃ,jinoyam,1,0,1,0,7
56736,nīluppalābha,niluppalabha,1,0,1,0,12
56737,indīvaradvayanibhaṃ,indivaradvayanibham,1,1,0,0,19
56738,adharoṭṭho,adharottho,2,2,0,0,10
56739,bandhukamiva,bandhukamiva,2,1,1,0,12
56740,bandhukakusumamiva,bandhukakusumamiva,1,1,0,0,18
56741,suvaṇṇaṅkusoyeva,suvannankusoyeva,2,2,0,0,16
56742,dassanamassāti,dassanamassati,1,1,0,0,14
56743,byākiṇṇadoso,byakinnadoso,2,2,0,0,12
56744,pasādoyevāti,pasadoyevati,2,2,0,0,12
56745,byākiṇṇadosaparihāraṃ,byakinnadosapariharam,1,1,0,0,21
56746,nīluppali,niluppali,1,0,1,0,9
56747,nettayugaḷaṃ,nettayugalam,2,2,0,0,12
56748,nīluppaladalasadisaṃ,niluppaladalasadisam,1,1,0,0,20
56749,bandhukapupphamiva,bandhukapupphamiva,1,1,0,0,18
56750,manuññadassano,manunnadassano,3,3,0,0,14
56751,pasādālaṅkārena,pasadalankarena,1,1,0,0,15
56752,nibhā,nibha,9,7,2,0,5
56753,ivattho,ivattho,1,1,0,0,7
56754,ruciroti,ruciroti,1,1,0,0,8
56755,dassanassa,dassanassa,41,40,1,0,10
56756,kattubhūtasādhujanasambandhattepi,kattubhutasadhujanasambandhattepi,1,1,0,0,33
56757,visayatteneva,visayatteneva,1,1,0,0,13
56758,jinasambandho,jinasambandho,1,1,0,0,13
56759,aññapadatthena,annapadatthena,3,3,0,0,14
56760,gahitoti,gahitoti,231,225,6,0,8
56761,samatikkantagāmmattakantavācābhisaṅkhataṃ,samatikkantagammattakantavacabhisankhatam,2,0,2,0,41
56762,samatikkanti,samatikkanti,1,0,1,0,12
56763,gāmmassa,gammassa,1,1,0,0,8
56764,kantānaṃ,kantanam,25,21,4,0,8
56765,madhurānaṃ,madhuranam,1,1,0,0,10
56766,abhisaṅkhataṃ,abhisankhatam,106,86,20,0,13
56767,rasassa,rasassa,35,32,3,0,7
56768,mādhuriyassa,madhuriyassa,2,2,0,0,12
56769,kāraṇabhāvena,karanabhavena,87,86,1,0,13
56770,atikkamati,atikkamati,120,118,2,0,10
56771,atikkantagāmmabhāvāhi,atikkantagammabhavahi,1,1,0,0,21
56772,kantavācāhi,kantavacahi,2,2,0,0,11
56773,muttakādibandhanaṃ,muttakadibandhanam,1,1,0,0,18
56774,pītirasassa,pitirasassa,1,1,0,0,11
56775,yathāvuttagāmmadosaṃ,yathavuttagammadosam,1,1,0,0,20
56776,tāhiyeva,tahiyeva,5,5,0,0,8
56777,abhisaṅkhatanti,abhisankhatanti,3,3,0,0,15
56778,byasanāpannaṃ,byasanapannam,2,0,2,0,13
56779,kimupekkhase,kimupekkhase,2,0,2,0,12
56780,kāmāturā,kamatura,1,1,0,0,8
56781,viravati,viravati,14,14,0,0,8
56782,pavattīti,pavattiti,103,94,9,0,9
56783,anunayavasena,anunayavasena,4,4,0,0,13
56784,sānunayāmantanañhi,sanunayamantananhi,1,1,0,0,18
56785,tatonuggahābhikaṅkhāyamaccantamucitaṃ,tatonuggahabhikankhayamaccantamucitam,1,1,0,0,37
56786,akaṇḍo,akando,1,1,0,0,6
56787,asayhopatāpāvahattā,asayhopatapavahatta,1,1,0,0,19
56788,caṇḍālattāropanañca,candalattaropananca,2,2,0,0,19
56789,ucitameva,ucitameva,2,2,0,0,9
56790,yatonena,yatonena,2,2,0,0,8
56791,kayiramānamasahanamupatāpamasahamānā,kayiramanamasahanamupatapamasahamana,1,1,0,0,36
56792,paribhavantaṃ,paribhavantam,2,2,0,0,13
56793,vippalapati,vippalapati,22,22,0,0,11
56794,nikkaruṇo,nikkaruno,5,5,0,0,9
56795,idamapi,idamapi,2,2,0,0,7
56796,ucitamupatāpe,ucitamupatape,1,1,0,0,13
56797,nikkaruṇānaṃ,nikkarunanam,1,1,0,0,12
56798,gatīti,gatiti,99,40,59,0,6
56799,adhikamupatāpeti,adhikamupatapeti,1,1,0,0,16
56800,niddayattā,niddayatta,1,1,0,0,10
56801,aññāsattataṃ,annasattatam,1,1,0,0,12
56802,nāññāsattosi,nannasattosi,1,1,0,0,12
56803,nāhamekākinī,nahamekakini,1,1,0,0,12
56804,asahāyānañhi,asahayananhi,1,1,0,0,12
56805,paṭisattavo,patisattavo,1,1,0,0,11
56806,ekākittāyevāhamappaṭisaraṇattānena,ekakittayevahamappatisaranattanena,1,1,0,0,34
56807,dusāmīti,dusamiti,1,1,0,0,8
56808,duññāmīti,dunnamiti,1,1,0,0,9
56809,hosi,hosi,74,74,0,0,4
56810,sanāthānaṃ,sanathanam,1,1,0,0,10
56811,vuttīti,vuttiti,23,19,4,0,7
56812,byasanamāpannaṃ,byasanamapannam,1,1,0,0,15
56813,upekkhaseti,upekkhaseti,1,1,0,0,11
56814,visayamanubhavantassa,visayamanubhavantassa,1,1,0,0,21
56815,vimukhattaṃ,vimukhattam,1,1,0,0,11
56816,nidassetītīdisaṃ,nidassetitidisam,1,1,0,0,16
56817,gāmmadosaparihāre,gammadosaparihare,1,1,0,0,17
56818,kāmataṇhābhibhūtā,kamatanhabhibhuta,1,1,0,0,17
56819,vallabhaṃ,vallabham,2,2,0,0,9
56820,vilapati,vilapati,15,15,0,0,8
56821,kāruṇika,karunika,1,1,0,0,8
56822,anaṅganīco,ananganico,1,1,0,0,10
56823,nikkāruṇiko,nikkaruniko,4,4,0,0,11
56824,pīḷeti,pileti,52,50,2,0,6
56825,anāthabhāvābhāvato,anathabhavabhavato,1,1,0,0,18
56826,sukhitopi,sukhitopi,3,3,0,0,9
56827,kāmacaṇḍālena,kamacandalena,1,1,0,0,13
56828,akāruṇena,akarunena,1,1,0,0,9
56829,kataasayhasantāpasaṅkhātabyasanamanuppattaṃ,kataasayhasantapasankhatabyasanamanuppattam,1,1,0,0,43
56830,udāsīnosī,udasinosi,1,1,0,0,9
56831,dukkhāturattā,dukkhaturatta,1,1,0,0,13
56832,dukkhadūrīkaraṇaṃ,dukkhadurikaranam,1,1,0,0,17
56833,kāruṇikānaṃyeva,karunikanamyeva,1,1,0,0,15
56834,visayanti,visayanti,13,13,0,0,9
56835,āmantanucitaṃ,amantanucitam,1,1,0,0,13
56836,dukkhāturataṃ,dukkhaturatam,1,1,0,0,13
56837,posetuṃ,posetum,25,24,1,0,7
56838,pīḷākārake,pilakarake,1,1,0,0,10
56839,niddayattakathanañca,niddayattakathananca,1,1,0,0,20
56840,upekkhakattā,upekkhakatta,1,1,0,0,12
56841,sukhīpīti,sukhipiti,1,0,1,0,9
56842,paravisayāsattatāya,paravisayasattataya,1,1,0,0,19
56843,aticāraṃ,aticaram,3,3,0,0,8
56844,abbhupagameti,abbhupagameti,1,1,0,0,13
56845,vallabhe,vallabhe,1,1,0,0,8
56846,sānurāgattañca,sanuragattanca,1,1,0,0,14
56847,tadabhāvattañca,tadabhavattanca,1,1,0,0,15
56848,kiṃnvidaṃ,kimnvidam,1,1,0,0,9
56849,gāmmadoso,gammadoso,1,1,0,0,9
56850,gāmmadosaparihāramidaṃ,gammadosapariharamidam,1,1,0,0,22
56851,kāmoyeva,kamoyeva,10,10,0,0,8
56852,sukhamassa,sukhamassa,4,4,0,0,10
56853,akkhame,akkhame,1,1,0,0,7
56854,savanubbegaṃ,savanubbegam,2,0,2,0,12
56855,yetaṃ,yetam,2,0,2,0,5
56856,pakāsitanti,pakasitanti,44,44,0,0,11
56857,yatihīni,yatihini,1,0,1,0,8
56858,dosānamuddesakkamena,dosanamuddesakkamena,1,1,0,0,20
56859,dosaparihārakkamo,dosapariharakkamo,1,1,0,0,17
56860,viññūnamuppajjamānaṃ,vinnunamuppajjamanam,1,1,0,0,20
56861,savanāsahanaṃ,savanasahanam,1,1,0,0,13
56862,yatihīnadosassa,yatihinadosassa,1,1,0,0,15
56863,pariharaṇavasena,pariharanavasena,9,9,0,0,16
56864,pavattamudāharaṇaṃ,pavattamudaharanam,1,1,0,0,18
56865,nāharīyateti,nahariyateti,1,1,0,0,12
56866,iminādhigatamādo,iminadhigatamado,1,1,0,0,16
56867,yatihīnadosapariharaṇaṃ,yatihinadosapariharanam,1,1,0,0,23
56868,anantaraparicchede,anantaraparicchede,3,3,0,0,18
56869,yatihīnadosapātubhāveyeva,yatihinadosapatubhaveyeva,1,1,0,0,25
56870,parihārakkamassāpi,pariharakkamassapi,1,1,0,0,18
56871,ihādassanepi,ihadassanepi,1,1,0,0,12
56872,ettheti,ettheti,1,1,0,0,7
56873,parihāroti,pariharoti,7,5,2,0,10
56874,ubbeganti,ubbeganti,1,1,0,0,9
56875,tenevā,teneva,16,6,10,0,6
56876,udāra,udara,1,0,1,0,5
56877,udāraṃ,udaram,3,3,0,0,6
56878,udārattaṃ,udarattam,1,1,0,0,9
56879,cāgātisayasambandhato,cagatisayasambandhato,1,1,0,0,21
56880,atiguṇapavatti,atigunapavatti,1,1,0,0,14
56881,ucitattā,ucitatta,3,3,0,0,8
56882,desādīnaṃ,desadinam,1,1,0,0,9
56883,yācanakkamassa,yacanakkamassa,1,1,0,0,14
56884,parihāroyaṃ,pariharoyam,1,1,0,0,11
56885,udāri,udari,1,0,1,0,5
56886,puññavanta,punnavanta,1,1,0,0,10
56887,udāracaritosi,udaracaritosi,1,0,1,0,13
56888,cāgātisayayogato,cagatisayayogato,1,1,0,0,16
56889,visāradapavattiyuttosi,visaradapavattiyuttosi,1,1,0,0,22
56890,kāraṇeneva,karaneneva,11,11,0,0,10
56891,ārādhanā,aradhana,9,8,1,0,8
56892,vājanapadaṃ,vajanapadam,1,1,0,0,11
56893,saṃvasathaṃ,samvasatham,1,1,0,0,11
56894,hīnapadatthayācanā,hinapadatthayacana,1,1,0,0,18
56895,dāyakassa,dayakassa,103,96,7,0,9
56896,dānassāpi,danassapi,1,1,0,0,9
56897,icchitatthapaṭilābhassāpi,icchitatthapatilabhassapi,1,1,0,0,25
56898,anurūpattā,anurupatta,16,15,1,0,10
56899,kamaccutadosamapaneti,kamaccutadosamapaneti,1,1,0,0,21
56900,yamākāso,yamakaso,1,0,1,0,8
56901,pātubhūtā,patubhuta,53,53,0,0,9
56902,yasorāsī,yasorasi,1,1,0,0,8
56903,ākāsopi,akasopi,1,1,0,0,7
56904,gaganameva,gaganameva,1,1,0,0,10
56905,tasseko,tasseko,18,18,0,0,7
56906,nāvakāso,navakaso,3,2,1,0,8
56907,tādisattā,tadisatta,4,4,0,0,9
56908,marīcinanti,maricinanti,1,1,0,0,11
56909,nātivuttaṃ,nativuttam,1,1,0,0,10
56910,munindacandasambhūtayasorāsimarīcinaṃ,munindacandasambhutayasorasimaricinam,1,0,1,0,37
56911,munindasaṅkhātacandato,munindasankhatacandato,1,1,0,0,22
56912,pātubhūtānaṃ,patubhutanam,1,1,0,0,12
56913,kittisamūhasaṅkhātakiraṇānaṃ,kittisamuhasankhatakirananam,1,1,0,0,28
56914,hetuphalādiekekakāraṇenāpi,hetuphaladiekekakaranenapi,1,1,0,0,26
56915,appameyyānaṃ,appameyyanam,1,1,0,0,12
56916,sabbaññuguṇānaṃ,sabbannugunanam,2,2,0,0,15
56917,appameyyasāmaññabhūtākāsassa,appameyyasamannabhutakasassa,1,1,0,0,28
56918,niravakāsassa,niravakasassa,1,1,0,0,13
56919,kathanamucitanti,kathanamucitanti,1,1,0,0,16
56920,ativuttadoso,ativuttadoso,1,1,0,0,12
56921,sambhūtānaṃyeva,sambhutanamyeva,1,1,0,0,15
56922,yasānaṃ,yasanam,1,1,0,0,7
56923,byāpannaṃ,byapannam,13,11,2,0,9
56924,naṭṭhaṃ,nattham,150,140,10,0,7
56925,ayathāpavattaṃ,ayathapavattam,1,1,0,0,14
56926,vākyalakkhaṇopetaṃ,vakyalakkhanopetam,1,1,0,0,18
56927,ahīḷitaṃ,ahilitam,6,6,0,0,8
56928,yathāvuttena,yathavuttena,174,164,10,0,12
56929,dhātukkhobhādinā,dhatukkhobhadina,1,1,0,0,16
56930,khittacitto,khittacitto,42,38,4,0,11
56931,bālādīnaṃ,baladinam,1,1,0,0,9
56932,asaṅgatāya,asangataya,1,1,0,0,10
56933,abyāpannacittavisaye,abyapannacittavisaye,1,1,0,0,20
56934,ummattādīnaṃyeva,ummattadinamyeva,1,1,0,0,16
56935,tathāvidhāya,tathavidhaya,2,2,0,0,12
56936,ucitattāti,ucitattati,1,1,0,0,10
56937,viruddhabhāvamāpannacittānaṃ,viruddhabhavamapannacittanam,1,1,0,0,28
56938,syādyantatyādyantapadasamudāyarūpaṃ,syadyantatyadyantapadasamudayarupam,1,1,0,0,35
56939,apagatasamudāyatthaṃ,apagatasamudayattham,1,1,0,0,20
56940,garahitaṃ,garahitam,10,10,0,0,9
56941,ummattādikānaṃ,ummattadikanam,1,0,1,0,14
56942,ummattavedanaṭṭādīnaṃ,ummattavedanattadinam,1,1,0,0,21
56943,vacanāññatra,vacanannatra,1,0,1,0,12
56944,anummattādivacane,anummattadivacane,1,1,0,0,17
56945,samudāyatthasambandharahitaṃ,samudayatthasambandharahitam,1,1,0,0,28
56946,dosaduṭṭhaṃ,dosaduttham,2,2,0,0,11
56947,yamaha,yamaha,1,0,1,0,6
56948,iccādino,iccadino,2,2,0,0,8
56949,gayhati,gayhati,269,267,2,0,7
56950,bandhattho,bandhattho,1,1,0,0,10
56951,avayavatthā,avayavattha,1,1,0,0,11
56952,ayosalākākappāpaṭibhantīti,ayosalakakappapatibhantiti,1,1,0,0,26
56953,īdisamapetatthamaninditaṃ,idisamapetatthamaninditam,1,1,0,0,25
56954,jararogābhibhūto,jararogabhibhuto,1,1,0,0,16
56955,meghā,megha,29,27,2,0,5
56956,thanayanti,thanayanti,1,1,0,0,10
56957,piyoti,piyoti,14,5,9,0,6
56958,ninditāninditānaṃ,ninditaninditanam,1,1,0,0,17
56959,dvinnamudāharaṇaṃ,dvinnamudaharanam,1,1,0,0,17
56960,avayavatthamantarena,avayavatthamantarena,1,1,0,0,20
56961,samudāyato,samudayato,15,14,1,0,10
56962,gamyamānatthassābhāvā,gamyamanatthassabhava,1,1,0,0,21
56963,ummattakādīhi,ummattakadihi,1,1,0,0,13
56964,vuttamappītikaraṃ,vuttamappitikaram,1,1,0,0,17
56965,ayosalākā,ayosalaka,3,3,0,0,9
56966,appītikaraṃ,appitikaram,1,1,0,0,11
56967,āturoti,aturoti,1,1,0,0,7
56968,sukhumālāvirodhittadittabhāvappabhāvitaṃ,sukhumalavirodhittadittabhavappabhavitam,2,0,2,0,40
56969,bandhapharusadosaṃ,bandhapharusadosam,3,1,2,0,18
56970,sukhumāli,sukhumali,2,0,2,0,9
56971,avirodhī,avirodhi,2,2,0,0,8
56972,avirodhittaṃ,avirodhittam,3,3,0,0,12
56973,sukhumālassa,sukhumalassa,5,5,0,0,12
56974,dittabhāvo,dittabhavo,1,1,0,0,10
56975,pabhāvitaṃ,pabhavitam,8,5,3,0,10
56976,nāsayeti,nasayeti,1,1,0,0,8
56977,aniṭṭhurakkharappāye,anitthurakkharappaye,1,1,0,0,20
56978,vuccamānasukhumālaguṇassa,vuccamanasukhumalagunassa,1,1,0,0,25
56979,aviruddhabhāvasamannāgatena,aviruddhabhavasamannagatena,1,1,0,0,27
56980,aññamaññasaṅgabhilakkhaṇena,annamannasangabhilakkhanena,1,1,0,0,27
56981,dittabhāvena,dittabhavena,1,0,1,0,12
56982,piyabhāvena,piyabhavena,4,4,0,0,11
56983,anubrūhitaṃ,anubruhitam,3,3,0,0,11
56984,bandhapharusasaṅkhātadosaṃ,bandhapharusasankhatadosam,1,1,0,0,26
56985,bandhapharusadosanti,bandhapharusadosanti,1,1,0,0,20
56986,dittassa,dittassa,1,1,0,0,8
56987,pabhāvitanti,pabhavitanti,1,1,0,0,12
56988,sambuddhakāle,sambuddhakale,5,1,4,0,13
56989,keḷiyā,keliya,4,4,0,0,6
56990,kīḷāya,kilaya,14,13,1,0,6
56991,parammukhā,parammukha,174,162,12,0,10
56992,vigatacchandā,vigatacchanda,3,3,0,0,13
56993,passante,passante,19,18,1,0,8
56994,dharamānakāle,dharamanakale,37,37,0,0,13
56995,rūpasampattiṃ,rupasampattim,36,35,1,0,13
56996,santappetvā,santappetva,77,77,0,0,11
56997,olokentā,olokenta,61,61,0,0,8
56998,aṭṭhaṅgasamannāgataṃ,atthangasamannagatam,82,74,8,0,20
56999,madhuravacanaṃ,madhuravacanam,5,5,0,0,14
57000,vimukhā,vimukha,4,3,1,0,7
57001,kīḷābhiratirahitā,kilabhiratirahita,1,1,0,0,17
57002,pavattantīti,pavattantiti,231,222,9,0,12
57003,pharusasithilavaṇṇehi,pharusasithilavannehi,1,1,0,0,21
57004,sukhuccāraṇīyavaṇṇehi,sukhuccaraniyavannehi,1,1,0,0,21
57005,sambhūtasukhumālaguṇāvirodhaaññamaññasaṅgatavaṇṇavisadappavattaguṇayuttattā,sambhutasukhumalagunavirodhaannamannasangatavannavisadappavattagunayuttatta,1,1,0,0,75
57006,bandhapharusadoso,bandhapharusadoso,1,1,0,0,17
57007,parāni,parani,92,91,1,0,6
57008,parivattitāni,parivattitani,1,1,0,0,13
57009,mukhāni,mukhani,26,26,0,0,7
57010,kāloti,kaloti,84,44,40,0,6
57011,tadākārappavattasambandhoyeva,tadakarappavattasambandhoyeva,1,1,0,0,29
57012,padatthoyevāti,padatthoyevati,1,1,0,0,14
57013,voharati,voharati,106,100,6,0,8
57014,vākyadosaparihāro,vakyadosapariharo,1,1,0,0,17
57015,vākyatthadosaparihāravaṇṇanā,vakyatthadosapariharavannana,1,1,0,0,28
57016,nibbānabhogasaggādisādhanāni,nibbanabhogasaggadisadhanani,2,0,2,0,28
57017,bhāvanādīni,bhavanadini,1,1,0,0,11
57018,nibbānādīnaṃ,nibbanadinam,1,1,0,0,12
57019,niddesena,niddesena,31,28,3,0,9
57020,apakkamadoso,apakkamadoso,2,2,0,0,12
57021,bhāvane,bhavane,1,0,1,0,7
57022,yathāvidhi,yathavidhi,7,7,0,0,10
57023,pavattāpitāni,pavattapitani,1,1,0,0,13
57024,nibbānaupabhogaparibhogasampattisagguppattiādīnaṃ,nibbanaupabhogaparibhogasampattisagguppattiadinam,1,1,0,0,49
57025,bhāvanādayo,bhavanadayo,2,2,0,0,11
57026,uddisitvā,uddisitva,301,294,7,0,9
57027,uddesakkamaṃ,uddesakkamam,2,2,0,0,12
57028,anatikkamma,anatikkamma,20,19,1,0,11
57029,nibbānādīnamanuddesassa,nibbanadinamanuddesassa,1,1,0,0,23
57030,apakkamavākyatthadosassa,apakkamavakyatthadosassa,1,1,0,0,24
57031,anuddiṭṭhesu,anudditthesu,3,0,3,0,12
57032,anudiṭṭhesu,anuditthesu,1,1,0,0,11
57033,uddiṭṭhe,udditthe,18,16,2,0,8
57034,uddiṭṭhā,uddittha,135,116,19,0,8
57035,uddesānuddesasambandhavijānanalakkhaṇassa,uddesanuddesasambandhavijananalakkhanassa,1,1,0,0,41
57036,yathākkamamuddesakamānamatikkamena,yathakkamamuddesakamanamatikkamena,1,1,0,0,34
57037,atthantaranissayena,atthantaranissayena,1,1,0,0,19
57038,parāmaṭṭhesu,paramatthesu,1,1,0,0,12
57039,kamassa,kamassa,15,13,2,0,7
57040,yathoddiṭṭhesu,yathodditthesu,1,1,0,0,14
57041,anukkamassa,anukkamassa,1,1,0,0,11
57042,vilaṅghane,vilanghane,1,0,1,0,10
57043,payuttatthavisayo,payuttatthavisayo,1,1,0,0,17
57044,uddesānuddesānaṃ,uddesanuddesanam,3,3,0,0,16
57045,pubbakathanaṃ,pubbakathanam,1,1,0,0,13
57046,pacchākathanaṃ,pacchakathanam,1,1,0,0,14
57047,aññamaññāpekkhalakkhaṇasambandhaparijānanalakkhaṇo,annamannapekkhalakkhanasambandhaparijananalakkhano,1,1,0,0,50
57048,bhaveyyā,bhaveyya,175,150,25,0,8
57049,kamātikkame,kamatikkame,5,5,0,0,11
57050,satthaññūnaṃ,satthannunam,1,1,0,0,12
57051,sutikāle,sutikale,1,1,0,0,8
57052,asahanakāraṇaṃ,asahanakaranam,1,1,0,0,14
57053,nevatthīti,nevatthiti,4,4,0,0,10
57054,paṭhamuccāritā,pathamuccarita,1,1,0,0,14
57055,vilaṅghananti,vilanghananti,1,1,0,0,13
57056,abyākata,abyakata,11,11,0,0,8
57057,kāmāvacarādikamekavīsatividhaṃ,kamavacaradikamekavisatividham,1,1,0,0,30
57058,dvādasavidhaṃ,dvadasavidham,35,30,5,0,13
57059,vipākakriyāsaṅkhātamiti,vipakakriyasankhatamiti,1,1,0,0,23
57060,pākaṃ,pakam,29,28,1,0,5
57061,nipātapadaṃ,nipatapadam,56,47,9,0,11
57062,apākadattaṃ,apakadattam,1,1,0,0,11
57063,abyākatasseva,abyakatasseva,3,3,0,0,13
57064,pākadattaṃ,pakadattam,1,1,0,0,10
57065,dvinnanti,dvinnanti,10,10,0,0,9
57066,kāmāvacarādiekavīsatikusalañca,kamavacaradiekavisatikusalanca,1,1,0,0,30
57067,vipākakriyārūpanibbānavasena,vipakakriyarupanibbanavasena,1,1,0,0,28
57068,catubbidhamabyākatañca,catubbidhamabyakatanca,1,1,0,0,22
57069,iccesu,iccesu,1,0,1,0,6
57070,pacchimamabyākataṃ,pacchimamabyakatam,1,1,0,0,18
57071,vipākadāyakaṃ,vipakadayakam,11,10,1,0,13
57072,yathāsaṅkhyamanudeso,yathasankhyamanudeso,2,2,0,0,20
57073,suttamidaṃ,suttamidam,1,1,0,0,10
57074,anudissate,anudissate,1,1,0,0,10
57075,anudeso,anudeso,4,4,0,0,7
57076,uccārito,uccarito,5,5,0,0,8
57077,sambandhechaṭṭhī,sambandhechatthi,1,1,0,0,16
57078,katvabodhinī,katvabodhini,1,1,0,0,12
57079,uddiṭṭhehi,udditthehi,9,9,0,0,10
57080,samānamanuddiṭṭhānameva,samanamanudditthanameva,1,1,0,0,23
57081,samasaṅkhyāya,samasankhyaya,1,1,0,0,13
57082,saṅkhyāyānatikkamo,sankhyayanatikkamo,1,1,0,0,18
57083,kusalādisabhāvato,kusaladisabhavato,2,2,0,0,17
57084,tividhattepi,tividhattepi,2,2,0,0,12
57085,vipākadānādānavasena,vipakadanadanavasena,1,1,0,0,20
57086,duvidhakusalākusalādivisayabhūtavisesassa,duvidhakusalakusaladivisayabhutavisesassa,1,1,0,0,41
57087,nissayanaṃ,nissayanam,8,8,0,0,10
57088,ocityahīnatāpatti,ocityahinatapatti,2,0,2,0,17
57089,saguṇāna,sagunana,1,0,1,0,8
57090,attatthanipphādanādike,attatthanipphadanadike,2,2,0,0,22
57091,yathāpavattaṃ,yathapavattam,22,22,0,0,13
57092,caritalakkhaṇaṃ,caritalakkhanam,1,1,0,0,15
57093,saṃsino,samsino,1,0,1,0,7
57094,vadantassa,vadantassa,177,172,5,0,10
57095,āvikaraṇe,avikarane,2,0,2,0,9
57096,adhikāravasena,adhikaravasena,40,39,1,0,14
57097,iccādikathane,iccadikathane,1,1,0,0,13
57098,ocikyahīnatāya,ocikyahinataya,1,1,0,0,14
57099,pāpuṇanaṃ,papunanam,13,13,0,0,9
57100,saguṇi,saguni,1,0,1,0,6
57101,vijjamānakāyādisaṃvaralakkhaṇaguṇasaṅkhātamatthaṃ,vijjamanakayadisamvaralakkhanagunasankhatamattham,1,1,0,0,49
57102,ahameko,ahameko,3,3,0,0,7
57103,tādisāvasare,tadisavasare,1,1,0,0,12
57104,saguṇānaṃ,sagunanam,1,0,1,0,9
57105,sakānaṃ,sakanam,2,2,0,0,7
57106,pākaṭīkaraṇe,pakatikarane,3,3,0,0,12
57107,ocityahīnasaṅkhātadosassāpatti,ocityahinasankhatadosassapatti,1,1,0,0,30
57108,attaattaniyavācakattā,attaattaniyavacakatta,1,1,0,0,21
57109,bhūtoyeva,bhutoyeva,3,3,0,0,9
57110,vikhyātaṃ,vikhyatam,4,2,2,0,9
57111,ābālajanaṃ,abalajanam,1,1,0,0,10
57112,ābālajanānaṃ,abalajananam,1,1,0,0,12
57113,yathāsakamanurūpaṃ,yathasakamanurupam,1,1,0,0,18
57114,vijānanato,vijananato,5,5,0,0,10
57115,ucitabhāvo,ucitabhavo,1,1,0,0,10
57116,nāmeti,nameti,24,24,0,0,6
57117,ādarā,adara,2,0,2,0,5
57118,ussāhena,ussahena,63,59,4,0,8
57119,paramādaraṇīyassābhāvato,paramadaraniyassabhavato,1,1,0,0,24
57120,anucitaṃ,anucitam,1,1,0,0,8
57121,kenāpyādaraṇīyaṃ,kenapyadaraniyam,1,1,0,0,16
57122,anassādanīyattā,anassadaniyatta,1,1,0,0,15
57123,ocitye,ocitye,3,2,1,0,6
57124,upadesassa,upadesassa,3,2,1,0,10
57125,paṭhamuccāraṇassa,pathamuccaranassa,2,2,0,0,17
57126,uggaṇhāpanavasena,ugganhapanavasena,2,2,0,0,17
57127,uppattiṭṭhānabhūtā,uppattitthanabhuta,6,5,1,0,18
57128,suṭṭhujanā,sutthujana,1,1,0,0,10
57129,kaviuttamā,kaviuttama,1,1,0,0,10
57130,kaviseṭṭhāti,kavisetthati,1,1,0,0,12
57131,ābālapasiddhaṃ,abalapasiddham,1,1,0,0,14
57132,gāravena,garavena,81,81,0,0,8
57133,ocityavisaye,ocityavisaye,1,1,0,0,12
57134,upadesapabhavā,upadesapabhava,1,0,1,0,14
57135,sādhujanabhūtā,sadhujanabhuta,1,1,0,0,14
57136,uttamakavayo,uttamakavayo,1,1,0,0,12
57137,pasiddhaocityapadena,pasiddhaocityapadena,1,1,0,0,20
57138,pabhavāti,pabhavati,4,3,1,0,9
57139,puṅgavāti,pungavati,2,2,0,0,9
57140,viññāta,vinnata,2,1,1,0,7
57141,viññāto,vinnato,11,11,0,0,7
57142,avabuddho,avabuddho,4,4,0,0,9
57143,yathāvuttakavivarapasādā,yathavuttakavivarapasada,1,1,0,0,24
57144,ocityameva,ocityameva,2,2,0,0,10
57145,parivajjeyya,parivajjeyya,60,56,4,0,12
57146,hetuto,hetuto,77,76,1,0,6
57147,ocityassa,ocityassa,2,2,0,0,9
57148,vaḍḍhibhāve,vaddhibhave,1,1,0,0,11
57149,assāditabbatāsaṅkhātassa,assaditabbatasankhatassa,1,1,0,0,24
57150,samposo,samposo,1,1,0,0,7
57151,tādisakavīnamanuggahena,tadisakavinamanuggahena,1,1,0,0,23
57152,viññātaocityasaṅkhātasampattisamannāgato,vinnataocityasankhatasampattisamannagato,1,1,0,0,40
57153,nirākareyya,nirakareyya,1,1,0,0,11
57154,dosaparihārato,dosapariharato,1,1,0,0,14
57155,upabrūhane,upabruhane,1,1,0,0,10
57156,mādhuriyasaṅkhatassa,madhuriyasankhatassa,1,1,0,0,20
57157,vibhavoti,vibhavoti,25,16,9,0,9
57158,ocityavibhavo,ocityavibhavo,1,1,0,0,13
57159,puṭṭhabhāvo,putthabhavo,2,2,0,0,11
57160,vuddhabhāvo,vuddhabhavo,1,1,0,0,11
57161,posetabbabhāvoti,posetabbabhavoti,1,1,0,0,16
57162,mārasenamāsannamāsannavijayussavo,marasenamasannamasannavijayussavo,1,1,0,0,33
57163,parābhibhavo,parabhibhavo,1,1,0,0,12
57164,abbhudayo,abbhudayo,6,6,0,0,9
57165,nippaṭipakkhā,nippatipakkha,2,2,0,0,13
57166,ediso,ediso,209,202,7,0,5
57167,āsannaṃ,asannam,60,50,10,0,7
57168,samīpamupagataṃ,samipamupagatam,1,1,0,0,15
57169,mārasenaṃ,marasenam,39,34,5,0,9
57170,tiṇampi,tinampi,16,16,0,0,7
57171,tiṇatopi,tinatopi,4,3,1,0,8
57172,detūti,detuti,10,9,1,0,6
57173,vidadhātu,vidadhatu,1,1,0,0,9
57174,jayāsīsanā,jayasisana,1,1,0,0,10
57175,accantamucitaṃ,accantamucitam,1,1,0,0,14
57176,pañcamāreti,pancamareti,1,1,0,0,11
57177,parābhibhavekaraso,parabhibhavekaraso,1,1,0,0,18
57178,vijayappadāne,vijayappadane,1,1,0,0,13
57179,sāmatthiyekayogo,samatthiyekayogo,1,1,0,0,16
57180,mārasenamāsannaṃ,marasenamasannam,2,2,0,0,16
57181,maññitthā,mannittha,3,3,0,0,9
57182,atisamucitaṃ,atisamucitam,1,1,0,0,12
57183,samīpamupagatampi,samipamupagatampi,1,1,0,0,17
57184,maññi,manni,42,40,2,0,5
57185,vijayappadānekarasatā,vijayappadanekarasata,1,1,0,0,21
57186,yuttāti,yuttati,94,77,17,0,7
57187,saṅkhepakkamamicchantopi,sankhepakkamamicchantopi,1,1,0,0,24
57188,saggarūhi,saggaruhi,1,1,0,0,9
57189,payujjitabbamiccevaṃ,payujjitabbamiccevam,1,1,0,0,20
57190,anusāsitvā,anusasitva,43,43,0,0,10
57191,ocityahīnapariharaṇatthaṃ,ocityahinapariharanattham,1,1,0,0,25
57192,mārasenamāsanne,marasenamasanne,1,0,1,0,15
57193,āsannavijayussavo,asannavijayussavo,1,0,1,0,17
57194,adūrasattuvijayasaṅkhātaussavo,adurasattuvijayasankhataussavo,1,1,0,0,30
57195,accāsannapaṭipakkhavirahappavattisaṅkhātaabhivuddhiyā,accasannapatipakkhavirahappavattisankhataabhivuddhiya,1,1,0,0,53
57196,anekappakārabhiṃsanakarūpena,anekappakarabhimsanakarupena,1,1,0,0,28
57197,samīpamāgataṃ,samipamagatam,2,2,0,0,13
57198,tiṇalavaṃ,tinalavam,1,1,0,0,9
57199,sallakkhaṇaṃ,sallakkhanam,17,17,0,0,12
57200,nākāsi,nakasi,28,27,1,0,6
57201,jitapañcamāro,jitapancamaro,6,6,0,0,13
57202,jitattā,jitatta,11,11,0,0,7
57203,parābhibhavane,parabhibhavane,3,3,0,0,14
57204,asahāyakiccattā,asahayakiccatta,1,1,0,0,15
57205,jayadāne,jayadane,2,2,0,0,8
57206,sāmatthiyayuttoti,samatthiyayuttoti,1,1,0,0,17
57207,detū,detu,20,20,0,0,4
57208,jayāsīsanamatiucitaṃ,jayasisanamatiucitam,1,1,0,0,20
57209,sāmatthiyasseva,samatthiyasseva,1,1,0,0,15
57210,posakattā,posakatta,1,1,0,0,9
57211,accantaucitapayogena,accantaucitapayogena,1,1,0,0,20
57212,ocityahīnadoso,ocityahinadoso,1,1,0,0,14
57213,vijayussavo,vijayussavo,1,1,0,0,11
57214,āraddhakattukammādikamātikkamalaṅghane,araddhakattukammadikamatikkamalanghane,2,0,2,0,38
57215,āraddha,araddha,7,6,1,0,7
57216,ādīni,adini,60,58,2,0,5
57217,karaṇādīnaṃ,karanadinam,9,9,0,0,11
57218,āraddhāni,araddhani,5,4,1,0,9
57219,paṭṭhapitāni,patthapitani,5,5,0,0,12
57220,kattukammādīni,kattukammadini,2,2,0,0,14
57221,laṅghane,langhane,2,1,1,0,8
57222,vattumāraddhakattukammādikamānatikkameti,vattumaraddhakattukammadikamanatikkameti,1,1,0,0,40
57223,katthacipi,katthacipi,101,101,0,0,10
57224,labhate,labhate,182,168,14,0,7
57225,āraddhi,araddhi,1,0,1,0,7
57226,vattumāraddhakattukammādīnaṃ,vattumaraddhakattukammadinam,1,1,0,0,28
57227,kamapariccāgassātikkame,kamapariccagassatikkame,1,1,0,0,23
57228,yathāvuttabhaggarītivirodho,yathavuttabhaggaritivirodho,1,1,0,0,27
57229,laṅghananti,langhananti,1,1,0,0,11
57230,sujanaññāna,sujanannana,1,0,1,0,11
57231,roganadīrājakulassa,roganadirajakulassa,2,1,1,0,19
57232,suddhabuddhādiratanattaye,suddhabuddhadiratanattaye,2,1,1,0,25
57233,saguṇepi,sagunepi,2,1,1,0,8
57234,para108-109,para108-109,4,4,0,0,11
57235,miccādike,miccadike,1,1,0,0,9
57236,iccādike,iccadike,4,4,0,0,8
57237,gāthādvaye,gathadvaye,3,3,0,0,10
57238,apariccāgena,apariccagena,1,1,0,0,12
57239,nāttharītiyā,nattharitiya,1,1,0,0,12
57240,kārassekassa,karassekassa,1,1,0,0,12
57241,bahūnamatthānañhi,bahunamatthananhi,1,1,0,0,17
57242,samuccayatthaṃ,samuccayattham,2,2,0,0,14
57243,cakāro,cakaro,39,39,0,0,6
57244,sujane,sujane,3,2,1,0,6
57245,sujanaññānaṃ,sujanannanam,1,0,1,0,12
57246,jīvitaharaṇasamatthassa,jivitaharanasamatthassa,1,1,0,0,23
57247,visāṇavato,visanavato,1,1,0,0,10
57248,upapajjate,upapajjate,3,2,1,0,10
57249,kiñcikāle,kincikale,23,19,4,0,9
57250,āraddhassa,araddhassa,21,21,0,0,10
57251,chaṭṭhuntakkamassa,chatthuntakkamassa,1,1,0,0,18
57252,apariccāgato,apariccagato,1,1,0,0,12
57253,attharītibhaṅgo,attharitibhango,1,1,0,0,15
57254,cakārassa,cakarassa,9,9,0,0,9
57255,saddarītibhaṅgo,saddaritibhango,1,1,0,0,15
57256,anekatthasamuccayattā,anekatthasamuccayatta,1,1,0,0,21
57257,sujanaññānañcā,sujanannananca,1,1,0,0,14
57258,itiādimhi,itiadimhi,65,65,0,0,9
57259,yojanamarahati,yojanamarahati,1,1,0,0,14
57260,ccādigāthāyampi,ccadigathayampi,1,1,0,0,15
57261,sattamīmattameva,sattamimattameva,1,1,0,0,16
57262,pathye,pathye,1,1,0,0,6
57263,vijjamānaguṇe,vijjamanagune,4,4,0,0,13
57264,cittapasādaṃ,cittapasadam,2,2,0,0,12
57265,ācare,acare,7,6,1,0,5
57266,munindacandimāloka,munindacandimaloka,1,0,1,0,18
57267,rasalolavilocano,rasalolavilocano,1,0,1,0,16
57268,raṃsidassanapīṇito,ramsidassanapinito,1,0,1,0,18
57269,sasaṃsayaparihāralakkhiyabhūtā,sasamsayapariharalakkhiyabhuta,1,1,0,0,30
57270,ccādigāthā,ccadigatha,1,1,0,0,10
57271,vuttatthāva,vuttatthava,14,14,0,0,11
57272,uppajjamānasaṃsayena,uppajjamanasamsayena,1,1,0,0,20
57273,sasaṃsayabhūtaṃ,sasamsayabhutam,1,1,0,0,15
57274,bandhadosamohatīti,bandhadosamohatiti,1,1,0,0,18
57275,saṃsayāyeva,samsayayeva,2,1,1,0,11
57276,kīḷādīti,kiladiti,1,0,1,0,8
57277,ākiṇṇasammantanādiṃ,akinnasammantanadim,1,1,0,0,19
57278,saṃsayāyeve,samsayayeve,1,0,1,0,11
57279,kīḷāsambādhasammantanādikāraṇena,kilasambadhasammantanadikaranena,1,1,0,0,32
57280,saṃsayuppādanasamatthaṃ,samsayuppadanasamattham,1,1,0,0,23
57281,saṃsayāya,samsayaya,1,0,1,0,9
57282,uppajjamānasaṃsayatthameva,uppajjamanasamsayatthameva,1,1,0,0,26
57283,vattārehi,vattarehi,3,3,0,0,9
57284,sasaṃsayadosasahito,sasamsayadosasahito,1,1,0,0,19
57285,dosova,dosova,6,5,1,0,6
57286,aduṭṭhovāti,adutthovati,1,1,0,0,11
57287,sasaṃsayena,sasamsayena,1,1,0,0,11
57288,samappitoti,samappitoti,9,2,7,0,11
57289,dutiyaṃnilayaṃ,dutiyamnilayam,1,0,1,0,14
57290,gurumhi,gurumhi,6,1,5,0,7
57291,majjhayanādinā,majjhayanadina,1,0,1,0,14
57292,ajjhāpake,ajjhapake,1,1,0,0,9
57293,mūlanilayato,mulanilayato,1,1,0,0,12
57294,niyata,niyata,6,4,2,0,6
57295,mekantamajjhayanādinā,mekantamajjhayanadina,1,1,0,0,21
57296,pāpuṇeyyāmāti,papuneyyamati,3,3,0,0,13
57297,ayamanicchitattho,ayamanicchitattho,2,2,0,0,17
57298,surācariye,suracariye,2,2,0,0,10
57299,suraccācariye,suraccacariye,1,1,0,0,13
57300,jātarāsito,jatarasito,2,2,0,0,10
57301,niyatamajjhayanādinā,niyatamajjhayanadina,1,1,0,0,20
57302,ācariye,acariye,66,63,3,0,7
57303,vāsāgārato,vasagarato,1,1,0,0,10
57304,gharaṃyāte,gharamyate,1,1,0,0,10
57305,anukūlattā,anukulatta,5,5,0,0,10
57306,mekantena,mekantena,3,3,0,0,9
57307,ajjhayanādinā,ajjhayanadina,1,0,1,0,13
57308,uggahaṇādinā,uggahanadina,1,1,0,0,12
57309,mānasikasukhaṃ,manasikasukham,1,1,0,0,14
57310,ganthaparisamattiṃ,ganthaparisamattim,1,1,0,0,18
57311,ubhayapakkhassāpi,ubhayapakkhassapi,1,1,0,0,17
57312,aparatthe,aparatthe,1,1,0,0,9
57313,ajjhayana,ajjhayana,3,2,1,0,9
57314,saddasannidhānena,saddasannidhanena,2,2,0,0,17
57315,ācariyatthavācakattepi,acariyatthavacakattepi,1,1,0,0,22
57316,icchitatthagopanatthaṃ,icchitatthagopanattham,1,1,0,0,22
57317,aduṭṭhoti,adutthoti,3,1,2,0,9
57318,iccevamādikaṃ,iccevamadikam,7,5,2,0,13
57319,bhaginīiccevamādikaṃ,bhaginiiccevamadikam,1,1,0,0,20
57320,subhage,subhage,7,6,1,0,7
57321,sundarāti,sundarati,4,1,3,0,9
57322,sakalehi,sakalehi,10,10,0,0,8
57323,gāmmamiti,gammamiti,1,0,1,0,9
57324,gāmmadosena,gammadosena,1,1,0,0,11
57325,duṭṭhamiti,dutthamiti,1,1,0,0,10
57326,niddiṭṭhanti,nidditthanti,46,46,0,0,12
57327,sundarabhāvaṃ,sundarabhavam,9,8,1,0,13
57328,gatāti,gatati,164,121,43,0,6
57329,aggahetvā,aggahetva,504,485,19,0,9
57330,bahubbīhisamāse,bahubbihisamase,3,3,0,0,15
57331,labbhamānatthassa,labbhamanatthassa,1,1,0,0,17
57332,asabbhabhāvepi,asabbhabhavepi,1,1,0,0,14
57333,cittakhedaṃ,cittakhedam,2,2,0,0,11
57334,īdisassa,idisassa,44,43,1,0,8
57335,vākyassāti,vakyassati,4,4,0,0,10
57336,duṭṭhālaṅkāravigame,dutthalankaravigame,2,0,2,0,19
57337,sobhanālaṅkatikkamo,sobhanalankatikkamo,2,0,2,0,19
57338,dosadūsitassa,dosadusitassa,1,1,0,0,13
57339,alaṅkārassa,alankarassa,12,12,0,0,11
57340,apagame,apagame,14,14,0,0,7
57341,duṭṭhi,dutthi,1,0,1,0,6
57342,dosaduṭṭhassa,dosadutthassa,1,1,0,0,13
57343,pasatthānamalaṅkārānaṃ,pasatthanamalankaranam,1,1,0,0,22
57344,pavattiākāro,pavattiakaro,24,23,1,0,12
57345,alaṅkārapakāsakattā,alankarapakasakatta,2,2,0,0,19
57346,tannāmake,tannamake,2,2,0,0,9
57347,pakāsattaṃ,pakasattam,1,1,0,0,10
57348,tadatthena,tadatthena,8,8,0,0,10
57349,parīharitumesa,pariharitumesa,1,1,0,0,14
57350,guruvarāna,guruvarana,1,0,1,0,10
57351,dhikappasādā,dhikappasada,1,0,1,0,12
57352,padadosādike,padadosadike,1,1,0,0,12
57353,pariharituṃ,pariharitum,145,135,10,0,11
57354,pariccajituṃ,pariccajitum,22,22,0,0,12
57355,satthantarānaṃ,satthantaranam,1,1,0,0,14
57356,anusaraṇena,anusaranena,2,1,1,0,11
57357,anugamena,anugamena,1,1,0,0,9
57358,anupagamena,anupagamena,1,1,0,0,11
57359,guruvarānaṃ,guruvaranam,2,2,0,0,11
57360,adhikappasādā,adhikappasada,2,0,2,0,13
57361,pasādena,pasadena,64,63,1,0,8
57362,tathāvidhena,tathavidhena,3,3,0,0,12
57363,apasijjhanato,apasijjhanato,1,1,0,0,13
57364,jānitvā,janitva,723,702,21,0,7
57365,ādarato,adarato,1,1,0,0,7
57366,parisuddhabandhanaṃ,parisuddhabandhanam,2,2,0,0,19
57367,kriyālakkhaṇato,kriyalakkhanato,1,1,0,0,15
57368,kittihetuttā,kittihetutta,1,1,0,0,12
57369,taṃsabbhāvā,tamsabbhava,1,1,0,0,11
57370,abhilasati,abhilasati,3,3,0,0,10
57371,sīleneti,sileneti,4,4,0,0,8
57372,mahāsāmināmikāyaṃ,mahasaminamikayam,4,4,0,0,17
57373,dosaparihārāvabodhaparicchedo,dosapariharavabodhaparicchedo,1,1,0,0,29
57374,yathāvuttapadadosādike,yathavuttapadadosadike,1,1,0,0,22
57375,pariharitu,pariharitu,1,0,1,0,10
57376,mapanetuṃ,mapanetum,1,1,0,0,9
57377,bāhirasatthānaṃ,bahirasatthanam,1,1,0,0,15
57378,anussatiyā,anussatiya,5,5,0,0,10
57379,anantaruddiṭṭhakkamena,anantarudditthakkamena,1,1,0,0,22
57380,adhikappasādena,adhikappasadena,1,1,0,0,15
57381,yasapaṭilābhakāraṇattā,yasapatilabhakaranatta,1,1,0,0,22
57382,kāriyopacārena,kariyopacarena,10,10,0,0,14
57383,dosāpagamena,dosapagamena,2,2,0,0,12
57384,tādisabandhanahetu,tadisabandhanahetu,1,1,0,0,18
57385,uppajjamānakittiṃ,uppajjamanakittim,1,1,0,0,17
57386,yathāvuttadose,yathavuttadose,1,1,0,0,14
57387,kareyyāti,kareyyati,158,118,40,0,9
57388,dosaparihāraparicchedassa,dosapariharaparicchedassa,1,1,0,0,25
57389,pasatthabhāvo,pasatthabhavo,1,1,0,0,13
57390,sissajanānusāsanaṃ,sissajananusasanam,1,1,0,0,18
57391,karuṇāpubbaṅgamapaññākiccaṃ,karunapubbangamapannakiccam,1,1,0,0,27
57392,paññāpubbaṅgamakaruṇākiccaṃ,pannapubbangamakarunakiccam,1,1,0,0,27
57393,attahitasampatti,attahitasampatti,36,35,1,0,16
57394,parahitasampatti,parahitasampatti,1,1,0,0,16
57395,evamanekākāradīpikāya,evamanekakaradipikaya,1,1,0,0,21
57396,nigameti,nigameti,24,22,2,0,8
57397,antara,antara,17,5,12,0,6
57398,saddapariyāyo,saddapariyayo,6,6,0,0,13
57399,gāmantaraṃ,gamantaram,58,49,9,0,10
57400,gaccheyyā,gaccheyya,58,55,3,0,9
57401,yasaṃ,yasam,318,311,7,0,5
57402,guṇāvabodhapariccheda,gunavabodhapariccheda,1,1,0,0,21
57403,anusandhivaṇṇanā,anusandhivannana,1,1,0,0,16
57404,dosaparihāropadesaṃ,dosapariharopadesam,1,1,0,0,19
57405,samupagataguṇaṃ,samupagatagunam,1,1,0,0,15
57406,upadassitumadhikāraṃ,upadassitumadhikaram,1,1,0,0,20
57407,viracayanto,viracayanto,1,1,0,0,11
57408,saddālaṅkārasabhāvā,saddalankarasabhava,1,1,0,0,19
57409,kiliṭṭhādīnaṃ,kilitthadinam,1,1,0,0,13
57410,vajjanā,vajjana,6,6,0,0,7
57411,saddālaṅkārasaṅkhāte,saddalankarasankhate,1,1,0,0,20
57412,upadisissāmi,upadisissami,1,1,0,0,12
57413,dosaparihārapavesopāyaṃ,dosapariharapavesopayam,1,1,0,0,23
57414,parihārena,pariharena,29,29,0,0,10
57415,bandhanissitaguṇā,bandhanissitaguna,1,1,0,0,17
57416,pubbāparaparicchedānaṃ,pubbaparaparicchedanam,1,1,0,0,22
57417,ghaṭento,ghatento,81,80,1,0,8
57418,ccādigāthamāha,ccadigathamaha,1,1,0,0,14
57419,niddiṭṭhapadadosādīnaṃ,nidditthapadadosadinam,1,1,0,0,22
57420,niddiṭṭhakkamena,nidditthakkamena,2,2,0,0,16
57421,pasādādisaddālaṅkārasaṅkhātā,pasadadisaddalankarasankhata,1,1,0,0,28
57422,saddadhammā,saddadhamma,2,2,0,0,11
57423,saddadhamme,saddadhamme,1,1,0,0,11
57424,kiliṭṭhadosabyākiṇṇadosaparihārehi,kilitthadosabyakinnadosapariharehi,1,1,0,0,34
57425,pasādālaṅkāro,pasadalankaro,2,2,0,0,13
57426,sesāpi,sesapi,50,49,1,0,6
57427,yathālābhato,yathalabhato,6,6,0,0,12
57428,ñātabbā,natabba,61,61,0,0,7
57429,saddālaṅkārauddesavaṇṇanā,saddalankarauddesavannana,1,1,0,0,25
57430,dāratā,darata,1,0,1,0,6
57431,atthabyattisamādhayo,atthabyattisamadhayo,1,0,1,0,20
57432,vibhajati,vibhajati,68,63,5,0,9
57433,pasatthi,pasatthi,2,2,0,0,8
57434,pakāsatthatā,pakasatthata,1,1,0,0,12
57435,samāsavuttibāhullaṃ,samasavuttibahullam,1,1,0,0,19
57436,atthapāriṇatyañca,atthaparinatyanca,1,1,0,0,17
57437,rasavantatā,rasavantata,1,1,0,0,11
57438,pajjāpekkhāya,pajjapekkhaya,1,1,0,0,13
57439,pādānamekajātiyasambandhatā,padanamekajatiyasambandhata,1,1,0,0,27
57440,gajjāpekkhāya,gajjapekkhaya,1,1,0,0,13
57441,apharusakkharabāhullaṃ,apharusakkharabahullam,1,1,0,0,22
57442,silesanaṃ,silesanam,1,1,0,0,9
57443,bandhagāravaṃ,bandhagaravam,1,1,0,0,13
57444,udāratā,udarata,3,1,2,0,7
57445,sanāthatā,sanathata,1,1,0,0,9
57446,visiṭṭhavisesanayuttatā,visitthavisesanayuttata,1,1,0,0,23
57447,sabbalokamanoharatā,sabbalokamanoharata,1,1,0,0,19
57448,abhidheyyassa,abhidheyyassa,7,4,3,0,13
57449,lokappatītyanusāriamukhyatthatā,lokappatityanusariamukhyatthata,1,1,0,0,31
57450,ojaudāratā,ojaudarata,1,1,0,0,10
57451,saddatthaguṇā,saddatthaguna,3,3,0,0,13
57452,atthaguṇo,atthaguno,3,3,0,0,9
57453,atthānugāmittā,atthanugamitta,3,3,0,0,14
57454,saddaguṇāva,saddagunava,1,1,0,0,11
57455,saddālaṅkāre,saddalankare,3,3,0,0,12
57456,vibhajituṃ,vibhajitum,114,110,4,0,10
57457,pasannaphaḷikāvali,pasannaphalikavali,1,1,0,0,18
57458,āvunitarattakambalasuttamiva,avunitarattakambalasuttamiva,1,1,0,0,28
57459,pasādanasaṅkhāto,pasadanasankhato,1,1,0,0,16
57460,samāsavuttibāhulyaatthapāriṇatyasaṅkhato,samasavuttibahulyaatthaparinatyasankhato,1,1,0,0,40
57461,rasavantabhāvasaṅkhātakaṇṇamadhuratā,rasavantabhavasankhatakannamadhurata,1,1,0,0,36
57462,sutito,sutito,2,2,0,0,6
57463,sadisatā,sadisata,47,42,5,0,8
57464,gajje,gajje,4,4,0,0,5
57465,sadisatāti,sadisatati,7,4,3,0,10
57466,padānañca,padananca,15,14,1,0,9
57467,tulyaguṇatā,tulyagunata,1,1,0,0,11
57468,atipharusaatisithilabhāvaṃ,atipharusaatisithilabhavam,1,1,0,0,26
57469,samappamāṇamuduguṇo,samappamanamuduguno,1,1,0,0,19
57470,ṭhānakaraṇādisambhūtasabhāgavaṇṇasutīhi,thanakaranadisambhutasabhagavannasutihi,1,1,0,0,39
57471,acchiddaguruguṇo,acchiddaguruguno,1,1,0,0,16
57472,ukkaṭṭhena,ukkatthena,39,36,3,0,10
57473,sajjitabhāvo,sajjitabhavo,1,1,0,0,12
57474,visiṭṭhavisesanapadena,visitthavisesanapadena,1,1,0,0,22
57475,yuttatā,yuttata,10,9,1,0,7
57476,piyaguṇatā,piyagunata,1,1,0,0,10
57477,icchitatthassa,icchitatthassa,8,8,0,0,14
57478,supākaṭabhāvo,supakatabhavo,1,1,0,0,13
57479,lokappatītianatikkantaaññadhammāropanena,lokappatitianatikkantaannadhammaropanena,1,1,0,0,40
57480,amukhyatthatā,amukhyatthata,1,1,0,0,13
57481,ojodāratāti,ojodaratati,1,1,0,0,11
57482,tadatthajotakasaddaguṇopi,tadatthajotakasaddagunopi,1,1,0,0,25
57483,saddaguṇā,saddaguna,1,1,0,0,9
57484,bandhamanenāti,bandhamanenati,2,2,0,0,14
57485,saddālaṅkārapayojanavaṇṇanā,saddalankarapayojanavannana,1,1,0,0,27
57486,sampādayati,sampadayati,6,3,3,0,11
57487,kittimaccantanimmalaṃ,kittimaccantanimmalam,1,0,1,0,21
57488,saddālaṅkārasabbhāvehi,saddalankarasabbhavehi,1,1,0,0,22
57489,samiddho,samiddho,34,34,0,0,8
57490,kavihadayahilādakārī,kavihadayahiladakari,1,1,0,0,20
57491,bandhantānaṃ,bandhantanam,7,5,2,0,12
57492,accantanimmalaṃ,accantanimmalam,3,1,2,0,15
57493,atisayaparisuddhaṃ,atisayaparisuddham,1,1,0,0,18
57494,aguṇalesenāpa,agunalesenapa,1,1,0,0,13
57495,nālimpattā,nalimpatta,1,1,0,0,10
57496,kittiṃ,kittim,51,43,8,0,6
57497,guṇaghosaṃ,gunaghosam,1,1,0,0,10
57498,nipphādeti,nipphadeti,55,55,0,0,10
57499,saddālaṅkārasaṅkhātadasavidhasaddadhammehi,saddalankarasankhatadasavidhasaddadhammehi,1,1,0,0,42
57500,pajjādibandho,pajjadibandho,1,1,0,0,13
57501,niravajjattā,niravajjatta,2,2,0,0,12
57502,pīṇento,pinento,4,4,0,0,7
57503,racayantānaṃ,racayantanam,1,1,0,0,12
57504,appakadosenāpi,appakadosenapi,1,1,0,0,14
57505,asammissattā,asammissatta,4,4,0,0,12
57506,atiparisuddhaṃ,atiparisuddham,5,4,1,0,14
57507,bandhanavisayabhūtayasorāsiṃ,bandhanavisayabhutayasorasim,1,1,0,0,28
57508,yathāvuttadasavidhaguṇapariggaho,yathavuttadasavidhagunapariggaho,1,1,0,0,32
57509,saussāhaṃ,saussaham,18,12,6,0,9
57510,kātabboti,katabboti,176,152,24,0,9
57511,kavimanoharoti,kavimanoharoti,1,0,1,0,14
57512,saddālaṅkāraniddesavaṇṇanā,saddalankaraniddesavannana,1,1,0,0,26
57513,adūrāhitasambandhasubhagā,adurahitasambandhasubhaga,1,0,1,0,25
57514,supasiddhābhidheyyā,supasiddhabhidheyya,1,0,1,0,19
57515,yathoddesānamesaṃ,yathoddesanamesam,1,1,0,0,17
57516,niddesaṃ,niddesam,50,50,0,0,8
57517,adūra,adura,1,0,1,0,5
57518,adūre,adure,9,6,3,0,5
57519,adūrena,adurena,1,1,0,0,7
57520,adūrāhitakriyākattukammādipadavasena,adurahitakriyakattukammadipadavasena,1,1,0,0,36
57521,anvayo,anvayo,13,11,2,0,6
57522,supasiddho,supasiddho,3,1,2,0,10
57523,suppakāso,suppakaso,1,1,0,0,9
57524,sugammo,sugammo,1,1,0,0,7
57525,bhāvattho,bhavattho,24,24,0,0,9
57526,sabhāvagambhīrattā,sabhavagambhiratta,2,2,0,0,18
57527,kavīna,kavina,2,2,0,0,6
57528,dhippāya,dhippaya,2,2,0,0,8
57529,masaddagocaraṃ,masaddagocaram,2,2,0,0,14
57530,phurantaṃ,phurantam,3,2,1,0,9
57531,mudukamhi,mudukamhi,3,3,0,0,9
57532,bhāvāvagamā,bhavavagama,3,2,1,0,11
57533,katassamā,katassama,3,2,1,0,9
57534,pakāsayantyā,pakasayantya,2,2,0,0,12
57535,katiyo,katiyo,2,2,0,0,6
57536,tannāmakaṃ,tannamakam,5,5,0,0,10
57537,uppādayati,uppadayati,16,15,1,0,10
57538,tamudāharati,tamudaharati,10,10,0,0,12
57539,saddālaṅkārādīnaṃ,saddalankaradinam,1,1,0,0,17
57540,adūrāhite,adurahite,1,0,1,0,9
57541,āsannapadese,asannapadese,10,9,1,0,12
57542,tadupacārena,tadupacarena,17,15,2,0,12
57543,laddhakriyāyogakattukammādipadānaṃ,laddhakriyayogakattukammadipadanam,1,1,0,0,34
57544,vinyāsavasena,vinyasavasena,1,1,0,0,13
57545,icchitatthapatītikkamena,icchitatthapatitikkamena,1,1,0,0,24
57546,aññamaññāpekkhalakkhaṇakriyākārakayogo,annamannapekkhalakkhanakriyakarakayogo,1,1,0,0,38
57547,pasiddhatthavisaye,pasiddhatthavisaye,1,1,0,0,18
57548,saddapayogato,saddapayogato,1,1,0,0,13
57549,atipākaṭo,atipakato,1,1,0,0,9
57550,pasādanāmakaṃ,pasadanamakam,1,1,0,0,13
57551,āhitoti,ahitoti,5,2,3,0,7
57552,upacaritattā,upacaritatta,4,4,0,0,12
57553,adūro,aduro,1,1,0,0,5
57554,subhagāti,subhagati,3,2,1,0,9
57555,pasiddhoti,pasiddhoti,2,2,0,0,10
57556,adhippāyattho,adhippayattho,7,7,0,0,13
57557,pakatigambhīro,pakatigambhiro,1,1,0,0,14
57558,asaddagocaraṃ,asaddagocaram,1,0,1,0,13
57559,avisayaṃ,avisayam,7,7,0,0,8
57560,cāpentaṃ,capentam,1,1,0,0,8
57561,kavīnadhippāyaṃ,kavinadhippayam,1,0,1,0,15
57562,kavīnamajjhāsayaṃ,kavinamajjhasayam,1,1,0,0,17
57563,saddatthavisaye,saddatthavisaye,1,1,0,0,15
57564,kataparicayā,kataparicaya,6,5,1,0,12
57565,padatthāvabodhena,padatthavabodhena,1,1,0,0,17
57566,ākatiyo,akatiyo,1,0,1,0,7
57567,saddasaddatthānaṃ,saddasaddatthanam,1,1,0,0,17
57568,ākārā,akara,137,119,18,0,5
57569,pakāsayanti,pakasayanti,3,2,1,0,11
57570,adhippāyatthaṃ,adhippayattham,21,21,0,0,14
57571,jotentīti,jotentiti,6,4,2,0,9
57572,mbujodare,mbujodare,1,0,1,0,9
57573,sabhāvamadhurapakatimukhaṃ,sabhavamadhurapakatimukham,1,1,0,0,26
57574,sajjantā,sajjanta,2,2,0,0,8
57575,sobhayamānā,sobhayamana,3,3,0,0,11
57576,adharānaṃ,adharanam,1,1,0,0,9
57577,raṃsiyo,ramsiyo,24,23,1,0,7
57578,supakkabimbaphalopamaoṭṭhayugaḷavinissaṭabahutarakanticchitābhā,supakkabimbaphalopamaotthayugalavinissatabahutarakanticchitabha,1,1,0,0,63
57579,muninoti,muninoti,12,7,5,0,8
57580,sutattā,sutatta,45,45,0,0,7
57581,ambujodare,ambujodare,2,0,2,0,10
57582,kālopanatapupphakāsaramaṇīye,kalopanatapupphakasaramaniye,1,1,0,0,28
57583,padumabbhantare,padumabbhantare,1,1,0,0,15
57584,pavattamānā,pavattamana,155,155,0,0,11
57585,aruṇaraṃsīva,arunaramsiva,1,0,1,0,12
57586,bālasūriyaraṃsiyo,balasuriyaramsiyo,1,1,0,0,17
57587,virājanti,virajanti,1,1,0,0,9
57588,alaṅkaronte,alankaronte,2,1,1,0,11
57589,pakatisundaramukhaṃ,pakatisundaramukham,1,1,0,0,19
57590,adhararaṃsiyo,adhararamsiyo,1,0,1,0,13
57591,oṭṭhadvayato,otthadvayato,1,1,0,0,12
57592,nikkhantakantisamūhā,nikkhantakantisamuha,1,1,0,0,20
57593,vikasanānurūpakālābhimukhe,vikasananurupakalabhimukhe,1,1,0,0,26
57594,upaḍḍhavikasiteti,upaddhavikasiteti,1,1,0,0,17
57595,aruṇaraṃsī,arunaramsi,1,0,1,0,10
57596,bālasūriyaraṃsīva,balasuriyaramsiva,1,1,0,0,17
57597,adūrasambandhaṃ,adurasambandham,1,1,0,0,15
57598,pasiddhatthañca,pasiddhatthanca,1,1,0,0,15
57599,pasādaguṇo,pasadaguno,1,1,0,0,10
57600,adhararaṃsīnaṃ,adhararamsinam,1,1,0,0,14
57601,munisambandho,munisambandho,1,1,0,0,13
57602,sutānumitasambandhesu,sutanumitasambandhesu,1,1,0,0,21
57603,sutasambandhassa,sutasambandhassa,1,1,0,0,16
57604,balavattā,balavatta,20,20,0,0,9
57605,sutānumitesu,sutanumitesu,5,5,0,0,12
57606,sutasambandho,sutasambandho,2,2,0,0,13
57607,balavā,balava,457,433,24,0,6
57608,paribhāsendusere,paribhasendusere,1,1,0,0,16
57609,ambujassa,ambujassa,2,2,0,0,9
57610,udaranti,udaranti,2,2,0,0,8
57611,nākulo,nakulo,1,0,1,0,6
57612,ekatthavuttiyā,ekatthavuttiya,1,1,0,0,14
57613,bāhulyaṃ,bahulyam,3,2,1,0,8
57614,bhiyyobhāvo,bhiyyobhavo,15,14,1,0,11
57615,ityanuvaditvā,ityanuvaditva,1,1,0,0,13
57616,samāsabāhullalakkhaṇo,samasabahullalakkhano,1,1,0,0,21
57617,vuttirūpassa,vuttirupassa,1,1,0,0,12
57618,tappadhānattā,tappadhanatta,6,6,0,0,13
57619,pajjassa,pajjassa,2,2,0,0,8
57620,agahano,agahano,6,5,1,0,7
57621,hadayaṅgamo,hadayangamo,2,2,0,0,11
57622,ojaguṇaṃ,ojagunam,1,1,0,0,8
57623,samāsabāhulyaṃ,samasabahulyam,1,0,1,0,14
57624,bhinnatthesu,bhinnatthesu,1,1,0,0,12
57625,pavattasaddānaṃ,pavattasaddanam,1,1,0,0,15
57626,ekatthapavattilakkhaṇassa,ekatthapavattilakkhanassa,1,1,0,0,25
57627,bahulatā,bahulata,8,4,4,0,8
57628,gajjabandhassa,gajjabandhassa,1,1,0,0,14
57629,jīvitasīsena,jivitasisena,2,2,0,0,12
57630,hadayasaṅkhataṃ,hadayasankhatam,1,1,0,0,15
57631,nibyākulo,nibyakulo,1,1,0,0,9
57632,piyabhūto,piyabhuto,1,1,0,0,9
57633,pajjabandhepi,pajjabandhepi,1,1,0,0,13
57634,bahulassa,bahulassa,3,3,0,0,9
57635,bāhulyanti,bahulyanti,1,1,0,0,10
57636,gajjabandhādhikārassābhāvā,gajjabandhadhikarassabhava,1,1,0,0,26
57637,pajjavisayassa,pajjavisayassa,1,1,0,0,14
57638,ojaguṇassa,ojagunassa,1,1,0,0,10
57639,munindamandasañjātahāsacandanalimpitā,munindamandasanjatahasacandanalimpita,1,0,1,0,37
57640,tassevekonā,tassevekona,1,0,1,0,11
57641,īsakaṃ,isakam,117,106,11,0,6
57642,taṃsabhāvattā,tamsabhavatta,27,27,0,0,13
57643,yasassa,yasassa,66,63,3,0,7
57644,dhavalattarūpattā,dhavalattarupatta,1,1,0,0,17
57645,upadehitā,upadehita,1,1,0,0,9
57646,kilasayāni,kilasayani,1,1,0,0,10
57647,idameve,idameve,3,3,0,0,7
57648,niyamābhāvato,niyamabhavato,25,25,0,0,13
57649,pakativaṇṇapariccāgena,pakativannapariccagena,1,1,0,0,22
57650,gāhāpitattā,gahapitatta,1,1,0,0,11
57651,saguṇassa,sagunassa,1,1,0,0,9
57652,tādisavisiṭṭhassa,tadisavisitthassa,1,1,0,0,17
57653,munindasseva,munindasseva,1,1,0,0,12
57654,tādisassābhāvā,tadisassabhava,2,2,0,0,14
57655,adharapallavo,adharapallavo,2,0,2,0,13
57656,accāsannadesiyopi,accasannadesiyopi,1,1,0,0,17
57657,bahumantabbo,bahumantabbo,1,1,0,0,12
57658,massānubhāvoti,massanubhavoti,1,1,0,0,14
57659,pemāvabandhahadaye,pemavabandhahadaye,3,2,1,0,18
57660,jinasmiṃ,jinasmim,3,2,1,0,8
57661,kumatayo,kumatayo,4,3,1,0,8
57662,bhavatha,bhavatha,84,80,4,0,8
57663,ppasannā,ppasanna,2,2,0,0,8
57664,muggadugga,muggadugga,2,2,0,0,10
57665,saṃsārasāgarasamuttaraṇāvasānaṃ,samsarasagarasamuttaranavasanam,2,2,0,0,31
57666,iccaparamudāharaṇaṃ,iccaparamudaharanam,2,2,0,0,19
57667,evametādiso,evametadiso,1,1,0,0,11
57668,jānitabboti,janitabboti,46,30,16,0,11
57669,tasseveko,tasseveko,3,3,0,0,9
57670,nādharapallavo,nadharapallavo,1,1,0,0,14
57671,saddābhāvoti,saddabhavoti,1,1,0,0,12
57672,kintu,kintu,104,104,0,0,5
57673,pakkantavisayo,pakkantavisayo,4,4,0,0,14
57674,pasiddhavisayo,pasiddhavisayo,5,4,1,0,14
57675,anubhūtavisayo,anubhutavisayo,4,3,1,0,14
57676,nāpekkhate,napekkhate,4,4,0,0,10
57677,nighātiya,nighatiya,5,5,0,0,9
57678,susuddhasantāno,susuddhasantano,2,2,0,0,15
57679,pūjānañca,pujananca,2,2,0,0,9
57680,sadāraho,sadaraho,2,2,0,0,8
57681,buddhānussatimādito,buddhanussatimadito,2,2,0,0,19
57682,pakkanto,pakkanto,129,121,8,0,8
57683,aggiṃ,aggim,658,632,26,0,5
57684,pakkhanda,pakkhanda,7,6,1,0,9
57685,pabbataggā,pabbatagga,2,2,0,0,10
57686,pate,pate,12,12,0,0,4
57687,ñātakārīhi,natakarihi,3,3,0,0,10
57688,atītaṃ,atitam,1384,1298,86,0,6
57689,nānusocāmi,nanusocami,5,5,0,0,10
57690,nappajappāma,nappajappama,3,3,0,0,12
57691,nāgataṃ,nagatam,25,21,4,0,7
57692,paccuppannena,paccuppannena,60,54,6,0,13
57693,yāpemi,yapemi,16,16,0,0,6
57694,pasīdati,pasidati,256,242,14,0,8
57695,tuttaravākyaṭṭho,tuttaravakyattho,1,1,0,0,16
57696,pubbavākye,pubbavakye,13,13,0,0,10
57697,saddameva,saddameva,19,18,1,0,9
57698,gamayati,gamayati,32,32,0,0,8
57699,natibhājanamaccuḷāraṃ,natibhajanamaccularam,2,2,0,0,21
57700,puññākaraṃ,punnakaram,2,2,0,0,10
57701,bhuvanamaṇḍalasotthibhūtaṃ,bhuvanamandalasotthibhutam,2,2,0,0,26
57702,cakkhusotasatigocarataṃ,cakkhusotasatigocaratam,2,2,0,0,23
57703,sameto,sameto,14,11,3,0,6
57704,dosāridappamathane,dosaridappamathane,2,2,0,0,18
57705,karaso,karaso,2,2,0,0,6
57706,budhānaṃ,budhanam,2,2,0,0,8
57707,pubbavākyopātto,pubbavakyopatto,1,1,0,0,15
57708,uttaravākye,uttaravakye,9,9,0,0,11
57709,saddopādānaṃ,saddopadanam,1,1,0,0,12
57710,sākaṅkhe,sakankhe,1,1,0,0,8
57711,ūnattaṃ,unattam,29,25,4,0,7
57712,candanacuṇṇamiva,candanacunnamiva,1,1,0,0,16
57713,ālepitā,alepita,1,1,0,0,7
57714,rukkhalatādīnaṃ,rukkhalatadinam,2,2,0,0,15
57715,pakatirattāni,pakatirattani,1,1,0,0,13
57716,kisalayāni,kisalayani,1,1,0,0,10
57717,saguṇapariccāgena,sagunapariccagena,1,1,0,0,17
57718,dantāvaraṇasaṅkhātapallavo,dantavaranasankhatapallavo,1,1,0,0,26
57719,raṃsisaṃsaṭṭhopi,ramsisamsatthopi,1,1,0,0,16
57720,samīpaṭṭhopi,samipatthopi,1,1,0,0,12
57721,agahanasamāsabāhulyaṃ,agahanasamasabahulyam,1,1,0,0,21
57722,aññāṇā,annana,45,43,2,0,6
57723,tumhesu,tumhesu,151,149,2,0,7
57724,pavattitadaḷhapemānubandhacitte,pavattitadalhapemanubandhacitte,1,1,0,0,31
57725,dayāsahite,dayasahite,1,1,0,0,10
57726,visayabhūte,visayabhute,24,23,1,0,11
57727,appasannā,appasanna,75,73,2,0,9
57728,dāruṇo,daruno,84,82,2,0,6
57729,duggo,duggo,4,1,3,0,5
57730,gantumasakkuṇeyyo,gantumasakkuneyyo,1,1,0,0,17
57731,saṃsārasāgaro,samsarasagaro,5,4,1,0,13
57732,samuttaraṇaṃ,samuttaranam,1,1,0,0,12
57733,pariyantappattiyeva,pariyantappattiyeva,1,1,0,0,19
57734,niccasambandhoti,niccasambandhoti,2,2,0,0,16
57735,pakkantatthavisayo,pakkantatthavisayo,1,1,0,0,18
57736,pasiddhatthavisayo,pasiddhatthavisayo,1,1,0,0,18
57737,anubhūtatthavisayo,anubhutatthavisayo,2,2,0,0,18
57738,nāpekkhati,napekkhati,3,3,0,0,10
57739,niddiṭṭha,niddittha,2,2,0,0,9
57740,atītena,atitena,40,38,2,0,7
57741,buddhasaddena,buddhasaddena,7,7,0,0,13
57742,vacanīyavisayo,vacaniyavisayo,1,1,0,0,14
57743,pasiddhabuddhapadatthavisayo,pasiddhabuddhapadatthavisayo,1,1,0,0,28
57744,pasīdatī,pasidati,11,11,0,0,8
57745,ananusocananappajappanayāpanasaṅkhātavijānanavasena,ananusocananappajappanayapanasankhatavijananavasena,1,1,0,0,51
57746,budhānanti,budhananti,1,1,0,0,10
57747,cakkhusotasatīnaṃ,cakkhusotasatinam,1,1,0,0,17
57748,gocarataṃ,gocaratam,2,1,1,0,9
57749,visayabhāvaṃ,visayabhavam,26,26,0,0,12
57750,dosārīnaṃ,dosarinam,1,0,1,0,9
57751,kilesapaccatthikānaṃ,kilesapaccatthikanam,4,4,0,0,20
57752,dappamathane,dappamathane,1,0,1,0,12
57753,dappamaddane,dappamaddane,1,1,0,0,12
57754,ekaraso,ekaraso,27,21,6,0,7
57755,padhānakicco,padhanakicco,1,1,0,0,12
57756,samiddhivanto,samiddhivanto,1,1,0,0,13
57757,payojito,payojito,12,12,0,0,8
57758,saddopādāne,saddopadane,1,1,0,0,11
57759,saṃsayamuppādayamāno,samsayamuppadayamano,1,1,0,0,20
57760,padābhidheyyavisayaṃ,padabhidheyyavisayam,1,0,1,0,20
57761,samāsabyāsasambhavaṃ,samasabyasasambhavam,2,0,2,0,20
57762,ojova,ojova,1,0,1,0,5
57763,pacurasaddābhidheyyo,pacurasaddabhidheyyo,1,1,0,0,20
57764,saṃkhittapadehi,samkhittapadehi,1,1,0,0,15
57765,yatthappakehi,yatthappakehi,1,1,0,0,13
57766,pacurapadehi,pacurapadehi,1,1,0,0,12
57767,samāsabyāsato,samasabyasato,6,6,0,0,13
57768,pariṇatabhāvo,parinatabhavo,8,8,0,0,13
57769,sasatthe,sasatthe,1,1,0,0,8
57770,ojovāti,ojovati,1,0,1,0,7
57771,tyubhayampi,tyubhayampi,1,1,0,0,11
57772,abhidheyyavisayaṃ,abhidheyyavisayam,1,0,1,0,17
57773,vitthārasaṃkhittatthavisayavantaṃ,vittharasamkhittatthavisayavantam,1,1,0,0,33
57774,saṅkhepavitthāradvayena,sankhepavittharadvayena,1,1,0,0,23
57775,nipphattivantaṃ,nipphattivantam,1,1,0,0,15
57776,pariṇatippakāsako,parinatippakasako,1,1,0,0,17
57777,saddadhammo,saddadhammo,1,1,0,0,11
57778,atthadhammo,atthadhammo,1,1,0,0,11
57779,saddaguṇo,saddaguno,3,3,0,0,9
57780,atthaguṇoti,atthagunoti,1,1,0,0,11
57781,pāriṇatyasseti,parinatyasseti,1,1,0,0,14
57782,pariṇatassa,parinatassa,4,4,0,0,11
57783,pāriṇatyapakkhe,parinatyapakkhe,1,1,0,0,15
57784,tappakāsakaganthassa,tappakasakaganthassa,1,1,0,0,20
57785,jotayitvāne,jotayitvane,1,0,1,0,11
57786,pacurapadābhihito,pacurapadabhihito,1,1,0,0,17
57787,buddhavaṃso,buddhavamso,40,39,1,0,11
57788,saṅkheparūpena,sankheparupena,1,1,0,0,14
57789,jotayi,jotayi,2,1,1,0,6
57790,sapariyattikaṃ,sapariyattikam,1,1,0,0,14
57791,navalokuttarasaddhammaṃ,navalokuttarasaddhammam,1,1,0,0,23
57792,saṃsārasāgarapariyantamupanetvā,samsarasagarapariyantamupanetva,1,1,0,0,31
57793,aggikhandhova,aggikhandhova,6,5,1,0,13
57794,mahātejena,mahatejena,1,1,0,0,10
57795,anaññasādhāraṇarūpakāyasampattiyā,anannasadharanarupakayasampattiya,1,1,0,0,33
57796,pajjalitvā,pajjalitva,11,11,0,0,10
57797,sāvakehi,savakehi,149,148,1,0,8
57798,khandhaparinibbānena,khandhaparinibbanena,17,17,0,0,20
57799,parinibbutoti,parinibbutoti,54,31,23,0,13
57800,sakalabuddhavaṃse,sakalabuddhavamse,1,1,0,0,17
57801,vattamānoti,vattamanoti,13,13,0,0,11
57802,matassāpi,matassapi,4,2,2,0,9
57803,jenapādambujadvaye,jenapadambujadvaye,2,1,1,0,18
57804,maraṇamāpannassāpi,maranamapannassapi,1,1,0,0,18
57805,aṭṭhī,atthi,49,48,1,0,5
57806,dhūlittaṃ,dhulittam,1,1,0,0,9
57807,pāpuṇantu,papunantu,17,16,1,0,9
57808,kasmāti,kasmati,202,178,24,0,7
57809,jenā,jena,2,1,1,0,4
57810,ambujāniva,ambujaniva,1,1,0,0,10
57811,dvaye,dvaye,21,20,1,0,5
57812,paṇatigedheneva,panatigedheneva,1,1,0,0,15
57813,kathamahaṃ,kathamaham,13,12,1,0,10
57814,paṇamāmī,panamami,2,2,0,0,8
57815,tyadhippāyo,tyadhippayo,1,1,0,0,11
57816,matthaki,matthaki,1,0,1,0,8
57817,aṭṭhīni,atthini,139,135,4,0,7
57818,atisukhumarajattaṃ,atisukhumarajattam,1,1,0,0,18
57819,āsīsanaṃ,asisanam,5,4,1,0,8
57820,kusalakammena,kusalakammena,26,26,0,0,13
57821,jinapaṭibaddhacaraṇapadumayugaḷe,jinapatibaddhacaranapadumayugale,1,1,0,0,32
57822,siripāde,siripade,3,3,0,0,8
57823,upalimpateva,upalimpateva,1,1,0,0,12
57824,vandanābhilāsena,vandanabhilasena,1,1,0,0,16
57825,muddhanā,muddhana,8,8,0,0,8
57826,tyabhilāso,tyabhilaso,1,1,0,0,10
57827,aṭṭhīti,atthiti,11,7,4,0,7
57828,rajaso,rajaso,2,2,0,0,6
57829,imeti,imeti,65,24,41,0,5
57830,ambujānīti,ambujaniti,2,2,0,0,10
57831,dvayanti,dvayanti,6,6,0,0,8
57832,niccaṃpaṇatigedho,niccampanatigedho,2,0,2,0,17
57833,tikkhapaññāna,tikkhapannana,1,0,1,0,13
57834,mabhiyogato,mabhiyogato,1,0,1,0,11
57835,byāsattamevassa,byasattamevassa,1,1,0,0,15
57836,iccatri,iccatri,1,0,1,0,7
57837,paṇatiyaṃ,panatiyam,1,0,1,0,9
57838,adhikacchando,adhikacchando,1,1,0,0,13
57839,pariṇatabhāvasaṅkhāto,parinatabhavasankhato,2,2,0,0,21
57840,tikkhapaññānaṃ,tikkhapannanam,4,2,2,0,14
57841,sātisayamatīnaṃ,satisayamatinam,1,1,0,0,15
57842,abhiyogato,abhiyogato,5,1,4,0,10
57843,punappunappavattitaparicayabalena,punappunappavattitaparicayabalena,1,1,0,0,33
57844,saṃkhittassatthassa,samkhittassatthassa,1,1,0,0,19
57845,pakāsitabhāvaṃ,pakasitabhavam,2,2,0,0,14
57846,anantaragāthāyaṃ,anantaragathayam,5,5,0,0,16
57847,vuttakkamena,vuttakkamena,13,13,0,0,12
57848,nirantarapaṇāme,nirantarapaname,1,1,0,0,15
57849,adhikakattukāmatākusalacchando,adhikakattukamatakusalacchando,1,1,0,0,30
57850,saddatthaguṇo,saddatthaguno,1,1,0,0,13
57851,sukhumabuddhimantānaṃ,sukhumabuddhimantanam,1,1,0,0,21
57852,ganthavisayabhūtena,ganthavisayabhutena,1,1,0,0,19
57853,nirantarābhyāseneva,nirantarabhyaseneva,1,1,0,0,19
57854,vattu,vattu,18,18,0,0,5
57855,pāriṇatyeneva,parinatyeneva,1,1,0,0,13
57856,bhavanato,bhavanato,20,20,0,0,9
57857,sijjhatīti,sijjhatiti,90,88,2,0,10
57858,paṇatīti,panatiti,1,1,0,0,8
57859,gedhoti,gedhoti,9,9,0,0,7
57860,yuñjananti,yunjananti,1,1,0,0,10
57861,padāsattiranuppāsavasā,padasattiranuppasavasa,1,0,1,0,22
57862,mādhuriyamavadhārayamāha,madhuriyamavadharayamaha,1,1,0,0,24
57863,madhuratta,madhuratta,1,0,1,0,10
57864,savanīyattena,savaniyattena,1,1,0,0,13
57865,manoharattaṃ,manoharattam,3,3,0,0,12
57866,vākyālaṅkārāni,vakyalankarani,1,1,0,0,14
57867,samānāni,samanani,13,13,0,0,8
57868,uttaruttarehi,uttaruttarehi,1,1,0,0,13
57869,āsatti,asatti,20,13,7,0,6
57870,ṭhānādināyathākathañci,thanadinayathakathanci,1,1,0,0,22
57871,samasutīnaṃ,samasutinam,1,1,0,0,11
57872,āsannatā,asannata,12,12,0,0,8
57873,paṭhamappayuttassakkharassa,pathamappayuttassakkharassa,1,1,0,0,27
57874,pakkhepo,pakkhepo,5,5,0,0,8
57875,anuppāso,anuppaso,10,7,3,0,8
57876,kīdisā,kidisa,75,72,3,0,6
57877,paṭhamābhihitā,pathamabhihita,1,1,0,0,14
57878,ṭhānamattāsaṃyogādinā,thanamattasamyogadina,1,1,0,0,21
57879,sarabyañjanalakkhaṇassa,sarabyanjanalakkhanassa,1,1,0,0,23
57880,āvutti,avutti,8,7,1,0,6
57881,samānapadāsatti,samanapadasatti,1,1,0,0,15
57882,tadubhayaṃ,tadubhayam,460,427,33,0,10
57883,viraso,viraso,1,1,0,0,6
57884,nassādīyate,nassadiyate,1,1,0,0,11
57885,paṭipajjitabbaṃ,patipajjitabbam,284,268,16,0,15
57886,silesasamatānvitantuccantameva,silesasamatanvitantuccantameva,1,1,0,0,30
57887,lakkhiyamubhayatthodāharati,lakkhiyamubhayatthodaharati,1,1,0,0,27
57888,yade,yade,4,4,0,0,4
57889,madhuraguṇaṃ,madhuragunam,2,2,0,0,12
57890,madhuri,madhuri,2,0,2,0,7
57891,savanīyabhāvato,savaniyabhavato,1,1,0,0,15
57892,vākyāvayavasaṅkhātānaṃ,vakyavayavasankhatanam,1,1,0,0,22
57893,uparūparipadehi,uparuparipadehi,2,2,0,0,15
57894,ṭhānakaraṇādinā,thanakaranadina,1,1,0,0,15
57895,pubbuccāritavaṇṇānaṃ,pubbuccaritavannanam,2,2,0,0,20
57896,pakkhipanañcāti,pakkhipanancati,1,1,0,0,15
57897,pubbāparavaṇṇānaṃ,pubbaparavannanam,1,1,0,0,17
57898,ṭhānamattākaraṇādīhi,thanamattakaranadihi,1,1,0,0,20
57899,āsannasutisaṅkhatavaṇṇavutti,asannasutisankhatavannavutti,1,1,0,0,28
57900,sarabyañjanasabhāvānaṃ,sarabyanjanasabhavanam,1,1,0,0,22
57901,udāharaṇamādisati,udaharanamadisati,2,2,0,0,17
57902,assādanīyo,assadaniyo,5,5,0,0,10
57903,vakkhamānāhi,vakkhamanahi,2,2,0,0,12
57904,silesasamatāhi,silesasamatahi,1,1,0,0,14
57905,assādanīyaṃ,assadaniyam,1,1,0,0,11
57906,madhurassa,madhurassa,5,5,0,0,10
57907,āsattīti,asattiti,1,1,0,0,8
57908,pakkhepoti,pakkhepoti,2,2,0,0,10
57909,bhedoti,bhedoti,66,46,20,0,7
57910,āvuttīti,avuttiti,2,2,0,0,8
57911,mahussavo,mahussavo,7,4,3,0,9
57912,abhisambodhiṃ,abhisambodhim,30,27,3,0,13
57913,samadhigato,samadhigato,6,6,0,0,11
57914,catusatipaṭṭhānādibhedassa,catusatipatthanadibhedassa,1,1,0,0,26
57915,sattatiṃsabodhipakkhiyasaṅkhātassa,sattatimsabodhipakkhiyasankhatassa,1,1,0,0,34
57916,tividhe,tividhe,49,43,6,0,7
57917,dīghatākataṃ,dighatakatam,1,1,0,0,12
57918,ṭhānakataṃ,thanakatam,1,1,0,0,10
57919,saṃyogakataṃ,samyogakatam,1,1,0,0,12
57920,uppādanavasena,uppadanavasena,23,23,0,0,14
57921,sampāpuṇi,sampapuni,103,103,0,0,9
57922,kāyānupassanāsatipaṭṭhānādipabhedassa,kayanupassanasatipatthanadipabhedassa,1,1,0,0,37
57923,sattatiṃsabodhipakkhiyadhammassa,sattatimsabodhipakkhiyadhammassa,1,1,0,0,32
57924,mahābhivuddhi,mahabhivuddhi,1,1,0,0,13
57925,kāmādilokattaye,kamadilokattaye,1,1,0,0,15
57926,dīghakālavasena,dighakalavasena,3,3,0,0,15
57927,saṃyogavasena,samyogavasena,3,3,0,0,13
57928,dhiṃ,dhim,2,2,0,0,4
57929,dhanitato,dhanitato,1,1,0,0,9
57930,āsannatāti,asannatati,1,1,0,0,10
57931,abhisambujjhati,abhisambujjhati,50,48,2,0,15
57932,goceti,goceti,1,1,0,0,6
57933,puṅgavoti,pungavoti,5,1,4,0,9
57934,munindamandahāsā,munindamandahasa,2,0,2,0,16
57935,kundasandohavibbhamā,kundasandohavibbhama,2,0,2,0,20
57936,disanta,disanta,2,1,1,0,7
57937,manudhāvanti,manudhavanti,2,0,2,0,12
57938,hasantā,hasanta,20,17,3,0,7
57939,candakantiyo,candakantiyo,4,2,2,0,12
57940,kundānaṃ,kundanam,3,2,1,0,8
57941,manuññā,manunna,24,24,0,0,7
57942,hasitāni,hasitani,3,3,0,0,8
57943,kantiyo,kantiyo,9,8,1,0,7
57944,sobhāyo,sobhayo,1,1,0,0,7
57945,viḍambayantā,vidambayanta,1,1,0,0,12
57946,anuvicaranti,anuvicaranti,14,14,0,0,12
57947,kārasahitassa,karasahitassa,1,1,0,0,13
57948,cānuvattanaṃ,canuvattanam,1,1,0,0,12
57949,indanīladaladvandasundaraṃ,indaniladaladvandasundaram,3,2,1,0,26
57950,sirimandiraṃ,sirimandiram,3,2,1,0,12
57951,munindanayanadvandaṃ,munindanayanadvandam,5,3,2,0,20
57952,ndīvarajjutiṃ,ndivarajjutim,2,2,0,0,13
57953,supupphitakundakusumarāsisadisalīlāvantā,supupphitakundakusumarasisadisalilavanta,1,1,0,0,40
57954,hasitā,hasita,3,3,0,0,6
57955,nimmalacandakiraṇe,nimmalacandakirane,1,1,0,0,18
57956,nindantā,nindanta,3,2,1,0,8
57957,disantaṃ,disantam,2,1,1,0,8
57958,disāpariyantaṃ,disapariyantam,1,1,0,0,14
57959,anudhāvanti,anudhavanti,6,5,1,0,11
57960,vidhāvantīti,vidhavantiti,2,1,1,0,12
57961,kārasahita,karasahita,3,3,0,0,10
57962,mandahāsāti,mandahasati,1,1,0,0,11
57963,sandohoti,sandohoti,1,1,0,0,9
57964,disāyeva,disayeva,3,3,0,0,8
57965,antanti,antanti,6,6,0,0,7
57966,kāravaṇṇāvuttiyā,karavannavuttiya,1,1,0,0,16
57967,indanīlamaṇisakalikāyugaḷamiva,indanilamanisakalikayugalamiva,1,1,0,0,30
57968,sobhāya,sobhaya,11,11,0,0,7
57969,nivāsaṭṭhānabhūtaṃ,nivasatthanabhutam,6,6,0,0,18
57970,indīvarajjutiṃ,indivarajjutim,1,0,1,0,14
57971,nīluppalakantiṃ,niluppalakantim,1,1,0,0,15
57972,anubhoti,anubhoti,78,71,7,0,8
57973,indīvarajjutisamānāti,indivarajjutisamanati,1,1,0,0,21
57974,linalolālimālinī,linalolalimalini,2,1,1,0,16
57975,āvuttito,avuttito,2,2,0,0,8
57976,anuppāsoti,anuppasoti,1,1,0,0,10
57977,netyāha,netyaha,1,1,0,0,7
57978,komalehi,komalehi,2,0,2,0,8
57979,sukumārehi,sukumarehi,1,1,0,0,10
57980,silāghanīyo,silaghaniyo,1,1,0,0,11
57981,silesavirodhittā,silesavirodhitta,1,1,0,0,16
57982,jātikusumadāmaṃ,jatikusumadamam,1,1,0,0,15
57983,linānaṃ,linanam,2,0,2,0,7
57984,byādhitānaṃ,byadhitanam,6,6,0,0,11
57985,lolānaṃ,lolanam,2,0,2,0,7
57986,kusumarasārabbha,kusumarasarabbha,1,1,0,0,16
57987,lolupānaṃ,lolupanam,1,1,0,0,9
57988,alīnaṃ,alinam,32,17,15,0,6
57989,vuttānuppāsopi,vuttanuppasopi,1,1,0,0,14
57990,pasaṃsiyoti,pasamsiyoti,9,1,8,0,11
57991,sabbakomalavaṇṇehī,sabbakomalavannehi,1,0,1,0,18
57992,sukumārakkharehi,sukumarakkharehi,1,1,0,0,16
57993,vaṇṇāvuttilakkhaṇo,vannavuttilakkhano,1,1,0,0,18
57994,silesālaṅkāraviruddhattā,silesalankaraviruddhatta,1,1,0,0,24
57995,jātisumanamālikā,jatisumanamalika,1,1,0,0,16
57996,byāvaṭānaṃ,byavatanam,2,2,0,0,10
57997,patantānaṃ,patantanam,1,1,0,0,10
57998,gandhaluddhānaṃ,gandhaluddhanam,1,1,0,0,15
57999,pantiyuttāti,pantiyuttati,1,1,0,0,12
58000,kārasseva,karasseva,4,4,0,0,9
58001,punappunappayogena,punappunappayogena,1,1,0,0,18
58002,komalavaṇṇāvutti,komalavannavutti,1,1,0,0,16
58003,mālatīnaṃ,malatinam,1,1,0,0,9
58004,mālāti,malati,22,8,14,0,6
58005,alayo,alayo,1,1,0,0,5
58006,linā,lina,1,1,0,0,4
58007,lolālayo,lolalayo,1,1,0,0,8
58008,samataṃ,samatam,42,30,12,0,7
58009,kevalaphuṭādibhāvāpavattehi,kevalaphutadibhavapavattehi,1,1,0,0,27
58010,catūsupi,catusupi,156,150,6,0,8
58011,asithilakomalehi,asithilakomalehi,1,1,0,0,16
58012,kārādīhi,karadihi,4,4,0,0,8
58013,sithilakomalassa,sithilakomalassa,1,1,0,0,16
58014,silesapaṭipakkhattā,silesapatipakkhatta,1,1,0,0,19
58015,adhimattasutīhi,adhimattasutihi,2,2,0,0,15
58016,rāgādīhi,ragadihi,115,112,3,0,8
58017,akicchavacanīye,akicchavacaniye,1,1,0,0,15
58018,kicchavacanīyassa,kicchavacaniyassa,1,1,0,0,17
58019,sukhumālavipariyayattā,sukhumalavipariyayatta,1,1,0,0,22
58020,majjhimasutīhi,majjhimasutihi,1,1,0,0,14
58021,mudubhūtasaṃsaṭṭhehi,mudubhutasamsatthehi,1,1,0,0,20
58022,tividhamudāharati,tividhamudaharati,2,2,0,0,17
58023,vibhāvetuṃ,vibhavetum,309,308,1,0,10
58024,phuṭamissehi,phutamissehi,1,1,0,0,12
58025,sithilakomalehi,sithilakomalehi,1,1,0,0,15
58026,kevalakomalavaṇṇarahitattā,kevalakomalavannarahitatta,1,1,0,0,26
58027,akicchuccāraṇīyehi,akicchuccaraniyehi,1,1,0,0,18
58028,yathāvuttamuduphuṭasammissehi,yathavuttamuduphutasammissehi,1,1,0,0,29
58029,sithilakomalavaṇṇehi,sithilakomalavannehi,1,1,0,0,20
58030,silesālaṅkārassa,silesalankarassa,1,1,0,0,16
58031,kicchuccāraṇīyehi,kicchuccaraniyehi,1,1,0,0,17
58032,phuṭavaṇṇehi,phutavannehi,1,1,0,0,12
58033,sukhumālālaṅkārassa,sukhumalalankarassa,1,1,0,0,19
58034,kokilālāpasaṃvādī,kokilalapasamvadi,2,0,2,0,17
58035,munindālāpavibbhamo,munindalapavibbhamo,1,0,1,0,19
58036,kokilānaṃ,kokilanam,5,3,2,0,9
58037,karavīkasakuṇānaṃ,karavikasakunanam,2,2,0,0,17
58038,kūjitaṃ,kujitam,4,4,0,0,7
58039,saṃvadati,samvadati,5,5,0,0,9
58040,taṃsadisoti,tamsadisoti,4,4,0,0,11
58041,visaṭṭhādiaṭṭhaṅgiko,visatthadiatthangiko,1,1,0,0,20
58042,manonusāritaṃ,manonusaritam,1,1,0,0,13
58043,madhurabhāvaṃ,madhurabhavam,4,3,1,0,13
58044,kokili,kokili,1,0,1,0,6
58045,ālāpaṃ,alapam,2,1,1,0,6
58046,nādalīlaṃ,nadalilam,1,1,0,0,9
58047,pakāsanasīlo,pakasanasilo,1,1,0,0,12
58048,ālāpassa,alapassa,1,0,1,0,8
58049,visaṭṭhādiaṭṭhaṅgikanādassa,visatthadiatthangikanadassa,1,1,0,0,27
58050,cittārādhitabhāvaṃ,cittaradhitabhavam,1,1,0,0,18
58051,sutasambandhena,sutasambandhena,3,3,0,0,15
58052,dentopi,dentopi,25,25,0,0,7
58053,kokilālāpa,kokilalapa,1,0,1,0,10
58054,nissite,nissite,13,13,0,0,7
58055,nissayavohārena,nissayavoharena,16,16,0,0,15
58056,bhavantasādhanākaṅkhī,bhavantasadhanakankhi,3,0,3,0,21
58057,sambhāvanīye,sambhavaniye,1,0,1,0,12
58058,sambhāvanīyo,sambhavaniyo,20,19,1,0,12
58059,ādaraṇīyo,adaraniyo,1,1,0,0,9
58060,bhavantagu,bhavantagu,1,0,1,0,10
58061,sampādanamākaṅkhati,sampadanamakankhati,1,1,0,0,19
58062,saṃsāravattijano,samsaravattijano,2,2,0,0,16
58063,karotyevāti,karotyevati,1,1,0,0,11
58064,sambhāvanīyi,sambhavaniyi,1,0,1,0,12
58065,ādaraṇīyasobhanādhippāyaṃ,adaraniyasobhanadhippayam,1,1,0,0,25
58066,antasaṅkhātaṃ,antasankhatam,3,3,0,0,13
58067,pabhuṃ,pabhum,1,1,0,0,6
58068,nibbānasādhanābhilāsī,nibbanasadhanabhilasi,1,1,0,0,21
58069,sambhāvo,sambhavo,2,2,0,0,8
58070,sādhananti,sadhananti,7,7,0,0,10
58071,ākaṅkhati,akankhati,240,235,5,0,9
58072,laddhacandanasaṃsaggasugandhimalayānilo,laddhacandanasamsaggasugandhimalayanilo,2,0,2,0,39
58073,bhītova,bhitova,6,5,1,0,7
58074,candanatarūnaṃ,candanatarunam,1,1,0,0,14
58075,paricayo,paricayo,16,16,0,0,8
58076,sugandhī,sugandhi,1,0,1,0,8
58077,malayānilodakkhiṇapavamāno,malayanilodakkhinapavamano,1,1,0,0,26
58078,mukhamārutā,mukhamaruta,1,1,0,0,11
58079,tādisamuduttasītalattasugandhasampattiyā,tadisamuduttasitalattasugandhasampattiya,1,1,0,0,40
58080,dūratarattā,durataratta,1,1,0,0,11
58081,āyāti,ayati,5,3,2,0,5
58082,anuvattati,anuvattati,48,47,1,0,10
58083,āgamanakriyāvisesanaṃ,agamanakriyavisesanam,1,1,0,0,21
58084,paṭiladdhacandanatarusārasamavāyena,patiladdhacandanatarusarasamavayena,1,1,0,0,35
58085,sobhanagandhasamannāgato,sobhanagandhasamannagato,1,1,0,0,24
58086,malayadesato,malayadesato,1,1,0,0,12
58087,āgacchamānamāluto,agacchamanamaluto,1,1,0,0,17
58088,mukhasurabhivāsitapavanato,mukhasurabhivasitapavanato,1,1,0,0,26
58089,tādisamudusurabhisītalattassa,tadisamudusurabhisitalattassa,1,1,0,0,29
58090,abhimukhametīti,abhimukhametiti,1,1,0,0,15
58091,candanānaṃ,candananam,1,1,0,0,10
58092,saṃsaggoti,samsaggoti,5,4,1,0,10
58093,candanasaṃsaggoti,candanasamsaggoti,1,1,0,0,17
58094,laddhacandanasaṃsaggena,laddhacandanasamsaggena,1,1,0,0,23
58095,sugandhīti,sugandhiti,1,1,0,0,10
58096,malayato,malayato,1,1,0,0,8
58097,aniloti,aniloti,1,1,0,0,7
58098,munindamukhato,munindamukhato,1,1,0,0,14
58099,nikkhanto,nikkhanto,362,355,7,0,9
58100,mārutoti,marutoti,1,1,0,0,8
58101,tividhasamatāyaṃ,tividhasamatayam,1,1,0,0,16
58102,kokilālāpasaṃvādi,kokilalapasamvadi,1,1,0,0,17
58103,ccāditividhalakkhiyassāpi,ccaditividhalakkhiyassapi,1,1,0,0,25
58104,dassitalakkhaṇattayena,dassitalakkhanattayena,1,1,0,0,22
58105,tulyatā,tulyata,8,8,0,0,7
58106,supākaṭāvāti,supakatavati,1,1,0,0,12
58107,aniṭṭhurakkharappāyā,anitthurakkharappaya,2,0,2,0,20
58108,sabbakomalanissaṭā,sabbakomalanissata,2,0,2,0,18
58109,kicchamuccāraṇāpetabyañjanā,kicchamuccaranapetabyanjana,2,0,2,0,27
58110,aniṭṭhurakkhare,anitthurakkhare,1,0,1,0,15
58111,aniṭṭhurāni,anitthurani,2,1,1,0,11
58112,apharusāni,apharusani,1,1,0,0,10
58113,akkharāni,akkharani,96,92,4,0,9
58114,vaṇṇāni,vannani,5,5,0,0,7
58115,pāyāni,payani,2,1,1,0,6
58116,niṭṭhurāni,nitthurani,1,1,0,0,10
58117,appakānī,appakani,1,1,0,0,8
58118,pāya,paya,3,2,1,0,4
58119,sūcitaṃ,sucitam,7,7,0,0,7
58120,sithilehi,sithilehi,1,1,0,0,9
58121,laghūhi,laghuhi,1,1,0,0,7
58122,kicchena,kicchena,167,156,11,0,8
58123,uccāraṇā,uccarana,6,6,0,0,8
58124,apetāni,apetani,2,2,0,0,7
58125,apagatāni,apagatani,1,1,0,0,9
58126,byañjanāni,byanjanani,73,64,9,0,10
58127,sukhumālataṃ,sukhumalatam,1,1,0,0,12
58128,aniṭṭhure,anitthure,1,0,1,0,9
58129,akakkasavaṇṇabahulā,akakkasavannabahula,1,1,0,0,19
58130,aniṭṭhurakkharānaṃ,anitthurakkharanam,1,1,0,0,18
58131,yebhuyyaggahaṇatoyeva,yebhuyyaggahanatoyeva,1,1,0,0,21
58132,sakalasithilavaṇṇavirahitā,sakalasithilavannavirahita,1,1,0,0,26
58133,dukkhuccāraṇīyavaṇṇehi,dukkhuccaraniyavannehi,1,1,0,0,22
58134,vigataakkharasamannāgatā,vigataakkharasamannagata,1,1,0,0,24
58135,yassanti,yassanti,3,3,0,0,8
58136,komalā,komala,2,2,0,0,6
58137,nissaṭāti,nissatati,10,8,2,0,9
58138,uccāraṇāti,uccaranati,1,1,0,0,10
58139,apetānīti,apetaniti,1,1,0,0,9
58140,nicchantā,nicchanta,1,1,0,0,9
58141,katthāti,katthati,22,12,10,0,8
58142,alaṅkāravihīnāpi,alankaravihinapi,2,0,2,0,16
58143,tadujjalā,tadujjala,2,0,2,0,9
58144,visiṭṭhassāññadhammassa,visitthassannadhammassa,1,1,0,0,23
58145,abhāvepimināvopādeyo,abhavepiminavopadeyo,1,1,0,0,20
58146,vihīnāpi,vihinapi,1,1,0,0,8
58147,edisī,edisi,40,38,2,0,5
58148,sammukhataṃ,sammukhatam,2,0,2,0,11
58149,abhimukhabhāvaṃ,abhimukhabhavam,2,2,0,0,15
58150,vācāgocarattaṃ,vacagocarattam,1,1,0,0,14
58151,kimutaatthālaṅkārālaṅkite,kimutaatthalankaralankite,1,1,0,0,25
58152,tyapi,tyapi,2,1,1,0,5
58153,sabhāvavutyādinā,sabhavavutyadina,1,1,0,0,16
58154,visesenā,visesena,14,1,13,0,8
58155,tisayena,tisayena,1,1,0,0,8
58156,manuññāti,manunnati,1,1,0,0,9
58157,evaṃvidhā,evamvidha,15,15,0,0,9
58158,atthālaṅkāravirahitāpi,atthalankaravirahitapi,1,1,0,0,22
58159,paññavantānaṃ,pannavantanam,24,24,0,0,13
58160,vacanavisayabhāvanti,vacanavisayabhavanti,1,1,0,0,20
58161,sabhāvavuttivaṅkavuttisambhūtena,sabhavavuttivankavuttisambhutena,1,1,0,0,32
58162,jotamānā,jotamana,2,2,0,0,8
58163,vihīnāti,vihinati,2,1,1,0,8
58164,ujjalāti,ujjalati,1,1,0,0,8
58165,romañcapiñcharacanā,romancapincharacana,2,0,2,0,19
58166,sādhuvādāhitaddhanī,sadhuvadahitaddhani,2,1,1,0,19
58167,munīmeghummadā,munimeghummada,1,0,1,0,14
58168,romañce,romance,1,0,1,0,7
58169,lomahaṃsā,lomahamsa,2,2,0,0,9
58170,piñchāni,pinchani,5,4,1,0,8
58171,barihāni,barihani,1,1,0,0,8
58172,parihārāni,pariharani,1,1,0,0,10
58173,chattākārena,chattakarena,8,7,1,0,12
58174,taṃsadisoyeva,tamsadisoyeva,1,1,0,0,13
58175,kekāsaṅkhāto,kekasankhato,1,1,0,0,12
58176,munimeghena,munimeghena,1,0,1,0,11
58177,munisadisena,munisadisena,2,2,0,0,12
58178,munisaṅkhātena,munisankhatena,2,2,0,0,14
58179,vāridena,varidena,1,1,0,0,8
58180,ummadā,ummada,1,0,1,0,6
58181,sādhusadisā,sadhusadisa,1,1,0,0,11
58182,līlopetā,lilopeta,2,2,0,0,8
58183,vicaranti,vicaranti,310,292,18,0,9
58184,atthālaṅkārayuttasukhumālatamudāharati,atthalankarayuttasukhumalatamudaharati,1,1,0,0,38
58185,rome,rome,1,0,1,0,4
58186,lomahaṃsasadisā,lomahamsasadisa,1,1,0,0,15
58187,romā,roma,2,2,0,0,4
58188,piñchānaṃ,pinchanam,1,1,0,0,9
58189,barihānaṃ,barihanam,1,1,0,0,9
58190,vitthāravantā,vittharavanta,1,1,0,0,13
58191,vacanasadisehi,vacanasadisehi,1,1,0,0,14
58192,pavattakekāninnādehi,pavattakekaninnadehi,1,1,0,0,20
58193,munimeghummadā,munimeghummada,1,0,1,0,14
58194,sañjātamadā,sanjatamada,1,1,0,0,11
58195,sādhusikhāvalā,sadhusikhavala,1,0,1,0,14
58196,sajjanasadisā,sajjanasadisa,1,1,0,0,13
58197,sādhuno,sadhuno,3,3,0,0,7
58198,asesavatthuvisayaṃ,asesavatthuvisayam,3,2,1,0,18
58199,samāsarūpakaṃ,samasarupakam,7,7,0,0,13
58200,amukhyapakkhe,amukhyapakkhe,1,1,0,0,13
58201,sādhuvādo,sadhuvado,3,3,0,0,9
58202,mukhyapakkhe,mukhyapakkhe,1,1,0,0,12
58203,piñcharacanā,pincharacana,1,1,0,0,12
58204,āhitaddhanī,ahitaddhani,1,1,0,0,11
58205,upacaritabbaṃ,upacaritabbam,2,2,0,0,13
58206,piñchānīti,pinchaniti,2,1,1,0,10
58207,vādoti,vadoti,37,12,25,0,6
58208,āhitaddhani,ahitaddhani,1,1,0,0,11
58209,meghoti,meghoti,4,3,1,0,7
58210,ummadāti,ummadati,1,1,0,0,8
58211,sikhāvalāti,sikhavalati,1,1,0,0,11
58212,munīmegho,munimegho,1,1,0,0,9
58213,sukhumālattamattheva,sukhumalattamattheva,2,0,2,0,20
58214,kittisesādikittanaṃ,kittisesadikittanam,1,0,1,0,19
58215,saddeva,saddeva,3,3,0,0,7
58216,atthepīti,atthepiti,2,2,0,0,9
58217,atthevāti,atthevati,45,44,1,0,9
58218,vijjateva,vijjateva,9,8,1,0,9
58219,anocityagāmmādivajjanā,anocityagammadivajjana,1,1,0,0,22
58220,disaddesu,disaddesu,2,2,0,0,9
58221,vattabbesu,vattabbesu,21,21,0,0,10
58222,kittanaṃ,kittanam,4,2,2,0,8
58223,padābhidheyyagocarampi,padabhidheyyagocarampi,1,1,0,0,22
58224,sukhumālattaṃ,sukhumalattam,1,1,0,0,13
58225,ocityahīnagāmmadosaparihārena,ocityahinagammadosapariharena,1,1,0,0,29
58226,kathananti,kathananti,18,18,0,0,10
58227,jīvitakkhayaṃ,jivitakkhayam,249,248,1,0,13
58228,iccādīnamiti,iccadinamiti,1,1,0,0,12
58229,kittiseso,kittiseso,1,1,0,0,9
58230,itiādiyesaṃ,itiadiyesam,1,1,0,0,11
58231,saggakāyamalaṅkarī,saggakayamalankari,1,1,0,0,18
58232,tyādīnamiti,tyadinamiti,1,1,0,0,11
58233,siliṭṭhapadasaṃsagga,silitthapadasamsagga,1,0,1,0,20
58234,ramaṇīyaguṇālayo,ramaniyagunalayo,1,0,1,0,16
58235,silesaṃ,silesam,9,9,0,0,7
58236,siliṭṭhe,silitthe,2,0,2,0,8
58237,siliṭṭhānaṃ,silitthanam,2,2,0,0,11
58238,bandhalāghavābhāvena,bandhalaghavabhavena,1,1,0,0,20
58239,saṃsaggena,samsaggena,36,36,0,0,10
58240,pavattiṭṭhānaṃ,pavattitthanam,50,48,2,0,14
58241,racanāya,racanaya,5,5,0,0,8
58242,gāravo,garavo,87,80,7,0,6
58243,asithilatā,asithilata,1,1,0,0,10
58244,sabandhagāravoti,sabandhagaravoti,1,0,1,0,16
58245,aññopi,annopi,208,206,2,0,6
58246,tvayameveti,tvayameveti,1,1,0,0,11
58247,saddassattho,saddassattho,7,7,0,0,12
58248,siliṭṭhapadasaṃsaggaramaṇīyaguṇālayo,silitthapadasamsaggaramaniyagunalayo,1,0,1,0,36
58249,ṭhānakaraṇādīhi,thanakaranadihi,1,1,0,0,15
58250,āsannavaṇṇānaṃ,asannavannanam,1,1,0,0,14
58251,vinyāsahetu,vinyasahetu,1,1,0,0,11
58252,aññamaññanissitānaṃ,annamannanissitanam,1,1,0,0,19
58253,samavāyena,samavayena,11,11,0,0,10
58254,manuññaguṇassa,manunnagunassa,1,1,0,0,14
58255,pavattiṭṭhānabhūto,pavattitthanabhuto,2,2,0,0,18
58256,bandhagāravasaṅkhātaracanāya,bandhagaravasankhataracanaya,1,1,0,0,28
58257,asithilabhāvena,asithilabhavena,2,2,0,0,15
58258,bandhagāravo,bandhagaravo,1,1,0,0,12
58259,tappaṭipādakabandhopyettha,tappatipadakabandhopyettha,1,1,0,0,26
58260,silesoti,silesoti,3,3,0,0,8
58261,ramaṇīyoti,ramaniyoti,11,7,4,0,10
58262,ālayoti,alayoti,7,2,5,0,7
58263,guruno,guruno,7,7,0,0,6
58264,bālindu,balindu,3,0,3,0,7
58265,bālinduvibbhamacchedinakharāvalikantibhi,balinduvibbhamacchedinakharavalikantibhi,1,0,1,0,40
58266,munindapadambhojakanti,munindapadambhojakanti,2,0,2,0,22
58267,bālinduno,balinduno,1,1,0,0,9
58268,pañcamīcandassa,pancamicandassa,2,2,0,0,15
58269,pañcadasakalassa,pancadasakalassa,1,1,0,0,16
58270,bālinduvibbhamacchediyo,balinduvibbhamacchediyo,2,1,1,0,23
58271,kalāsannibhānaṃ,kalasannibhanam,1,1,0,0,15
58272,nakharānaṃ,nakharanam,1,0,1,0,10
58273,nakhānaṃ,nakhanam,16,16,0,0,8
58274,āvaliyo,avaliyo,1,1,0,0,7
58275,sobhāhi,sobhahi,3,3,0,0,7
58276,padāniyeva,padaniyeva,4,4,0,0,10
58277,ambhojāni,ambhojani,1,1,0,0,9
58278,padumāni,padumani,95,95,0,0,8
58279,avataṃ,avatam,3,1,2,0,6
58280,pālayatu,palayatu,3,3,0,0,8
58281,taruṇacandavilāsavināsanasabhāvasamannāgatanakhapantisobhāhi,tarunacandavilasavinasanasabhavasamannagatanakhapantisobhahi,1,1,0,0,60
58282,sambuddhapādapadumasobhā,sambuddhapadapadumasobha,1,1,0,0,24
58283,āvaliyoti,avaliyoti,2,2,0,0,9
58284,kantīti,kantiti,5,4,1,0,7
58285,nakharāvalikantiyo,nakharavalikantiyo,1,1,0,0,18
58286,padānīti,padaniti,50,16,34,0,8
58287,ambhojānīti,ambhojaniti,2,2,0,0,11
58288,udārattamavadhārayamāha,udarattamavadharayamaha,1,1,0,0,23
58289,niyamābhāvā,niyamabhava,9,9,0,0,11
58290,cāgātisayādiko,cagatisayadiko,2,2,0,0,14
58291,adhimatto,adhimatto,74,74,0,0,9
58292,bandheti,bandheti,2,1,1,0,8
58293,bandhapaddhatī,bandhapaddhati,1,1,0,0,14
58294,udāroyaṃ,udaroyam,1,1,0,0,8
58295,teni,teni,3,2,1,0,4
58296,ukkaṃsavatā,ukkamsavata,4,4,0,0,11
58297,racanakkamo,racanakkamo,1,1,0,0,11
58298,nāthabhūtena,nathabhutena,1,1,0,0,12
58299,udāraguṇena,udaragunena,1,1,0,0,11
58300,sampadāvāti,sampadavati,1,1,0,0,11
58301,sampadāvatīti,sampadavatiti,1,1,0,0,13
58302,udārattamuddisati,udarattamuddisati,1,1,0,0,17
58303,atisayavā,atisayava,1,1,0,0,9
58304,saddāvaliyā,saddavaliya,1,1,0,0,11
58305,paṭipādanīyo,patipadaniyo,1,1,0,0,12
58306,yathāvuttaguṇo,yathavuttaguno,2,2,0,0,14
58307,bandhabandhati,bandhabandhati,1,0,1,0,14
58308,sappatiṭṭhā,sappatittha,2,2,0,0,11
58309,nāthena,nathena,9,9,0,0,7
58310,paddhatīti,paddhatiti,2,2,0,0,10
58311,pādambhojarajolittagattā,padambhojarajolittagatta,2,0,2,0,24
58312,yetava,yetava,1,0,1,0,6
58313,gotamāti,gotamati,51,15,36,0,8
58314,ālapati,alapati,319,318,1,0,7
58315,pādambhojānaṃ,padambhojanam,1,1,0,0,13
58316,rajāni,rajani,9,7,2,0,6
58317,reṇavo,renavo,4,4,0,0,6
58318,littāni,littani,3,2,1,0,7
58319,upadehitāni,upadehitani,1,1,0,0,11
58320,gattāni,gattani,133,127,6,0,7
58321,rajolavenāpyanupalittattā,rajolavenapyanupalittatta,1,1,0,0,25
58322,rajehi,rajehi,8,8,0,0,6
58323,kilesasaṅkhātehi,kilesasankhatehi,2,2,0,0,16
58324,nirajā,niraja,2,2,0,0,6
58325,nikkilesabhāvaṃ,nikkilesabhavam,1,1,0,0,15
58326,littā,litta,25,25,0,0,5
58327,saṃkiliṭṭhāyeva,samkilitthayeva,3,2,1,0,15
58328,pādarajasā,padarajasa,2,2,0,0,10
58329,vilepane,vilepane,1,1,0,0,8
58330,niraje,niraje,2,2,0,0,6
58331,pādambhoje,padambhoje,4,3,1,0,10
58332,pādapadumareṇulittamatthakanalāṭādisarīrāvayavayuttā,padapadumarenulittamatthakanalatadisariravayavayutta,1,1,0,0,52
58333,kilesasaṅkhātarajojallehi,kilesasankhatarajojallehi,1,1,0,0,25
58334,anupalittattā,anupalittatta,4,4,0,0,13
58335,vigatakilesarajobhāvaṃ,vigatakilesarajobhavam,1,1,0,0,22
58336,rajolittā,rajolitta,1,1,0,0,9
58337,saṃkiliṭṭhā,samkilittha,102,99,3,0,11
58338,upalittepi,upalittepi,1,1,0,0,10
58339,karosīti,karositi,34,32,2,0,8
58340,ukkaṃsaguṇo,ukkamsaguno,1,1,0,0,11
58341,pādāniyeva,padaniyeva,1,1,0,0,10
58342,niggatāti,niggatati,2,1,1,0,9
58343,jinānubhāvassa,jinanubhavassa,3,0,3,0,14
58344,tradissati,tradissati,1,0,1,0,10
58345,paramīdisaṃ,paramidisam,1,0,1,0,11
58346,sanātho,sanatho,3,3,0,0,7
58347,sammāsambuddhapabhāvassa,sammasambuddhapabhavassa,1,1,0,0,24
58348,padissate,padissate,5,5,0,0,9
58349,jinānubhāvena,jinanubhavena,1,0,1,0,13
58350,pakāramimamaññatrapiatidisanto,pakaramimamannatrapiatidisanto,1,1,0,0,30
58351,vitakkeyya,vitakkeyya,5,5,0,0,10
58352,yathāvuttaguṇanidassanañca,yathavuttagunanidassananca,1,1,0,0,26
58353,sissānusāsanañca,sissanusasananca,1,1,0,0,16
58354,yathāvuttakkamena,yathavuttakkamena,4,4,0,0,17
58355,tathāgatappabhāvassa,tathagatappabhavassa,1,1,0,0,20
58356,jinānubhāvasaṅkhātena,jinanubhavasankhatena,1,1,0,0,21
58357,pasatthañāṇavanto,pasatthananavanto,1,1,0,0,17
58358,kappeyya,kappeyya,98,87,11,0,8
58359,pasatthavisesanaṃ,pasatthavisesanam,2,0,2,0,17
58360,hemaṅgadādayo,hemangadadayo,2,0,2,0,13
58361,aparamudārappakāraṃ,aparamudarappakaram,1,1,0,0,19
58362,silāghanīyaṃ,silaghaniyam,1,1,0,0,12
58363,upādiyati,upadiyati,188,179,9,0,9
58364,yathāvuttova,yathavuttova,12,12,0,0,12
58365,kīḷatthaṃ,kilattham,5,5,0,0,9
58366,līlāya,lilaya,8,7,1,0,6
58367,hemamayamaṅgadanti,hemamayamangadanti,1,1,0,0,18
58368,bāhirattho,bahirattho,8,8,0,0,10
58369,kusumadāmamaṇimekhalādīnaṃ,kusumadamamanimekhaladinam,1,1,0,0,26
58370,bandhapharusagāmmapariccāgā,bandhapharusagammapariccaga,1,1,0,0,27
58371,aññamapi,annamapi,1,1,0,0,8
58372,pasaṃsanīyavisesanaṃ,pasamsaniyavisesanam,1,1,0,0,20
58373,udāroti,udaroti,1,1,0,0,7
58374,līlāhāso,lilahaso,2,1,1,0,8
58375,suvaṇṇakeyūrāiccādayoti,suvannakeyuraiccadayoti,1,1,0,0,23
58376,kīḷatthāya,kilatthaya,1,1,0,0,10
58377,hemamayaṃ,hemamayam,4,4,0,0,9
58378,aṅgadanti,angadanti,1,1,0,0,9
58379,hemaṅgadañcāti,hemangadancati,1,1,0,0,14
58380,kusumadāmamaṇimekhalādīnanti,kusumadamamanimekhaladinanti,1,1,0,0,28
58381,ayamudāro,ayamudaro,1,1,0,0,9
58382,bandhapharusagāmmādidosapariccāgena,bandhapharusagammadidosapariccagena,1,1,0,0,35
58383,lokiyatthānatikkantā,lokiyatthanatikkanta,2,0,2,0,20
58384,lokiyi,lokiyi,2,0,2,0,6
58385,anatikkantā,anatikkanta,9,8,1,0,11
58386,anatītā,anatita,14,14,0,0,7
58387,kavīnamitaresaṃ,kavinamitaresam,1,1,0,0,15
58388,vākyadosassa,vakyadosassa,1,1,0,0,12
58389,ativuttassā,ativuttassa,1,0,1,0,11
58390,pasiddhasaddatthamanatikkantā,pasiddhasaddatthamanatikkanta,1,1,0,0,29
58391,sabbajanānaṃ,sabbajananam,4,3,1,0,12
58392,sakalakavīnaṃ,sakalakavinam,1,1,0,0,13
58393,ativuttadosassa,ativuttadosassa,1,1,0,0,15
58394,dosaparihāraparicchede,dosapariharaparicchede,1,1,0,0,22
58395,ativuttadosaparihārato,ativuttadosapariharato,1,1,0,0,22
58396,kantiyā,kantiya,10,10,0,0,7
58397,siddhattā,siddhatta,118,118,0,0,9
58398,lakkhiyo,lakkhiyo,1,1,0,0,8
58399,viditoti,viditoti,15,11,4,0,8
58400,atthabyattiṃ,atthabyattim,2,2,0,0,12
58401,byañjayati,byanjayati,9,9,0,0,10
58402,atthabyattābhidheyyi,atthabyattabhidheyyi,1,0,1,0,20
58403,sambandhaatthassa,sambandhaatthassa,1,1,0,0,17
58404,aneyyatā,aneyyata,3,1,2,0,8
58405,gatyantarābhāvā,gatyantarabhava,1,1,0,0,15
58406,tamanuvaditvā,tamanuvaditva,1,1,0,0,13
58407,byākiṇṇaneyyādidosavajjanāya,byakinnaneyyadidosavajjanaya,1,1,0,0,28
58408,neyyaparihāre,neyyaparihare,2,1,1,0,13
58409,paṭhamadutiyodāharaṇassattho,pathamadutiyodaharanassattho,1,1,0,0,28
58410,atthasāmatthiyato,atthasamatthiyato,1,1,0,0,17
58411,aneyyatāsaṅkhatā,aneyyatasankhata,1,1,0,0,16
58412,neyyadosaparihārapadese,neyyadosapariharapadese,1,1,0,0,23
58413,pakāsitāti,pakasitati,90,80,10,0,10
58414,atthapatīti,atthapatiti,1,1,0,0,11
58415,aññathānupalabbhatīti,annathanupalabbhatiti,1,1,0,0,21
58416,byatti,byatti,5,5,0,0,6
58417,patītīti,patititi,1,1,0,0,8
58418,āharitabbaṃ,aharitabbam,36,35,1,0,11
58419,abhidheyyassāti,abhidheyyassati,2,2,0,0,15
58420,dvippakārāya,dvippakaraya,1,1,0,0,12
58421,atthabyattiyā,atthabyattiya,1,1,0,0,13
58422,udāharaṇamanussāreti,udaharanamanussareti,1,1,0,0,20
58423,mari,mari,23,22,1,0,4
58424,ccādigāthādvayena,ccadigathadvayena,1,1,0,0,17
58425,sabhāvāmalatā,sabhavamalata,3,0,3,0,13
58426,vanatānanta,vanatananta,1,0,1,0,11
58427,dhīrāti,dhirati,33,4,29,0,7
58428,pakatiparisuddhatā,pakatiparisuddhata,2,2,0,0,18
58429,tucchā,tuccha,54,52,2,0,6
58430,pādanakhā,padanakha,4,4,0,0,9
58431,avanatassa,avanatassa,1,0,1,0,10
58432,sannatassa,sannatassa,1,1,0,0,10
58433,anantassa,anantassa,6,5,1,0,9
58434,nāgarājassa,nagarajassa,77,77,0,0,11
58435,moḷino,molino,1,0,1,0,6
58436,kirīṭassa,kiritassa,2,2,0,0,9
58437,avanatānaṃ,avanatanam,3,2,1,0,10
58438,naramarānaṃ,naramaranam,2,2,0,0,11
58439,anantānaṃ,anantanam,12,11,1,0,9
58440,moḷīnaṃ,molinam,4,4,0,0,7
58441,chāyā,chaya,220,207,13,0,5
58442,pariccajanti,pariccajanti,33,33,0,0,12
58443,sañchaviyo,sanchaviyo,1,1,0,0,10
58444,jahantīti,jahantiti,12,5,7,0,9
58445,nakhesu,nakhesu,2,2,0,0,7
58446,sañchavittā,sanchavitta,1,1,0,0,11
58447,pādanakhassa,padanakhassa,1,1,0,0,12
58448,nirantarappaṇāmābyabhicārānaramarādīnaṃ,nirantarappanamabyabhicaranaramaradinam,1,1,0,0,39
58449,pādāravindavandanaṃ,padaravindavandanam,1,1,0,0,19
58450,sabhāvi,sabhavi,2,0,2,0,7
58451,caraṇanakhā,carananakha,1,1,0,0,11
58452,avanatānantamoḷicchāyā,avanatanantamolicchaya,1,0,1,0,22
58453,pādānatassa,padanatassa,1,1,0,0,11
58454,anantanāgarājassa,anantanagarajassa,1,1,0,0,17
58455,sambandhinī,sambandhini,12,12,0,0,11
58456,vijahanti,vijahanti,52,51,1,0,9
58457,kirīṭakantisadisā,kiritakantisadisa,1,1,0,0,17
58458,candakiraṇasannibhānaṃ,candakiranasannibhanam,1,1,0,0,22
58459,nakharaṃsīnaṃ,nakharamsinam,4,4,0,0,13
58460,nakharaṃsīhi,nakharamsihi,1,1,0,0,12
58461,amadditasakakantiyuttabhāvamāpajjanaṃ,amadditasakakantiyuttabhavamapajjanam,1,1,0,0,37
58462,nirantarappaṇāmābhāvābhāvato,nirantarappanamabhavabhavato,1,1,0,0,28
58463,khattiyādīnaṃ,khattiyadinam,25,25,0,0,13
58464,munindapādāravindadvande,munindapadaravindadvande,1,1,0,0,24
58465,nirantarappaṇāmo,nirantarappanamo,1,1,0,0,16
58466,amalāti,amalati,1,1,0,0,7
58467,paṭhamapakkhe,pathamapakkhe,3,3,0,0,13
58468,avanato,avanato,3,3,0,0,7
58469,moḷīti,moliti,3,2,1,0,6
58470,chāyāyoti,chayayoti,3,3,0,0,9
58471,dutiyapakkhe,dutiyapakkhe,5,5,0,0,12
58472,moḷī,moli,1,1,0,0,4
58473,anantamoḷīti,anantamoliti,1,1,0,0,12
58474,dassanāvasaraṃ,dassanavasaram,2,0,2,0,14
58475,samādhiphalaṃ,samadhiphalam,1,1,0,0,13
58476,kiccāha,kiccaha,1,1,0,0,7
58477,gajjapajjamissabhāvassa,gajjapajjamissabhavassa,1,1,0,0,23
58478,sāroti,saroti,25,11,14,0,6
58479,tapparāyattā,tapparayatta,1,1,0,0,12
58480,samādhikhyo,samadhikhyo,1,1,0,0,11
58481,avasaraṃ,avasaram,17,16,1,0,8
58482,okāsaṃ,okasam,862,818,44,0,6
58483,anottarattā,anottaratta,1,1,0,0,11
58484,uddiṭṭhānukkamenāti,udditthanukkamenati,1,1,0,0,19
58485,bandhi,bandhi,48,47,1,0,6
58486,pajjagajjavimissasaṅkhātassa,pajjagajjavimissasankhatassa,1,1,0,0,28
58487,dassanokāsaṃ,dassanokasam,1,1,0,0,12
58488,lokasīmānurodhato,lokasimanurodhato,3,0,3,0,17
58489,samādhīti,samadhiti,124,65,59,0,9
58490,kathamayaṃ,kathamayam,20,18,2,0,10
58491,saddavohāro,saddavoharo,3,3,0,0,11
58492,vuccatītyāha,vuccatityaha,2,2,0,0,12
58493,pakatāpekkhāya,pakatapekkhaya,1,1,0,0,14
58494,mukhyavisayā,mukhyavisaya,1,1,0,0,12
58495,amukhye,amukhye,1,1,0,0,7
58496,lokappatītyanuvattanena,lokappatityanuvattanena,1,1,0,0,23
58497,lokasīmānuvattanameveha,lokasimanuvattanameveha,1,1,0,0,23
58498,sādhuttaṃ,sadhuttam,4,4,0,0,9
58499,āropyate,aropyate,3,3,0,0,8
58500,niruccatī,niruccati,1,0,1,0,9
58501,tidha,tidha,1,1,0,0,5
58502,ādhīyatīti,adhiyatiti,2,2,0,0,10
58503,bandhavisaye,bandhavisaye,1,1,0,0,12
58504,āsaṅkāyaṃ,asankayam,8,8,0,0,9
58505,aññi,anni,1,0,1,0,4
58506,samādhānassa,samadhanassa,13,13,0,0,12
58507,visayabhūtaamukhyato,visayabhutaamukhyato,1,1,0,0,20
58508,mukhyavatthuno,mukhyavatthuno,1,1,0,0,14
58509,pasiddhaguṇo,pasiddhaguno,1,1,0,0,12
58510,mukhyavisayato,mukhyavisayato,1,1,0,0,14
58511,amukhyavisaye,amukhyavisaye,3,3,0,0,13
58512,lokavohāramariyādāvirodhabhāvena,lokavoharamariyadavirodhabhavena,1,1,0,0,32
58513,lokappatītyanuvattaneneva,lokappatityanuvattaneneva,1,1,0,0,25
58514,ādhīyati,adhiyati,5,4,1,0,8
58515,ṭhapīyati,thapiyati,18,17,1,0,9
58516,sīmāti,simati,24,9,15,0,6
58517,anurodhoti,anurodhoti,3,1,2,0,10
58518,samādhiuddesa,samadhiuddesa,1,1,0,0,13
58519,sarīrepi,sarirepi,4,3,1,0,8
58520,para151-152,para151-152,5,5,0,0,11
58521,samādhānavisayamāha,samadhanavisayamaha,1,1,0,0,19
58522,pāṇavantānaṃ,panavantanam,1,1,0,0,12
58523,pāṇavirahite,panavirahite,1,1,0,0,12
58524,vatthuni,vatthuni,8,8,0,0,8
58525,lokapatītyanuvattanena,lokapatityanuvattanena,1,1,0,0,22
58526,yathānurūpaṃ,yathanurupam,192,167,25,0,12
58527,nirūpeti,nirupeti,1,0,1,0,8
58528,rūpavirahite,rupavirahite,1,1,0,0,12
58529,asarīre,asarire,2,1,1,0,7
58530,aghane,aghane,2,2,0,0,6
58531,asaṃhate,asamhate,1,1,0,0,8
58532,kaṭhinassa,kathinassa,3,1,2,0,10
58533,daḷhassa,dalhassa,5,3,2,0,8
58534,visayamupadasseti,visayamupadasseti,1,1,0,0,17
58535,pāṇarahitavatthumhi,panarahitavatthumhi,1,1,0,0,19
58536,lokapatītianusārena,lokapatitianusarena,1,1,0,0,19
58537,rūpavantavatthuno,rupavantavatthuno,1,1,0,0,17
58538,rūparahitavatthumhi,ruparahitavatthumhi,1,1,0,0,19
58539,rasavantassa,rasavantassa,1,1,0,0,12
58540,rasarahite,rasarahite,1,1,0,0,10
58541,dravavantavatthuno,dravavantavatthuno,1,1,0,0,18
58542,dravarahite,dravarahite,2,2,0,0,11
58543,kattuguṇo,kattuguno,1,1,0,0,9
58544,thaddhassa,thaddhassa,4,4,0,0,10
58545,asarīrepi,asarirepi,1,0,1,0,9
58546,sarīrarahitepi,sarirarahitepi,1,1,0,0,14
58547,niggatoti,niggatoti,7,6,1,0,9
58548,dravāaññoti,dravaannoti,1,1,0,0,11
58549,dravena,dravena,1,1,0,0,7
58550,dravabhāvena,dravabhavena,1,1,0,0,12
58551,aññoti,annoti,69,48,21,0,6
58552,uṇṇāpuṇṇindunā,unnapunninduna,2,0,2,0,14
58553,nāthāti,nathati,2,0,2,0,7
58554,lokattayekapaṭisaraṇabhūtatāya,lokattayekapatisaranabhutataya,1,1,0,0,30
58555,uṇṇāromadhātusaṅkhātena,unnaromadhatusankhatena,1,1,0,0,23
58556,saṃyogena,samyogena,6,6,0,0,9
58557,kumudiniyo,kumudiniyo,3,3,0,0,10
58558,kumudākarā,kumudakara,1,1,0,0,10
58559,vigatasoppā,vigatasoppa,1,1,0,0,11
58560,suṭṭhuyeva,sutthuyeva,3,3,0,0,10
58561,pamodantīti,pamodantiti,4,3,1,0,11
58562,parikappemīti,parikappemiti,1,1,0,0,13
58563,pāṇidhammassa,panidhammassa,1,1,0,0,13
58564,suratarūpassa,suratarupassa,1,1,0,0,13
58565,saṅgamassa,sangamassa,1,1,0,0,10
58566,viniddāya,viniddaya,1,1,0,0,9
58567,sampīṇanassa,sampinanassa,1,1,0,0,12
58568,apāṇini,apanini,1,1,0,0,7
58569,āropitapumbhāve,aropitapumbhave,1,1,0,0,15
58570,uṇṇāpuṇṇindumhi,unnapunnindumhi,1,1,0,0,15
58571,āropitaitthibhāvāsu,aropitaitthibhavasu,1,1,0,0,19
58572,kumudinīsu,kumudinisu,1,1,0,0,10
58573,lokasīmānurodhena,lokasimanurodhena,1,1,0,0,17
58574,samādhānato,samadhanato,6,6,0,0,11
58575,tadabhidhāyī,tadabhidhayi,1,1,0,0,12
58576,saddikavohāraṃ,saddikavoharam,1,1,0,0,14
58577,pāṇidhammasamādhino,panidhammasamadhino,1,1,0,0,19
58578,uṇṇāromamaṇḍalasaṅkhātapuṇṇacandena,unnaromamandalasankhatapunnacandena,1,1,0,0,35
58579,aññamaññasamavāyahetunā,annamannasamavayahetuna,1,1,0,0,23
58580,keravākarasaṅkhātā,keravakarasankhata,1,1,0,0,18
58581,atisantuṭṭhā,atisantuttha,1,1,0,0,12
58582,kappemīti,kappemiti,7,6,1,0,9
58583,indusampamodo,indusampamodo,1,1,0,0,13
58584,pāṇidhammasaṅkhāto,panidhammasankhato,1,1,0,0,18
58585,suratasaṅgamo,suratasangamo,1,1,0,0,13
58586,niddāpagamo,niddapagamo,1,1,0,0,11
58587,sampamodanañcāti,sampamodanancati,1,1,0,0,16
58588,uṇṇāpuṇṇindukumudinīsaṅkhātesu,unnapunnindukumudinisankhatesu,1,1,0,0,30
58589,apāṇesu,apanesu,1,1,0,0,7
58590,lokavohārānatikkamma,lokavoharanatikkamma,1,1,0,0,20
58591,āropanena,aropanena,4,4,0,0,9
58592,pāṇidhammato,panidhammato,1,1,0,0,12
58593,tappaṭipādakaganthopi,tappatipadakaganthopi,1,1,0,0,21
58594,pādambujānatā,padambujanata,2,0,2,0,13
58595,pādambujesu,padambujesu,1,1,0,0,11
58596,ānatā,anata,3,3,0,0,5
58597,paṇāmavasena,panamavasena,2,2,0,0,12
58598,tilokakuharapavattino,tilokakuharapavattino,1,1,0,0,21
58599,amatarasesviva,amatarasesviva,1,0,1,0,14
58600,pīyūsarasesu,piyusarasesu,1,1,0,0,12
58601,karuṇārasesu,karunarasesu,1,1,0,0,12
58602,drave,drave,2,2,0,0,5
58603,nimujjamānā,nimujjamana,4,4,0,0,11
58604,naṭṭhā,nattha,94,92,2,0,6
58605,amatapakkhe,amatapakkhe,1,1,0,0,11
58606,kāyikacetasikasukhaṃ,kayikacetasikasukham,16,16,0,0,20
58607,rūpadhammasamādhino,rupadhammasamadhino,1,1,0,0,19
58608,caraṇapadume,caranapadume,1,1,0,0,12
58609,paṇatā,panata,1,1,0,0,6
58610,amatarasesu,amatarasesu,1,0,1,0,11
58611,sudhājalesu,sudhajalesu,1,1,0,0,11
58612,anaññasādhāraṇakaruṇāguṇesu,anannasadharanakarunagunesu,1,1,0,0,27
58613,vinaṭṭhavātapittādayo,vinatthavatapittadayo,1,1,0,0,21
58614,vinaṭṭharāgādidosā,vinattharagadidosa,1,1,0,0,18
58615,ajarāmarasaṅkhātasukhaṃ,ajaramarasankhatasukham,1,1,0,0,23
58616,rūpayuttajale,rupayuttajale,1,1,0,0,13
58617,mujjanaṃ,mujjanam,1,1,0,0,8
58618,dayāguṇe,dayagune,1,1,0,0,8
58619,āropitaṃ,aropitam,40,40,0,0,8
58620,rasāti,rasati,12,7,5,0,6
58621,ānatāti,anatati,3,3,0,0,7
58622,siṅgārādovise,singaradovise,1,1,0,0,13
58623,draveraso,draveraso,1,1,0,0,9
58624,guṇajalesu,gunajalesu,1,1,0,0,10
58625,madhurepi,madhurepi,2,0,2,0,9
58626,nappasīdanti,nappasidanti,18,16,2,0,12
58627,kīdisīmanaso,kidisimanaso,1,0,1,0,12
58628,khāraguṇānabho,kharagunanabho,1,0,1,0,14
58629,dhiyā,dhiya,19,19,0,0,5
58630,īratīti,iratiti,1,1,0,0,7
58631,manoharepi,manoharepi,1,1,0,0,10
58632,khāraguṇānaṃ,kharagunanam,2,0,2,0,12
58633,amadhuraguṇānaṃ,amadhuragunanam,2,2,0,0,15
58634,cittappavatti,cittappavatti,32,31,1,0,13
58635,kimiva,kimiva,30,28,2,0,6
58636,īdisī,idisi,42,41,1,0,5
58637,tādisaguṇāvabodhaparammukhā,tadisagunavabodhaparammukha,1,1,0,0,27
58638,mohandhakārasambandhitāti,mohandhakarasambandhitati,1,1,0,0,25
58639,sarasadhammasamādhino,sarasadhammasamadhino,1,1,0,0,21
58640,udāharaṇamuddisati,udaharanamuddisati,5,5,0,0,18
58641,pakatisundare,pakatisundare,1,1,0,0,13
58642,karuṇāpaññāguṇepi,karunapannagunepi,1,1,0,0,17
58643,hīnādhimuttikā,hinadhimuttika,48,47,1,0,14
58644,rasahīne,rasahine,1,1,0,0,8
58645,āropitarasayuttadhammabhūtaṃ,aropitarasayuttadhammabhutam,1,1,0,0,28
58646,madhurakhāraguṇadvayaṃ,madhurakharagunadvayam,1,1,0,0,22
58647,cūḷakapuṭapeyyā,culakaputapeyya,2,1,1,0,15
58648,kundasobhāsalakkhaṇā,kundasobhasalakkhana,3,0,3,0,20
58649,sabbatthasiddhi,sabbatthasiddhi,1,0,1,0,15
58650,sabbatthasiddhassa,sabbatthasiddhassa,2,2,0,0,18
58651,cūḷakapuṭena,culakaputena,2,2,0,0,12
58652,peyyā,peyya,7,6,1,0,5
58653,pātabbā,patabba,7,7,0,0,7
58654,kundakusumassa,kundakusumassa,1,1,0,0,14
58655,sobhāsavantā,sobhasavanta,1,1,0,0,12
58656,jutivijambhino,jutivijambhino,1,1,0,0,14
58657,disantāni,disantani,1,1,0,0,9
58658,dravayuttasamādhino,dravayuttasamadhino,1,1,0,0,19
58659,sabbatthi,sabbatthi,2,1,1,0,9
58660,sabbakicce,sabbakicce,2,2,0,0,10
58661,parinipphanna,parinipphanna,1,1,0,0,13
58662,nipphannehi,nipphannehi,2,2,0,0,11
58663,sabbatthehi,sabbatthehi,1,1,0,0,11
58664,samannāgata,samannagata,2,2,0,0,11
58665,kundasobhāhi,kundasobhahi,1,1,0,0,12
58666,samānalakkhaṇā,samanalakkhana,16,15,1,0,14
58667,kundasobhāsadisā,kundasobhasadisa,1,1,0,0,16
58668,saṅkhyāmahantattā,sankhyamahantatta,1,1,0,0,17
58669,ānubhāvamahantattā,anubhavamahantatta,1,1,0,0,18
58670,arahattādayo,arahattadayo,2,2,0,0,12
58671,dasadisāsu,dasadisasu,3,3,0,0,10
58672,dravayuttaguṇabhūto,dravayuttagunabhuto,1,1,0,0,19
58673,cūḷakapuṭapeyyabhāvo,culakaputapeyyabhavo,1,1,0,0,20
58674,cūḷakameva,culakameva,1,1,0,0,10
58675,puṭamiti,putamiti,2,2,0,0,8
58676,peyyāti,peyyati,1,1,0,0,7
58677,sobhāti,sobhati,1,1,0,0,7
58678,mārāribalavissaṭṭhā,mararibalavissattha,2,0,2,0,19
58679,pādānatā,padanata,3,0,3,0,8
58680,māroyeva,maroyeva,2,2,0,0,8
58681,sattūti,sattuti,5,2,3,0,7
58682,chaḍḍitā,chaddita,22,22,0,0,8
58683,āyudhā,ayudha,1,0,1,0,6
58684,bhindivāḷādayo,bhindivaladayo,1,1,0,0,14
58685,bheṇḍivālādayo,bhendivaladayo,1,1,0,0,14
58686,pariccattatikhiṇabhāvā,pariccattatikhinabhava,1,1,0,0,22
58687,tāyeva,tayeva,77,73,4,0,6
58688,kuṇṭhabhāvappattiyā,kunthabhavappattiya,1,1,0,0,19
58689,lokappatītānubhāvānamamhākampi,lokappatitanubhavanamamhakampi,1,1,0,0,30
58690,lajjantā,lajjanta,4,4,0,0,8
58691,aññavesena,annavesena,3,1,2,0,10
58692,jāneyyuṃ,janeyyum,103,93,10,0,8
58693,āvudhavesaṃ,avudhavesam,2,2,0,0,11
58694,parivattitvā,parivattitva,127,124,3,0,12
58695,kusumavesena,kusumavesena,1,1,0,0,12
58696,sannatā,sannata,1,1,0,0,7
58697,kattudhammasamādhino,kattudhammasamadhino,1,1,0,0,20
58698,mārasattunā,marasattuna,1,1,0,0,11
58699,mārārino,mararino,5,4,1,0,8
58700,pātitā,patita,8,8,0,0,6
58701,nānāvidhāyudhā,nanavidhayudha,1,0,1,0,14
58702,anekappakārabhindivāḷaususattitomarādayo,anekappakarabhindivalaususattitomaradayo,1,1,0,0,40
58703,āvudhā,avudha,3,3,0,0,6
58704,atikhiṇā,atikhina,9,9,0,0,8
58705,lokapasiddhānubhāvānamamhākampi,lokapasiddhanubhavanamamhakampi,1,1,0,0,31
58706,vippakāramahosī,vippakaramahosi,1,1,0,0,15
58707,kathamamhe,kathamamhe,1,1,0,0,10
58708,tadaññabhūtena,tadannabhutena,1,1,0,0,14
58709,pupphavesena,pupphavesena,1,1,0,0,12
58710,pādasamīpe,padasamipe,3,3,0,0,10
58711,ahesunti,ahesunti,106,105,1,0,8
58712,kattudhammabhūtaṃ,kattudhammabhutam,1,1,0,0,17
58713,lajjanañca,lajjananca,1,1,0,0,10
58714,parivattanañca,parivattananca,3,3,0,0,14
58715,ānatañceti,anatanceti,1,1,0,0,10
58716,lajjanādīnaṃ,lajjanadinam,1,1,0,0,12
58717,akattubhūtesu,akattubhutesu,1,1,0,0,13
58718,āropitā,aropita,24,24,0,0,7
58719,arīti,ariti,3,3,0,0,5
58720,vissaṭṭhāti,vissatthati,4,4,0,0,11
58721,mārārinā,mararina,1,1,0,0,8
58722,balavissaṭṭhāti,balavissatthati,1,1,0,0,15
58723,senāti,senati,13,9,4,0,6
58724,anekavidhā,anekavidha,41,41,0,0,10
58725,vesoti,vesoti,1,1,0,0,6
58726,bodhodayācale,bodhodayacale,2,0,2,0,13
58727,indamandhatamaṃ,indamandhatamam,1,0,1,0,15
58728,sabbaññutaññāṇasadiso,sabbannutannanasadiso,2,2,0,0,21
58729,udayācalo,udayacalo,1,0,1,0,9
58730,udayapabbato,udayapabbato,1,1,0,0,12
58731,rattipariyante,rattipariyante,34,34,0,0,14
58732,abhinikkhantasamaye,abhinikkhantasamaye,1,1,0,0,19
58733,pātubhūto,patubhuto,18,16,2,0,9
58734,munindasadiso,munindasadiso,2,2,0,0,13
58735,saddhammasadisena,saddhammasadisena,2,2,0,0,17
58736,saddhammasaṅkhatena,saddhammasankhatena,1,1,0,0,19
58737,raṃsinā,ramsina,4,4,0,0,7
58738,bhindaṃ,bhindam,3,0,3,0,7
58739,padālento,padalento,4,4,0,0,9
58740,kaṭhinadhammasamādhino,kathinadhammasamadhino,1,1,0,0,22
58741,sabbaññutaññāṇasadise,sabbannutannanasadise,1,1,0,0,21
58742,sabbaññutaññāṇasaṅkhāte,sabbannutannanasankhate,2,2,0,0,23
58743,udayapabbate,udayapabbate,1,1,0,0,12
58744,kālodito,kalodito,1,0,1,0,8
58745,rattikkhaye,rattikkhaye,8,8,0,0,11
58746,māraparājitasamaye,maraparajitasamaye,1,1,0,0,18
58747,munindabhānumā,munindabhanuma,1,0,1,0,14
58748,pakatighanandhakāraṃ,pakatighanandhakaram,1,1,0,0,20
58749,bahalamohandhakāraṃ,bahalamohandhakaram,1,1,0,0,19
58750,saddhammabhūtena,saddhammabhutena,1,1,0,0,16
58751,kiraṇena,kiranena,2,2,0,0,8
58752,matisayena,matisayena,4,4,0,0,10
58753,thaddhadhammabhūtaṃ,thaddhadhammabhutam,1,1,0,0,19
58754,asarīrabhūte,asarirabhute,1,1,0,0,12
58755,bhānumāti,bhanumati,1,1,0,0,9
58756,udayācaloti,udayacaloti,1,1,0,0,11
58757,vamanuggiranādye,vamanuggiranadye,1,0,1,0,16
58758,guṇavutyapariccutaṃ,gunavutyapariccutam,2,0,2,0,19
58759,atisundaramaññaṃ,atisundaramannam,1,0,1,0,16
58760,mukhyavisayeti,mukhyavisayeti,1,1,0,0,14
58761,dassanto,dassanto,7,7,0,0,8
58762,vamanaṃ,vamanam,42,34,8,0,7
58763,vamanañca,vamananca,2,2,0,0,9
58764,uggiranañca,uggirananca,1,1,0,0,11
58765,virecanādipariggaho,virecanadipariggaho,1,1,0,0,19
58766,padhānetarā,padhanetara,1,1,0,0,11
58767,pasiddhavisayā,pasiddhavisaya,1,1,0,0,14
58768,visayantarapariggahalakkhaṇā,visayantarapariggahalakkhana,1,1,0,0,28
58769,payogarūpā,payogarupa,1,1,0,0,10
58770,apariccutaṃ,apariccutam,1,0,1,0,11
58771,aparigaḷitaṃ,aparigalitam,1,1,0,0,12
58772,amukhyabhūtaṃ,amukhyabhutam,2,2,0,0,13
58773,atisundaraṃ,atisundaram,7,3,4,0,11
58774,accantamanoharamalaṅkārarūpattā,accantamanoharamalankararupatta,1,1,0,0,31
58775,mukhyanti,mukhyanti,1,1,0,0,9
58776,asabbhasabhāvaṃ,asabbhasabhavam,1,1,0,0,15
58777,tassānucitabhāvato,tassanucitabhavato,1,1,0,0,18
58778,paṭilabhati,patilabhati,402,394,8,0,11
58779,pasavatīti,pasavatiti,48,27,21,0,10
58780,imesuyeva,imesuyeva,16,14,2,0,9
58781,pāṇidhammādīsu,panidhammadisu,1,1,0,0,14
58782,mukhyavisaye,mukhyavisaye,2,2,0,0,12
58783,apasatthoti,apasatthoti,1,1,0,0,11
58784,vamanuggi,vamanuggi,1,0,1,0,9
58785,vamanuggiranādi,vamanuggiranadi,1,0,1,0,15
58786,vamanauggiranavirecanādikaṃ,vamanauggiranavirecanadikam,1,1,0,0,27
58787,amukhyapayogato,amukhyapayogato,1,1,0,0,15
58788,agaḷitaṃ,agalitam,4,4,0,0,8
58789,atipiyaṃ,atipiyam,2,2,0,0,8
58790,uttato,uttato,2,2,0,0,6
58791,byatirekaṃ,byatirekam,10,10,0,0,10
58792,vamanuggiranādikaṃ,vamanuggiranadikam,1,1,0,0,18
58793,sabhāvaappiyagāmmadosataṃ,sabhavaappiyagammadosatam,1,1,0,0,25
58794,uggiranañceti,uggirananceti,1,1,0,0,13
58795,appadhānā,appadhana,3,3,0,0,9
58796,apariccutanti,apariccutanti,1,1,0,0,13
58797,munipādanakhāvalī,munipadanakhavali,2,0,2,0,17
58798,pivantīva,pivantiva,2,0,2,0,9
58799,kantīna,kantina,2,0,2,0,7
58800,pādanakhānaṃ,padanakhanam,1,1,0,0,12
58801,āvalī,avali,1,0,1,0,5
58802,seṇiyo,seniyo,2,2,0,0,6
58803,nissarantīnaṃ,nissarantinam,1,1,0,0,13
58804,sobhāvisesānaṃ,sobhavisesanam,1,1,0,0,14
58805,uggiranalesena,uggiranalesena,2,2,0,0,14
58806,candacchaviyo,candacchaviyo,1,1,0,0,13
58807,patthaṭattā,patthatatta,14,13,1,0,11
58808,takkemi,takkemi,3,3,0,0,7
58809,parikappanābījamāha,parikappanabijamaha,1,1,0,0,19
58810,pabhāvirahitaṃ,pabhavirahitam,1,1,0,0,14
58811,vidahamānā,vidahamana,2,2,0,0,10
58812,idañhi,idanhi,389,378,11,0,6
58813,kappanābījaṃ,kappanabijam,1,1,0,0,12
58814,nakhasobhāliṅganena,nakhasobhalinganena,1,1,0,0,19
58815,sobhāvato,sobhavato,1,1,0,0,9
58816,nippabhattaṃ,nippabhattam,1,1,0,0,12
58817,mahattañca,mahattanca,2,2,0,0,10
58818,nakhāvaliyo,nakhavaliyo,2,2,0,0,11
58819,parikappeti,parikappeti,24,23,1,0,11
58820,kantīnañca,kantinanca,1,1,0,0,10
58821,vamanabyājaṃ,vamanabyajam,1,1,0,0,12
58822,iṭṭhavisaye,itthavisaye,3,3,0,0,11
58823,payuttavamanuggiranādīnamudāharaṇamuddisati,payuttavamanuggiranadinamudaharanamuddisati,1,1,0,0,43
58824,munipādanakhaseṇiyo,munipadanakhaseniyo,1,1,0,0,19
58825,candamarīcisadisasobhānaṃ,candamaricisadisasobhanam,1,1,0,0,25
58826,nimmalacandaṃ,nimmalacandam,1,1,0,0,13
58827,candaraṃsiyo,candaramsiyo,1,1,0,0,12
58828,sappabhassāpi,sappabhassapi,1,1,0,0,13
58829,nippabhattañca,nippabhattanca,1,1,0,0,14
58830,adhikattañca,adhikattanca,1,1,0,0,12
58831,iveti,iveti,2,1,1,0,5
58832,nakhāvalīnaṃ,nakhavalinam,1,1,0,0,12
58833,candakantipivanañca,candakantipivananca,1,1,0,0,19
58834,sakakantivamanañca,sakakantivamananca,1,1,0,0,18
58835,byājamiti,byajamiti,2,2,0,0,9
58836,parikappitaṃ,parikappitam,24,23,1,0,12
58837,bhattasitthādimukhyavisayato,bhattasitthadimukhyavisayato,1,1,0,0,28
58838,aññakantisaṅkhataamukhyavisaye,annakantisankhataamukhyavisaye,1,1,0,0,30
58839,guṇavuttīti,gunavuttiti,1,1,0,0,11
58840,vamanameva,vamanameva,1,1,0,0,10
58841,nakhāti,nakhati,4,2,2,0,7
58842,kantiyoti,kantiyoti,2,2,0,0,9
58843,pabhāhīti,pabhahiti,1,1,0,0,9
58844,rujhamiccevaṃ,rujhamiccevam,1,0,1,0,13
58845,guṇakamma,gunakamma,1,0,1,0,9
58846,guṇakammakaṃ,gunakammakam,1,1,0,0,12
58847,acitta,acitta,1,0,1,0,6
58848,acitto,acitto,5,5,0,0,6
58849,vamanādi,vamanadi,1,1,0,0,8
58850,rujha,rujha,1,0,1,0,5
58851,matimanoharaṃ,matimanoharam,1,1,0,0,13
58852,bandhocitattā,bandhocitatta,2,2,0,0,13
58853,acittakattāro,acittakattaro,1,1,0,0,13
58854,guṇakammanti,gunakammanti,1,1,0,0,12
58855,vamanamatrātisundaraṃ,vamanamatratisundaram,1,1,0,0,21
58856,nedameva,nedameva,1,1,0,0,8
58857,rujhanti,rujhanti,1,1,0,0,8
58858,sacitta,sacitta,1,0,1,0,7
58859,vamanādikaṃ,vamanadikam,3,3,0,0,11
58860,sacittakattukampiyadiguṇakammaṃ,sacittakattukampiyadigunakammam,1,1,0,0,31
58861,anantarodāharaṇassa,anantarodaharanassa,1,1,0,0,19
58862,pasatthattañca,pasatthattanca,1,1,0,0,14
58863,sacittakattukavamanādikañca,sacittakattukavamanadikanca,1,1,0,0,27
58864,iṭṭhamiti,itthamiti,1,1,0,0,9
58865,acittakattuka,acittakattuka,1,0,1,0,13
58866,miccādimāha,miccadimaha,3,3,0,0,11
58867,nakhāvalisaṅkhātaaviññāṇakakattuvantaṃ,nakhavalisankhataavinnanakakattuvantam,1,1,0,0,38
58868,nakhakantisaṅkhātaappadhānakammavantaṃ,nakhakantisankhataappadhanakammavantam,1,1,0,0,38
58869,rujhaṃ,rujham,1,0,1,0,6
58870,rucijanakaṃ,rucijanakam,1,1,0,0,11
58871,sacittakattukampi,sacittakattukampi,1,0,1,0,17
58872,saviññāṇakakattuvantampi,savinnanakakattuvantampi,1,1,0,0,24
58873,amukhyakammaṃ,amukhyakammam,1,1,0,0,13
58874,visiṭṭhameva,visitthameva,4,4,0,0,12
58875,bhāvasambandhe,bhavasambandhe,1,1,0,0,14
58876,vamanakriyāya,vamanakriyaya,1,1,0,0,13
58877,nātivattati,nativattati,98,93,5,0,11
58878,acittā,acitta,7,7,0,0,6
58879,vacanavacanīyānaṃ,vacanavacaniyanam,1,1,0,0,17
58880,vacanavacanīyādīnaṃ,vacanavacaniyadinam,1,1,0,0,19
58881,nigamārambhe,nigamarambhe,1,1,0,0,12
58882,uggirantova,uggirantova,2,0,2,0,11
58883,sneharasaṃ,sneharasam,3,0,3,0,10
58884,sampīṇaye,sampinaye,3,0,3,0,9
58885,tadudāharati,tadudaharati,1,1,0,0,12
58886,uggirantovā,uggirantova,1,0,1,0,11
58887,sakalasattanikāye,sakalasattanikaye,2,2,0,0,17
58888,pemasaṅkhātaṃ,pemasankhatam,1,1,0,0,13
58889,anurāgaṃ,anuragam,1,1,0,0,8
58890,vamanto,vamanto,2,2,0,0,7
58891,atipaṇītaṃ,atipanitam,13,13,0,0,10
58892,sacitto,sacitto,1,1,0,0,7
58893,sneharaso,sneharaso,1,1,0,0,9
58894,sacittakakattupakkhe,sacittakakattupakkhe,1,1,0,0,20
58895,pemasaṅkhātaanurāgaṃ,pemasankhataanuragam,1,1,0,0,20
58896,ādikalyāṇādibhāvena,adikalyanadibhavena,4,4,0,0,19
58897,uggiranaṃ,uggiranam,1,1,0,0,9
58898,jinavarasaṅkhatasacittakakattuvantampi,jinavarasankhatasacittakakattuvantampi,1,1,0,0,38
58899,sneharasasaṅkhātaamukhyakammayuttattā,sneharasasankhataamukhyakammayuttatta,1,1,0,0,37
58900,anurāgoti,anuragoti,1,1,0,0,9
58901,niccakatābhiyogo,niccakatabhiyogo,3,1,2,0,16
58902,mogayha,mogayha,1,0,1,0,7
58903,ganthantarāhitavāsanāya,ganthantarahitavasanaya,1,1,0,0,23
58904,tadanubandhapaṭibhāne,tadanubandhapatibhane,1,1,0,0,21
58905,cāvijjamānepi,cavijjamanepi,1,1,0,0,13
58906,abhiyogabalena,abhiyogabalena,1,1,0,0,14
58907,kavitā,kavita,6,5,1,0,6
58908,tadanugatā,tadanugata,3,3,0,0,10
58909,samupalabbhatīti,samupalabbhatiti,2,2,0,0,16
58910,samanusāsati,samanusasati,3,3,0,0,12
58911,byākaraṇe,byakarane,27,27,0,0,9
58912,nighaṇṭumhi,nighantumhi,1,0,1,0,11
58913,vuttijātippapañcapakāsakachandovicitisatthe,vuttijatippapancapakasakachandovicitisatthe,1,1,0,0,43
58914,alaṅkatisu,alankatisu,2,1,1,0,10
58915,alaṅkārasatthe,alankarasatthe,2,2,0,0,14
58916,saddasattheyeva,saddasattheyeva,2,2,0,0,15
58917,manavarataṃ,manavaratam,2,2,0,0,11
58918,abhiyogo,abhiyogo,20,17,3,0,8
58919,racanāvisaye,racanavisaye,1,1,0,0,12
58920,bandhakaraṇasaṅkhātakaviguṇaparihīnopi,bandhakaranasankhatakavigunaparihinopi,1,1,0,0,38
58921,kaviguṇopetesu,kavigunopetesu,1,1,0,0,14
58922,ogayha,ogayha,30,26,4,0,6
58923,paṭilabhitvā,patilabhitva,294,288,6,0,12
58924,amandarūpaṃ,amandarupam,2,0,2,0,11
58925,atibahuṃ,atibahum,24,23,1,0,8
58926,parisuddhabandharacanālakkhaṇaṃ,parisuddhabandharacanalakkhanam,1,1,0,0,31
58927,tappabhavaṃ,tappabhavam,4,4,0,0,11
58928,paṭilabhatevāti,patilabhatevati,1,1,0,0,15
58929,subodhālaṅkāraṭīkāyaṃ,subodhalankaratikayam,4,4,0,0,21
58930,guṇāvabodhaparicchedo,gunavabodhaparicchedo,1,1,0,0,21
58931,byākaraṇanighaṇṭuchandoparivārite,byakarananighantuchandoparivarite,1,1,0,0,33
58932,ihalokiyādimahantayasassa,ihalokiyadimahantayasassa,1,1,0,0,25
58933,sissānamanusāsanto,sissanamanusasanto,1,1,0,0,18
58934,theranavamajjhimesu,theranavamajjhimesu,5,5,0,0,19
58935,saddānusāsanabyākaraṇavisaye,saddanusasanabyakaranavisaye,1,1,0,0,28
58936,pakatipaccayādivibhāgakappanāya,pakatipaccayadivibhagakappanaya,1,1,0,0,31
58937,nighaṇṭuchandoalaṅkatīsu,nighantuchandoalankatisu,1,0,1,0,24
58938,abhidhānachandoalaṅkārasatthesupi,abhidhanachandoalankarasatthesupi,1,1,0,0,33
58939,taṃtaṃvibhāgabuddhīnaṃ,tamtamvibhagabuddhinam,1,1,0,0,22
58940,paṭipādanena,patipadanena,3,3,0,0,12
58941,dhāraṇamanasikāravasena,dharanamanasikaravasena,1,1,0,0,23
58942,katussāho,katussaho,1,1,0,0,9
58943,appamādī,appamadi,3,3,0,0,8
58944,pakatisiddhakabbaracanaguṇarahitopi,pakatisiddhakabbaracanagunarahitopi,1,1,0,0,35
58945,kabbakattūsu,kabbakattusu,1,1,0,0,12
58946,kabbakaraṇaṭīkākaraṇādipakārena,kabbakaranatikakaranadipakarena,1,1,0,0,31
58947,ogāhetvā,ogahetva,99,97,2,0,8
58948,pāpuṇitvā,papunitva,187,183,4,0,9
58949,anappakasabhāvaṃ,anappakasabhavam,1,1,0,0,16
58950,sattharacanalakkhaṇaṃ,sattharacanalakkhanam,1,1,0,0,21
58951,puññasañcayaṃ,punnasancayam,9,8,1,0,13
58952,pasiddhiṃ,pasiddhim,3,3,0,0,9
58953,labhatevāti,labhatevati,2,2,0,0,11
58954,yathāvuttasatthesu,yathavuttasatthesu,1,1,0,0,18
58955,ekantakāraṇameva,ekantakaranameva,1,1,0,0,16
58956,bahunimmalaṃ,bahunimmalam,2,2,0,0,12
58957,cābhiyogo,cabhiyogo,1,1,0,0,9
58958,sabhāvasiddhā,sabhavasiddha,6,6,0,0,13
58959,nijjaṭaṃ,nijjatam,47,41,6,0,8
58960,ayameso,ayameso,4,3,1,0,7
58961,kabbaracanāyaṃ,kabbaracanayam,3,3,0,0,14
58962,tappaccayañca,tappaccayanca,3,2,1,0,13
58963,desañca,desanca,13,13,0,0,7
58964,saddasatthanti,saddasatthanti,1,1,0,0,14
58965,kusaloti,kusaloti,55,27,28,0,8
58966,alaṅkārañceti,alankaranceti,1,1,0,0,13
58967,satthāpekkhāya,satthapekkhaya,1,1,0,0,14
58968,vikaloti,vikaloti,1,1,0,0,8
58969,amandaṃ,amandam,1,1,0,0,7
58970,atthālaṅkārāvabodhapariccheda,atthalankaravabodhapariccheda,1,1,0,0,29
58971,kantāva,kantava,2,0,2,0,7
58972,yatoaccantakantāva,yatoaccantakantava,1,1,0,0,18
58973,vuccantete,vuccantete,1,0,1,0,10
58974,sampatyatthālaṅkāraṃ,sampatyatthalankaram,1,1,0,0,20
58975,bodhayitumāha,bodhayitumaha,1,1,0,0,13
58976,yathāvuttehi,yathavuttehi,97,97,0,0,12
58977,pasādādīhi,pasadadihi,1,1,0,0,10
58978,saddaguṇehi,saddagunehi,1,1,0,0,11
58979,kabbaracanaṃ,kabbaracanam,1,1,0,0,12
58980,alaṅkarīyati,alankariyati,1,1,0,0,12
58981,sarīramiva,sariramiva,1,1,0,0,10
58982,hārādīhīti,haradihiti,1,1,0,0,10
58983,atthālaṅkārehi,atthalankarehi,1,1,0,0,14
58984,jātyādilakkhaṇehi,jatyadilakkhanehi,1,1,0,0,17
58985,patibbatādiguṇopetā,patibbatadigunopeta,1,1,0,0,19
58986,atisayaramaṇīyā,atisayaramaniya,1,1,0,0,15
58987,kathīyanti,kathiyanti,13,13,0,0,10
58988,saddālaṅkāravibhāgaṃ,saddalankaravibhagam,1,1,0,0,20
58989,tannissayaṃyeva,tannissayamyeva,1,1,0,0,15
58990,atthālaṅkārabandhamārabhanto,atthalankarabandhamarabhanto,1,1,0,0,28
58991,atthālaṅkāri,atthalankari,1,0,1,0,12
58992,yathāvuttapasādādisaddaguṇayuttā,yathavuttapasadadisaddagunayutta,1,1,0,0,32
58993,pajjagajjādipabhedā,pajjagajjadipabheda,1,1,0,0,19
58994,racanāvali,racanavali,1,1,0,0,10
58995,sabhāvavuttivaṅkavuttisaṅkhātena,sabhavavuttivankavuttisankhatena,1,1,0,0,32
58996,patibbatādīhi,patibbatadihi,1,1,0,0,13
58997,suvaṇṇarajatamaṇimuttādidhanehi,suvannarajatamanimuttadidhanehi,1,1,0,0,31
58998,gīveyyakaṭakanūpurādīhi,giveyyakatakanupuradihi,1,1,0,0,23
58999,aṅganāva,anganava,1,1,0,0,8
59000,sahitāti,sahitati,6,2,4,0,8
59001,kantāti,kantati,11,1,10,0,7
59002,sabhāvavaṅkavuttīnaṃ,sabhavavankavuttinam,2,1,1,0,20
59003,nānāvatthāvibhāvinī,nanavatthavibhavini,2,0,2,0,19
59004,katippabhedā,katippabheda,1,1,0,0,12
59005,vaṅkavuttīti,vankavuttiti,1,1,0,0,12
59006,atthālaṅkārādvi,atthalankaradvi,1,1,0,0,15
59007,jātiguṇakriyādabbasabhāvānaṃ,jatigunakriyadabbasabhavanam,1,1,0,0,28
59008,dvekāva,dvekava,1,1,0,0,7
59009,avatthā,avattha,33,32,1,0,7
59010,avasarā,avasara,2,2,0,0,7
59011,pakāsikā,pakasika,6,4,2,0,8
59012,yathāsabhāvamanekappakāraṃ,yathasabhavamanekappakaram,1,1,0,0,26
59013,vivarantī,vivaranti,1,1,0,0,9
59014,padatthasarūpassa,padatthasarupassa,1,1,0,0,17
59015,tathātathāpaṭipādakattena,tathatathapatipadakattena,1,1,0,0,25
59016,dattiyā,dattiya,16,16,0,0,7
59017,jātipi,jatipi,48,44,4,0,6
59018,pasatthālaṅkārā,pasatthalankara,1,1,0,0,15
59019,pasatthādialaṅkārā,pasatthadialankara,1,1,0,0,18
59020,pabhedato,pabhedato,147,129,18,0,9
59021,ettakāti,ettakati,17,15,2,0,8
59022,tāsudvīsu,tasudvisu,1,1,0,0,9
59023,jātiguṇakriyādabbalakkhaṇānaṃ,jatigunakriyadabbalakkhananam,1,1,0,0,29
59024,anekappakārassa,anekappakarassa,2,2,0,0,15
59025,pakāsinī,pakasini,1,1,0,0,8
59026,anekappakārasabhāvapakāsinī,anekappakarasabhavapakasini,1,1,0,0,27
59027,esāva,esava,18,17,1,0,5
59028,guṇādicatubbidhapadatthānaṃ,gunadicatubbidhapadatthanam,1,1,0,0,27
59029,sarūpasaṅkhātajātiyā,sarupasankhatajatiya,1,1,0,0,20
59030,ākārehi,akarehi,682,661,21,0,7
59031,jātyādipadatthānaṃyeva,jatyadipadatthanamyeva,1,1,0,0,22
59032,vatthuparikappitaatisayopamārūpakādisarūpasaṅkhātaṃ,vatthuparikappitaatisayopamarupakadisarupasankhatam,1,1,0,0,51
59033,vaṅkasabhāvaṃ,vankasabhavam,1,1,0,0,13
59034,pakāsentī,pakasenti,30,30,0,0,9
59035,yabhāvo,yabhavo,1,1,0,0,7
59036,alaṃkaronti,alamkaronti,1,1,0,0,11
59037,etāhīti,etahiti,11,9,2,0,7
59038,līlāvikantisubhago,lilavikantisubhago,3,1,2,0,18
59039,disāthiravilokano,disathiravilokano,2,0,2,0,17
59040,vācamāsabhiṃ,vacamasabhim,2,1,1,0,12
59041,vilāsena,vilasena,7,7,0,0,8
59042,vihitāya,vihitaya,3,3,0,0,8
59043,vikantiyā,vikantiya,1,0,1,0,9
59044,sattapadavītihārasaṅkhātena,sattapadavitiharasankhatena,1,1,0,0,27
59045,macalaṃ,macalam,2,2,0,0,7
59046,vilokanaṃ,vilokanam,13,9,4,0,9
59047,tadahujāto,tadahujato,2,2,0,0,10
59048,āsabhiṃ,asabhim,28,15,13,0,7
59049,aggohamasmī,aggohamasmi,4,4,0,0,11
59050,itiādikamuttamaṃ,itiadikamuttamam,1,1,0,0,16
59051,nibbhayavacanaṃ,nibbhayavacanam,1,1,0,0,15
59052,ramaṇīyattaṃ,ramaniyattam,3,3,0,0,12
59053,jātisabhāvavutyādayopi,jatisabhavavutyadayopi,1,1,0,0,22
59054,parikappanīyā,parikappaniya,1,1,0,0,13
59055,sabhāvavuttiyā,sabhavavuttiya,1,1,0,0,14
59056,līlāvikanti,lilavikanti,1,0,1,0,11
59057,vilāsagamanena,vilasagamanena,1,1,0,0,14
59058,sattapadavītihārena,sattapadavitiharena,47,44,3,0,19
59059,acalaolokano,acalaolokano,1,1,0,0,12
59060,mahābodhisattaṅkuro,mahabodhisattankuro,1,1,0,0,19
59061,abhītavacanaṃ,abhitavacanam,1,1,0,0,13
59062,asobhīti,asobhiti,1,1,0,0,8
59063,bodhisattasaṅkhātassa,bodhisattasankhatassa,1,1,0,0,21
59064,līlāvikantidisāthiravilokanavaconicchāraṇasaṅkhatānaṃ,lilavikantidisathiravilokanavaconiccharanasankhatanam,1,1,0,0,53
59065,avatthānaṃ,avatthanam,12,10,2,0,10
59066,pakāsitattā,pakasitatta,44,43,1,0,11
59067,dabbasabhāvavuttīti,dabbasabhavavuttiti,1,1,0,0,19
59068,esāyeva,esayeva,3,3,0,0,7
59069,dabbagatagatyādivicitrasarūpaṃ,dabbagatagatyadivicitrasarupam,1,1,0,0,30
59070,alaṅkaraṇato,alankaranato,1,1,0,0,12
59071,dabbagatagatyādayo,dabbagatagatyadayo,1,1,0,0,18
59072,alaṃkiriyamānattā,alamkiriyamanatta,1,1,0,0,17
59073,alaṃkiriyā,alamkiriya,1,1,0,0,10
59074,jātiguṇakriyāsabhāvavuttiyopi,jatigunakriyasabhavavuttiyopi,1,1,0,0,29
59075,vikantīti,vikantiti,1,1,0,0,9
59076,subhagoti,subhagoti,1,1,0,0,9
59077,thiraṃ,thiram,119,111,8,0,6
59078,aṅkuroti,ankuroti,2,2,0,0,8
59079,bhāvasaṅkhātā,bhavasankhata,3,3,0,0,13
59080,akampanīyā,akampaniya,3,3,0,0,10
59081,āsabhaṃ,asabham,166,136,30,0,7
59082,akampabhāvato,akampabhavato,1,1,0,0,13
59083,samāpi,samapi,1,1,0,0,6
59084,āsabhī,asabhi,15,12,3,0,6
59085,parābhave,parabhave,13,10,3,0,9
59086,bījopadassanaṃ,bijopadassanam,2,0,2,0,14
59087,dutiyamāha,dutiyamaha,2,2,0,0,10
59088,jātyādirūpassa,jatyadirupassa,1,1,0,0,14
59089,yādisaṃ,yadisam,116,112,4,0,7
59090,aññathābhāvena,annathabhavena,6,6,0,0,14
59091,dabbāpanena,dabbapanena,1,1,0,0,11
59092,sakkāti,sakkati,307,278,29,0,7
59093,anantavikappattā,anantavikappatta,2,0,2,0,16
59094,aparimitabhedakattā,aparimitabhedakatta,1,1,0,0,19
59095,sakalabyattibyāpisāmaññarūpassa,sakalabyattibyapisamannarupassa,1,1,0,0,31
59096,vicittālaṅkārā,vicittalankara,1,1,0,0,14
59097,pasavanti,pasavanti,50,50,0,0,9
59098,upadassanaṃ,upadassanam,1,0,1,0,11
59099,niravasesābhidhānassa,niravasesabhidhanassa,1,1,0,0,21
59100,kenāpyasakkuṇeyyattā,kenapyasakkuneyyatta,1,1,0,0,20
59101,vaṅkavuttiṃ,vankavuttim,1,1,0,0,11
59102,jātyādipadatthasambandhino,jatyadipadatthasambandhino,1,1,0,0,26
59103,avatthāsu,avatthasu,29,29,0,0,9
59104,vijjamānākāraṃ,vijjamanakaram,1,1,0,0,14
59105,vattuparikappitena,vattuparikappitena,1,1,0,0,18
59106,atisayaupamārūpakādiaññapakārena,atisayaupamarupakadiannapakarena,1,1,0,0,32
59107,sabhāvavuttito,sabhavavuttito,1,1,0,0,14
59108,appamāṇapakkhattā,appamanapakkhatta,1,1,0,0,17
59109,parisamāpetuṃ,parisamapetum,1,1,0,0,13
59110,asakkuṇeyyattā,asakkuneyyatta,108,108,0,0,14
59111,nayato,nayato,132,129,3,0,6
59112,anantapakkhassa,anantapakkhassa,1,1,0,0,15
59113,pariggahaṇatthaṃ,pariggahanattham,1,1,0,0,16
59114,kāraṇamattassa,karanamattassa,1,1,0,0,14
59115,vakkhamānabhedato,vakkhamanabhedato,1,1,0,0,17
59116,ekamekampi,ekamekampi,5,5,0,0,10
59117,anantabhedapariggahajānanatthaṃ,anantabhedapariggahajananattham,1,1,0,0,31
59118,pahotīti,pahotiti,41,13,28,0,8
59119,sabhāvoti,sabhavoti,60,46,14,0,9
59120,sabhāvasseti,sabhavasseti,1,1,0,0,12
59121,upadassananti,upadassananti,1,1,0,0,13
59122,vaṅkavuttiatthālaṅkārauddesavaṇṇanā,vankavuttiatthalankarauddesavannana,1,1,0,0,35
59123,tisayaupamā,tisayaupama,1,0,1,0,11
59124,rūpakāvuttidīpakaṃ,rupakavuttidipakam,1,0,1,0,18
59125,hetukkamo,hetukkamo,3,2,1,0,9
59126,samāsaparikappanā,samasaparikappana,1,1,0,0,17
59127,pariyāyavuttibyājopavaṇṇanaṃ,pariyayavuttibyajopavannanam,1,0,1,0,28
59128,parivuttibbhamobhāvo,parivuttibbhamobhavo,1,0,1,0,20
59129,jīvitamuccate,jivitamuccate,1,0,1,0,13
59130,para168-172,para168-172,2,2,0,0,11
59131,yathoddesaṃ,yathoddesam,1,1,0,0,11
59132,niddisitukāmo,niddisitukamo,16,16,0,0,13
59133,vaṅkavuttiyaṃ,vankavuttiyam,2,2,0,0,13
59134,samuddiṭṭhāti,samudditthati,1,0,1,0,13
59135,rūpakaṃ,rupakam,23,22,1,0,7
59136,dīpakañca,dipakanca,1,1,0,0,9
59137,ruḷhāhaṅkāro,rulhahankaro,1,1,0,0,12
59138,jīvitamuccateti,jivitamuccateti,1,0,1,0,15
59139,chavasseva,chavasseva,1,1,0,0,10
59140,sabhāvavuttiṃ,sabhavavuttim,1,1,0,0,13
59141,vatthusabhāvato,vatthusabhavato,2,2,0,0,15
59142,parikappanarūpāsu,parikappanarupasu,1,1,0,0,17
59143,atisayādīsu,atisayadisu,1,1,0,0,11
59144,vuttīsu,vuttisu,2,2,0,0,7
59145,bhedavantānaṃ,bhedavantanam,1,1,0,0,13
59146,sabhāvakathanaṃ,sabhavakathanam,3,3,0,0,15
59147,vattamānehi,vattamanehi,26,26,0,0,11
59148,tatthātisaya,tatthatisaya,1,0,1,0,12
59149,gāthācatukkamāha,gathacatukkamaha,1,1,0,0,16
59150,pañcatiṃsa,pancatimsa,52,51,1,0,10
59151,niddese,niddese,291,268,23,0,7
59152,āvibhavissati,avibhavissati,71,71,0,0,13
59153,atippasatthoti,atippasatthoti,1,1,0,0,14
59154,bhāvālaṅkāro,bhavalankaro,2,2,0,0,12
59155,pāṇabhūtoti,panabhutoti,1,1,0,0,11
59156,bhāvarahitassa,bhavarahitassa,1,1,0,0,14
59157,chavasarīrassa,chavasarirassa,2,2,0,0,14
59158,silesālaṅkāro,silesalankaro,1,1,0,0,13
59159,atisayopamādivaṅkavuttīsu,atisayopamadivankavuttisu,1,1,0,0,25
59160,mukkaṃsabhūtaṃ,mukkamsabhutam,1,1,0,0,14
59161,niddesavaṇṇanā,niddesavannana,13,12,1,0,14
59162,lokātikkantavisayā,lokatikkantavisaya,4,1,3,0,18
59163,lokiyāti,lokiyati,16,12,4,0,8
59164,tatthātisayavuttīnaṃ,tatthatisayavuttinam,1,1,0,0,20
59165,niddisanto,niddisanto,58,58,0,0,10
59166,vatthugatassātimattassa,vatthugatassatimattassa,1,1,0,0,23
59167,pakāsikāyāti,pakasikayati,1,1,0,0,12
59168,atisayavutti,atisayavutti,8,7,1,0,12
59169,atisayassa,atisayassa,9,9,0,0,10
59170,ukkaṃsassa,ukkamsassa,1,1,0,0,10
59171,duvidhāti,duvidhati,16,10,6,0,9
59172,lokappatītiṃ,lokappatitim,1,1,0,0,12
59173,lokaṭhitimanatikkantattāti,lokathitimanatikkantattati,1,1,0,0,26
59174,atisayavuttiṃ,atisayavuttim,1,1,0,0,13
59175,pakāsi,pakasi,1,0,1,0,6
59176,jātyādipadatthagataadhikavisesassa,jatyadipadatthagataadhikavisesassa,1,1,0,0,34
59177,jātyādipadatthānaṃ,jatyadipadatthanam,1,1,0,0,18
59178,yathāsabhāvasaṅkhatalokaṭhityātikkantavisayattā,yathasabhavasankhatalokathityatikkantavisayatta,1,1,0,0,47
59179,lokātikkanta,lokatikkanta,1,1,0,0,12
59180,visayāti,visayati,5,4,1,0,8
59181,yathāvuttalokamanatikkamma,yathavuttalokamanatikkamma,1,1,0,0,26
59182,cevaṃ,cevam,41,37,4,0,5
59183,pasiddhaguṇānuvādena,pasiddhagunanuvadena,1,1,0,0,20
59184,apasiddhaṃ,apasiddham,1,1,0,0,10
59185,atisayavuttividhānaṃ,atisayavuttividhanam,1,1,0,0,20
59186,anuvādakaanuvādanīyabhedo,anuvadakaanuvadaniyabhedo,1,1,0,0,25
59187,uparipyevameva,uparipyevameva,1,1,0,0,14
59188,sabhāvavutyādīhi,sabhavavutyadihi,1,1,0,0,16
59189,bhinnāti,bhinnati,14,13,1,0,8
59190,vicittasarūpapaṭipādikā,vicittasarupapatipadika,1,1,0,0,23
59191,sabhāvavuttipi,sabhavavuttipi,1,1,0,0,14
59192,alaṅkāriyaṃ,alankariyam,3,3,0,0,11
59193,vatthumattaṃ,vatthumattam,6,5,1,0,12
59194,lokiyātisayassa,lokiyatisayassa,2,1,1,0,15
59195,sahajaṃ,sahajam,3,3,0,0,7
59196,sundarattaṃ,sundarattam,4,4,0,0,11
59197,posakāpi,posakapi,1,1,0,0,8
59198,muttāvalippabhuti,muttavalippabhuti,1,1,0,0,17
59199,bandhepyalaṅkāriyavatthunimittaṃ,bandhepyalankariyavatthunimittam,1,1,0,0,32
59200,dhammattaṃ,dhammattam,1,1,0,0,10
59201,ukkaṃsīyati,ukkamsiyati,1,1,0,0,11
59202,ukkaṃsoti,ukkamsoti,6,5,1,0,9
59203,atisayavuttiyeva,atisayavuttiyeva,1,1,0,0,16
59204,lokiyātisayassete,lokiyatisayassete,1,0,1,0,17
59205,dassanīyāti,dassaniyati,8,3,5,0,11
59206,paṭī,pati,11,7,4,0,4
59207,paṭipādīyateti,patipadiyateti,1,1,0,0,14
59208,dvippakārāpi,dvippakarapi,1,1,0,0,12
59209,atisayavuttisabhāvavutyādīhi,atisayavuttisabhavavutyadihi,1,1,0,0,28
59210,anaññāti,anannati,5,4,1,0,8
59211,lokiye,lokiye,35,31,4,0,6
59212,jātiguṇādipadatthagatavicittasarūpassa,jatigunadipadatthagatavicittasarupassa,1,1,0,0,38
59213,jātyādayo,jatyadayo,1,1,0,0,9
59214,jātisabhāvavuttiguṇasabhāvavutyādayo,jatisabhavavuttigunasabhavavutyadayo,1,1,0,0,36
59215,lokiyātisayavuttiyāyeva,lokiyatisayavuttiyayeva,1,1,0,0,23
59216,lokiyātisayavutti,lokiyatisayavutti,1,1,0,0,17
59217,jātisabhāvavuttiguṇasabhāvavutyādayoyevāti,jatisabhavavuttigunasabhavavutyadayoyevati,1,1,0,0,42
59218,vicitrarūpapaṭipādikā,vicitrarupapatipadika,1,1,0,0,21
59219,ukkaṃsāti,ukkamsati,1,1,0,0,9
59220,lokiyātisayavuttiyā,lokiyatisayavuttiya,1,1,0,0,19
59221,udāharaṇassa,udaharanassa,3,3,0,0,12
59222,vakkhamānaṃ,vakkhamanam,62,62,0,0,11
59223,nipphādīyati,nipphadiyati,8,8,0,0,12
59224,ādhikkamiti,adhikkamiti,1,1,0,0,11
59225,sarīrasobhāyo,sarirasobhayo,2,2,0,0,13
59226,nayanadvandasaṅkhātena,nayanadvandasankhatena,1,1,0,0,22
59227,añjalipuṭena,anjaliputena,1,1,0,0,12
59228,pipāsaṃ,pipasam,54,51,3,0,7
59229,lobhameva,lobhameva,3,3,0,0,9
59230,anupatati,anupatati,8,8,0,0,9
59231,apanayati,apanayati,3,3,0,0,9
59232,nivattituṃ,nivattitum,45,39,6,0,10
59233,asamatthosi,asamatthosi,1,1,0,0,11
59234,taṇhāharā,tanhahara,1,1,0,0,9
59235,taṇhameva,tanhameva,1,1,0,0,9
59236,nudanti,nudanti,3,3,0,0,7
59237,hanantāmapiha,hanantamapiha,1,1,0,0,13
59238,sampanudati,sampanudati,1,1,0,0,11
59239,lokaṭhitiṃ,lokathitim,1,1,0,0,10
59240,dehakantiyā,dehakantiya,1,1,0,0,11
59241,bahuttanadhammo,bahuttanadhammo,1,1,0,0,15
59242,paṭiññātānusārena,patinnatanusarena,1,1,0,0,17
59243,paṭipādeti,patipadeti,23,23,0,0,10
59244,nettasaṅkhātena,nettasankhatena,1,1,0,0,15
59245,hatthapuṭena,hatthaputena,6,6,0,0,12
59246,taṇhāvināsakopi,tanhavinasakopi,1,1,0,0,15
59247,nivāretuṃ,nivaretum,83,78,5,0,9
59248,asamatthosīti,asamatthositi,1,1,0,0,13
59249,pivanaṃ,pivanam,3,3,0,0,7
59250,lokasabhāvo,lokasabhavo,1,1,0,0,11
59251,nālamiti,nalamiti,2,2,0,0,8
59252,lokasabhāvamatikkantattho,lokasabhavamatikkantattho,1,1,0,0,25
59253,adhikapiyatā,adhikapiyata,1,1,0,0,12
59254,atisayadhammo,atisayadhammo,1,1,0,0,13
59255,lokātikkantaatthaṃ,lokatikkantaattham,1,1,0,0,18
59256,kathetumicchitaṃ,kathetumicchitam,1,1,0,0,16
59257,adhikapiyataṃ,adhikapiyatam,1,1,0,0,13
59258,taṇhāhanane,tanhahanane,1,1,0,0,11
59259,vuccamānānaṃ,vuccamananam,24,24,0,0,12
59260,upamārūpakādīnampi,upamarupakadinampi,1,1,0,0,18
59261,vaṅkavuttitā,vankavuttita,1,1,0,0,12
59262,pakārantarena,pakarantarena,48,48,0,0,13
59263,pakāsanatoyeva,pakasanatoyeva,1,1,0,0,14
59264,sarīrasahajaṃ,sarirasahajam,1,1,0,0,13
59265,pīnattādisundarattaṃ,pinattadisundarattam,1,1,0,0,20
59266,uddīpanākārena,uddipanakarena,1,1,0,0,14
59267,kaṭakauṇhīsahārādayo,katakaunhisaharadayo,1,1,0,0,20
59268,bandhasarīrasaṅkhāte,bandhasarirasankhate,1,1,0,0,20
59269,alaṅkaraṇīyavatthumhi,alankaraniyavatthumhi,1,1,0,0,21
59270,vijjamānaatipiyatādimeva,vijjamanaatipiyatadimeva,1,1,0,0,24
59271,uddīpetvā,uddipetva,1,1,0,0,9
59272,alaṅkurumānā,alankurumana,1,1,0,0,12
59273,taṇhāharosi,tanhaharosi,1,1,0,0,11
59274,kantī,kanti,1,1,0,0,5
59275,pivantānaṃ,pivantanam,7,7,0,0,10
59276,nāla,nala,5,4,1,0,4
59277,vācābhaṅgī,vacabhangi,1,1,0,0,10
59278,alaṅkātabbakantipiyatāya,alankatabbakantipiyataya,1,1,0,0,24
59279,bahuttanti,bahuttanti,1,1,0,0,10
59280,uttaripi,uttaripi,64,63,1,0,8
59281,alaṅkāraalaṅkāriyavibhāgo,alankaraalankariyavibhago,1,1,0,0,25
59282,anurūpato,anurupato,66,64,2,0,9
59283,yojanakkamo,yojanakkamo,3,3,0,0,11
59284,añjalīyeva,anjaliyeva,1,1,0,0,10
59285,puṭoti,putoti,1,1,0,0,6
59286,nettāniyeva,nettaniyeva,1,1,0,0,11
59287,añjalipuṭoti,anjaliputoti,1,1,0,0,12
59288,saddatthagammā,saddatthagamma,3,0,3,0,14
59289,vākyatthavisayāti,vakyatthavisayati,2,0,2,0,17
59290,padumādikavatthu,padumadikavatthu,1,1,0,0,16
59291,padumādiko,padumadiko,1,1,0,0,10
59292,upamānavācako,upamanavacako,1,1,0,0,13
59293,upamīyatīti,upamiyatiti,2,2,0,0,11
59294,mukhādikavatthu,mukhadikavatthu,1,1,0,0,15
59295,mukhādiko,mukhadiko,1,1,0,0,9
59296,upameyyavācako,upameyyavacako,1,1,0,0,14
59297,padumādimukhādivatthūnañca,padumadimukhadivatthunanca,1,1,0,0,26
59298,kantimantatā,kantimantata,1,1,0,0,12
59299,sadhammo,sadhammo,6,6,0,0,8
59300,sadhammasaddassa,sadhammasaddassa,1,1,0,0,16
59301,pavattinimittasamānena,pavattinimittasamanena,1,1,0,0,22
59302,upamānopameyyapatiṭṭhitaṃ,upamanopameyyapatitthitam,1,1,0,0,25
59303,upamīyati,upamiyati,7,7,0,0,9
59304,panālaṅkāriyassa,panalankariyassa,1,1,0,0,16
59305,dhammassātisayapaṭipādanappakāro,dhammassatisayapatipadanappakaro,1,1,0,0,32
59306,katividhā,katividha,18,16,2,0,9
59307,gammā,gamma,17,17,0,0,5
59308,patīyamānā,patiyamana,1,1,0,0,10
59309,saddagammaatthagammavākyatthavisayāti,saddagammaatthagammavakyatthavisayati,1,1,0,0,37
59310,upamālaṅkāraṃ,upamalankaram,1,1,0,0,13
59311,candanīluppaladalābhādīnaṃ,candaniluppaladalabhadinam,1,1,0,0,26
59312,ānananayanādīnañca,anananayanadinanca,1,1,0,0,18
59313,kantimantatāpīnatāditulyadhammasambandho,kantimantatapinataditulyadhammasambandho,1,1,0,0,40
59314,alaṅkaraṇīyavatthuno,alankaraniyavatthuno,1,1,0,0,20
59315,ādhikkapaṭipādanappakārā,adhikkapatipadanappakara,1,1,0,0,24
59316,vākyatthavisayā,vakyatthavisaya,1,1,0,0,15
59317,tippakārā,tippakara,10,10,0,0,9
59318,upamānopameyyabhūtānaṃ,upamanopameyyabhutanam,2,2,0,0,22
59319,candānanādipadatthānaṃ,candananadipadatthanam,1,1,0,0,22
59320,sadhammasaṅkhato,sadhammasankhato,1,1,0,0,16
59321,aññamaññatulyakantimantatāpīnatādidhammayogo,annamannatulyakantimantatapinatadidhammayogo,1,1,0,0,44
59322,upamatthassa,upamatthassa,1,1,0,0,12
59323,patiṭṭhitattā,patitthitatta,43,43,0,0,13
59324,upaṭṭhānatāya,upatthanataya,2,2,0,0,13
59325,tannissayacandādayo,tannissayacandadayo,1,1,0,0,19
59326,nissitavohārena,nissitavoharena,7,7,0,0,15
59327,upamānabhūtacandādiatthapaṭipādako,upamanabhutacandadiatthapatipadako,1,1,0,0,34
59328,disaddopi,disaddopi,1,1,0,0,9
59329,upameyyupameyyanissayatappaṭipādakānampi,upameyyupameyyanissayatappatipadakanampi,1,1,0,0,40
59330,upameyyabhāvo,upameyyabhavo,4,4,0,0,13
59331,upamānanti,upamananti,2,2,0,0,10
59332,candādi,candadi,2,2,0,0,7
59333,ānanādi,ananadi,1,1,0,0,7
59334,upamānañca,upamananca,1,1,0,0,10
59335,upameyyañcāti,upameyyancati,1,1,0,0,13
59336,gammāti,gammati,3,3,0,0,7
59337,upamāyāti,upamayati,4,3,1,0,9
59338,samāsapaccayevādī,samasapaccayevadi,2,0,2,0,17
59339,candimānano,candimanano,5,0,5,0,11
59340,saddagammāpi,saddagammapi,1,1,0,0,12
59341,samāsādayo,samasadayo,2,2,0,0,10
59342,vattumadhippetāti,vattumadhippetati,1,1,0,0,17
59343,samāsādīnaṃ,samasadinam,2,2,0,0,11
59344,samāsasaddagammā,samasasaddagamma,2,2,0,0,16
59345,paccayasaddagammā,paccayasaddagamma,2,2,0,0,17
59346,ivādisaddagammāti,ivadisaddagammati,2,2,0,0,17
59347,samāsasaddena,samasasaddena,2,2,0,0,13
59348,ruciramānanaṃ,ruciramananam,1,1,0,0,13
59349,candimaṃ,candimam,17,17,0,0,8
59350,rucirattaṃ,rucirattam,4,4,0,0,10
59351,candimānanānaṃ,candimanananam,1,1,0,0,14
59352,samānadhammasambandhijotako,samanadhammasambandhijotako,1,1,0,0,27
59353,sādhāraṇadhammavācakassa,sadharanadhammavacakassa,2,2,0,0,24
59354,copamājotakassāppayogo,copamajotakassappayogo,1,1,0,0,22
59355,samāseneva,samaseneva,13,13,0,0,10
59356,upamānavācakena,upamanavacakena,2,2,0,0,15
59357,sambandhamupagato,sambandhamupagato,2,2,0,0,17
59358,candagatameva,candagatameva,1,1,0,0,13
59359,mukhagataṃ,mukhagatam,15,15,0,0,10
59360,padīyate,padiyate,15,13,2,0,8
59361,evamīdisaṃ,evamidisam,3,3,0,0,10
59362,saddagammassa,saddagammassa,1,1,0,0,13
59363,tividhattaṃ,tividhattam,2,2,0,0,11
59364,āyādipaccayā,ayadipaccaya,1,1,0,0,12
59365,ivādayo,ivadayo,4,4,0,0,7
59366,gammopamā,gammopama,2,2,0,0,9
59367,candasamānamanoharamukhamaṇḍalena,candasamanamanoharamukhamandalena,1,1,0,0,33
59368,ivaiti,ivaiti,1,1,0,0,6
59369,vādīnanti,vadinanti,1,1,0,0,9
59370,sādhāraṇadhammo,sadharanadhammo,2,2,0,0,15
59371,candānanānaṃ,candanananam,2,2,0,0,12
59372,ānanagatarucirattaṃ,ananagatarucirattam,1,1,0,0,19
59373,candagatarucirattaṃ,candagatarucirattam,1,1,0,0,19
59374,ānane,anane,4,4,0,0,5
59375,samānadhammasambandhaṃ,samanadhammasambandham,1,1,0,0,22
59376,tulyadhammasaṅkhātopamājotakassa,tulyadhammasankhatopamajotakassa,1,1,0,0,32
59377,appayogo,appayogo,14,14,0,0,8
59378,candagatasadisattaṃ,candagatasadisattam,1,1,0,0,19
59379,mukhagatasadisattaṃ,mukhagatasadisattam,2,2,0,0,19
59380,candasamānamāgacchantaṃ,candasamanamagacchantam,1,1,0,0,23
59381,mukhasadisattaṃ,mukhasadisattam,1,1,0,0,15
59382,aññathānupapatti,annathanupapatti,1,1,0,0,16
59383,sāmatthiyanti,samatthiyanti,7,7,0,0,13
59384,paccayasaddagammaṃ,paccayasaddagammam,1,1,0,0,18
59385,āyādi,ayadi,2,0,2,0,5
59386,āyādīti,ayaditi,1,0,1,0,7
59387,āyaīyaka,ayaiyaka,1,0,1,0,8
59388,paccayādayo,paccayadayo,1,1,0,0,11
59389,paccayasaddā,paccayasadda,2,2,0,0,12
59390,paccayasaddehi,paccayasaddehi,2,2,0,0,14
59391,paṅkajamiva,pankajamiva,2,2,0,0,11
59392,ruciramācarati,ruciramacarati,3,3,0,0,14
59393,paṅkajamupamānaṃ,pankajamupamanam,1,1,0,0,16
59394,ācaraṇakriyāya,acaranakriyaya,3,3,0,0,14
59395,kattubhūtaṃ,kattubhutam,8,8,0,0,11
59396,ānanamupameyyaṃ,ananamupameyyam,1,1,0,0,15
59397,paṅkajānanānaṃ,pankajanananam,1,1,0,0,14
59398,samānadhammasambandhajotako,samanadhammasambandhajotako,1,1,0,0,27
59399,viyāppayogo,viyappayogo,1,1,0,0,11
59400,vuttattāti,vuttattati,70,63,7,0,10
59401,paccayasaddagammopamaṃ,paccayasaddagammopamam,1,1,0,0,22
59402,āya,aya,28,12,16,0,3
59403,īya,iya,6,1,5,0,3
59404,itiādayo,itiadayo,104,104,0,0,8
59405,dalīyatī,daliyati,1,0,1,0,8
59406,padumamiva,padumamiva,6,6,0,0,10
59407,ācarati,acarati,41,39,2,0,7
59408,nīluppalapattamiva,niluppalapattamiva,1,1,0,0,18
59409,īyādīnanti,iyadinanti,1,1,0,0,10
59410,nayanadvandamiti,nayanadvandamiti,1,1,0,0,16
59411,nīluppalassa,niluppalassa,4,4,0,0,12
59412,dalamiti,dalamiti,1,1,0,0,8
59413,ruciramācaratīti,ruciramacaratiti,1,1,0,0,16
59414,paṅkaja,pankaja,5,5,0,0,7
59415,nīluppala,niluppala,5,5,0,0,9
59416,nayanadvandañca,nayanadvandanca,1,1,0,0,15
59417,samānadhammajotako,samanadhammajotako,1,1,0,0,18
59418,tesamappayogo,tesamappayogo,1,1,0,0,13
59419,evarūpesu,evarupesu,117,113,4,0,9
59420,aññesupi,annesupi,118,116,2,0,8
59421,tulyasamāna,tulyasamana,1,0,1,0,11
59422,yathāsaṅkāsa,yathasankasa,1,0,1,0,12
59423,tulitappakāsa,tulitappakasa,1,0,1,0,13
59424,sarīsarikkha,sarisarikkha,1,0,1,0,12
59425,paṭipakkhapaccanīkasapakkho,patipakkhapaccanikasapakkho,1,0,1,0,27
59426,paṭicchannasarūpa,paticchannasarupa,1,0,1,0,17
59427,sammitā,sammita,1,0,1,0,7
59428,sadhammādi,sadhammadi,1,0,1,0,10
59429,tenādhirohati,tenadhirohati,1,0,1,0,13
59430,kacchaṃvigāhate,kacchamvigahate,1,0,1,0,15
59431,tamanvetya,tamanvetya,1,0,1,0,10
59432,nisedheti,nisedheti,19,17,2,0,9
59433,cānukaroti,canukaroti,1,0,1,0,10
59434,para179-184,para179-184,1,1,0,0,11
59435,dvande,dvande,40,26,14,0,6
59436,saddamapekkhiya,saddamapekkhiya,1,1,0,0,15
59437,pulliṅgatā,pullingata,4,4,0,0,10
59438,sadhammādī,sadhammadi,2,2,0,0,10
59439,sādhāraṇasacchāyādīnaṃ,sadharanasacchayadinam,1,1,0,0,22
59440,jayaticcādīsu,jayaticcadisu,1,1,0,0,13
59441,para179-,para179-,1,1,0,0,8
59442,ivādisaddagammopamādhikāre,ivadisaddagammopamadhikare,1,1,0,0,26
59443,ivādīti,ivaditi,1,0,1,0,7
59444,yujjanaṭṭhāne,yujjanatthane,1,1,0,0,13
59445,cātiādayo,catiadayo,5,0,5,0,9
59446,yojetabbā,yojetabba,314,310,4,0,9
59447,sādhāraṇasacchāyādayo,sadharanasacchayadayo,1,1,0,0,21
59448,issatīti,issatiti,9,6,3,0,8
59449,dvepaññāsa,dvepannasa,12,12,0,0,10
59450,akkosati,akkosati,122,118,4,0,8
59451,taṃtaṃkriyāpadasaṅkhataanukāriyānaṃ,tamtamkriyapadasankhataanukariyanam,1,1,0,0,35
59452,anukaraṇanti,anukarananti,1,1,0,0,12
59453,sandhisamāsā,sandhisamasa,2,2,0,0,12
59454,addhassā,addhassa,1,1,0,0,8
59455,sandhisamāso,sandhisamaso,1,1,0,0,12
59456,tadaddhassāti,tadaddhassati,1,1,0,0,13
59457,sandhisamāsānaṃ,sandhisamasanam,1,1,0,0,15
59458,gāthaddhassa,gathaddhassa,1,1,0,0,12
59459,ubhayaddhamajjhe,ubhayaddhamajjhe,1,1,0,0,16
59460,alabbhanato,alabbhanato,21,21,0,0,11
59461,padato,padato,47,44,3,0,6
59462,pubbeyeva,pubbeyeva,46,46,0,0,9
59463,asamāsoti,asamasoti,1,1,0,0,9
59464,miccādikampi,miccadikampi,1,1,0,0,12
59465,vākyānukaraṇanti,vakyanukarananti,1,1,0,0,16
59466,kevalapadānīti,kevalapadaniti,1,1,0,0,14
59467,saddapariyāyattā,saddapariyayatta,1,1,0,0,16
59468,sadisatthāti,sadisatthati,1,1,0,0,12
59469,avayavattho,avayavattho,11,10,1,0,11
59470,pākaṭoyeva,pakatoyeva,33,33,0,0,10
59471,vibhāvihi,vibhavihi,3,1,2,0,9
59472,ivādīnaṃ,ivadinam,1,1,0,0,8
59473,viniyogavisayaṃ,viniyogavisayam,1,1,0,0,15
59474,upamābhedaṃ,upamabhedam,1,1,0,0,11
59475,upamāna,upamana,3,1,2,0,7
59476,kecīti,keciti,127,12,115,0,6
59477,apariyantattamesaṃ,apariyantattamesam,1,1,0,0,18
59478,apariyantapabhedaṃ,apariyantapabhedam,1,1,0,0,18
59479,ivādisaddagammopamaṃ,ivadisaddagammopamam,1,1,0,0,20
59480,samānadhammasambandho,samanadhammasambandho,1,1,0,0,21
59481,pakāsakehi,pakasakehi,3,3,0,0,10
59482,ivādīhi,ivadihi,1,1,0,0,7
59483,jānitabbā,janitabba,145,136,9,0,9
59484,apariyantattā,apariyantatta,3,3,0,0,13
59485,udāharaṇamattena,udaharanamattena,2,2,0,0,16
59486,tisundaraṃ,tisundaram,2,1,1,0,10
59487,sugatānanaṃ,sugatananam,3,0,3,0,11
59488,accantaramaṇīyaṃ,accantaramaniyam,1,1,0,0,16
59489,vikāsipadumaṃva,vikasipadumamva,2,0,2,0,15
59490,pabujjhamānapadumaṃviya,pabujjhamanapadumamviya,1,1,0,0,23
59491,ayamevaṃvidhā,ayamevamvidha,1,1,0,0,13
59492,ānanapadumānaṃ,ananapadumanam,1,1,0,0,14
59493,samānassa,samanassa,46,45,1,0,9
59494,sundarassa,sundarassa,4,4,0,0,10
59495,nidassanā,nidassana,5,4,1,0,9
59496,sundarattanti,sundarattanti,1,1,0,0,13
59497,udāharaṇamāha,udaharanamaha,3,3,0,0,13
59498,bujjhamānapaṅkajamiva,bujjhamanapankajamiva,1,1,0,0,21
59499,īdisā,idisa,49,48,1,0,5
59500,atisundaramiti,atisundaramiti,2,2,0,0,14
59501,samānaguṇadassanena,samanagunadassanena,1,1,0,0,19
59502,padumānanānaṃ,padumanananam,1,1,0,0,13
59503,sādhāraṇaguṇassa,sadharanagunassa,1,1,0,0,16
59504,tulyadhammo,tulyadhammo,3,3,0,0,11
59505,padumagatatulyadhammasambandhasaṅkhātāya,padumagatatulyadhammasambandhasankhataya,1,1,0,0,40
59506,jotiyamānattepi,jotiyamanattepi,1,1,0,0,15
59507,atisundaranti,atisundaranti,9,8,1,0,13
59508,yathāvuttopamāya,yathavuttopamaya,1,1,0,0,16
59509,mbhojasadisaṃ,mbhojasadisam,1,0,1,0,13
59510,viparītopamā,viparitopama,4,3,1,0,12
59511,tulyamānanena,tulyamananena,1,0,1,0,13
59512,ambhojena,ambhojena,1,0,1,0,9
59513,sundarasaṅkhātassa,sundarasankhatassa,1,1,0,0,18
59514,aniddiṭṭhattā,anidditthatta,13,13,0,0,13
59515,atthavasā,atthavasa,18,18,0,0,9
59516,kathamaññathā,kathamannatha,3,3,0,0,13
59517,mukhagatameva,mukhagatameva,1,1,0,0,13
59518,ambhojagataṃ,ambhojagatam,1,1,0,0,12
59519,ānanena,ananena,3,2,1,0,7
59520,ambujaṃ,ambujam,24,21,3,0,7
59521,tulyanti,tulyanti,7,7,0,0,8
59522,dhammahīnattepi,dhammahinattepi,1,1,0,0,15
59523,pasiddhivipariyayenābhihitattā,pasiddhivipariyayenabhihitatta,1,1,0,0,30
59524,tannāmeneva,tannameneva,1,1,0,0,11
59525,dhammahīne,dhammahine,1,0,1,0,10
59526,mukhambhojasadisaṃ,mukhambhojasadisam,1,1,0,0,18
59527,tyayaṃ,tyayam,2,2,0,0,6
59528,tulyadhammapakāsaka,tulyadhammapakasaka,1,1,0,0,19
59529,disaddahīnattā,disaddahinatta,1,1,0,0,14
59530,vācakābhāve,vacakabhave,1,1,0,0,11
59531,patīyatīti,patiyatiti,3,3,0,0,10
59532,ambhojasadisaṃ,ambhojasadisam,1,0,1,0,14
59533,padumasadisamiti,padumasadisamiti,1,1,0,0,16
59534,ambhojasamānattaṃ,ambhojasamanattam,1,1,0,0,17
59535,mukhambhojānaṃ,mukhambhojanam,1,1,0,0,14
59536,sādhāraṇadhamme,sadharanadhamme,1,1,0,0,15
59537,aññathānupapattilakkhaṇasāmatthiyāti,annathanupapattilakkhanasamatthiyati,1,1,0,0,36
59538,ambhojagatasadisattaṃ,ambhojagatasadisattam,1,1,0,0,21
59539,samānanti,samananti,31,31,0,0,9
59540,ambujena,ambujena,1,1,0,0,8
59541,lokappasiddhiyā,lokappasiddhiya,1,1,0,0,15
59542,vipariyayena,vipariyayena,1,1,0,0,12
59543,dhammahīnatte,dhammahinatte,1,1,0,0,13
59544,avijjamānepi,avijjamanepi,31,29,2,0,12
59545,pubbaddhe,pubbaddhe,1,1,0,0,9
59546,labbhamāno,labbhamano,55,55,0,0,10
59547,tumha,tumha,62,24,38,0,5
59548,āmantanattho,amantanattho,1,1,0,0,12
59549,ambujavisesanabhūto,ambujavisesanabhuto,1,1,0,0,19
59550,ambujagatasadisattaṃ,ambujagatasadisattam,1,1,0,0,20
59551,ānanagatasadisattañca,ananagatasadisattanca,1,1,0,0,21
59552,ambujānanānaṃ,ambujanananam,1,1,0,0,13
59553,ñāyaticcādikaṃ,nayaticcadikam,1,1,0,0,14
59554,pākaṭaṭṭhānaṃ,pakatatthanam,2,2,0,0,13
59555,tavānana,tavanana,1,0,1,0,8
59556,aññamaññopamānatoti,annamannopamanatoti,1,0,1,0,19
59557,ambhojassa,ambhojassa,1,1,0,0,10
59558,aññamaññena,annamannena,45,36,9,0,11
59559,taṃdvayena,tamdvayena,1,1,0,0,10
59560,upamānato,upamanato,1,1,0,0,9
59561,tavānani,tavanani,1,0,1,0,8
59562,tavānanamiva,tavananamiva,1,1,0,0,12
59563,ambhojamivā,ambhojamiva,1,1,0,0,11
59564,ayamupamā,ayamupama,2,2,0,0,9
59565,upamānattā,upamanatta,1,1,0,0,10
59566,upamāti,upamati,16,10,6,0,7
59567,viggahadvayepi,viggahadvayepi,1,1,0,0,14
59568,pubbavibhattilopo,pubbavibhattilopo,1,1,0,0,17
59569,sabbādīnaṃ,sabbadinam,34,32,2,0,10
59570,byatihāralakkhaṇena,byatiharalakkhanena,1,1,0,0,19
59571,uttaravibhattilopo,uttaravibhattilopo,1,1,0,0,18
59572,samāsalakkhaṇena,samasalakkhanena,1,1,0,0,16
59573,aññatthassa,annatthassa,4,4,0,0,11
59574,apekkhāsiddhattā,apekkhasiddhatta,5,5,0,0,16
59575,mukhāpekkhāya,mukhapekkhaya,2,2,0,0,13
59576,ambhojañca,ambhojanca,2,2,0,0,10
59577,ambhojāpekkhāya,ambhojapekkhaya,2,2,0,0,15
59578,mukhañca,mukhanca,71,71,0,0,8
59579,upameyyā,upameyya,2,2,0,0,8
59580,locanabbhamuvibbhamaṃ,locanabbhamuvibbhamam,3,1,2,0,21
59581,bhamuyo,bhamuyo,2,2,0,0,7
59582,tādisamambhojaṃ,tadisamambhojam,1,1,0,0,15
59583,kimapi,kimapi,2,2,0,0,6
59584,mīdisamambhojaṃ,midisamambhojam,1,1,0,0,15
59585,vadanakantiṃ,vadanakantim,2,2,0,0,12
59586,nisijjhate,nisijjhate,1,1,0,0,10
59587,nvacchariyamīdisanti,nvacchariyamidisanti,1,1,0,0,20
59588,abbhutatthavibhāvanena,abbhutatthavibhavanena,1,1,0,0,22
59589,vadanamambujenopamīyatīti,vadanamambujenopamiyatiti,1,1,0,0,25
59590,ayamabbhutopamā,ayamabbhutopama,1,1,0,0,15
59591,locanabhamūnaṃ,locanabhamunam,1,1,0,0,14
59592,līlāvantaṃ,lilavantam,1,1,0,0,10
59593,mambhojaṃ,mambhojam,1,1,0,0,9
59594,abbhutadhammapakāsakattā,abbhutadhammapakasakatta,1,1,0,0,24
59595,avijjamānopi,avijjamanopi,25,25,0,0,12
59596,vijjamānattena,vijjamanattena,5,5,0,0,14
59597,parikappito,parikappito,20,19,1,0,11
59598,padumagato,padumagato,1,1,0,0,10
59599,locanabbhamuvibbhamasambandho,locanabbhamuvibbhamasambandho,2,2,0,0,29
59600,ambhojavisesanena,ambhojavisesanena,1,1,0,0,17
59601,jotito,jotito,13,12,1,0,6
59602,locanabbhamuvibbhamasambandhasaṅkhataupamāya,locanabbhamuvibbhamasambandhasankhataupamaya,1,1,0,0,44
59603,jotakattā,jotakatta,4,4,0,0,9
59604,upameyyanti,upameyyanti,1,1,0,0,11
59605,mukhagato,mukhagato,3,3,0,0,9
59606,locanabbhamuvibbhamasaṅkhātasādhāraṇadhammo,locanabbhamuvibbhamasankhatasadharanadhammo,1,1,0,0,43
59607,nipphannena,nipphannena,7,7,0,0,11
59608,bhinnādhikaraṇaaññapadatthasamāsena,bhinnadhikaranaannapadatthasamasena,1,1,0,0,35
59609,guṇībhūtassapi,gunibhutassapi,1,1,0,0,14
59610,viññāyamānattā,vinnayamanatta,29,29,0,0,14
59611,sobhasambandhi,sobhasambandhi,3,0,3,0,14
59612,sisiraṃsuvirodhi,sisiramsuvirodhi,2,0,2,0,16
59613,sisiraṃsuno,sisiramsuno,1,0,1,0,11
59614,taṃsamānakantittā,tamsamanakantitta,1,1,0,0,17
59615,ambujañca,ambujanca,1,1,0,0,9
59616,tadudaye,tadudaye,1,1,0,0,8
59617,saṅkocabhajanato,sankocabhajanato,1,1,0,0,16
59618,kantiyuttaṃ,kantiyuttam,1,1,0,0,11
59619,mukhamambujañca,mukhamambujanca,1,1,0,0,15
59620,dvayamapīti,dvayamapiti,1,1,0,0,11
59621,silesapariggahena,silesapariggahena,1,1,0,0,17
59622,mukhambujānaṃ,mukhambujanam,1,1,0,0,13
59623,upamāyogato,upamayogato,1,1,0,0,11
59624,candodayena,candodayena,1,1,0,0,11
59625,saṅkocanattā,sankocanatta,1,1,0,0,12
59626,anaññasādhāraṇamukhagatakantisambandhayuttañca,anannasadharanamukhagatakantisambandhayuttanca,1,1,0,0,46
59627,padumagatakantisambandhinā,padumagatakantisambandhina,1,1,0,0,26
59628,catujjātisugandhavahanato,catujjatisugandhavahanato,1,1,0,0,25
59629,vamanato,vamanato,1,1,0,0,8
59630,padumasugandheneva,padumasugandheneva,1,1,0,0,18
59631,ekapadātihitaubhayatthalakkhaṇena,ekapadatihitaubhayatthalakkhanena,1,1,0,0,33
59632,silesavasena,silesavasena,2,2,0,0,12
59633,sisirā,sisira,2,2,0,0,6
59634,paccayasāmatthiyavasena,paccayasamatthiyavasena,1,1,0,0,23
59635,labbhanato,labbhanato,77,77,0,0,10
59636,silissati,silissati,11,10,1,0,9
59637,aparopi,aparopi,107,102,5,0,7
59638,alaṅkāreti,alankareti,1,1,0,0,10
59639,sotasambandho,sotasambandho,1,1,0,0,13
59640,sisiraṃsuvirodhittañceti,sisiramsuvirodhittanceti,1,1,0,0,24
59641,upamānopameyyānamambujamukhānaṃ,upamanopameyyanamambujamukhanam,1,1,0,0,31
59642,ambujagatatulyadhammasambandho,ambujagatatulyadhammasambandho,1,1,0,0,30
59643,sadhammattā,sadhammatta,1,1,0,0,11
59644,ambujasambandhinā,ambujasambandhina,1,1,0,0,17
59645,jotitā,jotita,18,17,1,0,6
59646,mukhagatatulyadhammo,mukhagatatulyadhammo,1,1,0,0,20
59647,assatthitassīlatthe,assatthitassilatthe,1,1,0,0,19
59648,katapaccaye,katapaccaye,1,1,0,0,11
59649,sāmatthiyāyeva,samatthiyayeva,1,1,0,0,14
59650,sālakānanasobhinī,salakananasobhini,6,1,5,0,17
59651,ayamuyyānamālā,ayamuyyanamala,1,1,0,0,14
59652,bālāva,balava,9,7,2,0,6
59653,sahālakena,sahalakena,1,1,0,0,10
59654,kesasannivesavisesena,kesasannivesavisesena,1,1,0,0,21
59655,sālakamānanaṃ,salakamananam,1,1,0,0,13
59656,uyyānamālāpi,uyyanamalapi,1,1,0,0,12
59657,rukkhavisesānaṃ,rukkhavisesanam,3,3,0,0,15
59658,kānanena,kananena,1,1,0,0,8
59659,gahanena,gahanena,4,4,0,0,8
59660,evarūpā,evarupa,656,629,27,0,7
59661,silesopamattasabhāvepi,silesopamattasabhavepi,1,1,0,0,22
59662,sarūpena,sarupena,142,130,12,0,8
59663,tvevaṃvidhena,tvevamvidhena,1,1,0,0,13
59664,saddasantānena,saddasantanena,1,1,0,0,14
59665,visesabhūtena,visesabhutena,3,3,0,0,13
59666,vāccattā,vaccatta,2,1,1,0,8
59667,pakāsiyattā,pakasiyatta,1,1,0,0,11
59668,tassāiti,tassaiti,1,1,0,0,8
59669,yatheti,yatheti,2,1,1,0,7
59670,sarūpe,sarupe,16,14,2,0,6
59671,tulyasutiyā,tulyasutiya,1,1,0,0,11
59672,acchinnasambandhavacanamālāya,acchinnasambandhavacanamalaya,1,1,0,0,29
59673,silesatte,silesatte,1,1,0,0,9
59674,katasamāsehi,katasamasehi,1,1,0,0,12
59675,padasantānehi,padasantanehi,1,1,0,0,13
59676,uyyānamālā,uyyanamala,1,0,1,0,10
59677,uyyānapanti,uyyanapanti,1,1,0,0,11
59678,alakasaṅkhātakesasannivesasahitena,alakasankhatakesasannivesasahitena,1,1,0,0,34
59679,sālavanehi,salavanehi,1,1,0,0,10
59680,sarūpā,sarupa,12,10,2,0,6
59681,vāccā,vacca,1,1,0,0,5
59682,santānena,santanena,19,18,1,0,9
59683,uyyānānaṃ,uyyananam,1,1,0,0,9
59684,alakena,alakena,1,1,0,0,7
59685,vattamānanti,vattamananti,7,7,0,0,12
59686,ānanañcāti,ananancati,1,1,0,0,10
59687,kānananti,kanananti,1,1,0,0,9
59688,samukkaṃsītya,samukkamsitya,1,0,1,0,13
59689,parāgāvayavā,paragavayava,1,1,0,0,12
59690,evaṃbhūtehi,evambhutehi,2,2,0,0,11
59691,candapadumehi,candapadumehi,2,2,0,0,13
59692,kantiādinā,kantiadina,1,1,0,0,10
59693,sadisampi,sadisampi,8,8,0,0,9
59694,paramukkaṃsavantaṃ,paramukkamsavantam,1,1,0,0,18
59695,dosepi,dosepi,1,1,0,0,6
59696,vattanato,vattanato,75,75,0,0,9
59697,saddacchalena,saddacchalena,2,2,0,0,13
59698,dosarūpassa,dosarupassa,1,1,0,0,11
59699,bahurajattassa,bahurajattassa,1,1,0,0,14
59700,tatthābhāvatoti,tatthabhavatoti,1,1,0,0,15
59701,ninditena,ninditena,1,1,0,0,9
59702,candādinā,candadina,1,1,0,0,9
59703,khayassopamitattā,khayassopamitatta,1,1,0,0,17
59704,khayi,khayi,1,0,1,0,5
59705,pāṭipadato,patipadato,8,8,0,0,10
59706,ekamekāya,ekamekaya,10,9,1,0,9
59707,kalāya,kalaya,2,2,0,0,6
59708,āsannahetu,asannahetu,2,2,0,0,10
59709,khīyanasabhāvayutto,khiyanasabhavayutto,1,1,0,0,19
59710,bahureṇusamannāgataṃ,bahurenusamannagatam,1,1,0,0,20
59711,kantisugandhādīhi,kantisugandhadihi,1,1,0,0,17
59712,tavānanaṃ,tavananam,6,6,0,0,9
59713,khayaraja,khayaraja,1,0,1,0,9
59714,dosassāpi,dosassapi,2,2,0,0,9
59715,saddacchalehi,saddacchalehi,1,1,0,0,13
59716,avijjamānattā,avijjamanatta,59,55,4,0,13
59717,adhikukkaṃsaguṇavantaṃ,adhikukkamsagunavantam,1,1,0,0,22
59718,candapadumānaṃ,candapadumanam,1,1,0,0,14
59719,upamitāti,upamitati,1,1,0,0,9
59720,mukhavisesanena,mukhavisesanena,1,1,0,0,15
59721,saddapariyāyena,saddapariyayena,1,1,0,0,15
59722,mukhagatasadhammo,mukhagatasadhammo,1,1,0,0,17
59723,upamāsaṅkhatacandapadumagatasadhammopi,upamasankhatacandapadumagatasadhammopi,1,1,0,0,38
59724,tulyadhammopi,tulyadhammopi,1,1,0,0,13
59725,vattabbantarasamuccaye,vattabbantarasamuccaye,8,8,0,0,22
59726,samukkaṃsoti,samukkamsoti,1,1,0,0,12
59727,vattabbantaro,vattabbantaro,1,1,0,0,13
59728,migalañchanalakkhaṇo,migalanchanalakkhano,1,1,0,0,20
59729,dosakathanaṃ,dosakathanam,1,1,0,0,12
59730,vivadituṃ,vivaditum,2,2,0,0,9
59731,mukhantu,mukhantu,1,1,0,0,8
59732,alaṅkatañceti,alankatanceti,1,1,0,0,13
59733,kathamanenāyaṃ,kathamanenayam,1,1,0,0,14
59734,sadisoti,sadisoti,23,20,3,0,8
59735,nisedhadvārena,nisedhadvarena,1,1,0,0,14
59736,sadhammatāva,sadhammatava,1,1,0,0,12
59737,gammate,gammate,3,3,0,0,7
59738,sadoso,sadoso,37,34,3,0,6
59739,visadena,visadena,2,2,0,0,8
59740,kalaṅkarahitena,kalankarahitena,1,1,0,0,15
59741,bhavitumasamatthoti,bhavitumasamatthoti,1,1,0,0,19
59742,paṭisedhadvayena,patisedhadvayena,4,4,0,0,16
59743,indamukhasaṅkhātānaṃ,indamukhasankhatanam,1,1,0,0,20
59744,tulyadhammasambandhassa,tulyadhammasambandhassa,1,1,0,0,23
59745,nindopamābhāve,nindopamabhave,1,1,0,0,14
59746,visesanattā,visesanatta,10,9,1,0,11
59747,candagatasadhammaṃ,candagatasadhammam,1,1,0,0,18
59748,jātamitya,jatamitya,1,0,1,0,9
59749,kaccha,kaccha,2,0,2,0,6
59750,aravindassa,aravindassa,1,1,0,0,11
59751,avatthariya,avatthariya,1,1,0,0,11
59752,tesa,tesa,18,14,4,0,4
59753,mavakaṃsato,mavakamsato,1,1,0,0,11
59754,avatthuyatesamaṇaṃsato,avatthuyatesamanamsato,1,1,0,0,22
59755,sarūpeneva,sarupeneva,101,96,5,0,10
59756,jātamiti,jatamiti,1,1,0,0,8
59757,asādhāraṇatābhidhānena,asadharanatabhidhanena,1,1,0,0,22
59758,sadisattapatītiyā,sadisattapatitiya,1,1,0,0,17
59759,asādhāraṇopameti,asadharanopameti,1,1,0,0,16
59760,lokapūjitānaṃ,lokapujitanam,1,1,0,0,13
59761,sasiambujānaṃ,sasiambujanam,1,1,0,0,13
59762,avatthaṃ,avattham,11,10,1,0,8
59763,atulyattena,atulyattena,1,1,0,0,11
59764,samānattavatthuno,samanattavatthuno,1,1,0,0,17
59765,asādhāraṇopamā,asadharanopama,3,2,1,0,14
59766,atulyadhammabhāvassa,atulyadhammabhavassa,1,1,0,0,20
59767,upamābhūtānaṃ,upamabhutanam,1,1,0,0,13
59768,hīnabhāvapaṭipādanadvārena,hinabhavapatipadanadvarena,1,1,0,0,26
59769,candāravindehi,candaravindehi,1,1,0,0,14
59770,paññāpanato,pannapanato,109,107,2,0,11
59771,candāravindā,candaravinda,1,1,0,0,12
59772,mukhagatassa,mukhagatassa,1,1,0,0,12
59773,sādhāraṇadhammaṃ,sadharanadhammam,1,1,0,0,16
59774,sabbambhojappabhāsāro,sabbambhojappabhasaro,1,0,1,0,21
59775,rāsibhūtova,rasibhutova,1,0,1,0,11
59776,vibhātīti,vibhatiti,5,4,1,0,9
59777,ekaṭṭhāne,ekatthane,99,95,4,0,9
59778,sabbesamambhojānaṃ,sabbesamambhojanam,1,1,0,0,18
59779,pabhāsārova,pabhasarova,1,1,0,0,11
59780,evaṃbhūtā,evambhuta,30,30,0,0,9
59781,abhūtopamā,abhutopama,3,2,1,0,10
59782,sabbambhojappabhāsārova,sabbambhojappabhasarova,1,0,1,0,23
59783,sakalapadumānaṃ,sakalapadumanam,1,1,0,0,15
59784,uttamakantipuñjo,uttamakantipunjo,1,1,0,0,16
59785,pabhāti,pabhati,7,5,2,0,7
59786,avijjamānavatthuno,avijjamanavatthuno,1,1,0,0,18
59787,upamitattā,upamitatta,7,7,0,0,10
59788,arāsi,arasi,2,2,0,0,5
59789,rāsibhūtoti,rasibhutoti,2,2,0,0,11
59790,yojanāvibhūto,yojanavibhuto,1,1,0,0,13
59791,tādisapabhāsārābhāvato,tadisapabhasarabhavato,1,1,0,0,22
59792,avijjamānatthena,avijjamanatthena,1,1,0,0,16
59793,samāsappaccayevādisaddayogaṃ,samasappaccayevadisaddayogam,1,0,1,0,28
59794,atthagammopamaṃ,atthagammopamam,2,2,0,0,15
59795,samāsādisaddānaṃ,samasadisaddanam,1,1,0,0,16
59796,yogaṃ,yogam,150,127,23,0,5
59797,payogavisesādigāḷhena,payogavisesadigalhena,1,1,0,0,21
59798,aññathānupapattilakkhaṇena,annathanupapattilakkhanena,2,2,0,0,26
59799,saddagammopamaṃ,saddagammopamam,1,1,0,0,15
59800,atthagammopamā,atthagammopama,1,1,0,0,14
59801,samāsapaccayevādisaddayogaṃ,samasapaccayevadisaddayogam,1,1,0,0,27
59802,vināpi,vinapi,330,316,14,0,6
59803,hitvāpi,hitvapi,12,12,0,0,7
59804,payuttāvasesasaddānaṃ,payuttavasesasaddanam,1,1,0,0,21
59805,atthasattiyā,atthasattiya,2,2,0,0,12
59806,bhiṅge,bhinge,2,1,1,0,6
59807,cakkhūnimāni,cakkhunimani,1,1,0,0,12
59808,nambujametaṃ,nambujametam,1,1,0,0,12
59809,mukhamevidanti,mukhamevidanti,1,1,0,0,14
59810,bhiṅgādīnamaviparītasarūpassa,bhingadinamaviparitasarupassa,1,1,0,0,29
59811,dīpanato,dipanato,39,39,0,0,8
59812,subyatte,subyatte,1,0,1,0,8
59813,subyattena,subyattena,1,0,1,0,10
59814,bhiṅgacakkhūnaṃ,bhingacakkhunam,1,1,0,0,15
59815,ambujamukhānañca,ambujamukhananca,2,2,0,0,16
59816,pariphuṭena,pariphutena,1,1,0,0,11
59817,sadisattena,sadisattena,1,0,1,0,11
59818,cañcalattakantyādilakkhaṇena,cancalattakantyadilakkhanena,1,1,0,0,28
59819,tenevābhedasaṅkāpubbameva,tenevabhedasankapubbameva,1,1,0,0,25
59820,vivecitaṃ,vivecitam,3,3,0,0,9
59821,cakkhādīsu,cakkhadisu,104,102,2,0,10
59822,bhiṅgādiññāṇamuppannaṃ,bhingadinnanamuppannam,1,1,0,0,22
59823,paccakkhānato,paccakkhanato,2,2,0,0,13
59824,upamājotakānamivādīnamabhāvepi,upamajotakanamivadinamabhavepi,1,1,0,0,30
59825,bhiṅgalocanādīnaṃ,bhingalocanadinam,1,1,0,0,17
59826,udāharaṇamāharati,udaharanamaharati,1,1,0,0,17
59827,bhiṅgāni,bhingani,2,0,2,0,8
59828,mukhamevāti,mukhamevati,1,1,0,0,11
59829,supākaṭena,supakatena,2,2,0,0,10
59830,bhiṅgalocanānaṃ,bhingalocananam,1,1,0,0,15
59831,tulyabhāvena,tulyabhavena,2,2,0,0,12
59832,samāsapaccayaivādisaddapayogābhāvepi,samasapaccayaivadisaddapayogabhavepi,1,1,0,0,36
59833,bhiṅgānemāni,bhinganemani,1,1,0,0,12
59834,cakkhumukhesu,cakkhumukhesu,2,2,0,0,13
59835,bhiṅgaambujanti,bhingaambujanti,1,1,0,0,15
59836,viparītapavattabuddhiṃ,viparitapavattabuddhim,1,1,0,0,22
59837,paṭisedhetvā,patisedhetva,30,30,0,0,12
59838,cakkhumukhavidhānato,cakkhumukhavidhanato,1,1,0,0,20
59839,cañcalattakantimattādīsu,cancalattakantimattadisu,1,1,0,0,24
59840,subyattaṃ,subyattam,4,4,0,0,9
59841,tulyattaṃ,tulyattam,1,1,0,0,9
59842,bhiṅgambujabuddhiṃ,bhingambujabuddhim,1,1,0,0,18
59843,kīdisamuppajjatīti,kidisamuppajjatiti,1,1,0,0,18
59844,aññathānupapattilakkhaṇasāmatthiyā,annathanupapattilakkhanasamatthiya,1,1,0,0,34
59845,upamānabhūtānaṃ,upamanabhutanam,1,1,0,0,15
59846,bhiṅgambujānaṃ,bhingambujanam,1,1,0,0,14
59847,upameyyabhūtānaṃ,upameyyabhutanam,1,1,0,0,16
59848,cakkhumukhānañca,cakkhumukhananca,1,1,0,0,16
59849,pākaṭanti,pakatanti,34,34,0,0,9
59850,sadisattañcāti,sadisattancati,1,1,0,0,14
59851,mayeva,mayeva,3,1,2,0,6
59852,ssetyala,ssetyala,1,1,0,0,8
59853,mbujepisā,mbujepisa,1,0,1,0,9
59854,mayevi,mayevi,1,0,1,0,6
59855,vadanajuti,vadanajuti,1,1,0,0,10
59856,nāññatrāti,nannatrati,1,1,0,0,10
59857,atthapasaṃsanena,atthapasamsanena,1,1,0,0,16
59858,paṭisedho,patisedho,90,88,2,0,9
59859,kimiti,kimiti,7,7,0,0,6
59860,ambujepi,ambujepi,3,3,0,0,8
59861,kevalamindumhi,kevalamindumhi,1,1,0,0,14
59862,asatopi,asatopi,3,3,0,0,7
59863,vikatthanassa,vikatthanassa,1,1,0,0,13
59864,parikappanato,parikappanato,6,6,0,0,13
59865,vadanamindunopamīyatīti,vadanamindunopamiyatiti,1,1,0,0,23
59866,lokasāmino,lokasamino,1,1,0,0,10
59867,vadanakanti,vadanakanti,1,1,0,0,11
59868,ekake,ekake,12,12,0,0,5
59869,attasilāghena,attasilaghena,1,1,0,0,13
59870,yatoti,yatoti,91,7,84,0,6
59871,aniyamaniddiṭṭhakāraṇaṃ,aniyamanidditthakaranam,1,1,0,0,23
59872,padumepi,padumepi,1,1,0,0,8
59873,atthittameva,atthittameva,1,1,0,0,12
59874,parikappanāya,parikappanaya,4,4,0,0,13
59875,avijjamānavikatthanassa,avijjamanavikatthanassa,1,1,0,0,23
59876,sadhammajotakasaddantare,sadhammajotakasaddantare,1,1,0,0,24
59877,upamānabhūtainduno,upamanabhutainduno,1,1,0,0,18
59878,upameyyabhūtamukhassa,upameyyabhutamukhassa,1,1,0,0,21
59879,tādisakappanā,tadisakappana,1,1,0,0,13
59880,bhantā,bhanta,24,24,0,0,6
59881,alī,ali,3,3,0,0,3
59882,tamīdisamambujaṃ,tamidisamambujam,1,1,0,0,16
59883,tavedaṃ,tavedam,19,18,1,0,7
59884,dolevācarati,dolevacarati,1,1,0,0,12
59885,pakkhadvayapariggahena,pakkhadvayapariggahena,1,1,0,0,22
59886,saṃsayatīti,samsayatiti,1,1,0,0,11
59887,iccaya,iccaya,1,0,1,0,6
59888,mīdisī,midisi,1,1,0,0,6
59889,saṃsayavesena,samsayavesena,1,1,0,0,13
59890,ambujamukhānamopamāvagamā,ambujamukhanamopamavagama,1,1,0,0,25
59891,mbuje,mbuje,3,2,1,0,5
59892,antobhantāli,antobhantali,1,0,1,0,12
59893,bhamamānabhamaravantaṃ,bhamamanabhamaravantam,1,1,0,0,22
59894,cañcalanettaṃ,cancalanettam,1,1,0,0,13
59895,ubhayasambhamajananato,ubhayasambhamajananato,1,1,0,0,22
59896,dolā,dola,12,10,2,0,4
59897,sadisattassa,sadisattassa,3,3,0,0,12
59898,sadhammapakāsake,sadhammapakasake,1,1,0,0,16
59899,saddantare,saddantare,3,3,0,0,10
59900,yathāvuttavisesanadvayena,yathavuttavisesanadvayena,1,1,0,0,25
59901,visiṭṭhānaṃ,visitthanam,6,6,0,0,11
59902,ambujamukhānaṃ,ambujamukhanam,1,1,0,0,14
59903,saṃsayanimitte,samsayanimitte,1,1,0,0,14
59904,tulyatte,tulyatte,2,2,0,0,8
59905,sāmatthiyeneva,samatthiyeneva,3,3,0,0,14
59906,tulyadhammasambandho,tulyadhammasambandho,1,1,0,0,20
59907,pativatthūpamā,pativatthupama,5,3,2,0,14
59908,micchitaṃ,micchitam,3,3,0,0,9
59909,sambuddhādikaṃ,sambuddhadikam,1,1,0,0,14
59910,upadassetvā,upadassetva,4,3,1,0,11
59911,sadhammassa,sadhammassa,2,0,2,0,11
59912,vatthunā,vatthuna,259,249,10,0,8
59913,ākārena,akarena,332,323,9,0,7
59914,sadisassa,sadisassa,79,76,3,0,9
59915,sāmyassa,samyassa,2,1,1,0,8
59916,patītiyā,patitiya,4,3,1,0,8
59917,avasāyassa,avasayassa,1,1,0,0,10
59918,sambhāvā,sambhava,1,0,1,0,8
59919,pativatthunā,pativatthuna,2,2,0,0,12
59920,tathāvidhenādhigatassa,tathavidhenadhigatassa,1,1,0,0,22
59921,paṭipāditā,patipadita,4,4,0,0,10
59922,jinādikiñcipadatthaṃ,jinadikincipadattham,1,1,0,0,20
59923,nidassetvā,nidassetva,12,12,0,0,10
59924,paṭipādanīyaatthena,patipadaniyaatthena,1,1,0,0,19
59925,sadisabhāvassa,sadisabhavassa,1,1,0,0,14
59926,sadisatāsambandhino,sadisatasambandhino,1,1,0,0,19
59927,parijānanassa,parijananassa,3,3,0,0,13
59928,upaṭṭhitassa,upatthitassa,11,11,0,0,12
59929,jinādipadatthassa,jinadipadatthassa,1,1,0,0,17
59930,tulyatthapakāsanato,tulyatthapakasanato,1,1,0,0,19
59931,pārijātādino,parijatadino,1,1,0,0,12
59932,tulyānaṃ,tulyanam,1,1,0,0,8
59933,sāmyappatītiyā,samyappatitiya,1,1,0,0,14
59934,sabbhāvoti,sabbhavoti,6,5,1,0,10
59935,guṇavā,gunava,66,59,7,0,6
59936,sammāsambuddhasamāno,sammasambuddhasamano,1,1,0,0,20
59937,vijjatītyekaṃ,vijjatityekam,1,1,0,0,13
59938,upadassitaṃ,upadassitam,2,2,0,0,11
59939,pativatthūpamadassanaṃ,pativatthupamadassanam,1,1,0,0,22
59940,nanū,nanu,10,3,7,0,4
59941,tyanumatiyaṃ,tyanumatiyam,1,1,0,0,12
59942,dibbarukkhavisesassa,dibbarukkhavisesassa,1,1,0,0,20
59943,pārijātoyeva,parijatoyeva,1,1,0,0,12
59944,rukkhajātīsu,rukkhajatisu,1,1,0,0,12
59945,janesūti,janesuti,6,1,5,0,8
59946,sambuddhasadiso,sambuddhasadiso,1,1,0,0,15
59947,nanūti,nanuti,16,12,4,0,6
59948,atulyabhāvaṃ,atulyabhavam,1,1,0,0,12
59949,anujānāti,anujanati,100,98,2,0,9
59950,pārijātarukkhassa,parijatarukkhassa,1,1,0,0,17
59951,rukkhehi,rukkhehi,34,33,1,0,8
59952,uttamattañca,uttamattanca,1,1,0,0,12
59953,uttamattañcāti,uttamattancati,1,1,0,0,14
59954,vuttatthassa,vuttatthassa,5,5,0,0,12
59955,samatthanavasena,samatthanavasena,8,8,0,0,16
59956,pativatthubhūtapārijātassa,pativatthubhutaparijatassa,1,1,0,0,26
59957,asamānattakathaneneva,asamanattakathaneneva,1,1,0,0,21
59958,jotitaṃ,jotitam,22,22,0,0,7
59959,vākyattheneva,vakyattheneva,2,0,2,0,13
59960,kocyu,kocyu,1,0,1,0,5
59961,ivayuttaviyuttattā,ivayuttaviyuttatta,2,0,2,0,18
59962,vākyatthavisayopamaṃ,vakyatthavisayopamam,2,2,0,0,20
59963,vākyatthenevi,vakyatthenevi,1,0,1,0,13
59964,kriyākārakasambandhaviseso,kriyakarakasambandhaviseso,1,1,0,0,26
59965,vattumicchito,vattumicchito,6,6,0,0,13
59966,bhijjate,bhijjate,16,15,1,0,8
59967,yuttaviyuttā,yuttaviyutta,2,1,1,0,12
59968,ivena,ivena,1,0,1,0,5
59969,atthaniddesoyaṃ,atthaniddesoyam,1,1,0,0,15
59970,dvidhāti,dvidhati,16,8,8,0,8
59971,vākyatthe,vakyatthe,1,0,1,0,9
59972,kriyākārakasambandhavisesasaṅkhatasamudāyabhūtena,kriyakarakasambandhavisesasankhatasamudayabhutena,1,1,0,0,49
59973,vākyatthena,vakyatthena,2,2,0,0,11
59974,sadisabhāvena,sadisabhavena,9,9,0,0,13
59975,yuttaviyuttavasena,yuttaviyuttavasena,1,1,0,0,18
59976,dīnamatthassa,dinamatthassa,1,1,0,0,13
59977,tappariyāyasaddāpi,tappariyayasaddapi,1,1,0,0,18
59978,gayhante,gayhante,6,6,0,0,8
59979,ivayutta,ivayutta,1,1,0,0,8
59980,saṃklesehi,samklesehi,2,2,0,0,10
59981,dasavidhehi,dasavidhehi,1,1,0,0,11
59982,tattānaṃ,tattanam,2,1,1,0,8
59983,anuppattānaṃ,anuppattanam,3,3,0,0,12
59984,katakiccattā,katakiccatta,6,6,0,0,12
59985,sammāsambodhādhigamena,sammasambodhadhigamena,1,1,0,0,22
59986,vākyamupameyyabhūtaṃ,vakyamupameyyabhutam,2,2,0,0,20
59987,kimivetyāha,kimivetyaha,1,1,0,0,11
59988,ghamme,ghamme,14,12,2,0,6
59989,ghammasantāpena,ghammasantapena,2,2,0,0,15
59990,gimhānasamaye,gimhanasamaye,1,1,0,0,13
59991,dutiyavākyamupamānabhūtamityayamivayuttā,dutiyavakyamupamanabhutamityayamivayutta,1,1,0,0,40
59992,pubbuttaravākyatthānaṃ,pubbuttaravakyatthanam,1,1,0,0,22
59993,visesyavisesanabhāvo,visesyavisesanabhavo,1,1,0,0,20
59994,ekavākyatthattāva,ekavakyatthattava,1,1,0,0,17
59995,anekappakāra,anekappakara,1,1,0,0,12
59996,kilesasantāpatattānaṃ,kilesasantapatattanam,1,1,0,0,21
59997,sabbaññutaññāṇādhigamena,sabbannutannanadhigamena,1,1,0,0,24
59998,upaṭṭhito,upatthito,64,62,2,0,9
59999,santattassa,santattassa,1,1,0,0,11
