660000,samasīlānaṃ,samasilanam,1,1,0,0,11
660001,samadiṭṭhīnaṃ,samaditthinam,1,1,0,0,13
660002,pārivattakaṃ,parivattakam,28,23,5,0,12
660003,hatthappasāraṇādīsu,hatthappasaranadisu,1,1,0,0,19
660004,paṭilābhenāti,patilabhenati,5,1,4,0,13
660005,sikkhamānāsāmaṇerasāmaṇerīupāsakaupāsikādīnaṃ,sikkhamanasamanerasamaneriupasakaupasikadinam,1,1,0,0,45
660006,nānāvirāgavatthāni,nanaviragavatthani,2,2,0,0,18
660007,pārivattakā,parivattaka,24,22,2,0,11
660008,pārivattakakiccaṃ,parivattakakiccam,1,1,0,0,17
660009,acittakabhāvena,acittakabhavena,7,5,2,0,15
660010,pārivattakameva,parivattakameva,1,1,0,0,15
660011,aññātikasaññīti,annatikasanniti,2,0,2,0,15
660012,appagghacīvarena,appagghacivarena,1,1,0,0,16
660013,upāhanatthavikapattatthavikaaṃsabaddhakakāyabandhanādinā,upahanatthavikapattatthavikaamsabaddhakakayabandhanadina,1,1,0,0,56
660014,harītakīkhaṇḍenāpī,haritakikhandenapi,1,1,0,0,18
660015,pattatthavikādiṃ,pattatthavikadim,6,5,1,0,16
660016,vikappanupagapacchimacīvarappamāṇaṃ,vikappanupagapacchimacivarappamanam,3,2,1,0,35
660017,paṭaparissāvanampi,pataparissavanampi,4,4,0,0,18
660018,mañcappamāṇā,mancappamana,3,3,0,0,12
660019,bhisicchavi,bhisicchavi,8,8,0,0,11
660020,pattatthavikādīsu,pattatthavikadisu,3,3,0,0,17
660021,kiriyākiriyaṃ,kiriyakiriyam,82,56,26,0,13
660022,kāyakammaṃvacīkammaṃ,kayakammamvacikammam,1,1,0,0,20
660023,aññātakaviññattisikkhāpadavaṇṇanā,annatakavinnattisikkhapadavannana,14,14,0,0,33
660024,aññātakaviññattisikkhāpadaṃ,annatakavinnattisikkhapadam,6,6,0,0,27
660025,patikiṭṭho,patikittho,1,1,0,0,10
660026,paṭṭoti,pattoti,3,1,2,0,7
660027,kaṇṭhamādhuriyena,kanthamadhuriyena,1,1,0,0,17
660028,hirottappavasena,hirottappavasena,1,1,0,0,16
660029,saṅkampanaṃ,sankampanam,2,2,0,0,11
660030,nagaravīthimagganti,nagaravithimagganti,1,1,0,0,19
660031,acchindiṃsūti,acchindimsuti,2,0,2,0,13
660032,musiṃsu,musimsu,1,1,0,0,7
660033,anuyuñjāhīti,anuyunjahiti,1,0,1,0,12
660034,bhikkhubhāvajānanatthāya,bhikkhubhavajananatthaya,1,1,0,0,24
660035,pabbajjāupasampadāpattacīvarādhiṭṭhānādīni,pabbajjaupasampadapattacivaradhitthanadini,1,1,0,0,42
660036,sāketā,saketa,10,10,0,0,6
660037,nivāsanapārupanamattaṃyeva,nivasanaparupanamattamyeva,4,2,2,0,26
660038,viññāpetabbaṃ,vinnapetabbam,19,17,2,0,13
660039,bhañjitabbaṃ,bhanjitabbam,5,3,2,0,12
660040,anacchinnacīvarā,anacchinnacivara,3,3,0,0,16
660041,acchinnacīvarānaṃ,acchinnacivaranam,6,6,0,0,17
660042,acchinnacīvarāva,acchinnacivarava,2,2,0,0,16
660043,viññattamanussā,vinnattamanussa,2,2,0,0,15
660044,sākhāpalāsanivāsane,sakhapalasanivasane,2,2,0,0,19
660045,sadasāni,sadasani,2,2,0,0,8
660046,adasāni,adasani,3,3,0,0,7
660047,nīlādinānāvaṇṇāni,niladinanavannani,2,2,0,0,17
660048,kappiyānipi,kappiyanipi,2,2,0,0,11
660049,akappiyānipi,akappiyanipi,2,2,0,0,12
660050,acchinnacīvaraṭṭhāne,acchinnacivaratthane,7,5,2,0,20
660051,nivāsetuñca,nivasetunca,4,4,0,0,11
660052,pārupituñca,parupitunca,4,4,0,0,11
660053,acchinnacīvarakaṃ,acchinnacivarakam,3,3,0,0,17
660054,sahagacchanti,sahagacchanti,1,1,0,0,13
660055,kusacīravākacīraphalakacīrāni,kusaciravakaciraphalakacirani,2,2,0,0,29
660056,vihāracīvaraṃ,viharacivaram,11,8,3,0,13
660057,attharaṇakaṃ,attharanakam,1,1,0,0,12
660058,bhumattharaṇaṃ,bhumattharanam,2,1,1,0,14
660059,cimilikāhi,cimilikahi,1,1,0,0,10
660060,kataattharaṇaṃ,kataattharanam,1,1,0,0,14
660061,bhisicchavīti,bhisicchaviti,2,0,2,0,13
660062,mañcabhisiyā,mancabhisiya,1,1,0,0,12
660063,pīṭhabhisiyā,pithabhisiya,1,1,0,0,12
660064,vidhunitvāpi,vidhunitvapi,1,1,0,0,12
660065,vihāracīvarādīsu,viharacivaradisu,2,2,0,0,16
660066,anāpucchāpi,anapucchapi,15,15,0,0,11
660067,acchinnacīvarakānaṃ,acchinnacivarakanam,1,1,0,0,19
660068,upaṭṭhākato,upatthakato,2,2,0,0,11
660069,videsagatena,videsagatena,4,4,0,0,12
660070,paribhuñjanatthāya,paribhunjanatthaya,4,4,0,0,18
660071,paribhogeneva,paribhogeneva,3,3,0,0,13
660072,gihivatthādīnaṃ,gihivatthadinam,3,3,0,0,15
660073,bhisicchavipariyantānaṃ,bhisicchavipariyantanam,2,2,0,0,23
660074,acchinnacīvarā,acchinnacivara,4,4,0,0,14
660075,dinnacīvarampi,dinnacivarampi,2,2,0,0,14
660076,viññattiyaṃ,vinnattiyam,7,5,2,0,11
660077,akappiyacīvaraparibhoge,akappiyacivaraparibhoge,1,1,0,0,23
660078,ñātakapavāritānaṃ,natakapavaritanam,3,3,0,0,17
660079,kappiyabhaṇḍena,kappiyabhandena,12,12,0,0,15
660080,kappiyavohāreneva,kappiyavohareneva,2,2,0,0,17
660081,parivattāpentassa,parivattapentassa,1,1,0,0,17
660082,puggalikapavāraṇāya,puggalikapavaranaya,1,1,0,0,19
660083,yāgubhattādīnīti,yagubhattadiniti,1,1,0,0,16
660084,viññāpanakiccaṃ,vinnapanakiccam,4,2,2,0,15
660085,pavāremī,pavaremi,18,18,0,0,8
660086,ñātakapavārite,natakapavarite,11,7,4,0,14
660087,aññassatthāya,annassatthaya,118,115,3,0,13
660088,ñātakapavāritā,natakapavarita,1,1,0,0,14
660089,kāyakammavacīkammaṃ,kayakammavacikammam,18,18,0,0,19
660090,tatuttarisikkhāpadavaṇṇanā,tatuttarisikkhapadavannana,16,16,0,0,26
660091,para522-4,para522-4,2,2,0,0,9
660092,tatuttarisikkhāpadaṃ,tatuttarisikkhapadam,5,5,0,0,20
660093,haritunti,haritunti,6,3,3,0,9
660094,pavāreyyāti,pavareyyati,23,9,14,0,11
660095,icchāpeyya,icchapeyya,3,3,0,0,10
660096,pavārentena,pavarentena,3,3,0,0,11
660097,abhiaṭṭhuṃ,abhiatthum,1,1,0,0,10
660098,pavāreyyā,pavareyya,63,63,0,0,9
660099,kāyābhihāro,kayabhiharo,2,2,0,0,11
660100,vācābhihāroti,vacabhiharoti,2,2,0,0,13
660101,cīvarassāti,civarassati,10,4,6,0,11
660102,nivāsanena,nivasanena,5,5,0,0,10
660103,abhihaṭacīvarato,abhihatacivarato,3,3,0,0,16
660104,acchinnasabbacīvarena,acchinnasabbacivarena,7,5,2,0,21
660105,ticīvarikeneva,ticivarikeneva,1,1,0,0,14
660106,sabhāgaṭṭhānato,sabhagatthanato,4,4,0,0,15
660107,sādiyanteneva,sadiyanteneva,6,3,3,0,13
660108,santaruttaraparamatāya,santaruttaraparamataya,6,6,0,0,22
660109,acchinnakāraṇāti,acchinnakaranati,2,0,2,0,16
660110,bāhusaccādiguṇavasena,bahusaccadigunavasena,3,3,0,0,21
660111,ñātakapavāritaṭṭhāne,natakapavaritatthane,10,9,1,0,20
660112,acchinnakāraṇā,acchinnakarana,7,7,0,0,14
660113,viññāpanavatthusmiṃyeva,vinnapanavatthusmimyeva,6,6,0,0,23
660114,aññassatthāyā,annassatthaya,24,21,3,0,13
660115,paṭhamaupakkhaṭasikkhāpadavaṇṇanā,pathamaupakkhatasikkhapadavannana,10,10,0,0,33
660116,upakkhaṭasikkhāpadaṃ,upakkhatasikkhapadam,3,3,0,0,20
660117,meyya,meyya,2,1,1,0,5
660118,mayyā,mayya,1,1,0,0,5
660119,para528-9,para528-9,2,2,0,0,9
660120,bhikkhussatthāyā,bhikkhussatthaya,1,1,0,0,16
660121,acchādetukāmo,acchadetukamo,7,7,0,0,13
660122,acchādetukāmena,acchadetukamena,1,1,0,0,15
660123,hiraññādīsu,hirannadisu,2,2,0,0,11
660124,vacanenassa,vacanenassa,1,1,0,0,11
660125,upakkhaṭabhāvo,upakkhatabhavo,1,1,0,0,14
660126,paccupaṭṭhitenā,paccupatthitena,1,1,0,0,15
660127,acchādessāmīti,acchadessamiti,4,0,4,0,14
660128,pacuravohāravasena,pacuravoharavasena,5,5,0,0,18
660129,visiṭṭhakappaṃ,visitthakappam,6,5,1,0,14
660130,kalyāṇakamyataṃ,kalyanakamyatam,11,7,4,0,15
660131,sundarakāmataṃ,sundarakamatam,2,2,0,0,14
660132,visiṭṭhakāmataṃ,visitthakamatam,2,2,0,0,15
660133,sādhatthiko,sadhatthiko,3,3,0,0,11
660134,adhippetatthameva,adhippetatthameva,2,2,0,0,17
660135,āpajjanamatteneva,apajjanamatteneva,2,2,0,0,17
660136,cetāpetukāmassa,cetapetukamassa,5,4,1,0,15
660137,cetāpetīti,cetapetiti,5,2,3,0,10
660138,vīsatiagghanakaṃ,visatiagghanakam,4,4,0,0,16
660139,dasagghanakaṃ,dasagghanakam,4,4,0,0,13
660140,aṭṭhagghanakaṃ,atthagghanakam,2,2,0,0,14
660141,atirekanivāraṇatthameva,atirekanivaranatthameva,1,1,0,0,23
660142,samakepi,samakepi,2,1,1,0,8
660143,agghavaseneva,agghavaseneva,2,2,0,0,13
660144,agghavaḍḍhanakañhi,agghavaddhanakanhi,3,2,1,0,18
660145,cetāpetukāmo,cetapetukamo,1,1,0,0,12
660146,tatuttarisikkhāpadasadisānevāti,tatuttarisikkhapadasadisanevati,1,1,0,0,31
660147,dutiyaupakkhaṭasikkhāpadavaṇṇanā,dutiyaupakkhatasikkhapadavannana,12,12,0,0,32
660148,dutiyaupakkhaṭepi,dutiyaupakkhatepi,1,1,0,0,17
660149,anupaññattisadisaṃ,anupannattisadisam,5,4,1,0,18
660150,rājasikkhāpadavaṇṇanā,rajasikkhapadavannana,19,19,0,0,21
660151,rājasikkhāpadaṃ,rajasikkhapadam,6,6,0,0,15
660152,saññāpetvāti,sannapetvati,7,0,7,0,12
660153,paññāsabandhoti,pannasabandhoti,1,0,1,0,15
660154,paññāsakahāpaṇadaṇḍoti,pannasakahapanadandoti,1,1,0,0,22
660155,baddhotipi,baddhotipi,1,1,0,0,10
660156,dāpetabboti,dapetabboti,4,3,1,0,11
660157,para538-9,para538-9,3,3,0,0,9
660158,rājabhogotipi,rajabhogotipi,1,1,0,0,13
660159,pahiṇeyyāti,pahineyyati,3,0,3,0,11
660160,veyyāvaccakaroti,veyyavaccakaroti,7,2,5,0,16
660161,codanālakkhaṇanidassanametaṃ,codanalakkhananidassanametam,3,3,0,0,28
660162,codanālakkhaṇaṃ,codanalakkhanam,5,5,0,0,15
660163,navattabbākāradassanatthaṃ,navattabbakaradassanattham,1,1,0,0,26
660164,uddiṭṭhacodanāparicchedaṃ,udditthacodanaparicchedam,2,1,1,0,25
660165,codayamāno,codayamano,8,8,0,0,10
660166,sārayamāno,sarayamano,5,5,0,0,10
660167,ṭhānalakkhaṇanidassanametaṃ,thanalakkhananidassanametam,2,2,0,0,27
660168,chakkhattuparamanti,chakkhattuparamanti,1,1,0,0,19
660169,chakkhattuparamañhi,chakkhattuparamanhi,2,2,0,0,19
660170,ṭhānalakkhaṇaṃ,thanalakkhanam,3,3,0,0,14
660171,sabbaṭṭhānānaṃ,sabbatthananam,1,1,0,0,14
660172,tuṇhībhūtenā,tunhibhutena,1,1,0,0,12
660173,vuttenāpi,vuttenapi,2,2,0,0,9
660174,yāgukhajjakādibhedaṃ,yagukhajjakadibhedam,3,3,0,0,20
660175,yāciyamānenāpi,yaciyamanenapi,4,4,0,0,14
660176,bhāsitabboti,bhasitabboti,5,0,5,0,12
660177,bhāsathāti,bhasathati,1,1,0,0,10
660178,pucchiyamānoti,pucchiyamanoti,3,1,2,0,14
660179,ekacodanāvuḍḍhiyā,ekacodanavuddhiya,1,1,0,0,17
660180,codetiyeva,codetiyeva,6,6,0,0,10
660181,codetipi,codetipi,3,3,0,0,8
660182,hāpetabbāni,hapetabbani,5,5,0,0,11
660183,sabbacodanāyo,sabbacodanayo,3,3,0,0,13
660184,sabbaṭṭhānāni,sabbatthanani,3,3,0,0,13
660185,nānādivasesu,nanadivasesu,5,5,0,0,12
660186,rājabhoggato,rajabhoggato,2,2,0,0,12
660187,yatvassātipi,yatvassatipi,1,1,0,0,12
660188,pesitanti,pesitanti,5,5,0,0,9
660189,rājabhoggassa,rajabhoggassa,2,2,0,0,13
660190,yuñjantāyasmanto,yunjantayasmanto,10,7,3,0,16
660191,vinassāti,vinassati,9,2,7,0,9
660192,pāheti,paheti,2,2,0,0,6
660193,sabbakappiyakārakesu,sabbakappiyakarakesu,3,3,0,0,20
660194,aniddiṭṭho,aniddittho,9,9,0,0,10
660195,aniddiṭṭhopi,anidditthopi,3,3,0,0,12
660196,mukhavevaṭika,mukhavevatika,1,1,0,0,13
660197,parammukhakappiyakārakoti,parammukhakappiyakarakoti,5,4,1,0,25
660198,sammukhāsammukhavasena,sammukhasammukhavasena,5,5,0,0,22
660199,niddiṭṭhopi,nidditthopi,4,4,0,0,11
660200,akappiyavatthuṃ,akappiyavatthum,31,30,1,0,15
660201,sammukhāniddiṭṭho,sammukhaniddittho,12,10,2,0,17
660202,asammukhāniddiṭṭho,asammukhaniddittho,6,4,2,0,18
660203,asammukhāniddiṭṭhoti,asammukhanidditthoti,6,4,2,0,20
660204,asammukhāniddiṭṭhāti,asammukhanidditthati,6,6,0,0,20
660205,niddiṭṭhaveyyāvaccakarā,nidditthaveyyavaccakara,6,4,2,0,23
660206,avicāretukāmatāya,avicaretukamataya,3,3,0,0,17
660207,upanikkhipanti,upanikkhipanti,7,7,0,0,14
660208,asādiyantena,asadiyantena,6,6,0,0,12
660209,mūlasāmikānampi,mulasamikanampi,3,3,0,0,15
660210,mukhavevaṭikakappiyakārako,mukhavevatikakappiyakarako,9,5,4,0,26
660211,aniddiṭṭhakappiyakārakā,anidditthakappiyakaraka,4,3,1,0,23
660212,aññātakaappavāritesu,annatakaappavaritesu,13,11,2,0,20
660213,āharitvāpi,aharitvapi,2,2,0,0,10
660214,dadantesupi,dadantesupi,3,3,0,0,11
660215,bhojanasālādīnaṃ,bhojanasaladinam,5,5,0,0,16
660216,sampaṭicchantassa,sampaticchantassa,5,5,0,0,17
660217,anāpattikā,anapattika,7,7,0,0,10
660218,piṇḍapātagilānapaccayatthāya,pindapatagilanapaccayatthaya,3,2,1,0,28
660219,garubhaṇḍattā,garubhandatta,12,10,2,0,13
660220,senāsanajagganatthaṃ,senasanajagganattham,2,2,0,0,20
660221,mūlacchejjaṃ,mulacchejjam,3,3,0,0,12
660222,khettavatthādi,khettavatthadi,2,2,0,0,14
660223,tisassasampādanakaṃ,tisassasampadanakam,2,2,0,0,19
660224,dhovissati,dhovissati,4,4,0,0,10
660225,kappiyasīsena,kappiyasisena,2,2,0,0,13
660226,udakaparibhogatthāya,udakaparibhogatthaya,2,2,0,0,20
660227,saṅghikabhūmiṃ,sanghikabhumim,3,3,0,0,14
660228,ṭhapetumpi,thapetumpi,6,5,1,0,10
660229,rājabalinā,rajabalina,2,2,0,0,10
660230,kasikammakāleyeva,kasikammakaleyeva,2,2,0,0,17
660231,kappiyabhaṇḍampi,kappiyabhandampi,6,5,1,0,16
660232,pariccattabhāvaṃ,pariccattabhavam,6,6,0,0,16
660233,nīhaṭaudakavāhakaṃ,nihataudakavahakam,2,2,0,0,18
660234,aḷanāgarājamahesī,alanagarajamahesi,3,1,2,0,17
660235,kappiyavohārepi,kappiyavoharepi,7,6,1,0,15
660236,udakavasena,udakavasena,4,4,0,0,11
660237,paṭiggahitataḷāke,patiggahitatalake,4,4,0,0,17
660238,mattikuddharaṇapāḷibandhanādīni,mattikuddharanapalibandhanadini,4,4,0,0,31
660239,sāretabbaṃ,saretabbam,1,1,0,0,10
660240,kappiyakārakā,kappiyakaraka,13,13,0,0,13
660241,lajjibhikkhunā,lajjibhikkhuna,6,5,1,0,14
660242,kārāpitesu,karapitesu,3,3,0,0,10
660243,visagatapiṇḍapāto,visagatapindapato,3,3,0,0,17
660244,akappiyamaṃsarasamissakabhojanaṃ,akappiyamamsarasamissakabhojanam,1,1,0,0,32
660245,dubbinibbhogaṃ,dubbinibbhogam,3,2,1,0,14
660246,udakakammaṃ,udakakammam,2,2,0,0,11
660247,porāṇakedāresu,poranakedaresu,2,2,0,0,14
660248,pakatibhāgaṃ,pakatibhagam,2,2,0,0,12
660249,navasasse,navasasse,2,2,0,0,9
660250,akālasasse,akalasasse,1,1,0,0,10
660251,aparicchinnabhāge,aparicchinnabhage,7,6,1,0,17
660252,kassakesu,kassakesu,2,2,0,0,9
660253,bhūmippamāṇaggahaṇatthaṃ,bhumippamanaggahanattham,1,1,0,0,24
660254,āhaṭanti,ahatanti,2,2,0,0,8
660255,kappiyānaṃ,kappiyanam,3,3,0,0,10
660256,kayavikkayepi,kayavikkayepi,3,3,0,0,13
660257,ācikkhitattā,acikkhitatta,2,2,0,0,12
660258,catusāladvāre,catusaladvare,3,3,0,0,13
660259,ettakappamāṇe,ettakappamane,2,2,0,0,13
660260,saññājananatthaṃ,sannajananattham,6,4,2,0,16
660261,catussāladvāre,catussaladvare,1,1,0,0,14
660262,tatruppādampi,tatruppadampi,1,1,0,0,13
660263,accajantena,accajantena,2,2,0,0,11
660264,āmisatthāya,amisatthaya,4,4,0,0,11
660265,lolatāti,lolatati,2,2,0,0,8
660266,pokkharaṇīudakavāhakamātikādīsupi,pokkharaniudakavahakamatikadisupi,2,2,0,0,33
660267,pubbaṇṇāparaṇṇaucchuphalāphalādīnaṃ,pubbannaparannaucchuphalaphaladinam,2,2,0,0,35
660268,anāṇattāyeva,ananattayeva,2,2,0,0,12
660269,aparaṇṇādīni,aparannadini,2,2,0,0,12
660270,sassuṭṭhānakaṃ,sassutthanakam,3,3,0,0,14
660271,paricchedanatthaṃ,paricchedanattham,4,4,0,0,17
660272,vihāramajjhena,viharamajjhena,15,15,0,0,14
660273,cetiyaṅgaṇabodhiyaṅgaṇādīni,cetiyanganabodhiyanganadini,2,2,0,0,27
660274,āmisagarukatāya,amisagarukataya,5,5,0,0,15
660275,yathājātameva,yathajatameva,3,3,0,0,13
660276,alābukumbhaṇḍādikaṃ,alabukumbhandadikam,2,2,0,0,19
660277,aparaṇṇavatthuṃ,aparannavatthum,2,2,0,0,15
660278,valliphalāvāṭaṃ,valliphalavatam,2,2,0,0,15
660279,abhilāpamattametaṃ,abhilapamattametam,5,5,0,0,18
660280,sāmikānaṃyeva,samikanamyeva,2,2,0,0,13
660281,bhesajjapaṭijagganampi,bhesajjapatijagganampi,1,1,0,0,22
660282,pañcadivasavārena,pancadivasavarena,2,2,0,0,17
660283,rajakadāsampi,rajakadasampi,2,2,0,0,13
660284,pesakāradāsampi,pesakaradasampi,2,2,0,0,15
660285,ārāmikanāmena,aramikanamena,3,3,0,0,13
660286,gorasaparibhogatthāya,gorasaparibhogatthaya,1,1,0,0,21
660287,pañcagorasaparibhogatthāya,pancagorasaparibhogatthaya,4,4,0,0,26
660288,ajikādīsupi,ajikadisupi,2,2,0,0,11
660289,mahisaṃ,mahisam,3,3,0,0,7
660290,kosiyavaggo,kosiyavaggo,18,18,0,0,11
660291,kosiyasikkhāpadavaṇṇanā,kosiyasikkhapadavannana,16,16,0,0,23
660292,kosiyasikkhāpadaṃ,kosiyasikkhapadam,4,4,0,0,17
660293,kosiyaṃsūni,kosiyamsuni,4,4,0,0,11
660294,kañjikādīhi,kanjikadihi,3,3,0,0,11
660295,kosiyaṃsunā,kosiyamsuna,9,8,1,0,11
660296,missitvāti,missitvati,1,0,1,0,10
660297,karaṇaṭṭhāne,karanatthane,3,3,0,0,12
660298,kosiyaṃsuṃ,kosiyamsum,1,1,0,0,10
660299,suddhakāḷakasikkhāpadavaṇṇanā,suddhakalakasikkhapadavannana,10,10,0,0,29
660300,suddhakāḷakasikkhāpadaṃ,suddhakalakasikkhapadam,5,5,0,0,23
660301,amissitakāḷakānanti,amissitakalakananti,3,3,0,0,19
660302,kosiyasikkhāpadasadisānevāti,kosiyasikkhapadasadisanevati,2,2,0,0,28
660303,dvebhāgasikkhāpadavaṇṇanā,dvebhagasikkhapadavannana,14,14,0,0,25
660304,dvebhāgasikkhāpadaṃ,dvebhagasikkhapadam,4,4,0,0,19
660305,santhatassa,santhatassa,52,51,1,0,11
660306,ādātabbāti,adatabbati,4,0,4,0,10
660307,kapilavaṇṇānaṃ,kapilavannanam,2,2,0,0,14
660308,tulāhi,tulahi,5,5,0,0,6
660309,kāretukāmaṃ,karetukamam,1,1,0,0,11
660310,gocariyānanti,gocariyananti,1,1,0,0,13
660311,kosiyasikkhāpadasadisāneva,kosiyasikkhapadasadisaneva,1,1,0,0,26
660312,chabbassasikkhāpadavaṇṇanā,chabbassasikkhapadavannana,14,14,0,0,26
660313,santhatānaṃ,santhatanam,3,3,0,0,11
660314,santhatasammutīti,santhatasammutiti,1,0,1,0,17
660315,laddhasammutiko,laddhasammutiko,4,4,0,0,15
660316,mūlabyādhināva,mulabyadhinava,2,2,0,0,14
660317,sammutikiccanti,sammutikiccanti,1,1,0,0,15
660318,paṭikuppatu,patikuppatu,2,2,0,0,11
660319,sammutikiccaṃ,sammutikiccam,3,3,0,0,13
660320,orimabhāge,orimabhage,6,6,0,0,10
660321,saṅkhyāmattadassanatthaṃ,sankhyamattadassanattham,1,1,0,0,24
660322,ūnakachabbassānī,unakachabbassani,1,1,0,0,16
660323,atirekachabbassāni,atirekachabbassani,3,2,1,0,18
660324,nisīdanasanthatasikkhāpadavaṇṇanā,nisidanasanthatasikkhapadavannana,8,8,0,0,33
660325,nisīdanasanthatasikkhāpadaṃ,nisidanasanthatasikkhapadam,4,4,0,0,27
660326,samādiyissanti,samadiyissanti,2,2,0,0,14
660327,ujjhitasanthatapaccayā,ujjhitasanthatapaccaya,2,2,0,0,22
660328,ānisaṃsānīti,anisamsaniti,1,1,0,0,12
660329,khandhakasikkhāpade,khandhakasikkhapade,1,1,0,0,19
660330,ovadiyo,ovadiyo,3,2,1,0,7
660331,anusāsiyo,anusasiyo,2,2,0,0,9
660332,puṇṇacandasassirīkena,punnacandasassirikena,1,1,0,0,21
660333,sabbākāraparipuṇṇena,sabbakaraparipunnena,1,1,0,0,20
660334,manāpānīti,manapaniti,1,0,1,0,10
660335,matthakatāḷanena,matthakatalanena,2,2,0,0,16
660336,gāhitomhīti,gahitomhiti,1,1,0,0,11
660337,sandississatīti,sandississatiti,4,3,1,0,15
660338,apaññattasikkhāpadapaññapanaṃ,apannattasikkhapadapannapanam,1,1,0,0,29
660339,paññattasamucchindanaṃ,pannattasamucchindanam,1,1,0,0,22
660340,sikkhissāmāti,sikkhissamati,1,1,0,0,13
660341,anuññātāvusoti,anunnatavusoti,1,0,1,0,14
660342,pihentāti,pihentati,1,0,1,0,9
660343,pihayantā,pihayanta,2,2,0,0,9
660344,catutthacīvarasaññitāya,catutthacivarasannitaya,2,2,0,0,23
660345,sabbasanthatāni,sabbasanthatani,1,1,0,0,15
660346,saddhādeyyavinipātane,saddhadeyyavinipatane,3,3,0,0,21
660347,paribhogupāyaṃ,paribhogupayam,2,2,0,0,14
660348,nisinnañceva,nisinnanceva,3,2,1,0,12
660349,nipannañca,nipannanca,1,1,0,0,10
660350,santharantena,santharantena,2,2,0,0,13
660351,kiriyākiriyattā,kiriyakiriyatta,6,6,0,0,15
660352,dvebhāgasikkhāpadasadisānīti,dvebhagasikkhapadasadisaniti,1,1,0,0,28
660353,santhatesu,santhatesu,4,4,0,0,10
660354,eḷakalomasikkhāpadavaṇṇanā,elakalomasikkhapadavannana,14,14,0,0,26
660355,eḷakalomasikkhāpadaṃ,elakalomasikkhapadam,4,4,0,0,20
660356,kītānī,kitani,1,1,0,0,6
660357,āsumbhīti,asumbhiti,2,0,2,0,9
660358,haritabbānīti,haritabbaniti,5,2,3,0,13
660359,bahitiyojanaṃ,bahitiyojanam,3,1,2,0,13
660360,patanake,patanake,2,2,0,0,8
660361,nissaggiyapācittiyāni,nissaggiyapacittiyani,3,3,0,0,21
660362,bahitiyojane,bahitiyojane,1,1,0,0,12
660363,eḷakalomabhaṇḍikā,elakalomabhandika,1,1,0,0,17
660364,harissatī,harissati,11,9,2,0,9
660365,ubhatobhaṇḍikaṃ,ubhatobhandikam,1,1,0,0,15
660366,ekābaddhepi,ekabaddhepi,1,1,0,0,11
660367,hatthipiṭṭhiādīsu,hatthipitthiadisu,4,4,0,0,17
660368,harissatīti,harissatiti,8,8,0,0,11
660369,agacchantepi,agacchantepi,2,2,0,0,12
660370,hatthipiṭṭhiyādīsu,hatthipitthiyadisu,1,1,0,0,18
660371,harāpetī,harapeti,14,14,0,0,8
660372,suṅkaghāte,sunkaghate,7,6,1,0,10
660373,āpattiparicchedo,apattiparicchedo,3,3,0,0,16
660374,vāsādhippāyo,vasadhippayo,3,2,1,0,12
660375,vinayakammakataṃ,vinayakammakatam,2,2,0,0,16
660376,kataṃbhaṇḍaṃ,katambhandam,1,1,0,0,12
660377,kambalakojavasanthatādiṃ,kambalakojavasanthatadim,3,3,0,0,24
660378,baddhamattampi,baddhamattampi,3,3,0,0,14
660379,tanukapattatthavikantare,tanukapattatthavikantare,3,3,0,0,24
660380,āyogaaṃsabaddhakakāyabandhanādīnaṃ,ayogaamsabaddhakakayabandhanadinam,2,2,0,0,34
660381,pipphalikādīnaṃ,pipphalikadinam,2,2,0,0,15
660382,malarakkhaṇatthaṃ,malarakkhanattham,2,2,0,0,17
660383,sipāṭikāya,sipatikaya,13,13,0,0,10
660384,vātābādhiko,vatabadhiko,2,2,0,0,11
660385,kaṇṇacchiddepi,kannacchiddepi,2,2,0,0,14
660386,katabhaṇḍaṭṭhāne,katabhandatthane,2,2,0,0,16
660387,nidhānamukhaṃ,nidhanamukham,8,5,3,0,13
660388,eḷakalomadhovāpanasikkhāpadavaṇṇanā,elakalomadhovapanasikkhapadavannana,10,10,0,0,35
660389,eḷakalomadhovāpanasikkhāpadaṃ,elakalomadhovapanasikkhapadam,7,6,1,0,29
660390,anuyuñjitunti,anuyunjitunti,1,1,0,0,13
660391,purāṇacīvarasikkhāpade,puranacivarasikkhapade,3,2,1,0,22
660392,samuṭṭhānādīhīti,samutthanadihiti,13,13,0,0,16
660393,rūpiyasikkhāpadavaṇṇanā,rupiyasikkhapadavannana,8,8,0,0,23
660394,rūpiyasikkhāpadaṃ,rupiyasikkhapadam,5,5,0,0,17
660395,paṭivisoti,pativisoti,1,0,1,0,10
660396,para583-4,para583-4,3,3,0,0,9
660397,jātarūpanti,jatarupanti,2,2,0,0,11
660398,vaṇṇasadisaṃ,vannasadisam,1,1,0,0,12
660399,vohāragamanīyaṃ,voharagamaniyam,3,3,0,0,15
660400,kahāpaṇādi,kahapanadi,3,3,0,0,10
660401,lohamāsakoti,lohamasakoti,3,1,2,0,12
660402,tambalohādīhi,tambalohadihi,8,7,1,0,13
660403,katamāsako,katamasako,12,12,0,0,10
660404,sāradārunā,saradaruna,5,5,0,0,10
660405,tālapaṇṇenāpi,talapannenapi,1,1,0,0,13
660406,jatumāsakoti,jatumasakoti,4,2,2,0,12
660407,aṭṭhimayopi,atthimayopi,5,5,0,0,11
660408,cammamayopi,cammamayopi,5,5,0,0,11
660409,rukkhaphalabījamayopi,rukkhaphalabijamayopi,5,5,0,0,21
660410,samuṭṭhāpitarūpopi,samutthapitarupopi,5,5,0,0,18
660411,asamuṭṭhāpitarūpopi,asamutthapitarupopi,4,4,0,0,19
660412,jātarūpamāsako,jatarupamasako,5,4,1,0,14
660413,rajatamāsakoti,rajatamasakoti,4,2,2,0,14
660414,nissaggiyavatthu,nissaggiyavatthu,12,12,0,0,16
660415,dāsidāsakhettavatthupupphārāmaphalārāmādayoti,dasidasakhettavatthupuppharamaphalaramadayoti,5,4,1,0,45
660416,paṭako,patako,6,4,2,0,6
660417,sappinavanītatelamadhuphāṇitādibhesajjañca,sappinavanitatelamadhuphanitadibhesajjanca,1,1,0,0,42
660418,kappiyavatthu,kappiyavatthu,10,9,1,0,13
660419,nissaggiyavatthuṃ,nissaggiyavatthum,19,17,2,0,17
660420,saṅghagaṇapuggalacetiyānaṃ,sanghaganapuggalacetiyanam,4,4,0,0,26
660421,sampaṭicchato,sampaticchato,7,7,0,0,13
660422,dukkaṭavatthuṃ,dukkatavatthum,17,14,3,0,14
660423,kappiyavatthumhi,kappiyavatthumhi,2,2,0,0,16
660424,nikkhipanatthāya,nikkhipanatthaya,2,2,0,0,16
660425,bhaṇḍāgārikasīsena,bhandagarikasisena,13,12,1,0,18
660426,ratanasikkhāpade,ratanasikkhapade,3,2,1,0,16
660427,uggaṇheyyāti,ugganheyyati,5,2,3,0,12
660428,jātarūparajatabhaṇḍesu,jataruparajatabhandesu,1,1,0,0,22
660429,kahāpaṇamāsakesu,kahapanamasakesu,1,1,0,0,16
660430,gaṇhāpayato,ganhapayato,1,1,0,0,11
660431,sithilabaddhāya,sithilabaddhaya,1,1,0,0,15
660432,sithilapūrite,sithilapurite,1,1,0,0,13
660433,ghanabaddhe,ghanabaddhe,2,2,0,0,11
660434,ghanapūrite,ghanapurite,2,2,0,0,11
660435,upanikkhittasādiyane,upanikkhittasadiyane,8,7,1,0,20
660436,appaṭikkhipitvāpi,appatikkhipitvapi,3,3,0,0,17
660437,akiriyasamuṭṭhānaṃ,akiriyasamutthanam,6,6,0,0,18
660438,tuyhidaṃ,tuyhidam,4,4,0,0,8
660439,guttaṭṭhānaṃ,guttatthanam,15,14,1,0,12
660440,sattabhūmikampi,sattabhumikampi,4,4,0,0,15
660441,kappiyañca,kappiyanca,22,17,5,0,10
660442,akappiyañca,akappiyanca,19,16,3,0,11
660443,gahessatha,gahessatha,3,3,0,0,10
660444,paṭiggahitamattameva,patiggahitamattameva,3,3,0,0,20
660445,cetāpitaṃ,cetapitam,30,26,4,0,9
660446,paribhogadassanatthaṃ,paribhogadassanattham,3,3,0,0,21
660447,rūpiyapaṭiggāhakaṃ,rupiyapatiggahakam,4,3,1,0,18
660448,rūpiyapaṭiggāhakena,rupiyapatiggahakena,3,3,0,0,19
660449,pattabhāgampi,pattabhagampi,3,3,0,0,13
660450,makkaṭādīhi,makkatadihi,3,3,0,0,11
660451,tiracchānagatapariggahitampi,tiracchanagatapariggahitampi,1,1,0,0,28
660452,paṃsukūlampi,pamsukulampi,5,5,0,0,12
660453,senāsanadhūpanampi,senasanadhupanampi,2,2,0,0,18
660454,dīpāloke,dipaloke,2,2,0,0,8
660455,potthakampi,potthakampi,2,2,0,0,11
660456,telamadhuphāṇitehi,telamadhuphanitehi,2,2,0,0,18
660457,gehaparicchedena,gehaparicchedena,2,2,0,0,16
660458,paricchedātikkantā,paricchedatikkanta,3,3,0,0,18
660459,āgantukattā,agantukatta,3,3,0,0,11
660460,setunāpi,setunapi,2,2,0,0,8
660461,nāvāyapi,navayapi,5,5,0,0,8
660462,uḷumpenapi,ulumpenapi,1,1,0,0,10
660463,khanāpitāya,khanapitaya,1,1,0,0,11
660464,ubbhidodakaṃ,ubbhidodakam,2,2,0,0,12
660465,kītāya,kitaya,4,4,0,0,6
660466,āgantukampi,agantukampi,2,2,0,0,11
660467,bhūmipi,bhumipi,4,4,0,0,7
660468,bhūmiṃyeva,bhumimyeva,2,2,0,0,10
660469,byāpārenāti,byaparenati,1,1,0,0,11
660470,yathāvuttalakkhaṇo,yathavuttalakkhano,4,4,0,0,18
660471,rūpiyachaḍḍako,rupiyachaddako,9,9,0,0,14
660472,muṭṭhapamuṭṭhassatibhāvaṃ,mutthapamutthassatibhavam,1,1,0,0,25
660473,rūpiyapaṭiggāhakassa,rupiyapatiggahakassa,8,8,0,0,20
660474,patitokāsaṃ,patitokasam,6,3,3,0,11
660475,asamannāharantena,asamannaharantena,3,2,1,0,17
660476,pātetabbanti,patetabbanti,4,4,0,0,12
660477,jigucchitabbepi,jigucchitabbepi,2,2,0,0,15
660478,rūpiye,rupiye,30,22,8,0,6
660479,uppannapaccayaparibhogo,uppannapaccayaparibhogo,6,6,0,0,23
660480,appaccavekkhitaparibhogo,appaccavekkhitaparibhogo,2,2,0,0,24
660481,purebhattapacchābhattapurimayāmapacchimayāmesu,purebhattapacchabhattapurimayamapacchimayamesu,2,2,0,0,46
660482,appaccavekkhatova,appaccavekkhatova,5,4,1,0,17
660483,satipaccayatā,satipaccayata,16,14,2,0,13
660484,desanāsuddhī,desanasuddhi,2,2,0,0,12
660485,saṃvarasuddhī,samvarasuddhi,3,2,1,0,13
660486,pariyeṭṭhisuddhī,pariyetthisuddhi,2,2,0,0,16
660487,paccayaparibhogasannissitasīlaṃ,paccayaparibhogasannissitasilam,2,2,0,0,31
660488,paccavekkhaṇasuddhī,paccavekkhanasuddhi,2,2,0,0,19
660489,lajjiparibhogo,lajjiparibhogo,3,3,0,0,14
660490,alajjiparibhogo,alajjiparibhogo,8,8,0,0,15
660491,dhammiyaparibhogo,dhammiyaparibhogo,2,2,0,0,17
660492,adhammiyaparibhogoti,adhammiyaparibhogoti,2,2,0,0,20
660493,alajjinā,alajjina,23,18,5,0,8
660494,alajjībhāvaṃ,alajjibhavam,1,1,0,0,12
660495,bhārabhūtena,bharabhutena,3,2,1,0,12
660496,alajjīsatampi,alajjisatampi,2,2,0,0,13
660497,alajjināva,alajjinava,2,2,0,0,10
660498,khattiyakumārānaṃ,khattiyakumaranam,2,2,0,0,17
660499,bhojanasadisoti,bhojanasadisoti,1,1,0,0,15
660500,dhammiyādhammiyaparibhogo,dhammiyadhammiyaparibhogo,4,2,2,0,25
660501,adhammiyo,adhammiyo,4,4,0,0,9
660502,yathādānameva,yathadanameva,4,3,1,0,13
660503,paggahā,paggaha,2,2,0,0,7
660504,lajjipaggaho,lajjipaggaho,2,2,0,0,12
660505,alajjipaggaho,alajjipaggaho,2,2,0,0,13
660506,dhammaparibhogo,dhammaparibhogo,9,7,2,0,15
660507,āmisaparibhogoti,amisaparibhogoti,2,2,0,0,16
660508,dhammaparibhogaāmisaparibhogesu,dhammaparibhogaamisaparibhogesu,2,2,0,0,31
660509,āmisaparibhogo,amisaparibhogo,5,5,0,0,14
660510,dhammaparibhogopi,dhammaparibhogopi,5,3,2,0,17
660511,rūpiyasaññīti,rupiyasanniti,4,0,4,0,13
660512,rūpiyasaṅgahameva,rupiyasangahameva,1,1,0,0,17
660513,kharapattaṃ,kharapattam,3,1,2,0,11
660514,arūpiyasaññīti,arupiyasanniti,2,1,1,0,14
660515,kharapattādisaññī,kharapattadisanni,2,2,0,0,17
660516,rājorodhādayo,rajorodhadayo,1,1,0,0,13
660517,bhattakhajjakagandhapiṇḍādīsu,bhattakhajjakagandhapindadisu,1,1,0,0,29
660518,coḷabhikkhāya,colabhikkhaya,1,1,0,0,13
660519,baddhakahāpaṇādīhiyeva,baddhakahapanadihiyeva,1,1,0,0,22
660520,bhattādisaññāya,bhattadisannaya,1,1,0,0,15
660521,coḷakasaññāya,colakasannaya,1,1,0,0,13
660522,arūpiyasaññī,arupiyasanni,12,12,0,0,12
660523,rūpiyaaññavādakaupassutisikkhāpadāni,rupiyaannavadakaupassutisikkhapadani,1,1,0,0,36
660524,rūpiyasaṃvohārasikkhāpadavaṇṇanā,rupiyasamvoharasikkhapadavannana,14,14,0,0,32
660525,rūpiyasaṃvohārasikkhāpadaṃ,rupiyasamvoharasikkhapadam,6,6,0,0,26
660526,katākatādivasena,katakatadivasena,2,2,0,0,16
660527,jātarūparajataparivattanaṃ,jataruparajataparivattanam,7,2,5,0,26
660528,paṭiggahaṇasseva,patiggahanasseva,2,2,0,0,16
660529,paṭikkhitattā,patikkhitatta,2,2,0,0,13
660530,paṭiggahitaparivattane,patiggahitaparivattane,3,3,0,0,22
660531,sīsūpagaṃ,sisupagam,4,2,2,0,9
660532,sīsūpakaṃ,sisupakam,2,2,0,0,9
660533,sīsālaṅkārassetaṃ,sisalankarassetam,1,1,0,0,17
660534,rūpiyasaṃvohāroyeva,rupiyasamvoharoyeva,2,2,0,0,19
660535,rūpiyasaññītiādimhi,rupiyasannitiadimhi,2,0,2,0,19
660536,vuttavatthūsu,vuttavatthusu,1,1,0,0,13
660537,nissaggiyavatthunā,nissaggiyavatthuna,13,10,3,0,18
660538,mūlaggahaṇe,mulaggahane,6,6,0,0,11
660539,purimasikkhāpadena,purimasikkhapadena,22,20,2,0,18
660540,aparāparaparivattane,aparaparaparivattane,2,1,1,0,20
660541,nissaggiyapācittiyameva,nissaggiyapacittiyameva,4,4,0,0,23
660542,kappiyavatthuṃ,kappiyavatthum,16,15,1,0,14
660543,cetāpentassapi,cetapentassapi,2,1,1,0,14
660544,arūpiye,arupiye,29,25,4,0,7
660545,rūpiyasaññī,rupiyasanni,17,15,2,0,11
660546,cetāpetītiādi,cetapetitiadi,2,0,2,0,13
660547,tassānulomattā,tassanulomatta,1,1,0,0,14
660548,arūpiyaṃ,arupiyam,24,20,4,0,8
660549,arūpiyena,arupiyena,9,9,0,0,9
660550,rūpiyapakkhe,rupiyapakkhe,4,4,0,0,12
660551,dukkaṭavatthunā,dukkatavatthuna,19,16,3,0,15
660552,cetāpitattā,cetapitatta,7,7,0,0,11
660553,dukkaṭavatthumeva,dukkatavatthumeva,2,2,0,0,17
660554,parivattanepi,parivattanepi,2,2,0,0,13
660555,akappiyavatthunā,akappiyavatthuna,3,3,0,0,16
660556,dānaggahaṇato,danaggahanato,2,2,0,0,13
660557,kayavikkayasikkhāpadañca,kayavikkayasikkhapadanca,1,1,0,0,24
660558,kappiyavatthunā,kappiyavatthuna,13,12,1,0,15
660559,kappiyavatthuparivattanameva,kappiyavatthuparivattanameva,1,1,0,0,28
660560,rūpiyārūpiyacetāpanaṃ,rupiyarupiyacetapanam,1,1,0,0,21
660561,rūpiyacetāpanaṃ,rupiyacetapanam,2,2,0,0,15
660562,dukkaṭavatthuno,dukkatavatthuno,10,10,0,0,15
660563,cetāpanepi,cetapanepi,2,2,0,0,10
660564,adhippāyaññūhi,adhippayannuhi,7,7,0,0,14
660565,mūlapaṭiggahaṇe,mulapatiggahane,1,1,0,0,15
660566,akappiyassa,akappiyassa,5,4,1,0,11
660567,kayavikkayasikkhāpadena,kayavikkayasikkhapadena,2,2,0,0,23
660568,uparisikkhāpadenapi,uparisikkhapadenapi,1,1,0,0,19
660569,payojentassa,payojentassa,1,1,0,0,12
660570,rūpiyasaṃvohārassa,rupiyasamvoharassa,3,3,0,0,18
660571,garukabhāvadīpakaṃ,garukabhavadipakam,1,1,0,0,18
660572,pattacatukkaṃ,pattacatukkam,3,2,1,0,13
660573,ayabījaṃ,ayabijam,3,3,0,0,8
660574,mahāakappiyo,mahaakappiyo,4,2,2,0,12
660575,mūlasāmikānaṃ,mulasamikanam,6,5,1,0,13
660576,pattasāmikānaṃ,pattasamikanam,5,5,0,0,14
660577,kappiyakārakena,kappiyakarakena,7,7,0,0,15
660578,kammārakulaṃ,kammarakulam,8,8,0,0,12
660579,kammāraṃ,kammaram,4,4,0,0,8
660580,dutiyapattasadisoyeva,dutiyapattasadisoyeva,3,2,1,0,21
660581,anissaṭṭhattā,anissatthatta,8,7,1,0,13
660582,pahitakappiyakārakena,pahitakappiyakarakena,6,6,0,0,21
660583,dubbicāritattā,dubbicaritatta,8,8,0,0,14
660584,asampaṭicchitattā,asampaticchitatta,7,6,1,0,17
660585,mahāsumattherassa,mahasumattherassa,5,2,3,0,17
660586,tipiṭakacūḷanāgattherassapi,tipitakaculanagattherassapi,1,0,1,0,27
660587,nissajjāpesīti,nissajjapesiti,2,2,0,0,14
660588,akappiyapattacatukkaṃ,akappiyapattacatukkam,3,3,0,0,21
660589,paribhogārahoti,paribhogarahoti,1,1,0,0,15
660590,kharapattādīsu,kharapattadisu,2,2,0,0,14
660591,suvaṇṇādisaññī,suvannadisanni,1,1,0,0,14
660592,arūpiyasaññissa,arupiyasannissa,1,1,0,0,15
660593,kayavikkayasikkhāpadavaṇṇanā,kayavikkayasikkhapadavannana,14,14,0,0,28
660594,kayavikkayasikkhāpadaṃ,kayavikkayasikkhapadam,5,5,0,0,22
660595,hipi,hipi,2,1,1,0,4
660596,dubbalasaṅghāṭi,dubbalasanghati,1,1,0,0,15
660597,katihampi,katihampi,1,0,1,0,9
660598,katihanti,katihanti,1,1,0,0,9
660599,divasānīti,divasaniti,7,2,5,0,10
660600,katihipi,katihipi,3,2,1,0,8
660601,kappiyabhaṇḍānaṃ,kappiyabhandanam,6,5,1,0,16
660602,dasikasuttapariyosānaṃ,dasikasuttapariyosanam,1,1,0,0,22
660603,akappiyabhaṇḍaparivattanañhi,akappiyabhandaparivattananhi,2,2,0,0,28
660604,kayavikkayasaṅgahaṃ,kayavikkayasangaham,4,4,0,0,19
660605,kayañceva,kayanceva,2,2,0,0,9
660606,vikkayañca,vikkayanca,2,2,0,0,10
660607,ajjhācaratīti,ajjhacaratiti,1,0,1,0,13
660608,vītikkamavācaṃ,vitikkamavacam,1,1,0,0,14
660609,kayitañca,kayitanca,7,5,2,0,9
660610,vikkayitañcāti,vikkayitancati,1,0,1,0,14
660611,vikkītañca,vikkitanca,4,3,1,0,10
660612,itiādivacanānurūpato,itiadivacananurupato,1,1,0,0,20
660613,kayavasena,kayavasena,1,1,0,0,10
660614,gahitakappiyabhaṇḍaṃ,gahitakappiyabhandam,1,1,0,0,20
660615,gihipabbajitehi,gihipabbajitehi,4,4,0,0,15
660616,aññātakehi,annatakehi,5,5,0,0,10
660617,mocentena,mocentena,3,3,0,0,9
660618,parivattanavidhi,parivattanavidhi,2,2,0,0,16
660619,pātheyyataṇḍulā,patheyyatandula,2,2,0,0,15
660620,bhattahatthaṃ,bhattahattham,2,2,0,0,13
660621,nimittakammamattampi,nimittakammamattampi,2,2,0,0,20
660622,rajanachalligaṇanāya,rajanachalligananaya,2,2,0,0,20
660623,dārugaṇanāya,darugananaya,2,2,0,0,12
660624,dantakārādīhi,dantakaradihi,2,2,0,0,13
660625,sippikehi,sippikehi,2,2,0,0,9
660626,dhamakaraṇādīsu,dhamakaranadisu,1,1,0,0,15
660627,nhāpitena,nhapitena,1,1,0,0,9
660628,bhuttosi,bhuttosi,5,5,0,0,8
660629,vatthadhovane,vatthadhovane,3,3,0,0,13
660630,kesacchedane,kesacchedane,3,3,0,0,12
660631,bhūmisodhanādinavakamme,bhumisodhanadinavakamme,3,3,0,0,23
660632,nissaggiyavatthumhi,nissaggiyavatthumhi,5,5,0,0,19
660633,kayavikkayasaññītiādimhi,kayavikkayasannitiadimhi,1,0,1,0,24
660634,kayavikkayasaññī,kayavikkayasanni,4,4,0,0,16
660635,cūḷattike,culattike,1,0,1,0,9
660636,thālakampi,thalakampi,4,4,0,0,10
660637,pattasāmiko,pattasamiko,8,8,0,0,11
660638,appagghabhāvaṃ,appagghabhavam,2,2,0,0,14
660639,puttabhātikampi,puttabhatikampi,2,2,0,0,15
660640,appaṭiggahitakena,appatiggahitakena,4,4,0,0,17
660641,mināpetabbaṃ,minapetabbam,2,2,0,0,12
660642,nāḷiyañhi,naliyanhi,2,2,0,0,9
660643,avasiṭṭhatelaṃ,avasitthatelam,2,2,0,0,14
660644,pattasikkhāpadavaṇṇanā,pattasikkhapadavannana,16,16,0,0,22
660645,pattasikkhāpadaṃ,pattasikkhapadam,4,4,0,0,16
660646,pattavāṇijjaṃ,pattavanijjam,4,3,1,0,13
660647,āmattikāpaṇaṃ,amattikapanam,7,4,3,0,13
660648,āmattikā,amattika,3,2,1,0,8
660649,āmattikānaṃ,amattikanam,2,2,0,0,11
660650,kulālabhaṇḍavāṇijakāpaṇanti,kulalabhandavanijakapananti,1,1,0,0,27
660651,aḍḍhāḷhakodanaṃ,addhalhakodanam,6,4,2,0,15
660652,taṇḍulanāḷīnaṃ,tandulanalinam,4,3,1,0,14
660653,magadhanāḷi,magadhanali,25,22,3,0,11
660654,aḍḍhaterasapalā,addhaterasapala,6,5,1,0,15
660655,pakatināḷi,pakatinali,3,3,0,0,10
660656,damiḷanāḷi,damilanali,3,3,0,0,10
660657,diyaḍḍhanāḷi,diyaddhanali,3,3,0,0,12
660658,sīhaḷanāḷi,sihalanali,5,5,0,0,10
660659,catutthabhāgappamāṇaṃ,catutthabhagappamanam,6,6,0,0,21
660660,hatthahāriyassa,hatthahariyassa,1,1,0,0,15
660661,macchamaṃsasākaphalakaḷīrādibyañjanaṃ,macchamamsasakaphalakaliradibyanjanam,1,1,0,0,37
660662,anupahatapurāṇasālitaṇḍulānaṃ,anupahatapuranasalitandulanam,5,5,0,0,29
660663,sukoṭṭitaparisuddhānaṃ,sukottitaparisuddhanam,5,5,0,0,22
660664,magadhanāḷiyo,magadhanaliyo,4,4,0,0,13
660665,anuttaṇḍulaṃ,anuttandulam,5,3,2,0,12
660666,akilinnaṃ,akilinnam,3,3,0,0,9
660667,apiṇḍitaṃ,apinditam,4,4,0,0,9
660668,kundamakuḷarāsisadisaṃ,kundamakularasisadisam,4,4,0,0,22
660669,avassāvitodanaṃ,avassavitodanam,7,7,0,0,15
660670,catutthabhāgappamāṇo,catutthabhagappamano,8,8,0,0,20
660671,nātighano,natighano,5,5,0,0,9
660672,nātitanuko,natitanuko,5,5,0,0,10
660673,sabbasambhārasaṅkhato,sabbasambharasankhato,5,5,0,0,21
660674,muggasūpo,muggasupo,10,8,2,0,9
660675,yāvacarimālopappahonakaṃ,yavacarimalopappahonakam,5,5,0,0,24
660676,macchamaṃsādibyañjanaṃ,macchamamsadibyanjanam,5,5,0,0,22
660677,sappitelatakkarasakañjikādīni,sappitelatakkarasakanjikadini,5,5,0,0,29
660678,odanagatikāneva,odanagatikaneva,3,3,0,0,15
660679,heṭṭhimarājisamaṃ,hetthimarajisamam,15,15,0,0,17
660680,hīrena,hirena,6,6,0,0,6
660681,hīrassa,hirassa,6,6,0,0,7
660682,heṭṭhimantaṃ,hetthimantam,7,7,0,0,12
660683,rājiṃ,rajim,29,29,0,0,5
660684,ukkaṭṭhomako,ukkatthomako,8,2,6,0,12
660685,upaḍḍhanāḷikodanaṃ,upaddhanalikodanam,2,1,1,0,18
660686,nāmamatte,namamatte,2,1,1,0,9
660687,nāḷikodanādi,nalikodanadi,4,4,0,0,12
660688,majjhimomako,majjhimomako,9,6,3,0,12
660689,majjhimukkaṭṭho,majjhimukkattho,4,2,2,0,15
660690,patthodanādi,patthodanadi,1,1,0,0,12
660691,omakukkaṭṭho,omakukkattho,4,2,2,0,12
660692,ukkaṭṭhattā,ukkatthatta,2,2,0,0,11
660693,omakattā,omakatta,1,1,0,0,8
660694,apattoti,apattoti,6,3,3,0,8
660695,bhājanaparibhogena,bhajanaparibhogena,10,10,0,0,18
660696,adhiṭṭhānupagā,adhitthanupaga,6,6,0,0,14
660697,vikappanupagā,vikappanupaga,4,4,0,0,13
660698,khañjakaṃ,khanjakam,1,1,0,0,9
660699,vikappetīti,vikappetiti,9,8,1,0,11
660700,pamāṇayuttassapi,pamanayuttassapi,1,1,0,0,16
660701,adhiṭṭhānavikappanupagattaṃ,adhitthanavikappanupagattam,1,1,0,0,27
660702,adhiṭṭhānupago,adhitthanupago,13,13,0,0,14
660703,dinneyeva,dinneyeva,4,4,0,0,9
660704,pattasaṅkhaṃ,pattasankham,2,2,0,0,12
660705,vikappanupago,vikappanupago,2,2,0,0,13
660706,vikappetabbo,vikappetabbo,6,6,0,0,12
660707,pattakārako,pattakarako,7,6,1,0,11
660708,paricchinnadivasato,paricchinnadivasato,4,4,0,0,19
660709,pesitabhikkhu,pesitabhikkhu,4,4,0,0,13
660710,napamāṇaṃ,napamanam,1,1,0,0,9
660711,pesitoyeva,pesitoyeva,4,4,0,0,10
660712,āgatabhikkhu,agatabhikkhu,2,2,0,0,12
660713,anatikkāmetvāva,anatikkametvava,3,3,0,0,15
660714,adhiṭṭhānavijahananti,adhitthanavijahananti,2,2,0,0,21
660715,paccuddharati,paccuddharati,6,6,0,0,13
660716,dinnavibbhantapaccakkhā,dinnavibbhantapaccakkha,2,2,0,0,23
660717,kālaṃkiriyakatena,kalamkiriyakatena,1,1,0,0,17
660718,liṅgapaccuddharā,lingapaccuddhara,2,2,0,0,16
660719,coraharaṇavissāsaggāhehipi,coraharanavissasaggahehipi,1,1,0,0,26
660720,kaṅgusitthaṃ,kangusittham,5,4,1,0,12
660721,lāmakadhaññasitthaṃ,lamakadhannasittham,2,2,0,0,19
660722,paṭipākatike,patipakatike,3,3,0,0,12
660723,dasāhabbhantare,dasahabbhantare,11,11,0,0,15
660724,ettāvattā,ettavatta,2,2,0,0,9
660725,vacanakkamo,vacanakkamo,12,12,0,0,11
660726,paṭhamakathinasikkhāpadavaṇṇanāyaṃ,pathamakathinasikkhapadavannanayam,1,1,0,0,34
660727,ūnapañcabandhanasikkhāpadavaṇṇanā,unapancabandhanasikkhapadavannana,14,14,0,0,33
660728,ūnapañcabandhanasikkhāpadaṃ,unapancabandhanasikkhapadam,6,6,0,0,27
660729,puttadārāpissa,puttadarapissa,5,5,0,0,14
660730,para612-3,para612-3,2,2,0,0,9
660731,ūnapañcabandhanenāti,unapancabandhanenati,3,0,3,0,20
660732,ūnapañcabandhano,unapancabandhano,9,7,2,0,16
660733,abandhanassāpi,abandhanassapi,2,2,0,0,14
660734,ūnapañcabandhanenā,unapancabandhanena,3,3,0,0,18
660735,pañcabandhano,pancabandhano,4,4,0,0,13
660736,bandhanokāse,bandhanokase,4,4,0,0,12
660737,abandhanokāso,abandhanokaso,3,3,0,0,13
660738,dvaṅgulappamāṇā,dvangulappamana,3,3,0,0,15
660739,heṭṭhimapariyante,hetthimapariyante,4,3,1,0,17
660740,pattavedhakena,pattavedhakena,6,6,0,0,14
660741,suttarajjukamakacirajjukādīhi,suttarajjukamakacirajjukadihi,3,3,0,0,29
660742,tipusuttakena,tipusuttakena,4,3,1,0,13
660743,tipupaṭṭakena,tipupattakena,3,2,1,0,13
660744,baddhasilesena,baddhasilesena,2,2,0,0,14
660745,madhusitthakalākhāsajjulasādīhi,madhusitthakalakhasajjulasadihi,1,1,0,0,31
660746,pāsāṇacuṇṇena,pasanacunnena,10,8,2,0,13
660747,mukhavaṭṭisamīpe,mukhavattisamipe,3,3,0,0,16
660748,vijjhitabbo,vijjhitabbo,4,4,0,0,11
660749,chaḷaṅgulā,chalangula,4,4,0,0,10
660750,aṭṭhaṅgulā,atthangula,3,3,0,0,10
660751,dasaṅgulā,dasangula,6,6,0,0,9
660752,baddhopi,baddhopi,5,5,0,0,8
660753,abaddhopi,abaddhopi,4,4,0,0,9
660754,apattoyeva,apattoyeva,3,3,0,0,10
660755,ayopatte,ayopatte,5,4,1,0,8
660756,lohamaṇḍalakena,lohamandalakena,4,4,0,0,15
660757,baddhampi,baddhampi,4,4,0,0,9
660758,therānurūpo,theranurupo,2,2,0,0,11
660759,pattapariyantoti,pattapariyantoti,4,0,4,0,16
660760,ṭhitapatto,thitapatto,3,3,0,0,10
660761,adeseti,adeseti,2,0,2,0,7
660762,mañcapīṭhachattanāgadantakādike,mancapithachattanagadantakadike,2,2,0,0,31
660763,nikkhipanadeso,nikkhipanadeso,3,3,0,0,14
660764,abhogenāti,abhogenati,2,1,1,0,10
660765,yāgurandhanarajanapacanādinā,yagurandhanarajanapacanadina,4,4,0,0,28
660766,aparibhogena,aparibhogena,5,4,1,0,12
660767,varapattaṃ,varapattam,2,2,0,0,10
660768,pavāritaṭṭhāne,pavaritatthane,17,17,0,0,14
660769,pañcabandhaneneva,pancabandhaneneva,4,4,0,0,17
660770,ūnapañcabandhanenāpi,unapancabandhanenapi,4,4,0,0,20
660771,bhesajjasikkhāpadavaṇṇanā,bhesajjasikkhapadavannana,20,20,0,0,25
660772,bhesajjasikkhāpadaṃ,bhesajjasikkhapadam,5,5,0,0,19
660773,uyyuttappayutte,uyyuttappayutte,1,1,0,0,15
660774,para619-21,para619-21,1,1,0,0,10
660775,pāṭiyekkoti,patiyekkoti,1,0,1,0,11
660776,mālākiteti,malakiteti,1,0,1,0,10
660777,katamāle,katamale,1,1,0,0,8
660778,mālādhare,maladhare,1,1,0,0,9
660779,kusumamālāpaṭimaṇḍiteti,kusumamalapatimanditeti,1,1,0,0,23
660780,tiṇaṇḍupakanti,tinandupakanti,1,0,1,0,14
660781,tiṇacumbaṭakaṃ,tinacumbatakam,2,2,0,0,14
660782,paṭimuñcīti,patimunciti,1,0,1,0,11
660783,suvaṇṇamālāti,suvannamalati,1,0,1,0,13
660784,ṭhapitamattāyeva,thapitamattayeva,1,1,0,0,16
660785,suvaṇṇapadumamālā,suvannapadumamala,1,1,0,0,17
660786,adhimuccīti,adhimucciti,2,0,2,0,11
660787,paccayabāhulikatāya,paccayabahulikataya,1,1,0,0,19
660788,kolambepi,kolambepi,4,3,1,0,9
660789,ghaṭepī,ghatepi,1,0,1,0,7
660790,kolambā,kolamba,1,1,0,0,7
660791,mahāmukhacāṭiyo,mahamukhacatiyo,1,1,0,0,15
660792,olīnavilīnānīti,olinavilinaniti,1,0,1,0,15
660793,okiṇṇavikiṇṇāti,okinnavikinnati,1,0,1,0,15
660794,khanantehi,khanantehi,2,2,0,0,10
660795,sañcarantehi,sancarantehi,1,1,0,0,12
660796,antokoṭṭhāgārikāti,antokotthagarikati,1,0,1,0,18
660797,saṃvihitakoṭṭhāgārā,samvihitakotthagara,1,1,0,0,19
660798,paṭisāyanīyānīti,patisayaniyaniti,2,0,2,0,16
660799,paṭisāyitabbāni,patisayitabbani,2,2,0,0,15
660800,bhesajjānīti,bhesajjaniti,4,0,4,0,12
660801,laddhavohārāni,laddhavoharani,2,2,0,0,14
660802,gosappī,gosappi,3,1,2,0,7
660803,migarohitasasādīnaṃ,migarohitasasadinam,1,1,0,0,19
660804,sappipi,sappipi,3,2,1,0,7
660805,āgatasappiādīsu,agatasappiadisu,1,1,0,0,15
660806,tadahupurebhattaṃ,tadahupurebhattam,14,14,0,0,17
660807,sāmisampi,samisampi,49,47,2,0,9
660808,nirāmisampi,niramisampi,5,5,0,0,11
660809,nirāmisameva,niramisameva,56,51,5,0,12
660810,abbhañjanādīsu,abbhanjanadisu,8,8,0,0,14
660811,sattāhātikkamepi,sattahatikkamepi,28,28,0,0,16
660812,anajjhoharaṇīyataṃ,anajjhoharaniyatam,3,3,0,0,18
660813,paṭisāyanīyānī,patisayaniyani,2,2,0,0,14
660814,paṭiggahitanavanītena,patiggahitanavanitena,5,5,0,0,21
660815,katasappi,katasappi,5,5,0,0,9
660816,uggahitakena,uggahitakena,2,2,0,0,12
660817,vuttasuddhasappinayeneva,vuttasuddhasappinayeneva,2,2,0,0,24
660818,paṭiggahitakhīrena,patiggahitakhirena,3,3,0,0,18
660819,sāmaṃpāko,samampako,10,9,1,0,9
660820,sāmaṃpakkena,samampakkena,3,3,0,0,12
660821,savatthukassa,savatthukassa,6,5,1,0,13
660822,uggahitakehi,uggahitakehi,11,11,0,0,12
660823,akappiyamaṃsasappimhi,akappiyamamsasappimhi,2,2,0,0,21
660824,āgatasappinā,agatasappina,2,2,0,0,12
660825,manussasappi,manussasappi,2,2,0,0,12
660826,navanītañca,navanitanca,4,4,0,0,11
660827,duppaṭikkhittaṃ,duppatikkhittam,2,2,0,0,15
660828,vinicchayopi,vinicchayopi,5,5,0,0,12
660829,nānābhājanesu,nanabhajanesu,5,5,0,0,13
660830,bhājanagaṇanāya,bhajanagananaya,10,10,0,0,15
660831,amissetvā,amissetva,14,13,1,0,9
660832,sappinayeneva,sappinayeneva,2,1,1,0,13
660833,dadhiguḷikāyopi,dadhigulikayopi,3,3,0,0,15
660834,takkabindūnipi,takkabindunipi,3,3,0,0,14
660835,upaḍḍhattherā,upaddhatthera,2,1,1,0,13
660836,anuññātakālato,anunnatakalato,4,4,0,0,14
660837,takkato,takkato,12,11,1,0,7
660838,dadhitakkamakkhikākipillikādīni,dadhitakkamakkhikakipillikadini,2,2,0,0,31
660839,paribhuñjitukāmena,paribhunjitukamena,6,6,0,0,18
660840,dadhigataṃ,dadhigatam,5,3,2,0,10
660841,takkagataṃ,takkagatam,4,3,1,0,10
660842,savatthukapaṭiggahitaṃ,savatthukapatiggahitam,12,9,3,0,22
660843,ṭhapitanavanīte,thapitanavanite,2,2,0,0,15
660844,khīradadhīni,khiradadhini,9,6,3,0,12
660845,katanavanīte,katanavanite,5,5,0,0,12
660846,uggahitehi,uggahitehi,1,1,0,0,10
660847,katanavavīte,katanavavite,1,1,0,0,12
660848,akappiyamaṃsanavanīte,akappiyamamsanavanite,2,2,0,0,21
660849,āpattānāpattiparibhogāparibhoganayo,apattanapattiparibhogaparibhoganayo,3,3,0,0,35
660850,pakkatelampi,pakkatelampi,3,3,0,0,12
660851,apakkatelampi,apakkatelampi,2,2,0,0,13
660852,takkadadhibindūnipi,takkadadhibindunipi,2,2,0,0,19
660853,bhattasitthānipi,bhattasitthanipi,2,2,0,0,16
660854,taṇḍulakaṇāpi,tandulakanapi,2,2,0,0,13
660855,makkhikādayopi,makkhikadayopi,2,2,0,0,14
660856,ādiccapākaṃ,adiccapakam,3,3,0,0,11
660857,ṭhapitabhesajjehi,thapitabhesajjehi,2,2,0,0,17
660858,natthupānampi,natthupanampi,2,2,0,0,13
660859,vaddalisamaye,vaddalisamaye,2,2,0,0,13
660860,patitataṇḍulakaṇādayo,patitatandulakanadayo,5,5,0,0,21
660861,sāmisapākaṃ,samisapakam,2,2,0,0,11
660862,telesu,telesu,2,1,1,0,6
660863,nissaggiyabhāvo,nissaggiyabhavo,2,2,0,0,15
660864,sīsamakkhanādīsu,sisamakkhanadisu,9,9,0,0,16
660865,katatelaṃ,katatelam,19,16,3,0,9
660866,anajjhoharaṇīyaṃ,anajjhoharaniyam,19,19,0,0,16
660867,anajjhoharaṇīyameva,anajjhoharaniyameva,4,4,0,0,19
660868,savatthukapaṭiggahitattā,savatthukapatiggahitatta,11,9,2,0,24
660869,uggahitakatilehi,uggahitakatilehi,2,2,0,0,16
660870,katatelepi,katatelepi,2,2,0,0,10
660871,paṭiggahitakatile,patiggahitakatile,1,1,0,0,17
660872,nibbaṭṭitattā,nibbattitatta,2,2,0,0,13
660873,sāmaṃpakkattā,samampakkatta,4,4,0,0,13
660874,abbhukkiraṇamattaṃ,abbhukkiranamattam,2,2,0,0,18
660875,sāmapākagaṇanaṃ,samapakagananam,1,1,0,0,15
660876,sāsapatelādīsupi,sasapateladisupi,2,2,0,0,16
660877,avatthukapaṭiggahitesu,avatthukapatiggahitesu,2,2,0,0,22
660878,avatthukatilatele,avatthukatilatele,2,2,0,0,17
660879,paṭiggahitānaṃ,patiggahitanam,4,4,0,0,14
660880,sāsapamadhukacuṇṇādīni,sasapamadhukacunnadini,1,1,0,0,22
660881,eraṇḍakaṭṭhīni,erandakatthini,2,2,0,0,14
660882,yāvajīvikattā,yavajivikatta,4,4,0,0,13
660883,savatthukapaṭiggahaṇe,savatthukapatiggahane,3,3,0,0,21
660884,nirāmisaparibhogeneva,niramisaparibhogeneva,2,2,0,0,21
660885,bāhiraparibhoge,bahiraparibhoge,4,4,0,0,15
660886,telakaraṇatthāya,telakaranatthaya,2,2,0,0,16
660887,sāsapamadhukaeraṇḍakaṭṭhīni,sasapamadhukaerandakatthini,2,2,0,0,27
660888,catutthapañcamachaṭṭhasattāmadivase,catutthapancamachatthasattamadivase,1,1,0,0,35
660889,uggamanā,uggamana,7,5,2,0,8
660890,anissaggiyattā,anissaggiyatta,5,5,0,0,14
660891,gahitasāsapādīnaṃ,gahitasasapadinam,2,2,0,0,17
660892,sattāhātikkamane,sattahatikkamane,1,1,0,0,16
660893,nāḷikeranimbakosambakakaramandaatasīādīnaṃ,nalikeranimbakosambakakaramandaatasiadinam,1,1,0,0,42
660894,ayametesu,ayametesu,3,3,0,0,9
660895,yāvakālikavatthuṃ,yavakalikavatthum,2,2,0,0,17
660896,yāvajīvikavatthuñca,yavajivikavatthunca,2,2,0,0,19
660897,sāmaṃpākasavatthukapurebhattapacchābhattapaṭiggahitauggahitakavatthuvidhānaṃ,samampakasavatthukapurebhattapacchabhattapatiggahitauggahitakavatthuvidhanam,1,1,0,0,76
660898,vasātelaṃ,vasatelam,20,17,3,0,9
660899,vasāni,vasani,17,17,0,0,6
660900,acchavasaṃ,acchavasam,25,19,6,0,10
660901,macchavasaṃ,macchavasam,15,15,0,0,11
660902,susukāvasaṃ,susukavasam,15,15,0,0,11
660903,sūkaravasaṃ,sukaravasam,14,14,0,0,11
660904,gadrabhavasaṃ,gadrabhavasam,15,15,0,0,13
660905,anuññātavasānaṃ,anunnatavasanam,3,3,0,0,15
660906,manussavasaṃ,manussavasam,13,9,4,0,12
660907,akappiyamaṃsāna,akappiyamamsana,1,1,0,0,15
660908,susukāpi,susukapi,2,2,0,0,8
660909,vāḷamacchattā,valamacchatta,2,2,0,0,13
660910,macchādiggahaṇena,macchadiggahanena,2,2,0,0,17
660911,kappiyamaṃsānaṃ,kappiyamamsanam,3,3,0,0,15
660912,dasamanaussahatthiassasunakhaahisīhabyagghadīpiacchataracchānaṃ,dasamanaussahatthiassasunakhaahisihabyagghadipiacchataracchanam,1,1,0,0,63
660913,akappiyāni,akappiyani,11,10,1,0,10
660914,vasāsu,vasasu,5,5,0,0,6
660915,manussavasāva,manussavasava,3,3,0,0,13
660916,khīrādīsu,khiradisu,8,8,0,0,9
660917,katanibbaṭṭitavasātelaṃ,katanibbattitavasatelam,2,2,0,0,23
660918,sukhumarajasadisaṃ,sukhumarajasadisam,5,5,0,0,18
660919,nirāmisaparibhogena,niramisaparibhogena,12,11,1,0,19
660920,nirāmisaparibhogañhi,niramisaparibhoganhi,3,3,0,0,20
660921,telaparibhogena,telaparibhogena,17,14,3,0,15
660922,sappinavanītavasāni,sappinavanitavasani,2,2,0,0,19
660923,nibbaṭṭitāni,nibbattitani,2,2,0,0,12
660924,pakkatelakasaṭe,pakkatelakasate,6,3,3,0,15
660925,dadhiguḷikā,dadhigulika,2,2,0,0,11
660926,takkabindu,takkabindu,2,2,0,0,10
660927,saṃsaṭṭhāni,samsatthani,19,19,0,0,11
660928,tejavantāni,tejavantani,2,2,0,0,11
660929,kappiyamaṃsavasā,kappiyamamsavasa,1,1,0,0,16
660930,sāmisaparibhoge,samisaparibhoge,2,2,0,0,15
660931,nirāmisaparibhoge,niramisaparibhoge,2,2,0,0,17
660932,vātābādhikā,vatabadhika,2,2,0,0,11
660933,pañcamūlakasāvayāguyaṃ,pancamulakasavayaguyam,2,2,0,0,22
660934,acchasūkaratelādīni,acchasukarateladini,2,2,0,0,19
660935,makkhikāmadhūti,makkhikamadhuti,1,0,1,0,15
660936,bhamaramakkhikāhi,bhamaramakkhikahi,2,2,0,0,17
660937,sāmisaparibhogampi,samisaparibhogampi,2,2,0,0,18
660938,nirāmisaparibhogameva,niramisaparibhogameva,2,2,0,0,21
660939,silesasadisaṃ,silesasadisam,6,3,3,0,13
660940,arumakkhanādīsu,arumakkhanadisu,2,2,0,0,15
660941,madhumakkhitaṃ,madhumakkhitam,6,6,0,0,14
660942,madhugatikameva,madhugatikameva,3,3,0,0,15
660943,cīrikā,cirika,2,2,0,0,6
660944,dīghamakkhikā,dighamakkhika,2,2,0,0,13
660945,tumbalanāmikā,tumbalanamika,1,1,0,0,13
660946,kāḷamahābhamarā,kalamahabhamara,2,2,0,0,15
660947,niyyāsasadisaṃ,niyyasasadisam,4,4,0,0,14
660948,ucchumhā,ucchumha,20,18,2,0,8
660949,apakkā,apakka,12,9,3,0,6
660950,avatthukapakkā,avatthukapakka,8,5,3,0,14
660951,ucchuvikati,ucchuvikati,8,8,0,0,11
660952,phāṇitanti,phanitanti,6,6,0,0,10
660953,ghanasannivesā,ghanasannivesa,2,2,0,0,14
660954,gharadhūpanādīsu,gharadhupanadisu,2,2,0,0,16
660955,paṭiggahitena,patiggahitena,10,8,2,0,13
660956,aparissāvitaucchurasena,aparissavitaucchurasena,4,4,0,0,23
660957,aparissāvitapaṭiggahitena,aparissavitapatiggahitena,2,2,0,0,25
660958,kataphāṇitepi,kataphanitepi,2,2,0,0,13
660959,parissāvitapaṭiggahitakena,parissavitapatiggahitakena,1,1,0,0,26
660960,parissāvitapaṭiggahitena,parissavitapatiggahitena,3,3,0,0,24
660961,uggahitakakataṃ,uggahitakakatam,1,1,0,0,15
660962,jhāmaucchuphāṇitaṃ,jhamaucchuphanitam,6,3,3,0,18
660963,koṭṭitaucchuphāṇitaṃ,kottitaucchuphanitam,7,4,3,0,20
660964,savatthukapakkaṃ,savatthukapakkam,7,7,0,0,16
660965,ucchuphāṇitaṃ,ucchuphanitam,4,4,0,0,13
660966,novaṭṭanakaṃ,novattanakam,2,2,0,0,12
660967,sītudakena,situdakena,6,4,2,0,10
660968,madhukapupphaphāṇitaṃ,madhukapupphaphanitam,6,6,0,0,21
660969,madhukaphāṇitaṃ,madhukaphanitam,6,4,2,0,15
660970,khaṇḍasakkharaṃ,khandasakkharam,6,4,2,0,15
660971,khīrajallikaṃ,khirajallikam,8,5,3,0,13
660972,bhajjitampi,bhajjitampi,2,2,0,0,11
660973,koṭṭitampi,kottitampi,1,1,0,0,10
660974,merayatthāya,merayatthaya,2,2,0,0,12
660975,kadalīkhajjūrīambalabujapanasaciñcādīnaṃ,kadalikhajjuriambalabujapanasacincadinam,2,2,0,0,40
660976,yāvakālikaphalānaṃ,yavakalikaphalanam,3,3,0,0,18
660977,yāvakālikameva,yavakalikameva,15,14,1,0,14
660978,maricapakkehi,maricapakkehi,4,4,0,0,13
660979,avinibbhogāni,avinibbhogani,1,1,0,0,13
660980,vinibhuttesu,vinibhuttesu,1,1,0,0,12
660981,anatikkāmetvā,anatikkametva,4,4,0,0,13
660982,gilānenapi,gilanenapi,1,1,0,0,10
660983,agilānenapi,agilanenapi,4,4,0,0,11
660984,sattavidhañhi,sattavidhanhi,4,3,1,0,13
660985,odissaṃ,odissam,3,1,2,0,7
660986,byādhiodissaṃ,byadhiodissam,2,1,1,0,13
660987,puggalodissaṃ,puggalodissam,4,2,2,0,13
660988,kālodissaṃ,kalodissam,11,8,3,0,10
660989,samayodissaṃ,samayodissam,4,2,2,0,12
660990,desodissaṃ,desodissam,4,2,2,0,10
660991,vasodissaṃ,vasodissam,5,2,3,0,10
660992,bhesajjodissanti,bhesajjodissanti,2,2,0,0,16
660993,amanussikābādhe,amanussikabadhe,7,7,0,0,15
660994,āmakamaṃsaṃ,amakamamsam,13,13,0,0,11
660995,āmakalohitaṃ,amakalohitam,7,7,0,0,12
660996,ābādhikassa,abadhikassa,1,1,0,0,11
660997,romanthakassa,romanthakassa,5,5,0,0,13
660998,romanthanaṃ,romanthanam,5,5,0,0,11
660999,bahimukhadvāraṃ,bahimukhadvaram,2,2,0,0,15
661000,ajjhoharitabbaṃ,ajjhoharitabbam,15,15,0,0,15
661001,mahāvikaṭāni,mahavikatani,9,7,2,0,12
661002,daṭṭhakālaṃ,datthakalam,1,1,0,0,11
661003,appaṭiggahitakampi,appatiggahitakampi,3,3,0,0,18
661004,anāpattiyo,anapattiyo,4,4,0,0,10
661005,upasampadādīni,upasampadadini,1,1,0,0,14
661006,bhesajjānī,bhesajjani,15,14,1,0,10
661007,vasānāmena,vasanamena,2,2,0,0,10
661008,kappiyākappiyavasānaṃ,kappiyakappiyavasanam,2,2,0,0,21
661009,taṃtadatthikānaṃ,tamtadatthikanam,3,3,0,0,16
661010,bhesajjodissaṃ,bhesajjodissam,6,3,3,0,14
661011,bhesajjanāmena,bhesajjanamena,4,4,0,0,14
661012,sappinavanītatelamadhuphāṇitanti,sappinavanitatelamadhuphanitanti,1,1,0,0,32
661013,sattāhātikkante,sattahatikkante,7,6,1,0,15
661014,atikkantasaññī,atikkantasanni,11,10,1,0,14
661015,sāyanamattaṃ,sayanamattam,2,2,0,0,12
661016,nissajjitabbameva,nissajjitabbameva,2,2,0,0,17
661017,kāsāvakattarayaṭṭhiupāhanapādakathalikamañcapīṭhādīnipi,kasavakattarayatthiupahanapadakathalikamancapithadinipi,1,1,0,0,55
661018,dvāravātapānakavāṭesupi,dvaravatapanakavatesupi,2,2,0,0,23
661019,kasāve,kasave,5,4,1,0,6
661020,dvāravātapānakavāṭāni,dvaravatapanakavatani,2,2,0,0,21
661021,makkhetabbānī,makkhetabbani,5,3,2,0,13
661022,antosattāhaṃ,antosattaham,10,9,1,0,12
661023,adhiṭṭhetīti,adhitthetiti,7,1,6,0,12
661024,muddhanitelaṃ,muddhanitelam,1,1,0,0,13
661025,gharadhūpanaṃ,gharadhupanam,5,4,1,0,13
661026,adhiṭṭhitatelaṃ,adhitthitatelam,2,2,0,0,15
661027,anadhiṭṭhitatelabhājane,anadhitthitatelabhajane,2,2,0,0,23
661028,ākiritukāmo,akiritukamo,2,2,0,0,11
661029,purāṇatelena,puranatelena,2,2,0,0,12
661030,bahutelaṃ,bahutelam,1,1,0,0,9
661031,purāṇatelaṃ,puranatelam,2,2,0,0,11
661032,adhiṭṭhitagatikameva,adhitthitagatikameva,4,4,0,0,20
661033,adhiṭṭhitatelabhājane,adhitthitatelabhajane,2,2,0,0,21
661034,anadhiṭṭhitatelākiraṇampi,anadhitthitatelakiranampi,1,1,0,0,25
661035,cattenātiādīsu,cattenatiadisu,1,0,1,0,14
661036,vantañca,vantanca,1,1,0,0,8
661037,anāpattidassanatthaṃ,anapattidassanattham,20,16,4,0,20
661038,sattāhātikkantassa,sattahatikkantassa,3,3,0,0,18
661039,anāpattidassanatthamidaṃ,anapattidassanatthamidam,2,2,0,0,24
661040,natthukammatthaṃ,natthukammattham,2,2,0,0,16
661041,vassikasāṭikasikkhāpadavaṇṇanā,vassikasatikasikkhapadavannana,22,22,0,0,30
661042,vassikasāṭikasikkhāpadaṃ,vassikasatikasikkhapadam,9,8,1,0,24
661043,visākhāvatthusmiṃ,visakhavatthusmim,3,2,1,0,17
661044,pacchimamāso,pacchimamaso,2,2,0,0,12
661045,sibbanarajanakappapariyosānena,sibbanarajanakappapariyosanena,2,1,1,0,30
661046,gimhāneti,gimhaneti,1,0,1,0,9
661047,gimhānanāmake,gimhananamake,1,1,0,0,13
661048,atirekaddhamāse,atirekaddhamase,15,14,1,0,15
661049,nivāsetīti,nivasetiti,1,0,1,0,10
661050,pariyesanakkhettaṃ,pariyesanakkhettam,10,8,2,0,18
661051,karaṇakkhettaṃ,karanakkhettam,4,4,0,0,14
661052,nivāsanakkhettaṃ,nivasanakkhettam,2,2,0,0,16
661053,adhiṭṭhānakkhettanti,adhitthanakkhettanti,2,2,0,0,20
661054,kucchisamayo,kucchisamayo,6,5,1,0,12
661055,piṭṭhisamayoti,pitthisamayoti,2,2,0,0,14
661056,piṭṭhisamayacatukkaṃ,pitthisamayacatukkam,2,2,0,0,20
661057,kucchisamayacatukkanti,kucchisamayacatukkanti,1,1,0,0,22
661058,jeṭṭhamūlapuṇṇamāsiyā,jetthamulapunnamasiya,8,7,1,0,21
661059,pacchimapāṭipadadivasato,pacchimapatipadadivasato,12,12,0,0,24
661060,kāḷapakkhuposathā,kalapakkhuposatha,1,1,0,0,17
661061,pariyesanakkhettañceva,pariyesanakkhettanceva,3,3,0,0,22
661062,karaṇakkhettañca,karanakkhettanca,3,3,0,0,16
661063,adhiṭṭhātuñca,adhitthatunca,8,8,0,0,13
661064,kāḷapakkhuposathassa,kalapakkhuposathassa,1,1,0,0,20
661065,pariyesanakaraṇanivāsanānaṃ,pariyesanakarananivasananam,3,3,0,0,27
661066,adhiṭṭhātuṃyeva,adhitthatumyeva,4,4,0,0,15
661067,āsāḷhīpuṇṇamāsiyā,asalhipunnamasiya,1,1,0,0,17
661068,pariyesanakaraṇanivāsanādhiṭṭhānānaṃ,pariyesanakarananivasanadhitthananam,2,2,0,0,36
661069,kattikapuṇṇamāsiyā,kattikapunnamasiya,10,10,0,0,18
661070,jeṭṭhamūlapuṇṇamā,jetthamulapunnama,2,2,0,0,17
661071,piṭṭhisamayo,pitthisamayo,4,3,1,0,12
661072,vassikasāṭikāyā,vassikasatikaya,4,3,1,0,15
661073,nipphādentassa,nipphadentassa,18,17,1,0,14
661074,aññātakaviññattisikkhāpadena,annatakavinnattisikkhapadena,16,13,3,0,28
661075,aññātakaappavāritā,annatakaappavarita,2,2,0,0,18
661076,satuppādakaraṇassa,satuppadakaranassa,2,2,0,0,18
661077,viññatiṃ,vinnatim,1,1,0,0,8
661078,vassikasāṭikadāyakesupi,vassikasatikadayakesupi,4,4,0,0,23
661079,pariyesanakāle,pariyesanakale,2,1,1,0,14
661080,aññātakaappavāriteyeva,annatakaappavariteyeva,2,2,0,0,22
661081,kucchisamayacatukkaṃ,kucchisamayacatukkam,1,1,0,0,20
661082,ovassāpeti,ovassapeti,5,4,1,0,10
661083,udakaphusitagaṇanāya,udakaphusitagananaya,2,2,0,0,20
661084,nhānapariyosānavasena,nhanapariyosanavasena,2,2,0,0,21
661085,patitaudakeneva,patitaudakeneva,3,3,0,0,15
661086,nhāyanto,nhayanto,3,3,0,0,8
661087,nhānakoṭṭhakavāpiādīsu,nhanakotthakavapiadisu,2,2,0,0,22
661088,āsittaudakena,asittaudakena,1,1,0,0,13
661089,ukkaḍḍhiyatīti,ukkaddhiyatiti,1,0,1,0,14
661090,katapariyesitāya,katapariyesitaya,1,1,0,0,16
661091,paṭhamamāsaṃ,pathamamasam,3,3,0,0,12
661092,ukkaḍḍhitvā,ukkaddhitva,2,2,0,0,11
661093,pacchimamāsameva,pacchimamasameva,2,2,0,0,16
661094,nikkhipitabbā,nikkhipitabba,11,11,0,0,13
661095,anadhiṭṭhitā,anadhitthita,4,4,0,0,12
661096,avikappitā,avikappita,2,2,0,0,10
661097,appahonakabhāvena,appahonakabhavena,3,3,0,0,17
661098,cātumāsanti,catumasanti,1,1,0,0,11
661099,ekamāsanti,ekamasanti,2,2,0,0,10
661100,dasāhānāgatāya,dasahanagataya,14,14,0,0,14
661101,adhiṭṭhātabbāti,adhitthatabbati,11,6,5,0,15
661102,antodasāhe,antodasahe,25,23,2,0,10
661103,cīvarakālaṃ,civarakalam,24,22,2,0,11
661104,nātikkametabbāti,natikkametabbati,5,3,2,0,16
661105,vassūpanāyikato,vassupanayikato,2,2,0,0,15
661106,dasāhātikkamepi,dasahatikkamepi,5,5,0,0,15
661107,nātikkametabbā,natikkametabba,1,1,0,0,14
661108,cātumāsabbhantare,catumasabbhantare,4,4,0,0,17
661109,atikkāmetabbā,atikkametabba,1,1,0,0,13
661110,nissaggiyāvasāne,nissaggiyavasane,2,2,0,0,16
661111,acchinnacīvarassāti,acchinnacivarassati,7,4,3,0,19
661112,vassikasāṭikameva,vassikasatikameva,4,4,0,0,17
661113,naggānaṃ,nagganam,3,3,0,0,8
661114,kāyovassāpane,kayovassapane,3,3,0,0,13
661115,mahagghavassikasāṭikaṃ,mahagghavassikasatikam,5,5,0,0,22
661116,corupaddavo,corupaddavo,3,3,0,0,11
661117,cīvaraacchindanasikkhāpadavaṇṇanā,civaraacchindanasikkhapadavannana,12,12,0,0,33
661118,cīvaraacchindanasikkhāpadaṃ,civaraacchindanasikkhapadam,5,5,0,0,27
661119,pattacīvaraupāhanapaccattharaṇāni,pattacivaraupahanapaccattharanani,2,2,0,0,33
661120,acchindīti,acchinditi,10,6,4,0,10
661121,acchindato,acchindato,12,11,1,0,10
661122,abaddhāni,abaddhani,3,3,0,0,9
661123,āharāpayato,aharapayato,3,3,0,0,11
661124,vikappanupagapacchimacīvaraṃ,vikappanupagapacchimacivaram,2,2,0,0,28
661125,sūcimpi,sucimpi,3,3,0,0,7
661126,ṭhapitasūcīsupi,thapitasucisupi,2,2,0,0,15
661127,sithilaveṭhitāsu,sithilavethitasu,2,2,0,0,16
661128,baddhāsu,baddhasu,10,8,2,0,8
661129,pakkhittāsupi,pakkhittasupi,2,2,0,0,13
661130,sithilabaddha,sithilabaddha,1,1,0,0,13
661131,gāḷhabaddhesu,galhabaddhesu,1,1,0,0,13
661132,tikaṭukādīsu,tikatukadisu,2,2,0,0,12
661133,bhesajjesupi,bhesajjesupi,2,2,0,0,12
661134,pariyāpuṇissatī,pariyapunissati,3,3,0,0,15
661135,pariyāpuṇāsī,pariyapunasi,3,3,0,0,12
661136,disāpakkantaṃ,disapakkantam,2,2,0,0,13
661137,rundhathāti,rundhathati,2,1,1,0,11
661138,pattacīvaratthāya,pattacivaratthaya,3,3,0,0,17
661139,pariyāpuṇantasseva,pariyapunantasseva,3,3,0,0,18
661140,apariyāpuṇantassa,apariyapunantassa,3,3,0,0,17
661141,avibbhamantasseva,avibbhamantasseva,3,3,0,0,17
661142,suttaviññattisikkhāpadavaṇṇanā,suttavinnattisikkhapadavannana,14,14,0,0,30
661143,suttaviññattisikkhāpadaṃ,suttavinnattisikkhapadam,6,6,0,0,24
661144,khomavākehi,khomavakehi,2,2,0,0,11
661145,katasuttaṃ,katasuttam,7,7,0,0,10
661146,kosiyaṃsūhi,kosiyamsuhi,2,2,0,0,11
661147,eḷakalomasuttaṃ,elakalomasuttam,3,3,0,0,15
661148,sāṇavākasuttaṃ,sanavakasuttam,1,1,0,0,14
661149,vākasuttamevāti,vakasuttamevati,2,2,0,0,15
661150,turivemādīni,turivemadini,1,1,0,0,12
661151,cīvaravāyanatthāya,civaravayanatthaya,1,1,0,0,18
661152,vidatthimatte,vidatthimatte,11,10,1,0,13
661153,hatthamatte,hatthamatte,7,7,0,0,11
661154,vikappanupagapacchimañhi,vikappanupagapacchimanhi,1,1,0,0,24
661155,cīvarasaṅkhyaṃ,civarasankhyam,4,4,0,0,14
661156,ñātakādivasena,natakadivasena,2,2,0,0,14
661157,tantavāyopi,tantavayopi,4,4,0,0,11
661158,aññātakaappavārito,annatakaappavarito,1,1,0,0,18
661159,akappiyasuttaṃ,akappiyasuttam,6,6,0,0,14
661160,akappiyatantavāyena,akappiyatantavayena,16,16,0,0,19
661161,kappiyasuttaṃ,kappiyasuttam,4,4,0,0,13
661162,pacchimacīvarappamāṇena,pacchimacivarappamanena,1,1,0,0,23
661163,suddhakappiyasuttamayo,suddhakappiyasuttamayo,1,1,0,0,22
661164,akappiyasuttamayoti,akappiyasuttamayoti,1,1,0,0,19
661165,kedārabaddhaṃ,kedarabaddham,2,2,0,0,13
661166,akappiyasuttamaye,akappiyasuttamaye,2,2,0,0,17
661167,ūnaparicchedā,unapariccheda,1,1,0,0,13
661168,acchimaṇḍalappamāṇāpi,acchimandalappamanapi,1,1,0,0,21
661169,sabbaparicchedesu,sabbaparicchedesu,2,2,0,0,17
661170,paricchedagaṇanāya,paricchedagananaya,5,5,0,0,18
661171,ekantarikena,ekantarikena,6,6,0,0,12
661172,kappiyatantavāyenapi,kappiyatantavayenapi,2,2,0,0,20
661173,pacchimacīvarappamāṇā,pacchimacivarappamana,2,2,0,0,21
661174,ūnakā,unaka,2,2,0,0,5
661175,akappiyasuttaparicchedā,akappiyasuttapariccheda,2,2,0,0,23
661176,kappiyasuttaparicchedesu,kappiyasuttaparicchedesu,2,2,0,0,24
661177,tantavāyā,tantavaya,6,6,0,0,9
661178,vinanti,vinanti,17,17,0,0,7
661179,ūnatare,unatare,2,2,0,0,7
661180,kedārabaddhādīhi,kedarabaddhadihi,2,2,0,0,16
661181,akappiyasuttamayesu,akappiyasuttamayesu,4,4,0,0,19
661182,pacchimacīvarappamāṇesu,pacchimacivarappamanesu,2,2,0,0,23
661183,vītesu,vitesu,2,2,0,0,6
661184,ūnakataresu,unakataresu,1,1,0,0,11
661185,kappiyasuttamayesu,kappiyasuttamayesu,4,4,0,0,18
661186,kappiyatantavāyena,kappiyatantavayena,4,4,0,0,18
661187,pamāṇayuttesu,pamanayuttesu,6,6,0,0,13
661188,ūnakesu,unakesu,3,3,0,0,7
661189,aparicchede,aparicchede,3,3,0,0,11
661190,dukkaṭānīti,dukkataniti,7,7,0,0,11
661191,ñātakappavārito,natakappavarito,1,1,0,0,15
661192,vāyāpanapaccayā,vayapanapaccaya,2,2,0,0,15
661193,dasāhātikkamanapaccayā,dasahatikkamanapaccaya,2,2,0,0,22
661194,vikappanupagappamāṇamatte,vikappanupagappamanamatte,3,3,0,0,25
661195,dasāhātikkamena,dasahatikkamena,3,3,0,0,15
661196,niṭṭhāpiyamānañhi,nitthapiyamananhi,2,2,0,0,17
661197,niyyātitepi,niyyatitepi,2,2,0,0,11
661198,gatabhikkhu,gatabhikkhu,2,2,0,0,11
661199,vāyāpanamūlaṃ,vayapanamulam,2,2,0,0,13
661200,āyogetiādīsupi,ayogetiadisupi,1,0,1,0,14
661201,āyogādinimittaṃ,ayogadinimittam,1,1,0,0,15
661202,mahāpesakārasikkhāpadavaṇṇanā,mahapesakarasikkhapadavannana,13,13,0,0,29
661203,mahāpesakārasikkhāpadaṃ,mahapesakarasikkhapadam,5,5,0,0,23
661204,dhārayitvāti,dharayitvati,1,0,1,0,12
661205,palaparicchedaṃ,palaparicchedam,1,1,0,0,15
661206,suppavāyitaṃ,suppavayitam,3,0,3,0,12
661207,pavāyitaṃ,pavayitam,3,3,0,0,9
661208,suvilekhitaṃ,suvilekhitam,3,0,3,0,12
661209,lekhaniyā,lekhaniya,5,5,0,0,9
661210,vilikhitaṃ,vilikhitam,2,2,0,0,10
661211,suvitacchitaṃ,suvitacchitam,3,0,3,0,13
661212,vitacchitaṃ,vitacchitam,3,3,0,0,11
661213,suniddhotanti,suniddhotanti,1,1,0,0,13
661214,pasāraṇeyeva,pasaraneyeva,1,1,0,0,12
661215,suttavaḍḍhanaākārameva,suttavaddhanaakarameva,2,1,1,0,22
661216,appavāritoti,appavaritoti,8,1,7,0,12
661217,cīvarasāmikehi,civarasamikehi,5,4,1,0,14
661218,accekacīvarasikkhāpadavaṇṇanā,accekacivarasikkhapadavannana,15,15,0,0,29
661219,para646-9,para646-9,1,1,0,0,9
661220,accekacīvarasikkhāpadaṃ,accekacivarasikkhapadam,5,5,0,0,23
661221,dasāhānāgataṃ,dasahanagatam,16,12,4,0,13
661222,dasāhena,dasahena,12,11,1,0,8
661223,dasāhānāgatā,dasahanagata,4,4,0,0,12
661224,asampattāti,asampattati,4,4,0,0,11
661225,dasāhānāgatāyā,dasahanagataya,3,3,0,0,14
661226,dasāhānāgatāti,dasahanagatati,1,1,0,0,14
661227,anupayogavacanaṃ,anupayogavacanam,1,1,0,0,16
661228,kattikatemāsikapuṇṇamaṃ,kattikatemasikapunnamam,10,6,4,0,23
661229,paṭhamakattikatemāsikapuṇṇamaṃ,pathamakattikatemasikapunnamam,1,1,0,0,30
661230,paṭhamamahāpavāraṇā,pathamamahapavarana,1,1,0,0,19
661231,accekaṃ,accekam,7,5,2,0,7
661232,pavāraṇāmāsassa,pavaranamasassa,6,5,1,0,15
661233,juṇhapakkhapañcamito,junhapakkhapancamito,9,8,1,0,20
661234,nidhānakālo,nidhanakalo,6,6,0,0,11
661235,accāyikacīvaraṃ,accayikacivaram,5,5,0,0,15
661236,accāyikabhāvaṃ,accayikabhavam,1,1,0,0,14
661237,saddhāmattakameva,saddhamattakameva,1,1,0,0,17
661238,balavasaddhā,balavasaddha,2,2,0,0,12
661239,dātukāmena,datukamena,8,8,0,0,10
661240,chaṭṭhito,chatthito,14,12,2,0,9
661241,anaccekacīvarampi,anaccekacivarampi,8,8,0,0,17
661242,ṭhapitacīvarampi,thapitacivarampi,5,5,0,0,16
661243,chinnavassena,chinnavassena,11,10,1,0,13
661244,accekacīvare,accekacivare,5,4,1,0,12
661245,accekacīvarasaññīti,accekacivarasanniti,1,0,1,0,19
661246,cīvarasamayātikkamepi,civarasamayatikkamepi,1,1,0,0,21
661247,atirekacīvarassa,atirekacivarassa,7,6,1,0,16
661248,vassikasāṭikacīvarassa,vassikasatikacivarassa,1,1,0,0,22
661249,anatthate,anatthate,70,69,1,0,9
661250,ukkaḍḍhite,ukkaddhite,1,1,0,0,10
661251,mūlacīvarādhiṭṭhānavasena,mulacivaradhitthanavasena,1,1,0,0,25
661252,accekacīvarassa,accekacivarassa,11,11,0,0,15
661253,ekādasadivasādhiko,ekadasadivasadhiko,10,10,0,0,18
661254,ekādasadivasādhikā,ekadasadivasadhika,9,9,0,0,18
661255,anaccekacīvareti,anaccekacivareti,1,0,1,0,16
661256,accekacīvarasadise,accekacivarasadise,5,3,2,0,18
661257,sāsaṅkasikkhāpadavaṇṇanā,sasankasikkhapadavannana,15,15,0,0,24
661258,sāsaṅkasikkhāpadaṃ,sasankasikkhapadam,6,6,0,0,18
661259,dubbalacīvarattā,dubbalacivaratta,1,1,0,0,16
661260,niṭṭhitacīvarā,nitthitacivara,1,1,0,0,14
661261,nippalibodhā,nippalibodha,1,1,0,0,12
661262,kattikacorakāti,kattikacorakati,1,0,1,0,15
661263,paripātentīti,paripatentiti,2,0,2,0,13
661264,palāpenti,palapenti,4,4,0,0,9
661265,sallekhavā,sallekhava,1,1,0,0,10
661266,cīvaraguttatthaṃ,civaraguttattham,5,4,1,0,16
661267,upavassanti,upavassanti,1,1,0,0,11
661268,upavasitvāti,upavasitvati,2,2,0,0,12
661269,upasampajjantiādīsu,upasampajjantiadisu,5,2,3,0,19
661270,pacchimakattikapuṇṇamapariyosānakālaṃ,pacchimakattikapunnamapariyosanakalam,2,2,0,0,37
661271,sāsaṅkasammatāni,sasankasammatani,9,7,2,0,16
661272,paṭhamakattikapuṇṇamaṃ,pathamakattikapunnamam,3,3,0,0,22
661273,atigahanaṃ,atigahanam,1,1,0,0,10
661274,byañjanavicāraṇaṃ,byanjanavicaranam,2,1,1,0,17
661275,cīvaranikkhepārahaṃ,civaranikkheparaham,1,1,0,0,19
661276,adinnādānavaṇṇanāyaṃ,adinnadanavannanayam,2,1,1,0,20
661277,parikkhepārahaṭṭhānato,parikkheparahatthanato,17,17,0,0,22
661278,bodhivā,bodhiva,1,1,0,0,7
661279,sāsaṅkasammatānīti,sasankasammataniti,2,0,2,0,18
661280,sāsaṅkānī,sasankani,4,3,1,0,9
661281,saññātānīti,sannataniti,2,2,0,0,11
661282,ārāmūpacāre,aramupacare,22,21,1,0,11
661283,paṭibhayena,patibhayena,2,2,0,0,11
661284,sannihitabalavabhayānīti,sannihitabalavabhayaniti,4,3,1,0,24
661285,aṅgasampatti,angasampatti,3,3,0,0,12
661286,chinnavasso,chinnavasso,19,19,0,0,11
661287,kattikamāsoyeva,kattikamasoyeva,2,2,0,0,15
661288,kattikamāsato,kattikamasato,2,2,0,0,13
661289,ūnappamāṇe,unappamane,4,4,0,0,10
661290,gāvutato,gavutato,5,5,0,0,8
661291,atirekappamāṇe,atirekappamane,3,3,0,0,14
661292,idamappamāṇaṃ,idamappamanam,2,2,0,0,13
661293,sāsaṅkasappaṭibhayameva,sasankasappatibhayameva,3,2,1,0,23
661294,anāsaṅkaappaṭibhaye,anasankaappatibhaye,1,1,0,0,19
661295,aṅgayuttepi,angayuttepi,2,2,0,0,11
661296,bhikkhusammutiyāti,bhikkhusammutiyati,15,3,12,0,18
661297,kosambakasammuti,kosambakasammuti,5,2,3,0,16
661298,chārattātirekampi,charattatirekampi,2,2,0,0,17
661299,gāmasīmampi,gamasimampi,5,4,1,0,11
661300,cīvarappavattiṃ,civarappavattim,3,3,0,0,15
661301,pariṇatasikkhāpadavaṇṇanā,parinatasikkhapadavannana,13,13,0,0,25
661302,pariṇatasikkhāpadaṃ,parinatasikkhapadam,6,6,0,0,19
661303,pūgassāti,pugassati,2,0,2,0,9
661304,dhammagaṇassāti,dhammaganassati,1,1,0,0,15
661305,lābhamukhāni,labhamukhani,1,1,0,0,12
661306,oṇojethāti,onojethati,1,0,1,0,10
661307,abhihaṭabhikkhā,abhihatabhikkha,5,5,0,0,15
661308,abhihaṭapaṭiyatte,abhihatapatiyatte,1,1,0,0,17
661309,ṭhapitabhāge,thapitabhage,1,1,0,0,12
661310,anārūḷhopi,anarulhopi,1,1,0,0,10
661311,paṭilabhitabbavatthuṃ,patilabhitabbavatthum,1,1,0,0,21
661312,cīvarampī,civarampi,2,2,0,0,9
661313,pariṇatalābhassa,parinatalabhassa,2,2,0,0,16
661314,pariṇāmanapayoge,parinamanapayoge,2,2,0,0,16
661315,mātusantakampi,matusantakampi,5,5,0,0,14
661316,suddhikapācittiyaṃ,suddhikapacittiyam,5,5,0,0,18
661317,suddhikapācittiyañca,suddhikapacittiyanca,2,2,0,0,20
661318,suddhikena,suddhikena,2,2,0,0,10
661319,pariṇāmanaṃ,parinamanam,23,16,7,0,11
661320,vassikasāṭikasamaye,vassikasatikasamaye,2,2,0,0,19
661321,mātugharepi,matugharepi,2,2,0,0,11
661322,ābhaṭāni,abhatani,1,1,0,0,8
661323,kukkuccāyantaṃ,kukkuccayantam,2,2,0,0,14
661324,aññasaṅghassāti,annasanghassati,1,0,1,0,15
661325,cetiyassapūjaṃ,cetiyassapujam,2,2,0,0,14
661326,aññacetiyassatthāya,annacetiyassatthaya,1,1,0,0,19
661327,ropitamālāvacchato,ropitamalavacchato,3,3,0,0,18
661328,aññacetiyamhi,annacetiyamhi,2,2,0,0,13
661329,sunakhassāpi,sunakhassapi,1,1,0,0,12
661330,nissaggiyavaṇṇanā,nissaggiyavannana,6,6,0,0,17
661331,pācittiyaaṭṭhakathā,pacittiyaatthakatha,1,1,0,0,19
661332,musāvādasikkhāpadavaṇṇanā,musavadasikkhapadavannana,12,12,0,0,25
661333,P4.0735,P4.0735,1,1,0,0,7
661334,musāvādavaggassa,musavadavaggassa,4,4,0,0,16
661335,vādakkhittoti,vadakkhittoti,2,0,2,0,13
661336,parivitakkitena,parivitakkitena,1,1,0,0,15
661337,paravādisantikaṃ,paravadisantikam,1,1,0,0,16
661338,vādamhi,vadamhi,8,5,3,0,7
661339,sandissatītipi,sandissatitipi,1,1,0,0,14
661340,niddosataṃ,niddosatam,6,6,0,0,10
661341,paṭijānanañca,patijanananca,1,1,0,0,13
661342,P4.0736,P4.0736,1,1,0,0,7
661343,paṭicaratī,paticarati,2,2,0,0,10
661344,saṅketato,sanketato,6,5,1,0,9
661345,sampajānamusāvādeti,sampajanamusavadeti,8,1,7,0,19
661346,visaṃvādanapurekkhārassāti,visamvadanapurekkharassati,1,0,1,0,26
661347,micchāvācāpariyāpannavacanasamuṭṭhāpikā,micchavacapariyapannavacanasamutthapika,1,1,0,0,39
661348,samuṭṭhāpitasaddaṃ,samutthapitasaddam,1,1,0,0,18
661349,diṭṭhānugatimāpajjantānaṃ,ditthanugatimapajjantanam,2,2,0,0,25
661350,pathabhūtato,pathabhutato,1,1,0,0,12
661351,vacīsaññitāya,vacisannitaya,1,1,0,0,13
661352,suddhacetanā,suddhacetana,4,3,1,0,12
661353,taṃsamuṭṭhāpitasaddasahitā,tamsamutthapitasaddasahita,1,1,0,0,26
661354,viññattisahitā,vinnattisahita,2,2,0,0,14
661355,sampajānamusāvādasaṅkhātānaṃ,sampajanamusavadasankhatanam,1,1,0,0,28
661356,anariyavohārānaṃ,anariyavoharanam,2,2,0,0,16
661357,cakkhuvasena,cakkhuvasena,2,1,1,0,12
661358,aggahitārammaṇaṃ,aggahitarammanam,2,1,1,0,16
661359,ghānādivasena,ghanadivasena,1,1,0,0,13
661360,aviññātanti,avinnatanti,2,2,0,0,11
661361,oḷārikeneva,olarikeneva,2,1,1,0,11
661362,P4.0737,P4.0737,1,1,0,0,7
661363,sutamutaviññātānīti,sutamutavinnataniti,1,1,0,0,19
661364,sutaṭṭhāne,sutatthane,1,1,0,0,10
661365,mutādīnipi,mutadinipi,1,1,0,0,10
661366,evamādicatutthapārājikapāḷivaṇṇanāyaṃ,evamadicatutthaparajikapalivannanayam,1,1,0,0,37
661367,āpattimatte,apattimatte,1,1,0,0,11
661368,ekalakkhaṇamevāti,ekalakkhanamevati,1,1,0,0,17
661369,vematikotiādīnampi,vematikotiadinampi,1,0,1,0,18
661370,evamādiduṭṭhadosapāḷivaṇṇanāyaṃ,evamadidutthadosapalivannanayam,1,1,0,0,31
661371,pāḷimattameva,palimattameva,1,1,0,0,13
661372,satheravāde,satheravade,1,1,0,0,11
661373,dārusakaṭaṃ,darusakatam,4,3,1,0,11
661374,siṅgālasaddaṃ,singalasaddam,2,2,0,0,13
661375,laggacakkaṃ,laggacakkam,2,2,0,0,11
661376,uddharantānaṃ,uddharantanam,3,3,0,0,13
661377,pūraṇakathā,puranakatha,8,5,3,0,11
661378,ekatelo,ekatelo,3,3,0,0,7
661379,pacchikāya,pacchikaya,2,2,0,0,10
661380,pacchikāhi,pacchikahi,2,2,0,0,10
661381,musāvādova,musavadova,4,4,0,0,10
661382,P4.0738,P4.0738,1,1,0,0,7
661383,omasavādasikkhāpadavaṇṇanā,omasavadasikkhapadavannana,12,12,0,0,26
661384,dutiyasikkhāpade,dutiyasikkhapade,17,16,1,0,16
661385,omasantīti,omasantiti,3,1,2,0,10
661386,padhaṃsenti,padhamsenti,1,1,0,0,11
661387,omasavādagarahaṇatthaṃ,omasavadagarahanattham,1,1,0,0,22
661388,ahetukapaṭisandhikālepi,ahetukapatisandhikalepi,1,1,0,0,23
661389,parakhuṃsanaṃ,parakhumsanam,2,2,0,0,13
661390,amanāpatoyeva,amanapatoyeva,1,1,0,0,13
661391,heṭṭhārukkhe,hettharukkhe,2,1,1,0,12
661392,muggamāsavālukādīhi,muggamasavalukadihi,1,1,0,0,19
661393,patiṭṭhitārappadesaṃ,patitthitarappadesam,4,1,3,0,20
661394,purimasakaṭena,purimasakatena,1,1,0,0,14
661395,pacchimasakaṭaṃ,pacchimasakatam,1,1,0,0,15
661396,sakaṭasatappamāṇaṃ,sakatasatappamanam,1,1,0,0,18
661397,sithilakaraṇaṃ,sithilakaranam,7,4,3,0,14
661398,akkosenapīti,akkosenapiti,1,0,1,0,12
661399,hīnenapi,hinenapi,6,6,0,0,8
661400,khuṃsentī,khumsenti,1,1,0,0,9
661401,iccevamāha,iccevamaha,3,3,0,0,10
661402,venajātīti,venajatiti,1,0,1,0,10
661403,tacchakajāti,tacchakajati,1,1,0,0,12
661404,veṇukārajātītipi,venukarajatitipi,1,1,0,0,16
661405,nesādajātīti,nesadajatiti,2,0,2,0,12
661406,migaluddakādijāti,migaluddakadijati,1,1,0,0,17
661407,rathakārajātīti,rathakarajatiti,1,0,1,0,15
661408,cammakārajāti,cammakarajati,1,1,0,0,13
661409,pukkusajātīti,pukkusajatiti,1,0,1,0,13
661410,pupphachaḍḍakajāti,pupphachaddakajati,1,1,0,0,18
661411,avakaṇṇakādi,avakannakadi,2,1,1,0,12
661412,P4.0739,P4.0739,1,1,0,0,7
661413,kimetenātiti,kimetenatiti,1,1,0,0,12
661414,paribhavakataṃ,paribhavakatam,1,1,0,0,14
661415,koṭṭhakakammaṃ,kotthakakammam,2,1,1,0,14
661416,tacchakakammaṃ,tacchakakammam,4,1,3,0,14
661417,hatthamuddāgaṇanā,hatthamuddaganana,1,1,0,0,17
661418,acchiddakādiavasesagaṇanā,acchiddakadiavasesaganana,1,1,0,0,25
661419,akkharalekhā,akkharalekha,1,1,0,0,12
661420,madhumehābādho,madhumehabadho,1,1,0,0,14
661421,bhakārena,bhakarena,3,2,1,0,9
661422,yakārabhakāre,yakarabhakare,3,2,1,0,13
661423,kāṭaṃ,katam,1,0,1,0,5
661424,koṭacikā,kotacika,1,0,1,0,8
661425,pabhedavasena,pabhedavasena,3,3,0,0,13
661426,khuṃsetukāmo,khumsetukamo,68,67,1,0,12
661427,vambhetukāmo,vambhetukamo,65,64,1,0,12
661428,maṅkukattukāmoti,mankukattukamoti,2,1,1,0,16
661429,padhaṃsitukāmo,padhamsitukamo,1,1,0,0,14
661430,jātivacanena,jativacanena,2,2,0,0,12
661431,hīnajātikaṃ,hinajatikam,1,1,0,0,11
661432,omasitukāmatāya,omasitukamataya,2,2,0,0,15
661433,aticaṇḍālosi,aticandalosi,1,1,0,0,12
661434,atibrāhmaṇosi,atibrahmanosi,1,1,0,0,13
661435,duṭṭhacaṇḍālosi,dutthacandalosi,1,1,0,0,15
661436,duṭṭhabrāhmaṇosī,dutthabrahmanosi,1,1,0,0,16
661437,idhekacceti,idhekacceti,1,0,1,0,11
661438,gaṇṭhibhedakosītiādivacanehi,ganthibhedakositiadivacanehi,1,1,0,0,28
661439,upasampannepi,upasampannepi,3,3,0,0,13
661440,anupampannepi,anupampannepi,1,1,0,0,13
661441,anupasampannepi,anupasampannepi,3,2,1,0,15
661442,davakamyatā,davakamyata,20,16,4,0,11
661443,keḷihasādhippāyatā,kelihasadhippayata,2,2,0,0,18
661444,bhikkhunīādayo,bhikkhuniadayo,2,2,0,0,14
661445,anupasampannaṭṭhāne,anupasampannatthane,14,13,1,0,19
661446,P4.0740,P4.0740,1,1,0,0,7
661447,atthapurekkhārassātiādīsu,atthapurekkharassatiadisu,1,0,1,0,25
661448,dhammapurekkhāro,dhammapurekkharo,5,2,3,0,16
661449,caṇḍālosi,candalosi,9,9,0,0,9
661450,anusāsanīpurekkhāro,anusasanipurekkharo,1,0,1,0,19
661451,dubbhāsitāpatti,dubbhasitapatti,6,4,2,0,15
661452,pesuññasikkhāpadavaṇṇanā,pesunnasikkhapadavannana,11,11,0,0,24
661453,tatiyasikkhāpade,tatiyasikkhapade,7,7,0,0,16
661454,sañjātabhaṇḍanānaṃ,sanjatabhandananam,2,2,0,0,18
661455,sakasakapakkhe,sakasakapakkhe,1,1,0,0,14
661456,āpattigāmiko,apattigamiko,1,1,0,0,12
661457,kāyavācāvītikkamo,kayavacavitikkamo,2,2,0,0,17
661458,vivādoti,vivadoti,13,3,10,0,8
661459,suññakaraṇavācanti,sunnakaranavacanti,1,1,0,0,18
661460,bhikkhupesuññeti,bhikkhupesunneti,4,0,4,0,16
661461,upasaṃhaṭapesuññeti,upasamhatapesunneti,2,2,0,0,19
661462,piyakamyassa,piyakamyassa,5,3,2,0,12
661463,bhedādhippāyassa,bhedadhippayassa,3,2,1,0,16
661464,jātitopītiādi,jatitopitiadi,1,0,1,0,13
661465,bhedādhippāyassāti,bhedadhippayassati,1,0,1,0,18
661466,maññissatī,mannissati,4,4,0,0,10
661467,pāpagarahitāya,papagarahitaya,10,8,2,0,14
661468,P4.0741,P4.0741,1,1,0,0,7
661469,padasodhammasikkhāpadavaṇṇanā,padasodhammasikkhapadavannana,11,11,0,0,29
661470,catutthasikkhāpade,catutthasikkhapade,8,8,0,0,18
661471,appatissavā,appatissava,2,2,0,0,11
661472,anīcavuttinoti,anicavuttinoti,1,1,0,0,14
661473,asabhāgavuttikāti,asabhagavuttikati,3,0,3,0,17
661474,visabhāgajīvikā,visabhagajivika,1,1,0,0,15
661475,appavattavuttinoti,appavattavuttinoti,1,1,0,0,18
661476,koṭṭhāsanāmakaṃ,kotthasanamakam,1,1,0,0,15
661477,anvakkharaṃ,anvakkharam,13,8,5,0,11
661478,gāthāpādo,gathapado,14,13,1,0,9
661479,dutiyapādo,dutiyapado,4,4,0,0,10
661480,ekekamakkharaṃ,ekekamakkharam,4,4,0,0,14
661481,purimabyañjanena,purimabyanjanena,6,4,2,0,16
661482,pacchābyañjanaṃ,pacchabyanjanam,5,4,1,0,15
661483,ekamakkharaṃ,ekamakkharam,3,3,0,0,12
661484,akkharānubyañjanasamūho,akkharanubyanjanasamuho,5,4,1,0,23
661485,anupadanti,anupadanti,4,4,0,0,10
661486,osāpentīti,osapentiti,2,0,2,0,10
661487,padagaṇanāya,padagananaya,5,4,1,0,12
661488,pācittiyā,pacittiya,65,60,5,0,9
661489,osāpenti,osapenti,3,3,0,0,8
661490,vācentassāpi,vacentassapi,3,3,0,0,12
661491,anupadagaṇanāya,anupadagananaya,2,1,1,0,15
661492,P4.0742,P4.0742,1,1,0,0,7
661493,rūkāramattameva,rukaramattameva,1,1,0,0,15
661494,anvakkharagaṇanāya,anvakkharagananaya,2,1,1,0,18
661495,gāthābandhepi,gathabandhepi,3,2,1,0,13
661496,nicchāretīti,niccharetiti,1,0,1,0,12
661497,aniccapadaṃ,aniccapadam,2,2,0,0,11
661498,anubyañjanagaṇanāya,anubyanjanagananaya,3,2,1,0,19
661499,padādīsu,padadisu,4,4,0,0,8
661500,buddhabhāsitoti,buddhabhasitoti,2,1,1,0,15
661501,catuparisapariyāpannehi,catuparisapariyapannehi,1,1,0,0,23
661502,anaṅgaṇasammādiṭṭhianumānasuttacuḷavedallamahāvedallādiko,ananganasammaditthianumanasuttaculavedallamahavedalladiko,1,1,0,0,57
661503,isibhāsitoti,isibhasitoti,1,0,1,0,12
661504,devatābhāsitoti,devatabhasitoti,1,0,1,0,15
661505,devatāsaṃyuttadevaputtasaṃyuttamārasaṃyuttabrahmasaṃyuttasakkasaṃyuttādivasena,devatasamyuttadevaputtasamyuttamarasamyuttabrahmasamyuttasakkasamyuttadivasena,1,1,0,0,78
661506,atthūpasañhitoti,atthupasanhitoti,1,0,1,0,16
661507,aṭṭhakathānissito,atthakathanissito,1,1,0,0,17
661508,dhammūpasañhitoti,dhammupasanhitoti,1,0,1,0,17
661509,pāḷinissito,palinissito,1,1,0,0,11
661510,vivaṭṭūpanissitameva,vivattupanissitameva,1,1,0,0,20
661511,āruḷhadhammaṃyeva,arulhadhammamyeva,2,2,0,0,17
661512,vivaṭṭūpanissitepi,vivattupanissitepi,1,1,0,0,18
661513,nānābhāsāvasena,nanabhasavasena,1,1,0,0,15
661514,gāthāsilokabandhādīhi,gathasilokabandhadihi,1,1,0,0,21
661515,anāruḷhepi,anarulhepi,1,1,0,0,10
661516,nandopanandanti,nandopanandanti,1,1,0,0,15
661517,mahāpaccariyampana,mahapaccariyampana,1,1,0,0,18
661518,meṇḍakamilindapañhesu,mendakamilindapanhesu,2,2,0,0,21
661519,sakapaṭibhāne,sakapatibhane,1,1,0,0,13
661520,vaṇṇapiṭakaaṅgulimālapiṭakaraṭṭhapālagaajataāḷavakagajjitaguḷhamaggaguḷhavessantaraguḷhavinayavedallapiṭakāni,vannapitakaangulimalapitakaratthapalagaajataalavakagajjitagulhamaggagulhavessantaragulhavinayavedallapitakani,1,1,0,0,109
661521,P4.0743,P4.0743,1,1,0,0,7
661522,sīlūpadeso,silupadeso,1,1,0,0,10
661523,maggakathāārammaṇakathābuddhikadaṇḍaka,maggakathaarammanakathabuddhikadandaka,1,1,0,0,38
661524,ñāṇavatthuasubhakathādīni,nanavatthuasubhakathadini,1,1,0,0,25
661525,dhutaṅgapañhe,dhutangapanhe,1,1,0,0,13
661526,mahāpaccariyādīsu,mahapaccariyadisu,14,14,0,0,17
661527,anāruḷhesu,anarulhesu,3,2,1,0,10
661528,rājovādatikkhindriyacatuparivaṭṭanandopanandakulumbasuttesuyeva,rajovadatikkhindriyacatuparivattanandopanandakulumbasuttesuyeva,1,1,0,0,63
661529,āpattivatthu,apattivatthu,2,2,0,0,12
661530,uddisāpentoti,uddisapentoti,2,0,2,0,13
661531,bhaṇatopi,bhanatopi,5,5,0,0,9
661532,acittakāpatti,acittakapatti,4,4,0,0,13
661533,palāyanakaganthaṃ,palayanakagantham,3,2,1,0,17
661534,paguṇagantho,pagunagantho,3,3,0,0,12
661535,P4.0744,P4.0744,1,1,0,0,7
661536,opātentassa,opatentassa,1,1,0,0,11
661537,osārentaṃ,osarentam,2,1,1,0,9
661538,uccārentaṃ,uccarentam,1,1,0,0,10
661539,parisaṅkamānaṃ,parisankamanam,2,1,1,0,14
661540,kiriyasamuṭṭhānattā,kiriyasamutthanatta,2,2,0,0,19
661541,padasodhammasamuṭṭhānaṃ,padasodhammasamutthanam,15,15,0,0,23
661542,padasodhammasikkhāpadaṃ,padasodhammasikkhapadam,7,7,0,0,23
661543,sahaseyyasikkhāpadavaṇṇanā,sahaseyyasikkhapadavannana,5,5,0,0,26
661544,pañcamasikkhāpade,pancamasikkhapade,5,5,0,0,17
661545,akaraṇavasenetaṃ,akaranavasenetam,1,1,0,0,16
661546,bhavaṅgotiṇṇakāle,bhavangotinnakale,1,1,0,0,17
661547,vikūjamānāti,vikujamanati,2,0,2,0,12
661548,vippalapamānā,vippalapamana,1,1,0,0,13
661549,niratthakasaddaṃ,niratthakasaddam,1,1,0,0,16
661550,uṭṭhitaupāsakā,utthitaupasaka,1,1,0,0,14
661551,sikkhāpadagāraveneva,sikkhapadagaraveneva,1,1,0,0,20
661552,cūḷamañcakaṃ,culamancakam,1,1,0,0,12
661553,ussīsakaraṇatthāya,ussisakaranatthaya,1,1,0,0,18
661554,muṭṭhisammuñjaniñca,mutthisammunjaninca,1,1,0,0,19
661555,P4.0745,P4.0745,1,1,0,0,7
661556,dhammasenāpatimahāmoggallānaānandattherādīnaṃ,dhammasenapatimahamoggallanaanandattheradinam,1,1,0,0,45
661557,vaḷañjanakavaccakuṭiyaṃ,valanjanakavaccakutiyam,1,1,0,0,23
661558,kavāṭabaddhā,kavatabaddha,2,2,0,0,12
661559,samosaritapupphadāmā,samosaritapupphadama,1,1,0,0,20
661560,cetiyaṭṭhānamiva,cetiyatthanamiva,1,1,0,0,16
661561,aparibhogā,aparibhoga,3,2,1,0,10
661562,nānuggahetunti,nanuggahetunti,1,1,0,0,14
661563,kāyappasāraṇasaṅkhātaṃ,kayappasaranasankhatam,7,6,1,0,22
661564,sayanampi,sayanampi,4,4,0,0,9
661565,sabbacchannā,sabbacchanna,11,10,1,0,12
661566,kāyappasāraṇaṃ,kayappasaranam,1,1,0,0,14
661567,senāsanasaṅkhātaṃ,senasanasankhatam,5,5,0,0,17
661568,vidaheyya,vidaheyya,4,4,0,0,9
661569,sampādeyyā,sampadeyya,3,2,1,0,10
661570,sabbacchannātiādinā,sabbacchannatiadina,1,0,1,0,19
661571,senāsanasaṅkhātāya,senasanasankhataya,2,2,0,0,18
661572,pākaṭavohāraṃ,pakatavoharam,3,2,1,0,13
661573,vācuggatavasena,vacuggatavasena,5,5,0,0,15
661574,dussakuṭiyaṃ,dussakutiyam,5,3,2,0,12
661575,paṭicchādanasamatthaṃ,paticchadanasamattham,3,3,0,0,21
661576,paricchannañca,paricchannanca,3,3,0,0,14
661577,pañcavidhacchadaneyeva,pancavidhacchadaneyeva,3,3,0,0,22
661578,padaracchannepi,padaracchannepi,2,2,0,0,15
661579,sahaseyyā,sahaseyya,15,14,1,0,9
661580,vatthenāpi,vatthenapi,3,3,0,0,10
661581,sabbaparicchannā,sabbaparicchanna,7,7,0,0,16
661582,anāhacca,anahacca,15,15,0,0,8
661583,diyaḍḍhahatthubbedhena,diyaddhahatthubbedhena,10,10,0,0,22
661584,pākārādinā,pakaradina,15,15,0,0,10
661585,parikkhittāpi,parikkhittapi,3,3,0,0,13
661586,sabbaparicchannāyevāti,sabbaparicchannayevati,2,2,0,0,22
661587,P4.0746,P4.0746,1,1,0,0,7
661588,satagabbhaṃ,satagabbham,8,8,0,0,11
661589,ekaseyyāicceva,ekaseyyaicceva,1,1,0,0,14
661590,nipajjanamatteneva,nipajjanamatteneva,2,2,0,0,18
661591,sāmaṇeragaṇanāya,samaneragananaya,2,2,0,0,16
661592,nipajjane,nipajjane,8,8,0,0,9
661593,bhikkhusseva,bhikkhusseva,13,12,1,0,12
661594,nipajjanenapi,nipajjanenapi,2,2,0,0,13
661595,sambahulabhāvepi,sambahulabhavepi,2,2,0,0,16
661596,ekāvāsādikampi,ekavasadikampi,3,3,0,0,14
661597,catutthadivasato,catutthadivasato,16,16,0,0,16
661598,devasikā,devasika,4,4,0,0,8
661599,nānāanupasampannehi,nanaanupasampannehi,4,4,0,0,19
661600,nānāāvāsesu,nanaavasesu,4,4,0,0,11
661601,tiracchānagatenapi,tiracchanagatenapi,10,10,0,0,18
661602,methunadhammāpattiyā,methunadhammapattiya,3,3,0,0,20
661603,godhābiḷālamaṅgusādīsu,godhabilalamangusadisu,2,2,0,0,22
661604,vasanasenāsane,vasanasenasane,2,2,0,0,14
661605,ekūpacāraṭṭhāne,ekupacaratthane,3,3,0,0,15
661606,sahaseyyāva,sahaseyyava,2,2,0,0,11
661607,katapāsādassa,katapasadassa,7,7,0,0,13
661608,uparimatalena,uparimatalena,15,10,5,0,13
661609,asambaddhabhittikassa,asambaddhabhittikassa,3,3,0,0,21
661610,ṭhitasusiratulāsīsassa,thitasusiratulasisassa,1,1,0,0,22
661611,susirena,susirena,11,11,0,0,8
661612,P4.0747,P4.0747,1,1,0,0,7
661613,sayitabhikkhussa,sayitabhikkhussa,3,2,1,0,16
661614,antochadane,antochadane,4,4,0,0,11
661615,nānūpacāre,nanupacare,4,4,0,0,10
661616,chadanabbhantare,chadanabbhantare,5,3,2,0,16
661617,antopāsādeneva,antopasadeneva,2,2,0,0,14
661618,sabbatalāni,sabbatalani,2,2,0,0,11
661619,ekūpacārāni,ekupacarani,2,2,0,0,11
661620,sabhāsaṅkhepena,sabhasankhepena,2,2,0,0,15
661621,aḍḍhakuṭṭakasenāsane,addhakuttakasenasane,1,1,0,0,20
661622,vāḷasaṅghāṭādīsu,valasanghatadisu,1,1,0,0,16
661623,nibbakosabbhantare,nibbakosabbhantare,4,4,0,0,18
661624,ekacchadanāya,ekacchadanaya,2,2,0,0,13
661625,gabbhamālāya,gabbhamalaya,2,2,0,0,12
661626,sādhāraṇadvārena,sadharanadvarena,2,2,0,0,16
661627,aparicchinnagabbhūpacāre,aparicchinnagabbhupacare,4,4,0,0,24
661628,sabbagabbhe,sabbagabbhe,4,3,1,0,11
661629,ekagabbhepi,ekagabbhepi,6,5,1,0,11
661630,sapamukhā,sapamukha,2,2,0,0,9
661631,gabbhacchadaneneva,gabbhacchadaneneva,2,2,0,0,18
661632,sambaddhacchadanaṃ,sambaddhacchadanam,1,1,0,0,18
661633,sabbacchannattā,sabbacchannatta,5,5,0,0,15
661634,sabbaparicchannattā,sabbaparicchannatta,3,3,0,0,19
661635,gabbhaparikkhepoyeva,gabbhaparikkhepoyeva,4,2,2,0,20
661636,parikkhepoti,parikkhepoti,2,1,1,0,12
661637,lohapāsādaparikkhepassa,lohapasadaparikkhepassa,1,1,0,0,23
661638,dasahatthubbedhāpi,dasahatthubbedhapi,3,2,1,0,18
661639,parikkhepasaṅkhyaṃ,parikkhepasankhyam,3,2,1,0,18
661640,ekūpacāraṃ,ekupacaram,34,28,6,0,10
661641,ekasāladvisālatisālacatussālasannivesā,ekasaladvisalatisalacatussalasannivesa,1,1,0,0,38
661642,mahāpāsādā,mahapasada,3,3,0,0,10
661643,P4.0748,P4.0748,1,1,0,0,7
661644,ekūpacāraṭṭhāneyeva,ekupacaratthaneyeva,2,2,0,0,19
661645,sudhāchadanamaṇḍapassa,sudhachadanamandapassa,2,2,0,0,22
661646,godhādīnaṃ,godhadinam,2,2,0,0,10
661647,pavisanamattampi,pavisanamattampi,1,1,0,0,16
661648,pākāramajjhe,pakaramajjhe,2,2,0,0,12
661649,ekūpacāratāya,ekupacarataya,2,2,0,0,13
661650,kavāṭena,kavatena,9,9,0,0,8
661651,dvārapidahanena,dvarapidahanena,2,2,0,0,15
661652,nānūpacāraṃ,nanupacaram,15,11,4,0,11
661653,advāraṃ,advaram,5,4,1,0,7
661654,kavāṭañhi,kavatanhi,4,4,0,0,9
661655,saṃvaraṇavivaraṇehi,samvaranavivaranehi,2,2,0,0,19
661656,vaḷañjanūpacchedanatthāya,valanjanupacchedanatthaya,1,1,0,0,25
661657,nānūpacārabhāveyeva,nanupacarabhaveyeva,2,2,0,0,19
661658,dīghapamukhaṃ,dighapamukham,2,2,0,0,13
661659,kavāṭānaṃ,kavatanam,3,3,0,0,9
661660,antocetiyaghare,antocetiyaghare,2,2,0,0,15
661661,ekūpacārattā,ekupacaratta,3,3,0,0,12
661662,ekūpacāranānūpacāratā,ekupacarananupacarata,7,7,0,0,21
661663,sabbaparicchannova,sabbaparicchannova,1,1,0,0,18
661664,sayiteneva,sayiteneva,1,1,0,0,10
661665,apihitadvāre,apihitadvare,2,2,0,0,12
661666,sabbaparicchannatā,sabbaparicchannata,2,2,0,0,18
661667,paricchanno,paricchanno,1,1,0,0,11
661668,ekūpacāranānūpacārataṃyeva,ekupacarananupacaratamyeva,1,1,0,0,26
661669,paccāgamissati,paccagamissati,3,3,0,0,14
661670,sabbacchannāti,sabbacchannati,1,1,0,0,14
661671,padaracchannādīsu,padaracchannadisu,1,1,0,0,17
661672,P4.0749,P4.0749,1,1,0,0,7
661673,kuṭṭena,kuttena,7,7,0,0,7
661674,paṭicchannameva,paticchannameva,2,2,0,0,15
661675,asambaddhaṃ,asambaddham,8,7,1,0,11
661676,anekabhūmakaṃ,anekabhumakam,1,1,0,0,13
661677,paricchanne,paricchanne,11,10,1,0,11
661678,upaḍḍhacchanne,upaddhacchanne,18,17,1,0,14
661679,upaḍḍhaparicchanne,upaddhaparicchanne,17,16,1,0,18
661680,upaḍḍhaparicchanneti,upaddhaparicchanneti,1,1,0,0,20
661681,yebhuyyenaparicchanne,yebhuyyenaparicchanne,12,12,0,0,21
661682,yebhuyyenachanne,yebhuyyenachanne,7,7,0,0,16
661683,sabbaparichanne,sabbaparichanne,1,1,0,0,15
661684,vuttapācittiyena,vuttapacittiyena,4,4,0,0,16
661685,cūḷakaparicchanne,culakaparicchanne,16,16,0,0,17
661686,cūḷakacchanne,culakacchanne,15,15,0,0,13
661687,dukkaṭānī,dukkatani,4,3,1,0,9
661688,sabbaaparicchanneti,sabbaaparicchanneti,1,1,0,0,19
661689,senambamaṇḍapavaṇṇaṃ,senambamandapavannam,3,1,2,0,20
661690,P4.0750,P4.0750,1,1,0,0,7
661691,parikkhepasaṅkhaya,parikkhepasankhaya,1,1,0,0,18
661692,sahaseyyasikkhāpadaṃ,sahaseyyasikkhapadam,6,6,0,0,20
661693,dutiyasahaseyyasikkhāpadavaṇṇanā,dutiyasahaseyyasikkhapadavannana,11,11,0,0,32
661694,dutiyasahaseyyasikkhāpade,dutiyasahaseyyasikkhapade,1,1,0,0,25
661695,vasanāgāraṃ,vasanagaram,2,2,0,0,11
661696,gandhagandhinīti,gandhagandhiniti,1,0,1,0,16
661697,agarukuṅkumādīnaṃ,agarukunkumadinam,1,1,0,0,17
661698,gandhagandho,gandhagandho,5,3,2,0,12
661699,gandhagandhinī,gandhagandhini,2,2,0,0,14
661700,okkhipitvāti,okkhipitvati,1,0,1,0,12
661701,paṭhamadivasepi,pathamadivasepi,2,2,0,0,15
661702,yakkhīpetīhi,yakkhipetihi,1,1,0,0,12
661703,dissamānakarūpāhi,dissamanakarupahi,2,2,0,0,17
661704,methunadhammavatthubhūtāya,methunadhammavatthubhutaya,2,2,0,0,26
661705,paṭhamasadisānevāti,pathamasadisanevati,1,1,0,0,19
661706,dutiyasahaseyyasikkhāpadaṃ,dutiyasahaseyyasikkhapadam,6,6,0,0,26
661707,dhammadesanāsikkhāpadavaṇṇanā,dhammadesanasikkhapadavannana,11,11,0,0,29
661708,sattamasikkhāpade,sattamasikkhapade,5,5,0,0,17
661709,gharasuṇhāti,gharasunhati,1,0,1,0,12
661710,āvasathadvāreti,avasathadvareti,1,0,1,0,15
661711,ovarakadvāre,ovarakadvare,2,2,0,0,12
661712,vissaṭṭhenāti,vissatthenati,1,0,1,0,13
661713,suniggatena,suniggatena,1,1,0,0,11
661714,saraṇasīlādibhedo,saranasiladibhedo,1,1,0,0,17
661715,purisaviggahenāti,purisaviggahenati,4,0,4,0,17
661716,purisaviggahaṃ,purisaviggaham,12,10,2,0,14
661717,purisaviggahena,purisaviggahena,10,9,1,0,15
661718,chappañcavācāhīti,chappancavacahiti,3,0,3,0,17
661719,P4.0751,P4.0751,1,1,0,0,7
661720,ekavācāti,ekavacati,2,2,0,0,9
661721,vācāpamāṇaṃ,vacapamanam,2,2,0,0,11
661722,jātakādivatthuṃ,jatakadivatthum,4,3,1,0,15
661723,chappañcapadamattameva,chappancapadamattameva,1,1,0,0,22
661724,aṭṭhakathātoti,atthakathatoti,4,4,0,0,14
661725,padasodhamme,padasodhamme,17,16,1,0,12
661726,mātugāmassāti,matugamassati,4,1,3,0,13
661727,āgatāgatāya,agatagataya,2,2,0,0,11
661728,aññissāpi,annissapi,2,2,0,0,9
661729,mātugāmasatasahassannampi,matugamasatasahassannampi,2,2,0,0,25
661730,mahāpaccariyaṭṭhakathāyaṃ,mahapaccariyatthakathayam,2,1,1,0,25
661731,dhammadesanāsikkhāpadaṃ,dhammadesanasikkhapadam,6,6,0,0,23
661732,bhūtārocanasikkhāpadavaṇṇanā,bhutarocanasikkhapadavannana,11,11,0,0,28
661733,aṭṭhamasikkhāpade,atthamasikkhapade,7,7,0,0,17
661734,vatthukathāya,vatthukathaya,1,1,0,0,13
661735,catutthapārājikavaṇṇanāyaṃ,catutthaparajikavannanayam,4,4,0,0,26
661736,ārocayamāne,arocayamane,1,1,0,0,11
661737,P4.0752,P4.0752,1,1,0,0,7
661738,paṭisedhesuṃ,patisedhesum,1,1,0,0,12
661739,tathāuppanne,tathauppanne,1,1,0,0,12
661740,tathāuppannabhāvaṃ,tathauppannabhavam,1,1,0,0,18
661741,ārocesunti,arocesunti,4,4,0,0,10
661742,ariyamissakattā,ariyamissakatta,1,1,0,0,15
661743,suddhacittatāya,suddhacittataya,5,5,0,0,15
661744,paṭijānantehi,patijanantehi,1,1,0,0,13
661745,sādiyantehipi,sadiyantehipi,1,1,0,0,13
661746,sabbasaṅgāhikeneva,sabbasangahikeneva,1,1,0,0,18
661747,bhāsissathā,bhasissatha,1,1,0,0,11
661748,catutthapārājikavatthusadisameva,catutthaparajikavatthusadisameva,1,1,0,0,32
661749,atikaḍḍhiyamānena,atikaddhiyamanena,3,3,0,0,17
661750,sutapariyattisīlaguṇaṃ,sutapariyattisilagunam,4,2,2,0,22
661751,anupasampannassāpi,anupasampannassapi,3,3,0,0,18
661752,ummattakassā,ummattakassa,1,1,0,0,12
661753,cittakkhepassa,cittakkhepassa,5,3,2,0,14
661754,bhūtārocanapaccayā,bhutarocanapaccaya,4,3,1,0,18
661755,bhūtasseva,bhutasseva,1,1,0,0,10
661756,bhūtārocanaṃ,bhutarocanam,9,9,0,0,12
661757,P4.0753,P4.0753,1,1,0,0,7
661758,kusalābyākatacittehi,kusalabyakatacittehi,4,2,2,0,20
661759,dvicittaṃ,dvicittam,9,5,4,0,9
661760,bhūtārocanasikkhāpadaṃ,bhutarocanasikkhapadam,6,6,0,0,22
661761,duṭṭhullārocanasikkhāpadavaṇṇanā,dutthullarocanasikkhapadavannana,12,12,0,0,32
661762,navamasikkhāpade,navamasikkhapade,7,7,0,0,16
661763,saṅghādisesāti,sanghadisesati,5,0,5,0,14
661764,duṭṭhullasaddatthadassanatthaṃ,dutthullasaddatthadassanattham,5,4,1,0,30
661765,upasampannasadde,upasampannasadde,1,1,0,0,16
661766,pārājikasaṅghādisesānaṃ,parajikasanghadisesanam,6,6,0,0,23
661767,duṭṭhullasadde,dutthullasadde,2,2,0,0,14
661768,akkosantopi,akkosantopi,6,5,1,0,11
661769,asuddhadiṭṭhi,asuddhaditthi,14,14,0,0,13
661770,vicāriyamānāya,vicariyamanaya,1,1,0,0,14
661771,aṭṭhakathācariyāva,atthakathacariyava,3,1,2,0,18
661772,āvocumha,avocumha,1,1,0,0,8
661773,bhikkhusammutiyā,bhikkhusammutiya,47,43,4,0,16
661774,avaṇṇamattappakāsanatthāya,avannamattappakasanatthaya,1,1,0,0,26
661775,patiṭṭhānisedhanatthāya,patitthanisedhanatthaya,1,1,0,0,23
661776,P4.0754,P4.0754,1,1,0,0,7
661777,anāpajjanena,anapajjanena,7,7,0,0,12
661778,bhikkhusammuti,bhikkhusammuti,10,8,2,0,14
661779,āpattipariyantātiādīsu,apattipariyantatiadisu,1,0,1,0,22
661780,vuttattāyeva,vuttattayeva,2,2,0,0,12
661781,abhiṇhāpattikaṃ,abhinhapattikam,2,2,0,0,15
661782,hirottappenāpi,hirottappenapi,3,3,0,0,14
661783,āpattikkhandhe,apattikkhandhe,41,41,0,0,14
661784,aduṭṭhullo,adutthullo,3,3,0,0,10
661785,sukkavissaṭṭhikāyasaṃsaggaduṭṭhullaattakāmā,sukkavissatthikayasamsaggadutthullaattakama,3,3,0,0,43
661786,attakāmaṃ,attakamam,14,13,1,0,9
661787,ārocentasseva,arocentasseva,3,3,0,0,13
661788,duṭṭhullārocanasikkhāpadaṃ,dutthullarocanasikkhapadam,6,6,0,0,26
661789,pathavīkhaṇanasikkhāpadavaṇṇanā,pathavikhananasikkhapadavannana,12,12,0,0,31
661790,dasamasikkhāpade,dasamasikkhapade,6,6,0,0,16
661791,jātapathaviñca,jatapathavinca,2,2,0,0,14
661792,ajātapathaviñca,ajatapathavinca,2,2,0,0,15
661793,appapāsāṇā,appapasana,6,4,2,0,10
661794,appapāsāṇāti,appapasanati,1,1,0,0,12
661795,P4.0755,P4.0755,1,1,0,0,7
661796,muṭṭhippamāṇato,mutthippamanato,4,4,0,0,15
661797,pāsāṇāti,pasanati,3,2,1,0,8
661798,kathalāti,kathalati,5,2,3,0,9
661799,kapālakhaṇḍāni,kapalakhandani,5,5,0,0,14
661800,marumbāti,marumbati,3,2,1,0,9
661801,kaṭasakkharā,katasakkhara,6,5,1,0,12
661802,vālukāyeva,valukayeva,2,2,0,0,10
661803,paṃsukāti,pamsukati,1,0,1,0,9
661804,adaḍḍhāpīti,adaddhapiti,3,1,2,0,11
661805,uddhanapattapacanakumbhakārāvāpādivasena,uddhanapattapacanakumbhakaravapadivasena,2,2,0,0,40
661806,adaḍḍhā,adaddha,11,11,0,0,7
661807,suddhapaṃsuādīsu,suddhapamsuadisu,3,3,0,0,16
661808,aññatarāva,annatarava,3,3,0,0,10
661809,yebhuyyenasakkharāti,yebhuyyenasakkharati,3,1,2,0,20
661810,hatthikucchiyaṃ,hatthikucchiyam,3,2,1,0,15
661811,ekapacchipūraṃ,ekapacchipuram,2,2,0,0,14
661812,sakkharabhāvaṃ,sakkharabhavam,1,1,0,0,14
661813,appapaṃsu,appapamsu,2,1,1,0,9
661814,yebhuyyenapāsāṇādipañcakameva,yebhuyyenapasanadipancakameva,2,2,0,0,29
661815,pabhedadassanametaṃ,pabhedadassanametam,2,2,0,0,19
661816,āṇāpetabbo,anapetabbo,17,17,0,0,10
661817,khaṇāpentassa,khanapentassa,5,4,1,0,13
661818,khatāyeva,khatayeva,3,3,0,0,9
661819,sodhentehi,sodhentehi,7,7,0,0,10
661820,kuṭehi,kutehi,4,4,0,0,6
661821,tanukakaddamo,tanukakaddamo,2,2,0,0,13
661822,sukkhakaddamo,sukkhakaddamo,4,4,0,0,13
661823,asambaddho,asambaddho,7,7,0,0,10
661824,udakapappaṭako,udakapappatako,8,8,0,0,14
661825,P4.0756,P4.0756,1,1,0,0,7
661826,udakasāmantā,udakasamanta,2,2,0,0,12
661827,omakacātumāsaṃ,omakacatumasam,10,8,2,0,14
661828,ovaṭṭhaṃ,ovattham,21,16,5,0,8
661829,atirekacātumāsaṃ,atirekacatumasam,13,13,0,0,16
661830,ovaṭṭhepi,ovatthepi,3,3,0,0,9
661831,cātumāsaccayena,catumasaccayena,10,10,0,0,15
661832,akappiyapathavīsaṅkhyaṃ,akappiyapathavisankhyam,2,2,0,0,23
661833,pariyādiṇṇe,pariyadinne,1,1,0,0,11
661834,ovaṭṭhoyeva,ovatthoyeva,3,3,0,0,11
661835,āruḷhaupacikāmattikāyapi,arulhaupacikamattikayapi,1,1,0,0,24
661836,gaṇḍuppādagūthamūsikukkaragokaṇṭakādīsupi,ganduppadaguthamusikukkaragokantakadisupi,2,2,0,0,41
661837,khuracchinnakaddamo,khuracchinnakaddamo,3,3,0,0,19
661838,heṭṭhimatalena,hetthimatalena,5,5,0,0,14
661839,bhūmisambandho,bhumisambandho,3,3,0,0,14
661840,kasitaṭṭhānepi,kasitatthanepi,1,1,0,0,14
661841,naṅgalacchinnamattikāpiṇḍaṃ,nangalacchinnamattikapindam,5,4,1,0,27
661842,purāṇasenāsanaṃ,puranasenasanam,3,3,0,0,15
661843,acchadanaṃ,acchadanam,6,4,2,0,10
661844,jātapathavīsaṅkhyameva,jatapathavisankhyameva,2,2,0,0,22
661845,chadaniṭṭhakaṃ,chadanitthakam,2,2,0,0,14
661846,gopānasīādikaṃ,gopanasiadikam,2,2,0,0,14
661847,gopanasiṃ,gopanasim,1,1,0,0,9
661848,bhittipādaṃ,bhittipadam,7,5,2,0,11
661849,padarattharaṇaṃ,padarattharanam,2,2,0,0,15
661850,mattikāpuñjo,mattikapunjo,17,17,0,0,12
661851,P4.0757,P4.0757,1,1,0,0,7
661852,jātapathavīyeva,jatapathaviyeva,2,2,0,0,15
661853,uparibhāgoyeva,uparibhagoyeva,2,2,0,0,14
661854,atinto,atinto,4,4,0,0,6
661855,kappiyakārakehi,kappiyakarakehi,12,12,0,0,15
661856,ekābaddhāyeva,ekabaddhayeva,2,2,0,0,13
661857,mattikāpākāro,mattikapakaro,2,2,0,0,13
661858,jātapathavīsaṅkhyaṃ,jatapathavisankhyam,2,2,0,0,19
661859,laggapaṃsuṃ,laggapamsum,2,2,0,0,11
661860,allahatthena,allahatthena,9,9,0,0,12
661861,iṭṭhakapākāro,itthakapakaro,4,4,0,0,13
661862,yebhuyyenakathalaṭṭhāne,yebhuyyenakathalatthane,1,1,0,0,23
661863,ṭhitamaṇḍapatthambhaṃ,thitamandapatthambham,2,2,0,0,21
661864,vikopentena,vikopentena,3,3,0,0,11
661865,sukkharukkhaṃ,sukkharukkham,3,3,0,0,13
661866,sukkhakhāṇukaṃ,sukkhakhanukam,2,2,0,0,14
661867,suddhacittā,suddhacitta,3,3,0,0,11
661868,bhinditukāmāyeva,bhinditukamayeva,2,2,0,0,16
661869,sākhādīni,sakhadini,7,7,0,0,9
661870,kaḍḍhantānampi,kaddhantanampi,2,2,0,0,14
661871,phālentānampi,phalentanampi,4,4,0,0,13
661872,aṭṭhisūcikaṇṭakādīsupi,atthisucikantakadisupi,2,2,0,0,22
661873,ākoṭetuṃ,akotetum,5,4,1,0,8
661874,passāvadhārāya,passavadharaya,5,5,0,0,14
661875,visamabhūmiṃ,visamabhumim,2,2,0,0,12
661876,ghaṃsitumpi,ghamsitumpi,3,3,0,0,11
661877,vattasīseneva,vattasiseneva,3,3,0,0,13
661878,vilikhanti,vilikhanti,4,4,0,0,10
661879,vīriyasampaggahatthaṃ,viriyasampaggahattham,2,2,0,0,21
661880,P4.0758,P4.0758,1,1,0,0,7
661881,aghaṃsantena,aghamsantena,2,2,0,0,12
661882,allahatthaṃ,allahattham,4,4,0,0,11
661883,kaṇḍukacchuādīhi,kandukacchuadihi,2,2,0,0,16
661884,chinnataṭādīsu,chinnatatadisu,2,2,0,0,14
661885,khaṇāpeti,khanapeti,6,5,1,0,9
661886,pādaṅguṭṭhakenapi,padangutthakenapi,4,4,0,0,17
661887,sammajjanīsalākāyapi,sammajjanisalakayapi,1,1,0,0,20
661888,pacantenapi,pacantenapi,2,2,0,0,11
661889,pakkaṭṭhāneyeva,pakkatthaneyeva,3,3,0,0,15
661890,adaḍḍhāya,adaddhaya,4,3,1,0,9
661891,pattapacanakapālassa,pattapacanakapalassa,3,3,0,0,20
661892,iṭṭhakakapālādīsupi,itthakakapaladisupi,3,3,0,0,19
661893,iṭṭhakādīnaṃyeva,itthakadinamyeva,3,3,0,0,16
661894,anupādānattā,anupadanatta,6,6,0,0,12
661895,upādānasaṅkhyaṃ,upadanasankhyam,2,2,0,0,15
661896,sukkhakhāṇusukkharukkhādīsupi,sukkhakhanusukkharukkhadisupi,2,2,0,0,29
661897,daḍḍhapathaviyā,daddhapathaviya,2,2,0,0,15
661898,usumāya,usumaya,6,6,0,0,7
661899,jālehī,jalehi,2,2,0,0,6
661900,ḍayhatī,dayhati,5,3,2,0,7
661901,dahissāmī,dahissami,2,2,0,0,9
661902,apātitattā,apatitatta,2,2,0,0,10
661903,jānātiādīsu,janatiadisu,2,0,2,0,11
661904,mahāmattikaṃ,mahamattikam,7,5,2,0,12
661905,thusamattikaṃ,thusamattikam,5,5,0,0,13
661906,P4.0759,P4.0759,1,1,0,0,7
661907,pāsāṇarukkhādīni,pasanarukkhadini,4,4,0,0,16
661908,pavaṭṭentassa,pavattentassa,4,4,0,0,13
661909,vilikhantassa,vilikhantassa,6,6,0,0,13
661910,akappiyapathavī,akappiyapathavi,3,2,1,0,15
661911,kappiyapathavī,kappiyapathavi,2,1,1,0,14
661912,khaṇāmi,khanami,2,2,0,0,7
661913,dahāmī,dahami,1,1,0,0,6
661914,khaṇittādīni,khanittadini,1,1,0,0,12
661915,ḍayhamānahattho,dayhamanahattho,3,3,0,0,15
661916,pathavīkhaṇanasikkhāpadaṃ,pathavikhananasikkhapadam,6,6,0,0,25
661917,vaṇṇanākkamena,vannanakkamena,18,18,0,0,14
661918,bhūtagāmasikkhāpadavaṇṇanā,bhutagamasikkhapadavannana,13,13,0,0,26
661919,senāsanavaggassa,senasanavaggassa,2,2,0,0,16
661920,cakkhuvisayātīte,cakkhuvisayatite,1,1,0,0,16
661921,rukkhaṭṭhakadibbavimāne,rukkhatthakadibbavimane,2,1,1,0,23
661922,thanamūleyeva,thanamuleyeva,2,1,1,0,13
661923,aṭṭhitā,atthita,8,7,1,0,7
661924,aṭṭhānapaccayaṃ,atthanapaccayam,1,1,0,0,15
661925,P4.0760,P4.0760,1,1,0,0,7
661926,sutapubbadhammadesanānusārena,sutapubbadhammadesananusarena,1,1,0,0,29
661927,chaddantādikāle,chaddantadikale,1,1,0,0,15
661928,sapitiko,sapitiko,2,1,1,0,8
661929,paṭisañcikkhantiyā,patisancikkhantiya,2,2,0,0,18
661930,pasaveyyāsīti,pasaveyyasiti,1,0,1,0,13
661931,janeyyāsi,janeyyasi,1,1,0,0,9
661932,uppādeyyāsi,uppadeyyasi,1,1,0,0,11
661933,laddhaparihārā,laddhaparihara,1,1,0,0,14
661934,mahesakkhadevatāsu,mahesakkhadevatasu,1,1,0,0,18
661935,P4.0761,P4.0761,1,1,0,0,7
661936,mahāsamuddacakkavāḷapabbatā,mahasamuddacakkavalapabbata,1,1,0,0,27
661937,bhūtagāmapātabyatāyāti,bhutagamapatabyatayati,2,0,2,0,22
661938,ahuvuñcāti,ahuvuncati,4,3,1,0,10
661939,patiṭṭhitaharitatiṇarukkhādīnametaṃ,patitthitaharitatinarukkhadinametam,5,5,0,0,35
661940,pātabyassa,patabyassa,2,2,0,0,10
661941,chedanabhedanādīhi,chedanabhedanadihi,5,5,0,0,18
661942,paribhuñjitabbatāti,paribhunjitabbatati,5,5,0,0,19
661943,bhūtagāmapātabyatāhetu,bhutagamapatabyatahetu,2,2,0,0,22
661944,chedanādipaccayā,chedanadipaccaya,4,3,1,0,16
661945,bījajātānītiādimāha,bijajatanitiadimaha,1,0,1,0,19
661946,mūlabījādīni,mulabijadini,3,3,0,0,12
661947,jāyamānāni,jayamanani,3,3,0,0,10
661948,bījākatāni,bijakatani,1,1,0,0,10
661949,vibhāgaparicchedo,vibhagaparicchedo,2,2,0,0,17
661950,rukkhādīnametaṃ,rukkhadinametam,1,1,0,0,15
661951,vijātāni,vijatani,1,1,0,0,8
661952,pasūtāni,pasutani,1,1,0,0,8
661953,nibbattapaṇṇamūlānīti,nibbattapannamulaniti,2,2,0,0,21
661954,allavālikādīsu,allavalikadisu,1,1,0,0,14
661955,nibbattapaṇṇamūlānaṃ,nibbattapannamulanam,1,1,0,0,20
661956,siṅgiverādīnaṃ,singiveradinam,1,1,0,0,14
661957,P4.0762,P4.0762,1,1,0,0,7
661958,āluvakaserukamaluppalapuṇḍarīkakuvalayakandapāṭalimūlādibhede,aluvakaserukamaluppalapundarikakuvalayakandapatalimuladibhede,1,1,0,0,61
661959,gacchavallirukkhādīni,gacchavallirukkhadini,5,5,0,0,21
661960,haliddādi,haliddadi,4,4,0,0,9
661961,khandhabījādīsu,khandhabijadisu,2,2,0,0,15
661962,yevāpanakakhandhabījesu,yevapanakakhandhabijesu,2,2,0,0,23
661963,ambāṭakaindasālanuhīpāḷibhaddakaṇikārādīni,ambatakaindasalanuhipalibhaddakanikaradini,1,1,0,0,42
661964,khandhabījāni,khandhabijani,2,2,0,0,13
661965,amūlavalli,amulavalli,1,1,0,0,10
661966,caturassavallikaṇavīrādīni,caturassavallikanaviradini,1,1,0,0,26
661967,phaḷubījāni,phalubijani,2,2,0,0,11
661968,makacisumanajayasumanādīni,makacisumanajayasumanadini,1,1,0,0,26
661969,aggabījāni,aggabijani,2,2,0,0,10
661970,ambajambūpanasaṭṭhiādīni,ambajambupanasatthiadini,1,1,0,0,24
661971,bījabījānīti,bijabijaniti,2,2,0,0,12
661972,āpattānāpattibhedaṃ,apattanapattibhedam,1,1,0,0,19
661973,pātabyatābhedañca,patabyatabhedanca,1,1,0,0,17
661974,bījasaññītiādimāha,bijasannitiadimaha,1,0,1,0,18
661975,sālitaṇḍulānaṃ,salitandulanam,2,2,0,0,14
661976,bhūtagāmaparimocanaṃ,bhutagamaparimocanam,4,3,1,0,20
661977,bījasaññī,bijasanni,8,8,0,0,9
661978,satthakādīni,satthakadini,1,1,0,0,12
661979,bhūtagāmavinimuttassa,bhutagamavinimuttassa,1,1,0,0,21
661980,chindanādibhedāya,chindanadibhedaya,1,1,0,0,17
661981,pātabyatāya,patabyataya,2,2,0,0,11
661982,vikopentassa,vikopentassa,27,26,1,0,12
661983,bhūtagāmaparimocitaṃ,bhutagamaparimocitam,4,3,1,0,20
661984,bījagāmaṃ,bijagamam,9,9,0,0,9
661985,udakaṭṭho,udakattho,6,5,1,0,9
661986,P4.0763,P4.0763,1,1,0,0,7
661987,sāsapamattikā,sasapamattika,6,6,0,0,13
661988,tilabījakādibhedā,tilabijakadibheda,1,1,0,0,17
661989,sapaṇṇikā,sapannika,2,2,0,0,9
661990,apaṇṇikā,apannika,2,2,0,0,8
661991,sevālajāti,sevalajati,3,3,0,0,10
661992,udakapappaṭakaṃ,udakapappatakam,3,2,1,0,15
661993,pharusavaṇṇo,pharusavanno,2,2,0,0,12
661994,orūhitvā,oruhitva,1,1,0,0,8
661995,saṅkāmentassa,sankamentassa,2,2,0,0,13
661996,vikopentasseva,vikopentasseva,2,2,0,0,14
661997,saṅkāmito,sankamito,3,3,0,0,9
661998,parissāvanantarena,parissavanantarena,1,1,0,0,18
661999,kārāpetvāva,karapetvava,3,3,0,0,11
662000,uppalinīpaduminīādīni,uppalinipaduminiadini,1,1,0,0,21
662001,jalajavallitiṇāni,jalajavallitinani,2,2,0,0,17
662002,tilabījakasāsapamattakasevālopi,tilabijakasasapamattakasevalopi,1,1,0,0,31
662003,aggabījasaṅgahaṃ,aggabijasangaham,6,6,0,0,16
662004,anantakatilabījakaudakapappaṭakādīni,anantakatilabijakaudakapappatakadini,2,2,0,0,36
662005,dukkaṭavatthukānī,dukkatavatthukani,1,1,0,0,17
662006,sampuṇṇabhūtagāmo,sampunnabhutagamo,2,2,0,0,17
662007,bhūtagāme,bhutagame,8,7,1,0,9
662008,asampuṇṇabhūtagāmo,asampunnabhutagamo,6,3,3,0,18
662009,bījagāmasaṅgahaṃ,bijagamasangaham,3,3,0,0,16
662010,abhūtagāmamūlattā,abhutagamamulatta,6,5,1,0,17
662011,bījagāmassāti,bijagamassati,3,2,1,0,13
662012,vinayalakkhaṇaṃ,vinayalakkhanam,6,6,0,0,15
662013,chinnarukkhānaṃ,chinnarukkhanam,3,3,0,0,15
662014,haritakhāṇu,haritakhanu,2,2,0,0,11
662015,kakudhakarañjapiyaṅgupanasādīnaṃ,kakudhakaranjapiyangupanasadinam,2,2,0,0,32
662016,P4.0764,P4.0764,1,1,0,0,7
662017,bhūtagāmena,bhutagamena,13,9,4,0,11
662018,tālanāḷikerādīnaṃ,talanalikeradinam,10,10,0,0,17
662019,bījagāmena,bijagamena,24,21,3,0,10
662020,aphalitāya,aphalitaya,3,3,0,0,10
662021,nīlapaṇṇā,nilapanna,5,5,0,0,9
662022,bhūtagāmeneva,bhutagameneva,5,5,0,0,13
662023,katarabījagāmena,katarabijagamena,3,3,0,0,16
662024,phaḷubījagāmena,phalubijagamena,3,3,0,0,15
662025,indasālādirukkhe,indasaladirukkhe,2,2,0,0,16
662026,rāsikatadaṇḍakehi,rasikatadandakehi,3,3,0,0,17
662027,ratanappamāṇāpi,ratanappamanapi,4,4,0,0,15
662028,bījagāmeneva,bijagameneva,2,2,0,0,12
662029,maṇḍapatthāya,mandapatthaya,2,2,0,0,13
662030,vatiatthāya,vatiatthaya,3,3,0,0,11
662031,valliāropanatthāya,valliaropanatthaya,2,2,0,0,18
662032,niggatesu,niggatesu,6,6,0,0,9
662033,bhūtagāmasaṅkhyaṃ,bhutagamasankhyam,2,2,0,0,17
662034,mūlamattesu,mulamattesu,4,4,0,0,11
662035,paṇṇamattesu,pannamattesu,3,3,0,0,12
662036,kapālādīsu,kapaladisu,2,2,0,0,10
662037,allapaṃsuṃ,allapamsum,2,2,0,0,10
662038,mūlamatte,mulamatte,2,2,0,0,9
662039,paṇṇamatte,pannamatte,2,2,0,0,10
662040,niggatepi,niggatepi,5,5,0,0,9
662041,bījāniyeva,bijaniyeva,5,5,0,0,10
662042,nīlapaṇṇavaṇṇe,nilapannavanne,3,2,1,0,14
662043,bhūtagāmasaṅgahaṃ,bhutagamasangaham,3,3,0,0,17
662044,tālaṭṭhīnaṃ,talatthinam,3,3,0,0,11
662045,sūkaradāṭhā,sukaradatha,2,2,0,0,11
662046,pattavaṭṭi,pattavatti,6,5,1,0,10
662047,bījagāmoyeva,bijagamoyeva,3,3,0,0,12
662048,migasiṅgasadisā,migasingasadisa,2,2,0,0,15
662049,nīlapattavaṭṭi,nilapattavatti,2,2,0,0,14
662050,aniggatepi,aniggatepi,3,3,0,0,10
662051,amūlakabhūtagāme,amulakabhutagame,8,4,4,0,16
662052,ambaṭṭhiādīni,ambatthiadini,2,2,0,0,13
662053,vīhiādīhi,vihiadihi,2,2,0,0,9
662054,vinicchinitabbāni,vinicchinitabbani,2,2,0,0,17
662055,rukkhova,rukkhova,4,4,0,0,8
662056,aṅguliveṭhako,angulivethako,2,2,0,0,13
662057,vanappagumbadaṇḍake,vanappagumbadandake,2,2,0,0,19
662058,gehamukhapākāravedikācetiyādīsu,gehamukhapakaravedikacetiyadisu,1,1,0,0,31
662059,P4.0765,P4.0765,1,1,0,0,7
662060,sudhālepampi,sudhalepampi,2,2,0,0,12
662061,littassa,littassa,2,2,0,0,8
662062,uparisnehalepo,uparisnehalepo,1,1,0,0,14
662063,sukkhasevālo,sukkhasevalo,2,2,0,0,12
662064,sammuñjanīādīhi,sammunjaniadihi,2,2,0,0,15
662065,pānīyaghaṭādīnaṃ,paniyaghatadinam,8,8,0,0,16
662066,abbohāriko,abbohariko,3,3,0,0,10
662067,dantakaṭṭhapūvādīsu,dantakatthapuvadisu,2,2,0,0,19
662068,kaṇṇakampi,kannakampi,4,2,2,0,10
662069,gerukaparikammakatā,gerukaparikammakata,14,14,0,0,19
662070,kaṇṇakitā,kannakita,25,24,1,0,9
662071,pamajjitabbā,pamajjitabba,33,33,0,0,12
662072,pāsāṇajātipāsāṇadaddusevālaseleyyakādīni,pasanajatipasanadaddusevalaseleyyakadini,1,1,0,0,40
662073,aharitavaṇṇāni,aharitavannani,2,2,0,0,14
662074,apattakāni,apattakani,2,2,0,0,10
662075,dukkaṭavatthukāni,dukkatavatthukani,3,3,0,0,17
662076,ahicchattakaṃ,ahicchattakam,8,6,2,0,13
662077,pupphitakālato,pupphitakalato,4,2,2,0,14
662078,allarukkhato,allarukkhato,8,6,2,0,12
662079,rukkhapappaṭikāyapi,rukkhapappatikayapi,1,1,0,0,19
662080,indasālakakudhādīnaṃ,indasalakakudhadinam,2,2,0,0,20
662081,pappaṭikā,pappatika,1,1,0,0,9
662082,niyyāsampi,niyyasampi,4,4,0,0,10
662083,sukkharukkhe,sukkharukkhe,4,4,0,0,12
662084,lākhāyapi,lakhayapi,2,2,0,0,9
662085,pariṇatakaṇikārādipupphaṃ,parinatakanikaradipuppham,2,2,0,0,25
662086,hatthakukkuccena,hatthakukkuccena,2,2,0,0,16
662087,mudukesu,mudukesu,2,2,0,0,8
662088,indasālanuhīkhandhādīsu,indasalanuhikhandhadisu,2,2,0,0,23
662089,tatthajātakatālapaṇṇādīsu,tatthajatakatalapannadisu,2,2,0,0,25
662090,chindantassāpi,chindantassapi,3,3,0,0,14
662091,ocinantānaṃ,ocinantanam,2,2,0,0,11
662092,pānīyavāsatthikena,paniyavasatthikena,3,3,0,0,18
662093,ocināpetabbāni,ocinapetabbani,2,2,0,0,14
662094,phalasākhāpi,phalasakhapi,2,2,0,0,12
662095,uppāṭentehi,uppatentehi,2,2,0,0,11
662096,anākaḍḍhantena,anakaddhantena,2,2,0,0,14
662097,kaḍḍhanākāraṃ,kaddhanakaram,2,2,0,0,13
662098,makkhikābījanādīnaṃ,makkhikabijanadinam,1,1,0,0,19
662099,P4.0766,P4.0766,1,1,0,0,7
662100,nakhenapi,nakhenapi,4,4,0,0,9
662101,allasiṅgiverādīsupi,allasingiveradisupi,2,2,0,0,19
662102,nīlaṅkure,nilankure,1,1,0,0,9
662103,sammuñjanosalākāyapi,sammunjanosalakayapi,1,1,0,0,20
662104,chijjanakaṃ,chijjanakam,3,2,1,0,11
662105,bhijjanakaṃ,bhijjanakam,4,4,0,0,11
662106,tiṇavalliādīni,tinavalliadini,2,2,0,0,14
662107,gaṇṭhipi,ganthipi,2,2,0,0,8
662108,anāruhanatthāya,anaruhanatthaya,1,1,0,0,15
662109,dārumakkaṭakaṃ,darumakkatakam,4,3,1,0,14
662110,dārumakkaṭako,darumakkatako,3,2,1,0,13
662111,allīnamattova,allinamattova,2,2,0,0,13
662112,uppāṭehī,uppatehi,5,5,0,0,8
662113,aniyāmitattā,aniyamitatta,2,2,0,0,12
662114,caturassavalliṃ,caturassavallim,1,1,0,0,15
662115,asukarukkhacchalliṃ,asukarukkhacchallim,2,2,0,0,19
662116,itiādivacanampi,itiadivacanampi,7,7,0,0,15
662117,aniyāmitameva,aniyamitameva,1,1,0,0,13
662118,itiādivacanameva,itiadivacanameva,10,10,0,0,16
662119,pacitukāmo,pacitukamo,5,5,0,0,10
662120,pacāpetīti,pacapetiti,1,1,0,0,10
662121,pathavīkhaṇanasikkhāpade,pathavikhananasikkhapade,1,1,0,0,24
662122,mūlabhesajjaṃ,mulabhesajjam,4,3,1,0,13
662123,P4.0767,P4.0767,1,1,0,0,7
662124,bījagāmaparimocanatthaṃ,bijagamaparimocanattham,7,6,1,0,23
662125,kappiyakaraṇañcettha,kappiyakaranancettha,2,2,0,0,20
662126,aggiparijitaṃ,aggiparijitam,12,9,3,0,13
662127,satthaparijitaṃ,satthaparijitam,9,8,1,0,15
662128,nakhaparijitaṃ,nakhaparijitam,7,7,0,0,14
662129,nibbaṭṭabījameva,nibbattabijameva,1,1,0,0,16
662130,parijitaṃ,parijitam,4,4,0,0,9
662131,phuṭṭhanti,phutthanti,2,2,0,0,10
662132,nakhaparijite,nakhaparijite,2,2,0,0,13
662133,abījanibbaṭṭabījāni,abijanibbattabijani,2,2,0,0,19
662134,kaṭṭhaggigomayaggiādīsu,katthaggigomayaggiadisu,3,3,0,0,23
662135,lohakhaṇḍenapi,lohakhandenapi,3,3,0,0,14
662136,phusantena,phusantena,4,4,0,0,10
662137,lohamayasatthassa,lohamayasatthassa,2,2,0,0,17
662138,sūcinakhacchedanānampi,sucinakhacchedananampi,2,2,0,0,22
662139,pūtinakhena,putinakhena,2,2,0,0,11
662140,sīhabyagghadīpimakkaṭādīnaṃ,sihabyagghadipimakkatadinam,1,1,0,0,27
662141,sakuntānañca,sakuntananca,4,4,0,0,12
662142,assamahiṃsasūkaramigagorūpādīnaṃ,assamahimsasukaramigagorupadinam,2,2,0,0,32
662143,hatthinakhā,hatthinakha,3,3,0,0,11
662144,tatthajātakehipi,tatthajatakehipi,2,2,0,0,16
662145,gahitakehipi,gahitakehipi,1,1,0,0,12
662146,rukkhasahassaṃ,rukkhasahassam,8,8,0,0,14
662147,mahābhāro,mahabharo,3,3,0,0,9
662148,P4.0768,P4.0768,1,1,0,0,7
662149,ucchukhaṇḍānaṃ,ucchukhandanam,4,3,1,0,14
662150,maricapakkādīhi,maricapakkadihi,3,2,1,0,15
662151,bhattasitthe,bhattasitthe,6,3,3,0,12
662152,tilataṇḍulādīsupi,tilatanduladisupi,2,2,0,0,17
662153,kapitthaphalādīnaṃ,kapitthaphaladinam,3,3,0,0,18
662154,kaṭāhepi,katahepi,5,3,2,0,8
662155,acchinnattā,acchinnatta,2,2,0,0,11
662156,etthabbhantare,etthabbhantare,1,1,0,0,14
662157,bījagāmoti,bijagamoti,5,5,0,0,10
662158,chindāmītipi,chindamitipi,1,1,0,0,12
662159,manussaviggahapārājikavaṇṇanāyaṃ,manussaviggahaparajikavannanayam,3,2,1,0,32
662160,P4.0769,P4.0769,1,1,0,0,7
662161,kusalacittenāpi,kusalacittenapi,1,1,0,0,15
662162,aññavādakasikkhāpadavaṇṇanā,annavadakasikkhapadavannana,11,11,0,0,27
662163,ācaritvāti,acaritvati,1,0,1,0,10
662164,āpajjitvāti,apajjitvati,8,5,3,0,11
662165,paṭicaraṇavidhiṃ,paticaranavidhim,1,1,0,0,16
662166,pāḷimuttakopi,palimuttakopi,5,5,0,0,13
662167,paṭicaraṇavidhi,paticaranavidhi,1,1,0,0,15
662168,kissevamasāruppaṃ,kissevamasaruppam,2,2,0,0,17
662169,tipumaṇḍalaṃ,tipumandalam,1,1,0,0,12
662170,kissevaṃ,kissevam,1,1,0,0,8
662171,P4.0770,P4.0770,1,1,0,0,7
662172,sotamupanento,sotamupanento,1,1,0,0,13
662173,aññavādakaṃ,annavadakam,16,11,5,0,11
662174,ropetūti,ropetuti,2,0,2,0,8
662175,patiṭṭhāpetūti,patitthapetuti,2,2,0,0,14
662176,vihesakaṃ,vihesakam,9,6,3,0,9
662177,paṭicaraṇassetaṃ,paticaranassetam,6,4,2,0,16
662178,tuṇhībhūtassetaṃ,tunhibhutassetam,5,3,2,0,16
662179,vatthudvaye,vatthudvaye,5,5,0,0,11
662180,pācittiyadvayaṃ,pacittiyadvayam,21,15,6,0,15
662181,aññavādaketi,annavadaketi,2,0,2,0,12
662182,anāropite,anaropite,19,17,2,0,9
662183,vihesaketi,vihesaketi,2,1,1,0,10
662184,dhammakammasaññītiādīsu,dhammakammasannitiadisu,2,0,2,0,23
662185,aññavādakavihesakaropanakammaṃ,annavadakavihesakaropanakammam,2,2,0,0,30
662186,dhammakammasaññī,dhammakammasanni,49,49,0,0,16
662187,aññavādakañca,annavadakanca,2,2,0,0,13
662188,vihesakañca,vihesakanca,2,2,0,0,11
662189,paṭicarantassa,paticarantassa,3,3,0,0,14
662190,vihesantassa,vihesantassa,3,3,0,0,12
662191,aññavādakasikkhāpadaṃ,annavadakasikkhapadam,6,6,0,0,21
662192,ujjhāpanakasikkhāpadavaṇṇanā,ujjhapanakasikkhapadavannana,11,11,0,0,28
662193,ujjhāpentīti,ujjhapentiti,2,0,2,0,12
662194,chandāya,chandaya,14,14,0,0,8
662195,avajānāpenti,avajanapenti,3,3,0,0,12
662196,olokāpenti,olokapenti,3,3,0,0,10
662197,cintāpentī,cintapenti,3,1,2,0,10
662198,ojjhāpentītipi,ojjhapentitipi,1,1,0,0,14
662199,P4.0771,P4.0771,1,1,0,0,7
662200,chandāyāti,chandayati,5,1,4,0,10
662201,sandiṭṭhasambhattānaṃ,sanditthasambhattanam,2,2,0,0,21
662202,ujjhāpenti,ujjhapenti,6,6,0,0,10
662203,ujjhāpanakaṃ,ujjhapanakam,9,4,5,0,12
662204,khiyyanakaṃ,khiyyanakam,6,4,2,0,11
662205,senāsanapaññāpakaṃ,senasanapannapakam,6,5,1,0,18
662206,appamattakavissajjanakaṃ,appamattakavissajjanakam,1,0,1,0,24
662207,maṅkukattukāmo,mankukattukamo,73,72,1,0,14
662208,upasampannassā,upasampannassa,3,2,1,0,14
662209,ujjhāpeti,ujjhapeti,23,19,4,0,9
662210,vuttavibhaṅgoyeva,vuttavibhangoyeva,1,1,0,0,17
662211,aññavādakasikkhāpade,annavadakasikkhapade,1,1,0,0,20
662212,nigamanameva,nigamanameva,1,1,0,0,12
662213,ujjhāpanakañca,ujjhapanakanca,1,1,0,0,14
662214,khiyyanakañca,khiyyanakanca,1,1,0,0,13
662215,asammataṃ,asammatam,52,43,9,0,9
662216,āropitabhāraṃ,aropitabharam,1,1,0,0,13
662217,anupasampannabhāve,anupasampannabhave,4,4,0,0,18
662218,P4.0772,P4.0772,1,1,0,0,7
662219,ujjhāpanakasikkhāpadaṃ,ujjhapanakasikkhapadam,6,6,0,0,22
662220,paṭhamasenāsanasikkhāpadavaṇṇanā,pathamasenasanasikkhapadavannana,15,15,0,0,32
662221,otāpentāti,otapentati,1,0,1,0,10
662222,bālātapena,balatapena,2,2,0,0,10
662223,otāpentā,otapenta,3,3,0,0,8
662224,ārociteti,arociteti,2,1,1,0,9
662225,himavassena,himavassena,3,3,0,0,11
662226,avassikasaṅketeti,avassikasanketeti,3,0,3,0,17
662227,vassikavassānamāsāti,vassikavassanamasati,2,2,0,0,20
662228,sākhāmaṇḍape,sakhamandape,3,3,0,0,12
662229,padaramaṇḍape,padaramandape,3,3,0,0,13
662230,ūhadantīti,uhadantiti,3,1,2,0,10
662231,dhuvanivāsena,dhuvanivasena,6,6,0,0,13
662232,kākakulalā,kakakulala,2,2,0,0,10
662233,sakuntā,sakunta,6,6,0,0,7
662234,ūhadanti,uhadanti,4,4,0,0,8
662235,gocarappasutā,gocarappasuta,2,2,0,0,13
662236,avassikasaṅkete,avassikasankete,7,7,0,0,15
662237,abbhokāsikenāpi,abbhokasikenapi,2,2,0,0,15
662238,puggalikamañcako,puggalikamancako,2,2,0,0,16
662239,P4.0773,P4.0773,1,1,0,0,7
662240,vītamañcako,vitamancako,3,3,0,0,11
662241,purāṇamañcako,puranamancako,4,4,0,0,13
662242,onaddhako,onaddhako,5,3,2,0,9
662243,ukkaṭṭharukkhamūliko,ukkattharukkhamuliko,2,2,0,0,20
662244,ukkaṭṭhaabbhokāsiko,ukkatthaabbhokasiko,4,3,1,0,19
662245,cīvarakuṭimpi,civarakutimpi,3,3,0,0,13
662246,asamaye,asamaye,20,19,1,0,7
662247,catugguṇenapi,catuggunenapi,3,3,0,0,13
662248,katakuṭi,katakuti,2,2,0,0,8
662249,atementaṃ,atementam,3,3,0,0,9
662250,sattāhavaddalikādīni,sattahavaddalikadini,3,3,0,0,20
662251,kāyānugatikattā,kayanugatikatta,3,3,0,0,15
662252,anovassake,anovassake,15,15,0,0,10
662253,bhojanasālaṅgaṇaṃ,bhojanasalanganam,2,2,0,0,17
662254,uposathāgāraṅgaṇaṃ,uposathagaranganam,2,2,0,0,18
662255,pariveṇadivāṭṭhānaaggisālādīsu,parivenadivatthanaaggisaladisu,2,2,0,0,30
662256,sammajjanīmāḷakeyeva,sammajjanimalakeyeva,1,1,0,0,20
662257,uposathāgārādīsu,uposathagaradisu,8,8,0,0,16
662258,sammajjantassāpi,sammajjantassapi,1,1,0,0,16
662259,valāhakānaṃ,valahakanam,5,2,3,0,11
662260,anuṭṭhitabhāvaṃ,anutthitabhavam,5,2,3,0,15
662261,paccāgacchantena,paccagacchantena,2,2,0,0,16
662262,pākatikaṭṭhāne,pakatikatthane,2,2,0,0,14
662263,sammajjanatthāya,sammajjanatthaya,2,2,0,0,16
662264,pādaṭṭhānābhimukhā,padatthanabhimukha,4,4,0,0,18
662265,masārakoti,masarakoti,2,0,2,0,10
662266,bundikābaddhoti,bundikabaddhoti,2,0,2,0,15
662267,aṭanīhi,atanihi,2,2,0,0,7
662268,pallaṅkasaṅkhepena,pallankasankhepena,2,2,0,0,18
662269,kuḷīrapādakoti,kulirapadakoti,2,0,2,0,14
662270,P4.0774,P4.0774,1,1,0,0,7
662271,assameṇḍakādīnaṃ,assamendakadinam,2,2,0,0,16
662272,vaṅkapādako,vankapadako,2,2,0,0,11
662273,āhaccapādako,ahaccapadako,12,9,3,0,12
662274,pādasikhaṃ,padasikham,3,3,0,0,10
662275,katamañco,katamanco,7,7,0,0,9
662276,pīṭhepi,pithepi,6,6,0,0,7
662277,saṃveṭhetvā,samvethetva,5,3,2,0,11
662278,paṇavasaṇṭhānaṃ,panavasanthanam,6,5,1,0,15
662279,sīhabyagghacammaparikkhittampi,sihabyagghacammaparikkhittampi,3,3,0,0,30
662280,akappiyacammaṃ,akappiyacammam,19,17,2,0,14
662281,senāsanañhi,senasananhi,3,3,0,0,11
662282,sovaṇṇamayampi,sovannamayampi,3,3,0,0,14
662283,santharāpitaṃ,santharapitam,3,3,0,0,13
662284,leḍḍupātātikkame,leddupatatikkame,16,16,0,0,16
662285,anuggahitavatto,anuggahitavatto,4,3,1,0,15
662286,tajjetiyeva,tajjetiyeva,2,2,0,0,11
662287,bhaṇḍakadhovanādi,bhandakadhovanadi,1,1,0,0,17
662288,bhojanasālato,bhojanasalato,7,6,1,0,13
662289,pāduddhārena,paduddharena,13,10,3,0,12
662290,P4.0775,P4.0775,1,1,0,0,7
662291,yatricchati,yatricchati,2,2,0,0,11
662292,antarasannipāte,antarasannipate,4,4,0,0,15
662293,paṭisāmethāti,patisamethati,1,1,0,0,13
662294,uposathāgāratopi,uposathagaratopi,2,2,0,0,16
662295,bhojanasālatopi,bhojanasalatopi,2,2,0,0,15
662296,āvāsikānaṃyeva,avasikanamyeva,6,3,3,0,14
662297,atikkamantānaṃ,atikkamantanam,3,3,0,0,14
662298,nisinnakānaṃ,nisinnakanam,2,2,0,0,12
662299,anuddharāpetvā,anuddharapetva,5,5,0,0,14
662300,paññapitattā,pannapitatta,2,2,0,0,12
662301,ussārako,ussarako,6,5,1,0,8
662302,paññāpakānaṃ,pannapakanam,2,2,0,0,12
662303,antoupacāraṭṭheyeva,antoupacarattheyeva,2,2,0,0,19
662304,cimilikaṃ,cimilikam,13,10,3,0,9
662305,vaṇṇānurakkhaṇatthaṃ,vannanurakkhanattham,6,4,2,0,20
662306,P4.0776,P4.0776,1,1,0,0,7
662307,attharitabbakaṃ,attharitabbakam,2,2,0,0,15
662308,kaṭasārakādivikati,katasarakadivikati,3,3,0,0,18
662309,katataṭṭikā,katatattika,5,5,0,0,11
662310,sīhabyagghadīpitaracchacammādīsupi,sihabyagghadipitaracchacammadisupi,3,3,0,0,34
662311,senāsanaparibhoge,senasanaparibhoge,17,14,3,0,17
662312,paṭikkhittacammaṃ,patikkhittacammam,4,4,0,0,17
662313,sīhacammādīnaṃ,sihacammadinam,6,4,2,0,14
662314,pariharaṇeyeva,pariharaneyeva,15,12,3,0,14
662315,pādapuñchanī,padapunchani,5,2,3,0,12
662316,pādapuñchanatthaṃ,padapunchanattham,4,4,0,0,17
662317,phalakamayaṃ,phalakamayam,5,5,0,0,12
662318,phalakañceva,phalakanceva,2,2,0,0,12
662319,dārumayapīṭhañca,darumayapithanca,2,2,0,0,16
662320,dārubhaṇḍādi,darubhandadi,1,1,0,0,12
662321,pattapidhānaṃ,pattapidhanam,7,7,0,0,13
662322,bījanīpattakaṃ,bijanipattakam,2,2,0,0,14
662323,pānīyauḷuṅkaṃ,paniyaulunkam,2,2,0,0,13
662324,rajanabhājanaṃ,rajanabhajanam,5,5,0,0,14
662325,rajanauḷuṅko,rajanaulunko,2,2,0,0,12
662326,rajanadoṇikāti,rajanadonikati,2,2,0,0,14
662327,puggaliketi,puggaliketi,3,0,3,0,11
662328,puggalikamiva,puggalikamiva,4,4,0,0,13
662329,āpucchaṃ,apuccham,5,3,2,0,8
662330,otāpento,otapento,8,5,3,0,8
662331,P4.0777,P4.0777,1,1,0,0,7
662332,palibuddhe,palibuddhe,8,8,0,0,10
662333,anuddharitvāpi,anuddharitvapi,1,1,0,0,14
662334,jīvitabrahmacariyantarāyesu,jivitabrahmacariyantarayesu,5,5,0,0,27
662335,paṭhamasenāsanasikkhāpadaṃ,pathamasenasanasikkhapadam,6,6,0,0,26
662336,dutiyasenāsanasikkhāpadavaṇṇanā,dutiyasenasanasikkhapadavannana,13,13,0,0,31
662337,dutiyasenāsanasikkhāpade,dutiyasenasanasikkhapade,2,2,0,0,24
662338,mañcakabhisi,mancakabhisi,6,5,1,0,12
662339,cimilikādīnipi,cimilikadinipi,1,1,0,0,14
662340,tiṇasanthāroti,tinasantharoti,4,0,4,0,14
662341,paṇṇasanthāre,pannasanthare,6,2,4,0,13
662342,atikkamantassāti,atikkamantassati,3,0,3,0,16
662343,dutiyātikkame,dutiyatikkame,4,4,0,0,13
662344,leḍḍupātā,leddupata,14,12,2,0,9
662345,anāpucchaṃ,anapuccham,34,28,6,0,10
662346,āpucchitabbo,apucchitabbo,37,35,2,0,12
662347,avasesamañcapīṭhāni,avasesamancapithani,3,3,0,0,19
662348,bhisiādikaṃ,bhisiadikam,4,4,0,0,11
662349,chadanatthañca,chadanatthanca,3,3,0,0,14
662350,anovassako,anovassako,7,7,0,0,10
662351,ussahantena,ussahantena,4,4,0,0,11
662352,aggidāhādīnaṃ,aggidahadinam,3,3,0,0,13
662353,aṅgamattampi,angamattampi,3,3,0,0,12
662354,P4.0778,P4.0778,1,1,0,0,7
662355,upacāretiādīsu,upacaretiadisu,1,0,1,0,14
662356,vihārassūpacāro,viharassupacaro,1,1,0,0,15
662357,pariveṇabhojanasālā,parivenabhojanasala,1,1,0,0,19
662358,maṇḍapoti,mandapoti,5,2,3,0,9
662359,pariveṇamaṇḍapo,parivenamandapo,1,1,0,0,15
662360,pariveṇarukkhamūlaṃ,parivenarukkhamulam,1,1,0,0,19
662361,antogabbho,antogabbho,2,2,0,0,10
662362,guttasenāsanaṃ,guttasenasanam,2,2,0,0,14
662363,upacāreti,upacareti,19,3,16,0,9
662364,sannipātamaṇḍape,sannipatamandape,3,3,0,0,16
662365,vuttappakārañhi,vuttappakaranhi,3,3,0,0,15
662366,antogabbhādimhi,antogabbhadimhi,3,3,0,0,15
662367,seyyāpi,seyyapi,4,4,0,0,7
662368,vammikarāsiyeva,vammikarasiyeva,4,4,0,0,15
662369,upaṭṭhānasālādīsu,upatthanasaladisu,3,3,0,0,17
662370,seyyāmattameva,seyyamattameva,4,4,0,0,14
662371,aguttatāya,aguttataya,3,3,0,0,10
662372,khāyituṃ,khayitum,4,3,1,0,8
662373,paṭisāmessanti,patisamessanti,1,1,0,0,14
662374,mañcapīṭhakavāṭaṃ,mancapithakavatam,2,2,0,0,17
662375,vasanakabhikkhunāpi,vasanakabhikkhunapi,3,3,0,0,19
662376,antokuṭṭato,antokuttato,3,3,0,0,11
662377,bahikuṭṭe,bahikutte,8,8,0,0,9
662378,āpucchitabbānāpucchitabbavinicchayo,apucchitabbanapucchitabbavinicchayo,3,3,0,0,35
662379,dīghasālā,dighasala,5,5,0,0,9
662380,P4.0779,P4.0779,1,1,0,0,7
662381,rukkhatthambhesu,rukkhatthambhesu,3,3,0,0,16
662382,katagehaṃ,katageham,7,7,0,0,9
662383,ajaggiyamāne,ajaggiyamane,3,3,0,0,12
662384,vammikāva,vammikava,3,3,0,0,9
662385,pāsāṇatthambhesu,pasanatthambhesu,9,9,0,0,16
662386,siluccayaleṇaṃ,siluccayalenam,7,3,4,0,14
662387,sudhālittasenāsanaṃ,sudhalittasenasanam,3,3,0,0,19
662388,upacikāsaṅkā,upacikasanka,4,4,0,0,12
662389,āpucchitvāpi,apucchitvapi,13,13,0,0,12
662390,purimabhikkhusseva,purimabhikkhusseva,2,2,0,0,18
662391,āgantukasseva,agantukasseva,2,2,0,0,13
662392,āpucchitabbaṃ,apucchitabbam,41,37,4,0,13
662393,santharāpenti,santharapenti,2,2,0,0,13
662394,netabbāni,netabbani,2,2,0,0,9
662395,aññāvāsato,annavasato,4,4,0,0,10
662396,evamaññattha,evamannattha,2,2,0,0,12
662397,gīvāyeva,givayeva,7,7,0,0,8
662398,vuḍḍhatarabhikkhūissariyayakkhasīhavāḷamigakaṇhasappādīsu,vuddhatarabhikkhuissariyayakkhasihavalamigakanhasappadisu,1,1,0,0,57
662399,P4.0780,P4.0780,1,1,0,0,7
662400,nadīpūrarājacorādīsu,nadipurarajacoradisu,2,2,0,0,20
662401,dutiyasenāsanasikkhāpadaṃ,dutiyasenasanasikkhapadam,6,6,0,0,25
662402,anupakhajjasikkhāpadavaṇṇanā,anupakhajjasikkhapadavannana,22,22,0,0,28
662403,chaṭṭhasikkhāpade,chatthasikkhapade,5,5,0,0,17
662404,palibundhentīti,palibundhentiti,1,0,1,0,15
662405,mañcaṭṭhānaṃyeva,mancatthanamyeva,1,1,0,0,16
662406,nipajjantipi,nipajjantipi,1,1,0,0,12
662407,anuṭṭhāpanīyo,anutthapaniyo,17,17,0,0,13
662408,vuḍḍhatāya,vuddhataya,9,9,0,0,10
662409,gilānatāya,gilanataya,6,6,0,0,10
662410,dhammakathikavinayadharādīnaṃ,dhammakathikavinayadharadinam,6,6,0,0,29
662411,gaṇavācakaācariyassa,ganavacakaacariyassa,3,3,0,0,20
662412,guṇavisiṭṭhatañca,gunavisitthatanca,15,12,3,0,17
662413,dhuvavāsatthāya,dhuvavasatthaya,24,24,0,0,15
662414,gilānassāpi,gilanassapi,13,13,0,0,11
662415,adinnasenāsanopi,adinnasenasanopi,2,2,0,0,16
662416,pīḷetabbo,piletabbo,3,3,0,0,9
662417,nikkhittapādadhovanapāsāṇato,nikkhittapadadhovanapasanato,3,3,0,0,28
662418,passāvaṭṭhānato,passavatthanato,3,3,0,0,15
662419,diyaḍḍhahatthavitthāro,diyaddhahatthavittharo,1,1,0,0,22
662420,P4.0781,P4.0781,1,1,0,0,7
662421,abhinisīdanamattena,abhinisidanamattena,1,1,0,0,19
662422,abhinipajjanamatteneva,abhinipajjanamatteneva,1,1,0,0,22
662423,dukkaṭavārepi,dukkatavarepi,1,1,0,0,13
662424,abhinisīdanamatte,abhinisidanamatte,1,1,0,0,17
662425,abhinipajjanamatte,abhinipajjanamatte,1,1,0,0,18
662426,ubhayakaraṇe,ubhayakarane,1,1,0,0,12
662427,payogabhede,payogabhede,1,1,0,0,11
662428,pācittiyappabhedo,pacittiyappabhedo,1,1,0,0,17
662429,dukkaṭappabhedo,dukkatappabhedo,1,1,0,0,15
662430,visabhāgapuggalena,visabhagapuggalena,3,3,0,0,18
662431,ekapariveṇe,ekaparivene,3,3,0,0,11
662432,sabbatthevassa,sabbatthevassa,3,3,0,0,14
662433,vissāsikassa,vissasikassa,8,8,0,0,12
662434,puggalikasadisameva,puggalikasadisameva,2,2,0,0,19
662435,jīvitabrahmacariyantarāyo,jivitabrahmacariyantarayo,1,1,0,0,25
662436,anupakhajjasikkhāpadaṃ,anupakhajjasikkhapadam,6,6,0,0,22
662437,nikkaḍḍhanasikkhāpadavaṇṇanā,nikkaddhanasikkhapadavannana,13,13,0,0,28
662438,catubhūmakapañcabhūmakā,catubhumakapancabhumaka,1,1,0,0,23
662439,chasattakoṭṭhakāni,chasattakotthakani,2,1,1,0,18
662440,catussālāni,catussalani,2,2,0,0,11
662441,nānāpayogehi,nanapayogehi,5,5,0,0,12
662442,dvāragaṇanāya,dvaragananaya,12,12,0,0,13
662443,nikkaḍḍhantassāpi,nikkaddhantassapi,2,2,0,0,17
662444,nikkaḍḍhā,nikkaddha,2,2,0,0,9
662445,āṇattimatte,anattimatte,1,1,0,0,11
662446,nikkaḍḍhāhī,nikkaddhahi,12,12,0,0,11
662447,pattacīvaraparissāvanadhamakaraṇamañcapīṭhabhisibimbohanādibhedaṃ,pattacivaraparissavanadhamakaranamancapithabhisibimbohanadibhedam,1,1,0,0,65
662448,rajanachallimpi,rajanachallimpi,1,1,0,0,15
662449,P4.0782,P4.0782,1,1,0,0,7
662450,vissāsikapuggalikaṃ,vissasikapuggalikam,1,1,0,0,19
662451,bhaṇḍanakārakakalahakārakameva,bhandanakarakakalahakarakameva,4,4,0,0,30
662452,sakalasaṅghārāmato,sakalasangharamato,9,8,1,0,18
662453,alajjīādayo,alajjiadayo,3,3,0,0,11
662454,vasanaṭṭhānatoyeva,vasanatthanatoyeva,4,4,0,0,18
662455,nikkaḍḍhitabbā,nikkaddhitabba,4,4,0,0,14
662456,nikkaḍḍhanasikkhāpadaṃ,nikkaddhanasikkhapadam,7,7,0,0,22
662457,vehāsakuṭisikkhāpadavaṇṇanā,vehasakutisikkhapadavannana,11,11,0,0,27
662458,uparivehāsakuṭiyāti,uparivehasakutiyati,3,0,3,0,19
662459,acchannatalāya,acchannatalaya,3,3,0,0,14
662460,dvibhūmikakuṭiyā,dvibhumikakutiya,3,3,0,0,16
662461,tibhūmikādikuṭiyā,tibhumikadikutiya,1,1,0,0,17
662462,abhinisīdīti,abhinisiditi,1,0,1,0,12
662463,padasobhanatthaṃ,padasobhanattham,2,2,0,0,16
662464,nippatitvāti,nippatitvati,1,0,1,0,12
662465,āṇīpi,anipi,1,1,0,0,5
662466,āturassaramakāsi,aturassaramakasi,1,1,0,0,16
662467,asīsaghaṭṭāti,asisaghattati,1,0,1,0,13
662468,sabbaheṭṭhimāhi,sabbahetthimahi,2,2,0,0,15
662469,vehāsakuṭilakkhaṇaṃ,vehasakutilakkhanam,2,2,0,0,19
662470,acchinnatalā,acchinnatala,1,1,0,0,12
662471,dvibhūmikā,dvibhumika,1,1,0,0,10
662472,tibhūmikādikuṭi,tibhumikadikuti,2,2,0,0,15
662473,vehāsakuṭī,vehasakuti,3,3,0,0,10
662474,asīsaghaṭṭā,asisaghatta,12,9,3,0,11
662475,abhinisīdanādīsu,abhinisidanadisu,1,1,0,0,16
662476,avehāsakuṭiyāti,avehasakutiyati,1,0,1,0,15
662477,katapaṇṇasālādīsu,katapannasaladisu,3,3,0,0,17
662478,P4.0783,P4.0783,1,1,0,0,7
662479,sīsaghaṭṭāyāti,sisaghattayati,2,0,2,0,14
662480,sīsaghaṭṭā,sisaghatta,1,1,0,0,10
662481,anoṇatena,anonatena,3,3,0,0,9
662482,asañcaraṇaṭṭhānattā,asancaranatthanatta,2,2,0,0,19
662483,parapīḷā,parapila,2,2,0,0,8
662484,dabbasambhārādīnaṃ,dabbasambharadinam,2,2,0,0,18
662485,padarasañcitaṃ,padarasancitam,4,2,2,0,14
662486,dāruphalakehi,daruphalakehi,2,2,0,0,13
662487,ghanasanthataṃ,ghanasanthatam,2,2,0,0,14
662488,sudhādiparikammakataṃ,sudhadiparikammakatam,2,2,0,0,21
662489,paṭāṇi,patani,7,4,3,0,6
662490,pādasikhāsu,padasikhasu,2,2,0,0,11
662491,nisīdantepi,nisidantepi,2,2,0,0,11
662492,nippatanti,nippatanti,1,1,0,0,10
662493,nisīdatopi,nisidatopi,1,1,0,0,10
662494,āhaccapādake,ahaccapadake,12,11,1,0,12
662495,nāgadantakādīsu,nagadantakadisu,3,3,0,0,15
662496,laggitakaṃ,laggitakam,1,1,0,0,10
662497,laggeti,laggeti,6,6,0,0,7
662498,vehāsakuṭisikkhāpadaṃ,vehasakutisikkhapadam,6,6,0,0,21
662499,mahallakavihārasikkhāpadavaṇṇanā,mahallakaviharasikkhapadavannana,11,11,0,0,32
662500,dvārakosāti,dvarakosati,3,0,3,0,11
662501,dvārakoso,dvarakoso,3,3,0,0,9
662502,piṭṭhasaṅghāṭassa,pitthasanghatassa,9,8,1,0,17
662503,kavāṭavitthārappamāṇo,kavatavittharappamano,5,5,0,0,21
662504,dvārabāhato,dvarabahato,2,2,0,0,11
662505,kavāṭappamāṇaṃ,kavatappamanam,1,1,0,0,14
662506,diyaḍḍhahatthampi,diyaddhahatthampi,1,1,0,0,17
662507,dvihatthampi,dvihatthampi,1,1,0,0,12
662508,aḍḍhateyyahatthampī,addhateyyahatthampi,2,2,0,0,19
662509,aggaḷaṭṭhapanāyāti,aggalatthapanayati,5,0,5,0,18
662510,sakavāṭakadvārabandhaṭṭhapanāya,sakavatakadvarabandhatthapanaya,1,1,0,0,31
662511,sakavāṭakassa,sakavatakassa,2,2,0,0,13
662512,dvārabandhassa,dvarabandhassa,5,5,0,0,14
662513,niccalabhāvatthāyāti,niccalabhavatthayati,2,2,0,0,20
662514,dvāraṭṭhapanāyāti,dvaratthapanayati,1,1,0,0,17
662515,lahuparivaṭṭakaṃ,lahuparivattakam,1,1,0,0,16
662516,vivaraṇakāle,vivaranakale,4,4,0,0,12
662517,pidahanakāle,pidahanakale,2,2,0,0,12
662518,dvārabandhaṃ,dvarabandham,8,8,0,0,12
662519,āhananena,ahananena,1,1,0,0,9
662520,P4.0784,P4.0784,1,1,0,0,7
662521,dvārakosā,dvarakosa,15,13,2,0,9
662522,aggaḷaṭṭhapanāyā,aggalatthapanaya,7,7,0,0,16
662523,lepāpesī,lepapesi,3,3,0,0,8
662524,aggaḷaṭṭhapanāya,aggalatthapanaya,10,8,2,0,16
662525,limpitabbo,limpitabbo,10,9,1,0,10
662526,lepāpetabbo,lepapetabbo,9,8,1,0,11
662527,aparipūraupacārāpi,aparipuraupacarapi,4,3,1,0,18
662528,niccalabhāvatthāya,niccalabhavatthaya,2,2,0,0,18
662529,limpituṃ,limpitum,2,2,0,0,8
662530,ālokasandhiparikammāyāti,alokasandhiparikammayati,2,0,2,0,24
662531,ālokasandhīti,alokasandhiti,5,1,4,0,13
662532,vātapānakavāṭakā,vatapanakavataka,7,5,2,0,16
662533,bhittippadesaṃ,bhittippadesam,2,2,0,0,14
662534,ālokasandhiparikammatthāya,alokasandhiparikammatthaya,2,2,0,0,26
662535,bhārikattaṃ,bharikattam,2,2,0,0,11
662536,padabhājaneyeva,padabhajaneyeva,2,2,0,0,15
662537,lepakamme,lepakamme,2,2,0,0,9
662538,dvatticchadanassā,dvatticchadanassa,1,0,1,0,17
662539,dvatticchadanassa,dvatticchadanassa,6,2,4,0,17
662540,dvattipariyāyaṃ,dvattipariyayam,6,4,2,0,15
662541,parikkhepadvayaṃ,parikkhepadvayam,2,2,0,0,16
662542,parikkhepattayaṃ,parikkhepattayam,2,2,0,0,16
662543,appaharite,appaharite,29,23,6,0,10
662544,sattadhaññabhedaṃ,sattadhannabhedam,2,2,0,0,17
662545,muggamāsatilakulatthaalābukumbhaṇḍādibhedañca,muggamasatilakulatthaalabukumbhandadibhedanca,3,3,0,0,45
662546,P4.0785,P4.0785,1,1,0,0,7
662547,yasmimpi,yasmimpi,4,4,0,0,8
662548,haritasaṅkhyameva,haritasankhyameva,1,1,0,0,17
662549,khettepi,khettepi,6,6,0,0,8
662550,ahariteyeva,ahariteyeva,1,1,0,0,11
662551,piṭṭhivaṃsassa,pitthivamsassa,4,4,0,0,14
662552,kūṭāgārakaṇṇikāya,kutagarakannikaya,2,2,0,0,17
662553,thupikāya,thupikaya,3,3,0,0,9
662554,chadanamukhavaṭṭiantena,chadanamukhavattiantena,2,2,0,0,23
662555,aharitepi,aharitepi,4,3,1,0,9
662556,patanokāsoti,patanokasoti,4,3,1,0,12
662557,chādentassāti,chadentassati,3,1,2,0,13
662558,iṭṭhakasilāsudhāhi,itthakasilasudhahi,3,3,0,0,18
662559,ducchannā,ducchanna,1,1,0,0,9
662560,apanetvāpi,apanetvapi,1,1,0,0,10
662561,tatiyaṃmaggaṃ,tatiyammaggam,1,1,0,0,13
662562,evaṃchadanaṃ,evamchadanam,1,1,0,0,12
662563,chadanūpari,chadanupari,5,5,0,0,11
662564,uparūparicchanno,uparuparicchanno,1,1,0,0,16
662565,pariyāyānaṃ,pariyayanam,10,8,2,0,11
662566,karaḷeti,karaleti,1,0,1,0,8
662567,tiṇamuṭṭhiyaṃ,tinamutthiyam,3,3,0,0,13
662568,mahallakavihārasikkhāpadaṃ,mahallakaviharasikkhapadam,6,6,0,0,26
662569,sappāṇakasikkhāpadavaṇṇanā,sappanakasikkhapadavannana,23,23,0,0,26
662570,P4.0786,P4.0786,1,1,0,0,7
662571,siñceyyāti,sinceyyati,4,3,1,0,10
662572,vicchindantassa,vicchindantassa,3,3,0,0,15
662573,sandatu,sandatu,3,3,0,0,7
662574,sakaṭabhāramattañcepi,sakatabharamattancepi,1,1,0,0,21
662575,kaṭṭhagomayādīsu,katthagomayadisu,1,1,0,0,16
662576,sappāṇakasikkhāpadaṃ,sappanakasikkhapadam,14,14,0,0,20
662577,senāsanavaggo,senasanavaggo,5,5,0,0,13
662578,ovādavaggo,ovadavaggo,21,21,0,0,10
662579,ovādasikkhāpadavaṇṇanā,ovadasikkhapadavannana,13,13,0,0,22
662580,para141-144,para141-144,1,1,0,0,11
662581,bhikkhunivaggassa,bhikkhunivaggassa,4,3,1,0,17
662582,mahākulehi,mahakulehi,3,3,0,0,10
662583,ñātimanussānaṃ,natimanussanam,2,2,0,0,14
662584,sīlasutācārajātigottādibhedaṃ,silasutacarajatigottadibhedam,1,1,0,0,29
662585,vijjamānaguṇaṃ,vijjamanagunam,5,4,1,0,14
662586,vijjamānaguṇā,vijjamanaguna,2,2,0,0,13
662587,cīvarādibhedaṃ,civaradibhedam,1,1,0,0,14
662588,P4.0787,P4.0787,1,1,0,0,7
662589,akaṃsuyeva,akamsuyeva,1,1,0,0,10
662590,saggamaggagamanepi,saggamaggagamanepi,1,1,0,0,18
662591,rājakathādimanekavidhaṃ,rajakathadimanekavidham,1,1,0,0,23
662592,sahitattho,sahitattho,2,1,1,0,10
662593,bahuraso,bahuraso,1,1,0,0,8
662594,lakkhaṇapaṭivedhasaṃyuttoti,lakkhanapativedhasamyuttoti,2,1,1,0,27
662595,para145-147,para145-147,4,4,0,0,11
662596,ovaditthā,ovadittha,1,1,0,0,9
662597,adiṭṭhasaccattā,aditthasaccatta,2,2,0,0,15
662598,apāyupagataṃ,apayupagatam,1,1,0,0,12
662599,bhikkhunovādato,bhikkhunovadato,1,1,0,0,15
662600,bhikkhunovādakasammutiṃ,bhikkhunovadakasammutim,18,18,0,0,23
662601,bhūtapubbānīti,bhutapubbaniti,1,1,0,0,14
662602,pātimokkhova,patimokkhova,1,1,0,0,12
662603,P4.0788,P4.0788,1,1,0,0,7
662604,micchājīvapaṭisedhakena,micchajivapatisedhakena,1,1,0,0,23
662605,veḷudānādinā,veludanadina,3,2,1,0,12
662606,saddhāsampannakulādinā,saddhasampannakuladina,1,1,0,0,22
662607,adhisīlasikkhādibhāvena,adhisilasikkhadibhavena,1,1,0,0,23
662608,sutamassāti,sutamassati,1,1,0,0,11
662609,sannicitamasminti,sannicitamasminti,1,1,0,0,17
662610,sannicitaratanasseva,sannicitaratanasseva,1,1,0,0,20
662611,cirakālenāpi,cirakalenapi,1,1,0,0,12
662612,dīpasahassena,dipasahassena,1,1,0,0,13
662613,supaccakkhakatā,supaccakkhakata,1,1,0,0,15
662614,parisupaṭṭhāpako,parisupatthapako,3,2,1,0,16
662615,bhikkhunovādakoti,bhikkhunovadakoti,1,1,0,0,17
662616,nissayamuccanakena,nissayamuccanakena,4,3,1,0,18
662617,dhammasāvanatthāya,dhammasavanatthaya,1,1,0,0,18
662618,suttantato,suttantato,9,9,0,0,10
662619,P4.0789,P4.0789,1,1,0,0,7
662620,parikathanatthāya,parikathanatthaya,4,4,0,0,17
662621,andhakavindamahārāhulovādaambaṭṭhasadiso,andhakavindamaharahulovadaambatthasadiso,2,2,0,0,40
662622,saṅghabhattamaṅgalāmaṅgalesu,sanghabhattamangalamangalesu,4,4,0,0,28
662623,uposathapavāraṇādijānanatthaṃ,uposathapavaranadijananattham,2,2,0,0,29
662624,kammākammavinicchayo,kammakammavinicchayo,5,5,0,0,20
662625,samaṇadhammakaraṇatthaṃ,samanadhammakaranattham,5,5,0,0,23
662626,arahattapariyosānamekaṃ,arahattapariyosanamekam,2,2,0,0,23
662627,parisupaṭṭhāpakena,parisupatthapakena,5,3,2,0,18
662628,parivattanakkhamā,parivattanakkhama,4,2,2,0,17
662629,kammākammañca,kammakammanca,3,3,0,0,13
662630,khandhakavattañca,khandhakavattanca,6,5,1,0,17
662631,majjhimabhāṇako,majjhimabhanako,5,4,1,0,15
662632,dīghabhāṇakena,dighabhanakena,2,2,0,0,14
662633,saṃyuttabhāṇakena,samyuttabhanakena,2,2,0,0,17
662634,aṅguttarabhāṇakena,anguttarabhanakena,2,2,0,0,18
662635,upaḍḍhanikāyo,upaddhanikayo,2,2,0,0,13
662636,tikanipātato,tikanipatato,3,2,1,0,12
662637,catukkanipātaṃ,catukkanipatam,3,3,0,0,14
662638,pañcakanipātaṃ,pancakanipatam,3,3,0,0,14
662639,jātakabhāṇakena,jatakabhanakena,6,6,0,0,15
662640,dhammapadampi,dhammapadampi,7,7,0,0,13
662641,mūlapaṇṇāsakamattaṃ,mulapannasakamattam,2,2,0,0,19
662642,vicāraṇāyeva,vicaranayeva,4,3,1,0,12
662643,uggahetabbanti,uggahetabbanti,6,5,1,0,14
662644,sāṭṭhakathampi,satthakathampi,2,2,0,0,14
662645,vuttappamāṇo,vuttappamano,5,5,0,0,12
662646,bhikkhunovādakena,bhikkhunovadakena,1,0,1,0,17
662647,P4.0790,P4.0790,1,1,0,0,7
662648,ekanikāyena,ekanikayena,1,1,0,0,11
662649,sesanikāyesupi,sesanikayesupi,1,1,0,0,14
662650,catuppakaraṇassa,catuppakaranassa,2,2,0,0,16
662651,laddhanayena,laddhanayena,2,2,0,0,12
662652,sesapakaraṇesu,sesapakaranesu,1,1,0,0,14
662653,navaṅgepi,navangepi,1,1,0,0,9
662654,bāhussacce,bahussacce,1,1,0,0,10
662655,ubhatovibhaṅgena,ubhatovibhangena,4,4,0,0,16
662656,suvibhattānī,suvibhattani,1,0,1,0,12
662657,padapaccābhaṭṭhasaṅkaradosavirahitāni,padapaccabhatthasankaradosavirahitani,2,2,0,0,37
662658,vācuggatāni,vacuggatani,3,3,0,0,11
662659,āharitabbasuttavasena,aharitabbasuttavasena,3,3,0,0,21
662660,akkharapadapāripūriyā,akkharapadaparipuriya,4,4,0,0,21
662661,aviparītakkharāni,aviparitakkharani,3,3,0,0,17
662662,parimaṇḍalapadabyañjanāya,parimandalapadabyanjanaya,6,6,0,0,25
662663,sarasampattirato,sarasampattirato,2,2,0,0,16
662664,parimaṇḍalapadabyañjanampi,parimandalapadabyanjanampi,1,1,0,0,26
662665,sarasampattirahitaṃ,sarasampattirahitam,2,2,0,0,19
662666,kāsāyavatthavasanāyāti,kasayavatthavasanayati,1,0,1,0,22
662667,kāsāyavatthanivatthāya,kasayavatthanivatthaya,1,1,0,0,22
662668,P4.0791,P4.0791,1,1,0,0,7
662669,sikkhamānāsāmaṇerīsu,sikkhamanasamanerisu,5,4,1,0,20
662670,anajjhāpannapubbo,anajjhapannapubbo,2,2,0,0,17
662671,katamanussaranto,katamanussaranto,1,1,0,0,16
662672,atirekavasso,atirekavasso,1,1,0,0,12
662673,samāgacchantopi,samagacchantopi,1,1,0,0,15
662674,aṭṭhamanti,atthamanti,2,2,0,0,10
662675,garudhammehīti,garudhammehiti,1,0,1,0,14
662676,garukehi,garukehi,2,2,0,0,8
662677,sampaṭicchitabbattā,sampaticchitabbatta,6,6,0,0,19
662678,garudhammāti,garudhammati,2,2,0,0,12
662679,ekatoupasampannāyāti,ekatoupasampannayati,6,1,5,0,20
662680,ekatoupasampannāya,ekatoupasampannaya,24,24,0,0,18
662681,garudhammena,garudhammena,3,3,0,0,12
662682,sammajjitvāti,sammajjitvati,2,0,2,0,13
662683,pādappahārehi,padappaharehi,1,1,0,0,13
662684,vikiṇṇavālikaṃ,vikinnavalikam,1,1,0,0,14
662685,asammaṭṭhañhi,asammatthanhi,1,1,0,0,13
662686,asotukāmā,asotukama,1,1,0,0,9
662687,hatthapādamukhasītalakaraṇañca,hatthapadamukhasitalakarananca,1,1,0,0,30
662688,asotukāmāpi,asotukamapi,1,1,0,0,11
662689,P4.0792,P4.0792,1,1,0,0,7
662690,nīcapīṭhakaphalakataṭṭikakaṭasārakādibhedaṃ,nicapithakaphalakatattikakatasarakadibhedam,1,1,0,0,43
662691,dhammadesanāpattimocanatthaṃ,dhammadesanapattimocanattham,3,2,1,0,28
662692,uposathāgārassa,uposathagarassa,8,8,0,0,15
662693,samaggātthāti,samaggatthati,1,0,1,0,13
662694,vācuggatāti,vacuggatati,4,1,3,0,11
662695,niyyādetabboti,niyyadetabboti,1,0,1,0,14
662696,appetabbo,appetabbo,1,1,0,0,9
662697,vassasatūpasampannāyātiādi,vassasatupasampannayatiadi,1,0,1,0,26
662698,vattabbapāḷidassanaṃ,vattabbapalidassanam,1,1,0,0,20
662699,maggasampadānabījanapānīyāpucchanādikaṃ,maggasampadanabijanapaniyapucchanadikam,2,2,0,0,39
662700,anucchavikavattaṃ,anucchavikavattam,1,1,0,0,17
662701,rājussāraṇāyapi,rajussaranayapi,1,1,0,0,15
662702,chattapattahatthāyapi,chattapattahatthayapi,1,1,0,0,21
662703,anubaddhāyapi,anubaddhayapi,1,1,0,0,13
662704,mahāsannipāte,mahasannipate,2,2,0,0,13
662705,añjalikammepi,anjalikammepi,1,1,0,0,13
662706,sāmīcikammassa,samicikammassa,1,1,0,0,14
662707,garuṃkatvāti,garumkatvati,1,0,1,0,12
662708,mānetvāti,manetvati,1,0,1,0,9
662709,anatikkamanīyoti,anatikkamaniyoti,1,0,1,0,16
662710,bhikkhunupassayato,bhikkhunupassayato,7,7,0,0,18
662711,aḍḍhayojanabbhantare,addhayojanabbhantare,2,2,0,0,20
662712,ovādadāyakā,ovadadayaka,5,5,0,0,11
662713,P4.0793,P4.0793,1,1,0,0,7
662714,evaṃvadanti,evamvadanti,1,1,0,0,11
662715,vuttappamāṇe,vuttappamane,4,4,0,0,12
662716,sākhāmaṇḍapepi,sakhamandapepi,1,1,0,0,14
662717,upagacchantīhi,upagacchantihi,2,2,0,0,14
662718,terasiyaṃyeva,terasiyamyeva,5,4,1,0,13
662719,atirekaḍḍhayojanaṃ,atirekaddhayojanam,2,2,0,0,18
662720,abhikkhukāvāsaṭṭhāneyeva,abhikkhukavasatthaneyeva,1,1,0,0,24
662721,āgataovādena,agataovadena,1,1,0,0,12
662722,anujīvantiyo,anujivantiyo,1,1,0,0,12
662723,bhikkhācārasampadaṃ,bhikkhacarasampadam,1,1,0,0,19
662724,P4.0794,P4.0794,1,1,0,0,7
662725,pacchimikāyapi,pacchimikayapi,15,15,0,0,14
662726,abhikkhukāvāse,abhikkhukavase,4,3,1,0,14
662727,vassacchedaṃ,vassacchedam,24,23,1,0,12
662728,pakkhasaṅkantā,pakkhasankanta,9,7,2,0,14
662729,ādikammikāyā,adikammikaya,3,3,0,0,12
662730,paccāsīsitabbāti,paccasisitabbati,2,0,2,0,16
662731,uposathapucchakaṃ,uposathapucchakam,5,1,4,0,17
662732,uposathapucchanaṃ,uposathapucchanam,4,2,2,0,17
662733,pannarasike,pannarasike,2,2,0,0,11
662734,pannarasiko,pannarasiko,22,19,3,0,11
662735,payirūpāsamānā,payirupasamana,1,1,0,0,14
662736,sātthikaṃ,satthikam,2,1,1,0,9
662737,paṭipajjissāmā,patipajjissama,2,2,0,0,14
662738,jāyāyo,jayayo,7,7,0,0,6
662739,jāriyo,jariyo,7,7,0,0,6
662740,abhiramissantī,abhiramissanti,4,4,0,0,14
662741,bhikkhunisaṅghena,bhikkhunisanghena,28,27,1,0,17
662742,P4.0795,P4.0795,1,1,0,0,7
662743,ethayye,ethayye,1,1,0,0,7
662744,ovādapaṭiggāhakaṃ,ovadapatiggahakam,1,1,0,0,17
662745,pātimokkhuddesako,patimokkhuddesako,20,19,1,0,17
662746,pātimokkhuddesakena,patimokkhuddesakena,42,41,1,0,19
662747,sampādetū,sampadetu,13,13,0,0,9
662748,sāsanamārocitaṃ,sasanamarocitam,1,1,0,0,15
662749,bhikkhunisaṅghenapi,bhikkhunisanghenapi,1,1,0,0,19
662750,gacchathayye,gacchathayye,1,1,0,0,12
662751,P4.0796,P4.0796,1,1,0,0,7
662752,sampaṭicchitabbañca,sampaticchitabbanca,2,2,0,0,19
662753,gaṇamattameva,ganamattameva,2,2,0,0,13
662754,puggalamattaṃ,puggalamattam,2,2,0,0,13
662755,bhikkhunupassayehi,bhikkhunupassayehi,4,4,0,0,18
662756,P4.0797,P4.0797,1,1,0,0,7
662757,pātimokkhuddesakenāpi,patimokkhuddesakenapi,2,2,0,0,21
662758,upasaṅkamantu,upasankamantu,3,3,0,0,13
662759,upasaṅkamatūti,upasankamatuti,1,1,0,0,14
662760,sampādentu,sampadentu,3,3,0,0,10
662761,sampādetūti,sampadetuti,5,1,4,0,11
662762,ovādapaṭiggāhakena,ovadapatiggahakena,3,3,0,0,18
662763,bālagilānagamike,balagilanagamike,1,1,0,0,16
662764,appaṭiggahetuṃ,appatiggahetum,2,2,0,0,14
662765,gamikaṃ,gamikam,11,10,1,0,7
662766,cātuddasikapannarasikesu,catuddasikapannarasikesu,2,2,0,0,24
662767,anārocetuṃ,anarocetum,3,3,0,0,10
662768,apaccāharituṃ,apaccaharitum,2,2,0,0,13
662769,P4.0798,P4.0798,1,1,0,0,7
662770,paccāhareyya,paccahareyya,3,3,0,0,12
662771,paccāharaṇatthaṃ,paccaharanattham,1,1,0,0,16
662772,saṅketañca,sanketanca,4,4,0,0,10
662773,paṭiharissāmī,patiharissami,1,1,0,0,13
662774,sāmantagāme,samantagame,8,7,1,0,11
662775,bhikkhunikhandhake,bhikkhunikhandhake,1,1,0,0,18
662776,sammannitabbā,sammannitabba,78,78,0,0,13
662777,byattāya,byattaya,35,35,0,0,8
662778,paṭibalāya,patibalaya,30,30,0,0,10
662779,itthannāmāya,itthannamaya,140,140,0,0,12
662780,P4.0799,P4.0799,1,1,0,0,7
662781,vadatayya,vadatayya,2,2,0,0,9
662782,paṭikarissatī,patikarissati,28,28,0,0,13
662783,paṭikarissantī,patikarissanti,9,9,0,0,14
662784,vadantayyā,vadantayya,2,2,0,0,10
662785,vadatayyo,vadatayyo,2,2,0,0,9
662786,apāripūriyā,aparipuriya,4,4,0,0,11
662787,P4.0800,P4.0800,1,1,0,0,7
662788,mānattacaraṇañca,manattacarananca,3,3,0,0,16
662789,upasampadāpariyesanā,upasampadapariyesana,1,1,0,0,20
662790,ovaṭoti,ovatoti,1,0,1,0,7
662791,vacanayeva,vacanayeva,1,1,0,0,10
662792,anovaṭoti,anovatoti,1,0,1,0,9
662793,pārupāhī,parupahi,1,1,0,0,8
662794,añjentī,anjenti,1,1,0,0,7
662795,vijjamānadosaṃ,vijjamanadosam,2,2,0,0,14
662796,vuḍḍhasamaṇī,vuddhasamani,1,1,0,0,12
662797,pārupāhi,parupahi,1,1,0,0,8
662798,tilakammapaṇṇakammādīni,tilakammapannakammadini,1,1,0,0,23
662799,samaggamhayyāti,samaggamhayyati,2,1,1,0,15
662800,aniyyādetvāti,aniyyadetvati,2,0,2,0,13
662801,adhammakammetiādīsu,adhammakammetiadisu,1,0,1,0,19
662802,bhikkhunovādakasammutikammaṃ,bhikkhunovadakasammutikammam,1,1,0,0,28
662803,adhammakamme,adhammakamme,148,142,6,0,12
662804,avasānapade,avasanapade,2,2,0,0,11
662805,dentoti,dentoti,3,0,3,0,7
662806,garudhammānaṃ,garudhammanam,3,3,0,0,13
662807,garudhammapāḷiyā,garudhammapaliya,2,2,0,0,16
662808,kathentoti,kathentoti,7,1,6,0,10
662809,osārehi,osarehi,5,4,1,0,7
662810,osāretīti,osaretiti,9,3,6,0,9
662811,aṭṭhagarudhammapāḷiṃ,atthagarudhammapalim,2,2,0,0,20
662812,P4.0801,P4.0801,1,1,0,0,7
662813,osārehīti,osarehiti,3,1,2,0,9
662814,garudhammanissitaṃ,garudhammanissitam,2,2,0,0,18
662815,khandhādinissitaṃ,khandhadinissitam,2,2,0,0,17
662816,desentassāpi,desentassapi,1,1,0,0,12
662817,ovādasikkhāpadaṃ,ovadasikkhapadam,5,5,0,0,16
662818,atthaṅgatasikkhāpadavaṇṇanā,atthangatasikkhapadavannana,11,11,0,0,27
662819,P4.0802,P4.0802,1,1,0,0,7
662820,kasiṇugghāṭime,kasinugghatime,2,2,0,0,14
662821,rūpaparicchede,rupaparicchede,4,3,1,0,14
662822,tiṭṭhatipīti,titthatipiti,1,0,1,0,12
662823,dhammabahumānaṃ,dhammabahumanam,1,1,0,0,15
662824,antaradhāyatipī,antaradhayatipi,2,2,0,0,15
662825,antaradhāyatipīti,antaradhayatipiti,2,0,2,0,17
662826,antaradhāyatipi,antaradhayatipi,3,3,0,0,15
662827,adassanampi,adassanampi,1,1,0,0,11
662828,bhātutherassa,bhatutherassa,1,1,0,0,13
662829,sajjhāyi,sajjhayi,1,1,0,0,8
662830,kattumasakkhi,kattumasakkhi,1,1,0,0,13
662831,parimajjāhī,parimajjahi,1,1,0,0,11
662832,parimajjitaṭṭhānaṃ,parimajjitatthanam,1,1,0,0,18
662833,kāḷakamahosi,kalakamahosi,1,1,0,0,12
662834,parisuddhampi,parisuddhampi,1,1,0,0,13
662835,āraddhavīriyabhāvaṃ,araddhaviriyabhavam,1,1,0,0,19
662836,mamāyanabhāvaṃ,mamayanabhavam,2,2,0,0,14
662837,P4.0803,P4.0803,1,1,0,0,7
662838,padasodhammasamuṭṭhānameva,padasodhammasamutthanameva,1,1,0,0,26
662839,atthaṅgatasikkhāpadaṃ,atthangatasikkhapadam,5,5,0,0,21
662840,bhikkhunupassayasikkhāpadavaṇṇanā,bhikkhunupassayasikkhapadavannana,11,11,0,0,33
662841,pācittiyassātiādīsu,pacittiyassatiadisu,2,0,2,0,19
662842,bhikkhunupassayasikkhāpadaṃ,bhikkhunupassayasikkhapadam,5,5,0,0,27
662843,asammato,asammato,25,22,3,0,8
662844,asammatamūlakaṃ,asammatamulakam,1,1,0,0,15
662845,ovadanamūlakaṃ,ovadanamulakam,7,7,0,0,14
662846,sammatassa,sammatassa,21,20,1,0,10
662847,P4.0804,P4.0804,1,1,0,0,7
662848,asammatassa,asammatassa,12,11,1,0,11
662849,āpattānāpattiyo,apattanapattiyo,1,1,0,0,15
662850,āmisasikkhāpadavaṇṇanā,amisasikkhapadavannana,11,11,0,0,22
662851,bahukatāti,bahukatati,1,0,1,0,10
662852,katabahumānā,katabahumana,1,1,0,0,12
662853,bhikkhunovādakaṃ,bhikkhunovadakam,15,14,1,0,16
662854,asammatoti,asammatoti,2,1,1,0,10
662855,āmisasikkhāpadaṃ,amisasikkhapadam,5,5,0,0,16
662856,cīvaradānasikkhāpadavaṇṇanā,civaradanasikkhapadavannana,9,9,0,0,27
662857,visikhāyāti,visikhayati,1,0,1,0,11
662858,nibaddhacāravasena,nibaddhacaravasena,1,1,0,0,18
662859,sandiṭṭhamittā,sanditthamitta,1,1,0,0,14
662860,cīvarapaṭiggahaṇasikkhāpade,civarapatiggahanasikkhapade,3,3,0,0,27
662861,cīvaradānasikkhāpadaṃ,civaradanasikkhapadam,7,7,0,0,21
662862,cīvarasibbanasikkhāpadavaṇṇanā,civarasibbanasikkhapadavannana,14,14,0,0,30
662863,vippakatamethunaṃ,vippakatamethunam,1,1,0,0,17
662864,itthipurisarūpamakāsi,itthipurisarupamakasi,1,1,0,0,21
662865,yathāsaṃhaṭaṃ,yathasamhatam,5,3,2,0,13
662866,yathāsaṃharitameva,yathasamharitameva,1,1,0,0,18
662867,nivāsituṃ,nivasitum,3,3,0,0,9
662868,P4.0805,P4.0805,1,1,0,0,7
662869,sibbissāmīti,sibbissamiti,1,1,0,0,12
662870,vicārentassāpi,vicarentassapi,1,1,0,0,14
662871,sibbantassa,sibbantassa,7,7,0,0,11
662872,ārāpathe,arapathe,13,10,3,0,8
662873,ārāpatheti,arapatheti,1,0,1,0,10
662874,sakalasūciṃ,sakalasucim,2,2,0,0,11
662875,dīghasuttappavesanatthaṃ,dighasuttappavesanattham,2,2,0,0,24
662876,sibbā,sibba,6,5,1,0,5
662877,sambahulānipi,sambahulanipi,4,4,0,0,13
662878,ñātikānaṃ,natikanam,4,4,0,0,9
662879,sibbantesu,sibbantesu,1,1,0,0,10
662880,kathinavattaṃ,kathinavattam,10,7,3,0,13
662881,ārāpathagaṇanāya,arapathagananaya,1,1,0,0,16
662882,sibbāpenti,sibbapenti,3,3,0,0,10
662883,ñātikāya,natikaya,50,49,1,0,8
662884,aññātikasaññāya,annatikasannaya,1,1,0,0,15
662885,sibbitattā,sibbitatta,2,2,0,0,10
662886,niyojitattā,niyojitatta,5,3,2,0,11
662887,sibbāpetabbaṃ,sibbapetabbam,1,1,0,0,13
662888,upāhanatthavikādiṃ,upahanatthavikadim,3,2,1,0,18
662889,cīvarasibbanasikkhāpadaṃ,civarasibbanasikkhapadam,6,6,0,0,24
662890,saṃvidhānasikkhāpadavaṇṇanā,samvidhanasikkhapadavannana,18,18,0,0,27
662891,dūsayiṃsu,dusayimsu,1,1,0,0,9
662892,pāpayiṃsūti,papayimsuti,1,1,0,0,11
662893,P4.0806,P4.0806,1,1,0,0,7
662894,saṃvidhāyāti,samvidhayati,19,2,17,0,12
662895,kukkuṭasampādeti,kukkutasampadeti,1,0,1,0,16
662896,kukkuṭasampādoti,kukkutasampadoti,1,1,0,0,16
662897,sampadanti,sampadanti,3,3,0,0,10
662898,sampādo,sampado,3,2,1,0,7
662899,sampādoti,sampadoti,1,1,0,0,9
662900,kukkuṭasampāte,kukkutasampate,9,9,0,0,14
662901,gehacchadanapiṭṭhito,gehacchadanapitthito,1,1,0,0,20
662902,gehacchadanapiṭṭhiyaṃ,gehacchadanapitthiyam,1,1,0,0,21
662903,kukkuṭasampātoti,kukkutasampatoti,1,1,0,0,16
662904,vuttappakāropi,vuttappakaropi,1,1,0,0,14
662905,sampuṇṇaraṭṭhe,sampunnaratthe,1,1,0,0,14
662906,ratanamattantaro,ratanamattantaro,2,1,1,0,16
662907,ṭhapitaupacāro,thapitaupacaro,1,1,0,0,14
662908,saṃvidhānakāle,samvidhanakale,1,1,0,0,14
662909,antarārāme,antararame,15,14,1,0,10
662910,titthiyaseyyāya,titthiyaseyyaya,4,4,0,0,15
662911,saṃvidahanapaccayā,samvidahanapaccaya,3,3,0,0,18
662912,bhikkhunupassayadvāre,bhikkhunupassayadvare,2,2,0,0,21
662913,catukkasiṅghāṭakahatthisālādīsu,catukkasinghatakahatthisaladisu,3,3,0,0,31
662914,anantaragāmassa,anantaragamassa,5,5,0,0,15
662915,upacārokkamane,upacarokkamane,7,7,0,0,14
662916,P4.0807,P4.0807,1,1,0,0,7
662917,saṃvidahitepi,samvidahitepi,4,4,0,0,13
662918,gāmūpacāragaṇanāya,gamupacaragananaya,4,4,0,0,18
662919,sesaaṭṭhakathāya,sesaatthakathaya,2,1,1,0,16
662920,addhayojaneti,addhayojaneti,1,0,1,0,13
662921,atikkamissatīti,atikkamissatiti,1,1,0,0,15
662922,gatapubbatthā,gatapubbattha,1,1,0,0,13
662923,bhikkhunīyeva,bhikkhuniyeva,3,3,0,0,13
662924,visaṅketenāti,visanketenati,6,0,6,0,13
662925,kālavisaṅketeyeva,kalavisanketeyeva,3,3,0,0,17
662926,dvāravisaṅkete,dvaravisankete,2,2,0,0,14
662927,maggavisaṅkete,maggavisankete,3,3,0,0,14
662928,raṭṭhabhede,ratthabhede,4,4,0,0,11
662929,saṃvidhānasikkhāpadaṃ,samvidhanasikkhapadam,10,10,0,0,21
662930,nāvābhiruhanasikkhāpadavaṇṇanā,navabhiruhanasikkhapadavannana,11,11,0,0,30
662931,P4.0808,P4.0808,1,1,0,0,7
662932,lokassādamittasanthavavasena,lokassadamittasanthavavasena,10,9,1,0,28
662933,kīḷāpurekkhārā,kilapurekkhara,3,2,1,0,14
662934,uddhaṃgāminiṃ,uddhamgaminim,15,10,5,0,13
662935,ujjavanikāya,ujjavanikaya,3,3,0,0,12
662936,ujjavanikāyā,ujjavanikaya,2,2,0,0,12
662937,adhogāminiṃ,adhogaminim,13,8,5,0,11
662938,ojavanikāya,ojavanikaya,2,2,0,0,11
662939,tenassāpi,tenassapi,1,1,0,0,9
662940,ojavanikāyā,ojavanikaya,1,1,0,0,11
662941,titthasampaṭipādanatthaṃ,titthasampatipadanattham,1,1,0,0,24
662942,gāmantareti,gamantareti,1,0,1,0,11
662943,kukkuṭasampādagāmehi,kukkutasampadagamehi,1,1,0,0,20
662944,sagāmakatīrapassena,sagamakatirapassena,3,2,1,0,19
662945,gāmantaragaṇanāya,gamantaragananaya,7,7,0,0,17
662946,agāmakatīrapassena,agamakatirapassena,3,3,0,0,18
662947,addhayojanagaṇanāya,addhayojanagananaya,11,9,2,0,19
662948,mahātitthapaṭṭanato,mahatitthapattanato,1,1,0,0,19
662949,nadiyaṃyeva,nadiyamyeva,3,3,0,0,11
662950,kālavisaṅketeneva,kalavisanketeneva,4,4,0,0,17
662951,titthavisaṅketena,titthavisanketena,2,2,0,0,17
662952,nāvāvisaṅketena,navavisanketena,2,2,0,0,15
662953,paṭhamasikkhāpadasadisameva,pathamasikkhapadasadisameva,1,1,0,0,27
662954,nāvābhiruhanasikkhāpadaṃ,navabhiruhanasikkhapadam,5,5,0,0,24
662955,paripācitasikkhāpadavaṇṇanā,paripacitasikkhapadavannana,11,11,0,0,27
662956,tiṭṭhamāneti,titthamaneti,1,0,1,0,12
662957,tiṭṭhamānesūti,titthamanesuti,1,1,0,0,14
662958,avasānassa,avasanassa,1,1,0,0,10
662959,pattakathā,pattakatha,2,2,0,0,10
662960,addhacchikena,addhacchikena,1,1,0,0,13
662961,P4.0809,P4.0809,1,1,0,0,7
662962,paripācitaṃ,paripacitam,17,15,2,0,11
662963,bhikkhuniñca,bhikkhuninca,18,18,0,0,12
662964,paripācanākārañca,paripacanakaranca,1,1,0,0,17
662965,adātukāmānaṃ,adatukamanam,3,3,0,0,12
662966,gihisamārambhāti,gihisamarambhati,3,0,3,0,16
662967,samārambhoti,samarambhoti,5,2,3,0,12
662968,samāraddhaṃ,samaraddham,5,4,1,0,11
662969,paṭiyāditassetaṃ,patiyaditassetam,2,2,0,0,16
662970,gihisamārambho,gihisamarambho,5,3,2,0,14
662971,paripācanato,paripacanato,4,4,0,0,12
662972,ñātakapavāritehi,natakapavaritehi,1,1,0,0,16
662973,bhikkhussatthāya,bhikkhussatthaya,5,5,0,0,16
662974,asamāraddhopi,asamaraddhopi,2,2,0,0,13
662975,samāraddhova,samaraddhova,3,3,0,0,12
662976,āharāpetabbato,aharapetabbato,1,1,0,0,14
662977,yāgukhajjakaphalāphale,yagukhajjakaphalaphale,1,1,0,0,22
662978,bhikkhuniparipācitepi,bhikkhuniparipacitepi,2,2,0,0,21
662979,paripācitasikkhāpadaṃ,paripacitasikkhapadam,5,5,0,0,21
662980,rahonisajjasikkhāpadavaṇṇanā,rahonisajjasikkhapadavannana,12,12,0,0,28
662981,dutiyaaniyate,dutiyaaniyate,2,2,0,0,13
662982,dutiyāniyatena,dutiyaniyatena,1,1,0,0,14
662983,upanandhassa,upanandhassa,1,1,0,0,12
662984,catutthasikkhāpadena,catutthasikkhapadena,3,3,0,0,20
662985,ekaparicchedaṃ,ekaparicchedam,9,9,0,0,14
662986,rahonisajjasikkhāpadaṃ,rahonisajjasikkhapadam,17,17,0,0,22
662987,bhikkhunivaggo,bhikkhunivaggo,5,5,0,0,14
662988,bhojanavaggo,bhojanavaggo,27,27,0,0,12
662989,āvasathapiṇḍasikkhāpadavaṇṇanā,avasathapindasikkhapadavannana,7,7,0,0,30
662990,bhojanavaggassa,bhojanavaggassa,4,4,0,0,15
662991,āvasathapiṇḍoti,avasathapindoti,4,0,4,0,15
662992,addhikagilānagabbhinipabbajitānaṃ,addhikagilanagabbhinipabbajitanam,1,1,0,0,33
662993,P4.0810,P4.0810,1,1,0,0,7
662994,paññattamañcapīṭhaṃ,pannattamancapitham,2,2,0,0,19
662995,anekagabbhapamukhaparicchedaṃ,anekagabbhapamukhaparicchedam,1,1,0,0,29
662996,yāgubhattabhesajjādi,yagubhattabhesajjadi,1,1,0,0,20
662997,hiyyopīti,hiyyopiti,1,0,1,0,9
662998,apasakkantīti,apasakkantiti,1,0,1,0,13
662999,kukkuccāyantoti,kukkuccayantoti,2,0,2,0,15
663000,āvasathā,avasatha,6,5,1,0,8
663001,anodissāti,anodissati,7,1,6,0,10
663002,ekakulena,ekakulena,4,4,0,0,9
663003,aniyamitaṭṭhāne,aniyamitatthane,1,1,0,0,15
663004,ekapūganānāpūgaekagāmanānāgāmesupi,ekapugananapugaekagamananagamesupi,2,2,0,0,34
663005,nānākulānaṃ,nanakulanam,3,3,0,0,11
663006,kalyāṇacitte,kalyanacitte,2,2,0,0,12
663007,gilānassāti,gilanassati,11,2,9,0,11
663008,P4.0811,P4.0811,1,1,0,0,7
663009,corādibhayaṃ,coradibhayam,4,4,0,0,12
663010,yāgukhajjakaphalāphalādibhede,yagukhajjakaphalaphaladibhede,1,1,0,0,29
663011,āvasathapiṇḍasikkhāpadaṃ,avasathapindasikkhapadam,5,5,0,0,24
663012,gaṇabhojanasikkhāpadavaṇṇanā,ganabhojanasikkhapadavannana,13,13,0,0,28
663013,parihīnalābhasakkāroti,parihinalabhasakkaroti,1,0,1,0,22
663014,yojetvāpi,yojetvapi,4,4,0,0,9
663015,guḷhapaṭicchanno,gulhapaticchanno,1,1,0,0,16
663016,abhimārepi,abhimarepi,1,1,0,0,10
663017,sāsanakaṇṭakaṃ,sasanakantakam,3,2,1,0,14
663018,nagarasaṅkhobhaṃ,nagarasankhobham,1,1,0,0,16
663019,bhijjī,bhijji,7,7,0,0,6
663020,niṭṭhāpente,nitthapente,1,1,0,0,11
663021,P4.0812,P4.0812,1,1,0,0,7
663022,nānāverajjaketi,nanaverajjaketi,3,0,3,0,15
663023,aññarajjehi,annarajjehi,3,2,1,0,11
663024,nānāvirajjake,nanavirajjake,1,1,0,0,13
663025,para217-8,para217-8,4,4,0,0,9
663026,gaṇabhojaneti,ganabhojaneti,4,0,4,0,13
663027,nimantanato,nimantanato,23,20,3,0,11
663028,viññattito,vinnattito,25,22,3,0,10
663029,ākaṅkhatha,akankhatha,5,5,0,0,10
663030,paṭimānethā,patimanetha,3,3,0,0,11
663031,pitarāti,pitarati,4,4,0,0,8
663032,viññāpeyyuṃ,vinnapeyyum,4,4,0,0,11
663033,mahācammassa,mahacammassa,3,3,0,0,12
663034,P4.0813,P4.0813,1,1,0,0,7
663035,gilānasamayoti,gilanasamayoti,3,2,1,0,14
663036,lesakappiyaṃ,lesakappiyam,3,2,1,0,12
663037,kayiramāneti,kayiramaneti,4,1,3,0,12
663038,mahāpaccariyañhi,mahapaccariyanhi,1,1,0,0,16
663039,sūcivedhanako,sucivedhanako,1,1,0,0,13
663040,cīvarakārasamayoti,civarakarasamayoti,3,2,1,0,18
663041,moghasuttaṃ,moghasuttam,3,2,1,0,11
663042,valeti,valeti,2,2,0,0,6
663043,cīvarakārako,civarakarako,4,4,0,0,12
663044,gacchantenāti,gacchantenati,3,0,3,0,13
663045,addhayojanabbhantare,addhayojanabbhantare,13,13,0,0,20
663046,nāvābhiruhanepi,navabhiruhanepi,1,1,0,0,15
663047,abhiruḷhena,abhirulhena,2,2,0,0,11
663048,antimaparicchedo,antimaparicchedo,2,2,0,0,16
663049,paribbājakasamāpannoti,paribbajakasamapannoti,4,2,2,0,22
663050,samaṇabhattasamayo,samanabhattasamayo,12,7,5,0,18
663051,animantitacatutthaṃ,animantitacatuttham,11,6,5,0,19
663052,piṇḍapātikacatutthaṃ,pindapatikacatuttham,2,2,0,0,20
663053,anupasampannacatutthaṃ,anupasampannacatuttham,2,2,0,0,22
663054,pattacatutthaṃ,pattacatuttham,2,2,0,0,14
663055,gilānacatutthanti,gilanacatutthanti,2,2,0,0,17
663056,P4.0814,P4.0814,1,1,0,0,7
663057,taṅkhaṇappattaṃ,tankhanappattam,2,1,1,0,15
663058,gaṇapūrakassa,ganapurakassa,2,2,0,0,13
663059,animantitattā,animantitatta,5,5,0,0,13
663060,piṇḍapātikacatutthe,pindapatikacatutthe,2,1,1,0,19
663061,nimantanakāle,nimantanakale,3,3,0,0,13
663062,anadhivāsitattā,anadhivasitatta,2,2,0,0,15
663063,anupasampannacatutthe,anupasampannacatutthe,2,1,1,0,21
663064,pattacatutthe,pattacatutthe,2,1,1,0,13
663065,gilānacatutthe,gilanacatutthe,3,2,1,0,14
663066,gilānena,gilanena,49,48,1,0,8
663067,samayaladdhako,samayaladdhako,4,4,0,0,14
663068,gaṇapūrakattā,ganapurakatta,5,5,0,0,13
663069,cīvaradānasamayaladdhakādīnampi,civaradanasamayaladdhakadinampi,2,2,0,0,31
663070,sādiyathā,sadiyatha,2,2,0,0,9
663071,yāgukhajjakāvasāne,yagukhajjakavasane,2,2,0,0,18
663072,bhojanānaṃyeva,bhojananamyeva,2,2,0,0,14
663073,P4.0815,P4.0815,1,1,0,0,7
663074,bhattuddesakena,bhattuddesakena,12,10,2,0,15
663075,nemantanikā,nemantanika,2,1,1,0,11
663076,gaṇabhojanato,ganabhojanato,4,4,0,0,13
663077,addhamāsampi,addhamasampi,1,1,0,0,12
663078,piṇḍapātike,pindapatike,3,3,0,0,11
663079,bhattamevā,bhattameva,2,2,0,0,10
663080,bhattenattho,bhattenattho,4,4,0,0,12
663081,nibaddhagocaro,nibaddhagocaro,2,2,0,0,14
663082,apaṇḍitamanusso,apanditamanusso,3,3,0,0,15
663083,P4.0816,P4.0816,1,1,0,0,7
663084,dubbacehi,dubbacehi,3,3,0,0,9
663085,bhojentesu,bhojentesu,2,2,0,0,10
663086,rathikāsu,rathikasu,2,2,0,0,9
663087,bhattasālāya,bhattasalaya,4,4,0,0,12
663088,piṇḍacārike,pindacarike,4,4,0,0,11
663089,āsanasālato,asanasalato,7,7,0,0,11
663090,niccabhattanti,niccabhattanti,1,1,0,0,14
663091,dhuvabhattaṃ,dhuvabhattam,5,5,0,0,12
663092,salākabhattādīsupi,salakabhattadisupi,2,2,0,0,18
663093,gaṇabhojanasikkhāpadaṃ,ganabhojanasikkhapadam,9,9,0,0,22
663094,paramparabhojanasikkhāpadavaṇṇanā,paramparabhojanasikkhapadavannana,17,17,0,0,33
663095,yathayime,yathayime,9,8,1,0,9
663096,P4.0817,P4.0817,1,1,0,0,7
663097,kirapatikoti,kirapatikoti,3,1,2,0,12
663098,adhipaccaṭṭhena,adhipaccatthena,1,1,0,0,15
663099,kirapatiko,kirapatiko,5,5,0,0,10
663100,māsautusaṃvaccharaniyāmena,masautusamvaccharaniyamena,1,1,0,0,26
663101,paṭiyattāti,patiyattati,3,1,2,0,11
663102,badaramissenāti,badaramissenati,1,0,1,0,15
663103,badarasāḷavena,badarasalavena,1,1,0,0,14
663104,āhariyitthāti,ahariyitthati,1,0,1,0,13
663105,bhattapaccāsaṃ,bhattapaccasam,16,15,1,0,14
663106,bhattavikappanā,bhattavikappana,3,3,0,0,15
663107,parammukhāvikappanāva,parammukhavikappanava,1,1,0,0,21
663108,gaṇappahonake,ganappahonake,1,1,0,0,13
663109,agaṇapūrakattā,aganapurakatta,1,1,0,0,14
663110,ekapatte,ekapatte,1,1,0,0,8
663111,ekamissakaṃ,ekamissakam,4,4,0,0,11
663112,mūlanimantanaṃ,mulanimantanam,6,3,3,0,14
663113,paṭhamanimantanato,pathamanimantanato,3,3,0,0,18
663114,ajjhotthataṃ,ajjhotthatam,6,6,0,0,12
663115,P4.0818,P4.0818,1,1,0,0,7
663116,laddhamaṃsakhaṇḍaṃ,laddhamamsakhandam,2,2,0,0,18
663117,sappipāyāsepi,sappipayasepi,2,2,0,0,13
663118,puttadārabhātikabhaginiādayopi,puttadarabhatikabhaginiadayopi,1,1,0,0,30
663119,pakkabhattato,pakkabhattato,2,2,0,0,13
663120,nimantitamhāti,nimantitamhati,3,2,1,0,14
663121,nimantitattā,nimantitatta,9,9,0,0,12
663122,gāmenāti,gamenati,1,0,1,0,8
663123,nimantitasseva,nimantitasseva,3,3,0,0,14
663124,pūgepi,pugepi,3,3,0,0,6
663125,P4.0819,P4.0819,1,1,0,0,7
663126,animantanaṃ,animantanam,4,4,0,0,11
663127,cārittato,carittato,2,2,0,0,9
663128,avikappanaṃ,avikappanam,5,4,1,0,11
663129,paramparabhojanasikkhāpadaṃ,paramparabhojanasikkhapadam,7,7,0,0,27
663130,kāṇamātāsikkhāpadavaṇṇanā,kanamatasikkhapadavannana,14,14,0,0,25
663131,kāṇamātāti,kanamatati,2,0,2,0,10
663132,rāgandhā,ragandha,1,1,0,0,8
663133,kāṇabhāvakaraṇato,kanabhavakaranato,1,1,0,0,17
663134,rittahatthaṃ,rittahattham,5,4,1,0,12
663135,kāṇāpi,kanapi,2,2,0,0,6
663136,appaññatteyeva,appannatteyeva,1,1,0,0,14
663137,pātheyyavatthu,patheyyavatthu,1,1,0,0,14
663138,paheṇakatthāyāti,pahenakatthayati,4,1,3,0,16
663139,atirasakamodakasakkhalikādi,atirasakamodakasakkhalikadi,1,1,0,0,27
663140,pūvotveva,puvotveva,1,1,0,0,9
663141,P4.0820,P4.0820,1,1,0,0,7
663142,pātheyyatthāyāti,patheyyatthayati,3,0,3,0,16
663143,antarāmaggatthāya,antaramaggatthaya,2,2,0,0,17
663144,baddhasattuabaddhasattutilataṇḍulādi,baddhasattuabaddhasattutilatanduladi,2,2,0,0,36
663145,manthotveva,manthotveva,2,2,0,0,11
663146,pūvagaṇanāya,puvagananaya,4,3,1,0,12
663147,dvattipattapūre,dvattipattapure,15,10,5,0,15
663148,heṭṭhimalekhāya,hetthimalekhaya,3,3,0,0,15
663149,samapūre,samapure,2,2,0,0,8
663150,dvattipattapūrāti,dvattipattapurati,2,0,2,0,17
663151,paramparārocane,parampararocane,2,2,0,0,15
663152,chaḍḍitasālā,chadditasala,1,1,0,0,12
663153,sambhattānaṃ,sambhattanam,3,3,0,0,12
663154,ekanikāyikānaṃ,ekanikayikanam,2,1,1,0,14
663155,nibaddhanisīdanaṭṭhānaṃ,nibaddhanisidanatthanam,1,1,0,0,23
663156,saṃvibhajitabbaṃ,samvibhajitabbam,11,8,3,0,16
663157,paṭippassaddheti,patippassaddheti,2,0,2,0,16
663158,pesissāma,pesissama,2,2,0,0,9
663159,pātheyyapaheṇakatthāya,patheyyapahenakatthaya,2,2,0,0,22
663160,paṭiyattato,patiyattato,2,2,0,0,11
663161,P4.0821,P4.0821,1,1,0,0,7
663162,kāṇamātāsikkhāpadaṃ,kanamatasikkhapadam,2,2,0,0,19
663163,paṭhamapavāraṇasikkhāpadavaṇṇanā,pathamapavaranasikkhapadavannana,3,3,0,0,32
663164,pavāritāti,pavaritati,8,1,7,0,10
663165,paṭikkhepapavāraṇāya,patikkhepapavaranaya,3,2,1,0,20
663166,paṭivissaketi,pativissaketi,1,0,1,0,13
663167,sāmantagharavāsike,samantagharavasike,2,2,0,0,18
663168,kākoravasaddaṃ,kakoravasaddam,4,2,2,0,14
663169,oravasaddaṃ,oravasaddam,6,2,4,0,11
663170,tikāraṃ,tikaram,3,1,2,0,7
663171,para238-9,para238-9,3,3,0,0,9
663172,asaṅkhāditvā,asankhaditva,3,3,0,0,12
663173,katapavāraṇo,katapavarano,4,2,2,0,12
663174,katapaṭikkhepo,katapatikkhepo,2,1,1,0,14
663175,paṭikkhepamattena,patikkhepamattena,3,3,0,0,17
663176,pañcaṅgavasena,pancangavasena,3,3,0,0,14
663177,bhuttāvīvacanena,bhuttavivacanena,1,1,0,0,16
663178,chappañcavācāhī,chappancavacahi,3,2,1,0,15
663179,dirattādivacanaṃ,dirattadivacanam,2,2,0,0,16
663180,pavāritapadassa,pavaritapadassa,2,2,0,0,15
663181,parivārakabhāvena,parivarakabhavena,2,2,0,0,17
663182,paññāyatītiādīsu,pannayatitiadisu,1,0,1,0,16
663183,vippakatabhojanaṃ,vippakatabhojanam,11,11,0,0,17
663184,pavāraṇappahonakabhojanaṃ,pavaranappahonakabhojanam,4,4,0,0,25
663185,pavāraṇappahonakaṃ,pavaranappahonakam,13,12,1,0,18
663186,aḍḍhateyyahatthappamāṇe,addhateyyahatthappamane,5,5,0,0,23
663187,P4.0822,P4.0822,1,1,0,0,7
663188,nīvāraṃ,nivaram,3,3,0,0,7
663189,sālijāti,salijati,5,5,0,0,8
663190,yavagodhumesu,yavagodhumesu,4,1,3,0,13
663191,kaṅgū,kangu,1,0,1,0,5
663192,setarattakāḷabhedā,setarattakalabheda,6,6,0,0,18
663193,kaṅgujāti,kangujati,5,5,0,0,9
663194,varakajāti,varakajati,3,3,0,0,10
663195,sāmākādibhedā,samakadibheda,3,3,0,0,13
663196,nīvāravarakacorakā,nivaravarakacoraka,3,3,0,0,18
663197,dhaññānulomā,dhannanuloma,2,2,0,0,12
663198,dhaññānulomāni,dhannanulomani,2,2,0,0,14
663199,pacissāmā,pacissama,8,8,0,0,9
663200,ambilapāyāsādīsu,ambilapayasadisu,3,3,0,0,16
663201,odanasaṅgahameva,odanasangahameva,2,2,0,0,16
663202,yāgusaṅgahaṃ,yagusangaham,6,6,0,0,12
663203,paṇṇaphalakaḷīramissakā,pannaphalakaliramissaka,2,2,0,0,23
663204,ambilayāgu,ambilayagu,6,5,1,0,10
663205,gahitokāsepi,gahitokasepi,4,4,0,0,12
663206,sītalībhūtā,sitalibhuta,2,2,0,0,11
663207,dadhitakkādīni,dadhitakkadini,2,2,0,0,14
663208,bahupaṇṇaphalakaḷīre,bahupannaphalakalire,1,1,0,0,20
663209,muṭṭhimattāpi,mutthimattapi,3,3,0,0,13
663210,ayāguke,ayaguke,9,9,0,0,7
663211,P4.0823,P4.0823,1,1,0,0,7
663212,udakakañjikakhīrādīni,udakakanjikakhiradini,7,6,1,0,21
663213,pakkuthitesu,pakkuthitesu,4,4,0,0,12
663214,yāgusaṅgahameva,yagusangahameva,6,6,0,0,15
663215,suddharasako,suddharasako,3,3,0,0,12
663216,rasakayāgu,rasakayagu,3,3,0,0,10
663217,vuttadhaññānaṃ,vuttadhannanam,3,3,0,0,14
663218,veṇutaṇḍulādīhi,venutanduladihi,3,3,0,0,15
663219,kandamūlaphalehi,kandamulaphalehi,3,3,0,0,16
663220,ghanayāgu,ghanayagu,4,4,0,0,9
663221,pupphaatthāya,pupphaatthaya,1,1,0,0,13
663222,pupphiatthāya,pupphiatthaya,3,3,0,0,13
663223,pupphikhajjakatthāya,pupphikhajjakatthaya,2,2,0,0,20
663224,kuthitatūdake,kuthitatudake,1,1,0,0,13
663225,seditataṇḍulā,seditatandula,2,2,0,0,13
663226,sattusaṅkhyaṃ,sattusankhyam,4,4,0,0,13
663227,bhattasaṅkhyaṃ,bhattasankhyam,3,3,0,0,14
663228,katabhattaṃ,katabhattam,4,4,0,0,11
663229,pavāretiyeva,pavaretiyeva,9,9,0,0,12
663230,sappitelādīsu,sappiteladisu,3,3,0,0,13
663231,katasattubhattādīni,katasattubhattadini,2,2,0,0,19
663232,katakummāso,katakummaso,6,6,0,0,11
663233,muggādīhi,muggadihi,5,5,0,0,9
663234,sālivīhiyavehi,salivihiyavehi,4,2,2,0,14
663235,kaṅguvarakakudrūsakasīsānipi,kanguvarakakudrusakasisanipi,2,2,0,0,28
663236,allattā,allatta,2,2,0,0,7
663237,sattusaṅgahameva,sattusangahameva,7,5,2,0,16
663238,kharapākabhajjitānaṃ,kharapakabhajjitanam,8,7,1,0,20
663239,samapākabhajjitānaṃ,samapakabhajjitanam,10,10,0,0,19
663240,vīhipalāpānaṃ,vihipalapanam,1,1,0,0,13
663241,bhajjitataṇḍulā,bhajjitatandula,3,3,0,0,15
663242,P4.0824,P4.0824,1,1,0,0,7
663243,kuṇḍakampi,kundakampi,6,6,0,0,10
663244,ātapasukkhānaṃ,atapasukkhanam,6,6,0,0,14
663245,katabhattasattuādīni,katabhattasattuadini,3,3,0,0,20
663246,bhajjitapiṭṭhaṃ,bhajjitapittham,3,2,1,0,15
663247,suddhakhajjakaṃ,suddhakhajjakam,3,2,1,0,15
663248,macchamaṃsapūritakhajjakaṃ,macchamamsapuritakhajjakam,2,2,0,0,26
663249,sattumodako,sattumodako,3,2,1,0,11
663250,yāgusitthamattāneva,yagusitthamattaneva,4,4,0,0,19
663251,macchakhaṇḍāni,macchakhandani,2,2,0,0,14
663252,maṃsakhaṇḍāni,mamsakhandani,2,2,0,0,13
663253,avatthutāya,avatthutaya,5,5,0,0,11
663254,paṭikkhipitabbaṭṭhāne,patikkhipitabbatthane,11,10,1,0,21
663255,maṃsabhāvaṃ,mamsabhavam,8,8,0,0,11
663256,kuladūsakavejjakammauttarimanussadhammārocanasāditarūpiyādīhi,kuladusakavejjakammauttarimanussadhammarocanasaditarupiyadihi,2,2,0,0,61
663257,P4.0825,P4.0825,1,1,0,0,7
663258,pattamukhahatthānaṃ,pattamukhahatthanam,2,2,0,0,19
663259,āmisagandhamattaṃ,amisagandhamattam,2,2,0,0,17
663260,vippakatabhojanabhāvassa,vippakatabhojanabhavassa,6,6,0,0,24
663261,mukhepi,mukhepi,3,3,0,0,7
663262,vijjamānabhojanaṃ,vijjamanabhojanam,2,2,0,0,17
663263,anajjhoharitukāmo,anajjhoharitukamo,3,3,0,0,17
663264,vighāsādassa,vighasadassa,3,3,0,0,12
663265,pacchimantato,pacchimantato,8,8,0,0,13
663266,paṇhiantato,panhiantato,6,6,0,0,11
663267,pārimantato,parimantato,12,12,0,0,11
663268,aḍḍhateyyahattho,addhateyyahattho,14,13,1,0,16
663269,paṭikkhipantasseva,patikkhipantasseva,3,3,0,0,18
663270,hatthapāsabbhantare,hatthapasabbhantare,6,6,0,0,19
663271,anantaranisinnopi,anantaranisinnopi,3,3,0,0,17
663272,ṭhitapattaṃ,thitapattam,2,2,0,0,11
663273,anabhiharitvāva,anabhiharitvava,2,2,0,0,15
663274,P4.0826,P4.0826,1,1,0,0,7
663275,bhattapacchiṃ,bhattapacchim,10,7,3,0,13
663276,daharabhikkhussa,daharabhikkhussa,3,3,0,0,16
663277,dūrabhāvato,durabhavato,9,7,2,0,11
663278,anabhiharaṇatoti,anabhiharanatoti,1,1,0,0,16
663279,odanapacchiṃ,odanapacchim,2,2,0,0,12
663280,abhihaṭāva,abhihatava,11,6,5,0,10
663281,parivisakena,parivisakena,1,1,0,0,12
663282,phuṭṭhamattāva,phutthamattava,3,3,0,0,14
663283,uddhaṭabhatte,uddhatabhatte,3,3,0,0,13
663284,kaṭacchuabhihāroyeva,katacchuabhiharoyeva,2,2,0,0,20
663285,samabhārepi,samabharepi,3,3,0,0,11
663286,pavāretiyevāti,pavaretiyevati,1,1,0,0,14
663287,macchikabījaniṃ,macchikabijanim,3,2,1,0,15
663288,bhamukāya,bhamukaya,9,9,0,0,9
663289,ākirantaṃ,akirantam,3,3,0,0,9
663290,ākira,akira,10,10,0,0,5
663291,P4.0827,P4.0827,1,1,0,0,7
663292,anākiraṇatthāya,anakiranatthaya,2,2,0,0,15
663293,abhiharantaṃ,abhiharantam,3,3,0,0,12
663294,samaṃsakaṃ,samamsakam,4,3,1,0,10
663295,maccharasaṃ,maccharasam,8,4,4,0,11
663296,maṃsarasaṃ,mamsarasam,17,13,4,0,10
663297,parissāvito,parissavito,3,3,0,0,11
663298,abhihārakassa,abhiharakassa,6,6,0,0,13
663299,kaḷīrapanasādīhi,kalirapanasadihi,4,4,0,0,16
663300,kaḷīrasūpaṃ,kalirasupam,3,3,0,0,11
663301,panasabyañjanaṃ,panasabyanjanam,4,4,0,0,15
663302,apavāraṇārahassa,apavaranarahassa,5,5,0,0,16
663303,macchasūpaṃ,macchasupam,5,3,2,0,11
663304,maṃsasūpaṃ,mamsasupam,4,3,1,0,10
663305,maṃsakarambako,mamsakarambako,4,2,2,0,14
663306,karambakaṃ,karambakam,7,6,1,0,10
663307,maṃsakarambakaṃ,mamsakarambakam,5,5,0,0,15
663308,macchamaṃsamissakesu,macchamamsamissakesu,2,2,0,0,20
663309,P4.0828,P4.0828,1,1,0,0,7
663310,pavāritova,pavaritova,6,5,1,0,10
663311,missakakathā,missakakatha,2,2,0,0,12
663312,bhattamissakaṃ,bhattamissakam,20,20,0,0,14
663313,yenāpucchito,yenapucchito,9,9,0,0,12
663314,yāgumissakaṃ,yagumissakam,13,12,1,0,12
663315,karambakena,karambakena,5,5,0,0,11
663316,karambako,karambako,8,7,1,0,9
663317,maṃsamissakopi,mamsamissakopi,2,2,0,0,14
663318,amaṃsamissakopi,amamsamissakopi,2,2,0,0,15
663319,bhattamissakameva,bhattamissakameva,2,2,0,0,17
663320,bahurase,bahurase,3,3,0,0,8
663321,bahukhīre,bahukhire,2,2,0,0,9
663322,bahusappimhi,bahusappimhi,2,2,0,0,12
663323,anupariyāyantena,anupariyayantena,4,4,0,0,16
663324,caṅkamantenava,cankamantenava,1,1,0,0,14
663325,upacchinditabbaṃ,upacchinditabbam,3,3,0,0,16
663326,hatthiassapiṭṭhe,hatthiassapitthe,2,2,0,0,16
663327,kopentena,kopentena,2,2,0,0,9
663328,ukkuṭikeneva,ukkutikeneva,3,3,0,0,12
663329,nisīdanakaṃ,nisidanakam,5,3,2,0,11
663330,P4.0829,P4.0829,1,1,0,0,7
663331,saṃsarituṃ,samsaritum,6,4,2,0,10
663332,nipanneneva,nipanneneva,4,4,0,0,11
663333,nātikkametabbaṃ,natikkametabbam,4,4,0,0,15
663334,kappiyakatādīhi,kappiyakatadihi,3,3,0,0,15
663335,vinayakammākārehi,vinayakammakarehi,12,12,0,0,17
663336,akappiyakataṃ,akappiyakatam,19,13,6,0,13
663337,kandamūlādi,kandamuladi,5,4,1,0,11
663338,akappiyakatanti,akappiyakatanti,1,1,0,0,15
663339,appaṭiggahitakataṃ,appatiggahitakatam,8,5,3,0,18
663340,appaṭiggahitaṃyeva,appatiggahitamyeva,3,3,0,0,18
663341,anuccāritakataṃ,anuccaritakatam,8,5,3,0,15
663342,anukkhittaṃ,anukkhittam,3,3,0,0,11
663343,anapanāmitaṃ,anapanamitam,3,3,0,0,12
663344,ahatthapāse,ahatthapase,10,7,3,0,11
663345,abhuttāvinā,abhuttavina,8,5,3,0,11
663346,abhuttena,abhuttena,6,5,1,0,9
663347,vuṭṭhitena,vutthitena,13,10,3,0,10
663348,gilānātirittaṃ,gilanatirittam,23,19,4,0,14
663349,anatirittanti,anatirittanti,2,2,0,0,13
663350,maṃsahīraṃ,mamsahiram,3,3,0,0,10
663351,bhuttāvināva,bhuttavinava,2,2,0,0,12
663352,avuṭṭhitenāti,avutthitenati,2,0,2,0,13
663353,P4.0830,P4.0830,1,1,0,0,7
663354,hatthadhovanakiccaṃ,hatthadhovanakiccam,2,2,0,0,19
663355,paṭhamabhājane,pathamabhajane,5,5,0,0,14
663356,kuṇḍepi,kundepi,2,2,0,0,7
663357,pacchiyampi,pacchiyampi,2,2,0,0,11
663358,onāmitabhājane,onamitabhajane,3,3,0,0,14
663359,appavāritānampi,appavaritanampi,5,5,0,0,15
663360,bhuñjanake,bhunjanake,2,2,0,0,10
663361,maṅgalanimantane,mangalanimantane,3,3,0,0,16
663362,yāmakālikādīsu,yamakalikadisu,8,6,2,0,14
663363,asaṃsaṭṭhavasena,asamsatthavasena,2,2,0,0,16
663364,P4.0831,P4.0831,1,1,0,0,7
663365,āmisasaṃsaṭṭhāni,amisasamsatthani,3,3,0,0,16
663366,anāhāratthāyapi,anaharatthayapi,3,3,0,0,15
663367,pipāsacchedanatthaṃ,pipasacchedanattham,4,4,0,0,19
663368,yāvajīvikañca,yavajivikanca,18,18,0,0,13
663369,upasametabbake,upasametabbake,2,2,0,0,14
663370,upasamanatthaṃ,upasamanattham,2,2,0,0,14
663371,paṭhamapavāraṇasikkhāpadaṃ,pathamapavaranasikkhapadam,2,2,0,0,26
663372,dutiyapavāraṇasikkhāpadavaṇṇanā,dutiyapavaranasikkhapadavannana,3,3,0,0,31
663373,upanandhīti,upanandhiti,3,0,3,0,11
663374,upanaddho,upanaddho,4,3,1,0,9
663375,janitaupanāho,janitaupanaho,2,2,0,0,13
663376,pavāritabhāvaṃ,pavaritabhavam,4,4,0,0,14
663377,āsādanāpekkhoti,asadanapekkhoti,6,0,6,0,15
663378,maṅkukaraṇabhāvaṃ,mankukaranabhavam,4,4,0,0,17
663379,abhihārakasseva,abhiharakasseva,1,1,0,0,15
663380,dutiyapavāraṇasikkhāpadaṃ,dutiyapavaranasikkhapadam,2,2,0,0,25
663381,vikālabhojanasikkhāpadavaṇṇanā,vikalabhojanasikkhapadavannana,13,13,0,0,30
663382,giraggasamajjoti,giraggasamajjoti,3,0,3,0,16
663383,aggasamajjo,aggasamajjo,3,3,0,0,11
663384,aggadese,aggadese,1,1,0,0,8
663385,P4.0832,P4.0832,1,1,0,0,7
663386,naṭanāṭakāni,natanatakani,4,1,3,0,12
663387,daharāva,daharava,2,2,0,0,8
663388,pūvakhādanīyādiṃ,puvakhadaniyadim,1,1,0,0,16
663389,para248-9,para248-9,4,4,0,0,9
663390,ṭhitamajjhanhikopi,thitamajjhanhikopi,3,3,0,0,18
663391,kālasaṅgahaṃ,kalasangaham,4,4,0,0,12
663392,kukkuccakena,kukkuccakena,5,5,0,0,12
663393,kālaparicchedajānanatthañca,kalaparicchedajananatthanca,4,4,0,0,27
663394,kālantareva,kalantareva,1,1,0,0,11
663395,sakkhalimodakādipubbaṇṇāparaṇṇamayaṃ,sakkhalimodakadipubbannaparannamayam,2,2,0,0,36
663396,vanamūlādippabhedaṃ,vanamuladippabhedam,2,2,0,0,19
663397,āmisagatikaṃ,amisagatikam,5,5,0,0,12
663398,mūlakhādanīyaṃ,mulakhadaniyam,6,3,3,0,14
663399,kandakhādanīyaṃ,kandakhadaniyam,7,5,2,0,15
663400,mūḷālakhādanīyaṃ,mulalakhadaniyam,1,1,0,0,16
663401,matthakakhādanīyaṃ,matthakakhadaniyam,5,3,2,0,18
663402,khandhakhādanīyaṃ,khandhakhadaniyam,5,3,2,0,17
663403,tacakhādanīyaṃ,tacakhadaniyam,5,3,2,0,14
663404,pattakhādanīyaṃ,pattakhadaniyam,5,3,2,0,15
663405,pupphakhādanīyaṃ,pupphakhadaniyam,5,3,2,0,16
663406,phalakhādanīyaṃ,phalakhadaniyam,11,10,1,0,15
663407,aṭṭhikhādanīyaṃ,atthikhadaniyam,5,3,2,0,15
663408,niyyāsakhādanīyanti,niyyasakhadaniyanti,3,3,0,0,19
663409,khādanīyasaṅkhyameva,khadaniyasankhyameva,2,2,0,0,20
663410,āmisagatikasallakkhaṇatthaṃ,amisagatikasallakkhanattham,2,2,0,0,27
663411,mūlakhādanīye,mulakhadaniye,3,2,1,0,13
663412,caccumūlaṃ,caccumulam,3,2,1,0,10
663413,tambakamūlaṃ,tambakamulam,2,2,0,0,12
663414,taṇḍuleyyakamūlaṃ,tanduleyyakamulam,2,2,0,0,17
663415,vatthuleyyakamūlaṃ,vatthuleyyakamulam,2,2,0,0,18
663416,vajakalimūlaṃ,vajakalimulam,2,2,0,0,13
663417,jajjharīmūlanti,jajjharimulanti,1,1,0,0,15
663418,sūpeyyapaṇṇamūlāni,supeyyapannamulani,3,2,1,0,18
663419,P4.0833,P4.0833,1,1,0,0,7
663420,āmisagatikāni,amisagatikani,3,2,1,0,13
663421,vajakalimūle,vajakalimule,3,3,0,0,12
663422,jaraṭṭhaṃ,jarattham,6,4,2,0,9
663423,mūlakakhārakajajjharīmūlānaṃ,mulakakharakajajjharimulanam,2,2,0,0,28
663424,jaraṭṭhānipi,jaratthanipi,3,3,0,0,12
663425,āmisagatikānevāti,amisagatikanevati,2,2,0,0,17
663426,ativisaṃ,ativisam,7,6,1,0,8
663427,kaṭukarohiṇiṃ,katukarohinim,4,4,0,0,13
663428,bhaddamuttakaṃ,bhaddamuttakam,7,7,0,0,14
663429,khādanīyatthaṃ,khadaniyattham,46,41,5,0,14
663430,bhojanīye,bhojaniye,21,21,0,0,9
663431,bhojanīyatthaṃ,bhojaniyattham,23,23,0,0,14
663432,yāvajīvikāni,yavajivikani,15,15,0,0,12
663433,cūḷapañcamūlaṃ,culapancamulam,2,2,0,0,14
663434,mahāpañcamūlantiādinā,mahapancamulantiadina,2,2,0,0,21
663435,gaṇiyamānānaṃ,ganiyamananam,3,3,0,0,13
663436,bhojanīyatthañca,bhojaniyatthanca,25,25,0,0,16
663437,pharaṇābhāvoyeva,pharanabhavoyeva,1,1,0,0,16
663438,pakatiāhāravasena,pakatiaharavasena,24,24,0,0,17
663439,yāvajīvikanti,yavajivikanti,15,15,0,0,13
663440,nāmasaññāsu,namasannasu,2,2,0,0,11
663441,vuccamānāsu,vuccamanasu,3,3,0,0,11
663442,sammohoyeva,sammohoyeva,7,5,2,0,11
663443,kandādīsupi,kandadisupi,3,3,0,0,11
663444,khandhatacapupphaphalampi,khandhatacapupphaphalampi,1,1,0,0,25
663445,kandakhādanīye,kandakhadaniye,6,5,1,0,14
663446,bhisakiṃsukakandādi,bhisakimsukakandadi,2,2,0,0,19
663447,uppalakaserukakandādi,uppalakaserukakandadi,2,2,0,0,21
663448,gaṇṭhī,ganthi,1,1,0,0,6
663449,kandānaṃ,kandanam,2,2,0,0,8
663450,jiṇṇajaraṭṭhānañca,jinnajaratthananca,1,1,0,0,18
663451,sukhumamūlāni,sukhumamulani,2,2,0,0,13
663452,sukhakhādanīyo,sukhakhadaniyo,2,2,0,0,14
663453,sālakalyāṇīpotakakando,salakalyanipotakakando,1,1,0,0,22
663454,kiṃsukapotakakando,kimsukapotakakando,2,2,0,0,18
663455,ambāṭakakando,ambatakakando,2,2,0,0,13
663456,ketakakando,ketakakando,2,2,0,0,11
663457,māluvakando,maluvakando,2,2,0,0,11
663458,bhisasaṅkhāto,bhisasankhato,3,3,0,0,13
663459,padumapuṇḍarīkakando,padumapundarikakando,3,3,0,0,20
663460,piṇḍālumasāluādayo,pindalumasaluadayo,2,2,0,0,18
663461,P4.0834,P4.0834,1,1,0,0,7
663462,khīravallikando,khiravallikando,5,4,1,0,15
663463,āluvakando,aluvakando,3,3,0,0,10
663464,siggukando,siggukando,2,2,0,0,10
663465,nīluppalarattuppalakumudasogandhikānaṃ,niluppalarattuppalakumudasogandhikanam,5,5,0,0,38
663466,kandā,kanda,7,7,0,0,5
663467,kadalikando,kadalikando,2,2,0,0,11
663468,veḷukando,velukando,2,2,0,0,9
663469,kaserukakandoti,kaserukakandoti,2,2,0,0,15
663470,khādanīyatthañca,khadaniyatthanca,6,6,0,0,16
663471,pharaṇakakandā,pharanakakanda,3,3,0,0,14
663472,yāvakālikā,yavakalika,8,8,0,0,10
663473,adhoto,adhoto,4,4,0,0,6
663474,yāvajīviko,yavajiviko,15,15,0,0,10
663475,yāvakāliko,yavakaliko,23,23,0,0,10
663476,khīrakākolījīvikausabhakalasuṇādikandā,khirakakolijivikausabhakalasunadikanda,1,1,0,0,38
663477,yāvajīvikā,yavajivika,9,9,0,0,10
663478,mūlabhesajjasaṅgaheneva,mulabhesajjasangaheneva,4,4,0,0,23
663479,mūḷālakhādanīye,mulalakhadaniye,1,1,0,0,15
663480,padumamūḷālaṃ,padumamulalam,1,1,0,0,13
663481,puṇḍarīkamuḷālasadisameva,pundarikamulalasadisameva,1,1,0,0,25
663482,erakamūlaṃ,erakamulam,1,1,0,0,10
663483,kandulamūlanti,kandulamulanti,1,1,0,0,14
663484,pharaṇakamuḷālaṃ,pharanakamulalam,3,3,0,0,16
663485,haliddisiṅgiveramakacicaturassavalliketakatālahintālakuntālanāḷikerapūgarukkhādimuḷālaṃ,haliddisingiveramakacicaturassavalliketakatalahintalakuntalanalikerapugarukkhadimulalam,2,2,0,0,87
663486,matthakakhādanīye,matthakakhadaniye,3,2,1,0,17
663487,tālahintālakuntālaketakanāḷikerapūgarukkhakhajjūrīvettaerakakadalīnaṃ,talahintalakuntalaketakanalikerapugarukkhakhajjurivettaerakakadalinam,1,1,0,0,69
663488,kaḷīrasaṅkhātā,kalirasankhata,4,4,0,0,14
663489,veṇukaḷīro,venukaliro,2,2,0,0,10
663490,naḷakaḷīro,nalakaliro,2,2,0,0,10
663491,ucchukaḷīro,ucchukaliro,2,2,0,0,11
663492,mūlakakaḷīro,mulakakaliro,2,2,0,0,12
663493,sāsapakaḷīro,sasapakaliro,2,2,0,0,12
663494,satāvarikaḷīro,satavarikaliro,2,2,0,0,14
663495,kaḷīrāti,kalirati,2,2,0,0,8
663496,pharaṇako,pharanako,4,4,0,0,9
663497,rukkhavalliādīnaṃ,rukkhavalliadinam,5,2,3,0,17
663498,haliddisiṅgiveravacamakacilasuṇānaṃkaḷīrā,haliddisingiveravacamakacilasunanamkalira,1,1,0,0,41
663499,tālahintālakuntālanāḷikerakaḷīrānañca,talahintalakuntalanalikerakalirananca,2,2,0,0,37
663500,jaraṭṭhabundo,jaratthabundo,3,3,0,0,13
663501,khandhakhādanīye,khandhakhadaniye,3,2,1,0,16
663502,antopathavīgato,antopathavigato,3,3,0,0,15
663503,sālakalyāṇīkhandho,salakalyanikhandho,2,2,0,0,18
663504,ucchukhandho,ucchukhandho,4,4,0,0,12
663505,khandhakāti,khandhakati,1,1,0,0,11
663506,uppalajātīnaṃ,uppalajatinam,3,3,0,0,13
663507,paṇṇadaṇḍako,pannadandako,2,2,0,0,12
663508,padumajātīnaṃ,padumajatinam,3,3,0,0,13
663509,kāravindakadaṇḍādayo,karavindakadandadayo,1,1,0,0,20
663510,avasesasabbakhandhā,avasesasabbakhandha,2,2,0,0,19
663511,P4.0835,P4.0835,1,1,0,0,7
663512,tacakhādanīye,tacakhadaniye,2,1,1,0,13
663513,ucchutacova,ucchutacova,3,3,0,0,11
663514,matthakakhandhatacānaṃ,matthakakhandhatacanam,2,2,0,0,22
663515,kasāvabhesajjena,kasavabhesajjena,3,3,0,0,16
663516,kasāvāni,kasavani,8,8,0,0,8
663517,nimbakasāvaṃ,nimbakasavam,4,4,0,0,12
663518,kuṭajakasāvaṃ,kutajakasavam,4,4,0,0,13
663519,paṭolakasāvaṃ,patolakasavam,4,4,0,0,13
663520,phaggavakasāvaṃ,phaggavakasavam,4,4,0,0,15
663521,nattamālakasāvaṃ,nattamalakasavam,4,4,0,0,16
663522,vuttakasāvāni,vuttakasavani,2,2,0,0,13
663523,kappiyānīti,kappiyaniti,2,2,0,0,11
663524,pattakhādanīye,pattakhadaniye,2,1,1,0,14
663525,caccu,caccu,5,5,0,0,5
663526,taṇḍuleyyako,tanduleyyako,3,3,0,0,12
663527,papunnāgo,papunnago,2,2,0,0,9
663528,vajakali,vajakali,3,2,1,0,8
663529,jajjharī,jajjhari,3,2,1,0,8
663530,sellu,sellu,4,3,1,0,5
663531,kāsamaddako,kasamaddako,2,2,0,0,11
663532,cīnamuggo,cinamuggo,3,2,1,0,9
663533,mahānipphāvaṃ,mahanipphavam,2,2,0,0,13
663534,avasesanipphāvo,avasesanipphavo,2,2,0,0,15
663535,sunisannako,sunisannako,3,3,0,0,11
663536,setavaraṇo,setavarano,2,2,0,0,10
663537,jātaloṇīti,jataloniti,3,2,1,0,10
663538,pharaṇakāni,pharanakani,9,9,0,0,11
663539,yāvakālikāni,yavakalikani,11,11,0,0,12
663540,panaññā,pananna,2,2,0,0,7
663541,mahānakhapiṭṭhimattā,mahanakhapitthimatta,1,1,0,0,20
663542,paṇṇaloṇi,pannaloni,1,1,0,0,9
663543,brahmīpattañca,brahmipattanca,1,1,0,0,14
663544,yāvakālikanti,yavakalikanti,8,8,0,0,13
663545,ambapallavaṃ,ambapallavam,3,3,0,0,12
663546,asokapallavaṃ,asokapallavam,2,2,0,0,13
663547,panaññāni,panannani,3,3,0,0,9
663548,nimbapaṇṇaṃ,nimbapannam,4,4,0,0,11
663549,kuṭajapaṇṇaṃ,kutajapannam,4,4,0,0,12
663550,paṭolapaṇṇaṃ,patolapannam,5,5,0,0,12
663551,sulasipaṇṇaṃ,sulasipannam,5,4,1,0,12
663552,kappāsakapaṇṇaṃ,kappasakapannam,1,1,0,0,15
663553,P4.0836,P4.0836,1,1,0,0,7
663554,pupphaphalādīnipi,pupphaphaladinipi,1,1,0,0,17
663555,phaggavapaṇṇaṃ,phaggavapannam,3,3,0,0,14
663556,ajjukapaṇṇaṃ,ajjukapannam,2,2,0,0,12
663557,phaṇijjakapaṇṇaṃ,phanijjakapannam,2,2,0,0,16
663558,tambūlapaṇṇaṃ,tambulapannam,2,2,0,0,13
663559,paduminipaṇṇanti,paduminipannanti,2,2,0,0,16
663560,pupphakhādanīye,pupphakhadaniye,3,2,1,0,15
663561,mūlakapupphaṃ,mulakapuppham,3,3,0,0,13
663562,khārakapupphaṃ,kharakapuppham,3,3,0,0,14
663563,caccupupphaṃ,caccupuppham,3,3,0,0,12
663564,tambakapupphaṃ,tambakapuppham,2,2,0,0,14
663565,vajakalipupphaṃ,vajakalipuppham,2,2,0,0,15
663566,jajjharīpupphaṃ,jajjharipuppham,1,1,0,0,15
663567,cūḷanipphāvapupphaṃ,culanipphavapuppham,2,2,0,0,19
663568,mahānipphāvapupphaṃ,mahanipphavapuppham,2,2,0,0,19
663569,kaserukapupphaṃ,kaserukapuppham,2,2,0,0,15
663570,nāḷikeratālaketakānaṃ,nalikeratalaketakanam,2,2,0,0,21
663571,taruṇapupphāni,tarunapupphani,2,2,0,0,14
663572,setavaraṇapupphaṃ,setavaranapuppham,2,2,0,0,17
663573,siggupupphaṃ,siggupuppham,2,2,0,0,12
663574,uppalapadumajātikānaṃ,uppalapadumajatikanam,2,2,0,0,21
663575,agandhikapupphaṃ,agandhikapuppham,2,1,1,0,16
663576,kaḷīrapupphaṃ,kalirapuppham,1,1,0,0,13
663577,jīvantīpupphanti,jivantipupphanti,1,1,0,0,16
663578,pharaṇakapupphaṃ,pharanakapuppham,1,1,0,0,16
663579,asokabakulakuyyakapunnāgacampakajātikaṇavīrakaṇikārakundanavamālikamallikādīnaṃ,asokabakulakuyyakapunnagacampakajatikanavirakanikarakundanavamalikamallikadinam,1,1,0,0,79
663580,kasāvabhesajjeneva,kasavabhesajjeneva,1,1,0,0,18
663581,phalakhādanīye,phalakhadaniye,2,1,1,0,14
663582,panasalabujatālanāḷikeraambajambūambāṭakatintiṇikamātuluṅgakapitthalābukumbhaṇḍapussaphalatimbarūsakatipusavātiṅgaṇacocamocamadhukādīnaṃ,panasalabujatalanalikeraambajambuambatakatintinikamatulungakapitthalabukumbhandapussaphalatimbarusakatipusavatinganacocamocamadhukadinam,1,1,0,0,136
663583,nāmagaṇanavasena,namagananavasena,2,2,0,0,16
663584,goṭṭhaphalaṃ,gotthaphalam,9,6,3,0,12
663585,P4.0837,P4.0837,1,1,0,0,7
663586,aparipakkāni,aparipakkani,2,2,0,0,12
663587,acchiva,acchiva,2,1,1,0,7
663588,bimbavaraṇaketakakāsmarīādīnaṃ,bimbavaranaketakakasmariadinam,1,1,0,0,30
663589,kaṭukaphalaṃ,katukaphalam,4,3,1,0,12
663590,takkolanti,takkolanti,2,2,0,0,10
663591,aṭṭhikhādanīye,atthikhadaniye,3,2,1,0,14
663592,labujaṭṭhi,labujatthi,3,3,0,0,10
663593,panasaṭṭhi,panasatthi,2,2,0,0,10
663594,ambāṭakaṭṭhi,ambatakatthi,2,2,0,0,12
663595,sālaṭṭhi,salatthi,3,3,0,0,8
663596,khajjūrīketakatimbarūsakānaṃ,khajjuriketakatimbarusakanam,2,2,0,0,28
663597,taruṇaphalaṭṭhi,tarunaphalatthi,2,2,0,0,15
663598,tintiṇikaṭṭhi,tintinikatthi,2,2,0,0,13
663599,bimbaphalaṭṭhi,bimbaphalatthi,2,2,0,0,14
663600,pokkharaṭṭhīti,pokkharatthiti,2,2,0,0,14
663601,madhukaṭṭhi,madhukatthi,2,2,0,0,11
663602,punnāgaṭṭhi,punnagatthi,2,2,0,0,11
663603,harītakādīnaṃ,haritakadinam,6,2,4,0,13
663604,siddhatthakaṭṭhi,siddhatthakatthi,2,2,0,0,16
663605,rājikaṭṭhīti,rajikatthiti,2,2,0,0,12
663606,phalabhesajjeneva,phalabhesajjeneva,2,2,0,0,17
663607,piṭṭhakhādanīye,pitthakhadaniye,3,2,1,0,15
663608,dhotakatālapiṭṭhañca,dhotakatalapitthanca,1,1,0,0,20
663609,piṭṭhāni,pitthani,5,5,0,0,8
663610,adhotakaṃ,adhotakam,3,2,1,0,9
663611,tālapiṭṭhaṃ,talapittham,5,4,1,0,11
663612,khīravallipiṭṭhaṃ,khiravallipittham,3,3,0,0,17
663613,assagandhādipiṭṭhāni,assagandhadipitthani,2,2,0,0,20
663614,mūlaphalehi,mulaphalehi,2,2,0,0,11
663615,saṅghaho,sanghaho,1,1,0,0,8
663616,niyyāsakhādanīye,niyyasakhadaniye,4,2,2,0,16
663617,ucchuniyyāsova,ucchuniyyasova,2,2,0,0,14
663618,sattāhakāliko,sattahakaliko,15,15,0,0,13
663619,jatūni,jatuni,9,9,0,0,6
663620,hiṅguṃ,hingum,5,4,1,0,6
663621,hiṅgujatuṃ,hingujatum,5,4,1,0,10
663622,hiṅgusipāṭikaṃ,hingusipatikam,6,4,2,0,14
663623,takaṃ,takam,12,4,8,0,5
663624,takapattiṃ,takapattim,6,4,2,0,10
663625,takapaṇṇiṃ,takapannim,6,4,2,0,10
663626,sajjulasaṃ,sajjulasam,4,4,0,0,10
663627,vuttaniyyāsā,vuttaniyyasa,1,1,0,0,12
663628,ambaniyyāso,ambaniyyaso,2,2,0,0,11
663629,kaṇikāraniyyāsoti,kanikaraniyyasoti,2,2,0,0,17
663630,mūlakhādanīyādīsu,mulakhadaniyadisu,3,3,0,0,17
663631,P4.0838,P4.0838,1,1,0,0,7
663632,bhojanānītiādimhi,bhojananitiadimhi,1,0,1,0,17
663633,sannidhikārakasikkhāpadavaṇṇanā,sannidhikarakasikkhapadavannana,19,19,0,0,31
663634,jaṭilasahassabbhantaro,jatilasahassabbhantaro,2,2,0,0,22
663635,sukkhakuraṃ,sukkhakuram,5,3,2,0,11
663636,asūpabyañjanaṃ,asupabyanjanam,4,4,0,0,14
663637,paccayagiddhatāya,paccayagiddhataya,1,1,0,0,17
663638,sannidhikāro,sannidhikaro,2,1,1,0,12
663639,sannidhikāraṃ,sannidhikaram,7,7,0,0,13
663640,sannidhikārameva,sannidhikarameva,2,2,0,0,16
663641,vītināmitassetaṃ,vitinamitassetam,5,4,1,0,16
663642,aparajjū,aparajju,2,2,0,0,8
663643,sannidhikataṃ,sannidhikatam,11,11,0,0,13
663644,ajjhoharitukāmatāya,ajjhoharitukamataya,12,11,1,0,19
663645,duddhoto,duddhoto,12,10,2,0,8
663646,gaṇṭhikapattassa,ganthikapattassa,4,4,0,0,16
663647,gaṇṭhikantare,ganthikantare,4,4,0,0,13
663648,otāpentassa,otapentassa,5,5,0,0,11
663649,nisnehabhāvo,nisnehabhavo,4,4,0,0,12
663650,P4.0839,P4.0839,1,1,0,0,7
663651,snehabhāvo,snehabhavo,2,2,0,0,10
663652,aṅgulilekhā,angulilekha,7,6,1,0,11
663653,telavaṇṇapatte,telavannapatte,3,3,0,0,14
663654,apariccattameva,apariccattameva,8,5,3,0,15
663655,akappiyamaṃsesu,akappiyamamsesu,10,10,0,0,15
663656,thullaccayena,thullaccayena,34,34,0,0,13
663657,sadviṃ,sadvim,1,1,0,0,6
663658,anatirittakataṃ,anatirittakatam,6,5,1,0,15
663659,pakatiāmise,pakatiamise,2,2,0,0,11
663660,sesaakappiyamaṃse,sesaakappiyamamse,3,3,0,0,17
663661,pakatibhojane,pakatibhojane,4,4,0,0,13
663662,sannidhipaccayā,sannidhipaccaya,30,28,2,0,15
663663,vikālabhojanapaccayā,vikalabhojanapaccaya,6,5,1,0,20
663664,yāmakālikesu,yamakalikesu,4,3,1,0,12
663665,vikālapaccayā,vikalapaccaya,6,5,1,0,13
663666,āhāratthāyāti,aharatthayati,5,0,5,0,13
663667,paṭiggaṇhato,patigganhato,22,20,2,0,12
663668,paṭiggahaṇapaccayā,patiggahanapaccaya,13,11,2,0,18
663669,āmisasaṃsaṭṭhaṃ,amisasamsattham,10,7,3,0,15
663670,yathāvatthukaṃ,yathavatthukam,11,8,3,0,14
663671,vikālabhojanasikkhāpade,vikalabhojanasikkhapade,3,2,1,0,23
663672,majjhantikasaṅkhāto,majjhantikasankhato,1,1,0,0,19
663673,bhuñjitabbato,bhunjitabbato,14,14,0,0,13
663674,anulomapānehi,anulomapanehi,2,2,0,0,13
663675,pacchimayāmasaṅkhāto,pacchimayamasankhato,2,2,0,0,20
663676,sappiādi,sappiadi,12,12,0,0,8
663677,nidhetabbato,nidhetabbato,3,3,0,0,12
663678,yāvajīvakaṃ,yavajivakam,1,0,1,0,11
663679,P4.0840,P4.0840,1,1,0,0,7
663680,aruṇodayeva,arunodayeva,1,1,0,0,11
663681,yāvakālo,yavakalo,2,1,1,0,8
663682,pānakathā,panakatha,3,3,0,0,9
663683,kappiyānulomakathā,kappiyanulomakatha,1,1,0,0,18
663684,kappiyabhūmikathā,kappiyabhumikatha,1,1,0,0,17
663685,sannidhikārakasikkhāpadaṃ,sannidhikarakasikkhapadam,6,6,0,0,25
663686,paṇītabhojanasikkhāpadavaṇṇanā,panitabhojanasikkhapadavannana,14,14,0,0,30
663687,paṇītabhojanānīti,panitabhojananiti,10,3,7,0,17
663688,uttamabhojanāni,uttamabhojanani,1,1,0,0,15
663689,sūpodanaviññattidukkaṭaṃ,supodanavinnattidukkatam,4,4,0,0,24
663690,odanasaṃsaṭṭhāni,odanasamsatthani,2,2,0,0,16
663691,paṇītabhojanānī,panitabhojanani,11,10,1,0,15
663692,sappiādīnaṃyeva,sappiadinamyeva,1,1,0,0,15
663693,paṇītasaṃsaṭṭhāni,panitasamsatthani,7,6,1,0,17
663694,sattadhaññanibbattāni,sattadhannanibbattani,3,3,0,0,21
663695,sappimissakaṃ,sappimissakam,3,3,0,0,13
663696,sahasappinā,sahasappina,1,1,0,0,11
663697,sappibhattaṃ,sappibhattam,18,14,4,0,12
663698,sūpodanaviññattidukkaṭameva,supodanavinnattidukkatameva,3,3,0,0,27
663699,P4.0841,P4.0841,1,1,0,0,7
663700,gosappinā,gosappina,7,7,0,0,9
663701,gosappimhi,gosappimhi,1,1,0,0,10
663702,gonavanītādīni,gonavanitadini,2,2,0,0,14
663703,gāviṃyeva,gavimyeva,2,2,0,0,9
663704,kappiyasappinā,kappiyasappina,6,4,2,0,14
663705,akappiyasappinā,akappiyasappina,8,7,1,0,15
663706,akappiyasappināti,akappiyasappinati,4,1,3,0,17
663707,akappiyasappimhi,akappiyasappimhi,2,2,0,0,16
663708,akappiyanavanītādīni,akappiyanavanitadini,2,2,0,0,20
663709,akappiyasappināva,akappiyasappinava,3,3,0,0,17
663710,navanītena,navanitena,2,2,0,0,10
663711,dehītiādīsupi,dehitiadisupi,2,2,0,0,13
663712,āgatanavanītādīni,agatanavanitadini,2,2,0,0,17
663713,navanītādīhi,navanitadihi,2,2,0,0,12
663714,sappibhattassa,sappibhattassa,1,1,0,0,14
663715,navanītabhattaṃ,navanitabhattam,3,3,0,0,15
663716,dehītiādīsupī,dehitiadisupi,1,1,0,0,13
663717,nānāṭṭhāne,nanatthane,4,3,1,0,10
663718,kāyikāni,kayikani,3,3,0,0,8
663719,vācasikāni,vacasikani,3,3,0,0,10
663720,nānāvatthukāni,nanavatthukani,18,18,0,0,14
663721,P4.0842,P4.0842,1,1,0,0,7
663722,gilānasaññīti,gilanasanniti,1,0,1,0,13
663723,gilānasaññīpi,gilanasannipi,2,2,0,0,13
663724,mahānāmasikkhāpadena,mahanamasikkhapadena,10,6,4,0,20
663725,pāṭidesanīyavatthūni,patidesaniyavatthuni,2,2,0,0,20
663726,sūpodanaviññattiyaṃ,supodanavinnattiyam,6,5,1,0,19
663727,sekhapaṇṇattidukkaṭameva,sekhapannattidukkatameva,1,1,0,0,24
663728,paṇṇativajjaṃ,pannativajjam,1,1,0,0,13
663729,paṇītabhojanasikkhāpadaṃ,panitabhojanasikkhapadam,5,5,0,0,24
663730,dantaponasikkhāpadavaṇṇanā,dantaponasikkhapadavannana,14,14,0,0,26
663731,chaḍḍitabhājanameva,chadditabhajanameva,1,1,0,0,19
663732,chaḍḍitacoḷakeheva,chadditacolakeheva,1,1,0,0,18
663733,chaḍḍitamañcapīṭhakāniyeva,chadditamancapithakaniyeva,1,1,0,0,26
663734,ayyavosāṭitakānīti,ayyavosatitakaniti,4,1,3,0,18
663735,pitipitāmahā,pitipitamaha,1,1,0,0,12
663736,vosāṭitakāni,vosatitakani,1,0,1,0,12
663737,chaḍḍitakāni,chadditakani,1,1,0,0,12
663738,sajīvakāle,sajivakale,1,1,0,0,10
663739,paribhuñjantūti,paribhunjantuti,1,1,0,0,15
663740,susānepi,susanepi,2,2,0,0,8
663741,ummārepi,ummarepi,2,2,0,0,8
663742,ayyavosāṭitakāni,ayyavosatitakani,3,3,0,0,16
663743,ghanabaddho,ghanabaddho,1,1,0,0,11
663744,udakadantapone,udakadantapone,5,4,1,0,14
663745,kukkuccāyantīti,kukkuccayantiti,2,1,1,0,15
663746,kukkuccāyisuṃ,kukkuccayisum,1,1,0,0,13
663747,yathāuppannassa,yathauppannassa,1,1,0,0,15
663748,P4.0843,P4.0843,1,1,0,0,7
663749,kāyakāyapaṭibaddhanissaggiyānaṃ,kayakayapatibaddhanissaggiyanam,3,3,0,0,31
663750,parapariggahitakaṃ,parapariggahitakam,3,2,1,0,18
663751,rathareṇumpi,ratharenumpi,1,1,0,0,12
663752,pādaṅguliyāpi,padanguliyapi,4,4,0,0,13
663753,natthukaraṇiyā,natthukaraniya,2,2,0,0,14
663754,nāsāpuṭena,nasaputena,4,3,1,0,10
663755,ābhogamattameva,abhogamattameva,3,3,0,0,15
663756,kaṭacchuādīsu,katacchuadisu,4,4,0,0,13
663757,sarīrapaṭibaddhena,sarirapatibaddhena,1,1,0,0,18
663758,pattathālakādinā,pattathalakadina,2,2,0,0,16
663759,pātiyamānampi,patiyamanampi,2,2,0,0,13
663760,pañcaṅgehi,pancangehi,3,3,0,0,10
663761,uccāraṇamattaṃ,uccaranamattam,7,4,3,0,14
663762,P4.0844,P4.0844,1,1,0,0,7
663763,ṭhitanisinnanipannānaṃ,thitanisinnanipannanam,3,3,0,0,22
663764,pavāraṇasikkhāpade,pavaranasikkhapade,7,4,3,0,18
663765,dāyakapaṭiggāhakesu,dayakapatiggahakesu,2,2,0,0,19
663766,bhūmaṭṭhassa,bhumatthassa,5,5,0,0,12
663767,ākāsaṭṭhassa,akasatthassa,4,4,0,0,12
663768,hatthapāsappamāṇaṃ,hatthapasappamanam,5,5,0,0,18
663769,kūpataṭe,kupatate,3,3,0,0,8
663770,addhaṭṭhamaratanassāpi,addhatthamaratanassapi,1,1,0,0,22
663771,bhattabyañjanabhājanāni,bhattabyanjanabhajanani,2,2,0,0,23
663772,heṭṭhimabhājanaṃ,hetthimabhajanam,2,2,0,0,16
663773,sabhattapacchiādimhi,sabhattapacchiadimhi,1,1,0,0,20
663774,guḷakumbho,gulakumbho,3,3,0,0,10
663775,ucchuyantadoṇito,ucchuyantadonito,2,2,0,0,16
663776,paggharantameva,paggharantameva,2,2,0,0,15
663777,paṭiggahaṇasaññāya,patiggahanasannaya,5,5,0,0,18
663778,paṭiggahessāmīti,patiggahessamiti,16,11,5,0,16
663779,P4.0845,P4.0845,1,1,0,0,7
663780,diyyamānameva,diyyamanameva,2,2,0,0,13
663781,mahākaṭasārahatthattharaṇādīsu,mahakatasarahatthattharanadisu,2,2,0,0,30
663782,ṭhapitapatte,thapitapatte,2,2,0,0,12
663783,ruhatī,ruhati,27,23,4,0,6
663784,hatthapāsātikkamaṃ,hatthapasatikkamam,3,2,1,0,18
663785,tatthajātakā,tatthajataka,8,8,0,0,12
663786,kiṃsukapaṇṇādimhi,kimsukapannadimhi,4,4,0,0,17
663787,kāyapaṭibaddhasaṅkhyaṃ,kayapatibaddhasankhyam,2,2,0,0,22
663788,ṭhapitamañcādimhi,thapitamancadimhi,3,3,0,0,17
663789,asaṃhārime,asamharime,9,7,2,0,10
663790,ruhatiyeva,ruhatiyeva,3,3,0,0,10
663791,tatthajātakasaṅkhepupagā,tatthajatakasankhepupaga,1,1,0,0,24
663792,atthatesu,atthatesu,5,5,0,0,9
663793,tintiṇikādipaṇṇesupi,tintinikadipannesupi,2,2,0,0,20
663794,samatthānīti,samatthaniti,3,3,0,0,12
663795,paduminipaṇṇādīsu,paduminipannadisu,3,3,0,0,17
663796,ākiratiyeva,akiratiyeva,2,2,0,0,11
663797,khipantepi,khipantepi,2,2,0,0,10
663798,nīhariyamāne,nihariyamane,2,2,0,0,12
663799,rajanacuṇṇāni,rajanacunnani,2,2,0,0,13
663800,rajanacuṇṇaṃ,rajanacunnam,2,2,0,0,12
663801,gaṇhitabbā,ganhitabba,12,12,0,0,10
663802,paribhuñjeyyāsi,paribhunjeyyasi,3,3,0,0,15
663803,P4.0846,P4.0846,1,1,0,0,7
663804,uppilavati,uppilavati,4,3,1,0,10
663805,amocentena,amocentena,1,1,0,0,10
663806,sukkhabhatte,sukkhabhatte,3,3,0,0,12
663807,uparibhattena,uparibhattena,2,2,0,0,13
663808,ālulentānaṃ,alulentanam,2,1,1,0,11
663809,uḷuṅkato,ulunkato,5,3,2,0,8
663810,thevā,theva,5,3,2,0,5
663811,supatitā,supatita,2,2,0,0,8
663812,abhihaṭattā,abhihatatta,14,14,0,0,11
663813,carukena,carukena,3,3,0,0,8
663814,ākiriyamāne,akiriyamane,2,2,0,0,11
663815,carukato,carukato,3,3,0,0,8
663816,supatitaṃ,supatitam,3,3,0,0,9
663817,jajjharisākhādiṃ,jajjharisakhadim,2,2,0,0,16
663818,mukhavaṭṭiyāpi,mukhavattiyapi,5,2,3,0,14
663819,ādhārakena,adharakena,5,5,0,0,10
663820,appaṭiggahitaṃ,appatiggahitam,34,30,4,0,14
663821,jāgarantassapi,jagarantassapi,2,2,0,0,14
663822,anādarapaṭiggahaṇaṃ,anadarapatiggahanam,2,2,0,0,19
663823,kāyapaṭibaddhapaṭibaddhena,kayapatibaddhapatibaddhena,2,2,0,0,26
663824,kāyapaṭibaddhameva,kayapatibaddhameva,4,4,0,0,18
663825,kāyasaṃsaggepi,kayasamsaggepi,3,3,0,0,14
663826,P4.0847,P4.0847,1,1,0,0,7
663827,paduminipaṇṇavatthakaṭasārakādīsu,paduminipannavatthakatasarakadisu,2,2,0,0,33
663828,sarajāya,sarajaya,5,5,0,0,8
663829,pavaṭṭantaṃ,pavattantam,5,5,0,0,11
663830,āharāpetumpi,aharapetumpi,2,2,0,0,12
663831,anāṇattenāpi,ananattenapi,1,1,0,0,12
663832,parasantakābhāvo,parasantakabhavo,2,2,0,0,16
663833,appaṭiggahitakattā,appatiggahitakatta,2,2,0,0,18
663834,paribhuñcituṃ,paribhuncitum,1,1,0,0,13
663835,abbohārikanayo,abboharikanayo,2,2,0,0,14
663836,bhuñjantānañhi,bhunjantananhi,2,2,0,0,14
663837,ucchuādīsu,ucchuadisu,6,6,0,0,10
663838,phālitesu,phalitesu,5,5,0,0,9
663839,navasamuṭṭhitaṃ,navasamutthitam,5,3,2,0,15
663840,lohagandhamattaṃ,lohagandhamattam,3,3,0,0,16
663841,phālitepi,phalitepi,2,2,0,0,9
663842,pisantānaṃ,pisantanam,3,3,0,0,10
663843,P4.0848,P4.0848,1,1,0,0,7
663844,nisadanisadapotakaudukkhalamusalādīni,nisadanisadapotakaudukkhalamusaladini,2,2,0,0,37
663845,pariharaṇakavāsiṃ,pariharanakavasim,2,2,0,0,17
663846,āmakatakkādīsu,amakatakkadisu,2,2,0,0,14
663847,sāmapākato,samapakato,2,2,0,0,10
663848,cīvarato,civarato,11,11,0,0,8
663849,kiliṭṭhaudakaṃ,kilitthaudakam,3,2,1,0,14
663850,abbhokāsato,abbhokasato,2,2,0,0,11
663851,acchupanteneva,acchupanteneva,2,2,0,0,14
663852,appaṭiggahite,appatiggahite,5,5,0,0,13
663853,pariccajatu,pariccajatu,3,3,0,0,11
663854,aphusantova,aphusantova,2,2,0,0,11
663855,sāmaṇerasantakena,samanerasantakena,2,2,0,0,17
663856,guḷapiṇḍassa,gulapindassa,2,2,0,0,12
663857,yāgupacanakabhājane,yagupacanakabhajane,4,4,0,0,19
663858,P4.0849,P4.0849,1,1,0,0,7
663859,patitañhi,patitanhi,2,2,0,0,9
663860,pattamiva,pattamiva,2,2,0,0,9
663861,yāgukuṭaṃ,yagukutam,5,4,1,0,9
663862,paṭiggaṇhāpetuṃ,patigganhapetum,3,3,0,0,15
663863,kuṭassa,kutassa,3,3,0,0,7
663864,paṭiggahitāva,patiggahitava,2,2,0,0,13
663865,pūvapacchibhattapacchiucchubhārādīsupi,puvapacchibhattapacchiucchubharadisupi,2,2,0,0,38
663866,paṭiggahaṇūpagaṃ,patiggahanupagam,6,2,4,0,16
663867,phāṇitaghaṭaṃ,phanitaghatam,2,2,0,0,13
663868,navanītaghaṭaṃ,navanitaghatam,1,1,0,0,14
663869,laggenti,laggenti,9,9,0,0,8
663870,telaghaṭā,telaghata,2,2,0,0,9
663871,paṭiggahitako,patiggahitako,4,4,0,0,13
663872,appaṭiggahitako,appatiggahitako,4,4,0,0,15
663873,telathālakaṃ,telathalakam,5,5,0,0,12
663874,paṭiggahitakaṃ,patiggahitakam,4,4,0,0,14
663875,nisseṇimajjhe,nissenimajjhe,1,1,0,0,13
663876,paṭiggahitake,patiggahitake,8,8,0,0,13
663877,telādimhi,teladimhi,2,2,0,0,9
663878,kaṇṇakaṃ,kannakam,4,4,0,0,8
663879,siṅgiverādimhi,singiveradimhi,2,2,0,0,14
663880,ghanacuṇṇaṃ,ghanacunnam,3,2,1,0,11
663881,taṃsamuṭṭhānameva,tamsamutthanameva,3,2,1,0,17
663882,P4.0850,P4.0850,1,1,0,0,7
663883,phalapiṇḍiṃ,phalapindim,2,2,0,0,11
663884,yottapāsake,yottapasake,2,2,0,0,11
663885,mahāsākhaṃ,mahasakham,2,2,0,0,10
663886,paṭiggahitāneva,patiggahitaneva,2,2,0,0,15
663887,antovatiyaṃ,antovatiyam,2,2,0,0,11
663888,timbarūsakaṃ,timbarusakam,5,5,0,0,12
663889,vatidaṇḍakesu,vatidandakesu,1,1,0,0,13
663890,appaharitvā,appaharitva,3,3,0,0,11
663891,sayaṃpatitameva,sayampatitameva,1,1,0,0,15
663892,takkayāma,takkayama,6,6,0,0,9
663893,suṅkaghātato,sunkaghatato,6,6,0,0,12
663894,bahipatitabhaṇḍaṃ,bahipatitabhandam,2,2,0,0,17
663895,hatthasatampi,hatthasatampi,4,4,0,0,13
663896,phaliniṃ,phalinim,6,4,2,0,8
663897,paṭiggahāpetvā,patiggahapetva,24,24,0,0,14
663898,macchikavāraṇatthaṃ,macchikavaranattham,6,3,3,0,19
663899,mūlapaṭiggahaṇameva,mulapatiggahanameva,11,10,1,0,19
663900,paṭiggahaṇārahaṃ,patiggahanaraham,3,3,0,0,16
663901,uḷumpepi,ulumpepi,2,2,0,0,8
663902,kuṇḍake,kundake,4,4,0,0,7
663903,gamikabhikkhūnaṃ,gamikabhikkhunam,3,3,0,0,16
663904,P4.0851,P4.0851,1,1,0,0,7
663905,gahitataṇḍulesu,gahitatandulesu,4,4,0,0,15
663906,anutherassāti,anutherassati,2,1,1,0,13
663907,uggahitapaccayā,uggahitapaccaya,6,6,0,0,15
663908,chāyādīnaṃ,chayadinam,6,5,1,0,10
663909,niccāletuṃ,niccaletum,6,2,4,0,10
663910,niccāletvā,niccaletva,5,5,0,0,10
663911,pakkabhāvo,pakkabhavo,3,3,0,0,10
663912,duppakkaṃ,duppakkam,2,2,0,0,9
663913,pākatthāya,pakatthaya,2,2,0,0,10
663914,āropetumpi,aropetumpi,1,1,0,0,10
663915,sataṇḍulodakabhājanaṃ,satandulodakabhajanam,1,1,0,0,21
663916,pakkayāguṃ,pakkayagum,3,3,0,0,10
663917,hatthakukkuccako,hatthakukkuccako,2,2,0,0,16
663918,durupaciṇṇaṃ,durupacinnam,7,6,1,0,12
663919,sāmapākañceva,samapakanceva,1,1,0,0,13
663920,P4.0852,P4.0852,1,1,0,0,7
663921,durupaciṇṇañca,durupacinnanca,2,2,0,0,14
663922,uggahitakampi,uggahitakampi,3,3,0,0,13
663923,durupaciṇṇadukkaṭañca,durupacinnadukkatanca,4,4,0,0,21
663924,apassayituṃ,apassayitum,12,11,1,0,11
663925,ambaphalādiṃ,ambaphaladim,2,2,0,0,12
663926,sīhavighāsādiṃ,sihavighasadim,4,2,2,0,14
663927,khāditumpi,khaditumpi,5,5,0,0,10
663928,āmakamaṃsapaṭiggahaṇapaccayā,amakamamsapatiggahanapaccaya,2,2,0,0,28
663929,uggahitakapaccayā,uggahitakapaccaya,3,3,0,0,17
663930,dīghasaṇḍāsena,dighasandasena,2,2,0,0,14
663931,amuñcanteneva,amuncanteneva,3,3,0,0,13
663932,aṅgārāpi,angarapi,2,2,0,0,8
663933,guḷapiṇḍakaṃ,gulapindakam,1,1,0,0,12
663934,khādantassāpi,khadantassapi,1,1,0,0,13
663935,vuttokāsato,vuttokasato,2,2,0,0,11
663936,gahitāvasesañhi,gahitavasesanhi,2,2,0,0,15
663937,ajahitapaṭiggahaṇameva,ajahitapatiggahanameva,2,2,0,0,22
663938,ekagahaṇeneva,ekagahaneneva,1,1,0,0,13
663939,P4.0853,P4.0853,1,1,0,0,7
663940,lolasāmaṇero,lolasamanero,2,2,0,0,12
663941,dhūmavaṭṭiṃ,dhumavattim,2,2,0,0,11
663942,yāvajīvikasaṃsagge,yavajivikasamsagge,4,2,2,0,18
663943,kaṇṇanāsamukhacchiddehi,kannanasamukhacchiddehi,1,1,0,0,23
663944,byādhipaccayā,byadhipaccaya,2,2,0,0,13
663945,bhattuggāro,bhattuggaro,3,3,0,0,11
663946,laggassa,laggassa,3,3,0,0,8
663947,abbohārikapakkhaṃ,abboharikapakkham,2,2,0,0,17
663948,nirudakaṭṭhāne,nirudakatthane,3,3,0,0,14
663949,kakkhāretvā,kakkharetva,2,2,0,0,11
663950,kheḷapiṇḍe,khelapinde,3,3,0,0,10
663951,vikkhāletabbaṃ,vikkhaletabbam,2,2,0,0,14
663952,ṭhapitasiṅgiverādīnaṃ,thapitasingiveradinam,2,2,0,0,21
663953,samuddodakena,samuddodakena,3,2,1,0,13
663954,loṇakiccaṃ,lonakiccam,4,3,1,0,10
663955,himakarakā,himakaraka,4,2,2,0,10
663956,udakagatikā,udakagatika,5,3,2,0,11
663957,parihārikena,pariharikena,1,1,0,0,12
663958,katakaṭṭhinā,katakatthina,2,2,0,0,12
663959,āmisagatikehi,amisagatikehi,2,2,0,0,13
663960,kapitthaphalādīhi,kapitthaphaladihi,2,2,0,0,17
663961,kakudhasobbhādayo,kakudhasobbhadayo,2,2,0,0,17
663962,sañchannodakā,sanchannodaka,2,2,0,0,13
663963,pabbatakandarādīsu,pabbatakandaradisu,3,3,0,0,18
663964,kāḷavaṇṇapaṇṇasañchannaudakepi,kalavannapannasanchannaudakepi,1,1,0,0,30
663965,sareṇukāni,sarenukani,3,3,0,0,10
663966,savaṇṭakhīrāni,savantakhirani,2,2,0,0,14
663967,P4.0854,P4.0854,1,1,0,0,7
663968,pāṭalicampakamallikā,patalicampakamallika,1,1,0,0,20
663969,vāsamattaṃ,vasamattam,5,3,2,0,10
663970,ṭhapitapupphavāsitakapānīyato,thapitapupphavasitakapaniyato,2,2,0,0,29
663971,padumasarādīsu,padumasaradisu,2,2,0,0,14
663972,acittakañhi,acittakanhi,3,3,0,0,11
663973,kappiyamaṃsakhīraṃ,kappiyamamsakhiram,4,3,1,0,18
663974,akappiyamaṃsakhīraṃ,akappiyamamsakhiram,2,2,0,0,19
663975,uṭṭhitaloṇanti,utthitalonanti,2,2,0,0,14
663976,aṅgalaggaṃ,angalaggam,5,4,1,0,10
663977,paṭiggahitakameva,patiggahitakameva,2,2,0,0,17
663978,uṇhaṃpāyāsaṃ,unhampayasam,1,1,0,0,12
663979,aṅgulianusārena,angulianusarena,2,2,0,0,15
663980,mukhavaṭṭiṃto,mukhavattimto,1,1,0,0,13
663981,pattatalaṃ,pattatalam,2,2,0,0,10
663982,jhāmamahābhūtesu,jhamamahabhutesu,1,1,0,0,16
663983,dujjhāpitaṃ,dujjhapitam,3,3,0,0,11
663984,manussaṭṭhimpi,manussatthimpi,2,2,0,0,14
663985,lehe,lehe,2,2,0,0,4
663986,asantapakkheyeva,asantapakkheyeva,4,4,0,0,16
663987,sukkhadārumhi,sukkhadarumhi,2,2,0,0,13
663988,alladāruṃ,alladarum,5,4,1,0,9
663989,mahāvikaṭaṃ,mahavikatam,5,5,0,0,11
663990,sappadaṭṭhakkhaṇeyeva,sappadatthakkhaneyeva,5,4,1,0,21
663991,P4.0855,P4.0855,1,1,0,0,7
663992,dantaponasikkhāpadaṃ,dantaponasikkhapadam,6,6,0,0,20
663993,acelakasikkhāpadavaṇṇanā,acelakasikkhapadavannana,13,13,0,0,24
663994,acelakavaggassa,acelakavaggassa,5,5,0,0,15
663995,parivisanaṭṭhānaṃ,parivisanatthanam,8,4,4,0,17
663996,yāgupattaṃ,yagupattam,1,1,0,0,10
663997,pūvabhattādīsu,puvabhattadisu,1,1,0,0,14
663998,atitthiyasaññīti,atitthiyasanniti,2,1,1,0,16
663999,mātāpitusaññāya,matapitusannaya,1,1,0,0,15
664000,ākiritabbaṃ,akiritabbam,1,1,0,0,11
664001,acelakasikkhāpadaṃ,acelakasikkhapadam,7,7,0,0,18
664002,uyyojanasikkhāpadavaṇṇanā,uyyojanasikkhapadavannana,11,11,0,0,25
664003,paṭikkamanepīti,patikkamanepiti,1,0,1,0,15
664004,āsanasālāyampi,asanasalayampi,1,1,0,0,14
664005,sambhāvesīti,sambhavesiti,2,0,2,0,12
664006,vijahantassāti,vijahantassati,2,0,2,0,14
664007,vijahantepi,vijahantepi,1,1,0,0,11
664008,vijahitameva,vijahitameva,1,1,0,0,12
664009,upacārabbhantare,upacarabbhantare,3,3,0,0,16
664010,dassanūpacārassa,dassanupacarassa,3,3,0,0,16
664011,savanūpacārassa,savanupacarassa,4,4,0,0,15
664012,kuṭṭadvārapākārādayo,kuttadvarapakaradayo,3,3,0,0,20
664013,antaritabhāvo,antaritabhavo,1,1,0,0,13
664014,dassanūpacārātikkamo,dassanupacaratikkamo,2,2,0,0,20
664015,P4.0856,P4.0856,1,1,0,0,7
664016,vuttappakāramanācāraṃ,vuttappakaramanacaram,1,1,0,0,21
664017,amanāpavacanaṃ,amanapavacanam,2,2,0,0,14
664018,uyyojanasikkhāpadaṃ,uyyojanasikkhapadam,6,6,0,0,19
664019,sabhojanasikkhāpadavaṇṇanā,sabhojanasikkhapadavannana,13,13,0,0,26
664020,sayanighareti,sayanighareti,7,5,2,0,13
664021,sayaniyaghare,sayaniyaghare,2,2,0,0,13
664022,methunādhippāyoti,methunadhippayoti,1,1,0,0,17
664023,sabhojanaṃ,sabhojanam,9,4,5,0,10
664024,sabhojaneti,sabhojaneti,5,0,5,0,11
664025,sabhoge,sabhoge,3,3,0,0,7
664026,rāgapariyuṭṭhitassa,ragapariyutthitassa,2,2,0,0,19
664027,sayanighare,sayanighare,18,17,1,0,11
664028,piṭṭhasaṅghāṭo,pitthasanghato,5,2,3,0,14
664029,antosayanassa,antosayanassa,2,2,0,0,13
664030,mahācatussālādīsu,mahacatussaladisu,2,2,0,0,17
664031,piṭṭhivaṃsaṃ,pitthivamsam,16,13,3,0,12
664032,majjhātikkamaṃ,majjhatikkamam,3,2,1,0,14
664033,sayanigharassa,sayanigharassa,5,5,0,0,14
664034,majjhātikkame,majjhatikkame,1,1,0,0,13
664035,sabhojanasikkhāpadaṃ,sabhojanasikkhapadam,8,8,0,0,20
664036,catutthapañcamasikkhāpadesu,catutthapancamasikkhapadesu,1,1,0,0,27
664037,aniyatadvaye,aniyatadvaye,5,4,1,0,12
664038,P4.0857,P4.0857,1,1,0,0,7
664039,paṭhamapārājikasamuṭṭhānānevāti,pathamaparajikasamutthananevati,1,1,0,0,31
664040,rahopaṭicchannasikkhāpadaṃ,rahopaticchannasikkhapadam,5,5,0,0,26
664041,cārittasikkhāpadavaṇṇanā,carittasikkhapadavannana,13,13,0,0,24
664042,anabhihaṭe,anabhihate,1,1,0,0,10
664043,nikkhipathāti,nikkhipathati,1,0,1,0,13
664044,ussāriyitthāti,ussariyitthati,1,0,1,0,14
664045,paṭihariyittha,patihariyittha,1,1,0,0,14
664046,gharaṃyeva,gharamyeva,1,1,0,0,10
664047,payirupāsanacittaṃ,payirupasanacittam,4,4,0,0,18
664048,pakativacanena,pakativacanena,7,7,0,0,14
664049,ārocanakiccaṃ,arocanakiccam,19,17,2,0,13
664050,asantoyeva,asantoyeva,3,3,0,0,10
664051,antoupacārasīmāya,antoupacarasimaya,14,13,1,0,17
664052,āpucchissāmīti,apucchissamiti,1,1,0,0,14
664053,antarārāmaṃ,antararamam,8,4,4,0,11
664054,bhattiyagharaṃ,bhattiyagharam,4,1,3,0,14
664055,nimantitagharaṃ,nimantitagharam,3,3,0,0,15
664056,salākabhattādidāyakānaṃ,salakabhattadidayakanam,2,2,0,0,23
664057,kiriyākirayaṃ,kiriyakirayam,1,1,0,0,13
664058,cārittasikkhāpadaṃ,carittasikkhapadam,8,8,0,0,18
664059,mahānāmasikkhāpadavaṇṇanā,mahanamasikkhapadavannana,13,13,0,0,25
664060,ṭhapitasappi,thapitasappi,1,1,0,0,12
664061,sāditabbāti,saditabbati,8,3,5,0,11
664062,viññāpessāmīti,vinnapessamiti,4,4,0,0,14
664063,pavāremīti,pavaremiti,1,0,1,0,10
664064,parimāṇavasena,parimanavasena,3,3,0,0,14
664065,āḷhakenāti,alhakenati,1,1,0,0,10
664066,P4.0858,P4.0858,1,1,0,0,7
664067,missakabhattenapi,missakabhattenapi,1,1,0,0,17
664068,bhesajjakaraṇīyaṃ,bhesajjakaraniyam,1,1,0,0,17
664069,pavāritānurūpena,pavaritanurupena,1,1,0,0,16
664070,sallakkhetabbamevāti,sallakkhetabbamevati,1,1,0,0,20
664071,mahānāmasikkhāpadaṃ,mahanamasikkhapadam,8,7,1,0,19
664072,uyyuttasenāsikkhāpadavaṇṇanā,uyyuttasenasikkhapadavannana,13,13,0,0,28
664073,abbhuyyātoti,abbhuyyatoti,1,0,1,0,12
664074,abhiuyyāto,abhiuyyato,1,1,0,0,10
664075,katauyyogaṃ,katauyyogam,4,4,0,0,11
664076,dvādasapuriso,dvadasapuriso,12,9,3,0,13
664077,ārohakā,arohaka,2,2,0,0,7
664078,ekekapādarakkhakā,ekekapadarakkhaka,2,2,0,0,17
664079,tipuriso,tipuriso,9,7,2,0,8
664080,ārohako,arohako,2,2,0,0,7
664081,pādarakkhakāti,padarakkhakati,3,3,0,0,14
664082,catupuriso,catupuriso,7,5,2,0,10
664083,āṇirakkhakāti,anirakkhakati,2,2,0,0,13
664084,sarahatthāti,sarahatthati,1,0,1,0,12
664085,oruḷhā,orulha,3,3,0,0,6
664086,ekapurisāruḷhakahatthimpi,ekapurisarulhakahatthimpi,1,1,0,0,25
664087,sarahatthaṃ,sarahattham,4,3,1,0,11
664088,anuyyuttā,anuyyutta,6,4,2,0,9
664089,uyyuttasenāsikkhāpadaṃ,uyyuttasenasikkhapadam,6,6,0,0,22
664090,senāvāsasikkhāpadavaṇṇanā,senavasasikkhapadavannana,13,13,0,0,25
664091,P4.0859,P4.0859,1,1,0,0,7
664092,verikena,verikena,3,3,0,0,8
664093,senāvāsasikkhāpadaṃ,senavasasikkhapadam,6,6,0,0,19
664094,uyyodhikasikkhāpadavaṇṇanā,uyyodhikasikkhapadavannana,11,11,0,0,26
664095,yujjhantīti,yujjhantiti,4,3,1,0,11
664096,sampahāraṭṭhānassetaṃ,sampaharatthanassetam,3,3,0,0,21
664097,balagaṇanaṭṭhānanti,balagananatthananti,4,3,1,0,19
664098,viyūhaṃ,viyuham,5,4,1,0,7
664099,senānivesassetaṃ,senanivesassetam,2,2,0,0,16
664100,uyyuttasenāsikkhāpade,uyyuttasenasikkhapade,3,3,0,0,21
664101,uyyodhikasikkhāpadaṃ,uyyodhikasikkhapadam,6,6,0,0,20
664102,surāpānavaggo,surapanavaggo,23,23,0,0,13
664103,surāpānasikkhāpadavaṇṇanā,surapanasikkhapadavannana,15,15,0,0,25
664104,surāpānavaggassa,surapanavaggassa,5,5,0,0,16
664105,bhaddavatikāti,bhaddavatikati,3,0,3,0,14
664106,kāpotikāti,kapotikati,2,0,2,0,10
664107,kapotapādasamavaṇṇarattobhāsā,kapotapadasamavannarattobhasa,2,2,0,0,29
664108,surāmaṇḍassetaṃ,suramandassetam,3,3,0,0,15
664109,ananucchaviyaṃ,ananucchaviyam,2,1,1,0,14
664110,sāgatassāti,sagatassati,2,1,1,0,11
664111,anucchaviyanti,anucchaviyanti,1,1,0,0,14
664112,madhukapupphādīnaṃ,madhukapupphadinam,3,3,0,0,18
664113,muddikaphalādīni,muddikaphaladini,1,1,0,0,16
664114,muddikānaṃ,muddikanam,5,5,0,0,10
664115,makkhikamadhunāpi,makkhikamadhunapi,1,1,0,0,17
664116,ucchurasādīhi,ucchurasadihi,1,1,0,0,13
664117,piṭṭhakiṇṇapakkhittā,pitthakinnapakkhitta,1,1,0,0,20
664118,nāḷikerādīnampi,nalikeradinampi,1,1,0,0,15
664119,surātveva,suratveva,1,1,0,0,9
664120,kiṇṇapakkhittāya,kinnapakkhittaya,1,1,0,0,16
664121,merayotveva,merayotveva,1,1,0,0,11
664122,pivatopi,pivatopi,5,5,0,0,8
664123,P4.0860,P4.0860,1,1,0,0,7
664124,payogagaṇanāya,payogagananaya,57,57,0,0,14
664125,amajjañca,amajjanca,2,1,1,0,9
664126,majjavaṇṇaṃ,majjavannam,4,2,2,0,11
664127,majjagandhaṃ,majjagandham,3,2,1,0,12
664128,majjarasaṃ,majjarasam,3,2,1,0,10
664129,sūpasampāketi,supasampaketi,1,0,1,0,13
664130,vāsagāhāpanatthaṃ,vasagahapanattham,1,1,0,0,17
664131,maṃsasampāke,mamsasampake,5,4,1,0,12
664132,vātabhesajjatthaṃ,vatabhesajjattham,1,1,0,0,17
664133,anatikkhittamajjeyeva,anatikkhittamajjeyeva,2,2,0,0,21
664134,atikkhittamajjaṃ,atikkhittamajjam,2,2,0,0,16
664135,amajjaṃ,amajjam,7,5,2,0,7
664136,āmalakādīnaṃyeva,amalakadinamyeva,1,1,0,0,16
664137,majjavaṇṇagandharasoyeva,majjavannagandharasoyeva,1,1,0,0,24
664138,sambhārapakkhitto,sambharapakkhitto,1,1,0,0,17
664139,vatthuajānanatāya,vatthuajananataya,8,7,1,0,17
664140,acittakatā,acittakata,12,12,0,0,10
664141,akusaleneva,akusaleneva,43,42,1,0,11
664142,lokavajjatāti,lokavajjatati,3,3,0,0,13
664143,surāpānasikkhāpadaṃ,surapanasikkhapadam,5,5,0,0,19
664144,aṅgulipatodakasikkhāpadavaṇṇanā,angulipatodakasikkhapadavannana,12,12,0,0,31
664145,aṅgulipatodakenāti,angulipatodakenati,1,0,1,0,18
664146,upakacchakādighaṭṭanaṃ,upakacchakadighattanam,2,2,0,0,22
664147,uttasantoti,uttasantoti,1,0,1,0,11
664148,atihāsena,atihasena,1,1,0,0,9
664149,upacchinnaassāsapassāsasañcāro,upacchinnaassasapassasasancaro,1,1,0,0,30
664150,aṅgulipatodakasikkhāpadaṃ,angulipatodakasikkhapadam,7,7,0,0,25
664151,hasadhammasikkhāpadavaṇṇanā,hasadhammasikkhapadavannana,13,13,0,0,27
664152,appakataññunoti,appakatannunoti,1,0,1,0,15
664153,hasadhammeti,hasadhammeti,2,0,2,0,12
664154,udakakīḷikā,udakakilika,1,1,0,0,11
664155,P4.0861,P4.0861,1,1,0,0,7
664156,uparigopphaketi,uparigopphaketi,2,0,2,0,15
664157,gopphakānaṃ,gopphakanam,9,8,1,0,11
664158,uparibhāgappamāṇe,uparibhagappamane,3,3,0,0,17
664159,hasādhippāyoti,hasadhippayoti,4,0,4,0,14
664160,kīḷādhippāyo,kiladhippayo,6,6,0,0,12
664161,nimujjanatthāya,nimujjanatthaya,1,1,0,0,15
664162,palavatīti,palavatiti,2,1,1,0,10
664163,pādesupi,padesupi,1,1,0,0,8
664164,patanuppatanavāresu,patanuppatanavaresu,1,1,0,0,19
664165,ekapayogattā,ekapayogatta,1,1,0,0,12
664166,uparigopphake,uparigopphake,14,13,1,0,13
664167,ummujjanādīni,ummujjanadini,2,2,0,0,13
664168,khipanakīḷāyapi,khipanakilayapi,2,2,0,0,15
664169,hasadhammasikkhāpadaṃ,hasadhammasikkhapadam,6,6,0,0,21
664170,anādariyasikkhāpadavaṇṇanā,anadariyasikkhapadavannana,13,13,0,0,26
664171,sikkhitukāmoti,sikkhitukamoti,1,0,1,0,14
664172,sikkhitukāmo,sikkhitukamo,3,3,0,0,12
664173,apaññattenāti,apannattenati,3,0,3,0,13
664174,ācariyuggahova,acariyuggahova,4,4,0,0,14
664175,suttānulomañca,suttanulomanca,9,9,0,0,14
664176,uggahitakānaṃyeva,uggahitakanamyeva,4,4,0,0,17
664177,āgatesamodhānaṃ,agatesamodhanam,1,1,0,0,15
664178,P4.0862,P4.0862,1,1,0,0,7
664179,anādariyasikkhāpadaṃ,anadariyasikkhapadam,6,6,0,0,20
664180,bhiṃsāpanasikkhāpadavaṇṇanā,bhimsapanasikkhapadavannana,10,10,0,0,27
664181,rūpūpahārādayo,rupupaharadayo,1,1,0,0,14
664182,anādariyasadisānevāti,anadariyasadisanevati,1,1,0,0,21
664183,bhiṃsāpanasikkhāpadaṃ,bhimsapanasikkhapadam,6,6,0,0,21
664184,jotisikkhāpadavaṇṇanā,jotisikkhapadavannana,13,13,0,0,21
664185,tannissitavanassa,tannissitavanassa,1,1,0,0,17
664186,samādahitvāti,samadahitvati,1,0,1,0,13
664187,paripātesīti,paripatesiti,1,0,1,0,12
664188,padīpepīti,padipepiti,1,0,1,0,10
664189,padīpujjalanepi,padipujjalanepi,1,1,0,0,15
664190,jotikepīti,jotikepiti,2,0,2,0,10
664191,pattapacanasedakammādīsu,pattapacanasedakammadisu,1,1,0,0,24
664192,jotikaraṇe,jotikarane,3,3,0,0,10
664193,tathārūpapaccayāti,tatharupapaccayati,3,0,3,0,18
664194,padīpādipaccayā,padipadipaccaya,1,1,0,0,15
664195,para354-5,para354-5,1,1,0,0,9
664196,samādahitukāmatāya,samadahitukamataya,1,1,0,0,18
664197,araṇisaṇṭhapanato,aranisanthapanato,1,1,0,0,17
664198,avijjhātaṃ,avijjhatam,6,3,3,0,10
664199,pakkhipantasseva,pakkhipantasseva,1,1,0,0,16
664200,jālāpentassa,jalapentassa,3,2,1,0,12
664201,padīpādīni,padipadini,3,3,0,0,10
664202,duṭṭhavāḷamigaamanussehi,dutthavalamigaamanussehi,2,2,0,0,24
664203,samādahantassāpi,samadahantassapi,1,1,0,0,16
664204,jotisikkhāpadaṃ,jotisikkhapadam,4,4,0,0,15
664205,nahānasikkhāpadavaṇṇanā,nahanasikkhapadavannana,10,10,0,0,23
664206,cuṇṇamattikānaṃ,cunnamattikanam,1,1,0,0,15
664207,abhisaṅkharaṇakālato,abhisankharanakalato,1,1,0,0,20
664208,kataāvāṭakesupi,kataavatakesupi,1,1,0,0,15
664209,bhamarādīhi,bhamaradihi,3,3,0,0,11
664210,P4.0863,P4.0863,1,1,0,0,7
664211,anubaddhassa,anubaddhassa,2,2,0,0,12
664212,nahānasikkhāpadaṃ,nahanasikkhapadam,7,7,0,0,17
664213,dubbaṇṇakaraṇasikkhāpadavaṇṇanā,dubbannakaranasikkhapadavannana,13,13,0,0,31
664214,cīvaralābhenāti,civaralabhenati,1,0,1,0,15
664215,labhoyeva,labhoyeva,2,2,0,0,9
664216,navacīvaralābhenā,navacivaralabhena,5,4,1,0,17
664217,paṭiladdhanavacīvarenāti,patiladdhanavacivarenati,5,4,1,0,24
664218,ṭhitapadadvaye,thitapadadvaye,3,3,0,0,14
664219,vikappanupagapacchimaṃ,vikappanupagapacchimam,9,9,0,0,22
664220,cammakāranīlaṃ,cammakaranilam,7,3,4,0,14
664221,ayomalaṃ,ayomalam,3,3,0,0,8
664222,lohamalaṃ,lohamalam,5,5,0,0,9
664223,sakalacīvarassa,sakalacivarassa,1,1,0,0,15
664224,ādiyantena,adiyantena,3,3,0,0,10
664225,akkhimaṇḍalamattaṃ,akkhimandalamattam,3,2,1,0,18
664226,maṅkulapiṭṭhimattaṃ,mankulapitthimattam,1,1,0,0,19
664227,pāḷikappakaṇṇikakappādayo,palikappakannikakappadayo,2,2,0,0,25
664228,vaṭṭabinduṃ,vattabindum,3,2,1,0,11
664229,aggaḷetiādīsu,aggaletiadisu,1,0,1,0,13
664230,aggaḷādīni,aggaladini,2,2,0,0,10
664231,kappakatacīvare,kappakatacivare,2,2,0,0,15
664232,kappakaraṇakiccaṃ,kappakaranakiccam,2,2,0,0,17
664233,dubbaṇṇakaraṇasikkhāpadaṃ,dubbannakaranasikkhapadam,6,6,0,0,25
664234,vikappanasikkhāpadavaṇṇanā,vikappanasikkhapadavannana,15,15,0,0,26
664235,P4.0864,P4.0864,1,1,0,0,7
664236,cīvarasāmikassa,civarasamikassa,3,3,0,0,15
664237,avissasantoti,avissasantoti,1,0,1,0,13
664238,avissāsena,avissasena,4,3,1,0,10
664239,tiṃsakavaṇṇanāyaṃ,timsakavannanayam,2,1,1,0,17
664240,vikappanasikkhāpadaṃ,vikappanasikkhapadam,6,6,0,0,20
664241,cīvarāpanidhānasikkhāpadavaṇṇanā,civarapanidhanasikkhapadavannana,3,3,0,0,32
664242,para377-81,para377-81,1,1,0,0,10
664243,apanidhentīti,apanidhentiti,1,0,1,0,13
664244,hasāpekkhoti,hasapekkhoti,2,0,2,0,12
664245,anihitaparikkhārena,anihitaparikkharena,3,3,0,0,19
664246,nikkhipato,nikkhipato,3,3,0,0,10
664247,cīvarāpanidhānasikkhāpadaṃ,civarapanidhanasikkhapadam,2,2,0,0,26
664248,sappāṇakavaggo,sappanakavaggo,26,26,0,0,14
664249,sañciccapāṇasikkhāpadavaṇṇanā,sanciccapanasikkhapadavannana,4,4,0,0,29
664250,sappāṇakavaggassa,sappanakavaggassa,4,4,0,0,17
664251,dhanuggahācariyo,dhanuggahacariyo,5,3,2,0,16
664252,viyojitā,viyojita,5,5,0,0,8
664253,sikkhāpadepi,sikkhapadepi,6,6,0,0,12
664254,viyojeyya,viyojeyya,5,5,0,0,9
664255,viyojite,viyojite,5,5,0,0,8
664256,sīsālaṅkāre,sisalankare,2,2,0,0,11
664257,voropite,voropite,1,1,0,0,8
664258,pāṇepi,panepi,1,1,0,0,6
664259,antaradhānameva,antaradhanameva,1,1,0,0,15
664260,upacchindatī,upacchindati,1,1,0,0,12
664261,tiracchānagatoyeva,tiracchanagatoyeva,3,3,0,0,18
664262,āpattinānākaraṇaṃ,apattinanakaranam,2,2,0,0,17
664263,upakkamamahantattā,upakkamamahantatta,2,2,0,0,18
664264,akusalamahattaṃ,akusalamahattam,1,1,0,0,15
664265,pāṇasaññīti,panasanniti,1,0,1,0,11
664266,maṅgulabījakepi,mangulabijakepi,3,3,0,0,15
664267,nikkāruṇikatāya,nikkarunikataya,3,3,0,0,15
664268,P4.0865,P4.0865,1,1,0,0,7
664269,sañciccapāṇasikkhāpadaṃ,sanciccapanasikkhapadam,2,2,0,0,23
664270,pattapūrampi,pattapurampi,3,3,0,0,12
664271,dhovatopi,dhovatopi,2,2,0,0,9
664272,uṇhayāgupattaṃ,unhayagupattam,1,1,0,0,14
664273,nibbāpayatopi,nibbapayatopi,1,1,0,0,13
664274,nhāyatopi,nhayatopi,3,2,1,0,9
664275,bahinikkhamanatthāya,bahinikkhamanatthaya,1,1,0,0,20
664276,uṭṭhāpayatopi,utthapayatopi,3,3,0,0,13
664277,kappiyaudakassa,kappiyaudakassa,4,4,0,0,15
664278,udakasaṇṭhānakappadese,udakasanthanakappadese,2,2,0,0,22
664279,nāsiñcitabbaṃ,nasincitabbam,2,2,0,0,13
664280,kappiyaudakena,kappiyaudakena,4,4,0,0,14
664281,paṭaṅgapāṇakānaṃ,patangapanakanam,2,2,0,0,16
664282,dīpajālane,dipajalane,2,2,0,0,10
664283,sappāṇakabhāvaṃ,sappanakabhavam,3,3,0,0,15
664284,paṇṇattivajjatā,pannattivajjata,5,5,0,0,15
664285,ukkoṭanasikkhāpadavaṇṇanā,ukkotanasikkhapadavannana,11,11,0,0,25
664286,ukkoṭentīti,ukkotentiti,2,1,1,0,11
664287,uccālenti,uccalenti,1,1,0,0,9
664288,yathāpatiṭṭhitabhāvena,yathapatitthitabhavena,3,2,1,0,22
664289,vūpasamanāya,vupasamanaya,4,4,0,0,12
664290,nihatādhikaraṇaṃ,nihatadhikaranam,15,12,3,0,16
664291,vuttadhammeneva,vuttadhammeneva,2,2,0,0,15
664292,P4.0866,P4.0866,1,1,0,0,7
664293,ukkoṭeti,ukkoteti,77,75,2,0,8
664294,tassevattho,tassevattho,5,5,0,0,11
664295,vaṇṇayimha,vannayimha,1,1,0,0,10
664296,ukkoṭanasikkhāpadaṃ,ukkotanasikkhapadam,6,6,0,0,19
664297,duṭṭhullasikkhāpadavaṇṇanā,dutthullasikkhapadavannana,11,11,0,0,26
664298,saṅghādisesāpatti,sanghadisesapatti,18,18,0,0,17
664299,chādentassa,chadentassa,28,22,6,0,11
664300,nikkhittamatteti,nikkhittamatteti,8,0,8,0,16
664301,nikkhittamatteyeva,nikkhittamatteyeva,4,4,0,0,18
664302,paṭicchādanatthameva,paticchadanatthameva,4,4,0,0,20
664303,vatthupuggaloyeva,vatthupuggaloyeva,1,1,0,0,17
664304,pañcāpattikkhandhe,pancapattikkhandhe,3,3,0,0,18
664305,duṭṭhullaajjhācāro,dutthullaajjhacaro,4,2,2,0,18
664306,dhuranikkhepasamuṭṭhānaṃ,dhuranikkhepasamutthanam,23,22,1,0,24
664307,P4.0867,P4.0867,1,1,0,0,7
664308,duṭṭhullasikkhāpadaṃ,dutthullasikkhapadam,5,5,0,0,20
664309,ūnavīsativassasikkhāpadavaṇṇanā,unavisativassasikkhapadavannana,16,16,0,0,31
664310,likhantassa,likhantassa,2,2,0,0,11
664311,piṅgalamakkhikāyo,pingalamakkhikayo,4,3,1,0,17
664312,kaṭukarasasadisānaṃ,katukarasasadisanam,1,1,0,0,19
664313,udakukkhepaparicchindanepi,udakukkhepaparicchindanepi,1,1,0,0,26
664314,paripuṇṇavīsativassoti,paripunnavisativassoti,1,0,1,0,22
664315,paripuṇṇavīsativasso,paripunnavisativasso,11,11,0,0,20
664316,gabbhavīsopi,gabbhavisopi,3,3,0,0,12
664317,paripuṇṇavīsativassotveva,paripunnavisativassotveva,2,2,0,0,25
664318,nukhomhi,nukhomhi,1,1,0,0,8
664319,gabbhavīsaṃ,gabbhavisam,3,3,0,0,11
664320,dvādasamāse,dvadasamase,3,3,0,0,11
664321,hāyanavaḍḍhanaṃ,hayanavaddhanam,6,2,4,0,15
664322,ekūnavīsativassaṃ,ekunavisativassam,17,14,3,0,17
664323,nikkhamanīyapuṇṇamāsiṃ,nikkhamaniyapunnamasim,8,8,0,0,22
664324,P4.0868,P4.0868,1,1,0,0,7
664325,cātuddasikauposathā,catuddasikauposatha,2,2,0,0,19
664326,ekavīsativasso,ekavisativasso,6,4,2,0,14
664327,sattamāsādhikavīsativasso,sattamasadhikavisativasso,2,2,0,0,25
664328,chamāsajāto,chamasajato,2,2,0,0,11
664329,paripuṇṇavīsativassasaññīti,paripunnavisativassasanniti,1,0,1,0,27
664330,dasavassaccayena,dasavassaccayena,5,4,1,0,16
664331,sūpasampanno,supasampanno,10,10,0,0,12
664332,mokkhantarāyo,mokkhantarayo,4,4,0,0,13
664333,upasampajjitabbaṃ,upasampajjitabbam,4,4,0,0,17
664334,ūnavīsativassasikkhāpadaṃ,unavisativassasikkhapadam,6,6,0,0,25
664335,theyyasatthasikkhāpadavaṇṇanā,theyyasatthasikkhapadavannana,11,11,0,0,29
664336,paṭiyālokaṃ,patiyalokam,8,3,5,0,11
664337,sūriyālokassa,suriyalokassa,2,2,0,0,13
664338,pacchimadisanti,pacchimadisanti,1,1,0,0,15
664339,kammiyāti,kammiyati,1,0,1,0,9
664340,kālavisaṅketena,kalavisanketena,3,3,0,0,15
664341,divasavisaṅketena,divasavisanketena,1,1,0,0,17
664342,maggavisaṅketena,maggavisanketena,3,3,0,0,16
664343,aṭavivisaṅketena,atavivisanketena,2,2,0,0,16
664344,bhikkhunivagge,bhikkhunivagge,4,4,0,0,14
664345,theyyasatthasamuṭṭhānaṃ,theyyasatthasamutthanam,28,24,4,0,23
664346,theyyasatthasikkhāpadaṃ,theyyasatthasikkhapadam,6,6,0,0,23
664347,P4.0869,P4.0869,1,1,0,0,7
664348,padhūpento,padhupento,3,1,2,0,10
664349,nippātesīti,nippatesiti,1,0,1,0,11
664350,saṃvidhānasikkhāpade,samvidhanasikkhapade,3,2,1,0,20
664351,ariṭṭhasikkhāpadavaṇṇanā,aritthasikkhapadavannana,12,12,0,0,24
664352,pañcānantariyakammā,pancanantariyakamma,1,1,0,0,19
664353,ariyūpavādā,ariyupavada,5,4,1,0,11
664354,itthirūpā,itthirupa,2,2,0,0,9
664355,itthiphoṭṭhabbā,itthiphotthabba,2,2,0,0,15
664356,P4.0870,P4.0870,1,1,0,0,7
664357,aṭṭhikaṅkalūpamātiādimhi,atthikankalupamatiadimhi,1,0,1,0,24
664358,sāsaṅkasappaṭibhayaṭṭhenāti,sasankasappatibhayatthenati,1,1,0,0,27
664359,byākhoti,byakhoti,1,0,1,0,8
664360,ukkhittasambhogasikkhāpadavaṇṇanā,ukkhittasambhogasikkhapadavannana,14,14,0,0,33
664361,akaṭānudhammenāti,akatanudhammenati,1,0,1,0,17
664362,ukkhittakassa,ukkhittakassa,39,39,0,0,13
664363,anulomavattaṃ,anulomavattam,6,5,1,0,13
664364,osāraṇā,osarana,40,28,12,0,7
664365,osāraṇasaṅkhāto,osaranasankhato,5,5,0,0,15
664366,akaṭānudhammo,akatanudhammo,3,2,1,0,13
664367,anosārito,anosarito,5,4,1,0,9
664368,ukkhittasambhogasikkhāpadaṃ,ukkhittasambhogasikkhapadam,6,6,0,0,27
664369,kaṇṭakasikkhāpadavaṇṇanā,kantakasikkhapadavannana,13,13,0,0,24
664370,nāsetūti,nasetuti,1,0,1,0,8
664371,P4.0871,P4.0871,1,1,0,0,7
664372,samaṇuddesa,samanuddesa,13,11,2,0,11
664373,apadisitabbo,apadisitabbo,11,11,0,0,12
664374,amāmaka,amamaka,5,5,0,0,7
664375,upalāpeyyāti,upalapeyyati,3,0,3,0,12
664376,upaṭṭhāpeyyāti,upatthapeyyati,4,0,4,0,14
664377,ariṭṭhasikkhāpade,aritthasikkhapade,4,2,2,0,17
664378,kaṇṭakasikkhāpadaṃ,kantakasikkhapadam,6,6,0,0,18
664379,sahadhammikavaggo,sahadhammikavaggo,26,26,0,0,17
664380,sahadhammikasikkhāpadavaṇṇanā,sahadhammikasikkhapadavannana,10,10,0,0,29
664381,sahadhammikavaggassa,sahadhammikavaggassa,5,4,1,0,20
664382,sikkhamānena,sikkhamanena,5,4,1,0,12
664383,sikkhitukāmeneva,sikkhitukameneva,2,2,0,0,16
664384,ājānitabbañceva,ajanitabbanceva,1,1,0,0,15
664385,pucchitabbañca,pucchitabbanca,4,3,1,0,14
664386,dubbacasikkhāpade,dubbacasikkhapade,4,3,1,0,17
664387,sahadhammikasikkhāpadaṃ,sahadhammikasikkhapadam,6,6,0,0,23
664388,vilekhanasikkhāpadavaṇṇanā,vilekhanasikkhapadavannana,11,11,0,0,26
664389,kappiyākappiyaāpattānāpattisaṃvarapahānapaṭisaṃyuttakathā,kappiyakappiyaapattanapattisamvarapahanapatisamyuttakatha,1,1,0,0,57
664390,padabhājanena,padabhajanena,8,8,0,0,13
664391,vinayapariyattimūlakaṃ,vinayapariyattimulakam,1,1,0,0,22
664392,vinayapariyattimūlake,vinayapariyattimulake,2,2,0,0,21
664393,pañcānisaṃse,pancanisamse,38,38,0,0,12
664394,chānisaṃse,chanisamse,7,7,0,0,10
664395,sattānisaṃse,sattanisamse,2,2,0,0,12
664396,aṭṭhānisaṃse,atthanisamse,18,15,3,0,12
664397,navānisaṃse,navanisamse,2,2,0,0,11
664398,dasānisaṃse,dasanisamse,9,9,0,0,11
664399,sīlakkhandhasuguttiādike,silakkhandhasuguttiadike,1,1,0,0,24
664400,P4.0872,P4.0872,1,1,0,0,7
664401,alajjitā,alajjita,14,12,2,0,8
664402,kukkuccapakatatā,kukkuccapakatata,7,6,1,0,16
664403,alajjitāya,alajjitaya,16,11,5,0,10
664404,alajjipuggalo,alajjipuggalo,6,6,0,0,13
664405,kappiyañce,kappiyance,3,3,0,0,10
664406,akappiyañce,akappiyance,2,2,0,0,11
664407,vītikkamatiyeva,vitikkamatiyeva,4,4,0,0,15
664408,sahaseyyacīvaravippavāsabhesajjacīvarakālātikkamanapaccayā,sahaseyyacivaravippavasabhesajjacivarakalatikkamanapaccaya,2,2,0,0,58
664409,P4.0873,P4.0873,1,1,0,0,7
664410,āpannampi,apannampi,4,4,0,0,9
664411,lajjipuggalo,lajjipuggalo,3,3,0,0,12
664412,lajjibhāve,lajjibhave,3,3,0,0,10
664413,ñāṇatāya,nanataya,4,2,2,0,8
664414,akukkuccapakatatāya,akukkuccapakatataya,4,2,2,0,19
664415,akappiyādisaññitāya,akappiyadisannitaya,1,0,1,0,19
664416,vikappetabbaṃ,vikappetabbam,26,26,0,0,13
664417,akhaṇḍasīlo,akhandasilo,3,3,0,0,11
664418,tirojanapadesu,tirojanapadesu,3,3,0,0,14
664419,uppannakukkuccā,uppannakukkucca,4,4,0,0,15
664420,āpattānāpattigarukalahukādibhedaṃ,apattanapattigarukalahukadibhedam,2,2,0,0,33
664421,avinayadharassa,avinayadharassa,4,4,0,0,15
664422,P4.0874,P4.0874,1,1,0,0,7
664423,ariṭṭhabhikkhukaṇṭakasāmaṇeravesālikavajjiputtakā,aritthabhikkhukantakasamaneravesalikavajjiputtaka,4,3,1,0,49
664424,parūpahāraaññāṇakaṅkhāparavitaraṇādivādā,parupaharaannanakankhaparavitaranadivada,1,1,0,0,40
664425,mahāsaṅghikādayo,mahasanghikadayo,6,6,0,0,16
664426,abuddhasāsanaṃ,abuddhasasanam,4,4,0,0,14
664427,katapaggahā,katapaggaha,4,4,0,0,11
664428,pariyattipaṭipattiadhigamavasena,pariyattipatipattiadhigamavasena,3,3,0,0,32
664429,suppaṭipannassapi,suppatipannassapi,3,3,0,0,17
664430,rakkhaṇakā,rakkhanaka,3,3,0,0,10
664431,vīsativaggagaṇaṃ,visativaggaganam,1,1,0,0,16
664432,gamayissanti,gamayissanti,3,3,0,0,12
664433,P4.0875,P4.0875,1,1,0,0,7
664434,sāmaggiuposatho,samaggiuposatho,5,4,1,0,15
664435,suttuddeso,suttuddeso,17,11,6,0,10
664436,adhiṭṭhānauposathoti,adhitthanauposathoti,3,3,0,0,20
664437,vinayadharāyattā,vinayadharayatta,4,4,0,0,16
664438,pannarasikā,pannarasika,12,10,2,0,11
664439,sāmaggipavāraṇā,samaggipavarana,3,3,0,0,15
664440,tevācikā,tevacika,5,5,0,0,8
664441,pavāraṇāti,pavaranati,21,9,12,0,10
664442,pavāraṇāyo,pavaranayo,1,1,0,0,10
664443,vinayadharāyattāni,vinayadharayattani,1,1,0,0,18
664444,vinayadharāyattāva,vinayadharayattava,2,2,0,0,18
664445,dvipiṭakadharopi,dvipitakadharopi,2,2,0,0,16
664446,sāmaṇerūpaṭṭhānaṃ,samanerupatthanam,1,1,0,0,17
664447,nissayadānañceva,nissayadananceva,2,2,0,0,16
664448,sāmaṇerūpaṭṭhānañca,samanerupatthananca,2,2,0,0,19
664449,ānisaṃsesu,anisamsesu,5,5,0,0,10
664450,P4.0876,P4.0876,1,1,0,0,7
664451,kirānisaṃse,kiranisamse,1,1,0,0,11
664452,yathāparikittitānisaṃsādhigame,yathaparikittitanisamsadhigame,1,1,0,0,30
664453,para439-40,para439-40,2,2,0,0,10
664454,uddissamāneti,uddissamaneti,6,0,6,0,13
664455,uddisante,uddisante,14,11,3,0,9
664456,uddisāpente,uddisapente,4,3,1,0,11
664457,uddissamāno,uddissamano,2,2,0,0,11
664458,khuddānukhuddakehīti,khuddanukhuddakehiti,2,0,2,0,20
664459,anukhuddakehi,anukhuddakehi,4,3,1,0,13
664460,saṃvattanamariyādaparicchedavacanaṃ,samvattanamariyadaparicchedavacanam,4,2,2,0,35
664461,kukkuccasaṅkhāto,kukkuccasankhato,2,2,0,0,16
664462,atisayavavatthāpanaṃ,atisayavavatthapanam,2,2,0,0,20
664463,vilekhāya,vilekhaya,10,10,0,0,9
664464,saṃvattantiyevāti,samvattantiyevati,2,2,0,0,17
664465,vivaṇṇetīti,vivannetiti,2,0,2,0,11
664466,vilekhanasikkhāpadaṃ,vilekhanasikkhapadam,6,6,0,0,20
664467,mohanasikkhāpadavaṇṇanā,mohanasikkhapadavannana,10,10,0,0,23
664468,uddisiyamāne,uddisiyamane,9,9,0,0,12
664469,P4.0877,P4.0877,1,1,0,0,7
664470,pātimokkhuddesake,patimokkhuddesake,3,3,0,0,17
664471,desanāgāminiñce,desanagaminince,1,1,0,0,15
664472,vuṭṭhānagāminiñce,vutthanagaminince,1,1,0,0,17
664473,dhammakammetiādīsu,dhammakammetiadisu,3,1,2,0,18
664474,mohāropanakammaṃ,moharopanakammam,4,4,0,0,16
664475,mohanasikkhāpadaṃ,mohanasikkhapadam,7,7,0,0,17
664476,pahārasikkhāpadavaṇṇanā,paharasikkhapadavannana,13,13,0,0,23
664477,virūpakaraṇādhippāyena,virupakaranadhippayena,2,2,0,0,22
664478,anupasampannassāti,anupasampannassati,5,2,3,0,18
664479,viheṭhiyamānoti,vihethiyamanoti,1,0,1,0,15
664480,mokkhādhippāyoti,mokkhadhippayoti,4,0,4,0,16
664481,viheṭhetukāmaṃ,vihethetukamam,3,3,0,0,14
664482,vāḷamigesupi,valamigesupi,2,2,0,0,12
664483,P4.0878,P4.0878,1,1,0,0,7
664484,paṭhamapārājikasadisāni,pathamaparajikasadisani,6,6,0,0,23
664485,pahārasikkhāpadaṃ,paharasikkhapadam,6,6,0,0,17
664486,talasattikasikkhāpadavaṇṇanā,talasattikasikkhapadavannana,13,13,0,0,28
664487,uggirantīti,uggirantiti,1,0,1,0,11
664488,pahāradānākāraṃ,paharadanakaram,2,2,0,0,15
664489,kāyapaṭibaddhampi,kayapatibaddhampi,1,1,0,0,17
664490,pahārasamuccitā,paharasamuccita,3,1,2,0,15
664491,pahāraparicitā,paharaparicita,2,2,0,0,14
664492,laddhapahārattā,laddhapaharatta,1,1,0,0,15
664493,muccitā,muccita,2,2,0,0,7
664494,amūlakasikkhāpadavaṇṇanā,amulakasikkhapadavannana,11,11,0,0,24
664495,anuddhaṃsentīti,anuddhamsentiti,1,0,1,0,15
664496,ākiṇṇadosattā,akinnadosatta,1,1,0,0,13
664497,sāressantī,saressanti,1,1,0,0,10
664498,attaparittāṇaṃ,attaparittanam,3,1,2,0,14
664499,terasakamhi,terasakamhi,1,1,0,0,11
664500,amūlakasikkhāpade,amulakasikkhapade,2,2,0,0,17
664501,amūlakasikkhāpadaṃ,amulakasikkhapadam,9,9,0,0,18
664502,sañciccasikkhāpadavaṇṇanā,sanciccasikkhapadavannana,20,20,0,0,25
664503,upadahantīti,upadahantiti,3,0,3,0,12
664504,katantiādinā,katantiadina,1,1,0,0,12
664505,P4.0879,P4.0879,1,1,0,0,7
664506,amūlakasadisānevāti,amulakasadisanevati,1,1,0,0,19
664507,sañciccasikkhāpadaṃ,sanciccasikkhapadam,10,10,0,0,19
664508,upassutisikkhāpadavaṇṇanā,upassutisikkhapadavannana,13,13,0,0,25
664509,adhikaraṇajātānaṃ,adhikaranajatanam,10,9,1,0,17
664510,bhaṇḍanādīhi,bhandanadihi,1,1,0,0,12
664511,uppannavivādādhikaraṇānaṃ,uppannavivadadhikarananam,2,2,0,0,25
664512,sutisamīpaṃ,sutisamipam,6,4,2,0,11
664513,mantentaṃ,mantentam,4,1,3,0,9
664514,mantayamāne,mantayamane,3,2,1,0,11
664515,mantente,mantente,2,2,0,0,8
664516,vūpasamissāmīti,vupasamissamiti,2,0,2,0,15
664517,parimocessāmīti,parimocessamiti,2,0,2,0,15
664518,mantayamānānaṃ,mantayamananam,8,8,0,0,14
664519,ajānāpanavasena,ajanapanavasena,4,4,0,0,15
664520,upassutisikkhāpadaṃ,upassutisikkhapadam,5,5,0,0,19
664521,kammapaṭibāhanasikkhāpadavaṇṇanā,kammapatibahanasikkhapadavannana,5,5,0,0,32
664522,kammapaṭibāhanasikkhāpadaṃ,kammapatibahanasikkhapadam,4,4,0,0,26
664523,chandaṃadatvāgamanasikkhāpadavaṇṇanā,chandamadatvagamanasikkhapadavannana,9,9,0,0,36
664524,P4.0880,P4.0880,1,1,0,0,7
664525,gamanasikkhāpadaṃ,gamanasikkhapadam,3,3,0,0,17
664526,dubbalasikkhāpadavaṇṇanā,dubbalasikkhapadavannana,16,16,0,0,24
664527,yathāmittatāti,yathamittatati,1,0,1,0,14
664528,yathāmittatāya,yathamittataya,1,1,0,0,14
664529,ujjhāpanakādīsu,ujjhapanakadisu,1,1,0,0,15
664530,dubbalasikkhāpadaṃ,dubbalasikkhapadam,6,6,0,0,18
664531,pariṇāmanasikkhāpadavaṇṇanā,parinamanasikkhapadavannana,9,9,0,0,27
664532,tiṃsake,timsake,1,1,0,0,7
664533,pariṇāmanasikkhāpade,parinamanasikkhapade,2,2,0,0,20
664534,suddhikapācittiyanti,suddhikapacittiyanti,2,2,0,0,20
664535,pariṇāmanasikkhāpadaṃ,parinamanasikkhapadam,8,8,0,0,21
664536,ratanavaggo,ratanavaggo,16,16,0,0,11
664537,antepurasikkhāpadavaṇṇanā,antepurasikkhapadavannana,13,13,0,0,25
664538,rājavaggassa,rajavaggassa,3,3,0,0,12
664539,jānāpitattā,janapitatta,1,1,0,0,11
664540,hatthisambādhanti,hatthisambadhanti,1,1,0,0,17
664541,assarathasammaddapade,assarathasammaddapade,1,0,1,0,21
664542,sammaddaṃ,sammaddam,3,2,1,0,9
664543,hatthisammaddo,hatthisammaddo,2,2,0,0,14
664544,anikkhantarājakaṃ,anikkhantarajakam,2,2,0,0,17
664545,anikkhantarājake,anikkhantarajake,7,4,3,0,16
664546,P4.0881,P4.0881,1,1,0,0,7
664547,aniggataṃ,aniggatam,2,2,0,0,9
664548,aniggataratanakaṃ,aniggataratanakam,2,2,0,0,17
664549,aniggataratanake,aniggataratanake,4,2,2,0,16
664550,antepurasikkhāpadaṃ,antepurasikkhapadam,4,4,0,0,19
664551,ratanasikkhāpadavaṇṇanā,ratanasikkhapadavannana,13,13,0,0,23
664552,para502-3,para502-3,2,2,0,0,9
664553,vissaritvāti,vissaritvati,1,0,1,0,12
664554,mahālataṃ,mahalatam,3,2,1,0,9
664555,uggaṇhāpentassa,ugganhapentassa,5,5,0,0,15
664556,saṅghagaṇapuggalacetiyanavakammānaṃ,sanghaganapuggalacetiyanavakammanam,2,2,0,0,35
664557,saṅghādīnaṃ,sanghadinam,11,10,1,0,11
664558,akappiyavatthu,akappiyavatthu,4,4,0,0,14
664559,kaṇṇapiḷandhanatāḷapaṇṇampi,kannapilandhanatalapannampi,1,1,0,0,27
664560,gihisantakaṃ,gihisantakam,20,17,3,0,12
664561,paṭisāmetuṃ,patisametum,13,13,0,0,11
664562,vaḍḍhakīādayo,vaddhakiadayo,3,3,0,0,13
664563,sayanabhaṇḍaṃ,sayanabhandam,6,6,0,0,13
664564,chandenapi,chandenapi,9,5,4,0,10
664565,ajjhārāme,ajjharame,45,37,8,0,9
664566,ajjhāvasathe,ajjhavasathe,10,7,3,0,12
664567,mahāvihārasadiso,mahaviharasadiso,1,1,0,0,16
664568,mahārāmo,maharamo,1,1,0,0,8
664569,P4.0882,P4.0882,1,1,0,0,7
664570,mahābodhidvārakoṭṭhakaambaṅgaṇasadisesu,mahabodhidvarakotthakaambanganasadisesu,1,1,0,0,39
664571,mahājanasañcaraṇaṭṭhānesu,mahajanasancaranatthanesu,1,1,0,0,25
664572,nimanussaṭṭhāne,nimanussatthane,1,1,0,0,15
664573,ākiṇṇamanussepi,akinnamanussepi,2,1,1,0,15
664574,antobhaṇḍikāya,antobhandikaya,1,1,0,0,14
664575,lañchanādi,lanchanadi,2,2,0,0,10
664576,lañchitāya,lanchitaya,1,1,0,0,10
664577,mattikālañchananti,mattikalanchananti,1,1,0,0,18
664578,lākhālañchananti,lakhalanchananti,1,1,0,0,16
664579,setapilotikāya,setapilotikaya,1,1,0,0,14
664580,lolajātikānañhi,lolajatikananhi,2,2,0,0,15
664581,cīvarādimūlaṃ,civaradimulam,2,2,0,0,13
664582,gaṇhātītiādīsu,ganhatitiadisu,2,0,2,0,14
664583,āmāsameva,amasameva,1,1,0,0,9
664584,ratanasikkhāpadaṃ,ratanasikkhapadam,7,6,1,0,17
664585,vikālagāmappavisanasikkhāpadavaṇṇanā,vikalagamappavisanasikkhapadavannana,7,7,0,0,36
664586,rājapaṭisaṃyutta,rajapatisamyutta,1,1,0,0,16
664587,P4.0883,P4.0883,1,1,0,0,7
664588,cārittasikkhāpade,carittasikkhapade,4,4,0,0,17
664589,āpucchanakiccaṃ,apucchanakiccam,25,23,2,0,15
664590,āpucchitabbameva,apucchitabbameva,3,3,0,0,16
664591,sappibhikkhāya,sappibhikkhaya,5,5,0,0,14
664592,gāmamajjhena,gamamajjhena,4,4,0,0,12
664593,telādibhikkhāya,teladibhikkhaya,2,2,0,0,15
664594,gacchantassapi,gacchantassapi,7,7,0,0,14
664595,bahigāmato,bahigamato,6,6,0,0,10
664596,vikālagāmappavisanasikkhāpadaṃ,vikalagamappavisanasikkhapadam,4,4,0,0,30
664597,sūcigharasikkhāpadavaṇṇanā,sucigharasikkhapadavannana,13,13,0,0,26
664598,para517-20,para517-20,2,2,0,0,10
664599,bhedanameva,bhedanameva,5,4,1,0,11
664600,bhedanakaṃ,bhedanakam,23,17,6,0,10
664601,bhedanakameva,bhedanakameva,1,1,0,0,13
664602,araṇiketi,araniketi,3,0,3,0,9
664603,vedhake,vedhake,3,3,0,0,7
664604,sūcigharasikkhāpadaṃ,sucigharasikkhapadam,6,6,0,0,20
664605,mañcasikkhāpadavaṇṇanā,mancasikkhapadavannana,3,3,0,0,22
664606,chedanakaṃ,chedanakam,41,28,13,0,10
664607,P4.0884,P4.0884,1,1,0,0,7
664608,tulāsaṅghāṭe,tulasanghate,3,3,0,0,12
664609,mañcasikkhāpadaṃ,mancasikkhapadam,2,2,0,0,16
664610,tūlonaddhasikkhāpadavaṇṇanā,tulonaddhasikkhapadavannana,13,13,0,0,27
664611,onaddhametthāti,onaddhametthati,3,3,0,0,15
664612,tūlonaddhaṃ,tulonaddham,23,18,5,0,11
664613,cimilikāya,cimilikaya,9,9,0,0,10
664614,onaddhanti,onaddhanti,2,2,0,0,10
664615,tūlonaddhasikkhāpadaṃ,tulonaddhasikkhapadam,6,6,0,0,21
664616,nisīdanasikkhāpadavaṇṇanā,nisidanasikkhapadavannana,20,20,0,0,25
664617,para531-4,para531-4,1,1,0,0,9
664618,paṇītabhojanavatthusmiṃ,panitabhojanavatthusmim,2,2,0,0,23
664619,kāyaguttiyā,kayaguttiya,3,3,0,0,11
664620,cīvaraguttiyā,civaraguttiya,3,3,0,0,13
664621,senāsanaguttiyā,senasanaguttiya,3,3,0,0,15
664622,purāṇāsikoṭṭhoti,puranasikotthoti,1,0,1,0,16
664623,purāṇacammakāroti,puranacammakaroti,1,1,0,0,17
664624,samañchati,samanchati,1,1,0,0,10
664625,santhatasadisaṃ,santhatasadisam,12,11,1,0,15
664626,dasāhi,dasahi,8,8,0,0,6
664627,nisīdanasikkhāpadaṃ,nisidanasikkhapadam,5,5,0,0,19
664628,kaṇḍupaṭicchādisikkhāpadavaṇṇanā,kandupaticchadisikkhapadavannana,3,3,0,0,32
664629,kaṇḍupaṭicchādi,kandupaticchadi,9,7,2,0,15
664630,belaṭṭhasīsavatthusmiṃ,belatthasisavatthusmim,1,1,0,0,22
664631,assāvo,assavo,8,8,0,0,6
664632,thullakacchu,thullakacchu,10,8,2,0,12
664633,kaṇḍupaṭicchādiṃ,kandupaticchadim,4,4,0,0,16
664634,adhonābhi,adhonabhi,4,3,1,0,9
664635,ubbhajāṇumaṇḍalaṃ,ubbhajanumandalam,38,29,9,0,17
664636,jāṇumaṇḍalānaṃ,janumandalanam,14,14,0,0,14
664637,lohitatuṇḍikā,lohitatundika,4,3,1,0,13
664638,sukhumapiḷakā,sukhumapilaka,2,2,0,0,13
664639,assāvoti,assavoti,4,0,4,0,8
664640,arisabhagandaramadhumehādīnaṃ,arisabhagandaramadhumehadinam,1,1,0,0,29
664641,asucipaggharaṇakaṃ,asucipaggharanakam,1,1,0,0,18
664642,mahāpiḷakābādho,mahapilakabadho,2,2,0,0,15
664643,kaṇḍupaṭicchādisikkhāpadaṃ,kandupaticchadisikkhapadam,2,2,0,0,26
664644,P4.0885,P4.0885,1,1,0,0,7
664645,nandattherasikkhāpadavaṇṇanā,nandattherasikkhapadavannana,3,3,0,0,28
664646,caturaṅgulomakoti,caturangulomakoti,1,0,1,0,17
664647,ūnakappamāṇo,unakappamano,1,1,0,0,12
664648,nandattherasikkhāpadaṃ,nandattherasikkhapadam,2,2,0,0,22
664649,khuddakavaṇṇanā,khuddakavannana,4,4,0,0,15
664650,pāṭidesanīyakaṇḍaṃ,patidesaniyakandam,22,22,0,0,18
664651,paṭhamapāṭidesanīyasikkhāpadavaṇṇanā,pathamapatidesaniyasikkhapadavannana,12,12,0,0,36
664652,pāṭidesanīyā,patidesaniya,50,49,1,0,12
664653,P4.0886,P4.0886,1,1,0,0,7
664654,paṭhamapāṭidesanīye,pathamapatidesaniye,2,2,0,0,19
664655,paṭikkamanakāleti,patikkamanakaleti,1,0,1,0,17
664656,paṭiāgamanakāle,patiagamanakale,1,1,0,0,15
664657,pavedhentīti,pavedhentiti,1,0,1,0,12
664658,para553-5,para553-5,2,2,0,0,9
664659,paṭidesetabbākāradassanaṃ,patidesetabbakaradassanam,6,3,3,0,25
664660,anibbijjhitvā,anibbijjhitva,5,5,0,0,13
664661,gatapaccāgataracchā,gatapaccagataraccha,3,3,0,0,19
664662,tikoṇaṃ,tikonam,8,7,1,0,7
664663,maggasamodhānaṭṭhānaṃ,maggasamodhanatthanam,4,4,0,0,21
664664,ajjhohāragaṇanāya,ajjhoharagananaya,3,3,0,0,17
664665,hatthisālādīsu,hatthisaladisu,2,2,0,0,14
664666,antarārāmādīsu,antararamadisu,5,5,0,0,14
664667,paviṭṭhāyā,pavitthaya,2,2,0,0,10
664668,vīthiādīsu,vithiadisu,5,4,1,0,10
664669,sambhinne,sambhinne,7,7,0,0,9
664670,pāṭidesanīyameva,patidesaniyameva,4,4,0,0,16
664671,paṭhamapāṭidesanīyaṃ,pathamapatidesaniyam,1,1,0,0,20
664672,dutiyapāṭidesanīyasikkhāpadavaṇṇanā,dutiyapatidesaniyasikkhapadavannana,9,9,0,0,35
664673,P4.0887,P4.0887,1,1,0,0,7
664674,apasakka,apasakka,9,7,2,0,8
664675,bhaginītiādi,bhaginitiadi,2,0,2,0,12
664676,apasādetabbākāradassanaṃ,apasadetabbakaradassanam,2,2,0,0,24
664677,dāpeyya,dapeyya,6,6,0,0,7
664678,dutiyapāṭidesanīyaṃ,dutiyapatidesaniyam,1,1,0,0,19
664679,tatiyapāṭidesanīyasikkhāpadavaṇṇanā,tatiyapatidesaniyasikkhapadavannana,5,5,0,0,35
664680,upāsakenapi,upasakenapi,2,2,0,0,11
664681,edisañhi,edisanhi,1,1,0,0,8
664682,antogehato,antogehato,4,4,0,0,10
664683,tatiyapāṭidesanīyaṃ,tatiyapatidesaniyam,1,1,0,0,19
664684,catutthapāṭidesanīyasikkhāpadavaṇṇanā,catutthapatidesaniyasikkhapadavannana,7,7,0,0,37
664685,appaṭisaṃviditamevāti,appatisamviditamevati,2,2,0,0,21
664686,ārāmūpacāraṃ,aramupacaram,5,4,1,0,12
664687,āraññakasenāsanārāmañca,arannakasenasanaramanca,1,1,0,0,23
664688,P4.0888,P4.0888,1,1,0,0,7
664689,appaṭisaṃviditameva,appatisamviditameva,3,3,0,0,19
664690,sāsaṅkanti,sasankanti,2,1,1,0,10
664691,nārocentīti,narocentiti,1,1,0,0,11
664692,vacanapaṭimocanatthaṃ,vacanapatimocanattham,2,2,0,0,21
664693,idhūpacarantīti,idhupacarantiti,1,0,1,0,15
664694,gaṇhāpentīti,ganhapentiti,2,2,0,0,12
664695,āhariyyatīti,ahariyyatiti,1,0,1,0,12
664696,suddhayāguyā,suddhayaguya,1,1,0,0,12
664697,pūvabhattādīnipi,puvabhattadinipi,2,2,0,0,16
664698,paṭisaṃviditameva,patisamviditameva,1,1,0,0,17
664699,paṭisaṃviditetiādīsupi,patisamviditetiadisupi,1,0,1,0,22
664700,appaṭisaṃviditepi,appatisamviditepi,4,4,0,0,17
664701,paṭisaṃviditasesakameva,patisamviditasesakameva,2,2,0,0,23
664702,āhaṭāvasesepi,ahatavasesepi,1,1,0,0,13
664703,bahiārāmaṃ,bahiaramam,3,3,0,0,10
664704,vanacarakādayo,vanacarakadayo,2,2,0,0,14
664705,mūlakhādanīyādiṃ,mulakhadaniyadim,2,2,0,0,16
664706,catutthapāṭidesanīyaṃ,catutthapatidesaniyam,2,2,0,0,21
664707,P4.0889,P4.0889,1,1,0,0,7
664708,pāṭidesanīyavaṇṇanā,patidesaniyavannana,7,7,0,0,19
664709,sekhiyakaṇḍaṃ,sekhiyakandam,14,14,0,0,13
664710,parimaṇḍalavaggavaṇṇanā,parimandalavaggavannana,7,7,0,0,23
664711,sikkhitasikkhena,sikkhitasikkhena,3,2,1,0,16
664712,sekhiyānīti,sekhiyaniti,1,0,1,0,11
664713,jaṅghaṭṭhikato,janghatthikato,2,2,0,0,14
664714,otārentassa,otarentassa,5,5,0,0,11
664715,pamāṇikaṃ,pamanikam,41,38,3,0,9
664716,aḍḍhateyyahatthaṃ,addhateyyahattham,2,1,1,0,17
664717,dvihatthapamāṇampi,dvihatthapamanampi,1,1,0,0,18
664718,jāṇumaṇḍalapaṭicchādanatthaṃ,janumandalapaticchadanattham,1,1,0,0,28
664719,cīvarenāpi,civarenapi,1,1,0,0,10
664720,ekapaṭṭacīvaraṃ,ekapattacivaram,5,5,0,0,15
664721,nivatthaṭṭhāne,nivatthatthane,1,1,0,0,14
664722,nivāsentasseva,nivasentasseva,3,3,0,0,14
664723,hatthisoṇḍakaṃ,hatthisondakam,10,6,4,0,14
664724,macchavālakaṃ,macchavalakam,4,2,2,0,13
664725,catukkaṇṇakaṃ,catukkannakam,3,2,1,0,13
664726,tālavaṇṭakaṃ,talavantakam,11,6,5,0,12
664727,nivāsanadosā,nivasanadosa,4,4,0,0,12
664728,nivāsentassāpi,nivasentassapi,2,2,0,0,14
664729,nivāsessāmīti,nivasessamiti,11,8,3,0,13
664730,parimaṇḍalaṃyeva,parimandalamyeva,3,3,0,0,16
664731,assatiyāti,assatiyati,3,0,3,0,10
664732,aññavihitassāpi,annavihitassapi,2,2,0,0,15
664733,nivāsanavattaṃ,nivasanavattam,7,6,1,0,14
664734,nivāsanavattañhi,nivasanavattanhi,1,1,0,0,16
664735,anuggahaṇamevassa,anuggahanamevassa,1,1,0,0,17
664736,uggahitavattopi,uggahitavattopi,2,2,0,0,15
664737,P4.0890,P4.0890,1,1,0,0,7
664738,oruḷhabhāvaṃ,orulhabhavam,1,1,0,0,12
664739,sukkhajaṅgho,sukkhajangho,6,5,1,0,12
664740,mahāpiṇḍikamaṃso,mahapindikamamso,5,4,1,0,16
664741,sāruppatthāya,saruppatthaya,9,9,0,0,13
664742,aṭṭhaṅgulādhikampi,atthanguladhikampi,5,5,0,0,18
664743,gihipārupanaṃ,gihiparupanam,2,1,1,0,13
664744,pārupanavattaṃ,parupanavattam,1,1,0,0,14
664745,antaragharepi,antaragharepi,5,4,1,0,13
664746,parimaṇḍalameva,parimandalameva,3,3,0,0,15
664747,nivāsetabbañca,nivasetabbanca,2,2,0,0,14
664748,pārupitabbañcāti,parupitabbancati,1,1,0,0,16
664749,vivaritvāti,vivaritvati,9,2,7,0,11
664750,jattumpi,jattumpi,2,2,0,0,8
664751,suppaṭicchannenāti,suppaticchannenati,2,0,2,0,18
664752,anuvātantena,anuvatantena,3,3,0,0,12
664753,piṇḍikamaṃsato,pindikamamsato,2,2,0,0,14
664754,akīḷāpento,akilapento,3,3,0,0,10
664755,khittacakkhu,khittacakkhu,18,18,0,0,12
664756,P4.0891,P4.0891,1,1,0,0,7
664757,yugayuttako,yugayuttako,2,2,0,0,11
664758,catuhatthappamāṇaṃ,catuhatthappamanam,5,4,1,0,18
664759,pekkhantena,pekkhantena,6,6,0,0,11
664760,taṃtaṃdisābhāgaṃ,tamtamdisabhagam,1,1,0,0,16
664761,hatthiassādiparissayābhāvaṃ,hatthiassadiparissayabhavam,4,3,1,0,27
664762,nisīdantenāpi,nisidantenapi,1,1,0,0,13
664763,okkhittacakkhunāva,okkhittacakkhunava,2,2,0,0,18
664764,ukkhittakāyāti,ukkhittakayati,3,0,3,0,14
664765,ukkhepena,ukkhepena,3,3,0,0,9
664766,ukkhittacīvaro,ukkhittacivaro,5,4,1,0,14
664767,antoindakhīlato,antoindakhilato,3,2,1,0,15
664768,nīharantenāpi,niharantenapi,2,2,0,0,13
664769,ujjagghikavaggavaṇṇanā,ujjagghikavaggavannana,7,7,0,0,22
664770,ujjagghikāyāti,ujjagghikayati,3,0,3,0,14
664771,tatiyattheroti,tatiyattheroti,4,4,0,0,14
664772,saddañceva,saddanceva,3,3,0,0,10
664773,tatiyatthero,tatiyatthero,9,9,0,0,12
664774,gantabbañceva,gantabbanceva,5,4,1,0,13
664775,khambhakatavaggavaṇṇanā,khambhakatavaggavannana,7,7,0,0,23
664776,para596-8,para596-8,2,2,0,0,9
664777,khambhakato,khambhakato,11,7,4,0,11
664778,katakhambho,katakhambho,4,4,0,0,11
664779,oguṇṭhitoti,ogunthitoti,4,0,4,0,11
664780,ukkuṭikāyāti,ukkutikayati,2,0,2,0,12
664781,paṇhiyo,panhiyo,4,4,0,0,7
664782,aggapāde,aggapade,6,6,0,0,8
664783,paṇhīhiyeva,panhihiyeva,2,2,0,0,11
664784,dussapallatthikāyāti,dussapallatthikayati,3,0,3,0,20
664785,āyogapallatthikāpi,ayogapallatthikapi,4,4,0,0,18
664786,ākirantepīti,akirantepiti,1,0,1,0,12
664787,pattasaññīti,pattasanniti,5,2,3,0,12
664788,samasūpako,samasupako,12,8,4,0,10
664789,P4.0892,P4.0892,1,1,0,0,7
664790,māsasūpoti,masasupoti,1,0,1,0,10
664791,kulatthādīhi,kulatthadihi,2,2,0,0,12
664792,katasūpāpi,katasupapi,1,1,0,0,10
664793,gacchantiyevāti,gacchantiyevati,2,2,0,0,15
664794,rasaraseti,rasaraseti,2,1,1,0,10
664795,oloṇīsākasūpeyyamaccharasamaṃsarasādīni,olonisakasupeyyamaccharasamamsarasadini,1,1,0,0,39
664796,rasarasāti,rasarasati,2,2,0,0,10
664797,rasarasaṃ,rasarasam,1,1,0,0,9
664798,samapuṇṇaṃ,samapunnam,6,4,2,0,10
664799,thūpīkato,thupikato,3,2,1,0,9
664800,antomukhavaṭṭilekhāsamappamāṇo,antomukhavattilekhasamappamano,2,2,0,0,30
664801,cuṇṇapiṇḍopi,cunnapindopi,9,9,0,0,12
664802,dasikasuttampī,dasikasuttampi,4,4,0,0,14
664803,cūḷasumanattheraṃ,culasumanattheram,1,1,0,0,17
664804,thūpīkatapiṇḍapāto,thupikatapindapato,1,1,0,0,18
664805,yāvakālikenāvuso,yavakalikenavuso,1,1,0,0,16
664806,āmisajātikaṃ,amisajatikam,4,4,0,0,12
664807,samatittikameva,samatittikameva,1,1,0,0,15
664808,adhiṭṭhānupagena,adhitthanupagena,2,2,0,0,16
664809,thūpīkatampi,thupikatampi,4,4,0,0,12
664810,yāmakālikasattāhakālikayāvajīvikāni,yamakalikasattahakalikayavajivikani,2,2,0,0,35
664811,adhiṭṭhānupagapattepi,adhitthanupagapattepi,1,1,0,0,21
664812,thūpīkatāni,thupikatani,1,1,0,0,11
664813,pakkhipiyamānaṃ,pakkhipiyamanam,5,5,0,0,15
664814,pūvaucchukhaṇḍaphalāphalādi,puvaucchukhandaphalaphaladi,3,3,0,0,27
664815,pūvavaṭaṃsakaṃ,puvavatamsakam,4,2,2,0,14
664816,thūpīkatameva,thupikatameva,2,2,0,0,13
664817,pupphavaṭaṃsakatakkolakaṭukaphalādivaṭaṃsake,pupphavatamsakatakkolakatukaphaladivatamsake,2,2,0,0,44
664818,P4.0893,P4.0893,1,1,0,0,7
664819,pāṭekkabhājanaṃ,patekkabhajanam,2,2,0,0,15
664820,gilānassapi,gilanassapi,16,16,0,0,11
664821,supaṭiggahitameva,supatiggahitameva,2,2,0,0,17
664822,sakkaccavaggavaṇṇanā,sakkaccavaggavannana,7,7,0,0,20
664823,paṭiggahaṇeyeva,patiggahaneyeva,5,4,1,0,15
664824,sakkaccanti,sakkaccanti,2,2,0,0,11
664825,samasūpake,samasupake,2,1,1,0,10
664826,thūpakatoti,thupakatoti,6,2,4,0,11
664827,vemajjhatoti,vemajjhatoti,3,3,0,0,12
664828,māghātasamayādīsu,maghatasamayadisu,2,2,0,0,17
664829,nātimahanto,natimahanto,5,3,2,0,11
664830,kabaḷoti,kabaloti,3,0,3,0,8
664831,atikhuddakaṃ,atikhuddakam,25,22,3,0,12
664832,vemajjhappamāṇo,vemajjhappamano,3,3,0,0,15
664833,khajjaketi,khajjaketi,1,0,1,0,10
664834,mūlakhādanīyādi,mulakhadaniyadi,1,1,0,0,15
664835,kabaḷavaggavaṇṇanā,kabalavaggavannana,7,7,0,0,18
664836,anāhaṭeti,anahateti,4,1,3,0,9
664837,anāharite,anaharite,5,5,0,0,9
664838,asampāpiteti,asampapiteti,3,3,0,0,12
664839,sakalahatthaṃ,sakalahattham,1,1,0,0,13
664840,sakabaḷenāti,sakabalenati,4,0,4,0,12
664841,capu,capu,16,12,4,0,4
664842,capūti,caputi,6,3,3,0,6
664843,surusuruvaggavaṇṇanā,surusuruvaggavannana,7,7,0,0,20
664844,surusurūti,surusuruti,1,1,0,0,10
664845,davoti,davoti,2,1,1,0,6
664846,parihāsavacanaṃ,parihasavacanam,2,2,0,0,15
664847,P4.0894,P4.0894,1,1,0,0,7
664848,silakabuddho,silakabuddho,3,3,0,0,12
664849,godhammo,godhammo,3,3,0,0,8
664850,ajadhammo,ajadhammo,3,3,0,0,9
664851,pasusaṅgho,pasusangho,1,1,0,0,10
664852,nillehitvā,nillehitva,9,9,0,0,10
664853,nillehituṃ,nillehitum,6,6,0,0,10
664854,ghanayāguphāṇitapāyāsādike,ghanayaguphanitapayasadike,3,3,0,0,26
664855,pattanillehakaoṭṭhanillehakesu,pattanillehakaotthanillehakesu,1,0,1,0,30
664856,ekaṅguliyāpi,ekanguliyapi,2,2,0,0,12
664857,nillehitabbo,nillehitabbo,6,6,0,0,12
664858,ekaoṭṭhopi,ekaotthopi,5,5,0,0,10
664859,oṭṭhamaṃsehi,otthamamsehi,3,3,0,0,12
664860,kokanadeti,kokanadeti,1,0,1,0,10
664861,padumasaṇṭhāno,padumasanthano,2,2,0,0,14
664862,kokanadotveva,kokanadotveva,1,1,0,0,13
664863,puggalikampi,puggalikampi,12,12,0,0,12
664864,gihisantakampi,gihisantakampi,3,3,0,0,14
664865,sarāvampi,saravampi,2,2,0,0,9
664866,āmisamakkhito,amisamakkhito,4,4,0,0,13
664867,udakagatikāni,udakagatikani,3,3,0,0,13
664868,paṭiggahena,patiggahena,4,4,0,0,11
664869,vatthapaliguṇṭhitaṃ,vatthapaligunthitam,4,3,1,0,19
664870,paṇḍaracchattaṃ,pandaracchattam,4,4,0,0,15
664871,kilañjacchattaṃ,kilanjacchattam,13,7,6,0,15
664872,vilīvacchattaṃ,vilivacchattam,7,3,4,0,14
664873,paṇṇacchattaṃ,pannacchattam,8,4,4,0,13
664874,maṇḍalabaddhaṃ,mandalabaddham,8,4,4,0,14
664875,salākabaddhaṃ,salakabaddham,8,4,4,0,13
664876,pañjaradassanatthaṃ,panjaradassanattham,3,3,0,0,19
664877,maṇḍalabaddhāni,mandalabaddhani,3,3,0,0,15
664878,salākabaddhāni,salakabaddhani,3,3,0,0,14
664879,tatthajātakadaṇḍakena,tatthajatakadandakena,6,2,4,0,21
664880,ekapaṇṇacchattaṃ,ekapannacchattam,13,10,3,0,16
664881,P4.0895,P4.0895,1,1,0,0,7
664882,chattapādukāya,chattapadukaya,6,4,2,0,14
664883,apagatamatte,apagatamatte,3,3,0,0,12
664884,daṇḍapāṇissāti,dandapanissati,1,0,1,0,14
664885,catuhatthappamāṇo,catuhatthappamano,5,4,1,0,17
664886,daṇḍapāṇibhāvo,dandapanibhavo,2,2,0,0,14
664887,chattapāṇimhi,chattapanimhi,2,2,0,0,13
664888,satthapāṇimhi,satthapanimhi,1,0,1,0,13
664889,satthapāṇisaṅkhyaṃ,satthapanisankhyam,2,2,0,0,18
664890,āvudhapāṇissāti,avudhapanissati,2,1,1,0,15
664891,kodaṇḍo,kodando,4,4,0,0,7
664892,dhanuvikati,dhanuvikati,11,11,0,0,11
664893,saravikatiyā,saravikatiya,2,2,0,0,12
664894,suddhadhanuṃ,suddhadhanum,3,3,0,0,12
664895,suddhasaraṃ,suddhasaram,3,3,0,0,11
664896,sajiyadhanuṃ,sajiyadhanum,2,2,0,0,12
664897,nijjiyadhanuṃ,nijjiyadhanum,2,2,0,0,13
664898,pādukavaggavaṇṇanā,padukavaggavannana,7,7,0,0,18
664899,akkantassāti,akkantassati,2,0,2,0,12
664900,chattadaṇḍake,chattadandake,3,3,0,0,13
664901,paṭimukkassāti,patimukkassati,2,0,2,0,14
664902,upāhanāyapi,upahanayapi,1,1,0,0,11
664903,omukkoti,omukkoti,1,0,1,0,8
664904,paṇhikabaddhaṃ,panhikabaddham,1,1,0,0,14
664905,yānagatassāti,yanagatassati,2,0,2,0,13
664906,hatthasaṅghāṭena,hatthasanghatena,2,2,0,0,16
664907,vayhati,vayhati,3,3,0,0,7
664908,vayhādike,vayhadike,3,3,0,0,9
664909,cakkamattepi,cakkamattepi,3,3,0,0,12
664910,yānagatotveva,yanagatotveva,2,2,0,0,13
664911,nisinnesupi,nisinnesupi,3,3,0,0,11
664912,samappamāṇepi,samappamanepi,2,2,0,0,13
664913,uccatarepi,uccatarepi,3,3,0,0,10
664914,sayanagatassāti,sayanagatassati,4,1,3,0,15
664915,kaṭasārakepi,katasarakepi,8,8,0,0,12
664916,pakatibhūmiyampi,pakatibhumiyampi,3,3,0,0,16
664917,sayanagatena,sayanagatena,2,2,0,0,12
664918,samappamāṇe,samappamane,4,4,0,0,11
664919,P4.0896,P4.0896,1,1,0,0,7
664920,pallatthikāyāti,pallatthikayati,3,0,3,0,15
664921,āyogapallatthikāya,ayogapallatthikaya,3,3,0,0,18
664922,hatthapallatthikāya,hatthapallatthikaya,5,5,0,0,19
664923,dussapallatthikāya,dussapallatthikaya,7,7,0,0,18
664924,veṭhitasīsassāti,vethitasisassati,4,1,3,0,16
664925,dussaveṭhanena,dussavethanena,2,2,0,0,14
664926,moḷiādīhi,moliadihi,2,2,0,0,9
664927,kesanto,kesanto,4,4,0,0,7
664928,oguṇṭhitasīsassāti,ogunthitasisassati,2,0,2,0,18
664929,nisinnenāti,nisinnenati,2,1,1,0,11
664930,chapakassāti,chapakassati,1,0,1,0,12
664931,chapakīti,chapakiti,1,0,1,0,9
664932,nilīnoti,nilinoti,2,0,2,0,8
664933,nimmariyādo,nimmariyado,2,2,0,0,11
664934,passareti,passareti,2,0,2,0,9
664935,cādhammenadhīyatī,cadhammenadhiyati,2,1,1,0,17
664936,adhammikabhāve,adhammikabhave,1,1,0,0,14
664937,saputtadāraparijanena,saputtadaraparijanena,1,1,0,0,21
664938,sucimaṃsūpasecanoti,sucimamsupasecanoti,2,0,2,0,19
664939,nānappakāravikatisampāditaṃ,nanappakaravikatisampaditam,1,1,0,0,27
664940,missīkaraṇamassāti,missikaranamassati,1,1,0,0,18
664941,vattāmīti,vattamiti,1,0,1,0,9
664942,chapako,chapako,2,2,0,0,7
664943,yasalābhañca,yasalabhanca,4,4,0,0,12
664944,P4.0897,P4.0897,1,1,0,0,7
664945,aparibbajitvā,aparibbajitva,1,1,0,0,13
664946,ācarissasi,acarissasi,1,1,0,0,10
664947,bhūmippadesepi,bhumippadesepi,3,3,0,0,14
664948,ṭhitabhikkhussa,thitabhikkhussa,1,1,0,0,15
664949,uggahitadhammaṃ,uggahitadhammam,2,2,0,0,15
664950,ekekacakkapathena,ekekacakkapathena,2,2,0,0,17
664951,P4.0898,P4.0898,1,1,0,0,7
664952,jīvarukkhassa,jivarukkhassa,3,3,0,0,13
664953,bhūmilaggā,bhumilagga,5,5,0,0,10
664954,haritasaṅkhātameva,haritasankhatameva,3,3,0,0,18
664955,appaharitaṭṭhāne,appaharitatthane,3,3,0,0,16
664956,appaharitaṭṭhānaṃ,appaharitatthanam,3,3,0,0,17
664957,gilānaṭṭhāne,gilanatthane,4,4,0,0,12
664958,palālaṇḍupakaṃ,palalandupakam,2,2,0,0,14
664959,siṅghāṇikāpi,singhanikapi,5,3,2,0,12
664960,paribhogaudakameva,paribhogaudakameva,3,3,0,0,18
664961,vaccakuṭisamuddādiudakesu,vaccakutisamuddadiudakesu,3,3,0,0,25
664962,aparibhogesu,aparibhogesu,4,4,0,0,12
664963,anudakaṭṭhānaṃ,anudakatthanam,7,7,0,0,14
664964,samuṭṭhānādidīpanatthāya,samutthanadidipanatthaya,2,2,0,0,24
664965,ujjagghikauccāsaddapaṭisaṃyuttāni,ujjagghikauccasaddapatisamyuttani,1,1,0,0,33
664966,byāharaṇaṃ,byaharanam,2,2,0,0,10
664967,chamānīcāsanaṭhānapacchatogamanauppathagamanapaṭisaṃyuttāni,chamanicasanathanapacchatogamanauppathagamanapatisamyuttani,1,1,0,0,59
664968,samanubhāsanasamuṭṭhānāni,samanubhasanasamutthanani,4,4,0,0,25
664969,saññāvimokkhāni,sannavimokkhani,4,4,0,0,15
664970,lokavajjāni,lokavajjani,22,18,4,0,11
664971,dukkhavedanānīti,dukkhavedananiti,3,3,0,0,16
664972,sūpodanaviññattisikkhāpadaṃ,supodanavinnattisikkhapadam,7,6,1,0,27
664973,chattapāṇidaṇḍapāṇisatthapāṇiāvudhapāṇipādukaupāhanayānasayanapallatthikaveṭhitaoguṇṭhitanāmakāni,chattapanidandapanisatthapaniavudhapanipadukaupahanayanasayanapallatthikavethitaogunthitanamakani,1,1,0,0,97
664974,dhammadesanasamuṭṭhānāni,dhammadesanasamutthanani,2,1,1,0,24
664975,kiriyākiriyāni,kiriyakiriyani,3,3,0,0,14
664976,paṭhamapārājikasamuṭṭhānānīti,pathamaparajikasamutthananiti,1,1,0,0,29
664977,sabbasekhiyesu,sabbasekhiyesu,2,2,0,0,14
664978,thūpīkatapiṇḍapāte,thupikatapindapate,1,1,0,0,18
664979,paṭicchādane,paticchadane,7,7,0,0,12
664980,ujjhānasaññimhīti,ujjhanasannimhiti,1,1,0,0,17
664981,sekhiyavaṇṇanā,sekhiyavannana,4,4,0,0,14
664982,sattādhikaraṇasamathā,sattadhikaranasamatha,1,1,0,0,21
664983,P4.0899,P4.0899,1,1,0,0,7
664984,bhikkhuvibhaṅgavaṇṇanā,bhikkhuvibhangavannana,2,2,0,0,22
664985,medaninti,medaninti,2,2,0,0,9
664986,bhikkhunīvibhaṅgavaṇṇanā,bhikkhunivibhangavannana,16,16,0,0,24
664987,P4.0900,P4.0900,1,1,0,0,7
664988,vibhaṅgassa,vibhangassa,11,11,0,0,11
664989,paṭhamapārājikasikkhāpadavaṇṇanā,pathamaparajikasikkhapadavannana,5,5,0,0,32
664990,sāḷhoti,salhoti,3,2,1,0,7
664991,navakammādhiṭṭhāyikaṃ,navakammadhitthayikam,3,2,1,0,21
664992,veyyattikena,veyyattikena,1,1,0,0,12
664993,pāḷiggahaṇe,paliggahane,1,1,0,0,11
664994,kattabbakārinīti,kattabbakariniti,1,1,0,0,16
664995,ālasiyavirahitā,alasiyavirahita,1,1,0,0,15
664996,kattabbakammupaparikkhāya,kattabbakammupaparikkhaya,1,1,0,0,25
664997,saṃvidahitumpi,samvidahitumpi,1,1,0,0,14
664998,nikūṭeti,nikuteti,2,0,2,0,8
664999,koṇasadisaṃ,konasadisam,2,2,0,0,11
665000,P4.0901,P4.0901,1,1,0,0,7
665001,vissaro,vissaro,4,3,1,0,7
665002,vippakārasaddo,vippakarasaddo,2,2,0,0,14
665003,patimānentīti,patimanentiti,1,0,1,0,13
665004,jarādubbalāti,jaradubbalati,1,0,1,0,13
665005,caraṇagilānāti,caranagilanati,2,0,2,0,14
665006,pādarogena,padarogena,2,2,0,0,10
665007,para657-8,para657-8,1,1,0,0,9
665008,avassutāti,avassutati,9,2,7,0,10
665009,kilinnāti,kilinnati,2,2,0,0,9
665010,apekkhavatīti,apekkhavatiti,2,0,2,0,13
665011,dutiyapadavibhaṅgepi,dutiyapadavibhangepi,1,1,0,0,20
665012,akkhakānaṃ,akkhakanam,10,10,0,0,10
665013,heṭṭhakkhakaṃ,hetthakkhakam,2,2,0,0,13
665014,uparijāṇumaṇḍalaṃ,uparijanumandalam,2,2,0,0,17
665015,ubbhakapparampi,ubbhakapparampi,2,2,0,0,15
665016,ubbhajāṇumaṇḍaleneva,ubbhajanumandaleneva,2,2,0,0,20
665017,mahāvibhaṅge,mahavibhange,35,33,2,0,12
665018,sādhāraṇapārājikehi,sadharanaparajikehi,1,1,0,0,19
665019,pārājikāyo,parajikayo,2,2,0,0,10
665020,ubbhajāṇumaṇḍalikāti,ubbhajanumandalikati,1,0,1,0,20
665021,pārājikāya,parajikaya,10,10,0,0,10
665022,avassutādibhedena,avassutadibhedena,1,1,0,0,17
665023,ubhatoavassute,ubhatoavassute,8,7,1,0,14
665024,ubhatoavassuteti,ubhatoavassuteti,2,1,1,0,16
665025,ubhatoavassave,ubhatoavassave,3,3,0,0,14
665026,avassutabhāve,avassutabhave,5,5,0,0,13
665027,yathāparicchinnena,yathaparicchinnena,4,4,0,0,18
665028,āmasatu,amasatu,2,2,0,0,7
665029,vuttappakārakāyapaṭibaddhena,vuttappakarakayapatibaddhena,1,1,0,0,28
665030,avasesapadesupi,avasesapadesupi,1,1,0,0,15
665031,P4.0902,P4.0902,1,1,0,0,7
665032,acopayamānāpi,acopayamanapi,2,2,0,0,13
665033,kiriyāsamuṭṭhānatā,kiriyasamutthanata,4,4,0,0,18
665034,adhojāṇumaṇḍalaṃ,adhojanumandalam,19,16,3,0,16
665035,adhokapparampi,adhokapparampi,1,1,0,0,14
665036,adhojāṇumaṇḍaleneva,adhojanumandaleneva,1,1,0,0,19
665037,ekatoavassuteti,ekatoavassuteti,5,2,3,0,15
665038,adhakkhake,adhakkhake,3,3,0,0,10
665039,ubbhajāṇumaṇḍale,ubbhajanumandale,4,4,0,0,16
665040,kāyappadese,kayappadese,1,1,0,0,11
665041,kāyasaṃsaggasādiyane,kayasamsaggasadiyane,1,1,0,0,20
665042,methunarāgo,methunarago,8,7,1,0,11
665043,gahessitapemaṃ,gahessitapemam,1,1,0,0,14
665044,asañciccātiādīsu,asanciccatiadisu,3,1,2,0,16
665045,āmasantiyā,amasantiya,6,6,0,0,10
665046,aññavihitāya,annavihitaya,3,3,0,0,12
665047,phuṭṭhāyapi,phutthayapi,2,2,0,0,11
665048,āmasanepi,amasanepi,4,4,0,0,9
665049,P4.0903,P4.0903,1,1,0,0,7
665050,dutiyapārājikasikkhāpadavaṇṇanā,dutiyaparajikasikkhapadavannana,5,5,0,0,31
665051,akittīti,akittiti,1,0,1,0,8
665052,parivāravipatti,parivaravipatti,1,1,0,0,15
665053,parammukhagarahā,parammukhagaraha,2,2,0,0,16
665054,vajjapaṭicchādikāti,vajjapaticchadikati,2,0,2,0,19
665055,pārājikānaṃ,parajikanam,31,28,3,0,11
665056,asādhāraṇānañca,asadharanananca,1,1,0,0,15
665057,sappāṇakavaggamhi,sappanakavaggamhi,2,2,0,0,17
665058,duṭṭhullasikkhāpade,dutthullasikkhapade,2,2,0,0,19
665059,idampiimissā,idampiimissa,1,1,0,0,12
665060,nāmamatthāmeva,namamatthameva,1,1,0,0,14
665061,tatiyapārājikasikkhāpadavaṇṇanā,tatiyaparajikasikkhapadavannana,3,3,0,0,31
665062,suukkhitto,suukkhitto,1,1,0,0,10
665063,adhippāyamattaṃ,adhippayamattam,6,5,1,0,15
665064,satthusāsanenāti,satthusasanenati,9,0,9,0,16
665065,jinasāsanena,jinasasanena,3,3,0,0,12
665066,buddhasāsanenā,buddhasasanena,1,1,0,0,14
665067,vevacanamattameva,vevacanamattameva,1,1,0,0,17
665068,sambahulapuggalasaṅkhātaṃ,sambahulapuggalasankhatam,1,1,0,0,25
665069,P4.0904,P4.0904,1,1,0,0,7
665070,samānasaṃvāsakā,samanasamvasaka,53,50,3,0,15
665071,saṃvāse,samvase,14,14,0,0,7
665072,akatasahāyo,akatasahayo,8,5,3,0,11
665073,saṅghabhedasikkhāpadādīsu,sanghabhedasikkhapadadisu,3,3,0,0,25
665074,catutthapārājikasikkhāpadavaṇṇanā,catutthaparajikasikkhapadavannana,5,5,0,0,33
665075,purisapuggalena,purisapuggalena,2,2,0,0,15
665076,hatthaggahaṇanti,hatthaggahananti,4,4,0,0,16
665077,saṅghāṭikaṇṇaggahaṇepi,sanghatikannaggahanepi,2,1,1,0,22
665078,hatthaggahaṇañca,hatthaggahananca,1,1,0,0,16
665079,apārājikakkhette,aparajikakkhette,2,2,0,0,16
665080,paṭisevanatthāya,patisevanatthaya,19,18,1,0,16
665081,methunassa,methunassa,16,16,0,0,10
665082,P4.0905,P4.0905,1,1,0,0,7
665083,tissitthiyo,tissitthiyo,7,4,3,0,11
665084,anariyapaṇḍake,anariyapandake,2,2,0,0,14
665085,cācare,cacare,5,2,3,0,6
665086,byañjanasmiṃ,byanjanasmim,7,2,5,0,12
665087,methunadhammapaccayā,methunadhammapaccaya,12,11,1,0,20
665088,sedamocakagāthāya,sedamocakagathaya,1,1,0,0,17
665089,vaṇṇāvaṇṇo,vannavanno,2,2,0,0,10
665090,duṭṭhullavācā,dutthullavaca,6,4,2,0,13
665091,attakāmapāricariyāgamanuppādanaṃ,attakamaparicariyagamanuppadanam,1,1,0,0,32
665092,sukkavissaṭṭhiādīni,sukkavissatthiadini,9,9,0,0,19
665093,methunadhammapaccayāti,methunadhammapaccayati,5,1,4,0,22
665094,paripūrentīyeva,paripurentiyeva,1,1,0,0,15
665095,gaṇanūpikā,gananupika,12,11,1,0,10
665096,nāpajjissāmīti,napajjissamiti,1,1,0,0,14
665097,desitagaṇanaṃ,desitagananam,5,5,0,0,13
665098,pūrentīpi,purentipi,2,2,0,0,9
665099,āpajjissāmīti,apajjissamiti,3,3,0,0,13
665100,P4.0906,P4.0906,1,1,0,0,7
665101,nagaṇanūpikā,nagananupika,1,1,0,0,12
665102,desitāpi,desitapi,9,8,1,0,8
665103,adesitā,adesita,6,5,1,0,7
665104,pārājikasseva,parajikasseva,2,2,0,0,13
665105,paripuṇṇamatte,paripunnamatte,1,1,0,0,14
665106,pātimokkhuddesamaggena,patimokkhuddesamaggena,5,5,0,0,22
665107,pārājikakaṇḍavaṇṇanā,parajikakandavannana,5,5,0,0,20
665108,paṭhamasaṅghādisesasikkhāpadavaṇṇanā,pathamasanghadisesasikkhapadavannana,7,7,0,0,36
665109,pārājikānantarassa,parajikanantarassa,1,1,0,0,18
665110,saṅghādisesakaṇḍassa,sanghadisesakandassa,2,2,0,0,20
665111,anuttānatthavaṇṇanā,anuttanatthavannana,4,3,1,0,19
665112,apināyyāti,apinayyati,1,0,1,0,10
665113,accāvadathāti,accavadathati,2,0,2,0,13
665114,ussayavādikāti,ussayavadikati,4,0,4,0,14
665115,mānussayavasena,manussayavasena,8,6,2,0,15
665116,kodhussayavasena,kodhussayavasena,2,2,0,0,16
665117,aṭṭakārikā,attakarika,1,1,0,0,10
665118,aḍḍakārikā,addakarika,2,2,0,0,10
665119,aḍḍoti,addoti,4,1,3,0,6
665120,vohārikavinicchayo,voharikavinicchayo,4,4,0,0,18
665121,P4.0907,P4.0907,1,1,0,0,7
665122,upassayo,upassayo,9,7,2,0,8
665123,paṭhamārocane,pathamarocane,5,5,0,0,13
665124,dutiyārocane,dutiyarocane,6,6,0,0,12
665125,vohārikehi,voharikehi,6,6,0,0,10
665126,aḍḍapariyosānaṃ,addapariyosanam,2,2,0,0,15
665127,aḍḍapariyosāne,addapariyosane,6,6,0,0,14
665128,jayepi,jayepi,2,2,0,0,6
665129,parājayepi,parajayepi,3,3,0,0,10
665130,aḍḍakārakañca,addakarakanca,1,1,0,0,13
665131,kathanakiccaṃ,kathanakiccam,1,1,0,0,13
665132,aḍḍapariyosānepi,addapariyosanepi,3,3,0,0,16
665133,paṭhamāpattiko,pathamapattiko,3,2,1,0,14
665134,paṭhamāpattikaṃ,pathamapattikam,30,14,16,0,15
665135,vatthujjhācārā,vatthujjhacara,11,11,0,0,14
665136,P4.0908,P4.0908,1,1,0,0,7
665137,asamanubhāsanāyā,asamanubhasanaya,1,1,0,0,16
665138,vatthujjhācārena,vatthujjhacarena,2,2,0,0,16
665139,paṭhamāpattikoti,pathamapattikoti,1,1,0,0,16
665140,nissāretīti,nissaretiti,8,4,4,0,11
665141,nissāraṇīyo,nissaraniyo,5,4,1,0,11
665142,nissārīyatīti,nissariyatiti,2,2,0,0,13
665143,nissārīyati,nissariyati,13,13,0,0,11
665144,nissāraṇīyoti,nissaraniyoti,3,1,2,0,13
665145,aḍḍakārakamanussehi,addakarakamanussehi,2,2,0,0,19
665146,aḍḍakārako,addakarako,3,3,0,0,10
665147,yathāyācitā,yathayacita,1,1,0,0,11
665148,odissaācikkhanā,odissaacikkhana,7,7,0,0,15
665149,anodissaācikkhanā,anodissaacikkhana,2,2,0,0,17
665150,P4.0909,P4.0909,1,1,0,0,7
665151,adhippāyepi,adhippayepi,3,3,0,0,11
665152,pañcamāsakamatte,pancamasakamatte,3,3,0,0,16
665153,asukenāti,asukenati,3,3,0,0,9
665154,avahaṭabhaṇḍañca,avahatabhandanca,3,3,0,0,16
665155,vacanakaraṃ,vacanakaram,7,4,3,0,11
665156,dāsadāsīvāpiādīnaṃ,dasadasivapiadinam,2,1,1,0,18
665157,akappiyaaḍḍo,akappiyaaddo,6,4,2,0,12
665158,anācārādīsu,anacaradisu,3,3,0,0,11
665159,akaraṇatthāyā,akaranatthaya,4,4,0,0,13
665160,atiṭṭhamāne,atitthamane,3,3,0,0,11
665161,P4.0910,P4.0910,1,1,0,0,7
665162,lahuparivattañhi,lahuparivattanhi,3,3,0,0,16
665163,theyyacetanāya,theyyacetanaya,3,3,0,0,14
665164,mūlacchejjampi,mulacchejjampi,3,3,0,0,14
665165,sattarasake,sattarasake,2,2,0,0,11
665166,dutiyasaṅghādisesasikkhāpadavaṇṇanā,dutiyasanghadisesasikkhapadavannana,7,7,0,0,35
665167,mallagaṇabhaṭiputtagaṇādikaṃ,mallaganabhatiputtaganadikam,5,2,3,0,28
665168,pūgaṃ,pugam,7,4,3,0,5
665169,dhammagaṇaṃ,dhammaganam,2,2,0,0,11
665170,seṇiṃ,senim,5,2,3,0,5
665171,gandhikaseṇidussikaseṇiādikaṃ,gandhikasenidussikaseniadikam,2,2,0,0,29
665172,āpucchitabbova,apucchitabbova,1,1,0,0,14
665173,aññabhikkhunīsu,annabhikkhunisu,2,2,0,0,15
665174,pabbajitapubbaṃ,pabbajitapubbam,1,1,0,0,15
665175,kappagatikaṃ,kappagatikam,5,1,4,0,12
665176,corīvuṭṭhāpanasamuṭṭhānaṃ,corivutthapanasamutthanam,3,3,0,0,25
665177,pakkantāsu,pakkantasu,7,7,0,0,10
665178,khaṇḍasīmaṃ,khandasimam,64,56,8,0,11
665179,yathānisinnaṭṭhāneyeva,yathanisinnatthaneyeva,3,3,0,0,22
665180,nissitakaparisāya,nissitakaparisaya,3,3,0,0,17
665181,vuṭṭhāpanavasena,vutthapanavasena,3,3,0,0,16
665182,tatiyasaṅghādisesasikkhāpadavaṇṇanā,tatiyasanghadisesasikkhapadavannana,7,7,0,0,35
665183,P4.0911,P4.0911,1,1,0,0,7
665184,atikkāmentiyāti,atikkamentiyati,9,0,9,0,15
665185,atikkāmentiyā,atikkamentiya,51,49,2,0,13
665186,parikkhepārahaṭṭhānaṃ,parikkheparahatthanam,23,20,3,0,21
665187,sakagāmato,sakagamato,13,12,1,0,10
665188,nikkhamantiyā,nikkhamantiya,4,4,0,0,13
665189,gāmantarapaccayā,gamantarapaccaya,2,2,0,0,16
665190,parikkhepe,parikkhepe,25,23,2,0,10
665191,sakagāmaṃ,sakagamam,6,6,0,0,9
665192,pavisantiyāpi,pavisantiyapi,2,2,0,0,13
665193,khaṇḍapākārena,khandapakarena,4,4,0,0,14
665194,vatichiddena,vatichiddena,3,3,0,0,12
665195,bhikkhunivihārabhūmiyeva,bhikkhuniviharabhumiyeva,1,1,0,0,24
665196,pavisamānāya,pavisamanaya,2,2,0,0,12
665197,kappiyabhūmiṃ,kappiyabhumim,8,8,0,0,13
665198,hatthipiṭṭhiādīhi,hatthipitthiadihi,2,2,0,0,17
665199,bhikkhunivihārena,bhikkhuniviharena,1,1,0,0,17
665200,sambaddhavatikā,sambaddhavatika,2,1,1,0,15
665201,bhikkhunivihāro,bhikkhuniviharo,2,2,0,0,15
665202,bahigāmadvāre,bahigamadvare,1,1,0,0,13
665203,vatiparikkhepaṃ,vatiparikkhepam,1,1,0,0,15
665204,P4.0912,P4.0912,1,1,0,0,7
665205,catugāmasādhāraṇattā,catugamasadharanatta,3,2,1,0,20
665206,temiyatīti,temiyatiti,5,2,3,0,10
665207,timaṇḍalapaṭicchādanaṃ,timandalapaticchadanam,3,3,0,0,22
665208,nivatthāya,nivatthaya,3,3,0,0,10
665209,uttarantiyā,uttarantiya,24,21,3,0,11
665210,nadīlakkhaṇaṃ,nadilakkhanam,2,2,0,0,13
665211,nadīnimittakathāya,nadinimittakathaya,1,1,0,0,18
665212,ṭhapentiyā,thapentiya,5,5,0,0,10
665213,dutiyapāduddhāre,dutiyapaduddhare,12,11,1,0,16
665214,uttarantiyāpi,uttarantiyapi,1,1,0,0,13
665215,yānanāvāākāsagamanādīsupi,yananavaakasagamanadisupi,1,1,0,0,25
665216,akkamantiyā,akkamantiya,3,2,1,0,11
665217,rajanakammatthaṃ,rajanakammattham,1,1,0,0,16
665218,dārusaṅkaḍḍhanādikiccena,darusankaddhanadikiccena,1,1,0,0,24
665219,orimatīrameva,orimatirameva,7,3,4,0,13
665220,pakkantaṭṭhāne,pakkantatthane,7,7,0,0,14
665221,aruṇuggamanāti,arunuggamanati,3,2,1,0,14
665222,dutiyikāya,dutiyikaya,32,31,1,0,10
665223,anābhogena,anabhogena,2,2,0,0,10
665224,hatthapāsoyeva,hatthapasoyeva,2,2,0,0,14
665225,hatthapāsātikkame,hatthapasatikkame,6,6,0,0,17
665226,ekagabbhopi,ekagabbhopi,2,2,0,0,11
665227,gāmābhāvena,gamabhavena,3,3,0,0,11
665228,viñjhāṭavisadisatāya,vinjhatavisadisataya,2,2,0,0,20
665229,P4.0913,P4.0913,1,1,0,0,7
665230,vijahite,vijahite,18,18,0,0,8
665231,mahābodhiaṅgaṇaṃ,mahabodhianganam,1,1,0,0,16
665232,pavisantīsupi,pavisantisupi,2,2,0,0,13
665233,vandamānāsu,vandamanasu,1,1,0,0,11
665234,dassanūpacāro,dassanupacaro,7,4,3,0,13
665235,sāṇipākārantarikāpi,sanipakarantarikapi,1,1,0,0,19
665236,maggamūḷhasaddena,maggamulhasaddena,7,5,2,0,17
665237,dhammasavanārocanasaddena,dhammasavanarocanasaddena,1,1,0,0,25
665238,saddāyantiyā,saddayantiya,6,6,0,0,12
665239,vijahitamatteva,vijahitamatteva,1,1,0,0,15
665240,ohīyatu,ohiyatu,4,3,1,0,7
665241,tatiyasikkhāpadaṃ,tatiyasikkhapadam,46,46,0,0,17
665242,catutthasaṅghādisesasikkhāpadavaṇṇanā,catutthasanghadisesasikkhapadavannana,7,7,0,0,37
665243,para694-8,para694-8,1,1,0,0,9
665244,dhotapādaṭṭhapanakaṃ,dhotapadatthapanakam,3,3,0,0,20
665245,pādakaṭhalikā,padakathalika,1,0,1,0,13
665246,adhotapādaṭṭhapanakaṃ,adhotapadatthapanakam,5,3,2,0,21
665247,kārakagaṇassa,karakaganassa,2,2,0,0,13
665248,vattantiṃ,vattantim,8,5,3,0,9
665249,tecattālīsappabhede,tecattalisappabhede,3,3,0,0,19
665250,netthāravatte,nettharavatte,2,2,0,0,13
665251,P4.0914,P4.0914,1,1,0,0,7
665252,pañcamasaṅghādisesasikkhāpadavaṇṇanā,pancamasanghadisesasikkhapadavannana,7,7,0,0,36
665253,avassutabhāvo,avassutabhavo,12,12,0,0,13
665254,pañcamasikkhāpadaṃ,pancamasikkhapadam,49,49,0,0,18
665255,chaṭṭhasaṅghādisesasikkhāpadavaṇṇanā,chatthasanghadisesasikkhapadavannana,7,7,0,0,36
665256,para705-6,para705-6,3,3,0,0,9
665257,dukkaṭassātiādikā,dukkatassatiadika,1,0,1,0,17
665258,saṅghādisesapariyosānā,sanghadisesapariyosana,2,2,0,0,22
665259,uyyojikāya,uyyojikaya,17,17,0,0,10
665260,paribhogapaccayā,paribhogapaccaya,12,12,0,0,16
665261,uyyojikaṃ,uyyojikam,1,1,0,0,9
665262,chaṭṭhasikkhāpadaṃ,chatthasikkhapadam,46,46,0,0,18
665263,sattamasaṅghādisesasikkhāpadavaṇṇanā,sattamasanghadisesasikkhapadavannana,5,5,0,0,36
665264,yāvatatiyaka,yavatatiyaka,2,0,2,0,12
665265,sattamasikkhāpadaṃ,sattamasikkhapadam,43,43,0,0,18
665266,aṭṭhamasaṅghādisesasikkhāpadavaṇṇanā,atthamasanghadisesasikkhapadavannana,3,3,0,0,36
665267,adhikaraṇavibhāgaṃ,adhikaranavibhagam,1,1,0,0,18
665268,P4.0915,P4.0915,1,1,0,0,7
665269,adhikaraṇānī,adhikaranani,8,3,5,0,12
665270,aṭṭhamasikkhāpadaṃ,atthamasikkhapadam,39,38,1,0,18
665271,navamasaṅghādisesasikkhāpadavaṇṇanā,navamasanghadisesasikkhapadavannana,5,5,0,0,35
665272,ananulomena,ananulomena,2,2,0,0,11
665273,koṭṭanapacanagandhapisanamālāganthanādinā,kottanapacanagandhapisanamalaganthanadina,1,1,0,0,41
665274,sāsanapaṭisāsanāharaṇasañcarittādinā,sasanapatisasanaharanasancarittadina,1,1,0,0,36
665275,pāpasaddā,papasadda,23,19,4,0,9
665276,ājīvasaṅkhāto,ajivasankhato,2,2,0,0,13
665277,pāpasilokā,papasiloka,23,19,4,0,10
665278,navamasikkhāpadaṃ,navamasikkhapadam,39,39,0,0,17
665279,dasamasaṅghādisesasikkhāpadavaṇṇanā,dasamasanghadisesasikkhapadavannana,1,1,0,0,35
665280,evācārāti,evacarati,3,0,3,0,9
665281,evaṃācārā,evamacara,3,3,0,0,9
665282,ācārāti,acarati,1,1,0,0,7
665283,uññāyāti,unnayati,4,0,4,0,8
665284,jānanāya,jananaya,6,6,0,0,8
665285,paribhavenāti,paribhavenati,3,0,3,0,13
665286,asahanatāya,asahanataya,2,2,0,0,11
665287,kodhenāti,kodhenati,3,2,1,0,9
665288,vebhassiyāti,vebhassiyati,4,0,4,0,12
665289,balavabhassabhāvena,balavabhassabhavena,1,1,0,0,19
665290,balappakāsanena,balappakasanena,2,2,0,0,15
665291,samutrāsanenāti,samutrasanenati,2,2,0,0,15
665292,dubbalyāti,dubbalyati,3,0,3,0,10
665293,uññāya,unnaya,10,10,0,0,6
665294,viviccathāti,viviccathati,3,0,3,0,12
665295,dasamasikkhāpadaṃ,dasamasikkhapadam,45,45,0,0,17
665296,paṭhamāpattikānaṃ,pathamapattikanam,1,1,0,0,17
665297,duṭṭhadosāti,dutthadosati,1,1,0,0,12
665298,mahāvibhaṅgato,mahavibhangato,4,4,0,0,14
665299,yāvatatiyakānaṃ,yavatatiyakanam,1,1,0,0,15
665300,mahāvibhaṅgatopi,mahavibhangatopi,1,1,0,0,16
665301,yāvatatiyake,yavatatiyake,12,9,3,0,12
665302,yāvatatiyakā,yavatatiyaka,44,41,3,0,12
665303,P4.0916,P4.0916,1,1,0,0,7
665304,pakkhamānattā,pakkhamanatta,1,1,0,0,13
665305,sattarasakavaṇṇanā,sattarasakavannana,1,1,0,0,18
665306,paṭhamanissaggiyapācittiyasikkhāpadavaṇṇanā,pathamanissaggiyapacittiyasikkhapadavannana,2,2,0,0,43
665307,āmattikāpaṇo,amattikapano,1,0,1,0,12
665308,pasāressantīti,pasaressantiti,1,1,0,0,14
665309,pattasannicayaṃ,pattasannicayam,14,11,3,0,15
665310,pattasannidhiṃ,pattasannidhim,2,2,0,0,14
665311,dutiyanissaggiyapācittiyasikkhāpadavaṇṇanā,dutiyanissaggiyapacittiyasikkhapadavannana,3,3,0,0,42
665312,duccoḷāti,duccolati,1,0,1,0,9
665313,virūpacoḷā,virupacola,2,2,0,0,10
665314,jiṇṇacoḷāti,jinnacolati,1,1,0,0,11
665315,apayyāhīti,apayyahiti,1,0,1,0,10
665316,ayyāhi,ayyahi,1,1,0,0,6
665317,bhājentūti,bhajentuti,1,1,0,0,10
665318,yathādāneyeva,yathadaneyeva,7,4,3,0,13
665319,tatiyanissaggiyapācittiyasikkhāpadavaṇṇanā,tatiyanissaggiyapacittiyasikkhapadavannana,3,3,0,0,42
665320,para743-5,para743-5,2,2,0,0,9
665321,P4.0917,P4.0917,1,1,0,0,7
665322,acchindatīti,acchindatiti,2,1,1,0,12
665323,acchindantiyā,acchindantiya,3,3,0,0,13
665324,catutthanissaggiyapācittiyasikkhāpadavaṇṇanā,catutthanissaggiyapacittiyasikkhapadavannana,3,3,0,0,44
665325,kayenāti,kayenati,1,0,1,0,8
665326,āhaṭasappiṃ,ahatasappim,3,1,2,0,11
665327,viññāpetvāti,vinnapetvati,15,4,11,0,12
665328,viññattaṃ,vinnattam,24,23,1,0,9
665329,sappiviññattaṃ,sappivinnattam,1,1,0,0,14
665330,pacitabbanti,pacitabbanti,3,3,0,0,12
665331,telenāpi,telenapi,6,6,0,0,8
665332,pañcamanissaggiyapācittiyasikkhāpadavaṇṇanā,pancamanissaggiyapacittiyasikkhapadavannana,3,3,0,0,43
665333,sikkhamāneti,sikkhamaneti,1,0,1,0,12
665334,cetāpetvāti,cetapetvati,15,3,12,0,11
665335,catutthasadisamevāti,catutthasadisamevati,5,5,0,0,20
665336,chaṭṭhanissaggiyapācittiyasikkhāpadavaṇṇanā,chatthanissaggiyapacittiyasikkhapadavannana,3,3,0,0,43
665337,P4.0918,P4.0918,1,1,0,0,7
665338,gahitaparikkhārassetaṃ,gahitaparikkharassetam,1,1,0,0,22
665339,aññadatthikenāti,annadatthikenati,2,0,2,0,16
665340,aññuddisikenāti,annuddisikenati,9,0,9,0,15
665341,saṅghikenāti,sanghikenati,5,0,5,0,12
665342,yadatthāya,yadatthaya,10,10,0,0,10
665343,telādīhi,teladihi,3,3,0,0,8
665344,cetāpetuṃ,cetapetum,2,2,0,0,9
665345,sattamanissaggiyapācittiyasikkhāpadavaṇṇanā,sattamanissaggiyapacittiyasikkhapadavannana,3,3,0,0,43
665346,saññācikenāti,sannacikenati,14,2,12,0,13
665347,chaṭṭhasadisamevāti,chatthasadisamevati,3,3,0,0,19
665348,aṭṭhamanissaggiyapācittiyasikkhāpadavaṇṇanā,atthamanissaggiyapacittiyasikkhapadavannana,3,3,0,0,43
665349,mahājanikenāti,mahajanikenati,6,0,6,0,14
665350,navamanissaggiyapācittiyasikkhāpadavaṇṇanā,navamanissaggiyapacittiyasikkhapadavannana,3,3,0,0,42
665351,dasamanissaggiyapācittiyasikkhāpadavaṇṇanā,dasamanissaggiyapacittiyasikkhapadavannana,3,3,0,0,42
665352,undriyatīti,undriyatiti,2,0,2,0,11
665353,puggalikena,puggalikena,14,12,2,0,11
665354,ekādasamanissaggiyapācittiyasikkhāpadavaṇṇanā,ekadasamanissaggiyapacittiyasikkhapadavannana,3,3,0,0,45
665355,P4.0919,P4.0919,1,1,0,0,7
665356,garupāvuraṇaṃ,garupavuranam,14,7,7,0,13
665357,catukkaṃsaparamaṃ,catukkamsaparamam,16,12,4,0,17
665358,catukkahāpaṇiko,catukkahapaniko,3,3,0,0,15
665359,soḷasakahāpaṇagghanakaṃ,solasakahapanagghanakam,4,4,0,0,23
665360,ekādasamasikkhāpadaṃ,ekadasamasikkhapadam,12,12,0,0,20
665361,dvādasamanissaggiyapācittiyasikkhāpadavaṇṇanā,dvadasamanissaggiyapacittiyasikkhapadavannana,1,1,0,0,45
665362,sikkhāpadadvayepi,sikkhapadadvayepi,1,1,0,0,17
665363,dvādasamasikkhāpadaṃ,dvadasamasikkhapadam,12,12,0,0,20
665364,cīvaravaggato,civaravaggato,2,2,0,0,13
665365,dhovanañca,dhovananca,15,11,4,0,10
665366,paṭiggahaṇañcāti,patiggahanancati,1,1,0,0,16
665367,kālacīvaranti,kalacivaranti,4,4,0,0,13
665368,bhājitasikkhāpadena,bhajitasikkhapadena,1,1,0,0,19
665369,acchinnacīvarena,acchinnacivarena,4,4,0,0,16
665370,eḷakalomavaggassa,elakalomavaggassa,2,2,0,0,17
665371,aññadatthikāni,annadatthikani,1,1,0,0,14
665372,tatiyavaggato,tatiyavaggato,1,1,0,0,13
665373,paṭhamapattaṃ,pathamapattam,1,1,0,0,13
665374,āraññakasikkhāpadanti,arannakasikkhapadanti,1,1,0,0,21
665375,pattasannicayagarupāvuraṇalahupāvuraṇasikkhāpadehi,pattasannicayagarupavuranalahupavuranasikkhapadehi,1,1,0,0,50
665376,ekatopaññattāni,ekatopannattani,1,1,0,0,15
665377,ubhatopaññattānīti,ubhatopannattaniti,2,1,1,0,18
665378,tiṃsakavaṇṇanā,timsakavannana,2,2,0,0,14
665379,lasuṇavaggo,lasunavaggo,21,21,0,0,11
665380,paṭhamalasuṇasikkhāpadavaṇṇanā,pathamalasunasikkhapadavannana,3,3,0,0,30
665381,tiṃsakānantaraṃ,timsakanantaram,2,1,1,0,15
665382,chasaṭṭhisatasaṅgahā,chasatthisatasangaha,2,1,1,0,20
665383,lasuṇavaggassa,lasunavaggassa,6,6,0,0,14
665384,bhaṇḍiketi,bhandiketi,1,0,1,0,10
665385,poṭṭalike,pottalike,1,1,0,0,9
665386,sampuṇṇamiñjānametaṃ,sampunnaminjanametam,2,2,0,0,20
665387,P4.0920,P4.0920,1,1,0,0,7
665388,vārentassa,varentassa,5,5,0,0,10
665389,haṃsayoniṃ,hamsayonim,3,2,1,0,10
665390,suvaṇṇahaṃsayoniṃ,suvannahamsayonim,2,1,1,0,17
665391,pubbasinehena,pubbasinehena,1,1,0,0,13
665392,tāpanatālanacchedanakkhamaṃ,tapanatalanacchedanakkhamam,1,1,0,0,27
665393,māgadhakaṃ,magadhakam,8,5,3,0,10
665394,jātalasuṇameva,jatalasunameva,3,3,0,0,14
665395,lasuṇanti,lasunanti,3,3,0,0,9
665396,bhaṇḍikalasuṇameva,bhandikalasunameva,3,3,0,0,18
665397,ekadvitimiñjakaṃ,ekadvitiminjakam,7,4,3,0,16
665398,jātadesaṃ,jatadesam,1,1,0,0,9
665399,bhaṇḍikalasuṇaṃ,bhandikalasunam,5,3,2,0,15
665400,palaṇḍukā,palanduka,3,0,3,0,9
665401,miñjāya,minjaya,8,8,0,0,7
665402,palaṇḍuko,palanduko,7,4,3,0,9
665403,haritako,haritako,6,4,2,0,8
665404,haritapaṇṇavaṇṇo,haritapannavanno,3,3,0,0,16
665405,palaṇḍukassa,palandukassa,6,6,0,0,12
665406,bhañjanakassa,bhanjanakassa,6,6,0,0,13
665407,haritakassa,haritakassa,6,6,0,0,11
665408,cāpalasuṇo,capalasuno,3,2,1,0,10
665409,amiñjako,aminjako,4,4,0,0,8
665410,aṅkuramattameva,ankuramattameva,4,4,0,0,15
665411,palaṇḍukādayo,palandukadayo,3,3,0,0,13
665412,sūpasampākādīsu,supasampakadisu,5,5,0,0,15
665413,māgadhakampi,magadhakampi,4,4,0,0,12
665414,muggasūpādīsu,muggasupadisu,4,4,0,0,13
665415,macchamaṃsavikatiyā,macchamamsavikatiya,4,4,0,0,19
665416,telādīsu,teladisu,5,5,0,0,8
665417,badarasāḷavādīsu,badarasalavadisu,4,4,0,0,16
665418,ambilasākādīsu,ambilasakadisu,3,3,0,0,14
665419,uttaribhaṅgesu,uttaribhangesu,3,3,0,0,14
665420,yāgubhattepi,yagubhattepi,4,4,0,0,12
665421,lasuṇasikkhāpadaṃ,lasunasikkhapadam,3,3,0,0,17
665422,dutiyasikkhāpadavaṇṇanā,dutiyasikkhapadavannana,16,16,0,0,23
665423,upakacchakā,upakacchaka,4,4,0,0,11
665424,P4.0921,P4.0921,1,1,0,0,7
665425,saṇḍāsakena,sandasakena,1,1,0,0,11
665426,saṃharāpentiyā,samharapentiya,8,8,0,0,14
665427,ābādhapaccayāti,abadhapaccayati,11,2,9,0,15
665428,kaṇḍukacchuādiābādhapaccayā,kandukacchuadiabadhapaccaya,3,3,0,0,27
665429,tatiyasikkhāpadavaṇṇanā,tatiyasikkhapadavannana,14,14,0,0,23
665430,para803-4,para803-4,1,1,0,0,9
665431,talaghātaketi,talaghataketi,3,0,3,0,13
665432,muttakaraṇatalaghātane,muttakaranatalaghatane,2,2,0,0,22
665433,uppalapattenāpīti,uppalapattenapiti,2,1,1,0,17
665434,kesarenāpi,kesarenapi,4,4,0,0,10
665435,catutthasikkhāpadavaṇṇanā,catutthasikkhapadavannana,14,14,0,0,25
665436,purāṇarājorodhāti,puranarajorodhati,2,0,2,0,17
665437,anārocitepi,anarocitepi,2,2,0,0,11
665438,mayhidaṃ,mayhidam,3,3,0,0,8
665439,jatumaṭṭhaketi,jatumatthaketi,3,0,3,0,14
665440,maṭṭhadaṇḍake,matthadandake,2,2,0,0,13
665441,pavesentiyā,pavesentiya,8,8,0,0,11
665442,kesaramattampi,kesaramattampi,3,3,0,0,14
665443,talaghātake,talaghatake,5,4,1,0,11
665444,vuttasadisānevāti,vuttasadisanevati,7,7,0,0,17
665445,pañcamasikkhāpadavaṇṇanā,pancamasikkhapadavannana,14,14,0,0,24
665446,P4.0922,P4.0922,1,1,0,0,7
665447,atianto,atianto,3,3,0,0,7
665448,chaṭṭhasikkhāpadavaṇṇanā,chatthasikkhapadavannana,14,14,0,0,24
665449,upatiṭṭhitvāti,upatitthitvati,1,0,1,0,14
665450,accāvadatīti,accavadatiti,1,0,1,0,12
665451,pabbajitacārittaṃ,pabbajitacarittam,1,1,0,0,17
665452,gehassitakathaṃ,gehassitakatham,3,3,0,0,15
665453,suddhaudakaṃ,suddhaudakam,2,2,0,0,12
665454,takkadadhimatthurasakhīrādīnaṃ,takkadadhimatthurasakhiradinam,1,1,0,0,30
665455,bījanīti,bijaniti,3,0,3,0,8
665456,cīvarakaṇṇopi,civarakannopi,1,1,0,0,13
665457,ṭhānapaccayāva,thanapaccayava,1,1,0,0,14
665458,sūpādiṃ,supadim,3,3,0,0,7
665459,upatiṭṭhanatthaṃ,upatitthanattham,1,1,0,0,16
665460,sattamasikkhāpadavaṇṇanā,sattamasikkhapadavannana,12,12,0,0,24
665461,P4.0923,P4.0923,1,1,0,0,7
665462,payogadukkaṭaṃ,payogadukkatam,4,4,0,0,14
665463,āharaṇepi,aharanepi,2,2,0,0,9
665464,sukkhāpanepi,sukkhapanepi,2,2,0,0,12
665465,vaddalidivase,vaddalidivase,3,3,0,0,13
665466,bhajjanatthāya,bhajjanatthaya,3,3,0,0,14
665467,uddhanasajjanepi,uddhanasajjanepi,2,2,0,0,16
665468,kapallasajjanepi,kapallasajjanepi,2,2,0,0,16
665469,dabbisajjanepi,dabbisajjanepi,2,2,0,0,14
665470,aggikaraṇepi,aggikaranepi,2,2,0,0,12
665471,kapallamhi,kapallamhi,2,2,0,0,10
665472,dhaññapakkhipanepi,dhannapakkhipanepi,2,2,0,0,18
665473,saṅghaṭṭanesupi,sanghattanesupi,2,2,0,0,15
665474,koṭṭanatthaṃ,kottanattham,2,2,0,0,12
665475,udukkhalamusalādisajjanesupi,udukkhalamusaladisajjanesupi,2,2,0,0,28
665476,koṭṭanapapphoṭanadhovanādīsupi,kottanapapphotanadhovanadisupi,2,2,0,0,30
665477,ajjhoharaṇatthaṃ,ajjhoharanattham,5,5,0,0,16
665478,ajjhoharaṇagaṇanāya,ajjhoharanagananaya,2,2,0,0,19
665479,bhajjanakoṭṭanapacanāni,bhajjanakottanapacanani,1,1,0,0,23
665480,bhuñjantiyāpi,bhunjantiyapi,4,4,0,0,13
665481,bhajjanādīni,bhajjanadini,20,20,0,0,12
665482,āmakadhaññaṃ,amakadhannam,23,18,5,0,12
665483,bhajjanādīnaṃ,bhajjanadinam,1,1,0,0,13
665484,sedakammādīnaṃ,sedakammadinam,2,2,0,0,14
665485,dhaññaviññattiyā,dhannavinnattiya,2,2,0,0,16
665486,muggamāsādiṃ,muggamasadim,1,1,0,0,12
665487,lābukumbhaṇḍādiṃ,labukumbhandadim,1,1,0,0,16
665488,P4.0924,P4.0924,1,1,0,0,7
665489,viññāpentiyā,vinnapentiya,13,13,0,0,12
665490,aṭṭhamasikkhāpadavaṇṇanā,atthamasikkhapadavannana,13,13,0,0,24
665491,nibbiṭṭharājabhaṭo,nibbittharajabhato,3,1,2,0,18
665492,laddhaudayoti,laddhaudayoti,1,1,0,0,13
665493,bhaṭapathaṃ,bhatapatham,6,3,3,0,11
665494,keṇiṃ,kenim,2,2,0,0,5
665495,āṇattiyampi,anattiyampi,9,9,0,0,11
665496,dantakaṭṭhachaḍḍanepi,dantakatthachaddanepi,2,2,0,0,21
665497,navamasikkhāpadavaṇṇanā,navamasikkhapadavannana,17,17,0,0,23
665498,para830-2,para830-2,1,1,0,0,9
665499,nāḷikerādiārāmo,nalikeradiaramo,2,2,0,0,15
665500,ropimaharitaṭṭhāne,ropimaharitatthane,3,3,0,0,18
665501,ucchiṭṭhodakacalakādīni,ucchitthodakacalakadini,2,2,0,0,23
665502,haritaṭṭhāne,haritatthane,6,6,0,0,12
665503,matthakacchinnanāḷikerampi,matthakacchinnanalikerampi,2,2,0,0,26
665504,nikkhittabīje,nikkhittabije,3,3,0,0,13
665505,P4.0925,P4.0925,1,1,0,0,7
665506,anikkhittabījesu,anikkhittabijesu,3,3,0,0,16
665507,khettakoṇādīsu,khettakonadisu,2,2,0,0,14
665508,asañjātaropimesu,asanjataropimesu,3,3,0,0,16
665509,khettamariyādādīsu,khettamariyadadisu,3,3,0,0,18
665510,kacavarachaḍḍanaṭṭhānepi,kacavarachaddanatthanepi,3,3,0,0,24
665511,chaḍḍitakhetteti,chadditakhetteti,3,0,3,0,16
665512,chaḍḍitakhettaṃ,chadditakhettam,4,4,0,0,15
665513,lāyitampi,layitampi,5,5,0,0,9
665514,pubbaṇṇādi,pubbannadi,4,4,0,0,10
665515,dasamasikkhāpadavaṇṇanā,dasamasikkhapadavannana,17,17,0,0,23
665516,naṭādayo,natadayo,4,4,0,0,8
665517,morasuvamakkaṭādayopi,morasuvamakkatadayopi,2,2,0,0,21
665518,naccameva,naccameva,4,4,0,0,9
665519,ratanattayaguṇūpasaṃhitaṃ,ratanattayagunupasamhitam,4,4,0,0,25
665520,sādhukīḷitagītaṃ,sadhukilitagitam,5,4,1,0,16
665521,asaṃyatabhikkhūnaṃ,asamyatabhikkhunam,3,2,1,0,18
665522,dhammabhāṇakagītaṃ,dhammabhanakagitam,6,5,1,0,18
665523,tantibaddhādivādanīyabhaṇḍavāditaṃ,tantibaddhadivadaniyabhandavaditam,2,2,0,0,34
665524,kuṭabherivāditaṃ,kutabherivaditam,5,4,1,0,16
665525,udakabherivāditampi,udakabherivaditampi,5,5,0,0,19
665526,vāditameva,vaditameva,3,3,0,0,10
665527,padavāragaṇanāya,padavaragananaya,5,5,0,0,16
665528,pāṭekkā,patekka,6,4,2,0,7
665529,gāya,gaya,2,2,0,0,4
665530,P4.0926,P4.0926,1,1,0,0,7
665531,upaṭṭhānakaraṇaṃ,upatthanakaranam,4,4,0,0,16
665532,karaṇīyeti,karaniyeti,7,1,6,0,10
665533,andhakāravaggo,andhakaravaggo,10,10,0,0,14
665534,paṭhamasikkhāpadavaṇṇanā,pathamasikkhapadavannana,13,13,0,0,24
665535,andhakāravaggassa,andhakaravaggassa,4,4,0,0,17
665536,appadīpeti,appadipeti,5,1,4,0,10
665537,padīpacandasūriyaaggīsu,padipacandasuriyaaggisu,1,1,0,0,23
665538,anobhāsite,anobhasite,3,3,0,0,10
665539,anāloke,analoke,3,3,0,0,7
665540,arahopekkhā,arahopekkha,5,4,1,0,11
665541,aññavihitāti,annavihitati,1,0,1,0,12
665542,rahoassādāpekkhā,rahoassadapekkha,1,1,0,0,16
665543,rahoassādato,rahoassadato,4,4,0,0,12
665544,aññavihitāva,annavihitava,4,4,0,0,12
665545,P4.0927,P4.0927,1,1,0,0,7
665546,ajjhokāseti,ajjhokaseti,4,0,4,0,11
665547,para850-3,para850-3,1,1,0,0,9
665548,nikaṇṇikaṃ,nikannikam,11,5,6,0,10
665549,jappeyyāti,jappeyyati,4,1,3,0,10
665550,paṭisāmanatthāya,patisamanatthaya,2,2,0,0,16
665551,purimasadisānevāti,purimasadisanevati,1,1,0,0,18
665552,sodhentāti,sodhentati,1,0,1,0,10
665553,gilānāyāti,gilanayati,14,0,14,0,10
665554,abhinisīdeyyāti,abhinisideyyati,6,0,6,0,15
665555,dhuvapaññatteti,dhuvapannatteti,3,0,3,0,15
665556,niccapaññatte,niccapannatte,2,2,0,0,13
665557,P4.0928,P4.0928,1,1,0,0,7
665558,abhisapeyyāti,abhisapeyyati,5,1,4,0,13
665559,abhisapati,abhisapati,10,7,3,0,10
665560,atthapurekkhārāyāti,atthapurekkharayati,3,1,2,0,19
665561,dhammapurekkhārāyāti,dhammapurekkharayati,3,1,2,0,20
665562,anusāsanipurekkhārāyāti,anusasanipurekkharayati,5,1,4,0,23
665563,uppajjissasī,uppajjissasi,3,3,0,0,12
665564,naggavaggo,naggavaggo,15,15,0,0,10
665565,para883-6,para883-6,1,1,0,0,9
665566,naggavaggassa,naggavaggassa,5,5,0,0,13
665567,P4.0929,P4.0929,1,1,0,0,7
665568,ciṇṇenāti,cinnenati,2,0,2,0,9
665569,acchinnacīvarikāyāti,acchinnacivarikayati,1,0,1,0,20
665570,acchinnāya,acchinnaya,2,2,0,0,10
665571,naṭṭhāya,natthaya,2,2,0,0,8
665572,udakasāṭikacīvaraṃ,udakasatikacivaram,2,2,0,0,18
665573,para893-4,para893-4,1,1,0,0,9
665574,anantarāyikinīti,anantarayikiniti,9,1,8,0,16
665575,antarāyesu,antarayesu,17,17,0,0,10
665576,para898-9,para898-9,1,1,0,0,9
665577,pañcāhameva,pancahameva,4,4,0,0,11
665578,saṅghāṭīnaṃ,sanghatinam,4,4,0,0,11
665579,saṅghāṭicāro,sanghaticaro,5,0,5,0,12
665580,otāpanavasena,otapanavasena,4,4,0,0,13
665581,corabhayādīsu,corabhayadisu,2,2,0,0,13
665582,P4.0930,P4.0930,1,1,0,0,7
665583,cīvarasaṅkamanīyaṃ,civarasankamaniyam,16,11,5,0,18
665584,saṅkametabbaṃ,sankametabbam,6,6,0,0,13
665585,paṭidātabbacīvaranti,patidatabbacivaranti,2,2,0,0,20
665586,anivatthaṃ,anivattham,10,9,1,0,10
665587,para909-10,para909-10,2,2,0,0,10
665588,thālakādīnaṃ,thalakadinam,4,4,0,0,12
665589,dātukāmatthā,datukamattha,2,2,0,0,12
665590,nivārentiyā,nivarentiya,7,7,0,0,11
665591,aññāsampi,annasampi,4,4,0,0,9
665592,āgamentī,agamenti,1,1,0,0,8
665593,āgamessatī,agamessati,5,5,0,0,10
665594,paṭibāheyyāti,patibaheyyati,7,1,6,0,13
665595,paṭibāhantiyā,patibahantiya,9,9,0,0,13
665596,para916-8,para916-8,1,1,0,0,9
665597,P4.0931,P4.0931,1,1,0,0,7
665598,laṅghakā,langhaka,4,2,2,0,8
665599,vaṃsavarattādīsu,vamsavarattadisu,1,1,0,0,16
665600,laṅghanakammaṃ,langhanakammam,2,2,0,0,14
665601,kumbhathūṇikā,kumbhathunika,5,1,4,0,13
665602,ghaṭakena,ghatakena,6,4,2,0,9
665603,kīḷanakā,kilanaka,4,2,2,0,8
665604,bimbisakavādakātipi,bimbisakavadakatipi,2,1,1,0,19
665605,cīvaragaṇanāya,civaragananaya,3,3,0,0,14
665606,para921-4,para921-4,1,1,0,0,9
665607,dubbalacīvarapaccāsāyāti,dubbalacivarapaccasayati,2,0,2,0,24
665608,cīvarapaccāsāya,civarapaccasaya,5,5,0,0,15
665609,atthāramūlako,attharamulako,8,7,1,0,13
665610,ubbhāramūlako,ubbharamulako,5,5,0,0,13
665611,samānisaṃsopi,samanisamsopi,4,4,0,0,13
665612,saddhāparipālanatthaṃ,saddhaparipalanattham,3,2,1,0,21
665613,dātabbova,databbova,9,9,0,0,9
665614,kathinānisaṃsamūlako,kathinanisamsamulako,3,3,0,0,20
665615,mahālābhoti,mahalabhoti,1,1,0,0,11
665616,P4.0932,P4.0932,1,1,0,0,7
665617,tuvaṭṭavaggo,tuvattavaggo,20,20,0,0,12
665618,tuvaṭṭavaggassa,tuvattavaggassa,4,4,0,0,15
665619,tuvaṭṭeyyuṃ,tuvatteyyum,18,11,7,0,11
665620,nipajjeyyuṃ,nipajjeyyum,8,7,1,0,11
665621,attharaṇañceva,attharananceva,4,3,1,0,14
665622,pāvuraṇañca,pavurananca,4,3,1,0,11
665623,ekattharaṇapāvuraṇā,ekattharanapavurana,20,15,5,0,19
665624,saṃhārimānaṃ,samharimanam,5,4,1,0,12
665625,pāvārattharaṇakaṭasārakādīnaṃ,pavarattharanakatasarakadinam,4,4,0,0,29
665626,tuvaṭṭentīnametaṃ,tuvattentinametam,3,3,0,0,17
665627,nipajjantīnaṃ,nipajjantinam,3,3,0,0,13
665628,uḷārasambhāvitāti,ularasambhavitati,1,0,1,0,17
665629,uḷārakulā,ularakula,1,1,0,0,9
665630,issāpakatāti,issapakatati,2,0,2,0,12
665631,apakatā,apakata,2,1,1,0,7
665632,saññattibahulā,sannattibahula,3,2,1,0,14
665633,saññāpayamānāti,sannapayamanati,1,1,0,0,15
665634,hetūdāharaṇādīhi,hetudaharanadihi,1,1,0,0,16
665635,nivattanagaṇanāya,nivattanagananaya,3,3,0,0,17
665636,padādigaṇanāya,padadigananaya,5,5,0,0,14
665637,P4.0933,P4.0933,1,1,0,0,7
665638,antarāyeti,antarayeti,6,1,5,0,10
665639,nikkaḍḍhāti,nikkaddhati,1,1,0,0,11
665640,atikkāmehīti,atikkamehiti,1,1,0,0,12
665641,sattamaaṭṭhamanavamasikkhāpadavaṇṇanā,sattamaatthamanavamasikkhapadavannana,1,1,0,0,37
665642,sattamaaṭṭhamanavamesu,sattamaatthamanavamesu,1,1,0,0,22
665643,eḷakalomasamuṭṭhānāni,elakalomasamutthanani,1,1,0,0,21
665644,nosaññāvimokkhāni,nosannavimokkhani,1,1,0,0,17
665645,paṇṇattivajjāni,pannattivajjani,9,5,4,0,15
665646,ticittāni,ticittani,3,3,0,0,9
665647,tivedanānīti,tivedananiti,1,1,0,0,12
665648,sattamaaṭṭhamanavamasikkhāpadāni,sattamaatthamanavamasikkhapadani,1,1,0,0,32
665649,āhundarikāti,ahundarikati,1,0,1,0,12
665650,P4.0934,P4.0934,1,1,0,0,7
665651,cittāgāravaggo,cittagaravaggo,20,20,0,0,14
665652,cittāgāravaggassa,cittagaravaggassa,5,5,0,0,17
665653,kīḷanagharaṃ,kilanagharam,4,4,0,0,12
665654,kīḷanacittasālaṃ,kilanacittasalam,5,4,1,0,16
665655,kīḷanaupavanaṃ,kilanaupavanam,7,3,4,0,14
665656,kīḷanuyyānaṃ,kilanuyyanam,4,2,2,0,12
665657,pokkharaṇīṃ,pokkharanim,1,0,1,0,11
665658,kīḷanapokkharaṇiṃ,kilanapokkharanim,2,2,0,0,17
665659,anuddharamānā,anuddharamana,2,2,0,0,13
665660,rājāgārādīni,rajagaradini,5,4,1,0,12
665661,P4.0935,P4.0935,1,1,0,0,7
665662,abhinisīdanābhinipajjanesu,abhinisidanabhinipajjanesu,1,1,0,0,26
665663,ujjavujjaveti,ujjavujjaveti,3,0,3,0,13
665664,kappāsavicinanaṃ,kappasavicinanam,3,3,0,0,16
665665,hatthavāragaṇanāya,hatthavaragananaya,5,5,0,0,18
665666,kantitasuttaṃ,kantitasuttam,4,2,2,0,13
665667,dasikasuttādiṃ,dasikasuttadim,4,3,1,0,14
665668,dukkantitaṃ,dukkantitam,2,2,0,0,11
665669,paṭikantati,patikantati,1,1,0,0,11
665670,taṇḍulakoṭṭanaṃ,tandulakottanam,1,1,0,0,15
665671,pubbapayogesu,pubbapayogesu,8,8,0,0,13
665672,yāgubhattesu,yagubhattesu,1,1,0,0,12
665673,khādanīyādīsu,khadaniyadisu,2,2,0,0,13
665674,yāgupāneti,yagupaneti,4,1,3,0,10
665675,yāgupāne,yagupane,15,14,1,0,8
665676,saṅghabhatte,sanghabhatte,7,6,1,0,12
665677,sahāyikabhāvena,sahayikabhavena,2,2,0,0,15
665678,pacantiyā,pacantiya,2,2,0,0,9
665679,cetiyapūjāya,cetiyapujaya,4,4,0,0,12
665680,veyyāvaccakarassāti,veyyavaccakarassati,2,0,2,0,19
665681,sammuñjanidaṇḍakaṃ,sammunjanidandakam,2,2,0,0,18
665682,veyyāvaccakaraṭṭhāne,veyyavaccakaratthane,5,4,1,0,20
665683,tatiyasadisānevāti,tatiyasadisanevati,3,3,0,0,18
665684,vinicchinantī,vinicchinanti,4,4,0,0,13
665685,āpajjitvāva,apajjitvava,6,6,0,0,11
665686,P4.0936,P4.0936,1,1,0,0,7
665687,naggavagge,naggavagge,1,1,0,0,10
665688,āgārikasikkhāpade,agarikasikkhapade,1,1,0,0,17
665689,supaṭisāmitampi,supatisamitampi,1,1,0,0,15
665690,nivāsentiyā,nivasentiya,3,3,0,0,11
665691,anissajjitvāti,anissajjitvati,4,0,4,0,14
665692,jaggeyyāsī,jaggeyyasi,3,3,0,0,10
665693,anāpucchitvāti,anapucchitvati,4,3,1,0,14
665694,paṭijaggikaṃ,patijaggikam,3,2,1,0,12
665695,anantarasikkhāpadasadisānevāti,anantarasikkhapadasadisanevati,3,3,0,0,30
665696,para1015-6,para1015-6,2,2,0,0,10
665697,hatthiassarathadhanutharusippaāthabbaṇakhīlanavasīkaraṇasosāpanamantāgadappayogādibhedaṃ,hatthiassarathadhanutharusippaathabbanakhilanavasikaranasosapanamantagadappayogadibhedam,1,1,0,0,88
665698,P4.0937,P4.0937,1,1,0,0,7
665699,parūpaghātakaraṃ,parupaghatakaram,3,3,0,0,16
665700,yakkhaparittanāgamaṇḍalādibhedaṃ,yakkhaparittanagamandaladibhedam,1,1,0,0,32
665701,ārāmavaggo,aramavaggo,18,18,0,0,10
665702,ārāmavaggassa,aramavaggassa,5,5,0,0,13
665703,okkamantiyāti,okkamantiyati,2,1,1,0,13
665704,sīsānulokikāti,sisanulokikati,1,0,1,0,14
665705,pavisantīnaṃ,pavisantinam,2,2,0,0,12
665706,anulokentī,anulokenti,1,1,0,0,10
665707,sajjhāyacetiyavandanādīni,sajjhayacetiyavandanadini,1,1,0,0,25
665708,kappitakoti,kappitakoti,1,0,1,0,11
665709,saṃharīti,samhariti,2,0,2,0,9
665710,saṃhaṭoti,samhatoti,1,0,1,0,9
665711,kāsāvaṭoti,kasavatoti,1,0,1,0,10
665712,P4.0938,P4.0938,1,1,0,0,7
665713,abyattātiādinā,abyattatiadina,1,1,0,0,14
665714,anusāsanipakkhe,anusasanipakkhe,2,2,0,0,15
665715,nimantitāya,nimantitaya,4,4,0,0,11
665716,āpattisambhavato,apattisambhavato,30,30,0,0,16
665717,akāretvāpi,akaretvapi,3,3,0,0,10
665718,kulamaccharo,kulamaccharo,4,4,0,0,12
665719,appasannanti,appasannanti,2,2,0,0,12
665720,ovādāyāti,ovadayati,3,0,3,0,9
665721,garudhammatthāya,garudhammatthaya,1,1,0,0,16
665722,saṃvāsāyāti,samvasayati,3,0,3,0,11
665723,uposathapavāraṇāpucchanatthāya,uposathapavaranapucchanatthaya,1,1,0,0,30
665724,bhikkhunovādakasikkhāpadavaṇṇanāyaṃ,bhikkhunovadakasikkhapadavannanayam,1,1,0,0,35
665725,P4.0939,P4.0939,1,1,0,0,7
665726,bhikkhunovādake,bhikkhunovadake,4,4,0,0,15
665727,uposathapavāraṇāyeva,uposathapavaranayeva,1,1,0,0,20
665728,pasākheti,pasakheti,3,0,3,0,9
665729,adhokāye,adhokaye,2,2,0,0,8
665730,adhokāyo,adhokayo,1,1,0,0,8
665731,pasākhoti,pasakhoti,2,2,0,0,9
665732,bhindātiādīsu,bhindatiadisu,1,0,1,0,13
665733,āṇattidukkaṭāni,anattidukkatani,1,1,0,0,15
665734,bhedanādīni,bhedanadini,5,5,0,0,11
665735,bhedanādīsupi,bhedanadisupi,1,1,0,0,13
665736,P4.0940,P4.0940,1,1,0,0,7
665737,gabbhinivaggo,gabbhinivaggo,9,9,0,0,13
665738,gabbhinivaggassa,gabbhinivaggassa,3,3,0,0,16
665739,āpannasattāti,apannasattati,1,0,1,0,13
665740,kucchipaviṭṭhasattā,kucchipavitthasatta,2,1,1,0,19
665741,para1073-4,para1073-4,1,1,0,0,10
665742,sikkhāsammutiṃ,sikkhasammutim,30,29,1,0,14
665743,avītikkamitabbasamādānaṃ,avitikkamitabbasamadanam,1,1,0,0,24
665744,saṭṭhivassāyapi,satthivassayapi,3,3,0,0,15
665745,dātabbāyeva,databbayeva,3,3,0,0,11
665746,upasampādetabbā,upasampadetabba,31,31,0,0,15
665747,vuṭṭhānasammuti,vutthanasammuti,11,11,0,0,15
665748,upasampadamāḷakepi,upasampadamalakepi,3,3,0,0,18
665749,mahāsikkhamānā,mahasikkhamana,11,10,1,0,14
665750,P4.0941,P4.0941,1,1,0,0,7
665751,ūnadvādasavassaṃ,unadvadasavassam,14,13,1,0,16
665752,paripuṇṇasaññāya,paripunnasannaya,2,2,0,0,16
665753,dasavassāya,dasavassaya,10,10,0,0,11
665754,gihigatāya,gihigataya,23,23,0,0,10
665755,paripuṇṇadvādasavassaṃ,paripunnadvadasavassam,27,25,2,0,22
665756,anuggaṇhāpeyyāti,anugganhapeyyati,4,0,4,0,16
665757,anuggaṇhāpeyya,anugganhapeyya,6,5,1,0,14
665758,pariyesitvāti,pariyesitvati,5,0,5,0,13
665759,upaṭṭhaheyyāti,upatthaheyyati,4,1,3,0,14
665760,mukhodakenāti,mukhodakenati,3,3,0,0,13
665761,vūpakāseyyāti,vupakaseyyati,4,0,4,0,13
665762,vūpakāsāpeyyāti,vupakasapeyyati,3,0,3,0,15
665763,kumāribhūtavaggo,kumaribhutavaggo,12,12,0,0,16
665764,paṭhamadutiyatatiyasikkhāpadavaṇṇanā,pathamadutiyatatiyasikkhapadavannana,1,1,0,0,36
665765,kumāribhūtavaggassa,kumaribhutavaggassa,5,5,0,0,19
665766,P4.0942,P4.0942,1,1,0,0,7
665767,paṭhamadutiyatatiyasikkhāpadāni,pathamadutiyatatiyasikkhapadani,1,1,0,0,31
665768,gihigatasikkhāpadehi,gihigatasikkhapadehi,2,2,0,0,20
665769,atikkantavīsativassāti,atikkantavisativassati,2,2,0,0,22
665770,gihigatā,gihigata,36,30,6,0,8
665771,agihigatā,agihigata,2,2,0,0,9
665772,gihigatāti,gihigatati,4,3,1,0,10
665773,kumāribhūtāti,kumaribhutati,4,3,1,0,13
665774,dvādasavassakāle,dvadasavassakale,4,4,0,0,16
665775,ekādasavassakāle,ekadasavassakale,4,4,0,0,16
665776,terasavassakāle,terasavassakale,4,4,0,0,15
665777,dvādasaterasacuddasapannarasasoḷasasattarasaaṭṭhārasavassakāle,dvadasaterasacuddasapannarasasolasasattarasaattharasavassakale,2,2,0,0,62
665778,aṭṭhārasavassakālato,attharasavassakalato,2,2,0,0,20
665779,gihigatātipi,gihigatatipi,3,3,0,0,12
665780,kumāribhūtātipi,kumaribhutatipi,2,2,0,0,15
665781,kumāribhūtā,kumaribhuta,36,29,7,0,11
665782,sikkhāsammutidānavasena,sikkhasammutidanavasena,2,2,0,0,23
665783,sikkhamānāti,sikkhamanati,7,6,1,0,12
665784,paṭhamadutiyatatiyāni,pathamadutiyatatiyani,4,4,0,0,21
665785,catutthapañcamachaṭṭhasikkhāpadavaṇṇanā,catutthapancamachatthasikkhapadavannana,1,1,0,0,39
665786,catutthapañcamachaṭṭhesu,catutthapancamachatthesu,1,0,1,0,24
665787,catutthapañcamachaṭṭhasikkhāpadāni,catutthapancamachatthasikkhapadani,1,1,0,0,34
665788,P4.0943,P4.0943,1,1,0,0,7
665789,anantarasadisānevāti,anantarasadisanevati,3,3,0,0,20
665790,agacchamānā,agacchamana,1,1,0,0,11
665791,sokāvāsā,sokavasa,10,8,2,0,8
665792,purisasamāgamaṃ,purisasamagamam,3,3,0,0,15
665793,ajānantīti,ajanantiti,3,0,3,0,10
665794,pabbajjākāle,pabbajjakale,4,4,0,0,12
665795,upasampadākāle,upasampadakale,7,7,0,0,14
665796,āpucchitepi,apucchitepi,5,5,0,0,11
665797,mātādīnaṃ,matadinam,12,11,1,0,9
665798,apubbasamuṭṭhānasīsaṃ,apubbasamutthanasisam,4,2,2,0,21
665799,abbhānakammādīsu,abbhanakammadisu,3,3,0,0,16
665800,khaṇḍasīmāyaṃ,khandasimayam,19,17,2,0,13
665801,upasampādessāmā,upasampadessama,3,3,0,0,15
665802,upasampādessāmīti,upasampadessamiti,1,1,0,0,17
665803,paṇṇattibhāvaṃ,pannattibhavam,2,2,0,0,14
665804,ananujānāpetvā,ananujanapetva,2,2,0,0,14
665805,upasampādanato,upasampadanato,2,2,0,0,14
665806,ekādasamasikkhāpadavaṇṇanā,ekadasamasikkhapadavannana,2,2,0,0,26
665807,para1167-8,para1167-8,1,1,0,0,10
665808,pārivāsikachandadānenāti,parivasikachandadanenati,3,0,3,0,24
665809,pārivāsiyena,parivasiyena,4,3,1,0,12
665810,pārivāsiyaṃ,parivasiyam,6,6,0,0,11
665811,parisapārivāsiyaṃ,parisaparivasiyam,22,17,5,0,17
665812,P4.0944,P4.0944,1,1,0,0,7
665813,rattipārivāsiyaṃ,rattiparivasiyam,12,8,4,0,16
665814,chandapārivāsiyaṃ,chandaparivasiyam,6,6,0,0,17
665815,ajjhāsayapārivāsiyanti,ajjhasayaparivasiyanti,6,6,0,0,22
665816,avissaṭṭhattā,avissatthatta,9,9,0,0,13
665817,cātuddasikaṃ,catuddasikam,16,15,1,0,12
665818,pannarasikaṃ,pannarasikam,7,7,0,0,12
665819,abbhānādisaṅghakammaṃ,abbhanadisanghakammam,4,4,0,0,21
665820,chandapārivāsiyañceva,chandaparivasiyanceva,5,2,3,0,21
665821,ajjhāsayapārivāsiyañca,ajjhasayaparivasiyanca,5,2,3,0,22
665822,pārivāsiye,parivasiye,7,7,0,0,10
665823,chandapārisuddhiṃ,chandaparisuddhim,31,29,2,0,17
665824,anānetvā,ananetva,6,6,0,0,8
665825,chandavissajjanamatteneva,chandavissajjanamatteneva,1,1,0,0,25
665826,P4.0945,P4.0945,1,1,0,0,7
665827,dvādasamasikkhāpadavaṇṇanā,dvadasamasikkhapadavannana,2,2,0,0,26
665828,terasamasikkhāpadavaṇṇanā,terasamasikkhapadavannana,2,2,0,0,25
665829,ekantarike,ekantarike,3,3,0,0,10
665830,terasamasikkhāpadaṃ,terasamasikkhapadam,9,9,0,0,19
665831,chattupāhanavaggo,chattupahanavaggo,18,18,0,0,17
665832,chattavaggassa,chattavaggassa,3,3,0,0,14
665833,maggagamane,maggagamane,2,2,0,0,11
665834,kaddamādīni,kaddamadini,3,3,0,0,11
665835,upāhanāruḷhāva,upahanarulhava,1,1,0,0,14
665836,upāhanāpi,upahanapi,3,3,0,0,9
665837,yāyantīti,yayantiti,3,1,2,0,9
665838,abhiruhantiyā,abhiruhantiya,2,2,0,0,13
665839,vippakiriyiṃsūti,vippakiriyimsuti,1,0,1,0,16
665840,P4.0946,P4.0946,1,1,0,0,7
665841,sīsūpagādīsu,sisupagadisu,2,2,0,0,12
665842,gandhavaṇṇakenāti,gandhavannakenati,2,0,2,0,17
665843,vaṇṇakena,vannakena,3,2,1,0,9
665844,para1208-9,para1208-9,1,1,0,0,10
665845,ummaddāpeti,ummaddapeti,7,6,1,0,11
665846,ummaddane,ummaddane,2,2,0,0,9
665847,sambāhanepi,sambahanepi,3,2,1,0,11
665848,maggagamanaparissamenāpi,maggagamanaparissamenapi,3,3,0,0,24
665849,sābādhāya,sabadhaya,1,1,0,0,9
665850,sarīrakampanādīsu,sarirakampanadisu,3,3,0,0,17
665851,aṭṭhamanavamadasamasikkhāpadavaṇṇanā,atthamanavamadasamasikkhapadavannana,1,1,0,0,36
665852,aṭṭhamādīsu,atthamadisu,4,4,0,0,11
665853,gihiniyāti,gihiniyati,2,2,0,0,10
665854,aṭṭhamanavamadasamasikkhāpadāni,atthamanavamadasamasikkhapadani,1,1,0,0,31
665855,abhimukhamevāti,abhimukhamevati,3,2,1,0,15
665856,para1219-23,para1219-23,1,1,0,0,11
665857,akataokāsaṃ,akataokasam,4,4,0,0,11
665858,anokāsakatanti,anokasakatanti,1,1,0,0,14
665859,P4.0947,P4.0947,1,1,0,0,7
665860,acchinnacīvarikāyātiādīsu,acchinnacivarikayatiadisu,1,0,1,0,25
665861,saṅkaccikacīvarameva,sankaccikacivarameva,1,1,0,0,20
665862,gacchantiyāva,gacchantiyava,1,1,0,0,13
665863,chasaṭṭhisataṃ,chasatthisatam,3,2,1,0,14
665864,dvenavutīti,dvenavutiti,2,2,0,0,11
665865,aṭṭhāsītisataṃ,atthasitisatam,10,9,1,0,14
665866,bhikkhunīvaggaṃ,bhikkhunivaggam,1,1,0,0,15
665867,paṇītabhojanaviññatti,panitabhojanavinnatti,5,5,0,0,21
665868,duṭṭhullapaṭicchādanaṃ,dutthullapaticchadanam,1,1,0,0,22
665869,ūnavīsativassupasampādanaṃ,unavisativassupasampadanam,1,1,0,0,26
665870,rājantepurappavesanaṃ,rajantepurappavesanam,3,3,0,0,21
665871,vassikasāṭikanti,vassikasatikanti,3,3,0,0,16
665872,P4.0948,P4.0948,1,1,0,0,7
665873,samuṭṭhānavinicchayo,samutthanavinicchayo,3,3,0,0,20
665874,cittāgārasikkhāpadaṃ,cittagarasikkhapadam,5,5,0,0,20
665875,saṅghāṇi,sanghani,8,6,2,0,8
665876,itthālaṅkāro,itthalankaro,7,6,1,0,12
665877,gandhavaṇṇako,gandhavannako,4,4,0,0,13
665878,vāsitakapiññāko,vasitakapinnako,5,5,0,0,15
665879,bhikkhunīādīhi,bhikkhuniadihi,3,3,0,0,14
665880,ummaddanaparimaddanānīti,ummaddanaparimaddananiti,3,3,0,0,24
665881,paṇṇattivajjāneva,pannattivajjaneva,3,3,0,0,17
665882,corīvuṭṭhāpanaṃ,corivutthapanam,1,1,0,0,15
665883,ārāmasikkhāpadaṃ,aramasikkhapadam,3,3,0,0,16
665884,gabbhinivagge,gabbhinivagge,10,10,0,0,13
665885,kumāribhūtavagge,kumaribhutavagge,4,4,0,0,16
665886,pārivāsiyachandadānaṃ,parivasiyachandadanam,2,2,0,0,21
665887,anuvassavuṭṭhāpanaṃ,anuvassavutthapanam,3,3,0,0,19
665888,ekantarikavuṭṭhāpananti,ekantarikavutthapananti,3,3,0,0,23
665889,lokavajjānevāti,lokavajjanevati,3,3,0,0,15
665890,pāṭidesanīyasikkhāpadavaṇṇanā,patidesaniyasikkhapadavannana,6,6,0,0,29
665891,pāḷivinimuttakesu,palivinimuttakesu,1,1,0,0,17
665892,sattādhikaraṇavhayā,sattadhikaranavhaya,2,2,0,0,19
665893,P4.0949,P4.0949,1,1,0,0,7
665894,sabbāsavapahaṃ,sabbasavapaham,6,3,3,0,14
665895,ubhatovibhaṅgaṭṭhakathā,ubhatovibhangatthakatha,1,1,0,0,23
665896,mahākhandhakaṃ,mahakhandhakam,4,4,0,0,14
665897,P5.0951,P5.0951,1,1,0,0,7
665898,pātimokkhānaṃ,patimokkhanam,10,6,4,0,13
665899,saṅgītisamanantaraṃ,sangitisamanantaram,2,2,0,0,19
665900,khandhakovidā,khandhakovida,2,1,1,0,13
665901,padabhājaniye,padabhajaniye,2,2,0,0,13
665902,adhippāyānusandhīhi,adhippayanusandhihi,2,1,1,0,19
665903,anuttānā,anuttana,2,2,0,0,8
665904,avaṇṇitā,avannita,2,2,0,0,8
665905,saṃvaṇṇanānayoti,samvannananayoti,2,1,1,0,16
665906,ayamabhilāpo,ayamabhilapo,2,2,0,0,12
665907,āropitoti,aropitoti,5,3,2,0,9
665908,āruḷhābhilāpavasenevetaṃ,arulhabhilapavasenevetam,1,1,0,0,24
665909,P5.0952,P5.0952,1,1,0,0,7
665910,vinayakammānaṃ,vinayakammanam,5,5,0,0,14
665911,nidānadassanaṃ,nidanadassanam,5,5,0,0,14
665912,upajjhāyaupajjhāyavattaācariyaācariyavattādīni,upajjhayaupajjhayavattaacariyaacariyavattadini,1,1,0,0,46
665913,paññattānīti,pannattaniti,7,5,2,0,12
665914,vālikarāsimhīti,valikarasimhiti,3,2,1,0,15
665915,dasasahassakulaputtā,dasasahassakulaputta,1,1,0,0,20
665916,P5.0953,P5.0953,1,1,0,0,7
665917,anulomapaṭilomatā,anulomapatilomata,3,3,0,0,17
665918,visuddhimaggatova,visuddhimaggatova,1,1,0,0,17
665919,saṅkhāranirodhotiādi,sankharanirodhotiadi,1,0,1,0,20
665920,P5.0954,P5.0954,1,1,0,0,7
665921,somanassayuttañāṇasamuṭṭhānaṃ,somanassayuttananasamutthanam,2,1,1,0,29
665922,P5.0955,P5.0955,1,1,0,0,7
665923,paccayakkhayassa,paccayakkhayassa,1,1,0,0,16
665924,tatrāpāyaṃ,tatrapayam,1,1,0,0,10
665925,P5.0956,P5.0956,1,1,0,0,7
665926,maggapaccavekkhaṇavasena,maggapaccavekkhanavasena,1,1,0,0,24
665927,uppāditamanasikāraṃ,uppaditamanasikaram,1,1,0,0,19
665928,ānubhāvadīpikā,anubhavadipika,2,2,0,0,14
665929,vuttasattāhaṃ,vuttasattaham,1,1,0,0,13
665930,ajapālakathā,ajapalakatha,5,5,0,0,12
665931,avikkhāletvā,avikkhaletva,1,1,0,0,12
665932,sayanasamīpaṃ,sayanasamipam,2,2,0,0,13
665933,nasayatīti,nasayatiti,1,1,0,0,10
665934,idamevattha,idamevattha,1,1,0,0,11
665935,napakkāmīti,napakkamiti,1,1,0,0,11
665936,P5.0957,P5.0957,1,1,0,0,7
665937,balādhigamanaṭṭhānaṃ,baladhigamanatthanam,1,1,0,0,20
665938,P5.0958,P5.0958,1,1,0,0,7
665939,huṃhuṅkārakabhāvādipāpadhammayutto,humhunkarakabhavadipapadhammayutto,1,1,0,0,34
665940,saññatacittatāya,sannatacittataya,1,1,0,0,16
665941,mucalindakathā,mucalindakatha,5,5,0,0,14
665942,uppannamegho,uppannamegho,2,2,0,0,12
665943,dūsitadivasattā,dusitadivasatta,1,1,0,0,15
665944,sītavātaduddinī,sitavataduddini,4,4,0,0,15
665945,karitvāva,karitvava,2,2,0,0,9
665946,P5.0959,P5.0959,1,1,0,0,7
665947,vītarāgatāpi,vitaragatapi,1,1,0,0,12
665948,virāgatāpi,viragatapi,1,1,0,0,10
665949,passaddhivinayo,passaddhivinayo,1,1,0,0,15
665950,rājāyatanakathā,rajayatanakatha,5,5,0,0,15
665951,mucalindamūlāti,mucalindamulati,1,0,1,0,15
665952,pācīnakoṇe,pacinakone,1,1,0,0,10
665953,ṭhitamucalindarukkhamūlā,thitamucalindarukkhamula,1,1,0,0,24
665954,rājāyatanarukkhaṃ,rajayatanarukkham,2,1,1,0,17
665955,vuṭṭhānadivase,vutthanadivase,1,1,0,0,14
665956,bhojanakiccena,bhojanakiccena,1,1,0,0,14
665957,osadhaharītakaṃ,osadhaharitakam,2,1,1,0,15
665958,aruṇamhi,arunamhi,1,1,0,0,8
665959,ukkalajanapadato,ukkalajanapadato,1,1,0,0,16
665960,katarasmiñca,katarasminca,1,1,0,0,12
665961,P5.0960,P5.0960,1,1,0,0,7
665962,ñātibhūtapubbā,natibhutapubba,2,2,0,0,14
665963,appavattīni,appavattini,1,1,0,0,11
665964,maggadevatānaṃ,maggadevatanam,1,1,0,0,14
665965,madhupiṇḍikāya,madhupindikaya,2,1,1,0,14
665966,abaddhasattunā,abaddhasattuna,1,1,0,0,14
665967,baddhasattunā,baddhasattuna,1,1,0,0,13
665968,patimānethāti,patimanethati,2,0,2,0,13
665969,patimānanaṃ,patimananam,3,3,0,0,11
665970,padhānānuyogakāle,padhananuyogakale,1,1,0,0,17
665971,madhupiṇḍakañcā,madhupindakanca,1,1,0,0,15
665972,parivitakkamaññāyāti,parivitakkamannayati,1,0,1,0,20
665973,dinnabhojanaṃyeva,dinnabhojanamyeva,1,1,0,0,17
665974,ojānuppabandhanavasena,ojanuppabandhanavasena,1,1,0,0,22
665975,paṭiggahetukāmatāya,patiggahetukamataya,1,1,0,0,19
665976,catuddisāti,catuddisati,6,1,5,0,11
665977,idaṃyeva,idamyeva,3,3,0,0,8
665978,muggavaṇṇasilāmaye,muggavannasilamaye,3,3,0,0,18
665979,paccaggheti,paccaggheti,11,4,7,0,11
665980,paccagghasmiṃ,paccagghasmim,2,2,0,0,13
665981,mahagghasminti,mahagghasminti,1,1,0,0,14
665982,nibbattasminti,nibbattasminti,1,1,0,0,14
665983,P5.0961,P5.0961,1,1,0,0,7
665984,abhivādanapaccuṭṭhānaṃ,abhivadanapaccutthanam,2,1,1,0,22
665985,rājāyatanamūlā,rajayatanamula,2,2,0,0,14
665986,bhāriyabhāvaṃ,bhariyabhavam,1,1,0,0,13
665987,parivitakkite,parivitakkite,1,1,0,0,13
665988,brahmagaruko,brahmagaruko,2,2,0,0,12
665989,suṭṭhumuditāti,sutthumuditati,1,1,0,0,14
665990,parivitakkayitabbabhāvaṃ,parivitakkayitabbabhavam,2,1,1,0,24
665991,P5.0962,P5.0962,1,1,0,0,7
665992,nibbānagāminti,nibbanagaminti,1,1,0,0,14
665993,kāmarāgabhavarāgadiṭṭhirāgena,kamaragabhavaragaditthiragena,1,1,0,0,29
665994,dhammadesanāyācanatthaṃ,dhammadesanayacanattham,1,1,0,0,23
665995,paṭivijjhitāro,pativijjhitaro,2,2,0,0,14
665996,devaputtamaccukilesābhisaṅkhāramārānaṃ,devaputtamaccukilesabhisankharamaranam,1,1,0,0,38
665997,jātikantārādinittharaṇasamatthatāya,jatikantaradinittharanasamatthataya,1,1,0,0,35
665998,P5.0963,P5.0963,1,1,0,0,7
665999,apparajakkhāti,apparajakkhati,2,0,2,0,14
666000,suppavattimpi,suppavattimpi,1,1,0,0,13
666001,bhāsinti,bhasinti,1,1,0,0,8
666002,pañcavaggiyakathā,pancavaggiyakatha,6,6,0,0,17
666003,P5.0964,P5.0964,1,1,0,0,7
666004,abhidosakālaṃkatoti,abhidosakalamkatoti,2,0,2,0,19
666005,kālaṃkato,kalamkato,7,7,0,0,9
666006,bahūkārāti,bahukarati,1,0,1,0,10
666007,mukhodakadānādinā,mukhodakadanadina,1,1,0,0,17
666008,addhānamaggappaṭipannaṃ,addhanamaggappatipannam,5,4,1,0,23
666009,kilesalepena,kilesalepena,3,3,0,0,12
666010,dhammacakkappaṭilābhāya,dhammacakkappatilabhaya,1,1,0,0,23
666011,hupeyyapāvusoti,hupeyyapavusoti,3,1,2,0,15
666012,P5.0965,P5.0965,1,1,0,0,7
666013,cīvarādibahulabhāvatthāya,civaradibahulabhavatthaya,1,1,0,0,25
666014,dukkarapaṭipadāya,dukkarapatipadaya,1,1,0,0,17
666015,samanupassatha,samanupassatha,10,10,0,0,14
666016,bhāsitametaṃ,bhasitametam,3,1,2,0,12
666017,cakkhukaraṇīti,cakkhukaraniti,2,0,2,0,14
666018,adhippāyānusandhiyojanādibhedato,adhippayanusandhiyojanadibhedato,1,1,0,0,32
666019,avaṇṇayitvā,avannayitva,1,1,0,0,11
666020,vinayakathaṃyeva,vinayakathamyeva,1,1,0,0,16
666021,devatākoṭīhi,devatakotihi,2,2,0,0,12
666022,abhinipphannā,abhinipphanna,2,1,1,0,13
666023,vappassāti,vappassati,1,0,1,0,10
666024,catutthiyanti,catutthiyanti,2,2,0,0,13
666025,anattasuttena,anattasuttena,1,1,0,0,13
666026,pabbajjākathā,pabbajjakatha,10,10,0,0,13
666027,pubbānupubbakānaṃ,pubbanupubbakanam,3,2,1,0,17
666028,P5.0966,P5.0966,1,1,0,0,7
666029,porāṇānuporāṇānanti,porananuporanananti,1,1,0,0,19
666030,antovassamhiyeva,antovassamhiyeva,1,1,0,0,16
666031,yasaādīnaṃ,yasaadinam,2,1,1,0,10
666032,pañcapaññāsajanā,pancapannasajana,1,1,0,0,16
666033,anāthasarīrāni,anathasarirani,1,1,0,0,14
666034,kālaṃkataṃ,kalamkatam,1,1,0,0,10
666035,mātāpitūnnañca,matapitunnanca,1,1,0,0,14
666036,tenāyasmato,tenayasmato,1,1,0,0,11
666037,nāṭakajanesu,natakajanesu,1,1,0,0,12
666038,susānasaññāyeva,susanasannayeva,1,1,0,0,15
666039,pacchimakattikapuṇṇamā,pacchimakattikapunnama,15,12,3,0,22
666040,lobhapāsā,lobhapasa,2,2,0,0,9
666041,visesādhigamato,visesadhigamato,3,2,1,0,15
666042,antakāti,antakati,2,1,1,0,8
666043,hīnasatta,hinasatta,1,1,0,0,9
666044,rāgapāsaṃ,ragapasam,2,2,0,0,9
666045,nānājanapadāti,nanajanapadati,1,0,1,0,14
666046,nānādisato,nanadisato,1,1,0,0,10
666047,P5.0967,P5.0967,1,1,0,0,7
666048,pabbājethātiādimhi,pabbajethatiadimhi,1,0,1,0,18
666049,pabbajjāpekkhaṃ,pabbajjapekkham,18,17,1,0,15
666050,andhamūgabadhiro,andhamugabadhiro,6,6,0,0,16
666051,pabbajjādosavirahito,pabbajjadosavirahito,2,2,0,0,20
666052,anuññātoyeva,anunnatoyeva,2,2,0,0,12
666053,anujānanalakkhaṇaṃ,anujananalakkhanam,2,2,0,0,18
666054,pabbajjādosavirahitaṃ,pabbajjadosavirahitam,2,2,0,0,21
666055,pabbājentenāpi,pabbajentenapi,4,4,0,0,14
666056,acchinnakeso,acchinnakeso,4,4,0,0,12
666057,kesacchedanatthāya,kesacchedanatthaya,2,2,0,0,18
666058,bhaṇḍukammaṃ,bhandukammam,26,18,8,0,12
666059,āpucchanākāraṃ,apucchanakaram,1,1,0,0,14
666060,apaloketuṃ,apaloketum,9,7,2,0,10
666061,bhaṇḍukammāyā,bhandukammaya,3,3,0,0,13
666062,bhikkhunāva,bhikkhunava,7,7,0,0,11
666063,kesoropanaṃ,kesoropanam,5,5,0,0,11
666064,mattikāmuṭṭhiṃ,mattikamutthim,2,2,0,0,14
666065,pabbajitukāmānañhi,pabbajitukamananhi,2,2,0,0,18
666066,balavaussāho,balavaussaho,2,2,0,0,12
666067,kesaharaṇasatthakañca,kesaharanasatthakanca,2,2,0,0,21
666068,utrasanti,utrasanti,2,2,0,0,9
666069,ettoyeva,ettoyeva,2,2,0,0,8
666070,nahānatitthaṃ,nahanatittham,4,4,0,0,13
666071,nātidaharo,natidaharo,2,2,0,0,10
666072,nahāhī,nahahi,2,2,0,0,6
666073,daharakumārako,daharakumarako,2,2,0,0,14
666074,gomayamattikāhi,gomayamattikahi,2,2,0,0,15
666075,nahāpetabbo,nahapetabbo,4,4,0,0,11
666076,P5.0968,P5.0968,1,1,0,0,7
666077,hatthapādasīsāni,hatthapadasisani,1,1,0,0,16
666078,therabhāvaṃ,therabhavam,2,2,0,0,11
666079,nahāpanakāle,nahapanakale,2,2,0,0,12
666080,oropanakāle,oropanakale,2,2,0,0,11
666081,aniyyānikakathā,aniyyanikakatha,3,3,0,0,15
666082,asucijegucchapaṭikūlabhāvaṃ,asucijegucchapatikulabhavam,3,3,0,0,27
666083,nijjīvanissattabhāvaṃ,nijjivanissattabhavam,9,5,4,0,21
666084,madditasaṅkhāro,madditasankharo,2,2,0,0,15
666085,kaṇṭakavedhāpekkho,kantakavedhapekkho,3,3,0,0,18
666086,paripakkagaṇḍo,paripakkagando,3,3,0,0,14
666087,sūriyuggamanāpekkhaṃ,suriyuggamanapekkham,2,2,0,0,20
666088,indāsani,indasani,3,3,0,0,8
666089,kilesapabbate,kilesapabbate,2,2,0,0,13
666090,cuṇṇayamānaṃyeva,cunnayamanamyeva,2,2,0,0,16
666091,dinnanayaṃ,dinnanayam,3,3,0,0,10
666092,oropitesu,oropitesu,2,2,0,0,9
666093,haliddicuṇṇena,haliddicunnena,2,2,0,0,14
666094,gihigandhaṃ,gihigandham,4,3,1,0,11
666095,paṭiggāhetabbo,patiggahetabbo,1,1,0,0,14
666096,acchādehī,acchadehi,16,15,1,0,9
666097,P5.0969,P5.0969,1,1,0,0,7
666098,upajjhāyamūlake,upajjhayamulake,3,3,0,0,15
666099,vandāpetvāti,vandapetvati,3,0,3,0,12
666100,saraṇaggahaṇatthaṃ,saranaggahanattham,1,1,0,0,18
666101,yathāvuttapaṭipāṭiyāva,yathavuttapatipatiyava,2,2,0,0,22
666102,saraṇaṃyeva,saranamyeva,2,2,0,0,11
666103,adinnāni,adinnani,3,3,0,0,8
666104,saraṇagamanūpasampadaṃ,saranagamanupasampadam,2,2,0,0,22
666105,sāmaṇerapabbajjā,samanerapabbajja,8,7,1,0,16
666106,ubhatosuddhiyāva,ubhatosuddhiyava,4,2,2,0,16
666107,ñattidosañceva,nattidosanceva,2,2,0,0,14
666108,kammavācādosañca,kammavacadosanca,2,2,0,0,16
666109,bukāradhakārādīnaṃ,bukaradhakaradinam,1,1,0,0,18
666110,ṭhānakaraṇasampadaṃ,thanakaranasampadam,9,5,4,0,19
666111,ahāpenteneva,ahapenteneva,1,1,0,0,12
666112,ācariyenapi,acariyenapi,4,4,0,0,11
666113,antevāsikenapi,antevasikenapi,2,2,0,0,14
666114,ekasambandhāni,ekasambandhani,2,2,0,0,14
666115,anunāsikantāni,anunasikantani,3,3,0,0,14
666116,makārantāni,makarantani,3,3,0,0,11
666117,ekaaṭṭhakathāyampi,ekaatthakathayampi,1,1,0,0,18
666118,rucimattameva,rucimattameva,3,3,0,0,13
666119,avadantassa,avadantassa,10,10,0,0,11
666120,P5.0970,P5.0970,1,1,0,0,7
666121,gacchāmītiādīhi,gacchamitiadihi,1,1,0,0,15
666122,ubhatosuddhiyā,ubhatosuddhiya,3,2,1,0,14
666123,saraṇamatteneva,saranamatteneva,2,2,0,0,15
666124,sāmaṇerapabbajjaṃ,samanerapabbajjam,10,10,0,0,17
666125,uddisitabbāni,uddisitabbani,6,6,0,0,13
666126,sikkhāpadadānampi,sikkhapadadanampi,2,2,0,0,17
666127,yathāpāḷiyāva,yathapaliyava,3,3,0,0,13
666128,sikkhāparipūraṇatthaṃ,sikkhaparipuranattham,1,1,0,0,21
666129,atthavasenapi,atthavasenapi,2,2,0,0,13
666130,sikkhitabbasikkhāpadāni,sikkhitabbasikkhapadani,2,2,0,0,23
666131,saṅghāṭipattacīvaradhāraṇaṭṭhānanisajjādīsu,sanghatipattacivaradharanatthananisajjadisu,2,2,0,0,43
666132,pānabhojanādividhimhi,panabhojanadividhimhi,2,2,0,0,21
666133,salākabhājanaṭṭhānaṃ,salakabhajanatthanam,2,2,0,0,20
666134,tathārūpaṭṭhānaṃ,tatharupatthanam,2,2,0,0,16
666135,santikāvacaroyeva,santikavacaroyeva,2,2,0,0,17
666136,nivāsanapārupanādīsu,nivasanaparupanadisu,3,3,0,0,20
666137,P5.0971,P5.0971,1,1,0,0,7
666138,nāsanaṅgāni,nasanangani,4,4,0,0,11
666139,paripūrentena,paripurentena,2,2,0,0,13
666140,dutiyamārakathā,dutiyamarakatha,5,5,0,0,15
666141,bhaddavaggiyakathā,bhaddavaggiyakatha,3,3,0,0,18
666142,bhaddavaggiyāti,bhaddavaggiyati,1,0,1,0,15
666143,tiṃsadhuttā,timsadhutta,1,1,0,0,11
666144,uruvelapāṭihāriyakathā,uruvelapatihariyakatha,4,4,0,0,22
666145,abhibhaveyyaṃ,abhibhaveyyam,2,2,0,0,13
666146,bhagavātiādikā,bhagavatiadika,1,0,1,0,14
666147,para44-9,para44-9,1,1,0,0,8
666148,P5.0972,P5.0972,1,1,0,0,7
666149,uyyojetvāti,uyyojetvati,1,0,1,0,11
666150,mandāmukhiyoti,mandamukhiyoti,2,0,2,0,14
666151,aggibhājanāni,aggibhajanani,2,2,0,0,13
666152,cirapaṭikāti,cirapatikati,4,0,4,0,12
666153,bimbisārasamāgamakathā,bimbisarasamagamakatha,4,4,0,0,22
666154,laṭṭhivaneti,latthivaneti,2,0,2,0,12
666155,tāluyyāne,taluyyane,3,2,1,0,9
666156,dvādasanahutehīti,dvadasanahutehiti,1,0,1,0,17
666157,kisakovadānoti,kisakovadanoti,4,0,4,0,14
666158,tāpasacariyāya,tapasacariyaya,2,1,1,0,14
666159,kisasarīrattā,kisasariratta,3,2,1,0,13
666160,anusāsantotipi,anusasantotipi,1,1,0,0,14
666161,uruvelavāsiaggiparicārakānaṃ,uruvelavasiaggiparicarakanam,1,1,0,0,28
666162,kāmappabhedaṃ,kamappabhedam,1,1,0,0,13
666163,yiṭṭhahutappabhedā,yitthahutappabheda,1,1,0,0,18
666164,P5.0973,P5.0973,1,1,0,0,7
666165,nābhiraminti,nabhiraminti,1,1,0,0,12
666166,kocarahīti,kocarahiti,2,0,2,0,10
666167,kvacarahi,kvacarahi,1,1,0,0,9
666168,rāgakiñcanādīnaṃ,ragakincanadinam,1,1,0,0,16
666169,anaññathābhāviṃ,anannathabhavim,1,0,1,0,15
666170,adhigametabbanti,adhigametabbanti,1,1,0,0,16
666171,padamaddasaṃ,padamaddasam,1,1,0,0,12
666172,devamanussalokasampattisādhake,devamanussalokasampattisadhake,1,1,0,0,30
666173,assāsakāti,assasakati,2,0,2,0,10
666174,maggappaṭivedhenevassa,maggappativedhenevassa,1,1,0,0,22
666175,maggavasenevāyaṃ,maggavasenevayam,1,1,0,0,16
666176,niyatasaraṇataṃ,niyatasaranatam,2,2,0,0,15
666177,paṇipātagamanañca,panipatagamananca,1,1,0,0,17
666178,siṅgīnikkhasavaṇṇoti,singinikkhasavannoti,3,1,2,0,20
666179,siṅgīsuvaṇṇanikkhena,singisuvannanikkhena,2,2,0,0,20
666180,dasavāsoti,dasavasoti,1,0,1,0,10
666181,dasadhammavidūti,dasadhammaviduti,1,0,1,0,16
666182,dasakammapathavidū,dasakammapathavidu,1,1,0,0,18
666183,cupetoti,cupetoti,1,0,1,0,8
666184,sabbadhidantoti,sabbadhidantoti,1,0,1,0,15
666185,P5.0974,P5.0974,1,1,0,0,7
666186,buddhābhivādanagamanena,buddhabhivadanagamanena,2,2,0,0,23
666187,abhikkamanīyaṃ,abhikkamaniyam,6,5,1,0,14
666188,vijanapātaṃ,vijanapatam,2,1,1,0,11
666189,janasañcāravirahitanti,janasancaravirahitanti,1,1,0,0,22
666190,vimvisārasamāgamakathā,vimvisarasamagamakatha,1,1,0,0,22
666191,sāriputtamoggallānapabbajjākathā,sariputtamoggallanapabbajjakatha,4,4,0,0,32
666192,paññāyamānanāmā,pannayamananama,2,1,1,0,15
666193,aḍḍhateyyasatamāṇavakaparivārā,addhateyyasatamanavakaparivara,1,1,0,0,30
666194,mahāsattanikāyo,mahasattanikayo,1,1,0,0,15
666195,paccupaṭṭhitamaraṇasaññā,paccupatthitamaranasanna,1,1,0,0,24
666196,amatenāpi,amatenapi,2,2,0,0,9
666197,pariyesāmā,pariyesama,1,1,0,0,10
666198,amatapariyesanatthaṃ,amatapariyesanattham,1,1,0,0,20
666199,channaparibbājakassa,channaparibbajakassa,1,1,0,0,20
666200,aññopettha,annopettha,1,1,0,0,10
666201,abhikkantenātiādīsu,abhikkantenatiadisu,2,0,2,0,19
666202,P5.0975,P5.0975,1,1,0,0,7
666203,anubandhanassa,anubandhanassa,2,2,0,0,14
666204,sudinnakaṇḍe,sudinnakande,3,2,1,0,12
666205,vattapaṭipattipūraṇatthaṃ,vattapatipattipuranattham,1,1,0,0,25
666206,dhotahatthapādena,dhotahatthapadena,1,1,0,0,17
666207,hetuppabhavāti,hetuppabhavati,2,0,2,0,14
666208,appavattinirodho,appavattinirodho,2,2,0,0,16
666209,adassitampi,adassitampi,1,1,0,0,11
666210,nirodhupāyo,nirodhupayo,2,2,0,0,11
666211,sotāpattiphalamattameva,sotapattiphalamattameva,1,1,0,0,23
666212,paccabyattha,paccabyattha,3,2,1,0,12
666213,P5.0976,P5.0976,1,1,0,0,7
666214,paṭividdhāttha,patividdhattha,1,1,0,0,14
666215,kappanahutehīti,kappanahutehiti,7,2,5,0,15
666216,adiṭṭhabhāvena,aditthabhavena,2,2,0,0,14
666217,mahājānibhāvaṃ,mahajanibhavam,1,1,0,0,14
666218,ñāṇavisayeti,nanavisayeti,1,0,1,0,12
666219,vimutteti,vimutteti,2,0,2,0,9
666220,sāvakapāramiññāṇe,savakaparaminnane,1,1,0,0,17
666221,ehibhikkhūpasampadāyeva,ehibhikkhupasampadayeva,1,1,0,0,23
666222,upasampannesu,upasampannesu,4,4,0,0,13
666223,pupphāsaneyeva,pupphasaneyeva,1,1,0,0,14
666224,pupphāsanāni,pupphasanani,1,1,0,0,12
666225,sirīvaḍḍhassa,sirivaddhassa,1,1,0,0,13
666226,nīluppalamaṇḍapaṃ,niluppalamandapam,1,1,0,0,17
666227,sirīvaḍḍho,sirivaddho,3,3,0,0,10
666228,aputtakatāyātiādīsu,aputtakatayatiadisu,1,0,1,0,19
666229,aputtakatāya,aputtakataya,2,2,0,0,12
666230,vedhabyāya,vedhabyaya,2,1,1,0,10
666231,vidhavābhāvāya,vidhavabhavaya,1,1,0,0,14
666232,kulupacchedāya,kulupacchedaya,2,1,1,0,14
666233,sañcayānīti,sancayaniti,2,0,2,0,11
666234,antevāsikāni,antevasikani,1,1,0,0,12
666235,mahāvīriyavanto,mahaviriyavanto,2,2,0,0,15
666236,P5.0977,P5.0977,1,1,0,0,7
666237,upajjhāyavattakathā,upajjhayavattakatha,5,5,0,0,19
666238,anupajjhāyakāti,anupajjhayakati,3,0,3,0,15
666239,upanijjhāyakena,upanijjhayakena,2,1,1,0,15
666240,anākappasampannāti,anakappasampannati,1,0,1,0,18
666241,samaṇasāruppācāravirahitāti,samanasaruppacaravirahitati,1,1,0,0,27
666242,uparibhojaneti,uparibhojaneti,1,0,1,0,14
666243,caraṇakapattaṃ,caranakapattam,4,2,2,0,14
666244,ucchiṭṭhasaññino,ucchitthasannino,6,5,1,0,16
666245,uttiṭṭhapattanti,uttitthapattanti,6,5,1,0,16
666246,puttacittaṃ,puttacittam,4,3,1,0,11
666247,upaṭṭhapessatīti,upatthapessatiti,1,0,1,0,16
666248,upaṭṭhapessati,upatthapessati,5,5,0,0,14
666249,garubhāvañceva,garubhavanceva,1,1,0,0,14
666250,sabhāgavuttinoti,sabhagavuttinoti,2,0,2,0,16
666251,upajjhāyabhāvasampaṭicchanavevacanāni,upajjhayabhavasampaticchanavevacanani,2,1,1,0,37
666252,sāhū,sahu,14,13,1,0,4
666253,upajjhāyaggahaṇaṃ,upajjhayaggahanam,7,7,0,0,17
666254,atthaviññāpananti,atthavinnapananti,2,2,0,0,17
666255,āyācanadānamattena,ayacanadanamattena,3,2,1,0,18
666256,saddhivihārikenāpi,saddhiviharikenapi,3,3,0,0,18
666257,sammāvattanāti,sammavattanati,5,1,4,0,14
666258,sammāvattanā,sammavattana,33,32,1,0,12
666259,dhotapādapariharaṇatthāya,dhotapadapariharanatthaya,2,2,0,0,25
666260,pādagatā,padagata,2,2,0,0,8
666261,P5.0978,P5.0978,1,1,0,0,7
666262,mukhadhovanodakaṃ,mukhadhovanodakam,8,6,2,0,17
666263,mukhadhovanaṭṭhāne,mukhadhovanatthane,3,3,0,0,18
666264,vaccakuṭito,vaccakutito,7,7,0,0,11
666265,vuttavattaṃ,vuttavattam,2,2,0,0,11
666266,uklāpoti,uklapoti,4,1,3,0,8
666267,saṅkiṇṇo,sankinno,1,1,0,0,8
666268,udakaphusitāneva,udakaphusitaneva,2,2,0,0,16
666269,pamajjitabbo,pamajjitabbo,2,2,0,0,12
666270,padavītihārehi,padavitiharehi,2,2,0,0,14
666271,opātetabbāti,opatetabbati,2,0,2,0,12
666272,samuṭṭhāpetabbā,samutthapetabba,2,2,0,0,15
666273,khandhakadhammatā,khandhakadhammata,2,2,0,0,17
666274,bhaṇamānoti,bhanamanoti,2,0,2,0,11
666275,padasodhammaduṭṭhullādivasena,padasodhammadutthulladivasena,1,1,0,0,29
666276,āsannavācaṃ,asannavacam,4,2,2,0,11
666277,nivāretabboti,nivaretabboti,5,2,3,0,13
666278,P5.0979,P5.0979,1,1,0,0,7
666279,bhaṇā,bhana,3,3,0,0,5
666280,āsanapaññāpanādi,asanapannapanadi,1,1,0,0,16
666281,sinnaṃ,sinnam,13,11,2,0,6
666282,sedaggahitaṃ,sedaggahitam,3,3,0,0,12
666283,ussāretvāti,ussaretvati,4,0,4,0,11
666284,saṃharitassa,samharitassa,2,2,0,0,12
666285,nivāraṇatthametaṃ,nivaranatthametam,2,2,0,0,17
666286,bhaṅgaṭṭhāneyeva,bhangatthaneyeva,2,2,0,0,16
666287,obhoge,obhoge,13,11,2,0,6
666288,paṭikkamane,patikkamane,5,4,1,0,11
666289,laddhabhikkhassa,laddhabhikkhassa,2,2,0,0,16
666290,laddhatopi,laddhatopi,2,2,0,0,10
666291,āhariyatū,ahariyatu,3,3,0,0,9
666292,taṭṭikadhammakhaṇḍādīsu,tattikadhammakhandadisu,1,1,0,0,23
666293,paṃsusakkharamissāya,pamsusakkharamissaya,3,3,0,0,20
666294,kāḷavaṇṇakatā,kalavannakata,16,16,0,0,13
666295,sudhābaddhā,sudhabaddha,4,4,0,0,11
666296,nirajamattikā,nirajamattika,4,4,0,0,13
666297,P5.0980,P5.0980,1,1,0,0,7
666298,dhotavālikāyapi,dhotavalikayapi,2,2,0,0,15
666299,paṃsurajasakkharādīsu,pamsurajasakkharadisu,3,3,0,0,21
666300,cīvaravaṃsādīnaṃ,civaravamsadinam,4,4,0,0,16
666301,nikkhipanatthaṃ,nikkhipanattham,3,3,0,0,15
666302,sannetabbaṃ,sannetabbam,15,12,3,0,11
666303,nhānacuṇṇaṃ,nhanacunnam,1,1,0,0,11
666304,aṅgāramattikauṇhodakadānādikaṃ,angaramattikaunhodakadanadikam,1,1,0,0,30
666305,aṅgapaccaṅgaghaṃsanādikaṃ,angapaccangaghamsanadikam,2,2,0,0,25
666306,saṭṭhivassenāpi,satthivassenapi,1,1,0,0,15
666307,nakārapaṭisaṃyuttesu,nakarapatisamyuttesu,4,4,0,0,20
666308,paṭikkhittakiriyaṃ,patikkhittakiriyam,4,4,0,0,18
666309,appaṭighaṃsantenāti,appatighamsantenati,2,1,1,0,19
666310,appaṭighaṃsantena,appatighamsantena,60,60,0,0,17
666311,kavāṭapiṭṭhaṃ,kavatapittham,33,32,1,0,13
666312,kavāṭañca,kavatanca,4,4,0,0,9
666313,piṭṭhasaṅghātañca,pitthasanghatanca,2,2,0,0,17
666314,acchupantena,acchupantena,3,3,0,0,12
666315,kīṭakulāvakamakkaṭakasuttādi,kitakulavakamakkatakasuttadi,3,3,0,0,28
666316,ullokato,ullokato,3,3,0,0,8
666317,avaharitabbanti,avaharitabbanti,2,2,0,0,15
666318,ālokasandhikaṇṇabhāgāti,alokasandhikannabhagati,2,0,2,0,23
666319,ālokasandhibhāgā,alokasandhibhaga,3,3,0,0,16
666320,kaṇṇabhāgā,kannabhaga,3,3,0,0,10
666321,antarabāhiravātapānakavāṭakāni,antarabahiravatapanakavatakani,1,1,0,0,30
666322,pamajjitabbāti,pamajjitabbati,1,1,0,0,14
666323,nikkhipitabbanti,nikkhipitabbanti,11,11,0,0,16
666324,purimavattaṃ,purimavattam,1,1,0,0,12
666325,dvaṅgulamattena,dvangulamattena,2,2,0,0,15
666326,tivaṅgulamattena,tivangulamattena,2,2,0,0,16
666327,paññāpanavattaṃ,pannapanavattam,2,2,0,0,15
666328,kaṭasārako,katasarako,9,9,0,0,10
666329,P5.0981,P5.0981,1,1,0,0,7
666330,vātapānā,vatapana,66,65,1,0,8
666331,thaketabbāti,thaketabbati,1,0,1,0,12
666332,thaketabbā,thaketabba,64,64,0,0,10
666333,vūpakāsetabboti,vupakasetabboti,2,0,2,0,15
666334,vūpakāsāpetabboti,vupakasapetabboti,1,0,1,0,17
666335,vissajjāpetabbaṃ,vissajjapetabbam,2,2,0,0,16
666336,vivecāpetabbaṃ,vivecapetabbam,9,8,1,0,14
666337,parivāsadānatthaṃ,parivasadanattham,3,3,0,0,17
666338,yācitabbo,yacitabbo,83,83,0,0,9
666339,dāpetabbo,dapetabbo,2,2,0,0,9
666340,pariṇāmeyyāti,parinameyyati,14,11,3,0,13
666341,vattāpetvā,vattapetva,2,2,0,0,10
666342,paṭippassambhetha,patippassambhetha,2,2,0,0,17
666343,samparivattakanti,samparivattakanti,1,0,1,0,17
666344,dātabbotiādi,databbotiadi,2,0,2,0,12
666345,visabhāgapuggalavasena,visabhagapuggalavasena,1,1,0,0,22
666346,pavisitukāmena,pavisitukamena,2,2,0,0,14
666347,āpucchituṃyeva,apucchitumyeva,3,3,0,0,14
666348,pakkamitabbāti,pakkamitabbati,3,1,2,0,14
666349,P5.0982,P5.0982,1,1,0,0,7
666350,pakkamitukāmena,pakkamitukamena,2,2,0,0,15
666351,nivārentepi,nivarentepi,2,2,0,0,11
666352,vuṭṭhānamassa,vutthanamassa,25,23,2,0,13
666353,gelaññato,gelannato,4,4,0,0,9
666354,saddhivihārikavattakathā,saddhiviharikavattakatha,6,6,0,0,24
666355,saddhivihārikamhi,saddhiviharikamhi,10,10,0,0,17
666356,sammāvattanāyaṃ,sammavattanayam,4,4,0,0,15
666357,anuggahetabboti,anuggahetabboti,2,0,2,0,15
666358,uddesādīhissa,uddesadihissa,2,2,0,0,13
666359,pāḷivācanaṃ,palivacanam,1,1,0,0,11
666360,uppajjamānaupāyapariyesanaṃ,uppajjamanaupayapariyesanam,3,2,1,0,27
666361,ācamanakumbhiyā,acamanakumbhiya,33,33,0,0,15
666362,udakāsiñcanapariyosānaṃ,udakasincanapariyosanam,1,1,0,0,23
666363,anabhirativūpakāsanādi,anabhirativupakasanadi,2,2,0,0,22
666364,rajantenāti,rajantenati,3,0,3,0,11
666365,rajeyyāsī,rajeyyasi,3,3,0,0,9
666366,nasammāvattanādikathā,nasammavattanadikatha,3,3,0,0,21
666367,paṇāmetabboti,panametabboti,2,0,2,0,13
666368,nādhimattā,nadhimatta,21,19,2,0,10
666369,P5.0983,P5.0983,1,1,0,0,7
666370,appaṇāmento,appanamento,11,10,1,0,11
666371,paṇāmetabbova,panametabbova,1,1,0,0,13
666372,sammāvattanāya,sammavattanaya,4,3,1,0,14
666373,cīvararajanaṃ,civararajanam,9,8,1,0,13
666374,nissayamuttakassāpi,nissayamuttakassapi,4,4,0,0,19
666375,amuttakassāpi,amuttakassapi,4,4,0,0,13
666376,pattadānato,pattadanato,3,3,0,0,11
666377,amuttakanissayasseva,amuttakanissayasseva,2,2,0,0,20
666378,asādiyanaṃ,asadiyanam,18,17,1,0,10
666379,bhārakaraṇato,bharakaranato,2,2,0,0,13
666380,rādhabrāhmaṇavatthukathā,radhabrahmanavatthukatha,3,3,0,0,24
666381,rādhabrāhmaṇavatthusmiṃ,radhabrahmanavatthusmim,2,1,1,0,23
666382,upasampādemī,upasampademi,3,3,0,0,12
666383,ajjhāsayakusalā,ajjhasayakusala,1,1,0,0,15
666384,buddhaparisāya,buddhaparisaya,1,1,0,0,14
666385,paṭibalenāti,patibalenati,2,0,2,0,12
666386,ñatticatutthakammavācāmattampi,natticatutthakammavacamattampi,1,1,0,0,30
666387,kāsasosasemhādinā,kasasosasemhadina,2,2,0,0,17
666388,P5.0984,P5.0984,1,1,0,0,7
666389,oṭṭhadantajivhādīnaṃ,otthadantajivhadinam,1,1,0,0,20
666390,akataparicayattā,akataparicayatta,2,2,0,0,16
666391,ñāpetabboti,napetabboti,2,1,1,0,11
666392,upasampannasamanantarāti,upasampannasamanantarati,2,0,2,0,24
666393,patiṭṭhapetu,patitthapetu,1,1,0,0,12
666394,sāmaṇerabhāvā,samanerabhava,2,2,0,0,13
666395,anukappaṃ,anukappam,1,1,0,0,9
666396,niccappavattinī,niccappavattini,2,2,0,0,15
666397,nissayeti,nissayeti,6,1,5,0,9
666398,ācariyavattakathā,acariyavattakatha,5,5,0,0,17
666399,anusāsiyoti,anusasiyoti,1,0,1,0,11
666400,gaṇabandhikaṃ,ganabandhikam,5,4,1,0,13
666401,gaṇabandho,ganabandho,1,1,0,0,10
666402,bāhullassa,bahullassa,3,3,0,0,10
666403,abyattāti,abyattati,1,0,1,0,9
666404,aññattaropi,annattaropi,1,0,1,0,11
666405,bhikkhunātiādimhi,bhikkhunatiadimhi,1,0,1,0,17
666406,bhikkhunovādakavaṇṇanāyaṃ,bhikkhunovadakavannanayam,2,2,0,0,25
666407,saddhivihāriṃ,saddhiviharim,23,23,0,0,13
666408,P5.0985,P5.0985,1,1,0,0,7
666409,vinetūṃ,vinetum,1,1,0,0,7
666410,pakkhasaṅkantesūti,pakkhasankantesuti,1,0,1,0,18
666411,titthiyapakkhasaṅkantesu,titthiyapakkhasankantesu,1,1,0,0,24
666412,ācārasamācārasikkhāpanakaṃ,acarasamacarasikkhapanakam,2,1,1,0,26
666413,antevāsikamhītiādi,antevasikamhitiadi,1,0,1,0,18
666414,saddhivihārikamhī,saddhiviharikamhi,1,1,0,0,17
666415,vuttavaseneva,vuttavaseneva,2,2,0,0,13
666416,paṇāmanākhamanākathā,panamanakhamanakatha,2,2,0,0,20
666417,nasammāvattanāya,nasammavattanaya,1,1,0,0,16
666418,nissayantevāsikassa,nissayantevasikassa,10,10,0,0,19
666419,nissayantevāsikena,nissayantevasikena,7,7,0,0,18
666420,pabbajjāupasampadādhammantevāsikehi,pabbajjaupasampadadhammantevasikehi,2,2,0,0,35
666421,nissayamuttakehipi,nissayamuttakehipi,4,4,0,0,18
666422,pattadānādimhi,pattadanadimhi,3,3,0,0,14
666423,pabbajjantevāsiko,pabbajjantevasiko,6,6,0,0,17
666424,upasampadantevāsiko,upasampadantevasiko,6,6,0,0,19
666425,nissayantevāsiko,nissayantevasiko,5,5,0,0,16
666426,ācariyantevāsikesu,acariyantevasikesu,2,2,0,0,18
666427,nissayapaṭippassaddhikathā,nissayapatippassaddhikatha,4,4,0,0,26
666428,upajjhāyamhā,upajjhayamha,9,9,0,0,12
666429,nissayapaṭippassaddhīsu,nissayapatippassaddhisu,5,3,2,0,23
666430,pakkantoti,pakkantoti,6,3,3,0,10
666431,ekasambhogaparibhogo,ekasambhogaparibhogo,6,4,2,0,20
666432,P5.0986,P5.0986,1,1,0,0,7
666433,pesalabhāvaṃ,pesalabhavam,5,5,0,0,12
666434,sabhāgataṃ,sabhagatam,15,12,3,0,10
666435,paricchinnakālato,paricchinnakalato,4,4,0,0,17
666436,udakosakkanaṃ,udakosakkanam,3,3,0,0,13
666437,vibbhante,vibbhante,13,11,2,0,9
666438,pakkhasaṅkante,pakkhasankante,8,8,0,0,14
666439,nissayapaṇāmanā,nissayapanamana,4,4,0,0,15
666440,paṭikkamī,patikkami,3,3,0,0,9
666441,pāḷimuttakanayena,palimuttakanayena,3,3,0,0,17
666442,nissayapaṇāmanāya,nissayapanamanaya,8,8,0,0,17
666443,khameyyā,khameyya,3,3,0,0,8
666444,dubbhikkhādidosena,dubbhikkhadidosena,2,2,0,0,18
666445,ayamāṇattiyaṃ,ayamanattiyam,2,2,0,0,13
666446,P5.0987,P5.0987,1,1,0,0,7
666447,gantukāmomhī,gantukamomhi,2,2,0,0,12
666448,upacārasīmātikkame,upacarasimatikkame,4,4,0,0,18
666449,antoupacārasīmato,antoupacarasimato,2,2,0,0,17
666450,bahisīmaṃ,bahisimam,27,26,1,0,9
666451,gamiyacitte,gamiyacitte,2,2,0,0,11
666452,P5.0988,P5.0988,1,1,0,0,7
666453,paṭippassambhatiyeva,patippassambhatiyeva,8,8,0,0,20
666454,sālayabhāve,salayabhave,4,4,0,0,11
666455,paṇāmitena,panamitena,6,6,0,0,10
666456,samodhānagatoti,samodhanagatoti,2,0,2,0,15
666457,dassanasavanavasena,dassanasavanavasena,4,4,0,0,19
666458,asañjānantassa,asanjanantassa,2,2,0,0,14
666459,upasampādetabbapañcakakathā,upasampadetabbapancakakatha,3,3,0,0,27
666460,upajjhāyācariyānaṃ,upajjhayacariyanam,2,2,0,0,18
666461,asamannāgatattāva,asamannagatattava,1,1,0,0,17
666462,P5.0989,P5.0989,1,1,0,0,7
666463,ayuttavasena,ayuttavasena,14,14,0,0,12
666464,āpattiaṅgavasena,apattiangavasena,15,15,0,0,16
666465,assaddhiyādidosayuttova,assaddhiyadidosayuttova,2,2,0,0,23
666466,upasampādetabbantiādi,upasampadetabbantiadi,1,1,0,0,21
666467,upajjhāyācariyabhāvo,upajjhayacariyabhavo,2,2,0,0,20
666468,sīlavipannotiādīsu,silavipannotiadisu,2,0,2,0,18
666469,ācāravipanno,acaravipanno,32,29,3,0,12
666470,atidiṭṭhiyā,atiditthiya,31,29,2,0,11
666471,āpattādi,apattadi,3,3,0,0,8
666472,desanāgāminito,desanagaminito,4,4,0,0,14
666473,ābhisamācārikāya,abhisamacarikaya,4,2,2,0,16
666474,khandhakavatte,khandhakavatte,2,2,0,0,14
666475,P5.0990,P5.0990,1,1,0,0,7
666476,ādibrahmacariyakāyāti,adibrahmacariyakayati,2,0,2,0,21
666477,sekkhapaṇṇattiyaṃ,sekkhapannattiyam,8,2,6,0,17
666478,jānātītiādipañcakasmimpi,janatitiadipancakasmimpi,1,0,1,0,24
666479,ūnadasavassapariyosānapañcakepi,unadasavassapariyosanapancakepi,2,2,0,0,31
666480,catutthapañcake,catutthapancake,2,2,0,0,15
666481,chaṭṭhasattamaaṭṭhamā,chatthasattamaatthama,1,1,0,0,21
666482,upasampādetabbachakkakathā,upasampadetabbachakkakatha,3,3,0,0,26
666483,ūnadasavassapadaṃ,unadasavassapadam,2,2,0,0,17
666484,ubhatovibhaṅgavasena,ubhatovibhangavasena,2,2,0,0,20
666485,mātikāvibhaṅgavasena,matikavibhangavasena,2,2,0,0,20
666486,mātikāto,matikato,2,2,0,0,8
666487,aññatitthiyapubbavatthukathā,annatitthiyapubbavatthukatha,3,3,0,0,28
666488,aññatitthiyapubbavatthusmiṃ,annatitthiyapubbavatthusmim,1,1,0,0,27
666489,titthiyapakkantakattā,titthiyapakkantakatta,1,1,0,0,21
666490,pabbajitapubbo,pabbajitapubbo,1,1,0,0,14
666491,aññopī,annopi,2,1,1,0,6
666492,appaṭicchannaparivāsotipi,appaticchannaparivasotipi,1,1,0,0,25
666493,naggaparibbājakasseva,naggaparibbajakasseva,2,1,1,0,21
666494,P5.0991,P5.0991,1,1,0,0,7
666495,vāḷakambalādīnaṃ,valakambaladinam,1,1,0,0,16
666496,titthiyaddhajaṃ,titthiyaddhajam,5,5,0,0,15
666497,tāpasapaṇḍaraṅgādikassa,tapasapandarangadikassa,1,1,0,0,23
666498,pabbājentehi,pabbajentehi,2,2,0,0,12
666499,ācariyupajjhāyabhāvena,acariyupajjhayabhavena,1,1,0,0,22
666500,anārādhakoti,anaradhakoti,2,0,2,0,12
666501,parivāsavattadassanatthaṃ,parivasavattadassanattham,1,1,0,0,25
666502,vattakaraṇavelāyameva,vattakaranavelayameva,1,1,0,0,21
666503,itthipurisadārakadārikādīhi,itthipurisadarakadarikadihi,1,1,0,0,27
666504,nācariyavattaṃ,nacariyavattam,1,1,0,0,14
666505,parivāsavattassa,parivasavattassa,1,1,0,0,16
666506,vesiyāti,vesiyati,2,0,2,0,8
666507,āmisakiñcikkhasampadānādinā,amisakincikkhasampadanadina,1,1,0,0,27
666508,sulabhajjhācārā,sulabhajjhacara,2,2,0,0,15
666509,yobbannappattā,yobbannappatta,1,1,0,0,14
666510,yobbannātītā,yobbannatita,1,1,0,0,12
666511,purisādhippāyāva,purisadhippayava,1,1,0,0,16
666512,pariḷāhavegābhibhūtā,parilahavegabhibhuta,1,1,0,0,20
666513,P5.0992,P5.0992,1,1,0,0,7
666514,samānapabbajjā,samanapabbajja,2,2,0,0,14
666515,vesiyānaṃ,vesiyanam,3,3,0,0,9
666516,kulupako,kulupako,5,5,0,0,8
666517,sinehasanthavajātena,sinehasanthavajatena,1,1,0,0,20
666518,abhiṇhadassanasallāpakāmatāya,abhinhadassanasallapakamataya,1,1,0,0,29
666519,asukavesiyā,asukavesiya,1,1,0,0,11
666520,vesiyādayo,vesiyadayo,1,1,0,0,10
666521,cetiyamahāpāsādapaṭisaṅkharaṇādīni,cetiyamahapasadapatisankharanadini,1,1,0,0,34
666522,khandhakapariyāpannāni,khandhakapariyapannani,1,1,0,0,22
666523,aggisālavattādīni,aggisalavattadini,1,1,0,0,17
666524,ābhisamācārikāni,abhisamacarikani,1,1,0,0,16
666525,ṭhānuppattikavīmaṃsāya,thanuppattikavimamsaya,1,1,0,0,22
666526,uppannapaññāya,uppannapannaya,4,4,0,0,14
666527,sahatthāpi,sahatthapi,1,1,0,0,10
666528,dahara,dahara,3,1,2,0,6
666529,kāretumpi,karetumpi,1,1,0,0,9
666530,samīpeneva,samipeneva,1,1,0,0,10
666531,P5.0993,P5.0993,1,1,0,0,7
666532,pāḷipariyāpuṇane,palipariyapunane,1,1,0,0,16
666533,atthasavane,atthasavane,1,1,0,0,11
666534,lokiyasamādhibhāvanāya,lokiyasamadhibhavanaya,1,1,0,0,22
666535,lokuttaramaggabhāvanāya,lokuttaramaggabhavanaya,1,1,0,0,23
666536,titthāyatanasāmikassa,titthayatanasamikassa,2,2,0,0,21
666537,titthakarassa,titthakarassa,2,2,0,0,13
666538,daḷhaggāhena,dalhaggahena,2,2,0,0,12
666539,ādāyoti,adayoti,2,1,1,0,7
666540,ādāyassā,adayassa,1,1,0,0,8
666541,bhaññamānāya,bhannamanaya,1,1,0,0,12
666542,aparipuṇṇasaṅkappo,aparipunnasankappo,2,2,0,0,18
666543,paggahitacitto,paggahitacitto,2,2,0,0,14
666544,saṅghātanikaṃ,sanghatanikam,4,3,1,0,13
666545,aññatitthiyapubbassa,annatitthiyapubbassa,17,16,1,0,20
666546,anārādhanīyasmiṃ,anaradhaniyasmim,4,2,2,0,16
666547,kāyavacīvikāranibbattakaṃ,kayavacivikaranibbattakam,1,1,0,0,25
666548,anattamanattaṃ,anattamanattam,3,3,0,0,14
666549,attamanattaṃ,attamanattam,3,3,0,0,12
666550,vaṇṇabhaṇane,vannabhanane,10,10,0,0,12
666551,anārādhake,anaradhake,2,2,0,0,10
666552,parivāsavattaṃ,parivasavattam,3,3,0,0,14
666553,apūrake,apurake,1,1,0,0,7
666554,idamacalappamāṇanti,idamacalappamananti,1,1,0,0,19
666555,gāmappavesanā,gamappavesana,3,3,0,0,13
666556,vesiyādigocaratā,vesiyadigocarata,1,1,0,0,16
666557,dakkhatādi,dakkhatadi,2,2,0,0,10
666558,tibbacchandatā,tibbacchandata,3,3,0,0,14
666559,avaṇṇabhaṇane,avannabhanane,9,9,0,0,13
666560,titthiyavattānaṃ,titthiyavattanam,1,1,0,0,16
666561,P5.0994,P5.0994,1,1,0,0,7
666562,bhinnasikkhāya,bhinnasikkhaya,1,1,0,0,14
666563,sikkhāsammuti,sikkhasammuti,7,7,0,0,13
666564,dātabbamatthi,databbamatthi,1,1,0,0,13
666565,dinnaparivāsoyeva,dinnaparivasoyeva,2,2,0,0,17
666566,kuppanasabhāvo,kuppanasabhavo,3,3,0,0,14
666567,pūritavattova,puritavattova,1,1,0,0,13
666568,paripuṇṇaṃyeva,paripunnamyeva,1,1,0,0,14
666569,samūhatāni,samuhatani,2,2,0,0,10
666570,vicikicchāsallaṃ,vicikicchasallam,1,1,0,0,16
666571,titthiyaliṅge,titthiyalinge,2,2,0,0,13
666572,parivāsakiccaṃ,parivasakiccam,1,1,0,0,14
666573,upajjhāyamūlakaṃ,upajjhayamulakam,4,3,1,0,16
666574,vilomā,viloma,2,2,0,0,6
666575,āyattajīvikattā,ayattajivikatta,2,2,0,0,15
666576,bhaṇḍukammāyāti,bhandukammayati,4,1,3,0,15
666577,kesoropanatthaṃ,kesoropanattham,2,2,0,0,15
666578,bhaṇḍukammakathā,bhandukammakatha,1,1,0,0,16
666579,aggiparicaraṇakā,aggiparicaranaka,1,1,0,0,16
666580,kiriyavādinoti,kiriyavadinoti,1,0,1,0,14
666581,P5.0995,P5.0995,1,1,0,0,7
666582,vaṇṇavādinova,vannavadinova,1,1,0,0,13
666583,pañcābādhavatthukathā,pancabadhavatthukatha,3,3,0,0,21
666584,magadhanāmake,magadhanamake,3,3,0,0,13
666585,amanussānañca,amanussananca,2,2,0,0,13
666586,phātippattā,phatippatta,2,2,0,0,11
666587,jīvakakomārabhaccakathā,jivakakomarabhaccakatha,1,1,0,0,23
666588,rattakuṭṭhaṃ,rattakuttham,4,4,0,0,12
666589,kāḷakuṭṭhaṃ,kalakuttham,3,3,0,0,11
666590,kiṭibhadaddukacchuādippabhedampi,kitibhadaddukacchuadippabhedampi,2,2,0,0,32
666591,kuṭṭhamevāti,kutthamevati,3,3,0,0,12
666592,nakhapiṭṭhippamāṇampi,nakhapitthippamanampi,7,5,2,0,21
666593,vaḍḍhanakapakkhe,vaddhanakapakkhe,15,14,1,0,16
666594,nivāsanapārupanehi,nivasanaparupanehi,6,6,0,0,18
666595,pakatipaṭicchanne,pakatipaticchanne,1,1,0,0,17
666596,avaḍḍhanakapakkhe,avaddhanakapakkhe,29,26,3,0,17
666597,nakhapiṭṭhito,nakhapitthito,4,4,0,0,13
666598,khuddakatarampi,khuddakatarampi,2,2,0,0,15
666599,tikicchāpetvā,tikicchapetva,5,5,0,0,13
666600,pakativaṇṇe,pakativanne,5,3,2,0,11
666601,godhāpiṭṭhisadisacuṇṇaokiraṇakasarīrampi,godhapitthisadisacunnaokiranakasarirampi,1,1,0,0,40
666602,medagaṇḍo,medagando,4,4,0,0,9
666603,kolaṭṭhimattakopi,kolatthimattakopi,3,3,0,0,17
666604,kolaṭṭhimatte,kolatthimatte,2,2,0,0,13
666605,P5.0996,P5.0996,1,1,0,0,7
666606,mukhādike,mukhadike,3,3,0,0,9
666607,appaṭicchannaṭṭhāne,appaticchannatthane,7,7,0,0,19
666608,uṇṇigaṇḍā,unniganda,4,4,0,0,9
666609,gothanā,gothana,1,1,0,0,7
666610,gaṇḍāyeva,gandayeva,2,2,0,0,9
666611,khīrapiḷakā,khirapilaka,1,1,0,0,11
666612,yobbannakāle,yobbannakale,2,2,0,0,12
666613,kharapiḷakā,kharapilaka,2,2,0,0,11
666614,gaṇḍasaṅkhyaṃ,gandasankhyam,2,2,0,0,13
666615,sāsapabījakā,sasapabijaka,5,4,1,0,12
666616,kuṭṭhajātikā,kutthajatika,1,1,0,0,12
666617,paggharaṇakaṃ,paggharanakam,2,2,0,0,13
666618,padumapuṇḍarīkapattavaṇṇaṃ,padumapundarikapattavannam,9,5,4,0,26
666619,pittummāro,pittummaro,2,2,0,0,10
666620,yakkhummāro,yakkhummaro,2,2,0,0,11
666621,pubbaverikena,pubbaverikena,3,3,0,0,13
666622,rājabhaṭavatthukathā,rajabhatavatthukatha,3,3,0,0,20
666623,rājabhaṭavatthusmiṃ,rajabhatavatthusmim,1,1,0,0,19
666624,uccinathāti,uccinathati,2,0,2,0,11
666625,pavattāpethāti,pavattapethati,1,1,0,0,14
666626,aḍḍavinicchaye,addavinicchaye,1,1,0,0,14
666627,bhattavetanabhaṭo,bhattavetanabhato,3,3,0,0,17
666628,rājabhaṭoti,rajabhatoti,4,3,1,0,11
666629,puttanattabhātukā,puttanattabhatuka,2,2,0,0,17
666630,P5.0997,P5.0997,1,1,0,0,7
666631,māsasaṃvaccharaparibbayaṃ,masasamvaccharaparibbayam,2,2,0,0,25
666632,puttabhātuke,puttabhatuke,2,2,0,0,12
666633,pabbajassūti,pabbajassuti,2,1,1,0,12
666634,coravatthukathā,coravatthukatha,3,3,0,0,15
666635,coravatthūsu,coravatthusu,1,1,0,0,12
666636,ubbijjantipi,ubbijjantipi,6,6,0,0,12
666637,dhajabandho,dhajabandho,12,8,4,0,11
666638,mūladevādayo,muladevadayo,2,2,0,0,12
666639,ambalabujādicorakā,ambalabujadicoraka,3,3,0,0,18
666640,sandhicchedādicorā,sandhicchedadicora,2,2,0,0,18
666641,aṭṭabandhanādiṃ,attabandhanadim,1,1,0,0,15
666642,abhayūvarāti,abhayuvarati,1,0,1,0,12
666643,uparamantīti,uparamantiti,2,1,1,0,12
666644,bhayūvarā,bhayuvara,1,1,0,0,9
666645,laddhābhayattā,laddhabhayatta,1,1,0,0,14
666646,bhayūvarāti,bhayuvarati,1,1,0,0,11
666647,abhayūvarā,abhayuvara,5,4,1,0,10
666648,andubandhanaṃ,andubandhanam,6,6,0,0,13
666649,P5.0998,P5.0998,1,1,0,0,7
666650,gāmabandhanaṃ,gamabandhanam,3,3,0,0,13
666651,nigamabandhanaṃ,nigamabandhanam,3,3,0,0,15
666652,nagarabandhanaṃ,nagarabandhanam,3,3,0,0,15
666653,purisagutti,purisagutti,3,3,0,0,11
666654,janapadabandhanaṃ,janapadabandhanam,3,3,0,0,17
666655,dīpabandhanaṃ,dipabandhanam,6,6,0,0,13
666656,passamānānaṃ,passamananam,2,2,0,0,12
666657,apassamānānaṃ,apassamananam,8,5,3,0,13
666658,kārabhedakoti,karabhedakoti,3,1,2,0,13
666659,dīpantaraṃ,dipantaram,6,5,1,0,10
666660,apalāyanto,apalayanto,2,2,0,0,10
666661,rājayuttādīhi,rajayuttadihi,2,2,0,0,13
666662,palātopi,palatopi,6,6,0,0,8
666663,gāmanigamapaṭṭanādīni,gamanigamapattanadini,2,2,0,0,21
666664,likhitakoti,likhitakoti,2,0,2,0,11
666665,likhitako,likhitako,15,12,3,0,9
666666,rājāparādhaṃ,rajaparadham,3,3,0,0,12
666667,hatthapādānissa,hatthapadanissa,1,1,0,0,15
666668,chinditabbānī,chinditabbani,3,3,0,0,13
666669,āharāpetabbo,aharapetabbo,6,6,0,0,12
666670,likhāpeti,likhapeti,3,3,0,0,9
666671,kasāhato,kasahato,15,13,2,0,8
666672,katadaṇḍakammoti,katadandakammoti,3,0,3,0,16
666673,vacanapesanādīni,vacanapesanadini,3,3,0,0,16
666674,katadaṇḍakammo,katadandakammo,18,17,1,0,14
666675,addhadaṇḍakādīnaṃ,addhadandakadinam,2,2,0,0,17
666676,allavaṇo,allavano,6,6,0,0,8
666677,nāḷikerapāsāṇādīhi,nalikerapasanadihi,2,2,0,0,18
666678,P5.0999,P5.0999,1,1,0,0,7
666679,gaṇṭhīsu,ganthisu,2,2,0,0,8
666680,lakkhaṇāhato,lakkhanahato,9,8,1,0,12
666681,katadaṇḍakammabhāvo,katadandakammabhavo,3,3,0,0,19
666682,ūruādīsu,uruadisu,4,4,0,0,8
666683,ruḷhā,rulha,3,3,0,0,5
666684,samaparicchedā,samapariccheda,3,3,0,0,14
666685,timaṇḍalavatthassa,timandalavatthassa,2,2,0,0,18
666686,appaṭicchannokāse,appaticchannokase,3,3,0,0,17
666687,iṇāyikavatthukathā,inayikavatthukatha,3,3,0,0,18
666688,iṇāyikoti,inayikoti,2,1,1,0,9
666689,pitipitāmahehi,pitipitamahehi,3,3,0,0,14
666690,āthapetvā,athapetva,2,2,0,0,9
666691,āthapetuṃ,athapetum,1,1,0,0,9
666692,upaṭṭhākassāpi,upatthakassapi,1,1,0,0,14
666693,iṇapalibodhena,inapalibodhena,2,2,0,0,14
666694,pabbājayato,pabbajayato,2,2,0,0,11
666695,iṇasāmikānaṃ,inasamikanam,3,3,0,0,12
666696,iṇasāmiko,inasamiko,6,6,0,0,9
666697,P5.1000,P5.1000,1,1,0,0,7
666698,sahetukasatto,sahetukasatto,1,1,0,0,13
666699,atiārādhako,atiaradhako,2,2,0,0,11
666700,dāsavatthukathā,dasavatthukatha,3,3,0,0,15
666701,jātidāso,jatidaso,1,1,0,0,8
666702,dāsacārittaṃ,dasacarittam,5,2,3,0,12
666703,pabbājetabbā,pabbajetabba,17,17,0,0,12
666704,cārittavasena,carittavasena,7,7,0,0,13
666705,tiroraṭṭhato,tiroratthato,5,5,0,0,12
666706,bhujissamānusakāni,bhujissamanusakani,2,2,0,0,18
666707,antoraṭṭheyeva,antorattheyeva,2,2,0,0,14
666708,vilumpathā,vilumpatha,2,2,0,0,10
666709,mānusakānipi,manusakanipi,2,2,0,0,12
666710,rakkhiyamāno,rakkhiyamano,2,2,0,0,12
666711,P5.1001,P5.1001,1,1,0,0,7
666712,karamarānītake,karamaranitake,2,2,0,0,14
666713,sabbasādhāraṇena,sabbasadharanena,3,2,1,0,16
666714,pabbājetabbova,pabbajetabbova,2,2,0,0,14
666715,ārakkhahetu,arakkhahetu,2,2,0,0,11
666716,hatthiassagomahiṃsagopakādayo,hatthiassagomahimsagopakadayo,2,2,0,0,29
666717,amaccaputtasadisā,amaccaputtasadisa,2,2,0,0,17
666718,bhujissitthiyo,bhujissitthiyo,6,6,0,0,14
666719,bhaṭiputtakagaṇādīnaṃ,bhatiputtakaganadinam,2,1,1,0,21
666720,adinnā,adinna,9,4,5,0,6
666721,ārāmikadāsā,aramikadasa,2,2,0,0,11
666722,antojātadhanakkītake,antojatadhanakkitake,2,2,0,0,20
666723,āsittakasadisāva,asittakasadisava,6,2,4,0,16
666724,attanovāssa,attanovassa,1,1,0,0,11
666725,vibbhamissati,vibbhamissati,3,3,0,0,13
666726,nissāmikadāso,nissamikadaso,6,2,4,0,13
666727,P5.1002,P5.1002,1,1,0,0,7
666728,sāmikāti,samikati,4,2,2,0,8
666729,vasamānoyeva,vasamanoyeva,2,2,0,0,12
666730,kammārabhaṇḍuvatthādikathā,kammarabhanduvatthadikatha,2,2,0,0,26
666731,para98-9,para98-9,2,2,0,0,8
666732,kammārabhaṇḍūti,kammarabhanduti,4,0,4,0,15
666733,tulādhāramuṇḍako,tuladharamundako,1,1,0,0,16
666734,taruṇadārakoti,tarunadarakoti,1,1,0,0,14
666735,bhaṇḍukammatthāya,bhandukammatthaya,1,1,0,0,17
666736,āpucchanavidhi,apucchanavidhi,2,2,0,0,14
666737,sīmāpariyāpanne,simapariyapanne,3,3,0,0,15
666738,samaṇakaraṇaṃ,samanakaranam,5,4,1,0,13
666739,P5.1003,P5.1003,1,1,0,0,7
666740,āpucchāmā,apucchama,6,6,0,0,9
666741,āpucchāpetuṃ,apucchapetum,3,3,0,0,12
666742,gumbādīni,gumbadini,4,4,0,0,9
666743,āpucchakā,apucchaka,2,2,0,0,9
666744,supabbajitova,supabbajitova,1,1,0,0,13
666745,pabbājentassāpi,pabbajentassapi,2,2,0,0,15
666746,anekabhikkhusahassāvāso,anekabhikkhusahassavaso,2,2,0,0,23
666747,sannipātetumpi,sannipatetumpi,1,1,0,0,14
666748,nadīsamuddādīni,nadisamuddadini,3,2,1,0,15
666749,vibbhantako,vibbhantako,10,9,1,0,11
666750,nigaṇṭhādīsu,niganthadisu,2,2,0,0,12
666751,dvaṅgulakeso,dvangulakeso,4,4,0,0,12
666752,ūnadvaṅgulakeso,unadvangulakeso,2,2,0,0,15
666753,kesacchedanakiccaṃ,kesacchedanakiccam,2,2,0,0,18
666754,dvaṅgulātirittakeso,dvangulatirittakeso,3,2,1,0,19
666755,ekasikhāmattadharopi,ekasikhamattadharopi,3,3,0,0,20
666756,ahivātakarogenāti,ahivatakarogenati,2,0,2,0,17
666757,māribyādhinā,maribyadhina,1,1,0,0,12
666758,tirogāmādigato,tirogamadigato,2,2,0,0,14
666759,pitāputtakā,pitaputtaka,2,2,0,0,11
666760,kākuḍḍepakaṃ,kakuddepakam,4,2,2,0,12
666761,uḍḍāpetvā,uddapetva,2,2,0,0,9
666762,kākuḍḍepako,kakuddepako,2,2,0,0,11
666763,ittaroti,ittaroti,1,0,1,0,8
666764,ogaṇenāti,oganenati,2,0,2,0,9
666765,parihīnagaṇena,parihinaganena,1,1,0,0,14
666766,sattativasso,sattativasso,3,3,0,0,12
666767,navakatarassāpi,navakatarassapi,1,1,0,0,15
666768,vacchāmī,vacchami,9,9,0,0,8
666769,āpucchantenāpi,apucchantenapi,1,1,0,0,14
666770,āpucchāmi,apucchami,3,3,0,0,9
666771,sabbaāpucchanesu,sabbaapucchanesu,3,3,0,0,16
666772,pañcakachakkesu,pancakachakkesu,4,4,0,0,15
666773,P5.1004,P5.1004,1,1,0,0,7
666774,rāhulavatthukathā,rahulavatthukatha,3,3,0,0,17
666775,abhinikkhamanadivasato,abhinikkhamanadivasato,1,1,0,0,22
666776,pavattisavanatthaṃ,pavattisavanattham,1,1,0,0,18
666777,padhānacariyañca,padhanacariyanca,1,1,0,0,16
666778,sambodhiñca,sambodhinca,1,1,0,0,11
666779,dhammacakkappavattanādīni,dhammacakkappavattanadini,1,1,0,0,25
666780,pavattimattampi,pavattimattampi,1,1,0,0,15
666781,ekadivasaṃjātaṃ,ekadivasamjatam,1,1,0,0,15
666782,sambhatesu,sambhatesu,1,1,0,0,10
666783,sabbasassesu,sabbasassesu,2,2,0,0,12
666784,vissaṭṭhakammantesu,vissatthakammantesu,1,1,0,0,19
666785,janapadamanussesu,janapadamanussesu,1,1,0,0,17
666786,thalajajalajapupphesu,thalajajalajapupphesu,1,1,0,0,21
666787,paṭipajjanakkhame,patipajjanakkhame,1,1,0,0,17
666788,pakkamitunti,pakkamitunti,2,2,0,0,12
666789,P5.1005,P5.1005,1,1,0,0,7
666790,dasahīti,dasahiti,8,3,5,0,8
666791,nāgarikadārake,nagarikadarake,1,1,0,0,14
666792,daharatarova,daharatarova,1,1,0,0,12
666793,P5.1006,P5.1006,1,1,0,0,7
666794,vandāpayissāmī,vandapayissami,1,1,0,0,14
666795,tambavaṇṇamudakaṃ,tambavannamudakam,1,1,0,0,17
666796,P5.1007,P5.1007,1,1,0,0,7
666797,piṇḍacāriyavattaṃ,pindacariyavattam,2,1,1,0,17
666798,catubhūmakādīsu,catubhumakadisu,1,1,0,0,15
666799,saṇṭhāpayamāno,santhapayamano,1,1,0,0,14
666800,P5.1008,P5.1008,1,1,0,0,7
666801,dhammapālajātakaṃ,dhammapalajatakam,5,2,3,0,17
666802,sotāpattiphalañca,sotapattiphalanca,17,17,0,0,17
666803,nandarājakumārassa,nandarajakumarassa,1,1,0,0,18
666804,kesavissajjanaṃ,kesavissajjanam,6,2,4,0,15
666805,paṭṭabandho,pattabandho,3,2,1,0,11
666806,gharamaṅgalaṃ,gharamangalam,7,2,5,0,13
666807,chattamaṅgalanti,chattamangalanti,1,1,0,0,16
666808,P5.1009,P5.1009,1,1,0,0,7
666809,savighātakaṃ,savighatakam,3,1,2,0,12
666810,lokuttaradāyajjapaṭilābhāya,lokuttaradayajjapatilabhaya,1,1,0,0,27
666811,garubhāve,garubhave,2,2,0,0,9
666812,upasampadāsadisā,upasampadasadisa,1,1,0,0,16
666813,P5.1010,P5.1010,1,1,0,0,7
666814,saraṇagamanehī,saranagamanehi,1,1,0,0,14
666815,anujānāpetukāmo,anujanapetukamo,2,2,0,0,15
666816,pabbājemī,pabbajemi,4,3,1,0,9
666817,upajjhāyamūlakā,upajjhayamulaka,1,1,0,0,15
666818,upajjhāyova,upajjhayova,4,4,0,0,11
666819,pabbājesī,pabbajesi,12,10,2,0,9
666820,uppannasaṃvegena,uppannasamvegena,2,1,1,0,16
666821,sampaṭicchanapaccayā,sampaticchanapaccaya,1,1,0,0,20
666822,rāhuleti,rahuleti,2,0,2,0,8
666823,nandampi,nandampi,3,3,0,0,8
666824,rāhulampi,rahulampi,3,3,0,0,9
666825,kulavaṃsopi,kulavamsopi,1,1,0,0,11
666826,pacchinno,pacchinno,1,1,0,0,9
666827,anāgāmiphalappatti,anagamiphalappatti,1,1,0,0,18
666828,piyataraputte,piyataraputte,1,1,0,0,13
666829,pabbājiyamāne,pabbajiyamane,3,3,0,0,13
666830,ñātiviyogadukkhaṃ,nativiyogadukkham,2,2,0,0,17
666831,P5.1011,P5.1011,1,1,0,0,7
666832,puttanattakesu,puttanattakesu,1,1,0,0,14
666833,adhivāsessanti,adhivasessanti,1,1,0,0,14
666834,mātāpitūhīti,matapituhiti,3,0,3,0,12
666835,jananijanake,jananijanake,1,1,0,0,12
666836,āpucchitabbāva,apucchitabbava,2,2,0,0,14
666837,āpucchantena,apucchantena,7,7,0,0,12
666838,anuññātomhī,anunnatomhi,3,3,0,0,11
666839,pabbājetukāmā,pabbajetukama,5,5,0,0,13
666840,cittakeḷiyaṃ,cittakeliyam,1,1,0,0,12
666841,cūḷamātādīnaṃ,culamatadinam,3,2,1,0,13
666842,vivādupacchedanatthaṃ,vivadupacchedanattham,2,2,0,0,21
666843,posanakā,posanaka,1,1,0,0,8
666844,āgatāgatakāle,agatagatakale,2,2,0,0,13
666845,imassāpucchanakiccaṃ,imassapucchanakiccam,1,1,0,0,20
666846,P5.1012,P5.1012,1,1,0,0,7
666847,pabbājeyyāthā,pabbajeyyatha,10,10,0,0,13
666848,āgatāgato,agatagato,2,2,0,0,9
666849,ñātakaupaṭṭhākānaṃ,natakaupatthakanam,1,1,0,0,18
666850,ārāmacchedanādīhi,aramacchedanadihi,2,2,0,0,17
666851,coramajjhaṃ,coramajjham,2,2,0,0,11
666852,jīvasseva,jivasseva,1,1,0,0,9
666853,pabbājayitthā,pabbajayittha,2,2,0,0,13
666854,pabbājayimha,pabbajayimha,2,2,0,0,12
666855,puttenā,puttena,2,2,0,0,7
666856,āpucchāpetvā,apucchapetva,2,2,0,0,12
666857,atidūrañce,atidurance,2,2,0,0,10
666858,mahākantāro,mahakantaro,4,3,1,0,11
666859,āpucchissāmā,apucchissama,1,1,0,0,12
666860,yāvatake,yavatake,4,3,1,0,8
666861,sikkhāpadadaṇḍakammavatthukathā,sikkhapadadandakammavatthukatha,3,3,0,0,31
666862,nāsanavatthu,nasanavatthu,1,1,0,0,12
666863,P5.1013,P5.1013,1,1,0,0,7
666864,daṇḍakammavatthu,dandakammavatthu,4,4,0,0,16
666865,visabhāgajīvikāti,visabhagajivikati,1,1,0,0,17
666866,avāsāyāti,avasayati,2,0,2,0,9
666867,bhedetīti,bhedetiti,2,0,2,0,9
666868,pattasenāsanañca,pattasenasananca,5,3,2,0,16
666869,mukhadvārikaṃ,mukhadvarikam,8,3,5,0,13
666870,mukhadvāriko,mukhadvariko,4,3,1,0,12
666871,nikkhipatopi,nikkhipatopi,2,2,0,0,12
666872,dubbacasāmaṇerassa,dubbacasamanerassa,4,4,0,0,18
666873,āvaraṇameva,avaranameva,4,4,0,0,11
666874,udakadāruvālikādīnaṃ,udakadaruvalikadinam,2,2,0,0,20
666875,āharāpanampi,aharapanampi,2,2,0,0,12
666876,vibbhamissatī,vibbhamissati,4,4,0,0,13
666877,pāpajjhāsayena,papajjhasayena,3,3,0,0,14
666878,pāsāṇiṭṭhakādīni,pasanitthakadini,2,2,0,0,16
666879,anāpucchāvaraṇavatthuādikathā,anapucchavaranavatthuadikatha,3,3,0,0,29
666880,daṇḍakammamassa,dandakammamassa,4,2,2,0,15
666881,saddhivihārikantevāsikānampi,saddhiviharikantevasikanampi,2,2,0,0,28
666882,apalāḷentīti,apalalentiti,2,0,2,0,12
666883,P5.1014,P5.1014,1,1,0,0,7
666884,upaṭṭhānakaraṇatthaṃ,upatthanakaranattham,2,2,0,0,20
666885,apalāḷetabbāti,apalaletabbati,2,0,2,0,14
666886,dussīlabhikkhussāpi,dussilabhikkhussapi,1,1,0,0,19
666887,parisabhūte,parisabhute,3,3,0,0,11
666888,gūthamakkhanaṃ,guthamakkhanam,3,3,0,0,14
666889,kaṇṭakasikkhāpadavaṇṇanāyaṃ,kantakasikkhapadavannanayam,1,1,0,0,27
666890,nāsanāsu,nasanasu,4,4,0,0,8
666891,liṅganāsanāva,linganasanava,1,1,0,0,13
666892,nānāāpattiyo,nanaapattiyo,2,2,0,0,12
666893,maṅguraṇḍakampi,mangurandakampi,1,1,0,0,15
666894,nāsetabbataṃyeva,nasetabbatamyeva,2,2,0,0,16
666895,upajjhāyaggahaṇañca,upajjhayaggahananca,2,2,0,0,19
666896,saṅghalābhaṃ,sanghalabham,2,2,0,0,12
666897,ākiṇṇadosova,akinnadosova,4,2,2,0,12
666898,nikkaḍḍhitabbo,nikkaddhitabbo,3,3,0,0,14
666899,liṅganāsanakiccaṃ,linganasanakiccam,2,2,0,0,17
666900,yathānivatthapārutasseva,yathanivatthaparutasseva,3,3,0,0,24
666901,sāmaṇerānañhi,samanerananhi,2,2,0,0,13
666902,upasampadakammavācāsadisaṃ,upasampadakammavacasadisam,3,2,1,0,26
666903,tiṇasalākamattenāpi,tinasalakamattenapi,2,2,0,0,19
666904,abrahmacariye,abrahmacariye,2,2,0,0,13
666905,hassādhippāyatāyapi,hassadhippayatayapi,1,1,0,0,19
666906,nāsetabbataṃ,nasetabbatam,2,2,0,0,12
666907,P5.1015,P5.1015,1,1,0,0,7
666908,adinnepi,adinnepi,7,7,0,0,8
666909,sammāsambuddhotiādīnaṃ,sammasambuddhotiadinam,1,1,0,0,22
666910,svākkhātotiādīnaṃ,svakkhatotiadinam,1,1,0,0,17
666911,ācariyupajjhāyādīhi,acariyupajjhayadihi,3,3,0,0,19
666912,kaṇṭakanāsanāya,kantakanasanaya,4,4,0,0,15
666913,micchādiṭṭhikepi,micchaditthikepi,2,2,0,0,16
666914,sassatucchedānañhi,sassatucchedananhi,4,2,2,0,18
666915,aññataradiṭṭhiko,annataraditthiko,5,3,2,0,16
666916,ācariyādīhi,acariyadihi,3,3,0,0,11
666917,appaṭinissajjantova,appatinissajjantova,1,1,0,0,19
666918,abrahmacāriggahaṇena,abrahmacariggahanena,2,2,0,0,20
666919,ṭhātukāmaṃ,thatukamam,2,2,0,0,10
666920,upasampadanti,upasampadanti,3,3,0,0,13
666921,paṇḍakavatthukathā,pandakavatthukatha,2,2,0,0,18
666922,dahareti,dahareti,1,0,1,0,8
666923,moḷigalleti,moligalleti,2,1,1,0,11
666924,thūlasarīre,thulasarire,2,2,0,0,11
666925,assabhaṇḍeti,assabhandeti,1,0,1,0,12
666926,usūyapaṇḍako,usuyapandako,9,7,2,0,12
666927,napuṃsakapaṇḍakoti,napumsakapandakoti,6,5,1,0,18
666928,P5.1016,P5.1016,1,1,0,0,7
666929,usūyapaṇḍakassa,usuyapandakassa,3,3,0,0,15
666930,tasmiṃyevassa,tasmimyevassa,6,4,2,0,13
666931,liṅganāsaneneva,linganasaneneva,2,2,0,0,15
666932,vuttesupi,vuttesupi,5,5,0,0,9
666933,paṇḍavatthukathā,pandavatthukatha,1,1,0,0,16
666934,theyyasaṃvāsakavatthukathā,theyyasamvasakavatthukatha,3,3,0,0,26
666935,purāṇakulaputtoti,puranakulaputtoti,1,0,1,0,17
666936,mātipakkhapitipakkhato,matipakkhapitipakkhato,2,2,0,0,22
666937,kolaññā,kolanna,3,3,0,0,7
666938,khīṇakolañño,khinakolanno,4,3,1,0,12
666939,phātiṃkātuṃ,phatimkatum,1,0,1,0,11
666940,anuyuñjiyamānoti,anuyunjiyamanoti,5,0,5,0,16
666941,kesamassuoropanakāsāyapaṭiggahaṇasaraṇagamanaupajjhāyaggahaṇakammavācānissayadhamme,kesamassuoropanakasayapatiggahanasaranagamanaupajjhayaggahanakammavacanissayadhamme,1,1,0,0,83
666942,theyyasaṃvāsakā,theyyasamvasaka,7,3,4,0,15
666943,ubhayatthenakoti,ubhayatthenakoti,4,4,0,0,16
666944,bhikkhuvassāni,bhikkhuvassani,20,19,1,0,14
666945,liṅgamattasseva,lingamattasseva,3,3,0,0,15
666946,P5.1017,P5.1017,1,1,0,0,7
666947,saṃvāsamattasseva,samvasamattasseva,6,6,0,0,17
666948,bhikkhuvassagaṇanādiko,bhikkhuvassagananadiko,8,7,1,0,22
666949,kiriyabhedo,kiriyabhedo,9,9,0,0,11
666950,paṭipajjantepi,patipajjantepi,5,5,0,0,14
666951,rājadubbhikkhakantārarogaveribhayehi,rajadubbhikkhakantararogaveribhayehi,3,2,1,0,36
666952,cīvarāharaṇatthaṃ,civaraharanattham,10,8,2,0,17
666953,ādiyatīdha,adiyatidha,4,4,0,0,10
666954,anosaritvāva,anosaritvava,15,15,0,0,12
666955,pabbajitālayaṃ,pabbajitalayam,6,5,1,0,14
666956,vassagaṇanādibhedaṃ,vassagananadibhedam,15,15,0,0,19
666957,sabbapāsaṇḍiyabhattāni,sabbapasandiyabhattani,12,10,2,0,22
666958,P5.1018,P5.1018,1,1,0,0,7
666959,nittharitukāmo,nittharitukamo,3,3,0,0,14
666960,rogabhaye,rogabhaye,6,5,1,0,9
666961,veribhayaṃ,veribhayam,3,3,0,0,10
666962,kāyaparihāriyāni,kayaparihariyani,4,3,1,0,16
666963,abbhuggacchanti,abbhuggacchanti,3,3,0,0,15
666964,muñcissāmā,muncissama,3,3,0,0,10
666965,hīnāyāvattabhāvaṃ,hinayavattabhavam,4,3,1,0,17
666966,mahāsāmaṇero,mahasamanero,5,5,0,0,12
666967,kammantānuṭṭhānena,kammantanutthanena,2,2,0,0,18
666968,uppabbajitabhāvaṃ,uppabbajitabhavam,2,2,0,0,17
666969,sāmaṇerabhāvaṃ,samanerabhavam,11,10,1,0,14
666970,theyyasaṃvāsakoyeva,theyyasamvasakoyeva,2,2,0,0,19
666971,liṅgaggahaṇakāle,lingaggahanakale,2,2,0,0,16
666972,P5.1019,P5.1019,1,1,0,0,7
666973,nācikkhissāmī,nacikkhissami,2,2,0,0,13
666974,theyyasaṃvāsakova,theyyasamvasakova,2,2,0,0,17
666975,vacchakarakkhaṇādīni,vacchakarakkhanadini,1,1,0,0,20
666976,anupasampannakāleyeva,anupasampannakaleyeva,3,3,0,0,21
666977,pabbajjāmattaṃ,pabbajjamattam,6,6,0,0,14
666978,kāsāye,kasaye,16,14,2,0,6
666979,P5.1020,P5.1020,1,1,0,0,7
666980,methunādiassamaṇakaraṇadhammaṃ,methunadiassamanakaranadhammam,2,2,0,0,30
666981,odātanivattho,odatanivattho,1,1,0,0,13
666982,methunasevanādīhi,methunasevanadihi,3,3,0,0,17
666983,gihinivāsanena,gihinivasanena,3,3,0,0,14
666984,vīmaṃsanasampaṭicchanesupi,vimamsanasampaticchanesupi,5,5,0,0,26
666985,nivatthakāsāyassa,nivatthakasayassa,3,3,0,0,17
666986,gihinivāsanaṃ,gihinivasanam,4,4,0,0,13
666987,vīmaṃsatu,vimamsatu,2,2,0,0,9
666988,ekapassenāgantvā,ekapassenagantva,1,1,0,0,16
666989,mahāpeḷādīsu,mahapeladisu,3,3,0,0,12
666990,sāmaṇerapaṭipāṭiyā,samanerapatipatiya,4,3,1,0,18
666991,bhikkhupaṭipāṭiyā,bhikkhupatipatiya,3,3,0,0,17
666992,titthiyapakkantakakathā,titthiyapakkantakakatha,5,5,0,0,23
666993,P5.1021,P5.1021,1,1,0,0,7
666994,pabbājetabbopi,pabbajetabbopi,1,1,0,0,14
666995,ādinnamatte,adinnamatte,8,6,2,0,11
666996,kusacīrādīni,kusaciradini,17,16,1,0,12
666997,ājīvakabhāvo,ajivakabhavo,2,2,0,0,12
666998,atidukkhā,atidukkha,3,3,0,0,9
666999,nivattantopi,nivattantopi,4,4,0,0,12
667000,kesamassuluñcanādīnī,kesamassuluncanadini,2,2,0,0,20
667001,ekakesampi,ekakesampi,3,3,0,0,10
667002,luñcāpeti,luncapeti,4,4,0,0,9
667003,ukkuṭikappadhānādīni,ukkutikappadhanadini,4,4,0,0,20
667004,morapiñchādīni,morapinchadini,3,3,0,0,14
667005,titthiyapabbajjā,titthiyapabbajja,3,3,0,0,16
667006,rājabhayādīhi,rajabhayadihi,15,15,0,0,13
667007,titthiyaliṅgaṃ,titthiyalingam,6,6,0,0,14
667008,upasampannabhikkhunā,upasampannabhikkhuna,8,4,4,0,20
667009,kūṭavassaṃ,kutavassam,5,4,1,0,10
667010,gaṇentopi,ganentopi,6,6,0,0,9
667011,bhikkhuvassādīni,bhikkhuvassadini,3,3,0,0,16
667012,tiracchānagatavatthukathā,tiracchanagatavatthukatha,2,2,0,0,25
667013,P5.1022,P5.1022,1,1,0,0,7
667014,akusalavipākapaṭisandhikassa,akusalavipakapatisandhikassa,1,1,0,0,28
667015,nāgasarīraṃ,nagasariram,2,2,0,0,11
667016,udakasañcārikaṃ,udakasancarikam,2,2,0,0,15
667017,maṇḍūkabhakkhaṃ,mandukabhakkham,2,2,0,0,15
667018,nikkhamaneti,nikkhamaneti,2,2,0,0,12
667019,vissarabhayena,vissarabhayena,1,1,0,0,14
667020,avissajjitvā,avissajjitva,5,5,0,0,12
667021,kapimiddhavaseneva,kapimiddhavaseneva,1,1,0,0,18
667022,khotthāti,khotthati,2,0,2,0,9
667023,jhānavipassanāmaggaphalānaṃ,jhanavipassanamaggaphalanam,1,1,0,0,27
667024,viruḷhidhammā,virulhidhamma,1,1,0,0,13
667025,sajātiyāti,sajatiyati,3,0,3,0,10
667026,manussitthiādibhedāya,manussitthiadibhedaya,1,1,0,0,21
667027,tacajahanakāle,tacajahanakale,1,1,0,0,14
667028,vissaṭṭhaniddokkamanakāle,vissatthaniddokkamanakale,1,1,0,0,25
667029,upasampannopi,upasampannopi,4,4,0,0,13
667030,mātughātakādivatthukathā,matughatakadivatthukatha,3,3,0,0,24
667031,mātughātakādivatthūsu,matughatakadivatthusu,2,2,0,0,21
667032,apavāhanaṃ,apavahanam,5,1,4,0,10
667033,P5.1023,P5.1023,1,1,0,0,7
667034,manussajātikeneva,manussajatikeneva,7,7,0,0,17
667035,ānantariyena,anantariyena,15,13,2,0,12
667036,mātughātakakammena,matughatakakammena,6,4,2,0,18
667037,posāvanikā,posavanika,4,3,1,0,10
667038,pitughātakotveva,pitughatakotveva,3,3,0,0,16
667039,arahantaghātakopi,arahantaghatakopi,4,3,1,0,17
667040,manussaarahantavaseneva,manussaarahantavaseneva,4,4,0,0,23
667041,manussajātiyañhi,manussajatiyanhi,3,3,0,0,16
667042,apabbajitampi,apabbajitampi,3,3,0,0,13
667043,arahantaghātakova,arahantaghatakova,4,4,0,0,17
667044,amanussajātikaṃ,amanussajatikam,4,4,0,0,15
667045,manussajātikaṃ,manussajatikam,9,9,0,0,14
667046,ānantariyo,anantariyo,7,6,1,0,10
667047,manussaarahantampi,manussaarahantampi,4,4,0,0,18
667048,onīyantīti,oniyantiti,2,0,2,0,10
667049,onīyanti,oniyanti,1,1,0,0,8
667050,pakatattaṃ,pakatattam,37,35,2,0,10
667051,odātavatthavasanaṃ,odatavatthavasanam,11,11,0,0,18
667052,P5.1024,P5.1024,1,1,0,0,7
667053,dūsentopi,dusentopi,4,4,0,0,9
667054,bhikkhunidūsakoyeva,bhikkhunidusakoyeva,3,3,0,0,19
667055,sampaṭicchitamatteyeva,sampaticchitamatteyeva,3,3,0,0,22
667056,abhikkhunī,abhikkhuni,14,14,0,0,10
667057,sīlavipannaṃ,silavipannam,4,4,0,0,12
667058,vippaṭipajjanto,vippatipajjanto,6,6,0,0,15
667059,pivanakamattampi,pivanakamattampi,2,2,0,0,16
667060,ubhatobyañjanakavatthukathā,ubhatobyanjanakavatthukatha,2,2,0,0,27
667061,itthinimittuppādanakammato,itthinimittuppadanakammato,5,5,0,0,26
667062,purisanimittuppādanakammato,purisanimittuppadanakammato,4,4,0,0,27
667063,purisaubhatobyañjanakoti,purisaubhatobyanjanakoti,3,3,0,0,24
667064,P5.1025,P5.1025,1,1,0,0,7
667065,vicāraṇakkamo,vicaranakkamo,3,2,1,0,13
667066,ubhatobyajjanakavatthukathā,ubhatobyajjanakavatthukatha,1,1,0,0,27
667067,anupajjhāyakādivatthukathā,anupajjhayakadivatthukatha,3,3,0,0,26
667068,agāhāpetvā,agahapetva,7,7,0,0,10
667069,upajjhāyavirahitaṃ,upajjhayavirahitam,6,6,0,0,18
667070,āmisato,amisato,2,2,0,0,7
667071,anupajjhāyakoti,anupajjhayakoti,3,0,3,0,15
667072,nirupajjhāyako,nirupajjhayako,2,2,0,0,14
667073,sikkhāpadapaññattito,sikkhapadapannattito,7,7,0,0,20
667074,upajjhāyenātiādīsupi,upajjhayenatiadisupi,1,0,1,0,20
667075,ubhatobyañjanakupajjhāyapariyosānesu,ubhatobyanjanakupajjhayapariyosanesu,2,2,0,0,36
667076,apattakādivatthukathā,apattakadivatthukatha,3,3,0,0,21
667077,ājīvakanāmakā,ajivakanamaka,3,3,0,0,13
667078,ṭhapitapiṇḍameva,thapitapindameva,2,2,0,0,16
667079,upasampādentasseva,upasampadentasseva,5,5,0,0,18
667080,acīvarakādi,acivarakadi,1,0,1,0,11
667081,yācitakenāti,yacitakenati,4,0,4,0,12
667082,tāvakālikenāti,tavakalikenati,2,2,0,0,14
667083,paripuṇṇapattacīvarova,paripunnapattacivarova,3,3,0,0,22
667084,nirapekkhehi,nirapekkhehi,4,4,0,0,12
667085,yācitakenāpi,yacitakenapi,2,2,0,0,12
667086,P5.1026,P5.1026,1,1,0,0,7
667087,cīvarūpagāni,civarupagani,2,2,0,0,12
667088,anāmaṭṭhapiṇḍapātaṃ,anamatthapindapatam,6,2,4,0,19
667089,sāmaṇerabhāgasamako,samanerabhagasamako,4,2,2,0,19
667090,āmisabhāgo,amisabhago,2,2,0,0,10
667091,salākabhattauddesabhattanimantanādīni,salakabhattauddesabhattanimantanadini,2,2,0,0,37
667092,sāmaṇerabhāgasamo,samanerabhagasamo,2,2,0,0,17
667093,telamadhuphāṇitādibhesajjabhāgo,telamadhuphanitadibhesajjabhago,1,1,0,0,31
667094,bhesajjamassa,bhesajjamassa,2,2,0,0,13
667095,paṭijagganakammanti,patijagganakammanti,1,1,0,0,19
667096,hatthacchinnādivatthukathā,hatthacchinnadivatthukatha,3,3,0,0,26
667097,hatthacchinnādivatthūsu,hatthacchinnadivatthusu,3,3,0,0,23
667098,hatthacchinnoti,hatthacchinnoti,2,0,2,0,15
667099,maṇibandhe,manibandhe,3,3,0,0,10
667100,pādacchinnoti,padacchinnoti,2,0,2,0,13
667101,hatthapādacchinnoti,hatthapadacchinnoti,2,0,2,0,19
667102,kaṇṇacchinnoti,kannacchinnoti,2,0,2,0,14
667103,kaṇṇasakkhalikāya,kannasakkhalikaya,3,3,0,0,17
667104,kaṇṇāviddhe,kannaviddhe,1,1,0,0,11
667105,saṅghāṭetuṃ,sanghatetum,4,3,1,0,11
667106,nāsacchinnoti,nasacchinnoti,2,0,2,0,13
667107,ajapadake,ajapadake,3,3,0,0,9
667108,ekapuṭe,ekapute,3,3,0,0,7
667109,sandhetuṃ,sandhetum,5,3,2,0,9
667110,aṅgulicchinnoti,angulicchinnoti,2,0,2,0,15
667111,nakhasesaṃ,nakhasesam,8,7,1,0,10
667112,suttatantumattampi,suttatantumattampi,5,5,0,0,18
667113,aṅguṭṭhakesu,angutthakesu,3,3,0,0,12
667114,phaṇahatthakoti,phanahatthakoti,2,0,2,0,15
667115,P5.1027,P5.1027,1,1,0,0,7
667116,vaggulipakkhakā,vaggulipakkhaka,4,4,0,0,15
667117,pabbājetukāmena,pabbajetukamena,6,6,0,0,15
667118,aṅgulantarikāyo,angulantarikayo,3,3,0,0,15
667119,antaracammaṃ,antaracammam,3,3,0,0,12
667120,adhikaaṅguliṃ,adhikaangulim,1,1,0,0,13
667121,khujjoti,khujjoti,5,2,3,0,8
667122,passassa,passassa,5,5,0,0,8
667123,khujjasarīro,khujjasariro,4,4,0,0,12
667124,akhujjo,akhujjo,3,3,0,0,7
667125,vāmanoti,vamanoti,2,0,2,0,8
667126,jaṅghavāmano,janghavamano,3,3,0,0,12
667127,kaṭivāmano,kativamano,3,3,0,0,10
667128,ubhayavāmano,ubhayavamano,4,4,0,0,12
667129,jaṅghavāmanassa,janghavamanassa,4,3,1,0,15
667130,kaṭivāmanassa,kativamanassa,3,3,0,0,13
667131,ubhayavāmanassa,ubhayavamanassa,3,3,0,0,15
667132,mahākucchighaṭasadiso,mahakucchighatasadiso,4,3,1,0,21
667133,galagaṇḍīti,galaganditi,5,1,4,0,11
667134,kumbhaṇḍaṃ,kumbhandam,5,4,1,0,10
667135,lakkhaṇāhatakasāhatalikhitakesu,lakkhanahatakasahatalikhitakesu,2,0,2,0,31
667136,sīpadīti,sipaditi,2,0,2,0,8
667137,bhārapādo,bharapado,4,3,1,0,9
667138,sañjātapiḷako,sanjatapilako,1,1,0,0,13
667139,kharabhāvaṃ,kharabhavam,4,4,0,0,11
667140,udakaāvāṭe,udakaavate,3,3,0,0,10
667141,udakavālikāya,udakavalikaya,3,3,0,0,13
667142,milāpetuṃ,milapetum,3,3,0,0,9
667143,upasampādentenāpi,upasampadentenapi,2,2,0,0,17
667144,pāparogīti,paparogiti,4,1,3,0,10
667145,arisabhagandarapittasemhakāsasosādīsu,arisabhagandarapittasemhakasasosadisu,3,3,0,0,37
667146,atekiccharogo,atekiccharogo,3,3,0,0,13
667147,parisadūsakoti,parisadusakoti,2,0,2,0,14
667148,virūpatāya,virupataya,3,3,0,0,10
667149,sīsappamāṇanābhippadeso,sisappamananabhippadeso,3,3,0,0,23
667150,atirasso,atirasso,4,4,0,0,8
667151,ubhayavāmanabhūtarūpaṃ,ubhayavamanabhutarupam,2,2,0,0,22
667152,P5.1028,P5.1028,1,1,0,0,7
667153,atikāḷo,atikalo,3,2,1,0,7
667154,jhāpitakhette,jhapitakhette,2,2,0,0,13
667155,accodāto,accodato,3,3,0,0,8
667156,dadhitakkādīhi,dadhitakkadihi,4,4,0,0,14
667157,pamajjitamaṭṭhatambalohavaṇṇo,pamajjitamatthatambalohavanno,1,1,0,0,29
667158,atikiso,atikiso,2,2,0,0,7
667159,mandamaṃsalohito,mandamamsalohito,3,3,0,0,16
667160,aṭṭhisirācammasarīro,atthisiracammasariro,3,3,0,0,20
667161,atithūlo,atithulo,4,3,1,0,8
667162,bhāriyamaṃso,bhariyamamso,3,3,0,0,12
667163,mahābhūtasadiso,mahabhutasadiso,3,3,0,0,15
667164,atimahantasīso,atimahantasiso,1,1,0,0,14
667165,atikhuddakasīso,atikhuddakasiso,3,3,0,0,15
667166,ananurūpena,ananurupena,5,5,0,0,11
667167,kūṭakūṭasīso,kutakutasiso,2,2,0,0,12
667168,tālaphalapiṇḍisadisena,talaphalapindisadisena,3,3,0,0,22
667169,sikharasīso,sikharasiso,2,2,0,0,11
667170,anupubbatanukena,anupubbatanukena,5,3,2,0,16
667171,nāḷisīso,nalisiso,5,3,2,0,8
667172,mahāveḷupabbasadisena,mahavelupabbasadisena,3,3,0,0,21
667173,kappasīso,kappasiso,4,3,1,0,9
667174,pabbhārasīso,pabbharasiso,4,3,1,0,12
667175,oṇatena,onatena,2,2,0,0,7
667176,vaṇasīso,vanasiso,2,2,0,0,8
667177,pūtisīso,putisiso,2,2,0,0,8
667178,kaṇṇikakeso,kannikakeso,7,3,4,0,11
667179,khāyitakedāre,khayitakedare,3,3,0,0,13
667180,sassasadisehi,sassasadisehi,3,3,0,0,13
667181,nillomasīso,nillomasiso,3,2,1,0,11
667182,thūlathaddhakeso,thulathaddhakeso,2,2,0,0,16
667183,tālahīrasadisehi,talahirasadisehi,3,3,0,0,16
667184,jātipalitehi,jatipalitehi,2,2,0,0,12
667185,pakatitambakeso,pakatitambakeso,2,2,0,0,15
667186,āvaṭṭasīso,avattasiso,3,3,0,0,10
667187,āvaṭṭasadisehi,avattasadisehi,3,3,0,0,14
667188,kesāvaṭṭehi,kesavattehi,3,3,0,0,11
667189,sīsalomehi,sisalomehi,3,3,0,0,10
667190,ekābaddhabhamukalomo,ekabaddhabhamukalomo,2,2,0,0,20
667191,jālabaddhena,jalabaddhena,3,2,1,0,12
667192,sambaddhabhamuko,sambaddhabhamuko,5,3,2,0,16
667193,nillomabhamuko,nillomabhamuko,2,2,0,0,14
667194,makkaṭabhamuko,makkatabhamuko,4,4,0,0,14
667195,atimahantakkhi,atimahantakkhi,2,2,0,0,14
667196,atikhuddakakkhi,atikhuddakakkhi,2,2,0,0,15
667197,vāsikoṇena,vasikonena,3,3,0,0,10
667198,katachiddasadisehi,katachiddasadisehi,3,3,0,0,18
667199,visamakkhi,visamakkhi,2,2,0,0,10
667200,visamacakkalo,visamacakkalo,3,3,0,0,13
667201,visamajātehi,visamajatehi,3,3,0,0,12
667202,akkhicakkalehi,akkhicakkalehi,1,1,0,0,14
667203,gambhīrakkhi,gambhirakkhi,2,2,0,0,12
667204,udakatārakā,udakataraka,10,8,2,0,11
667205,nikkhantakkhi,nikkhantakkhi,2,2,0,0,13
667206,kakkaṭakasseva,kakkatakasseva,2,2,0,0,14
667207,hatthikaṇṇo,hatthikanno,2,2,0,0,11
667208,kaṇṇasakkhalikāhi,kannasakkhalikahi,3,3,0,0,17
667209,mūsikakaṇṇo,musikakanno,3,2,1,0,11
667210,jaṭukakaṇṇo,jatukakanno,1,1,0,0,11
667211,khuddikāhi,khuddikahi,1,1,0,0,10
667212,chiddamattakaṇṇo,chiddamattakanno,2,2,0,0,16
667213,P5.1029,P5.1029,1,1,0,0,7
667214,yonakajātiko,yonakajatiko,2,2,0,0,12
667215,parisadūsako,parisadusako,15,14,1,0,12
667216,kaṇṇabhagandariko,kannabhagandariko,4,4,0,0,17
667217,niccapūtinā,niccaputina,3,3,0,0,11
667218,gaṇḍakaṇṇo,gandakanno,3,2,1,0,10
667219,sadāpaggharitapubbena,sadapaggharitapubbena,1,1,0,0,21
667220,ṭaṅkitakaṇṇo,tankitakanno,5,3,2,0,12
667221,gobhattanāḷikāya,gobhattanalikaya,3,3,0,0,16
667222,aggasadisehi,aggasadisehi,3,3,0,0,12
667223,atipiṅgalakkhi,atipingalakkhi,4,2,2,0,14
667224,madhupiṅgalaṃ,madhupingalam,5,3,2,0,13
667225,nippakhumakkhi,nippakhumakkhi,7,6,1,0,14
667226,assupaggharaṇakkhi,assupaggharanakkhi,3,2,1,0,18
667227,pupphitakkhi,pupphitakkhi,3,2,1,0,12
667228,akkhipākena,akkhipakena,2,2,0,0,11
667229,atimahantanāsiko,atimahantanasiko,2,2,0,0,16
667230,atikhuddakanāsiko,atikhuddakanasiko,3,3,0,0,17
667231,cipiṭanāsiko,cipitanasiko,2,2,0,0,12
667232,ṭhitavaṅkanāsiko,thitavankanasiko,2,2,0,0,16
667233,sukatuṇḍasadisāya,sukatundasadisaya,3,3,0,0,17
667234,lehituṃ,lehitum,3,3,0,0,7
667235,sakkuṇeyyāya,sakkuneyyaya,3,3,0,0,12
667236,niccapaggharitasiṅghāṇikanāso,niccapaggharitasinghanikanaso,2,2,0,0,29
667237,mahāmukho,mahamukho,3,3,0,0,9
667238,paṭaṅgamaṇḍūkasseva,patangamandukasseva,2,2,0,0,19
667239,mukhanimittaṃyeva,mukhanimittamyeva,3,3,0,0,17
667240,lābusadisaṃ,labusadisam,3,3,0,0,11
667241,bhinnamukho,bhinnamukho,5,4,1,0,11
667242,vaṅkamukho,vankamukho,4,4,0,0,10
667243,mahāoṭṭho,mahaottho,2,2,0,0,9
667244,ukkhalimukhavaṭṭisadisehi,ukkhalimukhavattisadisehi,3,3,0,0,25
667245,tanukaoṭṭho,tanukaottho,5,3,2,0,11
667246,bhericammasadisehi,bhericammasadisehi,3,3,0,0,18
667247,asamatthehi,asamatthehi,4,4,0,0,11
667248,mahādharoṭṭho,mahadharottho,3,3,0,0,13
667249,tanukauttaroṭṭho,tanukauttarottho,3,3,0,0,16
667250,tanukaadharoṭṭho,tanukaadharottho,3,3,0,0,16
667251,mahāuttaroṭṭho,mahauttarottho,3,3,0,0,14
667252,oṭṭhachinnako,otthachinnako,2,2,0,0,13
667253,eḷamukho,elamukho,3,3,0,0,8
667254,uppakkamukho,uppakkamukho,4,4,0,0,12
667255,saṅkhatuṇḍako,sankhatundako,3,3,0,0,13
667256,bahisetehi,bahisetehi,1,1,0,0,10
667257,atirattehi,atirattehi,3,3,0,0,10
667258,duggandhakuṇapamukho,duggandhakunapamukho,3,3,0,0,20
667259,aṭṭhakadantasadisehi,atthakadantasadisehi,3,3,0,0,20
667260,asuradanto,asuradanto,2,2,0,0,10
667261,bahinikkhantadanto,bahinikkhantadanto,1,1,0,0,18
667262,pūtidanto,putidanto,3,3,0,0,9
667263,niddanto,niddanto,2,2,0,0,8
667264,kalandakadanto,kalandakadanto,3,2,1,0,14
667265,sukhumadanto,sukhumadanto,2,2,0,0,12
667266,mahāhanuko,mahahanuko,4,4,0,0,10
667267,gohanusadisena,gohanusadisena,3,3,0,0,14
667268,hanunā,hanuna,6,5,1,0,6
667269,dīghahanuko,dighahanuko,2,2,0,0,11
667270,cipiṭahanuko,cipitahanuko,6,5,1,0,12
667271,atirassena,atirassena,3,3,0,0,10
667272,bhinnahanuko,bhinnahanuko,3,3,0,0,12
667273,vaṅkahanuko,vankahanuko,3,3,0,0,11
667274,nimmassudāṭhiko,nimmassudathiko,5,4,1,0,15
667275,bhikkhunisadisamukho,bhikkhunisadisamukho,2,2,0,0,20
667276,dīghagalo,dighagalo,2,2,0,0,9
667277,bakagalasadisena,bakagalasadisena,3,3,0,0,16
667278,rassagalo,rassagalo,2,2,0,0,9
667279,P5.1030,P5.1030,1,1,0,0,7
667280,bhinnagalo,bhinnagalo,3,3,0,0,10
667281,bhaṭṭhaaṃsakūṭo,bhatthaamsakuto,3,3,0,0,15
667282,ahattho,ahattho,2,2,0,0,7
667283,ekahattho,ekahattho,2,2,0,0,9
667284,atirassahattho,atirassahattho,3,3,0,0,14
667285,atidīghahattho,atidighahattho,3,3,0,0,14
667286,bhinnauro,bhinnauro,2,2,0,0,9
667287,bhinnapiṭṭhi,bhinnapitthi,4,3,1,0,12
667288,kacchugatto,kacchugatto,7,7,0,0,11
667289,kaṇḍugatto,kandugatto,2,2,0,0,10
667290,daddugatto,daddugatto,3,3,0,0,10
667291,godhāgatto,godhagatto,5,4,1,0,10
667292,vitthārikavasena,vittharikavasena,1,1,0,0,16
667293,ābādhehī,abadhehi,1,1,0,0,8
667294,bhaṭṭhakaṭiko,bhatthakatiko,4,4,0,0,13
667295,mahāānisado,mahaanisado,3,3,0,0,11
667296,uddhanakūṭasadisehi,uddhanakutasadisehi,3,3,0,0,19
667297,ānisadamaṃsehi,anisadamamsehi,3,3,0,0,14
667298,mahāūruko,mahauruko,2,2,0,0,9
667299,vātaṇḍiko,vatandiko,5,4,1,0,9
667300,mahājāṇuko,mahajanuko,2,2,0,0,10
667301,saṅghaṭṭanajāṇuko,sanghattanajanuko,3,3,0,0,17
667302,yaṭṭhisadisajaṅgho,yatthisadisajangho,3,3,0,0,18
667303,ubbaddhapiṇḍiko,ubbaddhapindiko,3,3,0,0,15
667304,oruḷhāhi,orulhahi,3,3,0,0,8
667305,āruḷhāhi,arulhahi,3,3,0,0,8
667306,jaṅghapiṇḍikāhi,janghapindikahi,5,5,0,0,15
667307,mahājaṅgho,mahajangho,3,3,0,0,10
667308,thūlajaṅghapiṇḍiko,thulajanghapindiko,3,3,0,0,18
667309,mahāpādo,mahapado,2,2,0,0,8
667310,mahāpaṇhi,mahapanhi,2,2,0,0,9
667311,piṭṭhikapādo,pitthikapado,5,4,1,0,12
667312,pādavemajjhato,padavemajjhato,3,3,0,0,14
667313,uṭṭhitajaṅgho,utthitajangho,3,3,0,0,13
667314,vaṅkapādo,vankapado,5,5,0,0,9
667315,parivattapādo,parivattapado,2,2,0,0,13
667316,gaṇṭhikaṅguli,ganthikanguli,2,2,0,0,13
667317,siṅgiveraphaṇasadisāhi,singiveraphanasadisahi,3,3,0,0,22
667318,kāḷavaṇṇehi,kalavannehi,3,3,0,0,11
667319,pūtinakhehi,putinakhehi,3,3,0,0,11
667320,pasannandho,pasannandho,3,3,0,0,11
667321,dviakkhikāṇo,dviakkhikano,2,2,0,0,12
667322,hatthakuṇī,hatthakuni,3,3,0,0,10
667323,pādakuṇī,padakuni,3,3,0,0,8
667324,aṅgulikuṇī,angulikuni,3,3,0,0,10
667325,natajāṇuko,natajanuko,3,3,0,0,10
667326,bhinnajaṅgho,bhinnajangho,3,3,0,0,12
667327,saṅkuṭitapādattā,sankutitapadatta,3,2,1,0,16
667328,kuṇḍapādako,kundapadako,5,5,0,0,11
667329,piṭṭhipādamajjhena,pitthipadamajjhena,5,5,0,0,18
667330,piṭṭhipādaggena,pitthipadaggena,6,3,3,0,15
667331,aggapādeneva,aggapadeneva,3,3,0,0,12
667332,caṅkamanakhañjo,cankamanakhanjo,15,15,0,0,15
667333,P5.1031,P5.1031,1,1,0,0,7
667334,khañjoyeva,khanjoyeva,2,2,0,0,10
667335,aḍḍhasarīraṃ,addhasariram,2,2,0,0,12
667336,chinniriyāpathoti,chinniriyapathoti,2,0,2,0,17
667337,jarādubbaloti,jaradubbaloti,3,0,3,0,13
667338,cīvararajanādikammaṃ,civararajanadikammam,1,1,0,0,20
667339,mammanampi,mammanampi,3,3,0,0,10
667340,saraṇagamanamattaṃ,saranagamanamattam,3,3,0,0,18
667341,andhamūgā,andhamuga,2,0,2,0,9
667342,ubhayadosavasena,ubhayadosavasena,2,2,0,0,16
667343,paṭikkhittāva,patikkhittava,10,10,0,0,13
667344,hatthacchinnādayo,hatthacchinnadayo,11,11,0,0,17
667345,suosārito,suosarito,1,1,0,0,9
667346,duosārito,duosarito,2,2,0,0,9
667347,alajjīnissayavatthukathā,alajjinissayavatthukatha,3,3,0,0,24
667348,alajjipuggale,alajjipuggale,2,2,0,0,13
667349,bhikkhusabhāgataṃ,bhikkhusabhagatam,12,8,4,0,17
667350,nissayadāyakassa,nissayadayakassa,3,3,0,0,16
667351,lajjibhāvaṃ,lajjibhavam,5,5,0,0,11
667352,vuccamānenāpi,vuccamanenapi,2,2,0,0,13
667353,nissayaggahaṇaṭṭhānaṃ,nissayaggahanatthanam,1,1,0,0,21
667354,P5.1032,P5.1032,1,1,0,0,7
667355,uggatampi,uggatampi,3,3,0,0,9
667356,nissayenā,nissayena,5,4,1,0,9
667357,paṭikkhittakālato,patikkhittakalato,2,2,0,0,17
667358,laddhaparihāro,laddhapariharo,3,3,0,0,14
667359,gamikādinissayavatthukathā,gamikadinissayavatthukatha,3,3,0,0,26
667360,nissayakaraṇīyoti,nissayakaraniyoti,3,0,3,0,17
667361,karaṇīyanissayo,karaniyanissayo,2,2,0,0,15
667362,alabhamānenāti,alabhamanenati,2,0,2,0,14
667363,addhānamaggappaṭipannesu,addhanamaggappatipannesu,3,3,0,0,24
667364,vutthapubbaṃ,vutthapubbam,4,3,1,0,12
667365,yāciyamānenāti,yaciyamanenati,4,1,3,0,14
667366,vissaṭṭhakammaṭṭhāne,vissatthakammatthane,2,2,0,0,20
667367,bālaputhujjane,balaputhujjane,2,2,0,0,14
667368,pavāraṇasaṅgahopi,pavaranasangahopi,2,2,0,0,17
667369,āsāḷhīmāse,asalhimase,6,4,2,0,10
667370,P5.1033,P5.1033,1,1,0,0,7
667371,gottenapi,gottenapi,10,8,2,0,9
667372,anussāvetuṃ,anussavetum,6,4,2,0,11
667373,ekānussāvaneti,ekanussavaneti,7,1,6,0,14
667374,anussāvane,anussavane,20,17,3,0,10
667375,anussāventehi,anussaventehi,2,2,0,0,13
667376,ekānussāvane,ekanussavane,16,12,4,0,12
667377,upajjhāyenāti,upajjhayenati,9,1,8,0,13
667378,anussāvanakiriyaṃ,anussavanakiriyam,4,4,0,0,17
667379,anussāvetabbā,anussavetabba,3,3,0,0,13
667380,nānāupajjhāyā,nanaupajjhaya,2,2,0,0,13
667381,upasampadāvidhikathā,upasampadavidhikatha,3,3,0,0,20
667382,gāhāpetabboti,gahapetabboti,4,0,4,0,13
667383,vitthāyantīti,vitthayantiti,2,0,2,0,13
667384,vitthaddhagattā,vitthaddhagatta,3,3,0,0,15
667385,vattabbantiādi,vattabbantiadi,2,2,0,0,14
667386,cattāronissayādikathā,cattaronissayadikatha,3,3,0,0,21
667387,upasampannasamanantarameva,upasampannasamanantarameva,6,6,0,0,26
667388,metabbāti,metabbati,3,0,3,0,9
667389,ekaporisā,ekaporisa,4,2,2,0,9
667390,dviporisā,dviporisa,2,2,0,0,9
667391,utuppamāṇaṃ,utuppamanam,17,13,4,0,11
667392,vassānādayo,vassanadayo,2,2,0,0,11
667393,ācikkhitabbo,acikkhitabbo,20,19,1,0,12
667394,P5.1034,P5.1034,1,1,0,0,7
667395,divasabhāgoti,divasabhagoti,2,2,0,0,13
667396,paṇḍupalāsoti,pandupalasoti,6,2,4,0,13
667397,haritatthāyāti,haritatthayati,2,0,2,0,14
667398,mahāsilā,mahasila,4,4,0,0,8
667399,alabbhamānāya,alabbhamanaya,6,5,1,0,13
667400,sambhoge,sambhoge,16,12,4,0,8
667401,saṃvāseti,samvaseti,6,2,4,0,9
667402,ukkhepanīyakammakaraṇatthāya,ukkhepaniyakammakaranatthaya,1,1,0,0,28
667403,uposathapavāraṇādikaraṇabhede,uposathapavaranadikaranabhede,1,1,0,0,29
667404,dvāsattatiadhikavatthusatapaṭimaṇḍitassa,dvasattatiadhikavatthusatapatimanditassa,2,2,0,0,40
667405,mahākhandhakassa,mahakhandhakassa,2,2,0,0,16
667406,mahākhandhakavaṇṇanā,mahakhandhakavannana,4,4,0,0,20
667407,uposathakkhandhakaṃ,uposathakkhandhakam,5,5,0,0,19
667408,sannipātānujānanādikathā,sannipatanujananadikatha,2,2,0,0,24
667409,uposathakkhandhake,uposathakkhandhake,31,24,7,0,18
667410,aññaladdhikāti,annaladdhikati,2,2,0,0,14
667411,mūgasūkarāti,mugasukarati,2,0,2,0,12
667412,thūlasarīrasūkarā,thulasarirasukara,2,2,0,0,17
667413,P5.1035,P5.1035,1,1,0,0,7
667414,pakaticārittavasena,pakaticarittavasena,11,11,0,0,19
667415,cātuddaso,catuddaso,49,40,9,0,9
667416,anuvattitabbaṃ,anuvattitabbam,47,40,7,0,14
667417,sīmānujānanakathā,simanujananakatha,3,3,0,0,17
667418,kittetabbāti,kittetabbati,5,1,4,0,12
667419,pāsāṇādīsupi,pasanadisupi,2,2,0,0,12
667420,P5.1036,P5.1036,1,1,0,0,7
667421,kittitanimittaṃ,kittitanimittam,3,3,0,0,15
667422,kittetvāva,kittetvava,5,5,0,0,10
667423,athānantaraṃ,athanantaram,1,1,0,0,12
667424,kammavācāpariyosāne,kammavacapariyosane,107,107,0,0,19
667425,sīmato,simato,52,45,7,0,6
667426,kittitānipi,kittitanipi,3,3,0,0,11
667427,kittitāneva,kittitaneva,3,3,0,0,11
667428,sīmamaṇḍalaṃ,simamandalam,7,5,2,0,12
667429,sambandhantena,sambandhantena,3,3,0,0,14
667430,kittetabbanti,kittetabbanti,1,1,0,0,13
667431,pabbatanimittādīsu,pabbatanimittadisu,1,1,0,0,18
667432,suddhapaṃsupabbato,suddhapamsupabbato,3,2,1,0,18
667433,suddhapāsāṇapabbato,suddhapasanapabbato,2,2,0,0,19
667434,ubhayamissakoti,ubhayamissakoti,2,2,0,0,15
667435,vālikarāsi,valikarasi,3,3,0,0,10
667436,omakataro,omakataro,6,6,0,0,9
667437,pabbatanimittehi,pabbatanimittehi,2,2,0,0,16
667438,pāsāṇanimittādīsupi,pasananimittadisupi,3,3,0,0,19
667439,kittentenāpi,kittentenapi,2,2,0,0,12
667440,cakkasaṇṭhānena,cakkasanthanena,4,4,0,0,15
667441,kittetabbāni,kittetabbani,12,12,0,0,12
667442,akittetvā,akittetva,32,32,0,0,9
667443,jātarukkhavammikādīsu,jatarukkhavammikadisu,3,3,0,0,21
667444,ekayojanadviyojanappamāṇaṃ,ekayojanadviyojanappamanam,2,2,0,0,26
667445,jātarukkhavammikādīni,jatarukkhavammikadini,3,3,0,0,21
667446,pāsāṇanimitte,pasananimitte,5,0,5,0,13
667447,ayaguḷopi,ayagulopi,3,3,0,0,9
667448,pāsāṇasaṅkhyameva,pasanasankhyameva,7,7,0,0,17
667449,P5.1037,P5.1037,1,1,0,0,7
667450,hatthippamāṇo,hatthippamano,5,2,3,0,13
667451,pabbatasaṅkhyaṃ,pabbatasankhyam,2,2,0,0,15
667452,mahāgoṇamahāmahiṃsappamāṇo,mahagonamahamahimsappamano,2,2,0,0,26
667453,dvattiṃsapalaguḷapiṇḍaparimāṇo,dvattimsapalagulapindaparimano,3,3,0,0,30
667454,khuddakataro,khuddakataro,6,6,0,0,12
667455,mahantīpi,mahantipi,2,2,0,0,9
667456,animittupagapāsāṇarāsipi,animittupagapasanarasipi,1,1,0,0,24
667457,paṃsuvālikarāsi,pamsuvalikarasi,1,1,0,0,15
667458,bhūmisamo,bhumisamo,3,3,0,0,9
667459,khalamaṇḍalasadiso,khalamandalasadiso,3,3,0,0,18
667460,uṭṭhitapāsāṇo,utthitapasano,5,5,0,0,13
667461,pamāṇupago,pamanupago,2,2,0,0,10
667462,atimahantopi,atimahantopi,7,7,0,0,12
667463,ekappadesaṃ,ekappadesam,2,2,0,0,11
667464,kittetabbo,kittetabbo,11,11,0,0,10
667465,piṭṭhipāsāṇupari,pitthipasanupari,3,3,0,0,16
667466,bahisīmāyaṃ,bahisimayam,14,14,0,0,11
667467,ṭhitapiṭṭhipāsāṇo,thitapitthipasano,3,3,0,0,17
667468,vananimitte,vananimitte,5,0,5,0,11
667469,tiṇavanaṃ,tinavanam,5,4,1,0,9
667470,tacasāratālanāḷikerādirukkhavanaṃ,tacasaratalanalikeradirukkhavanam,2,2,0,0,33
667471,antosārānaṃ,antosaranam,4,2,2,0,11
667472,sākasālādīnaṃ,sakasaladinam,2,2,0,0,13
667473,antosāramissakānaṃ,antosaramissakanam,6,2,4,0,18
667474,catupañcarukkhamattampi,catupancarukkhamattampi,4,4,0,0,23
667475,yojanasatikampi,yojanasatikampi,3,3,0,0,15
667476,kattukāmehipi,kattukamehipi,2,2,0,0,13
667477,rukkhapāsāṇādayo,rukkhapasanadayo,3,3,0,0,16
667478,ṭhitavanaṃ,thitavanam,5,5,0,0,10
667479,rukkhanimitte,rukkhanimitte,4,0,4,0,13
667480,tālanāḷikerādirukkho,talanalikeradirukkho,2,2,0,0,20
667481,jīvamānako,jivamanako,2,2,0,0,10
667482,aṭṭhaṅgulo,atthangulo,4,4,0,0,10
667483,pariṇāhato,parinahato,13,13,0,0,10
667484,sūcidaṇḍakappamāṇopi,sucidandakappamanopi,3,3,0,0,20
667485,suppatiṭṭhitanigrodhopi,suppatitthitanigrodhopi,2,2,0,0,23
667486,vaṃsanaḷakasarāvādīsu,vamsanalakasaravadisu,2,2,0,0,21
667487,vaḍḍhāpito,vaddhapito,2,2,0,0,10
667488,pamāṇupagopi,pamanupagopi,2,2,0,0,12
667489,P5.1038,P5.1038,1,1,0,0,7
667490,navamūlasākhāniggamanaṃ,navamulasakhaniggamanam,8,8,0,0,23
667491,sākarukkhotipi,sakarukkhotipi,1,1,0,0,14
667492,suppatiṭṭhitanigrodhasadisaṃ,suppatitthitanigrodhasadisam,7,5,2,0,28
667493,magganimitte,magganimitte,4,0,4,0,12
667494,araññakhettanadītaḷākamaggādayo,arannakhettanaditalakamaggadayo,3,3,0,0,31
667495,sakaṭamaggato,sakatamaggato,2,2,0,0,13
667496,sakaṭamaggameva,sakatamaggameva,3,3,0,0,15
667497,avaḷañjā,avalanja,2,2,0,0,8
667498,jaṅghasatthasakaṭasatthehi,janghasatthasakatasatthehi,3,3,0,0,26
667499,vaḷañjiyamānāyeva,valanjiyamanayeva,2,2,0,0,17
667500,sakaṭadhuramiva,sakatadhuramiva,3,3,0,0,15
667501,sambandhaṭṭhāne,sambandhatthane,3,3,0,0,15
667502,ekābaddhanimittañhetaṃ,ekabaddhanimittanhetam,6,6,0,0,22
667503,antimacakkamaggaṃ,antimacakkamaggam,3,3,0,0,17
667504,bāhiracakkamaggaṃ,bahiracakkamaggam,3,3,0,0,17
667505,bāhiracakkamaggova,bahiracakkamaggova,2,2,0,0,18
667506,parikhāsaṇṭhānena,parikhasanthanena,6,6,0,0,17
667507,vammikanimitte,vammikanimitte,3,0,3,0,14
667508,aṭṭhaṅgulubbedho,atthangulubbedho,5,4,1,0,16
667509,govisāṇappamāṇopi,govisanappamanopi,2,2,0,0,17
667510,himavantapabbatasadisopi,himavantapabbatasadisopi,2,2,0,0,24
667511,nadīnimitte,nadinimitte,6,2,4,0,11
667512,P5.1039,P5.1039,1,1,0,0,7
667513,anupañcāhanti,anupancahanti,2,2,0,0,13
667514,valāhakesu,valahakesu,5,4,1,0,10
667515,vigatamattesu,vigatamattesu,4,4,0,0,13
667516,nadīsaṅkhyaṃ,nadisankhyam,3,3,0,0,12
667517,suvuṭṭhikāle,suvutthikale,4,4,0,0,12
667518,nadīpāragamanepi,nadiparagamanepi,2,2,0,0,16
667519,uposathādisaṅghakammakaraṇepi,uposathadisanghakammakaranepi,2,2,0,0,29
667520,nadīpārasīmasammannanepi,nadiparasimasammannanepi,1,1,0,0,24
667521,sakaṭadhurasaṇṭhānena,sakatadhurasanthanena,3,3,0,0,21
667522,vinibbijjhitvā,vinibbijjhitva,4,4,0,0,14
667523,nadicatukkepi,nadicatukkepi,2,1,1,0,13
667524,asammissanadiyo,asammissanadiyo,2,2,0,0,15
667525,vallipalālādīhi,vallipalaladihi,3,3,0,0,15
667526,nadisotaṃ,nadisotam,2,2,0,0,9
667527,setumhi,setumhi,6,6,0,0,7
667528,appavattamānā,appavattamana,6,6,0,0,13
667529,nadinimittaṃ,nadinimittam,5,5,0,0,12
667530,appavattanaṭṭhāne,appavattanatthane,6,5,1,0,17
667531,udakanimittaṃ,udakanimittam,12,10,2,0,13
667532,nirudakabhāvena,nirudakabhavena,3,3,0,0,15
667533,udakamātikaṃ,udakamatikam,9,8,1,0,12
667534,kunnadisadisā,kunnadisadisa,1,1,0,0,13
667535,niggatāpi,niggatapi,2,2,0,0,9
667536,niggatamaggena,niggatamaggena,2,2,0,0,14
667537,susumārādisamākiṇṇā,susumaradisamakinna,3,3,0,0,19
667538,nāvādīhi,navadihi,8,8,0,0,8
667539,sañcaritabbā,sancaritabba,3,3,0,0,12
667540,udakanimitte,udakanimitte,5,2,3,0,12
667541,P5.1040,P5.1040,1,1,0,0,7
667542,appavattanaudakaṃ,appavattanaudakam,2,2,0,0,17
667543,āvāṭapokkharaṇitaḷākajātassaraloṇisamuddādīsu,avatapokkharanitalakajatassaralonisamuddadisu,2,2,0,0,45
667544,oghanadiudakavāhakamātikādīsu,oghanadiudakavahakamatikadisu,1,1,0,0,29
667545,ukkhepimaṃ,ukkhepimam,10,3,7,0,10
667546,duvuttaṃ,duvuttam,13,13,0,0,8
667547,attanomatimattameva,attanomatimattameva,2,2,0,0,19
667548,sūkarakhatāyapi,sukarakhatayapi,3,3,0,0,15
667549,kīḷanavāpiyampi,kilanavapiyampi,3,3,0,0,15
667550,āvāṭakaṃ,avatakam,2,1,1,0,8
667551,pūritaudakampi,puritaudakampi,2,2,0,0,14
667552,kammavācāpariyosānā,kammavacapariyosana,5,5,0,0,19
667553,nimittasaññākaraṇatthaṃ,nimittasannakaranattham,3,3,0,0,23
667554,pāsāṇavālikāpaṃsuādirāsi,pasanavalikapamsuadirasi,3,3,0,0,24
667555,dārutthambho,darutthambho,3,3,0,0,12
667556,kāretuñca,karetunca,2,2,0,0,9
667557,lābhasīmāyaṃ,labhasimayam,3,3,0,0,12
667558,samānasaṃvāsakasīmā,samanasamvasakasima,23,22,1,0,19
667559,vinayakammameva,vinayakammameva,3,3,0,0,15
667560,asammissehipi,asammissehipi,3,3,0,0,13
667561,sammissehipi,sammissehipi,2,2,0,0,12
667562,bajjhamānā,bajjhamana,9,9,0,0,10
667563,siṅghāṭakaaḍḍhacandamudiṅgādisaṇṭhānā,singhatakaaddhacandamudingadisanthana,2,2,0,0,37
667564,bandhitukāmehi,bandhitukamehi,6,6,0,0,14
667565,sāmantavihāresu,samantaviharesu,6,6,0,0,15
667566,sīmāparicchedaṃ,simaparicchedam,10,10,0,0,15
667567,baddhasīmavihārānaṃ,baddhasimaviharanam,5,4,1,0,19
667568,abaddhasīmavihārānaṃ,abaddhasimaviharanam,5,4,1,0,20
667569,disācārikabhikkhūnaṃ,disacarikabhikkhunam,6,5,1,0,20
667570,nissañcārasamaye,nissancarasamaye,6,6,0,0,16
667571,baddhasīmavihārā,baddhasimavihara,7,7,0,0,16
667572,sakasīmāparicchedato,sakasimaparicchedato,1,1,0,0,20
667573,nikkhamitthā,nikkhamittha,3,3,0,0,12
667574,abaddhasīmavihārā,abaddhasimavihara,6,6,0,0,17
667575,sannipātetabbā,sannipatetabba,3,3,0,0,14
667576,P5.1041,P5.1041,1,1,0,0,7
667577,antokātukāmā,antokatukama,3,3,0,0,12
667578,āharitabboti,aharitabboti,5,4,1,0,12
667579,nānāgāmakhettāni,nanagamakhettani,3,3,0,0,16
667580,baddhasīmāsadisāni,baddhasimasadisani,2,2,0,0,18
667581,antonimittagatehi,antonimittagatehi,11,8,3,0,17
667582,samānasaṃvāsakasīmāsammannanakāle,samanasamvasakasimasammannanakale,5,5,0,0,33
667583,āgamanampi,agamanampi,7,5,2,0,10
667584,anāgamanampi,anagamanampi,10,7,3,0,12
667585,avippavāsasīmāsammannanakāle,avippavasasimasammannanakale,6,6,0,0,28
667586,nadītitthagāmadvārādīsu,nadititthagamadvaradisu,5,5,0,0,23
667587,hatthapāsānayanatthañca,hatthapasanayanatthanca,3,3,0,0,23
667588,bahisīmākaraṇatthañca,bahisimakaranatthanca,1,1,0,0,21
667589,samaṇuddese,samanuddese,7,7,0,0,11
667590,saṅkhasaññaṃ,sankhasannam,5,4,1,0,12
667591,nimittakittanānantaraṃ,nimittakittananantaram,3,3,0,0,22
667592,kammavācāpariyosāneyeva,kammavacapariyosaneyeva,3,3,0,0,23
667593,samānasaṃvāsakasīmaṃ,samanasamvasakasimam,13,13,0,0,20
667594,sammannantehi,sammannantehi,4,4,0,0,13
667595,bandhantehi,bandhantehi,20,20,0,0,11
667596,bodhicetiyabhattasālādīni,bodhicetiyabhattasaladini,4,4,0,0,25
667597,sabbavatthūni,sabbavatthuni,4,4,0,0,13
667598,akatavihāre,akatavihare,4,4,0,0,11
667599,bodhicetiyādīnaṃ,bodhicetiyadinam,4,4,0,0,16
667600,sabbavatthūnaṃ,sabbavatthunam,4,4,0,0,14
667601,gaṇhantīpi,ganhantipi,6,6,0,0,10
667602,sīmāmāḷakassa,simamalakassa,4,4,0,0,13
667603,nimittupagā,nimittupaga,10,7,3,0,11
667604,khaṇḍasīmāya,khandasimaya,78,76,2,0,12
667605,P5.1042,P5.1042,1,1,0,0,7
667606,mahāsīmāyameva,mahasimayameva,3,3,0,0,14
667607,bandhanavidhi,bandhanavidhi,3,3,0,0,13
667608,avippavāsakammavācā,avippavasakammavaca,6,6,0,0,19
667609,samūhanissāmāti,samuhanissamati,2,2,0,0,15
667610,samūhanituṃ,samuhanitum,34,29,5,0,11
667611,bahisīmantarikapāsāṇā,bahisimantarikapasana,1,1,0,0,21
667612,ekaratanappamāṇā,ekaratanappamana,6,4,2,0,16
667613,vidatthippamāṇāpi,vidatthippamanapi,3,3,0,0,17
667614,caturaṅgulappamāṇāpi,caturangulappamanapi,4,4,0,0,20
667615,khaṇḍasīmāyo,khandasimayo,4,4,0,0,12
667616,mahāsīmāsammutikāle,mahasimasammutikale,3,3,0,0,19
667617,khaṇḍasīmato,khandasimato,12,12,0,0,12
667618,anupariyāyantehi,anupariyayantehi,5,5,0,0,16
667619,sīmantarikapāsāṇā,simantarikapasana,15,13,2,0,17
667620,avasesanimittāni,avasesanimittani,5,5,0,0,16
667621,avijahantehi,avijahantehi,4,4,0,0,12
667622,avippavāsakammavācāpi,avippavasakammavacapi,4,4,0,0,21
667623,samūhanissāmā,samuhanissama,17,17,0,0,13
667624,yathāvuttenayena,yathavuttenayena,1,1,0,0,16
667625,khaṇḍasīmatova,khandasimatova,6,4,2,0,14
667626,pathavitaleyeva,pathavitaleyeva,1,1,0,0,15
667627,piṭṭhipāsāṇepi,pitthipasanepi,2,2,0,0,14
667628,kuṭigehepi,kutigehepi,4,2,2,0,10
667629,pāsādepi,pasadepi,2,2,0,0,8
667630,P5.1043,P5.1043,1,1,0,0,7
667631,pabbatamatthakepi,pabbatamatthakepi,2,2,0,0,17
667632,baddhāyeva,baddhayeva,2,2,0,0,10
667633,nimittupagapāsāṇe,nimittupagapasane,4,2,2,0,17
667634,nimittapāsāṇā,nimittapasana,3,2,1,0,13
667635,uṭṭhāpetabbā,utthapetabba,1,1,0,0,12
667636,sīmāparicchedo,simaparicchedo,3,3,0,0,14
667637,usūyakā,usuyaka,3,3,0,0,7
667638,pāsāṇāva,pasanava,4,4,0,0,8
667639,okāsaṭṭhānaṃ,okasatthanam,2,2,0,0,12
667640,pāsāṇanimittāni,pasananimittani,2,2,0,0,15
667641,antokuṭṭameva,antokuttameva,2,2,0,0,13
667642,antokuṭṭe,antokutte,2,2,0,0,9
667643,nimittapāsāṇe,nimittapasane,7,5,2,0,13
667644,bahinibbodakapatanaṭṭhānepi,bahinibbodakapatanatthanepi,1,1,0,0,27
667645,kuṭigehaṃ,kutigeham,3,3,0,0,9
667646,sīmaṭṭhameva,simatthameva,4,4,0,0,12
667647,catubhittiyaleṇepi,catubhittiyalenepi,2,0,2,0,18
667648,pamukhepi,pamukhepi,5,5,0,0,9
667649,nibbodakapatanaṭṭhānepi,nibbodakapatanatthanepi,2,2,0,0,23
667650,uparipāsādepi,uparipasadepi,2,0,2,0,13
667651,tulānaṃ,tulanam,8,7,1,0,7
667652,P5.1044,P5.1044,1,1,0,0,7
667653,tulārukkhehi,tularukkhehi,4,4,0,0,12
667654,ekasambaddho,ekasambaddho,1,1,0,0,12
667655,ekathambhapāsādassa,ekathambhapasadassa,2,2,0,0,19
667656,thambhamatthake,thambhamatthake,4,3,1,0,15
667657,pāsādabhittito,pasadabhittito,2,2,0,0,14
667658,niyyūhakādīsu,niyyuhakadisu,2,2,0,0,13
667659,pāsādabhitti,pasadabhitti,2,2,0,0,12
667660,otaraṇānotaraṇaṃ,otarananotaranam,5,2,3,0,16
667661,kittentehipi,kittentehipi,2,2,0,0,12
667662,rukkhatthambhā,rukkhatthambha,2,2,0,0,14
667663,bhittilagge,bhittilagge,2,2,0,0,11
667664,pariyantathambhānaṃ,pariyantathambhanam,4,2,2,0,19
667665,heṭṭhāpāsādassa,hetthapasadassa,4,4,0,0,15
667666,kuḍḍo,kuddo,2,2,0,0,5
667667,uparipāsādampi,uparipasadampi,2,2,0,0,14
667668,sīmaṭṭho,simattho,10,7,3,0,8
667669,okāsārahaṃ,okasaraham,2,2,0,0,10
667670,heṭṭhāpabbatepi,hetthapabbatepi,2,2,0,0,15
667671,tālamūlakapabbatepi,talamulakapabbatepi,2,2,0,0,19
667672,otarateva,otarateva,2,2,0,0,9
667673,vitānasaṇṭhāno,vitanasanthano,3,3,0,0,14
667674,paṇavasaṇṭhāno,panavasanthano,5,4,1,0,14
667675,sīmappamāṇaṃ,simappamanam,12,11,1,0,12
667676,kūṭantaraṃ,kutantaram,3,2,1,0,10
667677,sappaphaṇasadiso,sappaphanasadiso,4,2,2,0,16
667678,sīmappamāṇassa,simappamanassa,2,2,0,0,14
667679,ākāsapabbhāraṃ,akasapabbharam,7,2,5,0,14
667680,sīmappamāṇo,simappamano,3,3,0,0,11
667681,susirapāsāṇo,susirapasano,6,5,1,0,12
667682,sīmaṭṭhoyeva,simatthoyeva,2,2,0,0,12
667683,P5.1045,P5.1045,1,1,0,0,7
667684,sīmāyeva,simayeva,6,6,0,0,8
667685,sīmāparicchedamatikkamitvā,simaparicchedamatikkamitva,3,3,0,0,26
667686,sabbapacchimasīmāparimāṇaṃ,sabbapacchimasimaparimanam,3,3,0,0,26
667687,apatitaṃ,apatitam,3,3,0,0,8
667688,nīcavatthukā,nicavatthuka,9,9,0,0,12
667689,sīmaṭṭhakameva,simatthakameva,2,2,0,0,14
667690,sīmāmaṇḍalaṃ,simamandalam,4,3,1,0,12
667691,umaṅganadī,umanganadi,4,3,1,0,10
667692,heṭṭhāpathavitale,hetthapathavitale,5,4,1,0,17
667693,kopetiyeva,kopetiyeva,2,2,0,0,10
667694,niggatapāroho,niggataparoho,4,4,0,0,13
667695,tatthajātarukkhādīni,tatthajatarukkhadini,4,4,0,0,20
667696,sākhāpārohā,sakhaparoha,4,4,0,0,11
667697,bahiṭṭhakā,bahitthaka,6,4,2,0,10
667698,ṭhitasākhādīsu,thitasakhadisu,2,2,0,0,14
667699,āruḷhabhikkhu,arulhabhikkhu,1,1,0,0,13
667700,jātarukkhassa,jatarukkhassa,8,7,1,0,13
667701,vehāsaṭṭhitasākhāya,vehasatthitasakhaya,1,1,0,0,19
667702,P5.1046,P5.1046,1,1,0,0,7
667703,nivāsanapārupanañca,nivasanaparupananca,2,2,0,0,19
667704,hatthapāsameva,hatthapasameva,5,3,2,0,14
667705,antosīmato,antosimato,2,2,0,0,10
667706,abbhugacchati,abbhugacchati,1,1,0,0,13
667707,ekasambaddhena,ekasambaddhena,2,1,1,0,14
667708,sīmāsaṅkhyameva,simasankhyameva,7,5,2,0,15
667709,pamāṇametissāti,pamanametissati,1,1,0,0,15
667710,tiyojanaparamā,tiyojanaparama,1,1,0,0,14
667711,sammannantena,sammannantena,16,16,0,0,13
667712,diyaḍḍhadiyaḍḍhayojanaṃ,diyaddhadiyaddhayojanam,2,2,0,0,23
667713,ekekadisato,ekekadisato,2,2,0,0,11
667714,koṇato,konato,9,8,1,0,6
667715,pārayatīti,parayatiti,6,1,5,0,10
667716,nadīpārā,nadipara,1,1,0,0,8
667717,ajjhottharamānanti,ajjhottharamananti,1,1,0,0,18
667718,sīmābandhanaṭṭhānagatesu,simabandhanatthanagatesu,1,1,0,0,24
667719,niccasañcaraṇanāvā,niccasancarananava,2,2,0,0,18
667720,pājanapurisena,pajanapurisena,1,1,0,0,14
667721,labbhaneyyā,labbhaneyya,8,6,2,0,11
667722,dhuvanāvāva,dhuvanavava,10,9,1,0,11
667723,P5.1047,P5.1047,1,1,0,0,7
667724,ogate,ogate,1,1,0,0,5
667725,ussāritāpi,ussaritapi,1,1,0,0,10
667726,sudhākasaṭādīhi,sudhakasatadihi,1,1,0,0,15
667727,visaṅkhatapadarā,visankhatapadara,1,1,0,0,16
667728,sīmābandhanaṭṭhāne,simabandhanatthane,2,2,0,0,18
667729,nibaddhanāvāyeva,nibaddhanavayeva,1,1,0,0,16
667730,dhuvasetu,dhuvasetu,8,7,1,0,9
667731,rukkhasaṅghāṭamayo,rukkhasanghatamayo,1,1,0,0,18
667732,padarabaddho,padarabaddho,1,1,0,0,12
667733,jaṅghasatthasetu,janghasatthasetu,1,1,0,0,16
667734,hatthissādīnaṃ,hatthissadinam,1,1,0,0,14
667735,sañcaraṇayoggo,sancaranayoggo,2,2,0,0,14
667736,mahāsetu,mahasetu,3,3,0,0,8
667737,ekapadikasetupi,ekapadikasetupi,1,1,0,0,15
667738,dhuvasetutveva,dhuvasetutveva,1,1,0,0,14
667739,vettalatādīni,vettalatadini,1,1,0,0,13
667740,nadīpārasīmaṃ,nadiparasimam,8,7,1,0,13
667741,abhimukhatittheyeva,abhimukhatittheyeva,2,2,0,0,19
667742,abhimukhatitthe,abhimukhatitthe,3,3,0,0,15
667743,gāvutamattabbhantarepi,gavutamattabbhantarepi,2,2,0,0,22
667744,adhosotepi,adhosotepi,2,2,0,0,10
667745,paṭhamakittitanimittassa,pathamakittitanimittassa,2,2,0,0,24
667746,paṭhamakittitanimittena,pathamakittitanimittena,5,5,0,0,23
667747,ghaṭetabbaṃ,ghatetabbam,4,4,0,0,11
667748,sammutipariyosāne,sammutipariyosane,4,4,0,0,17
667749,pāratīre,paratire,2,2,0,0,8
667750,ekasīmā,ekasima,6,6,0,0,7
667751,P5.1048,P5.1048,1,1,0,0,7
667752,baddhasīmāsaṅkhyaṃ,baddhasimasankhyam,2,2,0,0,18
667753,nadisīmā,nadisima,1,1,0,0,8
667754,ṭhitatīre,thitatire,2,2,0,0,9
667755,orimante,orimante,12,9,3,0,8
667756,anāgacchantāpi,anagacchantapi,2,2,0,0,14
667757,tīradvayañca,tiradvayanca,2,2,0,0,12
667758,nadisīmāyeva,nadisimayeva,1,1,0,0,12
667759,vihārasīmāparicchedato,viharasimaparicchedato,4,4,0,0,22
667760,vihārasīmāparicchedanimittassa,viharasimaparicchedanimittassa,2,2,0,0,30
667761,sammukhibhūte,sammukhibhute,1,1,0,0,13
667762,sorimante,sorimante,2,2,0,0,9
667763,dīpakasikharaṃ,dipakasikharam,3,2,1,0,14
667764,parikkhipantona,parikkhipantona,1,1,0,0,15
667765,nimittasammukhe,nimittasammukhe,2,2,0,0,15
667766,sammukhanimīttamādiṃkatvā,sammukhanimittamadimkatva,1,1,0,0,25
667767,pāratīranimittāni,paratiranimittani,1,1,0,0,17
667768,pārimantasorimantanimittāni,parimantasorimantanimittani,1,1,0,0,27
667769,pabbatasaṇḍānā,pabbatasandana,1,1,0,0,14
667770,adhopi,adhopi,5,5,0,0,6
667771,sīkharāni,sikharani,1,1,0,0,9
667772,nimittaghaṭanā,nimittaghatana,2,2,0,0,14
667773,mudiṅgasaṇṭhānā,mudingasanthana,4,3,1,0,15
667774,vihārasīmāparicchedassa,viharasimaparicchedassa,2,2,0,0,23
667775,sabbapaṭhamanayena,sabbapathamanayena,1,1,0,0,18
667776,paṇavasaṇṭhānā,panavasanthana,2,2,0,0,14
667777,uposathāgārādikathā,uposathagaradikatha,2,2,0,0,19
667778,anupariveṇiyaṃ,anupariveniyam,7,5,2,0,14
667779,ekasīmamahāvihāre,ekasimamahavihare,1,1,0,0,17
667780,asaṅketenāti,asanketenati,2,0,2,0,12
667781,P5.1049,P5.1049,1,1,0,0,7
667782,katovassa,katovassa,2,2,0,0,9
667783,asuṇantassāpi,asunantassapi,1,1,0,0,13
667784,uposathapamukhassa,uposathapamukhassa,1,1,0,0,18
667785,pāsāṇaiṭṭhakadārukhaṇḍadaṇḍakādīni,pasanaitthakadarukhandadandakadini,1,1,0,0,34
667786,māḷakādīsu,malakadisu,2,2,0,0,10
667787,animittupagā,animittupaga,3,2,1,0,12
667788,paricchedajānanatthaṃ,paricchedajananattham,1,1,0,0,21
667789,uṭṭhitāvāso,utthitavaso,1,1,0,0,11
667790,asambādho,asambadho,1,1,0,0,9
667791,visamappadese,visamappadese,1,1,0,0,13
667792,aphāsukadeso,aphasukadeso,1,1,0,0,12
667793,avippavāsasīmānujānanakathā,avippavasasimanujananakatha,2,2,0,0,27
667794,andhakavindāti,andhakavindati,1,0,1,0,14
667795,gāvutattaye,gavutattaye,1,1,0,0,11
667796,rājagahañhi,rajagahanhi,1,1,0,0,11
667797,āgacchantoti,agacchantoti,3,1,2,0,12
667798,tarantoti,tarantoti,2,0,2,0,9
667799,sippiniyaṃ,sippiniyam,2,2,0,0,10
667800,appattavuḷhabhāvo,appattavulhabhavo,2,1,1,0,17
667801,P5.1050,P5.1050,1,1,0,0,7
667802,udakabbhāhatānissa,udakabbhahatanissa,1,1,0,0,18
667803,avippavāsā,avippavasa,8,7,1,0,10
667804,purimakammavācā,purimakammavaca,3,2,1,0,15
667805,purimāyeva,purimayeva,4,4,0,0,10
667806,ticīvaraparihāraṃ,ticivarapariharam,2,2,0,0,17
667807,ajjhottharitvāpi,ajjhottharitvapi,2,2,0,0,16
667808,bhikkhunisīmāya,bhikkhunisimaya,1,1,0,0,15
667809,nigamanagarānampi,nigamanagaranampi,3,3,0,0,17
667810,gāmeneva,gameneva,2,2,0,0,8
667811,parikkhepokāso,parikkhepokaso,5,5,0,0,14
667812,adhiṭṭhitatecīvariko,adhitthitatecivariko,4,4,0,0,20
667813,samānasaṃvāsakasīmāva,samanasamvasakasimava,3,3,0,0,21
667814,nimittakittanaṃ,nimittakittanam,8,8,0,0,15
667815,sammutikāle,sammutikale,4,4,0,0,11
667816,niviṭṭhassa,nivitthassa,6,6,0,0,11
667817,vaḍḍhitappadesopi,vaddhitappadesopi,3,3,0,0,17
667818,appaviṭṭhā,appavittha,5,5,0,0,10
667819,porāṇakagāmaṃ,poranakagamam,3,3,0,0,13
667820,sagehameva,sagehameva,2,2,0,0,10
667821,agāmoyeva,agamoyeva,3,3,0,0,9
667822,P5.1051,P5.1051,1,1,0,0,7
667823,samūhantabboti,samuhantabboti,1,0,1,0,14
667824,samūhantabbā,samuhantabba,6,6,0,0,12
667825,avippavāsasīmāya,avippavasasimaya,24,22,2,0,16
667826,khaṇḍasīmāpi,khandasimapi,4,4,0,0,12
667827,khaṇḍasīmāva,khandasimava,4,4,0,0,12
667828,samūhanitabbā,samuhanitabba,28,28,0,0,13
667829,samūhananti,samuhananti,4,4,0,0,11
667830,āvāsavaḍḍhanatthāya,avasavaddhanatthaya,2,2,0,0,19
667831,vihārokāsadānatthāya,viharokasadanatthaya,2,2,0,0,20
667832,khaṇḍasīmañca,khandasimanca,3,3,0,0,13
667833,avippavāsasīmañca,avippavasasimanca,3,3,0,0,17
667834,samūhanituñceva,samuhanitunceva,13,11,2,0,15
667835,bandhituñca,bandhitunca,14,12,2,0,11
667836,avippavāsaṃyeva,avippavasamyeva,4,4,0,0,15
667837,cetiyaṅgaṇabodhiyaṅgaṇauposathāgārādīsu,cetiyanganabodhiyanganauposathagaradisu,2,2,0,0,39
667838,nirāsaṅkaṭṭhānesu,nirasankatthanesu,6,3,3,0,17
667839,paṭibandhituṃ,patibandhitum,11,6,5,0,13
667840,sakkhissanteva,sakkhissanteva,6,6,0,0,14
667841,avihāraṃ,aviharam,5,3,2,0,8
667842,gāmasīmādikathā,gamasimadikatha,2,2,0,0,15
667843,baddhasīmāvasena,baddhasimavasena,3,3,0,0,16
667844,samānasaṃvāsañca,samanasamvasanca,1,1,0,0,16
667845,ekūposathabhāvañca,ekuposathabhavanca,1,1,0,0,18
667846,abaddhasīmesupi,abaddhasimesupi,1,1,0,0,15
667847,aṭṭhapitāyā,atthapitaya,1,0,1,0,11
667848,aṭṭhapitāyāti,atthapitayati,2,0,2,0,13
667849,aparicchinnāya,aparicchinnaya,1,1,0,0,14
667850,nagaranigamasīmāsu,nagaranigamasimasu,1,0,1,0,18
667851,P5.1052,P5.1052,1,1,0,0,7
667852,gāmantavāsīnaṃ,gamantavasinam,2,2,0,0,14
667853,gāmanigamanagarasīmāhi,gamanigamanagarasimahi,1,1,0,0,22
667854,aṭavippadese,atavippadese,1,1,0,0,12
667855,vijjhāṭavisadise,vijjhatavisadise,2,2,0,0,16
667856,samānasaṃvāsakasīmāti,samanasamvasakasimati,1,1,0,0,21
667857,ticīvaravippavāsaparihārampi,ticivaravippavasapariharampi,3,3,0,0,28
667858,sattabbhantarānaṃ,sattabbhantaranam,3,3,0,0,17
667859,sattabbhantaraṃ,sattabbhantaram,11,11,0,0,15
667860,sattabbhantarasīmakathā,sattabbhantarasimakatha,1,1,0,0,23
667861,udositasikkhāpadavaṇṇanāyaṃ,udositasikkhapadavannanayam,1,1,0,0,27
667862,asīmāti,asimati,6,3,3,0,7
667863,nadīlakkhaṇappattā,nadilakkhanappatta,2,2,0,0,18
667864,baddhasīmaṃ,baddhasimam,49,47,2,0,11
667865,katāpi,katapi,15,15,0,0,6
667866,asīmāva,asimava,3,3,0,0,7
667867,baddhasīmāsadisā,baddhasimasadisa,11,11,0,0,16
667868,samuddajātassaresu,samuddajatassaresu,2,0,2,0,18
667869,sayaṃjātasobbho,sayamjatasobbho,1,1,0,0,15
667870,abaddhasīmāpaacchedaṃ,abaddhasimapaacchedam,1,1,0,0,21
667871,P5.1053,P5.1053,1,1,0,0,7
667872,jātassarasamuddesupi,jatassarasamuddesupi,2,2,0,0,20
667873,mahāsumattherena,mahasumattherena,6,4,2,0,16
667874,pavattamānāyeva,pavattamanayeva,2,2,0,0,15
667875,mahāpadumatthereneva,mahapadumatthereneva,2,2,0,0,20
667876,temiyatī,temiyati,6,6,0,0,8
667877,antonadiyaṃyeva,antonadiyamyeva,6,6,0,0,15
667878,jātarukkhe,jatarukkhe,7,5,2,0,10
667879,baddhaaṭṭakepi,baddhaattakepi,5,5,0,0,14
667880,jātarukkhepi,jatarukkhepi,4,3,1,0,12
667881,nikkhantapāroho,nikkhantaparoho,5,5,0,0,15
667882,P5.1054,P5.1054,1,1,0,0,7
667883,paviṭṭhasākhāya,pavitthasakhaya,5,4,1,0,15
667884,pārohe,parohe,8,8,0,0,6
667885,bahipatiṭṭhitabhāvo,bahipatitthitabhavo,2,2,0,0,19
667886,baddhanāvāya,baddhanavaya,5,5,0,0,12
667887,setupādā,setupada,13,12,1,0,8
667888,tīrānaṃ,tiranam,5,5,0,0,7
667889,upariākāse,upariakase,4,4,0,0,10
667890,nadīsaṅkhyameva,nadisankhyameva,4,4,0,0,15
667891,otthaṭokāso,otthatokaso,3,3,0,0,11
667892,gāmasīmāsaṅkhyameva,gamasimasankhyameva,7,6,1,0,19
667893,koṭṭakabandhanena,kottakabandhanena,4,2,2,0,17
667894,āvaraṇamatthakepi,avaranamatthakepi,1,1,0,0,17
667895,āvaraṇappadeso,avaranappadeso,3,3,0,0,14
667896,vuttapāsāṇadīpakappadeso,vuttapasanadipakappadeso,2,2,0,0,24
667897,ajjhotthariyati,ajjhotthariyati,1,1,0,0,15
667898,chaḍḍitamodakaṃ,chadditamodakam,4,1,3,0,15
667899,sandanaṭṭhānato,sandanatthanato,6,4,2,0,15
667900,sukkhanadiyāpi,sukkhanadiyapi,2,2,0,0,14
667901,nīhaṭamātikāya,nihatamatikaya,2,2,0,0,14
667902,gāmanigamasīmaṃ,gamanigamasimam,6,3,3,0,15
667903,vihārasīmātveva,viharasimatveva,4,4,0,0,15
667904,P5.1055,P5.1055,1,1,0,0,7
667905,vaḍḍhanaudakaṃ,vaddhanaudakam,2,2,0,0,14
667906,pakativīci,pakativici,2,2,0,0,10
667907,udakantato,udakantato,2,2,0,0,10
667908,antosamuddo,antosamuddo,1,1,0,0,11
667909,āgatāsupi,agatasupi,2,2,0,0,9
667910,anāgatāsupi,anagatasupi,3,3,0,0,11
667911,pakatiudakeneva,pakatiudakeneva,2,2,0,0,15
667912,otthariyati,otthariyati,1,1,0,0,11
667913,araññasīmāsaṅkhyameva,arannasimasankhyameva,5,2,3,0,21
667914,gamanapariyantassa,gamanapariyantassa,7,5,2,0,18
667915,gāmasīmāsaṅkhyaṃ,gamasimasankhyam,7,7,0,0,16
667916,nigamasīmaṃ,nigamasimam,3,3,0,0,11
667917,karontehipi,karontehipi,4,4,0,0,11
667918,pacchinnamatte,pacchinnamatte,3,3,0,0,14
667919,gāmakhettasaṅkhyameva,gamakhettasankhyameva,3,3,0,0,21
667920,jātarukkhamhi,jatarukkhamhi,1,1,0,0,13
667921,piṭṭhipāsāṇadīpakesu,pitthipasanadipakesu,2,2,0,0,20
667922,samavassadevakāle,samavassadevakale,2,2,0,0,17
667923,pahonakajātassaro,pahonakajatassaro,2,2,0,0,17
667924,gimhahemantesu,gimhahemantesu,2,2,0,0,14
667925,anodako,anodako,2,2,0,0,7
667926,gāmakhettaṃyeva,gamakhettamyeva,2,2,0,0,15
667927,pokkharaṇīādīni,pokkharaniadini,2,2,0,0,15
667928,P5.1056,P5.1056,1,1,0,0,7
667929,ajātassaro,ajatassaro,6,5,1,0,10
667930,lābutipusakādivappe,labutipusakadivappe,2,2,0,0,19
667931,loṇīpi,lonipi,3,3,0,0,6
667932,jātassarasaṅkhyameva,jatassarasankhyameva,2,2,0,0,20
667933,udakaṭṭhānokāse,udakatthanokase,2,2,0,0,15
667934,sambhindantīti,sambhindantiti,4,0,4,0,14
667935,sambhindanti,sambhindanti,10,8,2,0,12
667936,porāṇakassa,poranakassa,13,13,0,0,11
667937,saṃsaṭṭhaviṭapā,samsatthavitapa,8,7,1,0,15
667938,sambhindantī,sambhindanti,1,1,0,0,12
667939,hatthamattā,hatthamatta,3,2,1,0,11
667940,ekarukkhopi,ekarukkhopi,3,3,0,0,11
667941,sīmāsaṅkaraṃ,simasankaram,8,3,5,0,12
667942,uposathabhedādikathā,uposathabhedadikatha,2,2,0,0,20
667943,cātuddasikassa,catuddasikassa,2,2,0,0,14
667944,pubbakicce,pubbakicce,15,13,2,0,10
667945,P5.1057,P5.1057,1,1,0,0,7
667946,pātimokkhuddesakathā,patimokkhuddesakatha,2,2,0,0,20
667947,panāyasmantehi,panayasmantehi,7,7,0,0,14
667948,aṭavimanussabhayaṃ,atavimanussabhayam,4,1,3,0,18
667949,rājantarāyotiādīsu,rajantarayotiadisu,2,0,2,0,18
667950,rājantarāyo,rajantarayo,13,10,3,0,11
667951,corantarāyo,corantarayo,11,8,3,0,11
667952,davadāho,davadaho,4,4,0,0,8
667953,aggantarāyo,aggantarayo,1,1,0,0,11
667954,udakantarāyo,udakantarayo,11,8,3,0,12
667955,manussantarāyo,manussantarayo,11,8,3,0,14
667956,amanussantarāyo,amanussantarayo,11,8,3,0,15
667957,caṇḍamigā,candamiga,4,4,0,0,9
667958,vāḷantarāyo,valantarayo,11,8,3,0,11
667959,sarīsapantarāyo,sarisapantarayo,11,8,3,0,15
667960,cāvetukāmā,cavetukama,4,4,0,0,10
667961,P5.1058,P5.1058,1,1,0,0,7
667962,sāvetabbo,savetabbo,3,3,0,0,9
667963,anajjhiṭṭhāti,anajjhitthati,2,0,2,0,13
667964,sammatadhammajjhesakāyattā,sammatadhammajjhesakayatta,3,3,0,0,26
667965,saṅghattherāyattā,sanghattherayatta,2,2,0,0,17
667966,dhammajjhesake,dhammajjhesake,2,2,0,0,14
667967,saṅghattherenāpi,sanghattherenapi,2,2,0,0,16
667968,vārapaṭipāṭiyā,varapatipatiya,2,2,0,0,14
667969,vidhīhi,vidhihi,2,2,0,0,7
667970,osārehī,osarehi,5,5,0,0,7
667971,osāretumeva,osaretumeva,2,2,0,0,11
667972,kathetumeva,kathetumeva,2,2,0,0,11
667973,sarabhaññameva,sarabhannameva,2,2,0,0,14
667974,saṅghattheropi,sanghattheropi,4,4,0,0,14
667975,madhurabhāṇakepi,madhurabhanakepi,2,2,0,0,16
667976,nājjhesati,najjhesati,2,2,0,0,10
667977,bhaṇāpemā,bhanapema,2,2,0,0,9
667978,bhaṇāpethā,bhanapetha,2,2,0,0,10
667979,bhaṇāpetabbaṃ,bhanapetabbam,2,2,0,0,13
667980,saṅghatthere,sanghatthere,7,7,0,0,12
667981,aṭṭhapetvāyeva,atthapetvayeva,3,2,1,0,14
667982,upanisinnakathāyapi,upanisinnakathayapi,1,1,0,0,19
667983,saṅghattherova,sanghattherova,3,3,0,0,14
667984,jānanakabhikkhuṃ,jananakabhikkhum,1,1,0,0,16
667985,anumodanādīsupi,anumodanadisupi,2,2,0,0,15
667986,P5.1059,P5.1059,1,1,0,0,7
667987,laddhakappiyaṃ,laddhakappiyam,18,18,0,0,14
667988,āpucchitabboyeva,apucchitabboyeva,2,2,0,0,16
667989,vissamissāmīti,vissamissamiti,4,2,2,0,14
667990,sajjhāyantassāpi,sajjhayantassapi,2,2,0,0,16
667991,sammannitabbaṃti,sammannitabbamti,1,0,1,0,16
667992,puramhākaṃ,puramhakam,6,4,2,0,10
667993,adhammakammapaṭikkosanādikathā,adhammakammapatikkosanadikatha,2,2,0,0,30
667994,paṭikkosituṃ,patikkositum,12,9,3,0,12
667995,pañcahītiādi,pancahitiadi,1,0,1,0,12
667996,anupaddavatthāya,anupaddavatthaya,3,3,0,0,16
667997,sāventīti,saventiti,1,0,1,0,9
667998,bhaṇissāmāti,bhanissamati,1,1,0,0,12
667999,therādhikaṃ,theradhikam,8,5,3,0,11
668000,therādhīnaṃ,theradhinam,4,3,1,0,11
668001,therāyattaṃ,therayattam,3,2,1,0,11
668002,ajjhesitabbo,ajjhesitabbo,8,8,0,0,12
668003,ajjhesanavidhānañcettha,ajjhesanavidhanancettha,1,1,0,0,23
668004,dhammajjhesane,dhammajjhesane,1,1,0,0,14
668005,cātuddasikapannarasikabhedena,catuddasikapannarasikabhedena,1,1,0,0,29
668006,saṅghauposathādibhedena,sanghauposathadibhedena,2,1,1,0,23
668007,navavidhañca,navavidhanca,1,1,0,0,12
668008,P5.1060,P5.1060,1,1,0,0,7
668009,akhaṇḍā,akhanda,8,8,0,0,7
668010,therāyattova,therayattova,4,4,0,0,12
668011,pakkhagaṇanādiuggahaṇānujānanakathā,pakkhagananadiuggahananujananakatha,2,2,0,0,35
668012,kālavatoti,kalavatoti,2,0,2,0,10
668013,samannāharathā,samannaharatha,2,2,0,0,14
668014,sadākālameva,sadakalameva,5,5,0,0,12
668015,bhāranittharaṇako,bharanittharanako,5,5,0,0,17
668016,sarabhāṇakadhammakathikādīsu,sarabhanakadhammakathikadisu,5,5,0,0,28
668017,uposathāgārasammajjanatthaṃ,uposathagarasammajjanattham,4,4,0,0,27
668018,āṇāpetabbā,anapetabba,5,5,0,0,10
668019,āsanapaññāpanāṇattiyampi,asanapannapananattiyampi,3,3,0,0,24
668020,saṅghikāvāsatopi,sanghikavasatopi,2,2,0,0,16
668021,taṭṭikāyopi,tattikayopi,6,6,0,0,11
668022,taṭṭikāsupi,tattikasupi,4,4,0,0,11
668023,sākhābhaṅgāni,sakhabhangani,5,5,0,0,13
668024,paññapetabbāni,pannapetabbani,7,7,0,0,14
668025,padīpakaraṇepi,padipakaranepi,3,3,0,0,14
668026,āṇāpentena,anapentena,11,11,0,0,10
668027,pariyesitabbāni,pariyesitabbani,8,8,0,0,15
668028,jāletabbo,jaletabbo,7,7,0,0,9
668029,disaṃgamikādivatthukathā,disamgamikadivatthukatha,2,2,0,0,24
668030,saṅgahetabboti,sangahetabboti,3,1,2,0,14
668031,tathākaraṇavasena,tathakaranavasena,2,2,0,0,17
668032,P5.1061,P5.1061,1,1,0,0,7
668033,paṭivacanadāpanena,pativacanadapanena,2,2,0,0,18
668034,upalāpetabbo,upalapetabbo,7,5,2,0,12
668035,ālapitabboti,alapitabboti,2,2,0,0,12
668036,pariveṇasammajjanadantakaṭṭhadānādīni,parivenasammajjanadantakatthadanadini,3,3,0,0,37
668037,bhikkhuupaṭṭhākā,bhikkhuupatthaka,2,2,0,0,16
668038,viharantū,viharantu,3,3,0,0,9
668039,utuvasseyeva,utuvasseyeva,3,3,0,0,12
668040,vassūpagatānaṃ,vassupagatanam,10,10,0,0,14
668041,pārisuddhidānakathā,parisuddhidanakatha,3,3,0,0,19
668042,pārisuddhidānaṃ,parisuddhidanam,4,4,0,0,15
668043,P5.1062,P5.1062,1,1,0,0,7
668044,vaggena,vaggena,113,111,2,0,7
668045,saṅghappatto,sanghappatto,26,25,1,0,12
668046,āhaṭāva,ahatava,4,4,0,0,7
668047,bilāḷasaṅkhalikapārisuddhi,bilalasankhalikaparisuddhi,1,1,0,0,26
668048,pārisuddhihārakassa,parisuddhiharakassa,4,2,2,0,19
668049,anārocitattā,anarocitatta,4,4,0,0,12
668050,chandadānakathā,chandadanakatha,3,3,0,0,15
668051,chandadānepi,chandadanepi,3,3,0,0,12
668052,pārisuddhidāne,parisuddhidane,1,1,0,0,14
668053,pārisuddhimeva,parisuddhimeva,1,1,0,0,14
668054,chandameva,chandameva,8,8,0,0,10
668055,chandadāyakassa,chandadayakassa,3,3,0,0,15
668056,saratipi,saratipi,10,8,2,0,8
668057,saṅghuposathādikathā,sanghuposathadikatha,2,2,0,0,20
668058,P5.1063,P5.1063,1,1,0,0,7
668059,pubbakaraṇādidassanatthaṃ,pubbakaranadidassanattham,1,1,0,0,25
668060,pubbakaraṇanti,pubbakarananti,12,11,1,0,14
668061,pubbakaraṇaṃ,pubbakaranam,50,38,12,0,12
668062,pubbakiccanti,pubbakiccanti,12,12,0,0,13
668063,pubbakaraṇato,pubbakaranato,6,5,1,0,13
668064,sabhāgāpattiyo,sabhagapattiyo,21,18,3,0,14
668065,pattakallanti,pattakallanti,9,9,0,0,13
668066,akkhātānīti,akkhataniti,1,1,0,0,11
668067,pubbakaraṇādīni,pubbakaranadini,3,3,0,0,15
668068,cātuddasikepi,catuddasikepi,1,1,0,0,13
668069,āpattipaṭikammavidhikathā,apattipatikammavidhikatha,2,2,0,0,25
668070,pārisuddhidānapaññāpanena,parisuddhidanapannapanena,2,1,1,0,25
668071,pārisuddhiuposathapaññāpanena,parisuddhiuposathapannapanena,1,1,0,0,29
668072,thullaccayādīsu,thullaccayadisu,2,2,0,0,15
668073,paṭidesemīti,patidesemiti,12,8,4,0,12
668074,tumhamūle,tumhamule,14,14,0,0,9
668075,saṃvareyyāsīti,samvareyyasiti,6,2,4,0,14
668076,saṃvareyyāthā,samvareyyatha,4,4,0,0,13
668077,saṃvarissāmī,samvarissami,13,11,2,0,12
668078,P5.1064,P5.1064,1,1,0,0,7
668079,nibbematikoti,nibbematikoti,3,0,3,0,13
668080,desanāvidhi,desanavidhi,2,2,0,0,11
668081,meghacchanne,meghacchanne,3,3,0,0,12
668082,sabbāpattīsu,sabbapattisu,1,1,0,0,12
668083,vikālabhojanādinā,vikalabhojanadina,8,7,1,0,17
668084,sabhāgavatthunā,sabhagavatthuna,8,7,1,0,15
668085,vatthusabhāgā,vatthusabhaga,10,9,1,0,13
668086,vikālabhojanappaccayā,vikalabhojanappaccaya,1,1,0,0,21
668087,sudesitāva,sudesitava,4,4,0,0,10
668088,desanapaccayā,desanapaccaya,1,1,0,0,13
668089,paṭiggahaṇappaccayā,patiggahanappaccaya,1,1,0,0,19
668090,nānāvatthukaṃ,nanavatthukam,6,5,1,0,13
668091,sabhāgoyeva,sabhagoyeva,5,5,0,0,11
668092,bhaṇḍanakalahasaṅghabhedādīnipi,bhandanakalahasanghabhedadinipi,4,4,0,0,31
668093,anāpattipannarasakādikathā,anapattipannarasakadikatha,3,3,0,0,26
668094,anāpattipannarasake,anapattipannarasake,1,1,0,0,19
668095,okkantāti,okkantati,4,2,2,0,9
668096,samaggasaññinoti,samaggasanninoti,3,1,2,0,16
668097,okkantattā,okkantatta,5,4,1,0,10
668098,okkantabhāvassa,okkantabhavassa,1,1,0,0,15
668099,samaggasaññino,samaggasannino,35,34,1,0,14
668100,vaggāvaggasaññipannarasake,vaggavaggasannipannarasake,1,1,0,0,26
668101,vematikapannarasakaṃ,vematikapannarasakam,6,6,0,0,20
668102,P5.1065,P5.1065,1,1,0,0,7
668103,kukkuccapakatapannarasake,kukkuccapakatapannarasake,1,1,0,0,25
668104,karaṇakkhaṇe,karanakkhane,3,3,0,0,12
668105,akappiyasaññitāsaṅkhātena,akappiyasannitasankhatena,1,1,0,0,25
668106,kukkuccapakatā,kukkuccapakata,10,10,0,0,14
668107,bhedapurekkhārapannarasake,bhedapurekkharapannarasake,2,2,0,0,26
668108,akusalabalavatāya,akusalabalavataya,3,3,0,0,17
668109,sīmokkantikapeyyālakathā,simokkantikapeyyalakatha,2,2,0,0,24
668110,āvāsikenaāgantukapeyyāle,avasikenaagantukapeyyale,3,3,0,0,24
668111,āvāsikenaāvāsikapeyyāle,avasikenaavasikapeyyale,1,1,0,0,23
668112,āgantukenaāvāsikapeyyāle,agantukenaavasikapeyyale,2,2,0,0,24
668113,purimapeyyāle,purimapeyyale,1,1,0,0,13
668114,āgantukenaāgantukapeyyāle,agantukenaagantukapeyyale,2,2,0,0,25
668115,ubhayapadesu,ubhayapadesu,1,1,0,0,12
668116,āgantukavasena,agantukavasena,2,2,0,0,14
668117,āvāsikehi,avasikehi,45,44,1,0,9
668118,liṅgādidassanakathā,lingadidassanakatha,2,2,0,0,19
668119,āvāsikākāraṃ,avasikakaram,7,5,2,0,12
668120,ācārasaṇṭhānaṃ,acarasanthanam,3,1,2,0,14
668121,evarūpaparikkhārāti,evarupaparikkharati,1,1,0,0,19
668122,supaññattamañcapīṭhādīnañceva,supannattamancapithadinanceva,1,1,0,0,29
668123,padasaddādīnañca,padasaddadinanca,1,1,0,0,16
668124,āgantukākārādīsu,agantukakaradisu,2,1,1,0,16
668125,udakanissekaṃ,udakanissekam,5,3,2,0,13
668126,dhotaudakanissekaṃ,dhotaudakanissekam,2,2,0,0,18
668127,dhovanaudakanissekanti,dhovanaudakanissekanti,1,1,0,0,22
668128,nānāsaṃvāsakādivatthūsu,nanasamvasakadivatthusu,1,1,0,0,23
668129,samānasaṃvāsakadiṭṭhiṃ,samanasamvasakaditthim,10,8,2,0,22
668130,P5.1066,P5.1066,1,1,0,0,7
668131,vattapaṭivattiṃ,vattapativattim,1,1,0,0,15
668132,nābhivitarantīti,nabhivitarantiti,3,0,3,0,16
668133,nānāsaṃvāsakabhāvaṃ,nanasamvasakabhavam,4,1,3,0,19
668134,nissajjāpentīti,nissajjapentiti,2,1,1,0,15
668135,nagantabbagantabbavārakathā,nagantabbagantabbavarakatha,2,2,0,0,27
668136,uposathakārakā,uposathakaraka,2,2,0,0,14
668137,saṅghappahonakehi,sanghappahonakehi,3,3,0,0,17
668138,antarāyāti,antarayati,4,1,3,0,10
668139,attacatutthena,attacatutthena,5,4,1,0,14
668140,anāvāsoti,anavasoti,2,0,2,0,9
668141,navakammasālādiko,navakammasaladiko,3,3,0,0,17
668142,āvāsādayo,avasadayo,5,5,0,0,9
668143,uposathādhiṭṭhānatthaṃ,uposathadhitthanattham,6,5,1,0,22
668144,vissaṭṭhauposathāpi,vissatthauposathapi,5,5,0,0,19
668145,āraññakenāpi,arannakenapi,5,4,1,0,12
668146,vajjanīyapuggalasandassanakathā,vajjaniyapuggalasandassanakatha,2,2,0,0,31
668147,nisinnaparisāyātiādīsu,nisinnaparisayatiadisu,2,0,2,0,22
668148,hatthapāsupagamanameva,hatthapasupagamanameva,3,2,1,0,22
668149,pārivāsiyapārisuddhidānaṃ,parivasiyaparisuddhidanam,3,3,0,0,25
668150,parivāsiyachandadānavaṇṇanato,parivasiyachandadanavannanato,1,1,0,0,29
668151,anuposatheti,anuposatheti,2,0,2,0,12
668152,saṅghasāmaggiyāti,sanghasamaggiyati,5,2,3,0,17
668153,kosambakabhikkhūnaṃ,kosambakabhikkhunam,2,1,1,0,19
668154,P5.1067,P5.1067,1,1,0,0,7
668155,uposatheyeva,uposatheyeva,2,2,0,0,12
668156,uposathakkhandhakavaṇṇanā,uposathakkhandhakavannana,4,4,0,0,25
668157,vassūpanāyikakkhandhakaṃ,vassupanayikakkhandhakam,3,3,0,0,24
668158,vassūpanāyikānujānanakathā,vassupanayikanujananakatha,2,2,0,0,26
668159,vassūpanāyikakkhandhake,vassupanayikakkhandhake,11,11,0,0,23
668160,apaññattoti,apannattoti,2,0,2,0,11
668161,asaṃvihito,asamvihito,2,2,0,0,10
668162,āpādentāti,apadentati,2,0,2,0,10
668163,saṅkasāyissantīti,sankasayissantiti,1,0,1,0,17
668164,sakuntakāti,sakuntakati,1,0,1,0,11
668165,vassānanāmake,vassananamake,1,1,0,0,13
668166,aparajjugatāyāti,aparajjugatayati,1,0,1,0,16
668167,aparajjugatā,aparajjugata,3,3,0,0,12
668168,māsagatā,masagata,3,2,1,0,8
668169,paripuṇṇeti,paripunneti,2,2,0,0,11
668170,āsāḷhīpuṇṇamito,asalhipunnamito,2,2,0,0,15
668171,pāṭipadadivaseyeva,patipadadivaseyeva,5,5,0,0,18
668172,cetiyavandanādisāmīcikammaṃ,cetiyavandanadisamicikammam,4,4,0,0,27
668173,vassānecārikāpaṭikkhepādikathā,vassanecarikapatikkhepadikatha,2,2,0,0,30
668174,anapekkhagamanena,anapekkhagamanena,5,3,2,0,17
668175,uṭṭhāpanena,utthapanena,5,2,3,0,11
668176,vihāragaṇanāya,viharagananaya,5,4,1,0,14
668177,vihārasatassa,viharasatassa,2,2,0,0,13
668178,purimikaṃ,purimikam,4,4,0,0,9
668179,ukkaḍḍhitukāmoti,ukkaddhitukamoti,2,0,2,0,16
668180,vassanāmakaṃ,vassanamakam,2,2,0,0,12
668181,P5.1068,P5.1068,1,1,0,0,7
668182,ukkaḍḍhitukāmo,ukkaddhitukamo,3,3,0,0,14
668183,sāvaṇamāsaṃ,savanamasam,1,1,0,0,11
668184,āsāḷhīmāsameva,asalhimasameva,1,1,0,0,14
668185,vassukkaḍḍhane,vassukkaddhane,2,2,0,0,14
668186,sattāhakaraṇīyānujānanakathā,sattahakaraniyanujananakatha,2,2,0,0,28
668187,para187-8,para187-8,2,2,0,0,9
668188,sattāhakaraṇīyesu,sattahakaraniyesu,2,2,0,0,17
668189,sattāhakaraṇīyaṃ,sattahakaraniyam,6,6,0,0,16
668190,bhikkhuādīhi,bhikkhuadihi,2,2,0,0,12
668191,pahiteyeva,pahiteyeva,4,4,0,0,10
668192,sannivatto,sannivatto,54,52,2,0,10
668193,sattāheyeva,sattaheyeva,1,1,0,0,11
668194,sannivattitabbo,sannivattitabbo,1,1,0,0,15
668195,uṭṭhāpetabboti,utthapetabboti,6,2,4,0,14
668196,jantāgharasālāti,jantagharasalati,1,1,0,0,16
668197,udositādīni,udositadini,1,0,1,0,11
668198,udositasikkhāpadādīsu,udositasikkhapadadisu,1,1,0,0,21
668199,rasavatīti,rasavatiti,2,0,2,0,10
668200,sañcarittasikkhāpade,sancarittasikkhapade,2,2,0,0,20
668201,parisaṅkhataṃ,parisankhatam,2,1,1,0,13
668202,peyyālakkamo,peyyalakkamo,1,1,0,0,12
668203,vihārādayo,viharadayo,3,3,0,0,10
668204,sikkhamānāyo,sikkhamanayo,4,4,0,0,12
668205,sattappakāresu,sattappakaresu,1,1,0,0,14
668206,P5.1069,P5.1069,1,1,0,0,7
668207,pañcannaṃappahitepianujānanakathā,pancannamappahitepianujananakatha,1,1,0,0,33
668208,sattāhakaraṇīyenāti,sattahakaraniyenati,1,0,1,0,19
668209,bhikkhuādīnaṃ,bhikkhuadinam,6,6,0,0,13
668210,appahitepi,appahitepi,56,56,0,0,10
668211,paṭikassanāraho,patikassanaraho,8,8,0,0,15
668212,mānattāraho,manattaraho,73,72,1,0,11
668213,abbhānāraho,abbhanaraho,55,55,0,0,11
668214,sāmaṇerassāpi,samanerassapi,4,4,0,0,13
668215,anuññātaṭṭhānepi,anunnatatthanepi,1,1,0,0,16
668216,appahite,appahite,27,27,0,0,8
668217,pahiteyevaanujānanakathā,pahiteyevaanujananakatha,2,2,0,0,24
668218,bhikkhugatikoti,bhikkhugatikoti,4,1,3,0,15
668219,vasanakapuriso,vasanakapuriso,3,2,1,0,14
668220,chedāpitaṃ,chedapitam,5,2,3,0,10
668221,dabbasambhārabhaṇḍaṃ,dabbasambharabhandam,2,2,0,0,20
668222,āvahāpeyyuṃ,avahapeyyum,2,1,1,0,11
668223,āharāpeyyuṃ,aharapeyyum,1,1,0,0,11
668224,saṅghakaraṇīyenāti,sanghakaraniyenati,2,0,2,0,18
668225,cetiyachattavedikādīsu,cetiyachattavedikadisu,3,3,0,0,22
668226,puggalikasenāsanampi,puggalikasenasanampi,2,2,0,0,20
668227,saṅghakaraṇīyameva,sanghakaraniyameva,1,1,0,0,18
668228,dabbasambhārādīni,dabbasambharadini,2,2,0,0,17
668229,vaḍḍhakīppabhutīnaṃ,vaddhakippabhutinam,1,1,0,0,19
668230,bhattavetanādīni,bhattavetanadini,2,2,0,0,16
668231,pāḷimuttakaratticchedavinicchayo,palimuttakaratticchedavinicchayo,4,4,0,0,32
668232,animantitena,animantitena,9,6,3,0,12
668233,sannipatitabbaṃ,sannipatitabbam,25,24,1,0,15
668234,P5.1070,P5.1070,1,1,0,0,7
668235,nimantitoyeva,nimantitoyeva,6,5,1,0,13
668236,antarāyeanāpattivassacchedakathā,antarayeanapattivassacchedakatha,1,1,0,0,32
668237,yathāpavattāni,yathapavattani,2,2,0,0,14
668238,pāpuṇāpetvā,papunapetva,6,6,0,0,11
668239,uṭṭhāpayiṃsu,utthapayimsu,3,2,1,0,12
668240,chinnavassehi,chinnavassehi,4,4,0,0,13
668241,chinnavassā,chinnavassa,15,13,2,0,11
668242,upanikkhittakaṃ,upanikkhittakam,3,3,0,0,15
668243,cīvarādivebhaṅgiyabhaṇḍaṃ,civaradivebhangiyabhandam,3,3,0,0,25
668244,khettavatthuādike,khettavatthuadike,2,2,0,0,17
668245,tatruppādepi,tatruppadepi,2,2,0,0,12
668246,saṅghikañhi,sanghikanhi,4,4,0,0,11
668247,vebhaṅgiyabhaṇḍaṃ,vebhangiyabhandam,3,3,0,0,17
668248,P5.1071,P5.1071,1,1,0,0,7
668249,saṅghabhedeanāpattivassacchedakathā,sanghabhedeanapattivassacchedakatha,1,1,0,0,35
668250,vajādīsuvassūpagamanakathā,vajadisuvassupagamanakatha,1,1,0,0,26
668251,vajena,vajena,3,2,1,0,6
668252,vassacchede,vassacchede,27,22,5,0,11
668253,upakaṭṭhāyāti,upakatthayati,3,0,3,0,13
668254,āsannāya,asannaya,6,6,0,0,8
668255,sālāsaṅkhepena,salasankhepena,4,4,0,0,14
668256,ṭhitasakaṭassa,thitasakatassa,3,3,0,0,14
668257,cittuppādamattaṃ,cittuppadamattam,5,5,0,0,16
668258,maggappaṭipanneyeva,maggappatipanneyeva,3,3,0,0,19
668259,pavāraṇadivaso,pavaranadivaso,3,3,0,0,14
668260,patthitaṭṭhānaṃ,patthitatthanam,4,4,0,0,15
668261,upagacchantenāpi,upagacchantenapi,3,3,0,0,16
668262,kuṭiyaṃyeva,kutiyamyeva,3,3,0,0,11
668263,laddhagāmeyeva,laddhagameyeva,6,6,0,0,14
668264,P5.1072,P5.1072,1,1,0,0,7
668265,nāvāyanti,navayanti,4,4,0,0,9
668266,pavāretuñca,pavaretunca,14,12,2,0,11
668267,saṅghabhedapariyantesu,sanghabhedapariyantesu,2,2,0,0,22
668268,rukkhasusireti,rukkhasusireti,2,1,1,0,14
668269,rukkhasusireyeva,rukkhasusireyeva,2,2,0,0,16
668270,rukkhasusirassa,rukkhasusirassa,3,3,0,0,15
668271,padaracchadanaṃ,padaracchadanam,12,11,1,0,15
668272,rūkkhaṃ,rukkham,1,1,0,0,7
668273,khāṇukamatthake,khanukamatthake,2,2,0,0,15
668274,rukkhaviṭabhiyāti,rukkhavitabhiyati,2,1,1,0,17
668275,viṭapamatte,vitapamatte,2,2,0,0,11
668276,mahāviṭape,mahavitape,4,4,0,0,10
668277,asenāsanikenāti,asenasanikenati,2,0,2,0,15
668278,yojitadvārabandhanaṃ,yojitadvarabandhanam,3,3,0,0,20
668279,chavakuṭikāyaṃ,chavakutikayam,2,1,1,0,14
668280,chavakuṭikā,chavakutika,4,3,1,0,11
668281,ṭaṅkitamañcādibhedā,tankitamancadibheda,5,4,1,0,19
668282,chatteti,chatteti,7,1,6,0,8
668283,chattakuṭikā,chattakutika,3,2,1,0,12
668284,cāṭiyāti,catiyati,2,0,2,0,8
668285,kapallena,kapallena,4,4,0,0,9
668286,adhammikakatikādikathā,adhammikakatikadikatha,1,1,0,0,22
668287,katikāti,katikati,6,0,6,0,8
668288,para207-8,para207-8,1,1,0,0,9
668289,uddisāpessāmā,uddisapessama,3,3,0,0,13
668290,P5.1073,P5.1073,1,1,0,0,7
668291,asuddhacittassa,asuddhacittassa,5,5,0,0,15
668292,visaṃvādane,visamvadane,2,2,0,0,11
668293,akaraṇīyotiādīsu,akaraniyotiadisu,2,0,2,0,16
668294,pakkamantassāpi,pakkamantassapi,3,3,0,0,15
668295,vasitvāti,vasitvati,11,4,7,0,9
668296,nirapekkheneva,nirapekkheneva,1,1,0,0,14
668297,navamito,navamito,12,12,0,0,8
668298,vassūpanāyikakkhandhakavaṇṇanā,vassupanayikakkhandhakavannana,4,4,0,0,30
668299,pavāraṇākkhandhakaṃ,pavaranakkhandhakam,2,2,0,0,19
668300,aphāsukavihārakathā,aphasukaviharakatha,2,2,0,0,19
668301,pavāraṇākkhandhake,pavaranakkhandhake,3,3,0,0,18
668302,ālapeyyāma,alapeyyama,4,3,1,0,10
668303,sallapeyyāmāti,sallapeyyamati,1,0,1,0,14
668304,hatthukkhepakena,hatthukkhepakena,1,1,0,0,16
668305,pasusaṃvāsaṃ,pasusamvasam,4,2,2,0,12
668306,pasusaṃvāso,pasusamvaso,2,1,1,0,11
668307,adhammakatikā,adhammakatika,1,1,0,0,13
668308,aññamaññānulomatāti,annamannanulomatati,2,0,2,0,19
668309,anulomabhāvo,anulomabhavo,2,2,0,0,12
668310,P5.1074,P5.1074,1,1,0,0,7
668311,āpattivuṭṭhānatā,apattivutthanata,8,7,1,0,16
668312,vinayapurekkhāratāti,vinayapurekkharatati,6,4,2,0,20
668313,vuṭṭhānabhāvo,vutthanabhavo,2,2,0,0,13
668314,caraṇabhāvo,caranabhavo,2,2,0,0,11
668315,tevācikaṃ,tevacikam,30,29,1,0,9
668316,dvevācikaṃ,dvevacikam,25,24,1,0,10
668317,ekavācikañca,ekavacikanca,6,6,0,0,12
668318,samānavassikaṃ,samanavassikam,24,23,1,0,14
668319,tevācikameva,tevacikameva,3,3,0,0,12
668320,dvevācikañca,dvevacikanca,4,4,0,0,12
668321,tevācikañca,tevacikanca,5,5,0,0,11
668322,samānavassikañca,samanavassikanca,3,3,0,0,16
668323,ekavācikadvevācikatevācikāni,ekavacikadvevacikatevacikani,3,3,0,0,28
668324,samānavassikameva,samanavassikameva,3,3,0,0,17
668325,tadamantarāti,tadamantarati,2,0,2,0,13
668326,pavāraṇābhedakathā,pavaranabhedakatha,2,2,0,0,18
668327,cātuddasikāya,catuddasikaya,2,2,0,0,13
668328,pannarasikāya,pannarasikaya,1,1,0,0,13
668329,pavāraṇakammesu,pavaranakammesu,1,1,0,0,15
668330,gaṇañattiṃ,gananattim,23,21,2,0,10
668331,saṅghañattiṃ,sanghanattim,14,14,0,0,12
668332,adhammenavaggaṃ,adhammenavaggam,3,3,0,0,15
668333,pavāraṇakammaṃ,pavaranakammam,27,27,0,0,14
668334,adhammenasamaggaṃ,adhammenasamaggam,3,3,0,0,17
668335,dhammenavaggaṃ,dhammenavaggam,3,3,0,0,14
668336,P5.1075,P5.1075,1,1,0,0,7
668337,adhiṭṭhānapavāraṇaṃ,adhitthanapavaranam,2,2,0,0,19
668338,dhammenasamaggaṃ,dhammenasamaggam,2,2,0,0,16
668339,pavāraṇakammanti,pavaranakammanti,1,1,0,0,16
668340,pavāraṇādānānujānanakathā,pavaranadananujananakatha,1,1,0,0,25
668341,pavāraṇāhārakena,pavaranaharakena,4,4,0,0,16
668342,chandadānaṃ,chandadanam,12,12,0,0,11
668343,avasesakammatthāya,avasesakammatthaya,2,2,0,0,18
668344,āhaṭāya,ahataya,3,3,0,0,7
668345,pavāritameva,pavaritameva,3,3,0,0,12
668346,pavāraṇameva,pavaranameva,2,2,0,0,12
668347,suppavāritaṃ,suppavaritam,3,3,0,0,12
668348,sesakammāni,sesakammani,5,5,0,0,11
668349,appavāritaṃ,appavaritam,8,6,2,0,11
668350,āgatenapi,agatenapi,2,2,0,0,9
668351,tadahupavāraṇāya,tadahupavaranaya,2,1,1,0,16
668352,saṅghattherato,sanghattherato,6,6,0,0,14
668353,uposathakkhandhakavaṇṇanāyaṃ,uposathakkhandhakavannanayam,1,1,0,0,28
668354,P5.1076,P5.1076,1,1,0,0,7
668355,pannarasikavārepi,pannarasikavarepi,1,1,0,0,17
668356,nissīmaṃ,nissimam,39,36,3,0,8
668357,assāvasāne,assavasane,1,1,0,0,10
668358,ñattiyo,nattiyo,19,19,0,0,7
668359,thokatarā,thokatara,48,46,2,0,9
668360,saṅghapavāraṇāya,sanghapavaranaya,6,6,0,0,16
668361,saṅghapavāraṇāvasena,sanghapavaranavasena,4,4,0,0,20
668362,gaṇañattiyā,gananattiya,4,4,0,0,11
668363,purimavassūpagatehi,purimavassupagatehi,3,3,0,0,19
668364,pacchimavassūpagatā,pacchimavassupagata,4,4,0,0,19
668365,thokatarehi,thokatarehi,7,7,0,0,11
668366,kattikacātumāsiniyā,kattikacatumasiniya,1,1,0,0,19
668367,vassūpagatehi,vassupagatehi,8,8,0,0,13
668368,pavāritehi,pavaritehi,4,4,0,0,10
668369,pavāraṇāñattiṃ,pavarananattim,7,6,1,0,14
668370,P5.1077,P5.1077,1,1,0,0,7
668371,appavāraṇāya,appavaranaya,7,5,2,0,12
668372,kosambakasāmaggīsadisāva,kosambakasamaggisadisava,2,2,0,0,24
668373,pavāraṇāyameva,pavaranayameva,3,3,0,0,14
668374,sāmaggīpavāraṇaṃ,samaggipavaranam,7,7,0,0,16
668375,paṭhamapavāraṇaṃ,pathamapavaranam,2,1,1,0,16
668376,kattikacātumāsinī,kattikacatumasini,4,3,1,0,17
668377,dvevācikādipavāraṇākathā,dvevacikadipavaranakatha,2,2,0,0,24
668378,ṭhapentenāpi,thapentenapi,2,2,0,0,12
668379,ekavācike,ekavacike,2,2,0,0,9
668380,samānavassikepi,samanavassikepi,2,2,0,0,15
668381,samānavassā,samanavassa,4,3,1,0,11
668382,pavāraṇāṭhapanakathā,pavaranathapanakatha,1,1,0,0,20
668383,lapitāya,lapitaya,5,4,1,0,8
668384,apariyositāyāti,apariyositayati,1,0,1,0,15
668385,sabbasaṅgāhikañca,sabbasangahikanca,1,1,0,0,17
668386,puggalikañcāti,puggalikancati,3,3,0,0,14
668387,pavāraṇāṭhapanaṃ,pavaranathapanam,5,5,0,0,16
668388,sabbasaṅgāhike,sabbasangahike,4,4,0,0,14
668389,pavāre,pavare,2,2,0,0,6
668390,sukārato,sukarato,1,1,0,0,8
668391,rekāro,rekaro,3,3,0,0,6
668392,lapitā,lapita,3,2,1,0,6
668393,apariyositāva,apariyositava,4,4,0,0,13
668394,aṭṭhapitā,atthapita,12,12,0,0,9
668395,puggalikaṭhapane,puggalikathapane,2,2,0,0,16
668396,saṅkārato,sankarato,1,1,0,0,9
668397,dvevācikaekavācikasamānavassikāsupi,dvevacikaekavacikasamanavassikasupi,2,2,0,0,35
668398,P5.1078,P5.1078,1,1,0,0,7
668399,ṭikārāvasānaṃyeva,tikaravasanamyeva,1,1,0,0,17
668400,ṭhapanakhettanti,thapanakhettanti,1,1,0,0,16
668401,omadditvāti,omadditvati,4,1,3,0,11
668402,vacanomaddanā,vacanomaddana,1,1,0,0,13
668403,omaddanāti,omaddanati,1,1,0,0,10
668404,anuddhaṃsitaṃ,anuddhamsitam,5,3,2,0,13
668405,nāsetvāti,nasetvati,1,0,1,0,9
668406,paṭikatāti,patikatati,1,0,1,0,10
668407,pavārethāti,pavarethati,1,1,0,0,11
668408,vatthuṭhapanādikathā,vatthuthapanadikatha,1,1,0,0,20
668409,dhuttena,dhuttena,1,1,0,0,8
668410,codessāma,codessama,1,1,0,0,9
668411,pavāretū,pavaretu,1,1,0,0,8
668412,apadisāhīti,apadisahiti,2,2,0,0,11
668413,pavāretu,pavaretu,1,1,0,0,8
668414,P5.1079,P5.1079,1,1,0,0,7
668415,paribhuttaṭṭhānañca,paribhuttatthananca,1,1,0,0,19
668416,nahānaṭṭhānañca,nahanatthananca,1,1,0,0,15
668417,vinicchinitvāva,vinicchinitvava,2,2,0,0,15
668418,avinicchitattā,avinicchitatta,3,3,0,0,14
668419,coditattāti,coditattati,2,2,0,0,11
668420,ukkoṭanakaṃ,ukkotanakam,23,22,1,0,11
668421,ukkoṭentassa,ukkotentassa,5,5,0,0,12
668422,bhaṇḍanakārakavatthukathā,bhandanakarakavatthukatha,2,2,0,0,25
668423,catutthapañcamā,catutthapancama,4,4,0,0,15
668424,catuddasikoyevāti,catuddasikoyevati,1,1,0,0,17
668425,bhaṇḍanakārakānaṃ,bhandanakarakanam,7,5,2,0,17
668426,pannarasīpavāraṇaṃ,pannarasipavaranam,4,2,2,0,18
668427,pavāressanti,pavaressanti,4,4,0,0,12
668428,pavārentehi,pavarentehi,1,1,0,0,11
668429,asaṃvihitāti,asamvihitati,2,0,2,0,12
668430,saṃvidahanarahitā,samvidahanarahita,1,1,0,0,17
668431,āgamanajānanatthāya,agamanajananatthaya,1,1,0,0,19
668432,akatasaṃvidahitā,akatasamvidahita,1,1,0,0,16
668433,aviññātāva,avinnatava,1,1,0,0,10
668434,vikkhitvāti,vikkhitvati,2,0,2,0,11
668435,kilantattha,kilantattha,1,1,0,0,11
668436,anubaddhāva,anubaddhava,1,1,0,0,11
668437,pavāreyyāmāti,pavareyyamati,3,3,0,0,13
668438,P5.1080,P5.1080,1,1,0,0,7
668439,pavāriyamāneti,pavariyamaneti,1,0,1,0,14
668440,pavāriyamāne,pavariyamane,24,24,0,0,12
668441,pavāraṇāsaṅgahakathā,pavaranasangahakatha,2,2,0,0,20
668442,taruṇasamatho,tarunasamatho,2,2,0,0,13
668443,anibaddharattiṭṭhānadivāṭṭhānādibhāvena,anibaddharattitthanadivatthanadibhavena,1,1,0,0,39
668444,samaggakaraṇakāle,samaggakaranakale,2,2,0,0,17
668445,tiṇavatthārakasamathe,tinavattharakasamathe,12,11,1,0,21
668446,pavāraṇāsaṅgaheti,pavaranasangaheti,1,1,0,0,17
668447,pavāraṇāsaṅgaho,pavaranasangaho,10,10,0,0,15
668448,vissaṭṭhakammaṭṭhānānaṃ,vissatthakammatthananam,3,3,0,0,23
668449,thāmagatasamathavipassanānaṃ,thamagatasamathavipassananam,2,2,0,0,28
668450,taruṇasamathavipassanālābhino,tarunasamathavipassanalabhino,2,2,0,0,29
668451,pavāraṇāsaṅgahe,pavaranasangahe,6,6,0,0,15
668452,parihārova,pariharova,3,3,0,0,10
668453,antarāpi,antarapi,10,7,3,0,8
668454,pavāraṇākkhandhakavaṇṇanā,pavaranakkhandhakavannana,3,3,0,0,25
668455,cammakkhandhakaṃ,cammakkhandhakam,4,4,0,0,16
668456,soṇakoḷivisavatthukathā,sonakolivisavatthukatha,2,2,0,0,23
668457,lomānīti,lomaniti,4,0,4,0,8
668458,kammacittīkatāni,kammacittikatani,1,1,0,0,16
668459,jeṭṭhapuriso,jetthapuriso,1,1,0,0,12
668460,uṇṇapāvārakaṃ,unnapavarakam,1,1,0,0,13
668461,pādapuñchanikaṃ,padapunchanikam,4,3,1,0,15
668462,gāmikasahassānaṃ,gamikasahassanam,6,6,0,0,16
668463,P5.1081,P5.1081,1,1,0,0,7
668464,asītigāmikasahassānīti,asitigamikasahassaniti,3,1,2,0,22
668465,asītikulaputtasahassāni,asitikulaputtasahassani,1,1,0,0,23
668466,sannipātāpento,sannipatapento,1,1,0,0,14
668467,idhalokahite,idhalokahite,2,2,0,0,12
668468,anusāsissatīti,anusasissatiti,1,1,0,0,14
668469,paṭivedemīti,pativedemiti,1,0,1,0,12
668470,pāṭikāya,patikaya,3,2,1,0,8
668471,nimujjitvāti,nimujjitvati,3,0,3,0,12
668472,aḍḍhacandapāsāṇe,addhacandapasane,2,2,0,0,16
668473,hitakiriyatthassa,hitakiriyatthassa,1,1,0,0,17
668474,samannāharantīti,samannaharantiti,1,0,1,0,16
668475,gavāghātanaṃ,gavaghatanam,5,3,2,0,12
668476,vādanakusalo,vadanakusalo,1,1,0,0,12
668477,tantissareti,tantissareti,2,0,2,0,12
668478,kharamucchitā,kharamucchita,1,1,0,0,13
668479,vīriyasampayuttasamataṃ,viriyasampayuttasamatam,1,1,0,0,23
668480,yojayamāno,yojayamano,1,1,0,0,10
668481,P5.1082,P5.1082,1,1,0,0,7
668482,byāpajjābhāvato,byapajjabhavato,4,4,0,0,15
668483,maggappaṭivedhena,maggappativedhena,1,1,0,0,17
668484,gahitagahaṇamattaṃ,gahitagahanamattam,1,1,0,0,18
668485,abyāpajjādhimuttoti,abyapajjadhimuttoti,3,0,3,0,19
668486,amissakataṃ,amissakatam,3,3,0,0,11
668487,kilesāhi,kilesahi,1,1,0,0,8
668488,acalanappattaṃ,acalanappattam,3,3,0,0,14
668489,P5.1083,P5.1083,1,1,0,0,7
668490,upādānakkhayassāti,upadanakkhayassati,2,0,2,0,18
668491,akampiyattā,akampiyatta,1,1,0,0,11
668492,diguṇādiupāhanapaṭikkhepakathā,digunadiupahanapatikkhepakatha,2,2,0,0,30
668493,suttavaṇṇanatoyeva,suttavannanatoyeva,1,1,0,0,18
668494,asantameva,asantameva,4,4,0,0,10
668495,ekapalāsikaṃ,ekapalasikam,9,7,2,0,12
668496,ekapaṭalaṃ,ekapatalam,2,2,0,0,10
668497,asītisakaṭavāheti,asitisakatavaheti,2,0,2,0,17
668498,sakaṭabhārā,sakatabhara,2,2,0,0,11
668499,sattahatthikañca,sattahatthikanca,4,2,2,0,16
668500,sattahatthikaṃ,sattahatthikam,2,1,1,0,14
668501,diguṇāti,digunati,4,2,2,0,8
668502,dvipaṭalā,dvipatala,3,3,0,0,9
668503,tipaṭalā,tipatala,2,2,0,0,8
668504,gaṇaṅguṇūpāhanāti,ganangunupahanati,1,0,1,0,17
668505,catupaṭalato,catupatalato,8,8,0,0,12
668506,sabbanīlikādipaṭikkhepakathā,sabbanilikadipatikkhepakatha,2,2,0,0,28
668507,sabbanīlikāti,sabbanilikati,1,0,1,0,13
668508,umāpupphavaṇṇā,umapupphavanna,3,3,0,0,14
668509,pītikā,pitika,3,2,1,0,6
668510,kaṇikārapupphavaṇṇā,kanikarapupphavanna,3,3,0,0,19
668511,mañjiṭṭhavaṇṇā,manjitthavanna,4,4,0,0,14
668512,mahāraṅgarattā,maharangaratta,4,2,2,0,14
668513,satapadipiṭṭhivaṇṇā,satapadipitthivanna,4,4,0,0,19
668514,mahānāmarattā,mahanamaratta,3,2,1,0,13
668515,sambhinnavaṇṇā,sambhinnavanna,3,3,0,0,14
668516,P5.1084,P5.1084,1,1,0,0,7
668517,nīlakavaddhikāti,nilakavaddhikati,2,0,2,0,16
668518,vaddhāyeva,vaddhayeva,4,4,0,0,10
668519,khallakabaddhāti,khallakabaddhati,4,1,3,0,16
668520,paṇhipidhānatthaṃ,panhipidhanattham,4,4,0,0,17
668521,khallakaṃ,khallakam,6,4,2,0,9
668522,puṭabaddhāti,putabaddhati,3,1,2,0,12
668523,yonakaupāhanā,yonakaupahana,3,3,0,0,13
668524,yāvajaṅghato,yavajanghato,2,2,0,0,12
668525,sabbapādaṃ,sabbapadam,3,3,0,0,10
668526,pāliguṇṭhimāti,paligunthimati,2,0,2,0,14
668527,paliguṇṭhitvā,paligunthitva,4,4,0,0,13
668528,tūlapuṇṇikāti,tulapunnikati,2,0,2,0,13
668529,tūlapicunā,tulapicuna,3,3,0,0,10
668530,tittirapattikāti,tittirapattikati,3,0,3,0,16
668531,tittirapattasadisā,tittirapattasadisa,3,3,0,0,18
668532,vicittabaddhā,vicittabaddha,1,1,0,0,13
668533,meṇḍavisāṇavaddhikāti,mendavisanavaddhikati,3,0,3,0,21
668534,kaṇṇikaṭṭhāne,kannikatthane,4,4,0,0,13
668535,meṇḍakasiṅgasaṇṭhāne,mendakasingasanthane,2,2,0,0,20
668536,vaddhe,vaddhe,9,9,0,0,6
668537,vicchikanaṅguṭṭhasaṇṭhāne,vicchikanangutthasanthane,2,2,0,0,25
668538,morapiñchaparisibbitāti,morapinchaparisibbitati,3,0,3,0,23
668539,vaddhesu,vaddhesu,3,3,0,0,8
668540,morapiñchehi,morapinchehi,9,9,0,0,12
668541,suttakasadisehi,suttakasadisehi,3,3,0,0,15
668542,khallakādīni,khallakadini,4,3,1,0,12
668543,sīhacammaparikkhaṭā,sihacammaparikkhata,5,3,2,0,19
668544,lūvakacammaparikkhaṭāti,luvakacammaparikkhatati,1,0,1,0,23
668545,pakkhibiḷālacammaparikkhaṭā,pakkhibilalacammaparikkhata,2,2,0,0,27
668546,omukkaṃ,omukkam,5,3,2,0,7
668547,ajjhārāmeupāhanapaṭikkhepakathā,ajjharameupahanapatikkhepakatha,1,1,0,0,31
668548,abhijīvanikassāti,abhijivanikassati,1,0,1,0,17
668549,abhijīvanti,abhijivanti,2,2,0,0,11
668550,sobheyyāthāti,sobheyyathati,1,1,0,0,13
668551,P5.1085,P5.1085,1,1,0,0,7
668552,yadisaddassa,yadisaddassa,2,2,0,0,12
668553,ācariyesūtiādimhi,acariyesutiadimhi,1,0,1,0,17
668554,nissayācāriyo,nissayacariyo,1,1,0,0,13
668555,uddesācariyoti,uddesacariyoti,2,2,0,0,14
668556,chabbasso,chabbasso,2,2,0,0,9
668557,catuvassakāle,catuvassakale,3,3,0,0,13
668558,ekavassassa,ekavassassa,2,2,0,0,11
668559,duvassassa,duvassassa,2,2,0,0,10
668560,tivassassa,tivassassa,2,2,0,0,10
668561,navavasso,navavasso,2,2,0,0,9
668562,catuvassassa,catuvassassa,2,2,0,0,12
668563,ācariyamattā,acariyamatta,2,1,1,0,12
668564,upajjhāyamattā,upajjhayamatta,3,1,2,0,14
668565,anupāhanesu,anupahanesu,9,9,0,0,11
668566,caṅkamantesu,cankamantesu,3,3,0,0,12
668567,saupāhanassa,saupahanassa,2,2,0,0,12
668568,pādakhīlābādho,padakhilabadho,1,0,1,0,14
668569,khīlasadisaṃ,khilasadisam,1,1,0,0,12
668570,tiṇapādukāti,tinapadukati,3,1,2,0,12
668571,katapādukā,katapaduka,7,7,0,0,10
668572,hintālapādukāti,hintalapadukati,1,0,1,0,15
668573,khajjūrīpattehi,khajjuripattehi,1,1,0,0,15
668574,hintālapattehipi,hintalapattehipi,1,1,0,0,16
668575,kamalapādukāti,kamalapadukati,1,0,1,0,14
668576,kamalatiṇaṃ,kamalatinam,1,1,0,0,11
668577,usīrapādukātipi,usirapadukatipi,1,1,0,0,15
668578,kambalapādukāti,kambalapadukati,1,0,1,0,15
668579,uṇṇāhi,unnahi,5,1,4,0,6
668580,asaṅkamanīyāti,asankamaniyati,2,0,2,0,14
668581,chupantīti,chupantiti,2,0,2,0,10
668582,aṅgajāteneva,angajateneva,1,1,0,0,12
668583,chupanti,chupanti,12,12,0,0,8
668584,yānādipaṭikkhepakathā,yanadipatikkhepakatha,2,2,0,0,21
668585,itthiyuttenāti,itthiyuttenati,3,0,3,0,14
668586,dhenuyuttena,dhenuyuttena,1,1,0,0,12
668587,purisantarenāti,purisantarenati,3,0,3,0,15
668588,purisasārathinā,purisasarathina,2,2,0,0,15
668589,purisayuttenāti,purisayuttenati,1,0,1,0,15
668590,goṇayuttena,gonayuttena,1,1,0,0,11
668591,itthantarenāti,itthantarenati,1,0,1,0,14
668592,itthisārathinā,itthisarathina,1,1,0,0,14
668593,gaṅgāmahiyāyāti,gangamahiyayati,2,0,2,0,15
668594,gaṅgāmahakīḷikāya,gangamahakilikaya,1,1,0,0,17
668595,purisayuttaṃ,purisayuttam,19,13,6,0,12
668596,hatthavaṭṭakaṃ,hatthavattakam,15,10,5,0,14
668597,itthisārathi,itthisarathi,4,2,2,0,12
668598,purisasārathi,purisasarathi,2,2,0,0,13
668599,vaṭṭentu,vattentu,2,2,0,0,8
668600,yānugghātenāti,yanugghatenati,3,1,2,0,14
668601,pīṭhakasivikaṃ,pithakasivikam,6,2,4,0,14
668602,pāṭaṅkiṃ,patankim,7,3,4,0,8
668603,paṭapotalikaṃ,patapotalikam,3,1,2,0,13
668604,uccāsayanamahāsayananānīti,uccasayanamahasayanananiti,1,0,1,0,26
668605,P5.1086,P5.1086,1,1,0,0,7
668606,vānacitro,vanacitro,5,1,4,0,9
668607,uṇṇāmayalohitattharaṇo,unnamayalohitattharano,3,3,0,0,22
668608,pakatitūlikāyeva,pakatitulikayeva,2,2,0,0,16
668609,uddhalomī,uddhalomi,2,2,0,0,9
668610,uṇṇāmayaattharaṇaṃ,unnamayaattharanam,1,1,0,0,18
668611,hatthattharaassattharāti,hatthattharaassattharati,1,0,1,0,24
668612,attharaṇakaattharaṇā,attharanakaattharana,2,2,0,0,20
668613,uttaracchadanena,uttaracchadanena,1,1,0,0,16
668614,P5.1087,P5.1087,1,1,0,0,7
668615,sabbacammapaṭikkhepādikathā,sabbacammapatikkhepadikatha,2,2,0,0,27
668616,dīpicchāpoti,dipicchapoti,1,0,1,0,12
668617,dīpipotako,dipipotako,2,2,0,0,10
668618,ogumphiyantīti,ogumphiyantiti,1,0,1,0,14
668619,bhittidaṇḍakādīsu,bhittidandakadisu,1,1,0,0,17
668620,abhinissāya,abhinissaya,3,1,2,0,11
668621,nisīditunti,nisiditunti,4,4,0,0,11
668622,saupāhanenāti,saupahanenati,2,1,1,0,13
668623,papatake,papatake,4,2,2,0,8
668624,papatanāmake,papatanamake,1,1,0,0,12
668625,kaṇṇapiḷandhanakaṃ,kannapilandhanakam,1,1,0,0,18
668626,atthavevacanaṃ,atthavevacanam,1,1,0,0,14
668627,uttamadamathasamathaṃ,uttamadamathasamatham,5,2,3,0,21
668628,damathañca,damathanca,1,1,0,0,10
668629,kāyūpasamañca,kayupasamanca,1,1,0,0,13
668630,cittūpasamañcātipi,cittupasamancatipi,1,1,0,0,18
668631,visūkāyikavipphanditānaṃ,visukayikavipphanditanam,3,1,2,0,24
668632,khīṇakilesanti,khinakilesanti,1,1,0,0,14
668633,saṃvaraguttiyā,samvaraguttiya,1,1,0,0,14
668634,āguvirahitaṃ,aguvirahitam,2,2,0,0,12
668635,pabbajjādivasato,pabbajjadivasato,2,2,0,0,16
668636,P5.1088,P5.1088,1,1,0,0,7
668637,kaṇhuttarāti,kanhuttarati,2,0,2,0,12
668638,kaṇhamattikuttarā,kanhamattikuttara,2,2,0,0,17
668639,vaḍḍhitakaṇhamattikāti,vaddhitakanhamattikati,1,1,0,0,22
668640,akkantabhūmito,akkantabhumito,1,1,0,0,14
668641,gokaṇṭakehi,gokantakehi,1,1,0,0,11
668642,gokaṇṭake,gokantake,4,4,0,0,9
668643,eragū,eragu,4,3,1,0,5
668644,moragū,moragu,4,3,1,0,6
668645,majjārū,majjaru,4,3,1,0,7
668646,tiṇajātiyo,tinajatiyo,2,2,0,0,10
668647,taṭṭikāyo,tattikayo,1,1,0,0,9
668648,eragūti,eraguti,1,0,1,0,7
668649,erakatiṇaṃ,erakatinam,1,1,0,0,10
668650,moragūtiṇaṃ,moragutinam,1,1,0,0,11
668651,tambasīsaṃ,tambasisam,1,1,0,0,10
668652,vuṭṭhitamatte,vutthitamatte,1,1,0,0,13
668653,majjārunā,majjaruna,1,1,0,0,9
668654,sāṭakepi,satakepi,1,1,0,0,8
668655,jantussa,jantussa,6,6,0,0,8
668656,maṇisadiso,manisadiso,2,2,0,0,10
668657,bhisiṃ,bhisim,39,35,4,0,6
668658,ekāvāse,ekavase,6,5,1,0,7
668659,paridassīti,paridassiti,2,1,1,0,11
668660,paridassesi,paridassesi,1,1,0,0,11
668661,vinayadharapañcamenāti,vinayadharapancamenati,4,0,4,0,22
668662,anussāvanācariyapañcamena,anussavanacariyapancamena,2,2,0,0,25
668663,guṇaṅguṇūpāhananti,gunangunupahananti,2,1,1,0,18
668664,manussacammaṃ,manussacammam,3,3,0,0,13
668665,upāhanakosakasatthakosakakuñcikakosakesupi,upahanakosakasatthakosakakuncikakosakesupi,1,1,0,0,42
668666,attharaṇānīti,attharananiti,1,0,1,0,13
668667,ajacammañca,ajacammanca,2,2,0,0,11
668668,migacamme,migacamme,5,5,0,0,9
668669,kuraṅgamigo,kurangamigo,1,1,0,0,11
668670,migamātuko,migamatuko,3,3,0,0,10
668671,rohitamigoti,rohitamigoti,3,3,0,0,12
668672,P5.1089,P5.1089,1,1,0,0,7
668673,vāḷamigāti,valamigati,5,2,3,0,10
668674,sīhabyagghaacchataracchā,sihabyagghaacchataraccha,5,5,0,0,24
668675,gomahiṃsasasabiḷārādayopi,gomahimsasasabilaradayopi,3,3,0,0,25
668676,vāḷamigātveva,valamigatveva,1,1,0,0,13
668677,adhiṭṭhitañca,adhitthitanca,4,4,0,0,13
668678,dasāhameva,dasahameva,4,4,0,0,10
668679,cammakkhandhakavaṇṇanā,cammakkhandhakavannana,4,4,0,0,22
668680,bhesajjakkhandhakaṃ,bhesajjakkhandhakam,3,3,0,0,19
668681,pañcabhesajjādikathā,pancabhesajjadikatha,2,2,0,0,20
668682,ābādhenāti,abadhenati,2,0,2,0,10
668683,vassodakenapi,vassodakenapi,2,2,0,0,13
668684,kaddamampi,kaddamampi,2,2,0,0,10
668685,ātapopi,atapopi,1,1,0,0,7
668686,koṭṭhabbhantaragataṃ,kotthabbhantaragatam,7,4,3,0,20
668687,āhāratthañca,aharatthanca,10,8,2,0,12
668688,nacchādentīti,nacchadentiti,6,0,6,0,13
668689,jiranti,jiranti,3,3,0,0,7
668690,vātarogaṃ,vatarogam,3,3,0,0,9
668691,senesitānīti,senesitaniti,2,0,2,0,12
668692,bhattācchādakenāti,bhattacchadakenati,2,0,2,0,18
668693,arocikena,arocikena,1,1,0,0,9
668694,nissaggiyavaṇṇanāyaṃ,nissaggiyavannanayam,4,4,0,0,20
668695,P5.1090,P5.1090,1,1,0,0,7
668696,sattāhakālikatelaparibhogena,sattahakalikatelaparibhogena,2,2,0,0,28
668697,khuddakavaṇṇanāyaṃ,khuddakavannanayam,3,3,0,0,18
668698,setavacaṃ,setavacam,3,3,0,0,9
668699,nisadapotakaṃ,nisadapotakam,4,1,3,0,13
668700,pisanasilā,pisanasila,4,4,0,0,10
668701,pisanapoto,pisanapoto,2,2,0,0,10
668702,phaggavaṃ,phaggavam,2,0,2,0,9
668703,nattamālaṃ,nattamalam,3,0,3,0,10
668704,karañjaṃ,karanjam,2,2,0,0,8
668705,hiṅguhiṅgujatuhiṅgusipāṭikā,hinguhingujatuhingusipatika,2,0,2,0,27
668706,hiṅgujātiyoyeva,hingujatiyoyeva,2,2,0,0,15
668707,takatakapattitakapaṇṇiyo,takatakapattitakapanniyo,1,0,1,0,24
668708,lākhājātiyo,lakhajatiyo,2,2,0,0,11
668709,pakatiloṇaṃ,pakatilonam,3,2,1,0,11
668710,dabbasambhārehi,dabbasambharehi,6,6,0,0,15
668711,para264-6,para264-6,1,1,0,0,9
668712,kāyagandho,kayagandho,4,4,0,0,10
668713,sirīsakosumbādicuṇṇāni,sirisakosumbadicunnani,2,2,0,0,22
668714,rajananippakkaṃ,rajananippakkam,4,2,2,0,15
668715,rajanakasaṭaṃ,rajanakasatam,2,2,0,0,13
668716,pākatikacuṇṇampi,pakatikacunnampi,3,3,0,0,16
668717,rajananippakkasaṅkhepameva,rajananippakkasankhepameva,1,1,0,0,26
668718,āmakamaṃsañca,amakamamsanca,2,0,2,0,13
668719,āmakalohitañca,amakalohitanca,2,0,2,0,14
668720,amanussikābādho,amanussikabadho,4,4,0,0,15
668721,kāḷñjanaṃ,kalnjanam,1,0,1,0,9
668722,añjanajāti,anjanajati,2,2,0,0,10
668723,rasañjanaṃ,rasanjanam,4,2,2,0,10
668724,sotañjanaṃ,sotanjanam,4,2,2,0,10
668725,P5.1091,P5.1091,1,1,0,0,7
668726,nadīsotādīsu,nadisotadisu,2,2,0,0,12
668727,geruko,geruko,2,0,2,0,6
668728,suvaṇṇageruko,suvannageruko,2,2,0,0,13
668729,dīpasikhato,dipasikhato,3,3,0,0,11
668730,gahitamasi,gahitamasi,1,1,0,0,10
668731,añjanūpapiṃsanehīti,anjanupapimsanehiti,1,0,1,0,19
668732,piṃsitabbehi,pimsitabbehi,1,1,0,0,12
668733,aññanūpapiṃsanaṃ,annanupapimsanam,1,1,0,0,16
668734,lohitacandanādikaṃ,lohitacandanadikam,2,2,0,0,18
668735,aṭṭhimayaṃ,atthimayam,24,20,4,0,10
668736,avasesaaṭṭhimayaṃ,avasesaatthimayam,2,2,0,0,17
668737,hatthidantādisabbadantamayaṃ,hatthidantadisabbadantamayam,2,2,0,0,28
668738,visāṇamaye,visanamaye,1,0,1,0,10
668739,naḷamayā,nalamaya,1,0,1,0,8
668740,ekantakappiyāyeva,ekantakappiyayeva,2,2,0,0,17
668741,salākaṭṭhāniyaṃ,salakatthaniyam,4,1,3,0,15
668742,susiradaṇḍakaṃ,susiradandakam,2,2,0,0,14
668743,aṃsabaddhakoti,amsabaddhakoti,2,0,2,0,14
668744,añjanitthavikāya,anjanitthavikaya,3,3,0,0,16
668745,aṃsabaddhako,amsabaddhako,16,15,1,0,12
668746,yamakanatthukaraṇiṃ,yamakanatthukaranim,5,2,3,0,19
668747,samasotāhi,samasotahi,1,1,0,0,10
668748,panāḷikāhi,panalikahi,2,2,0,0,10
668749,natthukaraṇiṃ,natthukaranim,3,3,0,0,13
668750,telapākaṃ,telapakam,5,2,3,0,9
668751,bhesajjapakkhittaṃ,bhesajjapakkhittam,2,2,0,0,18
668752,atipakkhittamajjānīti,atipakkhittamajjaniti,2,0,2,0,21
668753,khittamajjāni,khittamajjani,2,2,0,0,13
668754,aṅgavātoti,angavatoti,2,0,2,0,10
668755,sambhārasedaṃ,sambharasedam,4,2,2,0,13
668756,nānāvidhapaṇṇabhaṅgasedaṃ,nanavidhapannabhangasedam,1,1,0,0,25
668757,mahāsedaṃ,mahasedam,4,2,2,0,9
668758,paṃsuvālikādīhi,pamsuvalikadihi,2,2,0,0,15
668759,vātaharaṇapaṇṇāni,vataharanapannani,2,2,0,0,17
668760,telamakkhitena,telamakkhitena,2,2,0,0,14
668761,samparivattantena,samparivattantena,2,2,0,0,17
668762,sedetuṃ,sedetum,2,2,0,0,7
668763,bhaṅgodakaṃ,bhangodakam,5,3,2,0,11
668764,nānāpaṇṇabhaṅgakuthitaṃ,nanapannabhangakuthitam,4,3,1,0,23
668765,sedetabbo,sedetabbo,2,2,0,0,9
668766,udakakoṭṭhe,udakakotthe,2,2,0,0,11
668767,sedakammakaraṇaṃ,sedakammakaranam,2,2,0,0,16
668768,pabbavāto,pabbavato,3,1,2,0,9
668769,P5.1092,P5.1092,1,1,0,0,7
668770,phālitapādā,phalitapada,1,1,0,0,11
668771,nāḷikerādīsu,nalikeradisu,3,2,1,0,12
668772,pacitunti,pacitunti,5,5,0,0,9
668773,kabaḷikaṃ,kabalikam,5,2,3,0,9
668774,vaṇamukhe,vanamukhe,7,7,0,0,9
668775,sattupiṇḍaṃ,sattupindam,4,3,1,0,11
668776,sāsapakuḍḍenāti,sasapakuddenati,1,0,1,0,15
668777,sāsapapiṭṭhena,sasapapitthena,2,2,0,0,14
668778,vaḍḍhamaṃsaṃ,vaddhamamsam,4,2,2,0,12
668779,adhikamaṃsaṃ,adhikamamsam,2,2,0,0,12
668780,loṇasakkharikāya,lonasakkharikaya,4,2,2,0,16
668781,vikāsikaṃ,vikasikam,7,4,3,0,9
668782,telarundhanapilotikaṃ,telarundhanapilotikam,3,3,0,0,21
668783,vaṇaparikammaṃ,vanaparikammam,1,1,0,0,14
668784,sappadaṭṭhasseva,sappadatthasseva,2,2,0,0,16
668785,daṭṭhavise,datthavise,4,4,0,0,10
668786,bhūmippatto,bhumippatto,3,3,0,0,11
668787,gharadinnakābādhoti,gharadinnakabadhoti,4,1,3,0,19
668788,vasīkaraṇapānakasamuṭṭhitarogo,vasikaranapanakasamutthitarogo,2,2,0,0,30
668789,sītāloḷiṃ,sitalolim,5,3,2,0,9
668790,laggamattikaṃ,laggamattikam,3,3,0,0,13
668791,duṭṭhagahaṇikoti,dutthagahanikoti,2,0,2,0,16
668792,vipannagahaṇiko,vipannagahaniko,2,2,0,0,15
668793,āmisakhāraṃ,amisakharam,5,3,2,0,11
668794,sukkhodanaṃ,sukkhodanam,2,2,0,0,11
668795,gomuttaparibhāvitaṃ,gomuttaparibhavitam,7,7,0,0,19
668796,abhisannakāyoti,abhisannakayoti,2,0,2,0,15
668797,ussannadosakāyo,ussannadosakayo,2,2,0,0,15
668798,acchakañjiyaṃ,acchakanjiyam,4,2,2,0,13
668799,taṇḍulodakamaṇḍo,tandulodakamando,2,2,0,0,16
668800,akaṭayusaṃ,akatayusam,1,0,1,0,10
668801,muggapacitapānīyo,muggapacitapaniyo,2,2,0,0,17
668802,kaṭākaṭaṃ,katakatam,5,3,2,0,9
668803,dhotasiniddho,dhotasiniddho,3,3,0,0,13
668804,paṭicchādanīyenāti,paticchadaniyenati,2,0,2,0,18
668805,guḷādianujānanakathā,guladianujananakatha,2,2,0,0,20
668806,pakkāpi,pakkapi,4,3,1,0,7
668807,antovutthaṃ,antovuttham,27,20,7,0,11
668808,P5.1093,P5.1093,1,1,0,0,7
668809,akappiyakuṭiyaṃ,akappiyakutiyam,23,22,1,0,15
668810,sulasipaṇṇāni,sulasipannani,3,3,0,0,13
668811,nibbāpemī,nibbapemi,3,3,0,0,9
668812,pidahitvāva,pidahitvava,3,3,0,0,11
668813,nibbāyatū,nibbayatu,3,3,0,0,9
668814,khīratakkādīsu,khiratakkadisu,4,4,0,0,14
668815,kuthitesu,kuthitesu,4,4,0,0,9
668816,punapākassa,punapakassa,3,3,0,0,11
668817,ukkapiṇḍakāpi,ukkapindakapi,2,1,1,0,13
668818,biḷāmūsikagodhāmaṅgusā,bilamusikagodhamangusa,1,1,0,0,22
668819,damakāti,damakati,1,0,1,0,8
668820,vanaṭṭhaṃ,vanattham,11,8,3,0,9
668821,pokkharaṭṭhaṃ,pokkharattham,10,7,3,0,13
668822,taruṇaphalaṃ,tarunaphalam,3,2,1,0,12
668823,nibbaṭṭabījaṃ,nibbattabijam,11,5,6,0,13
668824,nibbaṭṭetvā,nibbattetva,5,5,0,0,11
668825,ambapanasādi,ambapanasadi,6,6,0,0,12
668826,duropayo,duropayo,2,1,1,0,8
668827,parihareyyaṃ,parihareyyam,2,2,0,0,12
668828,vatthikammaṃ,vatthikammam,19,14,5,0,12
668829,sattikāya,sattikaya,3,3,0,0,9
668830,pāsāṇasakkhalikāya,pasanasakkhalikaya,3,3,0,0,18
668831,satthakammameva,satthakammameva,2,2,0,0,15
668832,vatthipīḷanampi,vatthipilanampi,2,2,0,0,15
668833,vatthikammameva,vatthikammameva,2,2,0,0,15
668834,sambādhassa,sambadhassa,12,10,2,0,11
668835,dvaṅgulāti,dvangulati,1,0,1,0,10
668836,satthakammaṃyeva,satthakammamyeva,3,3,0,0,16
668837,P5.1094,P5.1094,1,1,0,0,7
668838,succhinnaṃ,succhinnam,2,2,0,0,10
668839,aṇḍavuḍḍhirogepi,andavuddhirogepi,2,2,0,0,16
668840,aggitāpanabhesajjālimpanesu,aggitapanabhesajjalimpanesu,1,1,0,0,27
668841,bhesajjamakkhitā,bhesajjamakkhita,2,2,0,0,16
668842,ādānavaṭṭi,adanavatti,2,2,0,0,10
668843,veḷunāḷikā,velunalika,3,3,0,0,10
668844,khārakammaṃ,kharakammam,3,3,0,0,11
668845,māghātoti,maghatoti,2,0,2,0,9
668846,potthanikaṃ,potthanikam,7,3,4,0,11
668847,maṃsacchedanasatthakaṃ,mamsacchedanasatthakam,1,1,0,0,22
668848,kimpimāyāti,kimpimayati,1,0,1,0,11
668849,paṭivekkhīti,pativekkhiti,2,0,2,0,12
668850,paṭipucchīti,patipucchiti,1,1,0,0,12
668851,asukamaṃsanti,asukamamsanti,1,1,0,0,13
668852,paṭipucchanakiccaṃ,patipucchanakiccam,1,1,0,0,18
668853,hatthimaṃsādipaṭikkhepakathā,hatthimamsadipatikkhepakatha,4,4,0,0,28
668854,sunakhamaṃsaṃ,sunakhamamsam,6,5,1,0,13
668855,araññakokā,arannakoka,2,2,0,0,10
668856,sunakhasadisā,sunakhasadisa,1,1,0,0,13
668857,gāmasunakhiyā,gamasunakhiya,1,1,0,0,13
668858,kokena,kokena,1,1,0,0,6
668859,kokasunakhiyā,kokasunakhiya,1,1,0,0,13
668860,gāmasunakhena,gamasunakhena,2,2,0,0,13
668861,apādakassa,apadakassa,1,1,0,0,10
668862,dīghajātikassa,dighajatikassa,1,1,0,0,14
668863,sīhamaṃsā,sihamamsa,1,0,1,0,9
668864,sajātitāya,sajatitaya,1,1,0,0,10
668865,hatthiassamaṃsaṃ,hatthiassamamsam,1,1,0,0,16
668866,rājaṅgatāya,rajangataya,1,1,0,0,11
668867,sunakhamaṃsañca,sunakhamamsanca,1,1,0,0,15
668868,ahimaṃsañca,ahimamsanca,1,1,0,0,11
668869,sīhamaṃsādīni,sihamamsadini,1,1,0,0,13
668870,anupaddavatthāyāti,anupaddavatthayati,3,1,2,0,18
668871,aṭṭhipi,atthipi,3,3,0,0,7
668872,yāgumadhugoḷakādikathā,yagumadhugolakadikatha,2,2,0,0,22
668873,ekattakoti,ekattakoti,1,0,1,0,10
668874,P5.1095,P5.1095,1,1,0,0,7
668875,anumodanāgāthāpariyosāne,anumodanagathapariyosane,1,1,0,0,24
668876,patthayataṃ,patthayatam,3,3,0,0,11
668877,icchataṃ,icchatam,3,3,0,0,8
668878,bhojjayāguṃ,bhojjayagum,8,7,1,0,11
668879,yadaggenāti,yadaggenati,10,0,10,0,11
668880,sagganibbattakapuññaṃ,sagganibbattakapunnam,2,2,0,0,21
668881,paramparabhojanena,paramparabhojanena,4,4,0,0,18
668882,bhojjayāguyā,bhojjayaguya,6,5,1,0,12
668883,avasiṭṭhaguḷe,avasitthagule,1,1,0,0,13
668884,sukhumojaṃ,sukhumojam,2,1,1,0,10
668885,pāṭaligāmavatthukathā,pataligamavatthukatha,2,2,0,0,21
668886,P5.1096,P5.1096,1,1,0,0,7
668887,puṭabhedanaṭṭhānaṃ,putabhedanatthanam,1,1,0,0,18
668888,aññamaññabhedā,annamannabheda,2,2,0,0,14
668889,puthullassa,puthullassa,1,1,0,0,11
668890,uttaritukāmopi,uttaritukamopi,1,1,0,0,14
668891,bhavagamanā,bhavagamana,1,1,0,0,11
668892,sandhāvanā,sandhavana,1,1,0,0,10
668893,pakativaṇṇā,pakativanna,2,2,0,0,11
668894,nīlavilepanānaṃ,nilavilepananam,1,1,0,0,15
668895,P5.1097,P5.1097,1,1,0,0,7
668896,vicittatāvasenetaṃ,vicittatavasenetam,1,1,0,0,18
668897,paṭivaṭṭesīti,pativattesiti,3,0,3,0,13
668898,pahāresi,paharesi,1,1,0,0,8
668899,dajjeyyāthāti,dajjeyyathati,2,1,1,0,13
668900,tāvatiṃsassa,tavatimsassa,1,1,0,0,12
668901,sīhasenāpativatthuādikathā,sihasenapativatthuadikatha,1,1,0,0,26
668902,viññugarahitabbaṃ,vinnugarahitabbam,1,1,0,0,17
668903,sabbakārenāpi,sabbakarenapi,1,1,0,0,13
668904,gārayhakāraṇaṃ,garayhakaranam,3,3,0,0,14
668905,ācikkhitukāmā,acikkhitukama,2,2,0,0,13
668906,āhiṇḍeyyuṃ,ahindeyyum,3,2,1,0,10
668907,P5.1098,P5.1098,1,1,0,0,7
668908,jiridantiti,jiridantiti,1,0,1,0,11
668909,tikoṭiparisuddhakathā,tikotiparisuddhakatha,1,0,1,0,21
668910,saṅghabhedasikkhāpadavaṇṇanāyaṃ,sanghabhedasikkhapadavannanayam,2,2,0,0,31
668911,kappiyabhūmianujānanakathā,kappiyabhumianujananakatha,2,2,0,0,26
668912,sakaṭaparivaṭṭaṃ,sakataparivattam,2,1,1,0,16
668913,ākaṅkhatī,akankhati,6,4,2,0,9
668914,dhuravihāropi,dhuraviharopi,1,1,0,0,13
668915,apalokanenāpi,apalokanenapi,4,4,0,0,13
668916,āmisakhādanatthāya,amisakhadanatthaya,1,1,0,0,18
668917,anuppageyeva,anuppageyeva,1,1,0,0,12
668918,kapilasuttapariyosāne,kapilasuttapariyosane,1,1,0,0,21
668919,ussāvanantikaṃ,ussavanantikam,6,5,1,0,14
668920,ussāvanantikā,ussavanantika,20,12,8,0,13
668921,bhittipāde,bhittipade,7,7,0,0,10
668922,thambhapaṭicchakā,thambhapaticchaka,2,2,0,0,17
668923,bhūmigatikā,bhumigatika,4,3,1,0,11
668924,paṭhamathambhaṃ,pathamathambham,1,1,0,0,15
668925,paṭhamabhittipādaṃ,pathamabhittipadam,2,2,0,0,18
668926,patiṭṭhāpentehi,patitthapentehi,3,3,0,0,15
668927,nicchārentehi,niccharentehi,3,3,0,0,13
668928,patiṭṭhāpentesu,patitthapentesu,2,2,0,0,15
668929,bhittipādo,bhittipado,4,4,0,0,10
668930,kurundimahāpaccarīsu,kurundimahapaccarisu,7,5,2,0,20
668931,kappiyakuṭi,kappiyakuti,25,23,2,0,11
668932,kappiyakuṭī,kappiyakuti,6,6,0,0,11
668933,patiṭṭhāpetabbanti,patitthapetabbanti,1,1,0,0,18
668934,avatvāpi,avatvapi,16,16,0,0,8
668935,thambhapatiṭṭhānañca,thambhapatitthananca,3,3,0,0,20
668936,vacanapariyosānañca,vacanapariyosananca,3,3,0,0,19
668937,avassañhi,avassanhi,3,3,0,0,9
668938,vacananiṭṭhānañca,vacananitthananca,2,2,0,0,17
668939,iṭṭhakasilāmattikākuṭṭikāsu,itthakasilamattikakuttikasu,1,1,0,0,27
668940,uṭṭhāpetukāmā,utthapetukama,2,2,0,0,13
668941,P5.1099,P5.1099,1,1,0,0,7
668942,paṭhamiṭṭhakādīnaṃ,pathamitthakadinam,7,5,2,0,18
668943,iṭṭhakādikuṭṭe,itthakadikutte,2,2,0,0,14
668944,akatāyapi,akatayapi,3,3,0,0,9
668945,gonisādikā,gonisadika,9,5,4,0,10
668946,ārāmagonisādikā,aramagonisadika,4,2,2,0,15
668947,vihāragonisādikāti,viharagonisadikati,2,2,0,0,18
668948,vihāragonisādikā,viharagonisadika,4,0,4,0,16
668949,aparikkhittabhāvoyeva,aparikkhittabhavoyeva,2,2,0,0,21
668950,upaḍḍhaparikkhittopi,upaddhaparikkhittopi,3,3,0,0,20
668951,parikkhittopi,parikkhittopi,7,7,0,0,13
668952,parikkhittoyeva,parikkhittoyeva,4,4,0,0,15
668953,kurundimahaāpaccariyādīsu,kurundimahaapaccariyadisu,1,1,0,0,25
668954,sesasahadhammikānaṃ,sesasahadhammikanam,2,2,0,0,19
668955,antovutthañca,antovutthanca,11,11,0,0,13
668956,saṅghasantakameva,sanghasantakameva,2,2,0,0,17
668957,gahapatikuṭikā,gahapatikutika,2,2,0,0,14
668958,sammutikā,sammutika,3,1,2,0,9
668959,kappiyabhūmīsu,kappiyabhumisu,3,3,0,0,14
668960,antovutthasaṅkhyaṃ,antovutthasankhyam,2,2,0,0,18
668961,antovutthaantopakkamocanatthañhi,antovutthaantopakkamocanatthanhi,2,2,0,0,32
668962,kappiyakuṭiyo,kappiyakutiyo,8,8,0,0,13
668963,P5.1100,P5.1100,1,1,0,0,7
668964,sahaseyyappahonake,sahaseyyappahonake,18,18,0,0,18
668965,taṇḍulādikaṃ,tanduladikam,5,5,0,0,12
668966,nikkhittasappiādīsu,nikkhittasappiadisu,3,3,0,0,19
668967,mukhasannidhi,mukhasannidhi,9,7,2,0,13
668968,ṭhapitasappiñca,thapitasappinca,2,2,0,0,15
668969,yāvajīvikapaṇṇañca,yavajivikapannanca,2,2,0,0,18
668970,antovutthañceva,antovutthanceva,2,2,0,0,15
668971,sāmaṃpākañca,samampakanca,1,1,0,0,12
668972,sabbasaṃsaggā,sabbasamsagga,2,2,0,0,13
668973,jahitavatthukā,jahitavatthuka,20,19,1,0,14
668974,parivattitesu,parivattitesu,2,2,0,0,13
668975,ajahitavatthukāva,ajahitavatthukava,4,4,0,0,17
668976,iṭṭhakādīhi,itthakadihi,18,18,0,0,11
668977,cayassa,cayassa,2,2,0,0,7
668978,bhittiatthāya,bhittiatthaya,2,2,0,0,13
668979,vināsitakāle,vinasitakale,2,2,0,0,12
668980,apanītesupi,apanitesupi,4,4,0,0,11
668981,tadaññāsu,tadannasu,2,2,0,0,9
668982,patiṭṭhitāsu,patitthitasu,1,1,0,0,12
668983,pākārādīhi,pakaradihi,8,8,0,0,10
668984,gopānasīmattaṃ,gopanasimattam,2,2,0,0,14
668985,pakkhapāsakamaṇḍalaṃ,pakkhapasakamandalam,6,3,3,0,20
668986,kappiyabhūmiyo,kappiyabhumiyo,13,13,0,0,14
668987,P5.1101,P5.1101,1,1,0,0,7
668988,karavikatissatthero,karavikatissatthero,3,3,0,0,19
668989,vinayadharapāmokkho,vinayadharapamokkho,2,2,0,0,19
668990,sappikumbhaṃ,sappikumbham,5,5,0,0,12
668991,lūkhadivase,lukhadivase,2,2,0,0,11
668992,bhuñjanatthāyā,bhunjanatthaya,2,2,0,0,14
668993,sahaseyyappahonakaṭṭhāne,sahaseyyappahonakatthane,3,3,0,0,24
668994,avahato,avahato,1,1,0,0,7
668995,para296-9,para296-9,1,1,0,0,9
668996,meṇḍakavatthu,mendakavatthu,1,1,0,0,13
668997,goraseti,goraseti,2,0,2,0,8
668998,ñātipavāritaṭṭhānato,natipavaritatthanato,2,2,0,0,20
668999,aññātikaapavāritaṭṭhānato,annatikaapavaritatthanato,1,1,0,0,25
669000,gamanīye,gamaniye,3,2,1,0,8
669001,keṇiyajaṭilavatthukathā,keniyajatilavatthukatha,2,2,0,0,23
669002,gāhāpetvāti,gahapetvati,8,2,6,0,11
669003,susaṅkhatassa,susankhatassa,1,1,0,0,13
669004,badarapānassa,badarapanassa,1,1,0,0,13
669005,kuṭasahassaṃ,kutasahassam,2,2,0,0,12
669006,apivantā,apivanta,1,1,0,0,8
669007,paccayabāhullikāti,paccayabahullikati,2,1,1,0,18
669008,uppādayittha,uppadayittha,2,2,0,0,12
669009,pānānītiādimāha,pananitiadimaha,1,0,1,0,15
669010,P5.1102,P5.1102,1,1,0,0,7
669011,tadahupaṭiggahitehi,tadahupatiggahitehi,3,3,0,0,19
669012,sāmisaparibhogenāpi,samisaparibhogenapi,5,5,0,0,19
669013,sabbapānesu,sabbapanesu,4,4,0,0,11
669014,phārusakaphalehi,pharusakaphalehi,2,2,0,0,16
669015,sītānipi,sitanipi,4,4,0,0,8
669016,ādiccapākānipi,adiccapakanipi,4,4,0,0,14
669017,aggipākāni,aggipakani,5,5,0,0,10
669018,dhaññaphalarasaṃ,dhannaphalarasam,12,8,4,0,16
669019,ḍākarasaṃ,dakarasam,4,3,1,0,9
669020,pakkaḍākarasaṃ,pakkadakarasam,6,5,1,0,14
669021,yāvakālikapattānañhi,yavakalikapattananhi,2,2,0,0,20
669022,purebhattaṃyeva,purebhattamyeva,2,2,0,0,15
669023,yāvajīvikānaṃ,yavajivikanam,3,3,0,0,13
669024,ṭhapitasappiādīhi,thapitasappiadihi,1,1,0,0,17
669025,suddhaudakena,suddhaudakena,1,1,0,0,13
669026,ḍākarasasaṅkhyameva,dakarasasankhyameva,1,1,0,0,19
669027,yāvakālikapattānampi,yavakalikapattanampi,2,2,0,0,20
669028,kataraso,kataraso,2,2,0,0,8
669029,ādiccapāko,adiccapako,5,5,0,0,10
669030,madhukapuppharasaṃ,madhukapuppharasam,5,4,1,0,18
669031,madhukapuppharaso,madhukapuppharaso,4,4,0,0,17
669032,aggipāko,aggipako,3,3,0,0,8
669033,bhajjitaṃ,bhajjitam,5,5,0,0,9
669034,P5.1103,P5.1103,1,1,0,0,7
669035,ucchuraso,ucchuraso,45,42,3,0,9
669036,nikasaṭo,nikasato,6,5,1,0,8
669037,yaññātiādīsu,yannatiadisu,1,0,1,0,12
669038,rojamallādivatthukathā,rojamalladivatthukatha,2,2,0,0,22
669039,para301-2,para301-2,7,7,0,0,9
669040,rojavatthu,rojavatthu,1,1,0,0,10
669041,bahukatoti,bahukatoti,1,0,1,0,10
669042,buddhādigatapasādabahumānena,buddhadigatapasadabahumanena,1,1,0,0,28
669043,piṭṭhamayaṃ,pitthamayam,2,2,0,0,11
669044,mañjukāti,manjukati,1,0,1,0,9
669045,paṭibhāneyyakāti,patibhaneyyakati,3,1,2,0,16
669046,paṭibhānasampannā,patibhanasampanna,2,2,0,0,17
669047,pariyodātasippāti,pariyodatasippati,3,1,2,0,17
669048,niddosasippā,niddosasippa,2,2,0,0,12
669049,nāḷiyāvāpakenāti,naliyavapakenati,4,0,4,0,16
669050,āvāpakena,avapakena,2,2,0,0,9
669051,āvāpako,avapako,3,2,1,0,7
669052,āvapanti,avapanti,1,1,0,0,8
669053,nahāpitapubbena,nahapitapubbena,8,6,2,0,15
669054,pariharitumeva,pariharitumeva,1,1,0,0,14
669055,chedetuṃ,chedetum,2,2,0,0,8
669056,anahāpitapubbo,anahapitapubbo,2,2,0,0,14
669057,pariharitumpi,pariharitumpi,3,3,0,0,13
669058,chedetumpi,chedetumpi,2,2,0,0,10
669059,dasamabhāgaṃ,dasamabhagam,12,12,0,0,12
669060,porāṇakacārittaṃ,poranakacarittam,4,3,1,0,16
669061,nayaggahaṇatthāya,nayaggahanatthaya,2,2,0,0,17
669062,sattadhaññarasāni,sattadhannarasani,1,1,0,0,17
669063,tālanāḷikerapanasalabujaalābukumbhaṇḍapussaphalatipusaphalaeḷālukāni,talanalikerapanasalabujaalabukumbhandapussaphalatipusaphalaelalukani,2,2,0,0,68
669064,P5.1104,P5.1104,1,1,0,0,7
669065,mahāphalāni,mahaphalani,3,3,0,0,11
669066,dhaññagatikameva,dhannagatikameva,2,2,0,0,16
669067,vettatintiṇikamātuluṅgakapitthakosambakaramandādikhuddakaphalapānāni,vettatintinikamatulungakapitthakosambakaramandadikhuddakaphalapanani,2,2,0,0,68
669068,aṭṭhapānagatikāneva,atthapanagatikaneva,3,3,0,0,19
669069,sānulomaṃ,sanulomam,4,4,0,0,9
669070,phalapānaṃ,phalapanam,3,3,0,0,10
669071,yāmakālikaṃyevāti,yamakalikamyevati,2,2,0,0,17
669072,cīnapaṭṭaṃ,cinapattam,8,7,1,0,10
669073,somārapaṭṭaṃ,somarapattam,8,7,1,0,12
669074,sañjātavatthaṃ,sanjatavattham,13,13,0,0,14
669075,desanāmeneva,desanameneva,6,4,2,0,12
669076,koseyyassānulomāni,koseyyassanulomani,1,1,0,0,18
669077,kappāsikassa,kappasikassa,3,3,0,0,12
669078,lohapatto,lohapatto,2,2,0,0,9
669079,mattikāthālakaṃ,mattikathalakam,2,2,0,0,15
669080,tambalohathālakanti,tambalohathalakanti,5,5,0,0,19
669081,lohatumbo,lohatumbo,2,2,0,0,9
669082,kaṭṭhatumbo,katthatumbo,2,2,0,0,11
669083,phalatumboti,phalatumboti,3,2,1,0,12
669084,kañcanako,kancanako,8,8,0,0,9
669085,udakatumboti,udakatumboti,3,2,1,0,12
669086,pānīyasaṅkhapānīyasarāvakāni,paniyasankhapaniyasaravakani,1,1,0,0,28
669087,paṭṭikā,pattika,23,21,2,0,7
669088,sūkarantanti,sukarantanti,5,5,0,0,12
669089,kāyabandhanāni,kayabandhanani,14,14,0,0,14
669090,katakāyabandhanāni,katakayabandhanani,2,2,0,0,18
669091,paṇṇacchattanti,pannacchattanti,3,3,0,0,15
669092,kappiyākappiyānaṃ,kappiyakappiyanam,3,3,0,0,17
669093,tadahupaṭiggahitaṃ,tadahupatiggahitam,42,36,6,0,18
669094,kappatītiādi,kappatitiadi,2,0,2,0,12
669095,sambhinnarasaṃ,sambhinnarasam,21,17,4,0,14
669096,challimpi,challimpi,3,3,0,0,9
669097,sakaleneva,sakaleneva,3,3,0,0,10
669098,nāḷikeraphalena,nalikeraphalena,3,3,0,0,15
669099,P5.1105,P5.1105,1,1,0,0,7
669100,sappipiṇḍaṃ,sappipindam,4,4,0,0,11
669101,sītalapāyāsaṃ,sitalapayasam,4,4,0,0,13
669102,baddhamadhuphāṇitādīsupi,baddhamadhuphanitadisupi,2,2,0,0,24
669103,takkolajātiphalādīhi,takkolajatiphaladihi,3,3,0,0,20
669104,dinnasiṅgiverādīsupi,dinnasingiveradisupi,3,3,0,0,20
669105,dinnalaṭṭhimadhukādīsupi,dinnalatthimadhukadisupi,3,3,0,0,24
669106,asambhinnarasaṃ,asambhinnarasam,8,7,1,0,15
669107,paṭiggahitampi,patiggahitampi,15,15,0,0,14
669108,yāvakālikañhi,yavakalikanhi,3,3,0,0,13
669109,sambhinnarasāni,sambhinnarasani,7,7,0,0,15
669110,yāmakālikādīni,yamakalikadini,17,17,0,0,14
669111,sattāhakālikādīni,sattahakalikadini,4,4,0,0,17
669112,sattāhakālikampi,sattahakalikampi,3,3,0,0,16
669113,sabhāvaññeva,sabhavanneva,4,4,0,0,12
669114,tadahupaṭiggahitena,tadahupatiggahitena,13,12,1,0,19
669115,purepaṭiggahitaṃ,purepatiggahitam,16,16,0,0,16
669116,dvīhapaṭiggahitena,dvihapatiggahitena,5,5,0,0,18
669117,tīhapaṭiggahitena,tihapatiggahitena,3,3,0,0,17
669118,sattāhapaṭiggahitena,sattahapatiggahitena,4,4,0,0,20
669119,kālayāmasattāhātikkamesu,kalayamasattahatikkamesu,4,4,0,0,24
669120,vikālabhojanasannidhibhesajjasikkhāpadānaṃ,vikalabhojanasannidhibhesajjasikkhapadanam,3,3,0,0,42
669121,kālikesu,kalikesu,17,17,0,0,8
669122,yāmakālikanti,yamakalikanti,5,5,0,0,13
669123,antovutthakañceva,antovutthakanceva,3,3,0,0,17
669124,sannidhikārakañca,sannidhikarakanca,4,4,0,0,17
669125,sattāhakālikañca,sattahakalikanca,5,5,0,0,16
669126,nikkhipitumpi,nikkhipitumpi,7,7,0,0,13
669127,sannidhimpi,sannidhimpi,6,6,0,0,11
669128,bhesajjakkhandhakavaṇṇanā,bhesajjakkhandhakavannana,4,4,0,0,25
669129,kathinakkhandhakaṃ,kathinakkhandhakam,3,3,0,0,18
669130,kathinānujānanakathā,kathinanujananakatha,2,2,0,0,20
669131,pāveyyaraṭṭhavāsino,paveyyaratthavasino,1,1,0,0,19
669132,P5.1106,P5.1106,1,1,0,0,7
669133,vāsinoti,vasinoti,1,1,0,0,8
669134,ekapitukabhātūnaṃ,ekapitukabhatunam,1,1,0,0,17
669135,bhaddavaggiyattherānaṃ,bhaddavaggiyattheranam,1,1,0,0,22
669136,araññavāsamattena,arannavasamattena,2,2,0,0,17
669137,piṇḍapātikādibhāvepi,pindapatikadibhavepi,1,1,0,0,20
669138,sīsavasena,sisavasena,2,2,0,0,10
669139,udakasaṅgaheti,udakasangaheti,1,0,1,0,14
669140,ekodakībhūteti,ekodakibhuteti,1,1,0,0,14
669141,ānisadā,anisada,1,1,0,0,7
669142,cikkhalleti,cikkhalleti,1,1,0,0,11
669143,okapuṇṇehīti,okapunnehiti,2,0,2,0,12
669144,ghanattā,ghanatta,3,3,0,0,8
669145,oghapuṇṇehī,oghapunnehi,1,1,0,0,11
669146,dassanālābhena,dassanalabhena,2,2,0,0,14
669147,ukkaṇṭhitatāya,ukkanthitataya,4,3,1,0,14
669148,anamataggiyakathaṃ,anamataggiyakatham,3,2,1,0,18
669149,nisinnaṭṭhānatoyeva,nisinnatthanatoyeva,1,1,0,0,19
669150,kathinatthāraṃ,kathinattharam,25,23,2,0,14
669151,atthatakathinānaṃ,atthatakathinanam,18,16,2,0,17
669152,atthatakathinānanti,atthatakathinananti,2,2,0,0,19
669153,sāmivacanamevetaṃ,samivacanamevetam,2,2,0,0,17
669154,cīvaruppādo,civaruppado,15,14,1,0,11
669155,atthatakathinā,atthatakathina,6,6,0,0,14
669156,anāmantacāroti,anamantacaroti,6,1,5,0,14
669157,kappissati,kappissati,6,6,0,0,10
669158,P5.1107,P5.1107,1,1,0,0,7
669159,cārittasikkhāpadena,carittasikkhapadena,4,4,0,0,19
669160,asamādānacāroti,asamadanacaroti,5,1,4,0,15
669161,asamādāya,asamadaya,4,4,0,0,9
669162,cīvaravippavāso,civaravippavaso,5,5,0,0,15
669163,kappissatīti,kappissatiti,4,4,0,0,12
669164,gaṇabhojanampi,ganabhojanampi,2,2,0,0,14
669165,yāvadatthacīvaraṃ,yavadatthacivaram,13,9,4,0,17
669166,yāvattakena,yavattakena,1,1,0,0,11
669167,cīvaruppādoti,civaruppadoti,8,2,6,0,13
669168,tatruppādena,tatruppadena,9,8,1,0,12
669169,saṅghikacīvaraṃ,sanghikacivaram,1,1,0,0,15
669170,vutthavassavasena,vutthavassavasena,3,3,0,0,17
669171,gaṇapūrake,ganapurake,14,14,0,0,10
669172,khandhakabhāṇakatherā,khandhakabhanakathera,1,1,0,0,21
669173,kathinadāyakassa,kathinadayakassa,5,5,0,0,16
669174,aññatarappahonakaṃ,annatarappahonakam,4,3,1,0,18
669175,sūriyuggamanasamaye,suriyuggamanasamaye,4,4,0,0,19
669176,P5.1108,P5.1108,1,1,0,0,7
669177,kathinatthārakenāpi,kathinattharakenapi,4,4,0,0,19
669178,attharantena,attharantena,3,3,0,0,12
669179,tantavāyagehato,tantavayagehato,4,4,0,0,15
669180,ābhatasantāneneva,abhatasantaneneva,3,3,0,0,17
669181,khalimakkhitasāṭako,khalimakkhitasatako,3,3,0,0,19
669182,malīnasāṭakopi,malinasatakopi,3,3,0,0,14
669183,kathinatthārasāṭakaṃ,kathinattharasatakam,4,3,1,0,20
669184,sūciādīni,suciadini,7,6,1,0,9
669185,cīvarakammūpakaraṇāni,civarakammupakaranani,3,3,0,0,21
669186,niṭṭhitasūcikammaṃ,nitthitasucikammam,3,3,0,0,18
669187,kathinasāṭakaṃ,kathinasatakam,4,4,0,0,14
669188,kathinānisaṃsavatthāni,kathinanisamsavatthani,7,7,0,0,22
669189,jiṇṇacīvarā,jinnacivara,7,6,1,0,11
669190,vuḍḍhesupi,vuddhesupi,4,4,0,0,10
669191,mahāpariso,mahapariso,5,4,1,0,10
669192,dupaṭṭacīvarassa,dupattacivarassa,11,10,1,0,16
669193,dupaṭṭatthāyeva,dupattatthayeva,4,4,0,0,15
669194,kathinasāṭako,kathinasatako,4,4,0,0,13
669195,dupaṭṭappahonakameva,dupattappahonakameva,4,4,0,0,20
669196,pārupāmī,parupami,4,4,0,0,8
669197,lobhapakatiko,lobhapakatiko,4,4,0,0,13
669198,bhantetiādikā,bhantetiadika,1,0,1,0,13
669199,niṭṭhitaparikammameva,nitthitaparikammameva,4,3,1,0,21
669200,P5.1109,P5.1109,1,1,0,0,7
669201,niṭṭhitaparikammaṃ,nitthitaparikammam,2,2,0,0,18
669202,dhovanasibbanarajanāni,dhovanasibbanarajanani,2,2,0,0,22
669203,niṭṭhāpetabbāni,nitthapetabbani,3,3,0,0,15
669204,buddhappasatthaṃ,buddhappasattham,6,4,2,0,16
669205,padumuttaropi,padumuttaropi,2,2,0,0,13
669206,sujātatthero,sujatatthero,2,2,0,0,12
669207,atthārakena,attharakena,9,9,0,0,11
669208,attharitukāmo,attharitukamo,14,14,0,0,13
669209,paccuddharitabbā,paccuddharitabba,12,12,0,0,16
669210,attharāmī,attharami,22,21,1,0,9
669211,kathinatthārakena,kathinattharakena,11,11,0,0,17
669212,anumodathā,anumodatha,7,7,0,0,10
669213,anumodakehi,anumodakehi,8,8,0,0,11
669214,anumodāmā,anumodama,11,10,1,0,9
669215,vuttavidhāneneva,vuttavidhaneneva,1,1,0,0,16
669216,anumodāpetabbaṃ,anumodapetabbam,3,3,0,0,15
669217,atthārakassa,attharakassa,19,19,0,0,12
669218,atthārā,atthara,12,12,0,0,7
669219,kathinacīvarena,kathinacivarena,5,4,1,0,15
669220,kathinatthārakassa,kathinattharakassa,12,12,0,0,18
669221,sesacīvarānipi,sesacivaranipi,5,5,0,0,14
669222,kathinānisaṃse,kathinanisamse,4,4,0,0,14
669223,balavavatthāni,balavavatthani,9,9,0,0,14
669224,P5.1110,P5.1110,1,1,0,0,7
669225,vassāvāsikaṭṭhitikāya,vassavasikatthitikaya,2,2,0,0,21
669226,ṭhitikāya,thitikaya,83,83,0,0,9
669227,anatthataṃ,anatthatam,33,30,3,0,10
669228,akaraṇīyañceva,akaraniyanceva,1,1,0,0,14
669229,mahābhūmikañca,mahabhumikanca,1,1,0,0,14
669230,anatthatalakkhaṇaṃ,anatthatalakkhanam,2,2,0,0,18
669231,ullikhitamattenātiādike,ullikhitamattenatiadike,1,0,1,0,23
669232,atthatalakkhaṇaṃ,atthatalakkhanam,2,2,0,0,16
669233,ullikhitamattenāti,ullikhitamattenati,2,0,2,0,18
669234,pamāṇaggahaṇamattena,pamanaggahanamattena,1,1,0,0,20
669235,pamāṇañhi,pamananhi,1,1,0,0,9
669236,nakhādīhi,nakhadihi,6,6,0,0,9
669237,ullikhati,ullikhati,1,1,0,0,9
669238,nalāṭādīsu,nalatadisu,1,1,0,0,10
669239,pamāṇaggahaṇaṃ,pamanaggahanam,1,1,0,0,14
669240,ullikhitamattaṃ,ullikhitamattam,1,1,0,0,15
669241,dhovanamattenāti,dhovanamattenati,1,0,1,0,16
669242,kathinadussadhovanamattena,kathinadussadhovanamattena,1,1,0,0,26
669243,cīvaravicāraṇamattenāti,civaravicaranamattenati,1,0,1,0,23
669244,vicāritamattena,vicaritamattena,1,1,0,0,15
669245,chedanamattenāti,chedanamattenati,1,0,1,0,16
669246,yathāvicāritassa,yathavicaritassa,2,2,0,0,16
669247,chedanamattena,chedanamattena,3,3,0,0,14
669248,bandhanamattenāti,bandhanamattenati,1,0,1,0,17
669249,moghasuttakāropanamattena,moghasuttakaropanamattena,1,1,0,0,25
669250,ovaṭṭiyakaraṇamattenāti,ovattiyakaranamattenati,1,0,1,0,23
669251,moghasuttakānusārena,moghasuttakanusarena,1,1,0,0,20
669252,dīghasibbitamattena,dighasibbitamattena,1,1,0,0,19
669253,kaṇḍusakaraṇamattenāti,kandusakaranamattenati,1,0,1,0,22
669254,muddhiyapattabandhanamattena,muddhiyapattabandhanamattena,1,1,0,0,28
669255,daḷhīkammakaraṇamattenāti,dalhikammakaranamattenati,1,0,1,0,25
669256,cimilikāyo,cimilikayo,1,1,0,0,10
669257,sibbitamattena,sibbitamattena,2,2,0,0,14
669258,paṭhamacimilikā,pathamacimilika,2,1,1,0,15
669259,kucchicimilikaṃ,kucchicimilikam,5,3,2,0,15
669260,sibbitamattenātipi,sibbitamattenatipi,1,1,0,0,18
669261,pakaticīvarassa,pakaticivarassa,3,3,0,0,15
669262,upassayadānenā,upassayadanena,1,1,0,0,14
669263,pakatipattabaddhacīvaraṃ,pakatipattabaddhacivaram,1,1,0,0,24
669264,alliyāpanamattenā,alliyapanamattena,1,1,0,0,17
669265,anuvātakaraṇamattenāti,anuvatakaranamattenati,1,0,1,0,22
669266,piṭṭhianuvātāropanamattena,pitthianuvataropanamattena,1,1,0,0,26
669267,paribhaṇḍakaraṇamattenāti,paribhandakaranamattenati,2,0,2,0,25
669268,kucchianauvātāropanamattena,kucchianauvataropanamattena,1,1,0,0,27
669269,ovaddheyyakaraṇamattenāti,ovaddheyyakaranamattenati,1,0,1,0,25
669270,āgantukapattāropanamattena,agantukapattaropanamattena,1,1,0,0,26
669271,P5.1111,P5.1111,1,1,0,0,7
669272,kathinacīvarato,kathinacivarato,3,3,0,0,15
669273,akathinacīvare,akathinacivare,2,2,0,0,14
669274,pattāropanamattena,pattaropanamattena,1,1,0,0,18
669275,kambalamaddanamattenāti,kambalamaddanamattenati,1,0,1,0,23
669276,dantavaṇṇena,dantavannena,3,3,0,0,12
669277,paṇḍupalāsavaṇṇena,pandupalasavannena,1,1,0,0,18
669278,nimittakatenāti,nimittakatenati,1,0,1,0,15
669279,attharissāmī,attharissami,2,2,0,0,12
669280,nimittakatena,nimittakatena,3,3,0,0,13
669281,laddhenā,laddhena,1,1,0,0,8
669282,parikathākatenāti,parikathakatenati,1,0,1,0,17
669283,kathinadāyako,kathinadayako,3,3,0,0,13
669284,atiukkaṭṭhaṃ,atiukkattham,4,3,1,0,12
669285,otiṇṇasadisameva,otinnasadisameva,1,1,0,0,16
669286,kukkukatenāti,kukkukatenati,1,0,1,0,13
669287,tāvakālikena,tavakalikena,1,1,0,0,12
669288,sannidhikatenāti,sannidhikatenati,1,0,1,0,16
669289,karaṇasannidhi,karanasannidhi,5,5,0,0,14
669290,nicayasannidhi,nicayasannidhi,7,6,1,0,14
669291,rattinissaggiyena,rattinissaggiyena,1,1,0,0,17
669292,akappakatenāti,akappakatenati,1,0,1,0,14
669293,anādinnakappabindunā,anadinnakappabinduna,1,1,0,0,20
669294,saṅghāṭiyātiādīsu,sanghatiyatiadisu,1,0,1,0,17
669295,saṅghāṭiuttarāsaṅgaantaravāsake,sanghatiuttarasangaantaravasake,1,1,0,0,31
669296,paccattharaṇādinā,paccattharanadina,3,3,0,0,17
669297,atirekapañcakena,atirekapancakena,6,5,1,0,16
669298,mahāmaṇḍalaaḍḍhamaṇḍalāni,mahamandalaaddhamandalani,1,1,0,0,25
669299,samaṇḍalikataṃ,samandalikatam,2,1,1,0,14
669300,acchinnakena,acchinnakena,1,1,0,0,12
669301,dvatticatukhaṇḍena,dvatticatukhandena,1,1,0,0,18
669302,atthārāti,attharati,1,0,1,0,9
669303,atthāraṃ,attharam,10,10,0,0,8
669304,atthārena,attharena,8,7,1,0,9
669305,nissīmaṭṭho,nissimattho,4,3,1,0,11
669306,anumodatīti,anumodatiti,1,0,1,0,11
669307,bahiupacārasīmāya,bahiupacarasimaya,19,18,1,0,17
669308,ahatenāti,ahatenati,1,0,1,0,9
669309,aparibhuttena,aparibhuttena,1,1,0,0,13
669310,ahatakappenāti,ahatakappenati,2,0,2,0,14
669311,ahatasadisena,ahatasadisena,1,1,0,0,13
669312,dhotena,dhotena,1,1,0,0,7
669313,pilotikāyāti,pilotikayati,1,0,1,0,12
669314,hatavatthakasāṭakena,hatavatthakasatakena,1,1,0,0,20
669315,P5.1112,P5.1112,1,1,0,0,7
669316,paṃsukūlenāti,pamsukulenati,1,0,1,0,13
669317,uppannapaṃsukūlena,uppannapamsukulena,1,1,0,0,18
669318,paṃsukūlikabhikkhunā,pamsukulikabhikkhuna,1,1,0,0,20
669319,laddhacoḷakehi,laddhacolakehi,1,1,0,0,14
669320,katacīvarenātipi,katacivarenatipi,1,1,0,0,16
669321,pāpaṇikenāti,papanikenati,2,0,2,0,12
669322,patitapilotikaṃ,patitapilotikam,1,1,0,0,15
669323,bahuaṭṭhakathāsu,bahuatthakathasu,1,1,0,0,16
669324,pāḷiārūḷhameva,paliarulhameva,1,1,0,0,14
669325,avuccamānena,avuccamanena,3,3,0,0,12
669326,ubbhāraṃ,ubbharam,3,3,0,0,8
669327,janettiyoti,janettiyoti,3,3,0,0,11
669328,kathinubbhārañhi,kathinubbharanhi,2,2,0,0,16
669329,janettiyo,janettiyo,3,3,0,0,9
669330,ādāyasattakakathā,adayasattakakatha,2,2,0,0,17
669331,paccessaṃ,paccessam,236,232,4,0,9
669332,pakkamanantike,pakkamanantike,2,2,0,0,14
669333,kathinuddhāre,kathinuddhare,6,6,0,0,13
669334,cīvarapalibodho,civarapalibodho,39,36,3,0,15
669335,pakkamato,pakkamato,3,3,0,0,9
669336,antosīmāyameva,antosimayameva,4,4,0,0,14
669337,pakkamanantiko,pakkamanantiko,15,12,3,0,14
669338,akatacīvaraṃ,akatacivaram,6,6,0,0,12
669339,bahisīmagatassāti,bahisimagatassati,1,0,1,0,17
669340,senāsanaphāsukaṃ,senasanaphasukam,1,1,0,0,16
669341,sahāyasampattiṃ,sahayasampattim,1,1,0,0,15
669342,niṭṭhānantike,nitthanantike,1,1,0,0,13
669343,niṭṭhānantiko,nitthanantiko,37,34,3,0,13
669344,P5.1113,P5.1113,1,1,0,0,7
669345,sesamātikāvibhajanepi,sesamatikavibhajanepi,1,1,0,0,21
669346,sanniṭṭhānantike,sannitthanantike,3,2,1,0,16
669347,nevimaṃ,nevimam,33,32,1,0,7
669348,paccessanti,paccessanti,9,9,0,0,11
669349,sanniṭṭhānantiko,sannitthanantiko,39,35,4,0,16
669350,sabbakathinuddhāresu,sabbakathinuddharesu,1,1,0,0,20
669351,nāsanantike,nasanantike,1,1,0,0,11
669352,nāsanantiko,nasanantiko,36,32,4,0,11
669353,savanantike,savanantike,1,1,0,0,11
669354,āsāvacchedike,asavacchedike,2,2,0,0,13
669355,cīvarāsāya,civarasaya,35,35,0,0,10
669356,upacchinnāya,upacchinnaya,6,6,0,0,12
669357,anāsāya,anasaya,33,31,2,0,7
669358,uddhārehi,uddharehi,1,1,0,0,9
669359,vomissakadesano,vomissakadesano,1,1,0,0,15
669360,savanantikassa,savanantikassa,1,1,0,0,14
669361,sīmātikkantiko,simatikkantiko,20,16,4,0,14
669362,bahisīme,bahisime,24,19,5,0,8
669363,sahubbhāre,sahubbhare,4,3,1,0,10
669364,para316-325,para316-325,1,1,0,0,11
669365,ādāyavāre,adayavare,1,1,0,0,9
669366,sattakathinuddhāre,sattakathinuddhare,1,1,0,0,18
669367,samādāyavārepi,samadayavarepi,3,2,1,0,14
669368,vippakatacīvarassa,vippakatacivarassa,3,3,0,0,18
669369,ādāyasamādāyavāresupi,adayasamadayavaresupi,1,1,0,0,21
669370,anadhiṭṭhitenā,anadhitthitena,1,1,0,0,14
669371,āsāvacchedikaṃ,asavacchedikam,1,1,0,0,14
669372,disaṃgamiyavasena,disamgamiyavasena,1,1,0,0,17
669373,phāsuvihārikavasena,phasuviharikavasena,1,1,0,0,19
669374,niṭṭhānantikesu,nitthanantikesu,1,1,0,0,15
669375,yujjamānā,yujjamana,1,1,0,0,9
669376,kathinuddhārā,kathinuddhara,23,23,0,0,13
669377,P5.1114,P5.1114,1,1,0,0,7
669378,kathinuddhārena,kathinuddharena,4,4,0,0,15
669379,palibodhātiādimāha,palibodhatiadimaha,1,0,1,0,18
669380,cattenāti,cattenati,1,0,1,0,9
669381,cattena,cattena,5,5,0,0,7
669382,vantamuttesupi,vantamuttesupi,1,0,1,0,14
669383,kathinakkhandhakavaṇṇanā,kathinakkhandhakavannana,4,4,0,0,24
669384,cīvarakkhandhakaṃ,civarakkhandhakam,3,3,0,0,17
669385,jīvakavatthukathā,jivakavatthukatha,2,2,0,0,17
669386,abhisaṭāti,abhisatati,2,0,2,0,10
669387,abhigatāti,abhigatati,2,1,1,0,10
669388,negamoti,negamoti,2,0,2,0,8
669389,kuṭumbiyagaṇo,kutumbiyagano,3,3,0,0,13
669390,sālavatiṃ,salavatim,2,1,1,0,9
669391,vuṭṭhāpesīti,vutthapesiti,3,2,1,0,12
669392,ārāmuyyānavāhanādiparicchedaṃ,aramuyyanavahanadiparicchedam,1,1,0,0,29
669393,gaṇikaṭṭhāne,ganikatthane,1,1,0,0,12
669394,ṭhapesunti,thapesunti,7,7,0,0,10
669395,paṭisatena,patisatena,4,2,2,0,10
669396,paṭivedeyyaṃ,pativedeyyam,3,1,2,0,12
669397,gilānabhāvaṃ,gilanabhavam,3,3,0,0,12
669398,kattarasuppeti,kattarasuppeti,2,0,2,0,14
669399,jiṇṇasuppe,jinnasuppe,2,2,0,0,10
669400,chaṇādīsu,chanadisu,3,3,0,0,9
669401,cuḷamātāmahāmātādayo,culamatamahamatadayo,1,1,0,0,20
669402,nimmātikoyeva,nimmatikoyeva,1,1,0,0,13
669403,sikkheyyanti,sikkheyyanti,1,1,0,0,12
669404,hatthiassasippādīni,hatthiassasippadini,1,1,0,0,19
669405,parūpaghātapaṭisaṃyuttāni,parupaghatapatisamyuttani,1,1,0,0,25
669406,hitapaṭisaṃyuttaṃ,hitapatisamyuttam,2,2,0,0,17
669407,vejjasippameva,vejjasippameva,2,2,0,0,14
669408,P5.1115,P5.1115,1,1,0,0,7
669409,patthataguṇaṃ,patthatagunam,2,1,1,0,13
669410,asukavejjo,asukavejjo,1,1,0,0,10
669411,purimapatthanāya,purimapatthanaya,1,1,0,0,16
669412,codiyamānopesa,codiyamanopesa,1,1,0,0,14
669413,disāpāmokkhoti,disapamokkhoti,5,1,4,0,14
669414,vejjasippācariyo,vejjasippacariyo,1,1,0,0,16
669415,sikkhitunti,sikkhitunti,2,2,0,0,11
669416,sikkhantiyeva,sikkhantiyeva,2,2,0,0,13
669417,dhammantevāsikova,dhammantevasikova,1,1,0,0,17
669418,adhīyantassa,adhiyantassa,3,2,1,0,12
669419,P5.1116,P5.1116,1,1,0,0,7
669420,aggavissāsako,aggavissasako,1,1,0,0,13
669421,bhesajjayojanaṃ,bhesajjayojanam,4,3,1,0,15
669422,sikkhāpemī,sikkhapemi,1,1,0,0,10
669423,avasesarogaṃ,avasesarogam,1,1,0,0,12
669424,bhesajjayogena,bhesajjayogena,1,1,0,0,14
669425,vissaṭṭhamatte,vissatthamatte,5,5,0,0,14
669426,bhaṇetiādimāha,bhanetiadimaha,2,0,2,0,14
669427,pitipitāmahānaṃ,pitipitamahanam,2,2,0,0,15
669428,khīṇapātheyyo,khinapatheyyo,1,1,0,0,13
669429,seṭṭhibhariyādivatthukathā,setthibhariyadivatthukatha,2,2,0,0,26
669430,pasatenāti,pasatenati,1,0,1,0,10
669431,ekahatthapuṭena,ekahatthaputena,1,1,0,0,15
669432,picunāti,picunati,1,0,1,0,8
669433,kappāsapaṭalena,kappasapatalena,1,1,0,0,15
669434,kimpimāyaṃ,kimpimayam,1,0,1,0,10
669435,upajānāmetassa,upajanametassa,2,1,1,0,14
669436,rogūpasamassa,rogupasamassa,2,1,1,0,13
669437,pamāṇayutte,pamanayutte,7,7,0,0,11
669438,abhayakumārassāpi,abhayakumarassapi,1,1,0,0,17
669439,nāṭakānampi,natakanampi,2,2,0,0,11
669440,ayyikānaṃ,ayyikanam,2,1,1,0,9
669441,saratūti,saratuti,2,1,1,0,8
669442,ambavanuyyānañca,ambavanuyyananca,1,1,0,0,16
669443,satasahassauṭṭhānakaṃ,satasahassautthanakam,1,1,0,0,21
669444,mahāsakkārañca,mahasakkaranca,1,1,0,0,14
669445,rājagahaseṭṭhivatthukathā,rajagahasetthivatthukatha,2,2,0,0,25
669446,P5.1117,P5.1117,1,1,0,0,7
669447,iriyāpathasamparivattanena,iriyapathasamparivattanena,1,1,0,0,26
669448,sattāhehi,sattahehi,3,3,0,0,9
669449,saṇṭhahissatīti,santhahissatiti,1,1,0,0,15
669450,sattasattamāse,sattasattamase,1,1,0,0,14
669451,sattasattadivasepi,sattasattadivasepi,1,1,0,0,18
669452,sīsacchaviṃ,sisacchavim,3,2,1,0,11
669453,uppāṭetvāti,uppatetvati,7,0,7,0,11
669454,vināmetvāti,vinametvati,1,0,1,0,11
669455,sattāhehīti,sattahehiti,1,0,1,0,11
669456,pajjotarājavatthukathā,pajjotarajavatthukatha,2,2,0,0,22
669457,vicchikassa,vicchikassa,8,6,2,0,11
669458,vicchikavisapaṭighātāya,vicchikavisapatighataya,1,1,0,0,23
669459,vicchikānaṃ,vicchikanam,8,8,0,0,11
669460,uddekaṃ,uddekam,3,2,1,0,7
669461,uggāraṃ,uggaram,5,4,1,0,7
669462,hatthinīyeva,hatthiniyeva,2,2,0,0,12
669463,celakaṇṇo,celakanno,1,1,0,0,9
669464,muñcakeso,muncakeso,1,1,0,0,9
669465,kāyaveyyāvatikena,kayaveyyavatikena,1,1,0,0,17
669466,vāhanasampanno,vahanasampanno,2,2,0,0,14
669467,vāhanasampatti,vahanasampatti,1,1,0,0,14
669468,pāyetvāti,payetvati,3,0,3,0,9
669469,paricārikānañca,paricarikananca,1,1,0,0,15
669470,āhārācāre,aharacare,2,2,0,0,9
669471,olumpetvāti,olumpetvati,2,0,2,0,11
669472,virecesi,virecesi,3,3,0,0,8
669473,siveyyakadussayugakathā,siveyyakadussayugakatha,4,4,0,0,23
669474,avamaṅgalavatthaṃ,avamangalavattham,1,1,0,0,17
669475,P5.1118,P5.1118,1,1,0,0,7
669476,hatthisoṇḍakasakuṇā,hatthisondakasakuna,1,1,0,0,19
669477,himavantakūṭe,himavantakute,1,1,0,0,13
669478,pajjotena,pajjotena,3,3,0,0,9
669479,aṃsūhi,amsuhi,2,2,0,0,6
669480,vāyitavatthaṃ,vayitavattham,1,1,0,0,13
669481,etantipi,etantipi,1,1,0,0,8
669482,samattiṃsavirecanakathā,samattimsavirecanakatha,4,4,0,0,23
669483,sinehethāti,sinehethati,1,0,1,0,11
669484,lūkhoti,lukhoti,1,1,0,0,7
669485,uppalahatthānīti,uppalahatthaniti,1,0,1,0,16
669486,oḷārikadosaharaṇatthaṃ,olarikadosaharanattham,2,1,1,0,22
669487,majjhimadosaharaṇatthaṃ,majjhimadosaharanattham,1,1,0,0,23
669488,sukhumadosaharaṇatthaṃ,sukhumadosaharanattham,1,1,0,0,22
669489,pakatatte,pakatatte,20,20,0,0,9
669490,sampādesuṃ,sampadesum,2,2,0,0,10
669491,khettaparikammato,khettaparikammato,1,1,0,0,17
669492,asādhāraṇānaṃ,asadharananam,3,3,0,0,13
669493,khīrodakasecanasaṃvaddhānaṃ,khirodakasecanasamvaddhanam,1,1,0,0,27
669494,gandhasālīnaṃ,gandhasalinam,1,1,0,0,13
669495,piṇḍapātagandhaṃ,pindapatagandham,1,1,0,0,16
669496,P5.1119,P5.1119,1,1,0,0,7
669497,piṇḍapātesu,pindapatesu,3,3,0,0,11
669498,bhājanagatesu,bhajanagatesu,3,3,0,0,13
669499,apakkhittojameva,apakkhittojameva,1,1,0,0,16
669500,kulaputtasahassehi,kulaputtasahassehi,1,1,0,0,18
669501,varayācanakathā,varayacanakatha,2,2,0,0,15
669502,atikkantavarāti,atikkantavarati,1,0,1,0,15
669503,paṃsukūlikāva,pamsukulikava,3,3,0,0,13
669504,vatthadānānisaṃsapaṭisaṃyuttāya,vatthadananisamsapatisamyuttaya,1,1,0,0,31
669505,itarītarenāpīti,itaritarenapiti,1,0,1,0,15
669506,appagghenapi,appagghenapi,6,4,2,0,12
669507,mahagghenapi,mahagghenapi,6,4,2,0,12
669508,pāvāroti,pavaroti,5,1,4,0,8
669509,kappāsādibhedo,kappasadibhedo,3,3,0,0,14
669510,kojavaṃ,kojavam,13,8,5,0,7
669511,pakatikojavameva,pakatikojavameva,3,3,0,0,16
669512,mahāpiṭṭhiyakojavaṃ,mahapitthiyakojavam,9,3,6,0,19
669513,mahāpiṭṭhiyakojavanti,mahapitthiyakojavanti,1,1,0,0,21
669514,pāvārasadiso,pavarasadiso,2,2,0,0,12
669515,kambalānujānanādikathā,kambalanujananadikatha,4,4,0,0,22
669516,ekapitikabhātā,ekapitikabhata,1,1,0,0,14
669517,aḍḍhakāsiyaṃ,addhakasiyam,2,0,2,0,12
669518,aḍḍhakāsiyo,addhakasiyo,1,1,0,0,11
669519,upaḍḍhakāsīnaṃ,upaddhakasinam,1,1,0,0,14
669520,asundarāni,asundarani,1,1,0,0,10
669521,P5.1120,P5.1120,1,1,0,0,7
669522,khomādīhi,khomadihi,3,3,0,0,9
669523,vākamayamevātipi,vakamayamevatipi,1,1,0,0,16
669524,pakkamiṃsuyeva,pakkamimsuyeva,2,2,0,0,14
669525,nākāmā,nakama,19,16,3,0,6
669526,āgamentānaṃ,agamentanam,5,5,0,0,11
669527,okkamiṃsūti,okkamimsuti,3,0,3,0,11
669528,okkamiṃsūtipi,okkamimsutipi,2,2,0,0,13
669529,bahimeva,bahimeva,3,3,0,0,8
669530,cīvarapaṭiggāhakanti,civarapatiggahakanti,1,1,0,0,20
669531,gaccheyyātiādīsu,gaccheyyatiadisu,2,0,2,0,16
669532,cīvarapaṭiggāhakesu,civarapatiggahakesu,1,1,0,0,19
669533,ñātakādīnaṃ,natakadinam,17,14,3,0,11
669534,ekaccasmiṃ,ekaccasmim,5,4,1,0,10
669535,lobhapakatikatāya,lobhapakatikataya,1,1,0,0,17
669536,duggatamanussesu,duggatamanussesu,2,2,0,0,16
669537,issarānampi,issaranampi,1,1,0,0,11
669538,cīvarapaṭiggāhakaṭṭhānaṃ,civarapatiggahakatthanam,3,3,0,0,24
669539,santasanto,santasanto,3,2,1,0,10
669540,P5.1121,P5.1121,1,1,0,0,7
669541,idañciṃdañca,idancimdanca,1,1,0,0,12
669542,chandāgatiādivasena,chandagatiadivasena,2,2,0,0,19
669543,ñātakaaññātakaaḍḍhaduggatesu,natakaannatakaaddhaduggatesu,2,2,0,0,28
669544,āgatapaapāṭiyā,agatapaapatiya,1,1,0,0,14
669545,sīlācārapaṭipattiyutto,silacarapatipattiyutto,2,2,0,0,22
669546,vissaṭṭhavācāya,vissatthavacaya,1,1,0,0,15
669547,kammavācāyapi,kammavacayapi,4,4,0,0,13
669548,sabbasaṅghamajjhepi,sabbasanghamajjhepi,5,4,1,0,19
669549,khaṇḍasīmāyapi,khandasimayapi,4,4,0,0,14
669550,dhuravihāraṭṭhāne,dhuraviharatthane,2,2,0,0,17
669551,nisīditabbanti,nisiditabbanti,15,15,0,0,14
669552,cīvaranidahakaṃ,civaranidahakam,7,6,1,0,15
669553,cīvarapaṭisāmakaṃ,civarapatisamakam,2,2,0,0,17
669554,sammutivinicchayopi,sammutivinicchayopi,1,1,0,0,19
669555,kathitānusāreneva,kathitanusareneva,1,1,0,0,17
669556,bhaṇḍāgārasammutiādikathā,bhandagarasammutiadikatha,4,4,0,0,25
669557,ārāmikasāmaṇerādīhi,aramikasamaneradihi,2,2,0,0,19
669558,paccantasenāsanaṃ,paccantasenasanam,3,3,0,0,17
669559,sammannitabbaṃ,sammannitabbam,26,23,3,0,14
669560,guttāguttañca,guttaguttanca,3,2,1,0,13
669561,chadanādīsu,chadanadisu,4,4,0,0,11
669562,mūsikādīnaṃ,musikadinam,4,4,0,0,11
669563,P5.1122,P5.1122,1,1,0,0,7
669564,kaṇṇakitāni,kannakitani,4,4,0,0,11
669565,vātappavesanatthaṃ,vatappavesanattham,2,2,0,0,18
669566,cīvarapaṭiggāhakādīhi,civarapatiggahakadihi,2,2,0,0,21
669567,cīvarapaṭiggāhakena,civarapatiggahakena,4,4,0,0,19
669568,kālacīvaraṃ,kalacivaram,42,40,2,0,11
669569,cīvaranidahakassa,civaranidahakassa,4,4,0,0,17
669570,cīvaranidahakenāpi,civaranidahakenapi,1,1,0,0,18
669571,mukhapuñchanacoḷanti,mukhapunchanacolanti,2,2,0,0,20
669572,ācikkhitvāva,acikkhitvava,2,2,0,0,12
669573,bhaṇḍāgārikenāpi,bhandagarikenapi,1,1,0,0,16
669574,kālacīvarameva,kalacivarameva,2,2,0,0,14
669575,mukhapuñchanacoḷakaṃ,mukhapunchanacolakam,3,3,0,0,20
669576,cīvaranidahako,civaranidahako,7,6,1,0,14
669577,bāhulikatāya,bahulikataya,2,2,0,0,12
669578,saṅghassānuggahāya,sanghassanuggahaya,1,1,0,0,18
669579,bhājeyyuṃ,bhajeyyum,2,2,0,0,9
669580,nāladdhaṃ,naladdham,3,3,0,0,9
669581,avuṭṭhāpanīyā,avutthapaniya,2,2,0,0,13
669582,vuṭṭhāpetabbā,vutthapetabba,4,4,0,0,13
669583,P5.1123,P5.1123,1,1,0,0,7
669584,laddhasenāsanoti,laddhasenasanoti,3,3,0,0,16
669585,bhaṇḍāgārassa,bhandagarassa,12,12,0,0,13
669586,dinnatāya,dinnataya,7,7,0,0,9
669587,bahupakārassa,bahupakarassa,1,1,0,0,13
669588,bhāranitthārakassa,bharanittharakassa,4,4,0,0,18
669589,upakāratāya,upakarataya,3,2,1,0,11
669590,laddhatāya,laddhataya,2,2,0,0,10
669591,sammukhībhūtenāti,sammukhibhutenati,4,0,4,0,17
669592,cīvarabhājanakaṅgesu,civarabhajanakangesu,1,1,0,0,20
669593,apāpuṇantampi,apapunantampi,2,2,0,0,13
669594,pāpuṇantampi,papunantampi,2,2,0,0,12
669595,cīvaradānavattaṃ,civaradanavattam,2,2,0,0,16
669596,navakānampi,navakanampi,2,2,0,0,11
669597,apāpuṇantameva,apapunantameva,1,1,0,0,14
669598,abhājitānī,abhajitani,1,1,0,0,10
669599,bhājitābhājitañca,bhajitabhajitanca,4,4,0,0,17
669600,agghaparicchedaṃ,agghaparicchedam,4,4,0,0,16
669601,ekaagghanakena,ekaagghanakena,3,3,0,0,14
669602,dviagghanakena,dviagghanakena,4,4,0,0,14
669603,diyamāne,diyamane,1,1,0,0,8
669604,P5.1124,P5.1124,1,1,0,0,7
669605,cīvarapaṭivīse,civarapativise,3,3,0,0,14
669606,ekavaggaṃ,ekavaggam,2,2,0,0,9
669607,cīvarapaṭivīsaṃ,civarapativisam,11,9,2,0,15
669608,cīvarapaṭivīsesu,civarapativisesu,4,4,0,0,16
669609,kusapātaṃ,kusapatam,4,4,0,0,9
669610,upaḍḍhapaṭivīsaṃ,upaddhapativisam,9,7,2,0,16
669611,attissarā,attissara,3,3,0,0,9
669612,ācariyupajjhāyānaṃyeva,acariyupajjhayanamyeva,3,3,0,0,22
669613,upaḍḍhabhāgo,upaddhabhago,12,12,0,0,12
669614,piṭṭhisamaye,pitthisamaye,33,31,2,0,12
669615,akālacīvareneva,akalacivareneva,3,3,0,0,15
669616,tatruppādavassāvāsikaṃ,tatruppadavassavasikam,6,5,1,0,22
669617,sammuñjanībandhanādi,sammunjanibandhanadi,2,2,0,0,20
669618,etañhettha,etanhettha,2,2,0,0,10
669619,bhaṇḍāgārikacīvarepi,bhandagarikacivarepi,1,1,0,0,20
669620,raṅgachalliṃ,rangachallim,3,2,1,0,12
669621,samabhāgova,samabhagova,4,4,0,0,11
669622,samapaṭivīso,samapativiso,5,2,3,0,12
669623,uttaritukāmoti,uttaritukamoti,1,0,1,0,14
669624,uttaritukāmo,uttaritukamo,3,3,0,0,12
669625,pakkamitukāmoti,pakkamitukamoti,1,1,0,0,15
669626,anīhatesu,anihatesu,1,1,0,0,9
669627,appahaṭāya,appahataya,1,1,0,0,10
669628,P5.1125,P5.1125,1,1,0,0,7
669629,nīhatesu,nihatesu,1,1,0,0,8
669630,cīvarabhājakena,civarabhajakena,2,2,0,0,15
669631,tulitamiva,tulitamiva,2,2,0,0,10
669632,nātirittaṃ,natirittam,3,3,0,0,10
669633,paṭiggaṇhitabbanti,patigganhitabbanti,1,1,0,0,18
669634,atirekabhāgenāti,atirekabhagenati,2,0,2,0,16
669635,sāṭakāpi,satakapi,3,3,0,0,8
669636,dasagghanakā,dasagghanaka,3,3,0,0,12
669637,dasagghanakavasena,dasagghanakavasena,3,3,0,0,18
669638,dvādasagghanako,dvadasagghanako,3,3,0,0,15
669639,atirekabhāgena,atirekabhagena,3,3,0,0,14
669640,gaṇhantenāpi,ganhantenapi,4,4,0,0,12
669641,anukkhepe,anukkhepe,3,1,2,0,9
669642,anukkhepo,anukkhepo,2,1,1,0,9
669643,anukkhipitabbaṃ,anukkhipitabbam,2,2,0,0,15
669644,kappiyabhaṇḍe,kappiyabhande,6,6,0,0,13
669645,dinneti,dinneti,8,6,2,0,7
669646,vikalake,vikalake,5,2,3,0,8
669647,tosetvāti,tosetvati,5,2,3,0,9
669648,cīvaravikalakaṃ,civaravikalakam,6,4,2,0,15
669649,puggalavikalakanti,puggalavikalakanti,2,2,0,0,18
669650,vikalakā,vikalaka,2,2,0,0,8
669651,chindantehi,chindantehi,3,3,0,0,11
669652,aḍḍhamaṇḍalādīnaṃ,addhamandaladinam,3,3,0,0,17
669653,upāhanatthavikādīnaṃ,upahanatthavikadinam,5,5,0,0,20
669654,caturaṅgulavitthārampi,caturangulavittharampi,3,3,0,0,22
669655,anuvātappahonakāyāmaṃ,anuvatappahonakayamam,3,3,0,0,21
669656,appahonakabhāvo,appahonakabhavo,4,4,0,0,15
669657,tositaṃ,tositam,5,5,0,0,7
669658,kusapāto,kusapato,14,14,0,0,8
669659,cīvaravikalakanti,civaravikalakanti,2,2,0,0,17
669660,puggalavikalakaṃ,puggalavikalakam,4,2,2,0,16
669661,P5.1126,P5.1126,1,1,0,0,7
669662,bhājethā,bhajetha,5,5,0,0,8
669663,cīvaravibhāgo,civaravibhago,2,2,0,0,13
669664,cīvararajanakathā,civararajanakatha,4,4,0,0,17
669665,chakaṇenāti,chakanenati,2,0,2,0,11
669666,paṇḍumattikāyāti,pandumattikayati,2,0,2,0,16
669667,mūlarajanādīsu,mularajanadisu,1,1,0,0,14
669668,mūlarajanaṃ,mularajanam,7,6,1,0,11
669669,mañjiṭṭhiñca,manjitthinca,2,2,0,0,12
669670,tuṅgahārañca,tungaharanca,2,2,0,0,12
669671,khandharajanaṃ,khandharajanam,10,8,2,0,14
669672,tuṅgahāro,tungaharo,2,2,0,0,9
669673,sakaṇṭakarukkho,sakantakarukkho,5,5,0,0,15
669674,haritālavaṇṇaṃ,haritalavannam,5,5,0,0,14
669675,loddañca,loddanca,5,5,0,0,8
669676,kaṇḍulañca,kandulanca,3,3,0,0,10
669677,tacarajanaṃ,tacarajanam,6,5,1,0,11
669678,allipattaṃ,allipattam,1,1,0,0,10
669679,nīlipattañca,nilipattanca,2,2,0,0,12
669680,pattarajanaṃ,pattarajanam,6,5,1,0,12
669681,gihiparibhuttaṃ,gihiparibhuttam,4,3,1,0,15
669682,allipattena,allipattena,4,4,0,0,11
669683,kiṃsukapupphañca,kimsukapupphanca,2,2,0,0,16
669684,kusumbhapupphañca,kusumbhapupphanca,2,2,0,0,17
669685,puppharajanaṃ,puppharajanam,6,5,1,0,13
669686,phalarajane,phalarajane,4,3,1,0,11
669687,sītudakāti,situdakati,3,0,3,0,10
669688,apakkarajanaṃ,apakkarajanam,2,2,0,0,13
669689,uttarāḷumpaṃ,uttaralumpam,8,5,3,0,12
669690,vaṭṭādhārakaṃ,vattadharakam,5,5,0,0,13
669691,rajanakumbhiyā,rajanakumbhiya,4,2,2,0,14
669692,nakhapiṭṭhikāya,nakhapitthikaya,4,2,2,0,15
669693,nakhapiṭṭhiyampi,nakhapitthiyampi,2,2,0,0,16
669694,avisaranto,avisaranto,2,2,0,0,10
669695,rajanuḷuṅkaṃ,rajanulunkam,4,2,2,0,12
669696,rajanauḷuṅkaṃ,rajanaulunkam,4,3,1,0,13
669697,daṇḍakathālakaṃ,dandakathalakam,4,1,3,0,15
669698,sadaṇḍakaṃ,sadandakam,2,2,0,0,10
669699,rajanakolambaṃ,rajanakolambam,4,2,2,0,14
669700,rajanakuṇḍaṃ,rajanakundam,5,2,3,0,12
669701,omaddantīti,omaddantiti,2,0,2,0,11
669702,sammaddanti,sammaddanti,1,1,0,0,11
669703,rajanabindu,rajanabindu,3,3,0,0,11
669704,atirajitattā,atirajitatta,2,2,0,0,12
669705,P5.1127,P5.1127,1,1,0,0,7
669706,madditabbaṃ,madditabbam,3,3,0,0,11
669707,dantakāsāvānīti,dantakasavaniti,3,0,3,0,15
669708,chinnakacīvarānujānanakathā,chinnakacivaranujananakatha,2,2,0,0,27
669709,acchibaddhaṃ,acchibaddham,5,3,2,0,12
669710,caturassakedārakabaddhaṃ,caturassakedarakabaddham,1,1,0,0,24
669711,pāḷibaddhaṃ,palibaddham,7,5,2,0,11
669712,dīghamariyādabaddhaṃ,dighamariyadabaddham,3,2,1,0,20
669713,mariyādabaddhaṃ,mariyadabaddham,5,3,2,0,15
669714,rassamariyādabaddhaṃ,rassamariyadabaddham,2,2,0,0,20
669715,siṅghāṭakabaddhaṃ,singhatakabaddham,7,5,2,0,17
669716,catukkasaṇṭhānanti,catukkasanthananti,2,2,0,0,18
669717,saṃvidahituṃ,samvidahitum,2,1,1,0,12
669718,kusimpi,kusimpi,4,2,2,0,7
669719,nāmātiādīsu,namatiadisu,2,0,2,0,11
669720,kusīti,kusiti,3,1,2,0,6
669721,anuvātādīnaṃ,anuvatadinam,5,3,2,0,12
669722,dīghapattānametaṃ,dighapattanametam,2,2,0,0,17
669723,aḍḍhakusīti,addhakusiti,3,1,2,0,11
669724,rassapattānaṃ,rassapattanam,2,2,0,0,13
669725,pañcakhaṇḍikacīvarassa,pancakhandikacivarassa,2,2,0,0,22
669726,aḍḍhamaṇḍalaṃ,addhamandalam,5,2,3,0,13
669727,khuddakamaṇḍalaṃ,khuddakamandalam,8,8,0,0,16
669728,aḍḍhamaṇḍalañca,addhamandalanca,3,3,0,0,15
669729,anuvivaṭṭaṃ,anuvivattam,8,3,5,0,11
669730,gīvāveṭhanaṭṭhāne,givavethanatthane,3,3,0,0,17
669731,suttasaṃsibbitaṃ,suttasamsibbitam,2,2,0,0,16
669732,āgantukapattaṃ,agantukapattam,11,10,1,0,14
669733,jaṅgheyyakaṃ,jangheyyakam,4,1,3,0,12
669734,jaṅghapāpuṇanaṭṭhāne,janghapapunanatthane,2,2,0,0,20
669735,jaṅghaṭṭhāne,janghatthane,2,2,0,0,12
669736,pattānamevetaṃ,pattanamevetam,1,1,0,0,14
669737,bāhantaṃ,bahantam,8,1,7,0,8
669738,anuvivaṭṭānaṃ,anuvivattanam,4,4,0,0,13
669739,pañcakhaṇḍikacīvarenetaṃ,pancakhandikacivarenetam,2,2,0,0,24
669740,khaṇḍānametaṃ,khandanametam,3,3,0,0,13
669741,suppamāṇaṃ,suppamanam,3,3,0,0,10
669742,pārupantena,parupantena,3,3,0,0,11
669743,ticīvarānujānanakathā,ticivaranujananakatha,2,2,0,0,21
669744,ubbhaṇḍiketi,ubbhandiketi,1,0,1,0,12
669745,ubbhaṇḍe,ubbhande,1,1,0,0,8
669746,ukkhittabhaṇḍā,ukkhittabhanda,3,3,0,0,14
669747,P5.1128,P5.1128,1,1,0,0,7
669748,ukkhittabhaṇḍikabhāvaṃ,ukkhittabhandikabhavam,2,2,0,0,22
669749,āpāditeti,apaditeti,2,1,1,0,9
669750,cīvarabhisiṃ,civarabhisim,10,9,1,0,12
669751,bhisisaṅkhepena,bhisisankhepena,1,1,0,0,15
669752,saṃharitacīvarāni,samharitacivarani,1,1,0,0,17
669753,paṭinivattissatī,patinivattissati,1,1,0,0,16
669754,laddhacīvarāni,laddhacivarani,1,1,0,0,14
669755,antaraṭṭhakāsūti,antaratthakasuti,2,0,2,0,16
669756,mahājanasaññāpanatthaṃ,mahajanasannapanattham,1,1,0,0,22
669757,sītālukāti,sitalukati,3,0,3,0,10
669758,sītapakatikā,sitapakatika,2,2,0,0,12
669759,upacchindituṃ,upacchinditum,7,7,0,0,13
669760,ekaccike,ekaccike,1,1,0,0,8
669761,atirekacīvarādikathā,atirekacivaradikatha,2,2,0,0,20
669762,acchupeyyaṃ,acchupeyyam,7,2,5,0,11
669763,chiddaṭṭhāne,chiddatthane,1,1,0,0,12
669764,laggāpeyyaṃ,laggapeyyam,3,3,0,0,11
669765,ahatakappānaṃ,ahatakappanam,6,3,3,0,13
669766,utuddhaṭānaṃ,utuddhatanam,12,8,4,0,12
669767,uddhaṭānaṃ,uddhatanam,4,4,0,0,10
669768,hatavatthakānaṃ,hatavatthakanam,5,2,3,0,15
669769,pilotikānanti,pilotikananti,4,4,0,0,13
669770,pāpaṇiketi,papaniketi,2,0,2,0,10
669771,patitapilotikacīvare,patitapilotikacivare,3,3,0,0,20
669772,paṭṭasatampi,pattasatampi,3,3,0,0,12
669773,allīyāpanakhaṇḍaṃ,alliyapanakhandam,5,3,2,0,17
669774,kaṇḍusakaṃ,kandusakam,2,1,1,0,10
669775,allīyāpanakaṃ,alliyapanakam,2,2,0,0,13
669776,para349-351,para349-351,3,3,0,0,11
669777,vinicchitameva,vinicchitameva,1,1,0,0,14
669778,saggappattahetukaṃ,saggappattahetukam,2,2,0,0,18
669779,P5.1129,P5.1129,1,1,0,0,7
669780,saggopapannā,saggopapanna,1,1,0,0,12
669781,ekasambhogo,ekasambhogo,1,1,0,0,11
669782,aññataranāmena,annataranamena,1,1,0,0,14
669783,gahitavissāso,gahitavissaso,1,1,0,0,13
669784,pacchimavikappanupagacīvarādikathā,pacchimavikappanupagacivaradikatha,4,4,0,0,34
669785,paṃsukūlakatoti,pamsukulakatoti,1,0,1,0,15
669786,katapaṃsukūlo,katapamsukulo,1,1,0,0,13
669787,jiṇṇajiṇṇaṭṭhāne,jinnajinnatthane,1,1,0,0,16
669788,aggaḷāropanena,aggalaropanena,1,1,0,0,14
669789,vikaṇṇo,vikanno,3,2,1,0,7
669790,sibbantānaṃ,sibbantanam,3,3,0,0,11
669791,saṅghāṭikoṇo,sanghatikono,2,2,0,0,12
669792,vikaṇṇaṃ,vikannam,5,4,1,0,8
669793,dīghakoṇaṃ,dighakonam,1,1,0,0,10
669794,okiriyantīti,okiriyantiti,1,0,1,0,12
669795,chinnakoṇato,chinnakonato,1,1,0,0,12
669796,anuvātañceva,anuvatanceva,1,1,0,0,12
669797,paribhaṇḍañca,paribhandanca,3,3,0,0,13
669798,lujjantīti,lujjantiti,2,0,2,0,10
669799,pattamukhesu,pattamukhesu,1,1,0,0,12
669800,aṭṭhapadakaṃ,atthapadakam,4,2,2,0,12
669801,aṭṭhapadakacchannena,atthapadakacchannena,2,1,1,0,20
669802,pattamukhaṃ,pattamukham,5,3,2,0,11
669803,anvādhikampi,anvadhikampi,9,7,2,0,12
669804,āgantukapattampi,agantukapattampi,4,4,0,0,16
669805,appahonake,appahonake,8,8,0,0,10
669806,chinditabbameva,chinditabbameva,3,3,0,0,15
669807,vinipātetiyeva,vinipatetiyeva,3,3,0,0,14
669808,vassikasaṅketaṃ,vassikasanketam,7,4,3,0,15
669809,aggaḷaguttivihāroti,aggalaguttiviharoti,1,0,1,0,19
669810,gilānavassikasaṅketanadīpāragamanaatthatakathinabhāvesu,gilanavassikasanketanadiparagamanaatthatakathinabhavesu,2,2,0,0,55
669811,aggaḷaguttiyeva,aggalaguttiyeva,5,2,3,0,15
669812,agutte,agutte,1,1,0,0,6
669813,pāsāṇasusira,pasanasusira,1,1,0,0,12
669814,P5.1130,P5.1130,1,1,0,0,7
669815,suppaṭicchannesu,suppaticchannesu,1,1,0,0,16
669816,saṅghikacīvaruppādakathā,sanghikacivaruppadakatha,4,4,0,0,24
669817,cīvarānīti,civaraniti,12,3,9,0,10
669818,haṭānipi,hatanipi,2,2,0,0,8
669819,ubbhārāti,ubbharati,1,0,1,0,9
669820,cīvaramāsameva,civaramasameva,1,1,0,0,14
669821,vassaṃvutthasaṅghassa,vassamvutthasanghassa,17,17,0,0,21
669822,ṭhapitaupanikkhepato,thapitaupanikkhepato,6,6,0,0,20
669823,tatruppādato,tatruppadato,12,12,0,0,12
669824,suggahitameva,suggahitameva,2,2,0,0,13
669825,atthatakathinassa,atthatakathinassa,16,14,2,0,17
669826,anatthatakathinassa,anatthatakathinassa,5,5,0,0,19
669827,cīvaramāsaṃ,civaramasam,6,6,0,0,11
669828,anatthatakathinassāpi,anatthatakathinassapi,4,3,1,0,21
669829,atītavasse,atitavasse,5,5,0,0,10
669830,anāgatavasse,anagatavasse,5,5,0,0,12
669831,utukālaṃ,utukalam,7,5,2,0,8
669832,vassānato,vassanato,9,9,0,0,9
669833,saṅghikāneva,sanghikaneva,11,11,0,0,12
669834,diṭṭhamattamevettha,ditthamattamevettha,2,2,0,0,19
669835,suggahitāni,suggahitani,11,11,0,0,11
669836,suggahitāneva,suggahitaneva,2,2,0,0,13
669837,P5.1131,P5.1131,1,1,0,0,7
669838,bhājetabbāni,bhajetabbani,10,10,0,0,12
669839,mayhimāni,mayhimani,7,7,0,0,9
669840,paṭhamabhāgo,pathamabhago,20,20,0,0,12
669841,dutiyabhāgo,dutiyabhago,7,7,0,0,11
669842,duggahitāni,duggahitani,8,6,2,0,11
669843,ekakoṭṭhāse,ekakotthase,5,5,0,0,11
669844,kusadaṇḍake,kusadandake,3,3,0,0,11
669845,pātitamatte,patitamatte,3,3,0,0,11
669846,anubhāgepi,anubhagepi,2,2,0,0,10
669847,sacīvarānīti,sacivaraniti,1,0,1,0,12
669848,kālacīvarampi,kalacivarampi,4,4,0,0,13
669849,sajjiyamāne,sajjiyamane,2,2,0,0,11
669850,sacīvarāni,sacivarani,2,2,0,0,10
669851,pacchinnadānattā,pacchinnadanatta,1,1,0,0,16
669852,vinayadharapāmokkhatherā,vinayadharapamokkhathera,1,1,0,0,24
669853,dvebhātikavatthunā,dvebhatikavatthuna,1,1,0,0,18
669854,paññattanayeneva,pannattanayeneva,1,1,0,0,16
669855,upanandasakyaputtavatthukathā,upanandasakyaputtavatthukatha,2,2,0,0,29
669856,bhājentā,bhajenta,1,1,0,0,8
669857,cīvarabhājanakālaṃ,civarabhajanakalam,1,1,0,0,18
669858,sādiyissasīti,sadiyissasiti,2,0,2,0,13
669859,sādiyissasī,sadiyissasi,2,2,0,0,11
669860,P5.1132,P5.1132,1,1,0,0,7
669861,ekādhippāyaṃ,ekadhippayam,5,4,1,0,12
669862,puggalapaṭivīsameva,puggalapativisameva,1,1,0,0,19
669863,ekāhamekāhaṃ,ekahamekaham,2,2,0,0,12
669864,aruṇameva,arunameva,9,5,4,0,9
669865,vasitavihārato,vasitaviharato,3,3,0,0,14
669866,nānālābhehi,nanalabhehi,5,3,2,0,11
669867,nānūpacārehi,nanupacarehi,5,3,2,0,12
669868,ekasīmavihārehi,ekasimaviharehi,2,2,0,0,15
669869,nānāsīmavihāre,nanasimavihare,2,2,0,0,14
669870,cīvarapaṭivīso,civarapativiso,27,27,0,0,14
669871,āmisabhesajjādi,amisabhesajjadi,2,2,0,0,15
669872,antosīmagatassa,antosimagatassa,2,2,0,0,15
669873,gilānavatthukathā,gilanavatthukatha,4,4,0,0,17
669874,muttakarīsakiliṭṭhaṃ,muttakarisakilittham,2,1,1,0,20
669875,ovādakārakena,ovadakarakena,2,2,0,0,13
669876,upaṭṭhātabboti,upatthatabboti,5,4,1,0,14
669877,ekasadisanti,ekasadisanti,4,4,0,0,12
669878,upajjhādayo,upajjhadayo,1,1,0,0,11
669879,jaggantesu,jaggantesu,2,2,0,0,10
669880,P5.1133,P5.1133,1,1,0,0,7
669881,jaggissāmīti,jaggissamiti,1,1,0,0,12
669882,abhikkamatītiādīsu,abhikkamatitiadisu,1,0,1,0,18
669883,nāvikarotīti,navikarotiti,2,2,0,0,12
669884,yāgubhattapattacīvarāni,yagubhattapattacivarani,1,1,0,0,23
669885,matasantakakathā,matasantakakatha,4,4,0,0,16
669886,kālaṅkateti,kalankateti,2,0,2,0,11
669887,lahubhaṇḍagarubhaṇḍānaṃ,lahubhandagarubhandanam,1,1,0,0,23
669888,gilānupaṭṭhākalābhe,gilanupatthakalabhe,1,1,0,0,19
669889,saṃvidahanamattameva,samvidahanamattameva,2,2,0,0,20
669890,jeṭṭhakabhāgo,jetthakabhago,2,2,0,0,13
669891,ānītaudakena,anitaudakena,2,2,0,0,12
669892,paṭiggāhāpanamattameva,patiggahapanamattameva,1,1,0,0,22
669893,P5.1134,P5.1134,1,1,0,0,7
669894,gilānupaṭṭhākavasena,gilanupatthakavasena,2,2,0,0,20
669895,gilānupaṭṭhākova,gilanupatthakova,4,4,0,0,16
669896,bhesajjataṇḍulādīni,bhesajjatanduladini,2,2,0,0,19
669897,jaggissāmī,jaggissami,5,5,0,0,10
669898,upaṭṭhākabhāgo,upatthakabhago,2,2,0,0,14
669899,pattacīvaramattameva,pattacivaramattameva,2,2,0,0,20
669900,gilānupaṭṭhākānaṃyeva,gilanupatthakanamyeva,3,3,0,0,21
669901,bahukañceva,bahukanceva,1,1,0,0,11
669902,ticīvaraparikkhāro,ticivaraparikkharo,2,2,0,0,18
669903,saṅghikatova,sanghikatova,2,2,0,0,12
669904,saddhivihārikādīnaṃyeva,saddhiviharikadinamyeva,2,2,0,0,23
669905,kusacīrādipaṭikkhepakathā,kusaciradipatikkhepakatha,4,4,0,0,25
669906,kusacīrādīsu,kusaciradisu,2,2,0,0,12
669907,P5.1135,P5.1135,1,1,0,0,7
669908,akkanāḷaṃ,akkanalam,6,3,3,0,9
669909,akkanāḷamayaṃ,akkanalamayam,3,2,1,0,13
669910,makacimayo,makacimayo,2,2,0,0,10
669911,thullaccayānīti,thullaccayaniti,1,1,0,0,15
669912,akkadussakadalidussaerakadussāni,akkadussakadalidussaerakadussani,1,1,0,0,32
669913,potthakagatikāneva,potthakagatikaneva,2,2,0,0,18
669914,upāhanāsu,upahanasu,3,3,0,0,9
669915,acchinnadasadīghadasāni,acchinnadasadighadasani,3,2,1,0,23
669916,veṭhanepi,vethanepi,3,3,0,0,9
669917,rukkhachallimayaṃ,rukkhachallimayam,2,1,1,0,17
669918,gāhaketi,gahaketi,2,0,2,0,8
669919,saṅghebhinnecīvaruppādakathā,sanghebhinnecivaruppadakatha,1,1,0,0,28
669920,kosambakabhikkhū,kosambakabhikkhu,2,2,0,0,16
669921,dakkhiṇodakañca,dakkhinodakanca,2,2,0,0,15
669922,pakkhassevetaṃ,pakkhassevetam,3,2,1,0,14
669923,cīvarānameva,civaranameva,2,2,0,0,12
669924,anissaroyeva,anissaroyeva,2,2,0,0,12
669925,cīvarapesanavatthūni,civarapesanavatthuni,1,0,1,0,20
669926,aṭṭhacīvaramātikākathā,atthacivaramatikakatha,2,2,0,0,22
669927,vuttacīvarānaṃ,vuttacivaranam,2,2,0,0,14
669928,paṭilābhakhettaṃ,patilabhakhettam,1,1,0,0,16
669929,P5.1136,P5.1136,1,1,0,0,7
669930,puggalādhiṭṭhānanayena,puggaladhitthananayena,7,5,2,0,22
669931,antosīmagatā,antosimagata,2,1,1,0,12
669932,cakkavāḷasīmāti,cakkavalasimati,4,4,0,0,15
669933,sīmākathāyaṃ,simakathayam,5,5,0,0,12
669934,parikkhepārahaṭṭhānena,parikkheparahatthanena,12,10,2,0,22
669935,dhuvasannipātaṭṭhānato,dhuvasannipatatthanato,5,5,0,0,22
669936,ṭhitabhojanasālato,thitabhojanasalato,6,6,0,0,18
669937,nibaddhavasanakaāvāsato,nibaddhavasanakaavasato,5,5,0,0,23
669938,sannipatitabhikkhūhi,sannipatitabhikkhuhi,6,6,0,0,20
669939,upacārasīmāva,upacarasimava,8,8,0,0,13
669940,samānasaṃvāsaavippavāsasīmādvayampi,samanasamvasaavippavasasimadvayampi,1,1,0,0,35
669941,nāmalikhitake,namalikhitake,3,3,0,0,13
669942,gāmanigamanagaraabbhantaraudakukkhepasīmāpi,gamanigamanagaraabbhantaraudakukkhepasimapi,2,1,1,0,43
669943,kāsikosalaraṭṭhādīnaṃ,kasikosalaratthadinam,3,3,0,0,21
669944,P5.1137,P5.1137,1,1,0,0,7
669945,janapadaparicchedo,janapadaparicchedo,5,4,1,0,18
669946,kāsikosalādiraṭṭhaparicchedo,kasikosaladiratthaparicchedo,4,4,0,0,28
669947,coḷabhogo,colabhogo,3,3,0,0,9
669948,keraḷabhogo,keralabhogo,2,2,0,0,11
669949,samuddantena,samuddantena,4,4,0,0,12
669950,paricchinnamahādīpā,paricchinnamahadipa,2,2,0,0,19
669951,cakkavāḷapabbateneva,cakkavalapabbateneva,4,4,0,0,20
669952,antokhaṇḍasīmagatā,antokhandasimagata,2,2,0,0,18
669953,pathavīvemajjhagatassa,pathavivemajjhagatassa,2,2,0,0,22
669954,pāpuṇātiyeva,papunatiyeva,5,5,0,0,12
669955,khaṇḍasīmāsīmantarikāsu,khandasimasimantarikasu,7,7,0,0,23
669956,samānasaṃvāsasīmāya,samanasamvasasimaya,9,8,1,0,19
669957,avippavāsasīmālābhasīmāsu,avippavasasimalabhasimasu,4,4,0,0,25
669958,antogatānaṃ,antogatanam,2,2,0,0,11
669959,gāmasīmādīsu,gamasimadisu,10,10,0,0,12
669960,abbhantarasīmāudakukkhepasīmāsu,abbhantarasimaudakukkhepasimasu,5,4,1,0,31
669961,antogatānaṃyeva,antogatanamyeva,4,4,0,0,15
669962,janapadaraṭṭharajjadīpacakkavāḷasīmāsupi,janapadarattharajjadipacakkavalasimasupi,4,4,0,0,40
669963,tambapaṇṇidīpato,tambapannidipato,4,4,0,0,16
669964,sabhāgabhikkhu,sabhagabhikkhu,3,3,0,0,14
669965,asukasīmāyāti,asukasimayati,1,1,0,0,13
669966,sīmaṭṭhakasaṅghassa,simatthakasanghassa,7,7,0,0,19
669967,katarasīmaṃ,katarasimam,4,4,0,0,11
669968,P5.1138,P5.1138,1,1,0,0,7
669969,asukasīmāti,asukasimati,1,1,0,0,11
669970,sīmaṭṭhakasaṅgho,simatthakasangho,6,6,0,0,16
669971,katarasīmāya,katarasimaya,4,4,0,0,12
669972,avippavāsasīmāyā,avippavasasimaya,4,4,0,0,16
669973,tiyojanāpi,tiyojanapi,5,5,0,0,10
669974,āpucchissati,apucchissati,5,5,0,0,12
669975,tiyojanātikkame,tiyojanatikkame,11,11,0,0,15
669976,ārāmappavesanaṃ,aramappavesanam,3,3,0,0,15
669977,paricchedavaseneva,paricchedavaseneva,2,2,0,0,18
669978,katikāyāti,katikayati,1,0,1,0,10
669979,samānalābhakatikāya,samanalabhakatikaya,2,2,0,0,19
669980,samānalābhā,samanalabha,2,2,0,0,11
669981,saṅgaṇhitukāmā,sanganhitukama,4,4,0,0,14
669982,samānalābhaṃ,samanalabham,5,5,0,0,12
669983,porāṇakoti,poranakoti,1,1,0,0,10
669984,buddhādhivutthoti,buddhadhivutthoti,5,1,4,0,17
669985,appalābhoti,appalabhoti,2,1,1,0,11
669986,ekalābhaṃ,ekalabham,4,4,0,0,9
669987,ekalābhā,ekalabha,3,3,0,0,8
669988,bhikkhāpaññattiyāti,bhikkhapannattiyati,3,0,3,0,19
669989,pariccāgapaññāpanaṭṭhāne,pariccagapannapanatthane,2,2,0,0,24
669990,dhuvakārā,dhuvakara,19,16,3,0,9
669991,kariyantī,kariyanti,2,2,0,0,9
669992,cīvaradāyakassa,civaradayakassa,4,4,0,0,15
669993,pākavaṭṭaṃ,pakavattam,5,3,2,0,10
669994,P5.1139,P5.1139,1,1,0,0,7
669995,dhuvakāre,dhuvakare,8,8,0,0,9
669996,bhikkhugaṇanāya,bhikkhugananaya,10,10,0,0,15
669997,vatthabhesajjādi,vatthabhesajjadi,3,3,0,0,16
669998,bhājiyati,bhajiyati,2,2,0,0,9
669999,senāsanaparibhogabhaṇḍaṃ,senasanaparibhogabhandam,4,4,0,0,24
