90000,kinte,kinte,14,13,1,0,5
90001,upadhī,upadhi,74,64,10,0,6
90002,samatikkantā,samatikkanta,18,18,0,0,12
90003,padālitā,padalita,25,24,1,0,8
90004,etthetaṃ,etthetam,40,32,8,0,8
90005,sampadāniye,sampadaniye,4,4,0,0,11
90006,pañcasvatthesu,pancasvatthesu,1,1,0,0,14
90007,nassā,nassa,16,16,0,0,5
90008,nassaṃ,nassam,15,9,6,0,6
90009,tyāsu,tyasu,16,16,0,0,5
90010,kujjhanti,kujjhanti,32,31,1,0,9
90011,paṇihitā,panihita,15,14,1,0,8
90012,ruhantī,ruhanti,1,1,0,0,7
90013,tyāsū,tyasu,1,1,0,0,5
90014,ñāṇacakkhusammuyhanaṭṭhānabhūtāni,nanacakkhusammuyhanatthanabhutani,1,1,0,0,33
90015,parammukhavacanassa,parammukhavacanassa,1,1,0,0,19
90016,yācassu,yacassu,12,12,0,0,7
90017,tetiādīni,tetiadini,1,0,1,0,9
90018,nenātiādīni,nenatiadini,1,0,1,0,11
90019,parabhāvamhi,parabhavamhi,1,1,0,0,12
90020,diṭṭhāni,ditthani,53,53,0,0,8
90021,paṭinandati,patinandati,11,11,0,0,11
90022,aparattepi,aparattepi,2,2,0,0,10
90023,panevantu,panevantu,1,1,0,0,9
90024,vāde,vade,182,176,6,0,4
90025,labbhare,labbhare,42,38,4,0,8
90026,atthova,atthova,14,14,0,0,7
90027,dhārehi,dharehi,82,76,6,0,7
90028,taṃputto,tamputto,1,1,0,0,8
90029,taṃsadiso,tamsadiso,8,8,0,0,9
90030,tanninno,tanninno,35,31,4,0,8
90031,tappoṇo,tappono,28,26,2,0,7
90032,tappabbhāro,tappabbharo,26,24,2,0,11
90033,tabbhūto,tabbhuto,2,2,0,0,8
90034,tagguṇo,tagguno,4,4,0,0,7
90035,tassadiso,tassadiso,4,4,0,0,9
90036,dvittantu,dvittantu,1,1,0,0,9
90037,etesānaṃ,etesanam,5,4,1,0,8
90038,etamhā,etamha,65,65,0,0,6
90039,etamhi,etamhi,3,3,0,0,6
90040,etāyo,etayo,12,12,0,0,5
90041,etāhi,etahi,49,48,1,0,5
90042,etābhi,etabhi,4,4,0,0,6
90043,parapadenettha,parapadenettha,1,1,0,0,14
90044,samāsopissa,samasopissa,2,2,0,0,11
90045,etadatthāya,etadatthaya,33,31,2,0,11
90046,nidhiyyati,nidhiyyati,1,1,0,0,10
90047,etapparamāyeva,etapparamayeva,5,5,0,0,14
90048,sannipatitā,sannipatita,163,159,4,0,11
90049,imābhi,imabhi,5,5,0,0,6
90050,pakatibhāvena,pakatibhavena,7,7,0,0,13
90051,idappaccayā,idappaccaya,102,88,14,0,11
90052,idappaccayānaṃ,idappaccayanam,17,15,2,0,14
90053,idappaccayatāti,idappaccayatati,17,6,11,0,15
90054,samūhatthaṃ,samuhattham,2,2,0,0,11
90055,saddamāha,saddamaha,2,2,0,0,9
90056,janatāti,janatati,16,2,14,0,8
90057,idappaccayatātveva,idappaccayatatveva,1,1,0,0,18
90058,siyuttare,siyuttare,1,1,0,0,9
90059,amūbhi,amubhi,15,15,0,0,6
90060,dussa,dussa,10,8,2,0,5
90061,amumhā,amumha,8,8,0,0,6
90062,amusmiṃ,amusmim,51,48,3,0,7
90063,amumhi,amumhi,29,25,4,0,6
90064,amūṃ,amum,1,1,0,0,4
90065,khettapālassa,khettapalassa,10,10,0,0,13
90066,rattibhattaṃ,rattibhattam,5,4,1,0,12
90067,apābhataṃ,apabhatam,7,5,2,0,9
90068,dussā,dussa,3,3,0,0,5
90069,padamamhehi,padamamhehi,1,1,0,0,11
90070,kārāgamavasena,karagamavasena,3,3,0,0,14
90071,asabbanāmikarūpāni,asabbanamikarupani,2,2,0,0,18
90072,liṅgattayassa,lingattayassa,1,1,0,0,13
90073,asuke,asuke,16,15,1,0,5
90074,amuke,amuke,1,1,0,0,5
90075,asukāyo,asukayo,2,2,0,0,7
90076,amukāyo,amukayo,2,2,0,0,7
90077,asukānī,asukani,2,2,0,0,7
90078,amukānī,amukani,1,1,0,0,7
90079,asabbanāmikānipi,asabbanamikanipi,2,2,0,0,16
90080,nānattadassanatthaṃ,nanattadassanattham,4,4,0,0,19
90081,kimhi,kimhi,141,129,12,0,5
90082,rūpavisesopettha,rupavisesopettha,1,1,0,0,16
90083,gandhabbe,gandhabbe,10,9,1,0,9
90084,rakkhase,rakkhase,9,8,1,0,8
90085,kimpurise,kimpurise,7,7,0,0,9
90086,mānuse,manuse,106,100,6,0,6
90087,sabbakāmadade,sabbakamadade,4,4,0,0,13
90088,chave,chave,12,11,1,0,5
90089,pāthikaputte,pathikaputte,6,6,0,0,12
90090,sammāsambuddhānaṃ,sammasambuddhanam,77,72,5,0,17
90091,āsādanā,asadana,6,6,0,0,7
90092,kissassa,kissassa,12,8,4,0,8
90093,ekadhammassa,ekadhammassa,32,30,2,0,12
90094,vadhaṃ,vadham,85,77,8,0,6
90095,rocesi,rocesi,43,41,2,0,6
90096,patthitā,patthita,29,28,1,0,8
90097,bodhimuttamā,bodhimuttama,6,6,0,0,12
90098,pāḷisu,palisu,4,4,0,0,6
90099,kvasaddatthe,kvasaddatthe,1,1,0,0,12
90100,iccayaṃ,iccayam,6,5,1,0,7
90101,sāmamaddakkhiṃ,samamaddakkhim,2,2,0,0,14
90102,jīvasi,jivasi,9,9,0,0,6
90103,nipātoti,nipatoti,32,28,4,0,8
90104,icchasī,icchasi,21,20,1,0,7
90105,kānī,kani,3,3,0,0,4
90106,kābhi,kabhi,3,3,0,0,5
90107,etthetassa,etthetassa,1,1,0,0,10
90108,maññathā,mannatha,20,18,2,0,8
90109,garahane,garahane,4,4,0,0,8
90110,aniyame,aniyame,5,5,0,0,7
90111,vakkali,vakkali,113,108,5,0,7
90112,pūtikāyena,putikayena,24,24,0,0,10
90113,nippayojanatāyaṃ,nippayojanatayam,1,1,0,0,16
90114,kāraṇapucchādivasena,karanapucchadivasena,1,1,0,0,20
90115,kāraṇapucchādivasenapi,karanapucchadivasenapi,1,1,0,0,22
90116,santaramānova,santaramanova,15,15,0,0,13
90117,kāsuṃ,kasum,27,24,3,0,5
90118,khaṇasi,khanasi,17,17,0,0,7
90119,tetādiso,tetadiso,80,79,1,0,8
90120,kāraṇapucchāyaṃ,karanapucchayam,2,2,0,0,15
90121,kāsuyā,kasuya,13,12,1,0,6
90122,kiccapucchāyaṃ,kiccapucchayam,1,1,0,0,14
90123,sarūpapucchāyaṃ,sarupapucchayam,1,1,0,0,15
90124,khādasi,khadasi,37,36,1,0,7
90125,pivasī,pivasi,1,1,0,0,6
90126,vatthupucchāyaṃ,vatthupucchayam,1,1,0,0,15
90127,pivasi,pivasi,24,23,1,0,6
90128,kriyāpucchāyaṃ,kriyapucchayam,1,1,0,0,14
90129,adiṭṭhajotanāpucchāti,aditthajotanapucchati,1,1,0,0,21
90130,evamādikā,evamadika,62,62,0,0,9
90131,anāharitabbattā,anaharitabbatta,1,1,0,0,15
90132,anāgatāti,anagatati,31,25,6,0,9
90133,nippayojanatāya,nippayojanataya,2,2,0,0,15
90134,sampaṭicchanapucchāsu,sampaticchanapucchasu,1,1,0,0,21
90135,kiṃsamudayo,kimsamudayo,35,35,0,0,11
90136,kiṃvedano,kimvedano,1,1,0,0,9
90137,kiṃsaññojano,kimsannojano,1,1,0,0,12
90138,vibhattāni,vibhattani,77,76,1,0,10
90139,saddamayāni,saddamayani,1,1,0,0,11
90140,pakatibhāveneva,pakatibhaveneva,9,7,2,0,15
90141,ravena,ravena,7,7,0,0,6
90142,iccādettha,iccadettha,2,2,0,0,10
90143,sahaññena,sahannena,1,1,0,0,9
90144,kiṃcitto,kimcitto,30,29,1,0,8
90145,sarūpamavijahanto,sarupamavijahanto,1,1,0,0,17
90146,kiṃcittaṃ,kimcittam,1,1,0,0,9
90147,saddanicchāraṇaṃ,saddaniccharanam,1,1,0,0,16
90148,kiṃkāro,kimkaro,1,1,0,0,7
90149,paṭissāvetīti,patissavetiti,3,3,0,0,13
90150,kiṃkārapaṭissāvinītiādi,kimkarapatissavinitiadi,1,0,1,0,23
90151,kiṃpakkamiva,kimpakkamiva,5,4,1,0,12
90152,bhakkhitaṃ,bhakkhitam,7,6,1,0,10
90153,nibbacanamappasiddhaṃ,nibbacanamappasiddham,1,1,0,0,21
90154,padāvayavabhāvena,padavayavabhavena,2,2,0,0,17
90155,nukho,nukho,71,69,2,0,5
90156,sahacāribhāvena,sahacaribhavena,1,1,0,0,15
90157,kimpurisānuciṇṇo,kimpurisanucinno,3,3,0,0,16
90158,kiṃsuchetvā,kimsuchetva,1,1,0,0,11
90159,pamajjasi,pamajjasi,8,8,0,0,9
90160,kiñhi,kinhi,86,68,18,0,5
90161,cajantassa,cajantassa,7,7,0,0,10
90162,adadamappakanti,adadamappakanti,1,1,0,0,15
90163,padāvayavo,padavayavo,3,2,1,0,10
90164,nvā,nva,2,0,2,0,3
90165,sambhavopi,sambhavopi,6,6,0,0,10
90166,sabbanāmikabhāve,sabbanamikabhave,1,1,0,0,16
90167,ṭhitehi,thitehi,90,90,0,0,7
90168,liṅgattayamissakaparicchede,lingattayamissakaparicchede,1,1,0,0,27
90169,asabbanāmikattā,asabbanamikatta,1,1,0,0,15
90170,vibhatto,vibhatto,229,226,3,0,8
90171,brahmavātakāyatthavācako,brahmavatakayatthavacako,1,1,0,0,24
90172,sirojalasukhatthavācako,sirojalasukhatthavacako,1,1,0,0,23
90173,asabbanāmikāni,asabbanamikani,1,1,0,0,14
90174,saddamayattā,saddamayatta,1,1,0,0,12
90175,sabbanāmikarūpasaṅkhātehi,sabbanamikarupasankhatehi,1,1,0,0,25
90176,asādhāraṇarūpehi,asadharanarupehi,1,1,0,0,16
90177,virahitattā,virahitatta,23,22,1,0,11
90178,pucchatthato,pucchatthato,1,1,0,0,12
90179,atthantaravācakattā,atthantaravacakatta,1,1,0,0,19
90180,samānasutivasena,samanasutivasena,1,1,0,0,16
90181,sabbanāmikatte,sabbanamikatte,1,1,0,0,14
90182,suddhanāmatte,suddhanamatte,1,1,0,0,13
90183,saddoyevāti,saddoyevati,3,3,0,0,11
90184,jalasukhesu,jalasukhesu,1,1,0,0,11
90185,sabbanāmabhūtānaṃ,sabbanamabhutanam,1,1,0,0,17
90186,kiṃka,kimka,2,1,1,0,5
90187,vuttappakārānaṃ,vuttappakaranam,43,43,0,0,15
90188,paññāvepullakaraṇo,pannavepullakarano,1,1,0,0,18
90189,kiṃpakkena,kimpakkena,1,1,0,0,10
90190,kiṃpabhavo,kimpabhavo,32,32,0,0,10
90191,kiṃpakkasadiso,kimpakkasadiso,1,1,0,0,14
90192,taṇhādisambhavo,tanhadisambhavo,1,1,0,0,15
90193,uṇhakāle,unhakale,28,27,1,0,8
90194,micchanti,micchanti,7,7,0,0,9
90195,pipāsitā,pipasita,15,15,0,0,8
90196,paccāmittā,paccamitta,15,13,2,0,10
90197,dukhaṭṭitā,dukhattita,1,1,0,0,10
90198,bhūtale,bhutale,5,5,0,0,7
90199,jhānajaṃ,jhanajam,1,1,0,0,8
90200,kassaṅgesu,kassangesu,1,1,0,0,10
90201,sabbanāmikasaññitassa,sabbanamikasannitassa,1,1,0,0,21
90202,pulliṅganapuṃsakaliṅgaṭṭhāne,pullinganapumsakalingatthane,1,1,0,0,28
90203,kamhī,kamhi,1,1,0,0,5
90204,sesapadato,sesapadato,1,1,0,0,10
90205,nipātetvā,nipatetva,13,12,1,0,9
90206,anāgatattā,anagatatta,83,83,0,0,10
90207,kasmiñci,kasminci,12,11,1,0,8
90208,kismici,kismici,7,7,0,0,7
90209,pulliṅganapuṃsakaliṅgavasena,pullinganapumsakalingavasena,1,1,0,0,28
90210,kismicīti,kismiciti,2,0,2,0,9
90211,anusāralopavasena,anusaralopavasena,1,1,0,0,17
90212,kāyaci,kayaci,137,136,1,0,6
90213,kāhici,kahici,75,75,0,0,6
90214,kassāci,kassaci,3,3,0,0,7
90215,kāsañci,kasanci,20,20,0,0,7
90216,kāsucīti,kasuciti,1,1,0,0,8
90217,hiṃsāmi,himsami,9,8,1,0,7
90218,kiñcītiādīni,kincitiadini,2,0,2,0,12
90219,appamattakānaṃ,appamattakanam,1,1,0,0,14
90220,saṅgāhakavacanānīti,sangahakavacananiti,1,1,0,0,19
90221,punetāniyeva,punetaniyeva,1,1,0,0,12
90222,dassessāmi,dassessami,22,22,0,0,10
90223,kasmāci,kasmaci,4,4,0,0,7
90224,suṇeyya,suneyya,53,52,1,0,7
90225,kecime,kecime,74,55,19,0,6
90226,sādhutaraṃ,sadhutaram,13,13,0,0,10
90227,dhataraṭṭhanivesane,dhataratthanivesane,3,3,0,0,19
90228,napuṃsakaliṅgarūpāni,napumsakalingarupani,28,28,0,0,20
90229,kāsuci,kasuci,11,10,1,0,6
90230,atītānāgatapaccuppannā,atitanagatapaccuppanna,33,33,0,0,22
90231,anavasesapariyādānavacanānīti,anavasesapariyadanavacananiti,1,1,0,0,29
90232,nipātapadāni,nipatapadani,6,6,0,0,12
90233,nipātapatirūpakā,nipatapatirupaka,2,2,0,0,16
90234,saddagatiyoti,saddagatiyoti,1,1,0,0,13
90235,ekākārena,ekakarena,10,10,0,0,9
90236,saddagatiyoyeva,saddagatiyoyeva,1,1,0,0,15
90237,liṅgānurūpato,linganurupato,2,2,0,0,13
90238,ttakattika,ttakattika,1,0,1,0,10
90239,vatticchāyaṃ,vatticchayam,1,1,0,0,12
90240,paricchedavacanāni,paricchedavacanani,1,1,0,0,18
90241,asabbanāmikāniyeva,asabbanamikaniyeva,1,1,0,0,18
90242,yattikā,yattika,2,2,0,0,7
90243,tattako,tattako,19,17,2,0,7
90244,tattikā,tattika,3,2,1,0,7
90245,kittako,kittako,38,37,1,0,7
90246,kittikā,kittika,4,4,0,0,7
90247,ettikāti,ettikati,4,3,1,0,8
90248,sambhūtatthantaresu,sambhutatthantaresu,1,1,0,0,19
90249,saṅkhādivacanassa,sankhadivacanassa,1,1,0,0,17
90250,asadisavacano,asadisavacano,1,1,0,0,13
90251,asahāyavacano,asahayavacano,1,1,0,0,13
90252,ekaccavacano,ekaccavacano,2,2,0,0,12
90253,missībhūtavacano,missibhutavacano,2,2,0,0,16
90254,sahāyavacano,sahayavacano,2,2,0,0,12
90255,ekamhā,ekamha,22,20,2,0,6
90256,ekamhīti,ekamhiti,1,1,0,0,8
90257,saṅkhāvisaye,sankhavisaye,1,1,0,0,12
90258,ekavacanakova,ekavacanakova,2,2,0,0,13
90259,nipajjāmī,nipajjami,41,41,0,0,9
90260,asadisāsahāyakathanepi,asadisasahayakathanepi,1,1,0,0,22
90261,ekavacanikā,ekavacanika,1,1,0,0,11
90262,sabbanāmikapadamālā,sabbanamikapadamala,2,2,0,0,19
90263,saṅkhatthā,sankhattha,1,1,0,0,10
90264,asahāyā,asahaya,3,3,0,0,7
90265,ekakā,ekaka,41,36,5,0,5
90266,ekakehi,ekakehi,3,3,0,0,7
90267,ekakebhi,ekakebhi,1,1,0,0,8
90268,saṅkhatthāpi,sankhatthapi,1,1,0,0,12
90269,asahāyāpi,asahayapi,1,1,0,0,9
90270,sabbanāmikapakkhaṃ,sabbanamikapakkham,2,2,0,0,18
90271,asādhāraṇarūpābhāvato,asadharanarupabhavato,2,2,0,0,21
90272,ekehi,ekehi,12,12,0,0,5
90273,ekebhi,ekebhi,6,6,0,0,6
90274,ekesaṃ,ekesam,16,14,2,0,6
90275,ekesū,ekesu,2,1,1,0,5
90276,eketi,eketi,47,5,42,0,5
90277,ekānaṃ,ekanam,1,1,0,0,6
90278,bhavantūti,bhavantuti,9,4,5,0,10
90279,ekībhavantu,ekibhavantu,1,1,0,0,11
90280,missībhavantu,missibhavantu,1,1,0,0,13
90281,saṃsandantu,samsandantu,1,1,0,0,11
90282,samentūti,samentuti,1,1,0,0,9
90283,sabbanāmattameva,sabbanamattameva,1,1,0,0,16
90284,yojenti,yojenti,48,48,0,0,7
90285,ekesānaṃ,ekesanam,3,3,0,0,8
90286,ekesūti,ekesuti,1,1,0,0,7
90287,sabbanāmikapadamālāti,sabbanamikapadamalati,1,1,0,0,21
90288,saṅkhyātulyāsahāyaññavacano,sankhyatulyasahayannavacano,2,2,0,0,27
90289,saṅkhyāvacano,sankhyavacano,3,3,0,0,13
90290,sabbatthekavacanantova,sabbatthekavacanantova,2,2,0,0,22
90291,bahuvacanantopi,bahuvacanantopi,3,3,0,0,15
90292,sabbasaddasamaṃ,sabbasaddasamam,1,1,0,0,15
90293,saṃsāsveva,samsasveva,1,1,0,0,10
90294,yojanānayaṃ,yojananayam,16,16,0,0,11
90295,kārantaniddesopi,karantaniddesopi,1,1,0,0,16
90296,ekāni,ekani,12,12,0,0,5
90297,ekānīti,ekaniti,1,0,1,0,7
90298,sesabahuvacanesupi,sesabahuvacanesupi,1,1,0,0,18
90299,ekāyo,ekayo,4,4,0,0,5
90300,ekāhi,ekahi,7,7,0,0,5
90301,ekābhi,ekabhi,3,3,0,0,6
90302,ekāsaṃ,ekasam,5,4,1,0,6
90303,ekāyaṃ,ekayam,5,5,0,0,6
90304,ekāsu,ekasu,2,2,0,0,5
90305,ekāhīti,ekahiti,1,0,1,0,7
90306,ekaccāhi,ekaccahi,3,3,0,0,8
90307,ekāsūti,ekasuti,1,0,1,0,7
90308,ekaccāsu,ekaccasu,24,24,0,0,8
90309,liṅgattayarūpāni,lingattayarupani,1,1,0,0,16
90310,ekavacanāneva,ekavacananeva,1,1,0,0,13
90311,ekekasmā,ekekasma,2,2,0,0,8
90312,ekekamhā,ekekamha,1,1,0,0,8
90313,ekekamhīti,ekekamhiti,1,1,0,0,10
90314,ekekāya,ekekaya,62,56,6,0,7
90315,ekekissā,ekekissa,25,25,0,0,8
90316,ekekāyaṃ,ekekayam,1,1,0,0,8
90317,vicchāsabbanāmānīti,vicchasabbanamaniti,1,1,0,0,19
90318,payogābhāvato,payogabhavato,3,3,0,0,13
90319,liṅgattayarūpesu,lingattayarupesu,1,1,0,0,16
90320,samāsacintā,samasacinta,2,2,0,0,11
90321,anibbacanīyattā,anibbacaniyatta,1,1,0,0,15
90322,vicchāsaddānaṃ,vicchasaddanam,1,1,0,0,14
90323,tattakapāle,tattakapale,25,25,0,0,11
90324,pakkhittatilā,pakkhittatila,5,5,0,0,13
90325,taṭataṭāyantā,tatatatayanta,6,5,1,0,13
90326,bhijjantī,bhijjanti,13,10,3,0,9
90327,pabbapabba,pabbapabba,1,0,1,0,10
90328,samāsakaraṇavasena,samasakaranavasena,1,1,0,0,18
90329,dvirutti,dvirutti,1,1,0,0,8
90330,ekacca,ekacca,6,4,2,0,6
90331,ekatiya,ekatiya,2,1,1,0,7
90332,ekacciya,ekacciya,4,2,2,0,8
90333,ekacceti,ekacceti,15,4,11,0,8
90334,paccattabahuvacanameva,paccattabahuvacanameva,2,2,0,0,22
90335,sabbanāmikarūpasamaṃ,sabbanamikarupasamam,2,2,0,0,20
90336,asādhāraṇarūpattā,asadharanarupatta,2,2,0,0,17
90337,idhekacce,idhekacce,125,122,3,0,9
90338,ekatiyo,ekatiyo,1,1,0,0,7
90339,ekatiye,ekatiye,4,4,0,0,7
90340,ekatiyaṃ,ekatiyam,4,4,0,0,8
90341,ekatiyeti,ekatiyeti,1,0,1,0,9
90342,vissase,vissase,79,77,2,0,7
90343,ekatiyesu,ekatiyesu,3,3,0,0,9
90344,agārisu,agarisu,3,3,0,0,7
90345,pabbajitesu,pabbajitesu,30,30,0,0,11
90346,sādhūpi,sadhupi,4,3,1,0,7
90347,hontī,honti,486,402,84,0,5
90348,atthitāyaṃ,atthitayam,2,2,0,0,10
90349,kirevamāhaṃsu,kirevamahamsu,9,9,0,0,13
90350,niplavitaṃ,niplavitam,13,10,3,0,10
90351,tvevekacciyo,tvevekacciyo,7,6,1,0,12
90352,ekacciyaṃ,ekacciyam,19,16,3,0,9
90353,ekacciyo,ekacciyo,5,5,0,0,8
90354,ekacciyeti,ekacciyeti,1,1,0,0,10
90355,ekatiyāni,ekatiyani,2,2,0,0,9
90356,ekacciyāni,ekacciyani,2,2,0,0,10
90357,ekatiyā,ekatiya,2,2,0,0,7
90358,ekatiyāyo,ekatiyayo,1,1,0,0,9
90359,ekacciyāyo,ekacciyayo,1,1,0,0,10
90360,ekākiya,ekakiya,1,0,1,0,7
90361,ekākino,ekakino,8,8,0,0,7
90362,ekākiṃ,ekakim,2,2,0,0,6
90363,ekākiyo,ekakiyo,10,9,1,0,7
90364,ekākiyā,ekakiya,4,4,0,0,7
90365,ekākiyaṃ,ekakiyam,4,4,0,0,8
90366,ekākiye,ekakiye,1,1,0,0,7
90367,ekākiyena,ekakiyena,1,1,0,0,9
90368,ekākīni,ekakini,2,2,0,0,7
90369,ekākiyāni,ekakiyani,2,2,0,0,9
90370,ekākinī,ekakini,12,12,0,0,7
90371,ekākiniyo,ekakiniyo,2,2,0,0,9
90372,ekākiniṃ,ekakinim,1,1,0,0,8
90373,ekākiniyāti,ekakiniyati,1,1,0,0,11
90374,ekākiyāyo,ekakiyayo,2,2,0,0,9
90375,ekākiyāyāti,ekakiyayati,1,1,0,0,11
90376,bahuvacanantassa,bahuvacanantassa,2,2,0,0,16
90377,sabbanāmikapadassa,sabbanamikapadassa,1,1,0,0,18
90378,ubhobhi,ubhobhi,5,5,0,0,7
90379,ubhosū,ubhosu,1,1,0,0,6
90380,vuttapadamālā,vuttapadamala,1,1,0,0,13
90381,nikkītā,nikkita,3,3,0,0,7
90382,saññamissāmi,sannamissami,1,1,0,0,12
90383,bāhāhi,bahahi,21,21,0,0,6
90384,passesūti,passesuti,5,2,3,0,9
90385,ayamasmākaṃ,ayamasmakam,5,5,0,0,11
90386,ubhehi,ubhehi,4,4,0,0,6
90387,ubhebhi,ubhebhi,3,3,0,0,7
90388,ubhesū,ubhesu,1,1,0,0,6
90389,kātabbāniyeva,katabbaniyeva,2,2,0,0,13
90390,liṅgattayasādhāraṇarūpāni,lingattayasadharanarupani,2,2,0,0,25
90391,saṅkhāvacanānaṃ,sankhavacananam,1,1,0,0,15
90392,bahuvacanantānaṃ,bahuvacanantanam,1,1,0,0,16
90393,dvinnannaṃ,dvinnannam,1,1,0,0,10
90394,liṅgādibhāvavinimuttānipi,lingadibhavavinimuttanipi,1,1,0,0,25
90395,liṅgattayasādhāraṇāni,lingattayasadharanani,1,1,0,0,21
90396,dvitippakatikaṃyeva,dvitippakatikamyeva,1,1,0,0,19
90397,nānādesehi,nanadesehi,1,1,0,0,10
90398,dvirattañca,dvirattanca,1,1,0,0,11
90399,duvassako,duvassako,1,1,0,0,9
90400,dupattañca,dupattanca,1,1,0,0,10
90401,taddhitatte,taddhitatte,1,1,0,0,11
90402,tissannannaṃ,tissannannam,1,1,0,0,12
90403,bahuvacanamāgataṃ,bahuvacanamagatam,1,1,0,0,17
90404,kāralopopi,karalopopi,1,1,0,0,10
90405,udakaphusitānī,udakaphusitani,4,4,0,0,14
90406,bahulīkatattā,bahulikatatta,135,135,0,0,13
90407,piṇḍolabhāradvājena,pindolabharadvajena,16,16,0,0,19
90408,byākatā,byakata,78,75,3,0,7
90409,tippakatikā,tippakatika,1,1,0,0,11
90410,ticittaṃ,ticittam,152,141,11,0,8
90411,napuṃsakattaṃva,napumsakattamva,1,1,0,0,15
90412,pāsaṃsaṃ,pasamsam,7,7,0,0,8
90413,pāyavuttito,payavuttito,1,1,0,0,11
90414,pumattampettha,pumattampettha,1,1,0,0,14
90415,khāyate,khayate,7,7,0,0,7
90416,catūbhi,catubhi,16,16,0,0,7
90417,catubbhi,catubbhi,50,42,8,0,8
90418,soṇadantasuttādīsu,sonadantasuttadisu,1,1,0,0,18
90419,suttantaṭṭhakathāyaṃ,suttantatthakathayam,5,1,4,0,20
90420,acchariyabbhutadhammehi,acchariyabbhutadhammehi,8,8,0,0,23
90421,sattilaṅghajātakaṭṭhakathāyaṃ,sattilanghajatakatthakathayam,1,1,0,0,29
90422,sattīnaṃ,sattinam,2,2,0,0,8
90423,laṅghanaṃ,langhanam,1,1,0,0,9
90424,jānātī,janati,252,222,30,0,6
90425,samāsabhāvamhi,samasabhavamhi,1,1,0,0,14
90426,ppakatikaṃ,ppakatikam,1,1,0,0,10
90427,nidassanapadānettha,nidassanapadanettha,1,1,0,0,19
90428,kamakovido,kamakovido,1,1,0,0,10
90429,catussālaṃ,catussalam,10,9,1,0,10
90430,ādikāni,adikani,3,3,0,0,7
90431,sabbanāmikāni,sabbanamikani,1,1,0,0,13
90432,bahuvacanāniyeva,bahuvacananiyeva,1,1,0,0,16
90433,tassālapane,tassalapane,1,1,0,0,11
90434,tumhebhi,tumhebhi,6,6,0,0,8
90435,attayoge,attayoge,1,1,0,0,8
90436,ahakaṃ,ahakam,2,2,0,0,6
90437,amhebhi,amhebhi,6,6,0,0,7
90438,asmesu,asmesu,2,2,0,0,6
90439,karomase,karomase,10,10,0,0,8
90440,ahakañca,ahakanca,1,1,0,0,8
90441,cittavasānugā,cittavasanuga,6,6,0,0,13
90442,ahakanti,ahakanti,1,1,0,0,8
90443,kaccāyanacūḷaniruttiniruttipiṭakesu,kaccayanaculaniruttiniruttipitakesu,1,0,1,0,35
90444,paṭhamādutiyābahuvacanaṃ,pathamadutiyabahuvacanam,1,1,0,0,24
90445,catutthīchaṭṭhekavacanaṃ,catutthichatthekavacanam,1,1,0,0,24
90446,paṭhamādutiyābahuvacanañca,pathamadutiyabahuvacananca,1,1,0,0,26
90447,cūḷaniruttiniruttipiṭake,culaniruttiniruttipitake,1,1,0,0,24
90448,dutiyekavacanaṃ,dutiyekavacanam,3,3,0,0,15
90449,catutthīchaṭṭhībahuvacanaṃ,catutthichatthibahuvacanam,1,1,0,0,26
90450,sāṭṭhakathesu,satthakathesu,4,4,0,0,13
90451,maṃdīpā,mamdipa,12,11,1,0,7
90452,tathāgatādimukhato,tathagatadimukhato,1,1,0,0,18
90453,maṃleṇā,mamlena,8,6,2,0,7
90454,tathāgatamukhato,tathagatamukhato,1,1,0,0,16
90455,mayyogo,mayyogo,3,2,1,0,7
90456,niruttaññumukhato,niruttannumukhato,1,1,0,0,17
90457,kābyādāse,kabyadase,2,0,2,0,9
90458,tvaṃmukhaṃ,tvammukham,6,5,1,0,10
90459,kamaleneva,kamaleneva,2,2,0,0,10
90460,nāññena,nannena,14,11,3,0,7
90461,kenacī,kenaci,40,29,11,0,6
90462,kavimukhato,kavimukhato,1,1,0,0,11
90463,tumhena,tumhena,1,1,0,0,7
90464,amhena,amhena,1,1,0,0,6
90465,bahuvacanavasenapi,bahuvacanavasenapi,1,1,0,0,18
90466,nibbacanīyaṃ,nibbacaniyam,2,2,0,0,12
90467,tvaṃdīpā,tvamdipa,3,1,2,0,8
90468,tvaṃvaṇṇo,tvamvanno,2,0,2,0,9
90469,tvaṃsaro,tvamsaro,1,0,1,0,8
90470,maṃmukhaṃ,mammukham,3,0,3,0,9
90471,maṃvaṇṇo,mamvanno,1,0,1,0,8
90472,maṃsaro,mamsaro,1,0,1,0,7
90473,tumhaamhākaṃ,tumhaamhakam,1,0,1,0,12
90474,etthāha,etthaha,186,186,0,0,7
90475,nāmikapantīsu,namikapantisu,2,2,0,0,13
90476,nosaddānamatthuddhāro,nosaddanamatthuddharo,1,1,0,0,21
90477,saddaṭṭhānepi,saddatthanepi,2,2,0,0,13
90478,mayampi,mayampi,372,362,10,0,7
90479,anuññātapaṭiññātā,anunnatapatinnata,5,5,0,0,17
90480,tevijjāmayamasmubho,tevijjamayamasmubho,1,1,0,0,19
90481,asmadatthe,asmadatthe,2,2,0,0,10
90482,hemāya,hemaya,2,2,0,0,6
90483,mandosisūpagā,mandosisupaga,1,1,0,0,13
90484,pītibhakkhā,pitibhakkha,23,21,2,0,11
90485,sayaṃpabhā,sayampabha,32,26,6,0,10
90486,nibbattiatthe,nibbattiatthe,3,3,0,0,13
90487,manasāva,manasava,50,49,1,0,8
90488,nibbattāti,nibbattati,39,33,6,0,10
90489,yaṃnūnāhaṃ,yamnunaham,641,626,15,0,10
90490,vikāratthe,vikaratthe,6,6,0,0,10
90491,dānamayaṃ,danamayam,121,107,14,0,9
90492,sīlamayaṃ,silamayam,73,66,7,0,9
90493,padapūraṇamatte,padapuranamatte,57,51,6,0,15
90494,suvaṇṇameva,suvannameva,13,13,0,0,11
90495,sovaṇṇanti,sovannanti,3,3,0,0,10
90496,sovaṇṇamayanti,sovannamayanti,6,6,0,0,14
90497,nibbattiatthotipi,nibbattiatthotipi,1,1,0,0,17
90498,sovaṇṇameva,sovannameva,2,2,0,0,11
90499,pakāsituṃ,pakasitum,21,17,4,0,9
90500,saṃkhittena,samkhittena,527,513,14,0,11
90501,desetū,desetu,43,43,0,0,6
90502,anabhisambuddhassa,anabhisambuddhassa,44,44,0,0,18
90503,bodhisattasseva,bodhisattasseva,58,53,5,0,15
90504,mamāti,mamati,122,57,65,0,6
90505,nayadassinā,nayadassina,2,2,0,0,11
90506,saddānamatthavivaraṇe,saddanamatthavivarane,1,1,0,0,21
90507,tesamadhippāyappakāsanavasena,tesamadhippayappakasanavasena,1,1,0,0,29
90508,saṃsayasamugghāṭanatthaṃ,samsayasamugghatanattham,2,2,0,0,24
90509,sampadānatthavasena,sampadanatthavasena,2,2,0,0,19
90510,sāmiatthavasena,samiatthavasena,3,3,0,0,15
90511,saddatthavācakā,saddatthavacaka,1,1,0,0,15
90512,sampadānasāmiatthesu,sampadanasamiatthesu,3,3,0,0,20
90513,aniyamato,aniyamato,58,56,2,0,9
90514,vikappemi,vikappemi,2,2,0,0,9
90515,medena,medena,6,6,0,0,6
90516,matthakena,matthakena,15,15,0,0,10
90517,āhutiṃ,ahutim,31,24,7,0,6
90518,paggahessāmi,paggahessami,3,3,0,0,12
90519,kahanti,kahanti,5,5,0,0,7
90520,aññādisaṃ,annadisam,15,13,2,0,9
90521,marissati,marissati,46,46,0,0,9
90522,mātāpitā,matapita,47,43,4,0,8
90523,cūḷaniruttiyañhi,culaniruttiyanhi,1,0,1,0,16
90524,anaññarūpattaṃ,anannarupattam,1,1,0,0,14
90525,anaññaṃ,anannam,57,50,7,0,7
90526,bahuvacanañcā,bahuvacananca,1,1,0,0,13
90527,passiṃsū,passimsu,3,3,0,0,8
90528,yuttaṃyeva,yuttamyeva,1,1,0,0,10
90529,saṃvaṇṇayiṃsu,samvannayimsu,2,2,0,0,13
90530,passitabbañca,passitabbanca,1,1,0,0,13
90531,passiṃsu,passimsu,78,78,0,0,8
90532,saddasatthampi,saddasatthampi,1,1,0,0,14
90533,sāsanānukūlaṃ,sasananukulam,1,1,0,0,13
90534,paresamanukampāya,paresamanukampaya,4,4,0,0,17
90535,catutthīchaṭṭhīrūpehi,catutthichatthirupehi,1,1,0,0,21
90536,samānagatikāni,samanagatikani,2,2,0,0,14
90537,sampadānatthe,sampadanatthe,24,24,0,0,13
90538,pavattiniyamo,pavattiniyamo,4,4,0,0,13
90539,karuṇāyevāyaṃparādho,karunayevayamparadho,1,1,0,0,20
90540,atthavacanena,atthavacanena,5,5,0,0,13
90541,sāmivisayesu,samivisayesu,1,1,0,0,12
90542,vibhattivipallāsanayo,vibhattivipallasanayo,2,2,0,0,21
90543,saddanayaññeva,saddanayanneva,2,2,0,0,14
90544,ruccatī,ruccati,84,80,4,0,7
90545,cuṇṇiyapadaṭṭhānepi,cunniyapadatthanepi,1,1,0,0,19
90546,aniyamena,aniyamena,35,35,0,0,9
90547,rajjassahaṃ,rajjassaham,3,3,0,0,11
90548,bhāyāmī,bhayami,28,27,1,0,7
90549,medenā,medena,2,2,0,0,6
90550,piyaputtadānaṃ,piyaputtadanam,3,3,0,0,14
90551,vibhattivipallāsattho,vibhattivipallasattho,1,1,0,0,21
90552,catutthīchaṭṭhīrūpānaṃ,catutthichatthirupanam,1,1,0,0,22
90553,nupalabbhanti,nupalabbhanti,22,22,0,0,13
90554,vibhattivipallāsatthavacane,vibhattivipallasatthavacane,1,1,0,0,27
90555,avijjamānaggahaṇaṃ,avijjamanaggahanam,1,1,0,0,18
90556,vibhattivipallāsakaraṇaṃ,vibhattivipallasakaranam,1,1,0,0,24
90557,sāvajjaṃ,savajjam,113,104,9,0,8
90558,anaññāni,anannani,5,5,0,0,8
90559,dīpetabbā,dipetabba,48,45,3,0,9
90560,aggassā,aggassa,1,1,0,0,7
90561,kriyāpaṭiggahaṇaṃ,kriyapatiggahanam,1,1,0,0,17
90562,deyyadhammassa,deyyadhammassa,99,92,7,0,14
90563,yhaṃsaddassa,yhamsaddassa,1,1,0,0,12
90564,sakuṇajātiyā,sakunajatiya,1,1,0,0,12
90565,loluppacāritāya,loluppacaritaya,1,1,0,0,15
90566,mayha,mayha,86,80,6,0,5
90567,saddūpapadassa,saddupapadassa,2,2,0,0,14
90568,yhaṃ,yham,2,2,0,0,4
90569,mayhaṃsaddā,mayhamsadda,1,1,0,0,11
90570,lokavohārakusalena,lokavoharakusalena,2,2,0,0,18
90571,paṇṇatti,pannatti,61,54,7,0,8
90572,anantogadhasampadānatthattā,anantogadhasampadanatthatta,1,1,0,0,27
90573,antogadhasāmyatthattā,antogadhasamyatthatta,1,1,0,0,21
90574,mamako,mamako,1,1,0,0,6
90575,paṇṇattivisaye,pannattivisaye,1,1,0,0,14
90576,vibhattivipariṇāmassa,vibhattiviparinamassa,1,1,0,0,21
90577,anavakāsattā,anavakasatta,3,3,0,0,12
90578,yhaṃsaddo,yhamsaddo,1,1,0,0,9
90579,vibhatyantabhāvena,vibhatyantabhavena,1,1,0,0,18
90580,kasaddena,kasaddena,5,5,0,0,9
90581,ekapadattūpagamanato,ekapadattupagamanato,2,2,0,0,20
90582,sakuṇavisesavācako,sakunavisesavacako,1,1,0,0,18
90583,ṭhitoyeva,thitoyeva,30,30,0,0,9
90584,sāmiatthampi,samiatthampi,1,1,0,0,12
90585,jotayati,jotayati,4,4,0,0,8
90586,rājapurisa,rajapurisa,1,0,1,0,10
90587,padāvayavabhūtassa,padavayavabhutassa,1,1,0,0,18
90588,yhasaddassa,yhasaddassa,1,1,0,0,11
90589,avipallāsavacanalesena,avipallasavacanalesena,1,1,0,0,22
90590,saddesupi,saddesupi,6,6,0,0,9
90591,pavattānampi,pavattanampi,6,6,0,0,12
90592,vuttappakāro,vuttappakaro,58,57,1,0,12
90593,itime,itime,10,9,1,0,5
90594,sāmyatthasampadānatthā,samyatthasampadanattha,1,1,0,0,22
90595,pāyā,paya,3,3,0,0,4
90596,panappakā,panappaka,1,1,0,0,9
90597,yhaṃsaddāva,yhamsaddava,1,1,0,0,11
90598,nekasahassamhi,nekasahassamhi,1,1,0,0,14
90599,pavattareti,pavattareti,3,3,0,0,11
90600,nītiyo,nitiyo,1,1,0,0,6
90601,paramasukhumā,paramasukhuma,2,2,0,0,13
90602,sududdasā,sududdasa,1,1,0,0,9
90603,paccattaupayogakaraṇasampadānasāmivacanapadapūraṇesu,paccattaupayogakaranasampadanasamivacanapadapuranesu,3,3,0,0,52
90604,anuruddhā,anuruddha,157,151,6,0,9
90605,sammodamānā,sammodamana,141,139,2,0,11
90606,paṇāmemi,panamemi,12,12,0,0,8
90607,vanapatthapariyāyaṃ,vanapatthapariyayam,7,6,1,0,19
90608,desessāmī,desessami,84,79,5,0,9
90609,voariyā,voariya,1,1,0,0,7
90610,kāyakammantā,kayakammanta,1,1,0,0,12
90611,paccattopayogakaraṇasampadānasāmivacanāvadhāraṇanusaddatthesu,paccattopayogakaranasampadanasamivacanavadharananusaddatthesu,1,1,0,0,61
90612,nipātamatte,nipatamatte,3,3,0,0,11
90613,gaccheyyāmā,gaccheyyama,1,1,0,0,11
90614,vivāho,vivaho,27,24,3,0,6
90615,nāgehi,nagehi,27,27,0,0,6
90616,katapubbo,katapubbo,13,13,0,0,9
90617,rajjenā,rajjena,12,11,1,0,7
90618,tathāgatenā,tathagatena,22,20,2,0,11
90619,pucchāyantipi,pucchayantipi,1,1,0,0,13
90620,subhāsitaññeva,subhasitanneva,1,1,0,0,14
90621,cupayoge,cupayoge,1,1,0,0,8
90622,sāmyāvadhāraṇe,samyavadharane,1,1,0,0,14
90623,nipātamattamhi,nipatamattamhi,1,1,0,0,14
90624,liṅgattayayojanā,lingattayayojana,1,1,0,0,16
90625,anupagamma,anupagamma,80,79,1,0,10
90626,etī,eti,24,23,1,0,3
90627,vicittappayogā,vicittappayoga,1,1,0,0,14
90628,sabbanāmikapadānaṃ,sabbanamikapadanam,1,1,0,0,18
90629,sabbadassino,sabbadassino,10,10,0,0,12
90630,asabbanāmanāmehi,asabbanamanamehi,1,1,0,0,16
90631,sabbanāmapadehi,sabbanamapadehi,1,1,0,0,15
90632,pantito,pantito,1,1,0,0,7
90633,katayogānaṃ,katayoganam,1,1,0,0,11
90634,sukhumatthavijānanaṃ,sukhumatthavijananam,1,1,0,0,20
90635,akicchapaṭivedhena,akicchapativedhena,1,1,0,0,18
90636,sabbanāmataṃsadisanāmānaṃ,sabbanamatamsadisanamanam,1,1,0,0,25
90637,dvādasamo,dvadasamo,60,60,0,0,9
90638,savinicchayasaṅkhyānāmanāmikapadamālā,savinicchayasankhyanamanamikapadamala,1,1,0,0,37
90639,saṅkhyānāmikapantiyo,sankhyanamikapantiyo,1,1,0,0,20
90640,dhātujehi,dhatujehi,1,1,0,0,9
90641,cupayojituṃ,cupayojitum,1,1,0,0,11
90642,saṅkhyāsabbanāmānaṃ,sankhyasabbanamanam,1,1,0,0,19
90643,asabbanāmānaṃ,asabbanamanam,1,1,0,0,13
90644,saṅkhyānāmānaṃ,sankhyanamanam,3,3,0,0,14
90645,dhātumayehi,dhatumayehi,1,1,0,0,11
90646,yojanatthaṃ,yojanattham,8,8,0,0,11
90647,pañcabhi,pancabhi,7,7,0,0,8
90648,chabhi,chabhi,1,1,0,0,6
90649,chassu,chassu,8,7,1,0,6
90650,samuppanno,samuppanno,63,61,2,0,10
90651,krubbati,krubbati,7,7,0,0,8
90652,sattabhi,sattabhi,1,1,0,0,8
90653,aṭṭhabhi,atthabhi,2,2,0,0,8
90654,navabhi,navabhi,1,1,0,0,7
90655,dasabhi,dasabhi,5,4,1,0,7
90656,tedasa,tedasa,1,0,1,0,6
90657,aṭṭhārasabhi,attharasabhi,1,1,0,0,12
90658,aṭṭhārasasu,attharasasu,79,76,3,0,11
90659,ekūnavīsati,ekunavisati,144,135,9,0,11
90660,ekūnavīsaṃ,ekunavisam,4,3,1,0,10
90661,iccādipi,iccadipi,10,10,0,0,8
90662,ekūnavīsāya,ekunavisaya,24,24,0,0,11
90663,ekūnavīsāyaṃ,ekunavisayam,4,4,0,0,12
90664,ekūnavīsa,ekunavisa,19,19,0,0,9
90665,cittesū,cittesu,2,1,1,0,7
90666,ekūnavīsatiṃ,ekunavisatim,6,6,0,0,12
90667,ekūnavīsatiyā,ekunavisatiya,68,65,3,0,13
90668,ekūnavīsatiyaṃ,ekunavisatiyam,5,5,0,0,14
90669,vīsatiṃ,visatim,20,19,1,0,7
90670,vīsa,visa,31,28,3,0,4
90671,vīsāya,visaya,12,12,0,0,6
90672,vīsāyaṃ,visayam,2,2,0,0,7
90673,ekavīsa,ekavisa,190,189,1,0,7
90674,dvāvīsa,dvavisa,9,8,1,0,7
90675,bāvīsa,bavisa,25,24,1,0,6
90676,catuvīsa,catuvisa,19,18,1,0,8
90677,tiṃsāya,timsaya,29,29,0,0,7
90678,tiṃsāyaṃ,timsayam,4,4,0,0,8
90679,cattālīsa,cattalisa,103,99,4,0,9
90680,cattālīsāya,cattalisaya,61,57,4,0,11
90681,cattālīsāyaṃ,cattalisayam,4,4,0,0,12
90682,cattārīsa,cattarisa,12,11,1,0,9
90683,paññāsa,pannasa,152,146,6,0,7
90684,paññāsāya,pannasaya,43,37,6,0,9
90685,paññāsāyaṃ,pannasayam,4,4,0,0,10
90686,paṇṇāsaṃ,pannasam,15,14,1,0,8
90687,paṇṇāsāya,pannasaya,6,5,1,0,9
90688,paṇṇāsāyaṃ,pannasayam,2,2,0,0,10
90689,saṭṭhiṃ,satthim,11,11,0,0,7
90690,saṭṭhiyā,satthiya,25,23,2,0,8
90691,saṭṭhiyaṃ,satthiyam,4,4,0,0,9
90692,sattatiṃ,sattatim,5,5,0,0,8
90693,sattatiyā,sattatiya,9,9,0,0,9
90694,sattatiyaṃ,sattatiyam,4,4,0,0,10
90695,asītiṃ,asitim,6,6,0,0,6
90696,asītiyaṃ,asitiyam,4,4,0,0,8
90697,navutiṃ,navutim,5,5,0,0,7
90698,navutiyaṃ,navutiyam,4,4,0,0,9
90699,itthañca,itthanca,13,11,2,0,8
90700,saṅkhyārūpāni,sankhyarupani,1,1,0,0,13
90701,ekūnavīsehi,ekunavisehi,1,1,0,0,11
90702,ekūnavīsānaṃ,ekunavisanam,1,1,0,0,12
90703,ekūnavīsesu,ekunavisesu,1,1,0,0,11
90704,ādināpi,adinapi,1,1,0,0,7
90705,saṅkhyārūpānaṃ,sankhyarupanam,1,1,0,0,14
90706,ūnavīsati,unavisati,7,6,1,0,9
90707,sabbadāpi,sabbadapi,42,42,0,0,9
90708,ekavacanantamitthiliṅgameva,ekavacanantamitthilingameva,1,1,0,0,27
90709,saṅkhyeyyasaṅkhāsu,sankhyeyyasankhasu,1,1,0,0,18
90710,vīsatā,visata,3,1,2,0,6
90711,saṅkhatthe,sankhatthe,1,1,0,0,10
90712,dvibahuttamhi,dvibahuttamhi,1,1,0,0,13
90713,tthiyo,tthiyo,1,1,0,0,6
90714,chaḍḍetabbaṃ,chaddetabbam,43,39,4,0,12
90715,yathāvuttavacanaṃ,yathavuttavacanam,5,5,0,0,17
90716,vīsativīsaṃtiṃsaṃ,visativisamtimsam,1,0,1,0,17
90717,iccādīnañhi,iccadinanhi,1,1,0,0,11
90718,saṅkhatthānaṃ,sankhatthanam,1,1,0,0,13
90719,bahuvacanappayogavasenapi,bahuvacanappayogavasenapi,1,1,0,0,25
90720,vacanasambhūtarūpavantatādassanato,vacanasambhutarupavantatadassanato,1,1,0,0,34
90721,yathāpāvacanañca,yathapavacananca,2,2,0,0,16
90722,tesamekavacanantatā,tesamekavacanantata,1,1,0,0,19
90723,atthinatthi,atthinatthi,1,0,1,0,11
90724,matthi,matthi,43,37,6,0,6
90725,dhanammatthi,dhanammatthi,5,5,0,0,12
90726,attasamaṃ,attasamam,17,13,4,0,9
90727,aliṅgattepi,alingattepi,1,1,0,0,11
90728,panetesaṃ,panetesam,34,34,0,0,9
90729,anudhammacakkavattinā,anudhammacakkavattina,1,1,0,0,21
90730,vohārakusalasādhakena,voharakusalasadhakena,1,1,0,0,21
90731,atthiyā,atthiya,503,500,3,0,7
90732,natthiyā,natthiya,363,363,0,0,8
90733,vīsativīsati,visativisati,1,0,1,0,12
90734,miccādīnampi,miccadinampi,2,2,0,0,12
90735,tattheke,tattheke,3,3,0,0,8
90736,tammativasena,tammativasena,1,1,0,0,13
90737,adhipatimhī,adhipatimhi,1,1,0,0,11
90738,hetupaccaye,hetupaccaye,43,43,0,0,11
90739,adhipatipaccaye,adhipatipaccaye,19,18,1,0,15
90740,itthiliṅgarūpapaṭibhāgaṃ,itthilingarupapatibhagam,1,1,0,0,24
90741,itthiliṅgarūpapaṭibhāgānaṃ,itthilingarupapatibhaganam,1,1,0,0,26
90742,pulliṅgarūpānampi,pullingarupanampi,1,1,0,0,17
90743,ākhyātanipātavasena,akhyatanipatavasena,2,2,0,0,19
90744,saṃvijjati,samvijjati,227,224,3,0,10
90745,atthikhīrā,atthikhira,4,4,0,0,10
90746,nipātoyeva,nipatoyeva,4,4,0,0,10
90747,itthiliṅgādivasena,itthilingadivasena,1,1,0,0,18
90748,ekattādivasena,ekattadivasena,4,4,0,0,14
90749,dabyayaṃ,dabyayam,1,0,1,0,8
90750,paṭhamāyā,pathamaya,2,2,0,0,9
90751,liṅgesū,lingesu,3,3,0,0,7
90752,vacanalesena,vacanalesena,1,1,0,0,12
90753,yugaḷapadattā,yugalapadatta,1,1,0,0,13
90754,upasagganipātasaṅkhāte,upasagganipatasankhate,1,1,0,0,22
90755,asaṅkhyāsadde,asankhyasadde,1,1,0,0,13
90756,ekekamasaṅkhyāsaddaṃ,ekekamasankhyasaddam,1,1,0,0,20
90757,asaṅkhyā,asankhya,1,1,0,0,8
90758,abyayā,abyaya,2,2,0,0,6
90759,laddhavohāresu,laddhavoharesu,2,2,0,0,14
90760,upasagganipātesu,upasagganipatesu,2,2,0,0,16
90761,sabbavibhattivacanakā,sabbavibhattivacanaka,1,1,0,0,21
90762,paṭhamādīsu,pathamadisu,10,10,0,0,11
90763,vibhattiyuttā,vibhattiyutta,4,4,0,0,13
90764,avibhattiyuttā,avibhattiyutta,1,1,0,0,14
90765,yadaggena,yadaggena,130,127,3,0,9
90766,tadaggena,tadaggena,125,125,0,0,9
90767,tabbacanakā,tabbacanaka,1,1,0,0,11
90768,kaccāyanācariyenapi,kaccayanacariyenapi,1,0,1,0,19
90769,ālapanatthavācakattā,alapanatthavacakatta,1,1,0,0,20
90770,ekavacanikaanekavacanikā,ekavacanikaanekavacanika,1,1,0,0,24
90771,paṭhamāvibhattiyoyeva,pathamavibhattiyoyeva,1,1,0,0,21
90772,sabbavibhattilopaṃ,sabbavibhattilopam,1,1,0,0,18
90773,itiādivacanato,itiadivacanato,210,210,0,0,14
90774,padapūraṇamattānañca,padapuranamattananca,1,1,0,0,20
90775,avibhattiyuttānaṃ,avibhattiyuttanam,1,1,0,0,17
90776,avibhattiyuttānampi,avibhattiyuttanampi,1,1,0,0,19
90777,savibhattiko,savibhattiko,1,1,0,0,12
90778,niddisitumasakkuṇeyyattāti,niddisitumasakkuneyyattati,1,1,0,0,26
90779,luttāya,luttaya,1,1,0,0,7
90780,paṭhamāvibhattikāyeva,pathamavibhattikayeva,1,1,0,0,21
90781,niddisitabbā,niddisitabba,75,74,1,0,12
90782,evamakatvā,evamakatva,5,5,0,0,10
90783,sattamyantavasena,sattamyantavasena,1,1,0,0,17
90784,niddiṭṭhāti,nidditthati,40,33,7,0,11
90785,paṭhamāvibhattiyuttāyeva,pathamavibhattiyuttayeva,1,1,0,0,24
90786,atthipaccaye,atthipaccaye,17,16,1,0,12
90787,natthipaccaye,natthipaccaye,3,3,0,0,13
90788,paridīpane,paridipane,3,3,0,0,10
90789,sattamiyāyeva,sattamiyayeva,1,1,0,0,13
90790,atthiyānatthiyā,atthiyanatthiya,1,0,1,0,15
90791,sattamyantabhāve,sattamyantabhave,1,1,0,0,16
90792,tatiyācatutthīpañcamīchaṭṭhiyantabhāvopi,tatiyacatutthipancamichatthiyantabhavopi,1,1,0,0,40
90793,siddhoyeva,siddhoyeva,12,12,0,0,10
90794,natthibhāvo,natthibhavo,41,37,4,0,11
90795,bhiādinā,bhiadina,1,1,0,0,8
90796,samāsataddhitaviggaho,samasataddhitaviggaho,1,1,0,0,21
90797,yadidamamhehi,yadidamamhehi,1,1,0,0,13
90798,nipātopasaggā,nipatopasagga,1,1,0,0,13
90799,aliṅgabhedāti,alingabhedati,1,1,0,0,13
90800,pubbācariyānubhāvaññeva,pubbacariyanubhavanneva,1,1,0,0,23
90801,saṅkhyāsaddānaṃ,sankhyasaddanam,4,4,0,0,15
90802,adabbavācakattepi,adabbavacakattepi,2,2,0,0,17
90803,dabbavācakānaṃ,dabbavacakanam,1,1,0,0,14
90804,latāmatirattiitthī,latamatirattiitthi,1,0,1,0,18
90805,yāguvadhū,yaguvadhu,1,0,1,0,9
90806,liṅgabhāvavinimuttāni,lingabhavavinimuttani,1,1,0,0,21
90807,sattamiyantāni,sattamiyantani,1,1,0,0,14
90808,nipātapadānītipi,nipatapadanitipi,1,1,0,0,16
90809,chaḍḍetabbamidaṃ,chaddetabbamidam,1,1,0,0,16
90810,pāvacanasmiñhi,pavacanasminhi,1,1,0,0,14
90811,aniddiṭṭhānipi,anidditthanipi,1,1,0,0,14
90812,anekavihitāni,anekavihitani,52,52,0,0,13
90813,apasaddā,apasadda,2,2,0,0,8
90814,uppādetabbo,uppadetabbo,25,23,2,0,11
90815,pāramitāpuññena,paramitapunnena,1,1,0,0,15
90816,ñeyyamaṇḍalaṃ,neyyamandalam,1,1,0,0,13
90817,hatthatale,hatthatale,80,80,0,0,10
90818,vācāvippalāpo,vacavippalapo,7,7,0,0,13
90819,sāriputtatthera,sariputtatthera,1,0,1,0,15
90820,nikkhittattā,nikkhittatta,11,11,0,0,12
90821,tāvatiṃsabhapane,tavatimsabhapane,1,1,0,0,16
90822,desitakāle,desitakale,3,3,0,0,10
90823,buddhavacanaṃyeva,buddhavacanamyeva,1,1,0,0,17
90824,sāriputtassa,sariputtassa,244,237,7,0,12
90825,tenapi,tenapi,114,111,3,0,6
90826,santikā,santika,327,326,1,0,7
90827,suropitaṃ,suropitam,7,6,1,0,9
90828,paṭisambhidappattā,patisambhidappatta,15,15,0,0,18
90829,dunniruttiṃ,dunniruttim,1,1,0,0,11
90830,niruttipabhedasmiṃ,niruttipabhedasmim,1,1,0,0,18
90831,sukusalattā,sukusalatta,1,1,0,0,11
90832,aññesamavisayo,annesamavisayo,1,1,0,0,14
90833,satehi,satehi,49,45,4,0,6
90834,satebhi,satebhi,2,2,0,0,7
90835,satasmiṃ,satasmim,4,4,0,0,8
90836,satamhi,satamhi,3,3,0,0,7
90837,satesu,satesu,20,20,0,0,6
90838,sahassānīti,sahassaniti,13,9,4,0,11
90839,dasasatasahassanti,dasasatasahassanti,4,3,1,0,18
90840,sahassādīsupi,sahassadisupi,4,4,0,0,13
90841,koṭī,koti,7,6,1,0,4
90842,koṭiyo,kotiyo,98,97,1,0,6
90843,ekappabhutito,ekappabhutito,1,1,0,0,13
90844,dasakā,dasaka,45,41,4,0,6
90845,saṅkhyeyyappadhānāti,sankhyeyyappadhanati,3,3,0,0,20
90846,vīsatito,visatito,2,2,0,0,8
90847,saṅkhyāppadhānā,sankhyappadhana,3,3,0,0,15
90848,vaṇṇayuṃ,vannayum,2,2,0,0,8
90849,saṅkhyeyyappadhānā,sankhyeyyappadhana,3,3,0,0,18
90850,hiraññassāpi,hirannassapi,3,3,0,0,12
90851,pabbajiṃ,pabbajim,194,184,10,0,8
90852,vītamalā,vitamala,11,11,0,0,8
90853,samiṃsu,samimsu,42,42,0,0,7
90854,satakoṭiyo,satakotiyo,11,11,0,0,10
90855,saṅkhyāsaddarūpānaṃ,sankhyasaddarupanam,1,1,0,0,19
90856,pākaṭīkaraṇena,pakatikaranena,2,2,0,0,14
90857,sukhumañāṇapaṭilābhatthaṃ,sukhumananapatilabhattham,1,1,0,0,25
90858,ppadesaṃ,ppadesam,2,2,0,0,8
90859,pāḷippadesamaṭṭhakathāvacanañca,palippadesamatthakathavacananca,1,1,0,0,31
90860,dukkhāni,dukkhani,73,71,2,0,8
90861,cattārīsaṃ,cattarisam,13,13,0,0,10
90862,piyānīti,piyaniti,3,0,3,0,8
90863,piyāyitabbavatthūni,piyayitabbavatthuni,2,2,0,0,19
90864,saṅkhyāsaṅkhyeyyappadhānā,sankhyasankhyeyyappadhana,1,1,0,0,25
90865,dukkhānī,dukkhani,5,3,2,0,8
90866,piyānaṃ,piyanam,14,12,2,0,7
90867,dukkhānaṃ,dukkhanam,64,57,7,0,9
90868,saṅkhyeyyappadhānaṃyeva,sankhyeyyappadhanamyeva,1,1,0,0,23
90869,dukkhassāti,dukkhassati,52,12,40,0,11
90870,ekasmiñhi,ekasminhi,103,103,0,0,9
90871,padakkame,padakkame,2,2,0,0,9
90872,ekarasāva,ekarasava,1,1,0,0,9
90873,yathāvuttanayāva,yathavuttanayava,2,2,0,0,16
90874,sāṭṭhakatho,satthakatho,1,1,0,0,11
90875,udānapāḷippadeso,udanapalippadeso,1,1,0,0,16
90876,pāḷippadeso,palippadeso,1,1,0,0,11
90877,aṭṭhakathāpāṭhappadeso,atthakathapathappadeso,1,1,0,0,22
90878,assatarīrathā,assatariratha,13,12,1,0,13
90879,āmukkamaṇikuṇḍalā,amukkamanikundala,18,18,0,0,17
90880,padavītihārassa,padavitiharassa,6,6,0,0,15
90881,nāgghanti,nagghanti,52,47,5,0,9
90882,visesitāni,visesitani,5,5,0,0,10
90883,sahassānī,sahassani,8,5,3,0,9
90884,upapadaṃ,upapadam,5,4,1,0,8
90885,saṅkhyeyyappadhānavasenatthagahaṇaṃ,sankhyeyyappadhanavasenatthagahanam,1,1,0,0,35
90886,saṅkhyāppadhānavasena,sankhyappadhanavasena,2,2,0,0,21
90887,assatarīrathānaṃ,assatarirathanam,1,1,0,0,16
90888,āmukkamaṇikuṇḍalānaṃ,amukkamanikundalanam,1,1,0,0,20
90889,yojanānaṃ,yojananam,55,50,5,0,9
90890,satānucco,satanucco,10,7,3,0,9
90891,ayamaṭṭhakathāpāṭho,ayamatthakathapatho,1,1,0,0,19
90892,uccoti,uccoti,1,1,0,0,6
90893,satānī,satani,9,8,1,0,6
90894,accantasaṃyogavasena,accantasamyogavasena,14,14,0,0,20
90895,athetthekasataṃ,athetthekasatam,5,5,0,0,15
90896,anuyantā,anuyanta,37,36,1,0,8
90897,ekavacanabahuvacanatā,ekavacanabahuvacanata,1,1,0,0,21
90898,yakkhānaṃ,yakkhanam,81,76,5,0,9
90899,payirupāsatī,payirupasati,7,7,0,0,12
90900,asaṅkhiye,asankhiye,16,16,0,0,9
90901,asaṅkhiyeti,asankhiyeti,7,3,4,0,11
90902,mahākappānaṃ,mahakappanam,28,28,0,0,12
90903,vacanaseso,vacanaseso,94,91,3,0,10
90904,kappasatasahassādhikānaṃ,kappasatasahassadhikanam,21,21,0,0,24
90905,bodhipācanaṃ,bodhipacanam,7,6,1,0,12
90906,saddasambandhena,saddasambandhena,2,2,0,0,16
90907,upayoganiddeso,upayoganiddeso,7,5,2,0,14
90908,samānādhikaraṇañhi,samanadhikarananhi,1,1,0,0,18
90909,acchantasaṃyogavasena,acchantasamyogavasena,1,1,0,0,21
90910,upayogabahuvacanāni,upayogabahuvacanani,1,1,0,0,19
90911,kappassa,kappassa,58,58,0,0,8
90912,avuttassa,avuttassa,17,17,0,0,9
90913,asaṅkhyeyye,asankhyeyye,32,32,0,0,11
90914,mahākappe,mahakappe,22,22,0,0,9
90915,ghaṭānekasahassāni,ghatanekasahassani,6,6,0,0,18
90916,kumbhīnañca,kumbhinanca,7,6,1,0,11
90917,ghaṭāti,ghatati,8,3,5,0,7
90918,ghaṭānaṃ,ghatanam,6,6,0,0,8
90919,kumbhīnaṃ,kumbhinam,1,1,0,0,9
90920,dasavīsasahassānaṃ,dasavisasahassanam,11,7,4,0,18
90921,dhammābhisamayo,dhammabhisamayo,308,295,13,0,15
90922,ekadvinnaṃ,ekadvinnam,12,8,4,0,10
90923,gaṇanāto,gananato,104,102,2,0,8
90924,asaṅkhiyo,asankhiyo,7,7,0,0,9
90925,dasasahassānaṃ,dasasahassanam,7,7,0,0,14
90926,vīsasahassānañca,visasahassananca,1,1,0,0,16
90927,dhammābhisamayoti,dhammabhisamayoti,22,14,8,0,17
90928,catusaccappaṭivedho,catusaccappativedho,2,2,0,0,19
90929,sīsamattakathanaṃ,sisamattakathanam,1,1,0,0,17
90930,dvinnañca,dvinnanca,31,29,2,0,9
90931,asaṅkhyeyyoti,asankhyeyyoti,2,1,1,0,13
90932,satasahassāni,satasahassani,181,179,2,0,13
90933,mahiddhikā,mahiddhika,113,107,6,0,10
90934,dīpaṅkaraṃ,dipankaram,16,16,0,0,10
90935,lokaviduṃ,lokavidum,7,7,0,0,9
90936,parivārenti,parivarenti,114,110,4,0,11
90937,satasahassānīti,satasahassaniti,5,2,3,0,15
90938,liṅgabhedavasena,lingabhedavasena,1,1,0,0,16
90939,asaṅkhyeyya,asankhyeyya,6,6,0,0,11
90940,vācakopi,vacakopi,1,1,0,0,8
90941,napuṃsakova,napumsakova,1,1,0,0,11
90942,satasahassānī,satasahassani,10,9,1,0,13
90943,padattayaṃ,padattayam,15,14,1,0,10
90944,mahiddhikāti,mahiddhikati,8,3,5,0,12
90945,chaḷabhiññānaṃ,chalabhinnanam,14,11,3,0,14
90946,mahaddhikānanti,mahaddhikananti,1,1,0,0,15
90947,samalaṅkatā,samalankata,67,66,1,0,11
90948,satāti,satati,22,5,17,0,6
90949,vipākā,vipaka,301,287,14,0,6
90950,itthiliṅgabhūtā,itthilingabhuta,2,2,0,0,15
90951,pulliṅgabhūto,pullingabhuto,1,1,0,0,13
90952,kārantapulliṅga,karantapullinga,1,1,0,0,15
90953,kārantitthirūpehipibhavitabbaṃ,karantitthirupehipibhavitabbam,1,1,0,0,30
90954,rūpadvayampi,rupadvayampi,1,1,0,0,12
90955,ekantanapuṃsako,ekantanapumsako,1,1,0,0,15
90956,napuṃsakoyevāti,napumsakoyevati,1,1,0,0,15
90957,samānādhikaraṇoti,samanadhikaranoti,2,2,0,0,17
90958,napuṃsakoyeva,napumsakoyeva,3,3,0,0,13
90959,saṅkhyāvisayesu,sankhyavisayesu,1,1,0,0,15
90960,samānādhikaraṇabhāvo,samanadhikaranabhavo,12,10,2,0,20
90961,ciravāsino,ciravasino,1,1,0,0,10
90962,sattasatānī,sattasatani,1,1,0,0,11
90963,napuṃsakabhāvoyevāti,napumsakabhavoyevati,1,1,0,0,20
90964,avagantabbo,avagantabbo,3,3,0,0,11
90965,hatthisate,hatthisate,3,3,0,0,10
90966,navutikoṭisahassehi,navutikotisahassehi,7,7,0,0,19
90967,parivāresi,parivaresi,27,27,0,0,10
90968,bhikkhūhī,bhikkhuhi,16,10,6,0,9
90969,navutikoṭisahassehī,navutikotisahassehi,1,1,0,0,19
90970,saṅkhyeyyasaṅkhyāpadhānavasena,sankhyeyyasankhyapadhanavasena,1,1,0,0,30
90971,satasahassavassāni,satasahassavassani,7,7,0,0,18
90972,satasahassavassānī,satasahassavassani,1,1,0,0,18
90973,dasavassasahassāni,dasavassasahassani,34,34,0,0,18
90974,agāra,agara,3,3,0,0,5
90975,pāḷiyampi,paliyampi,50,46,4,0,9
90976,satasahassamhi,satasahassamhi,50,49,1,0,14
90977,ekanavute,ekanavute,37,36,1,0,9
90978,ekanavutiyā,ekanavutiya,5,5,0,0,11
90979,sāmibhummavacanavasena,samibhummavacanavasena,2,2,0,0,22
90980,vussatī,vussati,90,89,1,0,7
90981,nahutāni,nahutani,34,33,1,0,8
90982,nevamhākaṃ,nevamhakam,4,4,0,0,10
90983,vāḷesu,valesu,6,6,0,0,6
90984,ayametassā,ayametassa,1,1,0,0,10
90985,satānīti,sataniti,15,8,7,0,8
90986,vijjantesupi,vijjantesupi,1,1,0,0,12
90987,kocīti,kociti,52,12,40,0,6
90988,vāḷe,vale,12,11,1,0,4
90989,vāḷamigassa,valamigassa,1,1,0,0,11
90990,vāḷesū,valesu,1,1,0,0,6
90991,bhummaṃ,bhummam,292,272,20,0,7
90992,chattiṃsaparimaṇḍalaṃ,chattimsaparimandalam,3,3,0,0,21
90993,dasañceva,dasanceva,3,3,0,0,9
90994,aḍḍhuḍḍhāni,addhuddhani,35,30,5,0,11
90995,samānavibhattiliṅgavacanānaṃ,samanavibhattilingavacananam,1,1,0,0,28
90996,asamānavibhattiliṅgavacanānaṃ,asamanavibhattilingavacananam,1,1,0,0,29
90997,ṭhitānampi,thitanampi,38,38,0,0,10
90998,ekasambandho,ekasambandho,4,4,0,0,12
90999,chattiṃsā,chattimsa,10,7,3,0,9
91000,bahalattena,bahalattena,22,21,1,0,11
91001,saṅkhātāyaṃ,sankhatayam,10,9,1,0,11
91002,nahutānī,nahutani,2,1,1,0,8
91003,dvisatasahassaṃ,dvisatasahassam,3,3,0,0,15
91004,catunahutaṃ,catunahutam,1,1,0,0,11
91005,atthappakāsanāni,atthappakasanani,1,1,0,0,16
91006,saṅkhyāsaddehi,sankhyasaddehi,2,2,0,0,14
91007,puthujjanā,puthujjana,466,436,30,0,10
91008,dabbavācakattā,dabbavacakatta,2,2,0,0,14
91009,visesitabbapadānaṃ,visesitabbapadanam,2,2,0,0,18
91010,adabbavācakattā,adabbavacakatta,1,1,0,0,15
91011,imesamaññamaññasambandharahitā,imesamannamannasambandharahita,1,1,0,0,30
91012,visesanavisesitabbabhāvena,visesanavisesitabbabhavena,12,12,0,0,26
91013,laddhabboti,laddhabboti,2,2,0,0,11
91014,guṇaguṇīnaṃyeva,gunaguninamyeva,1,1,0,0,15
91015,visesanavisesitabbānaṃ,visesanavisesitabbanam,5,5,0,0,22
91016,visesanavisesitabbattepi,visesanavisesitabbattepi,1,1,0,0,24
91017,pamāṇavacanaṃ,pamanavacanam,2,2,0,0,13
91018,bahalattenā,bahalattena,1,1,0,0,11
91019,bhāvanapuṃsakaṃ,bhavanapumsakam,46,43,3,0,15
91020,kriyāvisesananti,kriyavisesananti,1,1,0,0,16
91021,hutāni,hutani,2,2,0,0,6
91022,saṅkhyāvacanamattattā,sankhyavacanamattatta,1,1,0,0,21
91023,sabbopāyaṃ,sabbopayam,8,8,0,0,10
91024,dasettha,dasettha,10,8,2,0,8
91025,rājiyo,rajiyo,26,25,1,0,6
91026,haliddā,halidda,5,5,0,0,7
91027,catuddasā,catuddasa,5,5,0,0,9
91028,pannarasāti,pannarasati,8,5,3,0,11
91029,rājiyoti,rajiyoti,2,1,1,0,8
91030,puttāpi,puttapi,37,35,2,0,7
91031,ekanāmā,ekanama,7,5,2,0,7
91032,indanāmā,indanama,17,15,2,0,8
91033,mahabbalā,mahabbala,141,141,0,0,9
91034,ekanavutī,ekanavuti,1,1,0,0,9
91035,vicitrasaddaracanañhi,vicitrasaddaracananhi,1,1,0,0,21
91036,pāvacanaṃ,pavacanam,76,65,11,0,9
91037,tiṃsapurisanāvutyo,timsapurisanavutyo,1,1,0,0,18
91038,sabbevekekaniccitā,sabbevekekaniccita,3,3,0,0,18
91039,mahi,mahi,3,3,0,0,4
91040,tiṃsasahassāni,timsasahassani,2,2,0,0,14
91041,nāvutyo,navutyo,3,3,0,0,7
91042,edisāya,edisaya,5,5,0,0,7
91043,saddaracanāya,saddaracanaya,1,1,0,0,13
91044,upadesena,upadesena,5,5,0,0,9
91045,lokasaṅketarūḷhaṃ,lokasanketarulham,1,1,0,0,17
91046,saṅketarūḷhassa,sanketarulhassa,1,1,0,0,15
91047,vacanassattho,vacanassattho,3,3,0,0,13
91048,gahitapubbasaṅketehi,gahitapubbasanketehi,1,1,0,0,20
91049,upadesato,upadesato,4,4,0,0,9
91050,brahmadattena,brahmadattena,30,27,3,0,13
91051,vuttakālepi,vuttakalepi,3,3,0,0,11
91052,tiṃsañceva,timsanceva,1,1,0,0,10
91053,nāvutiyo,navutiyo,1,1,0,0,8
91054,umaṅgajātake,umangajatake,8,4,4,0,12
91055,acintiyā,acintiya,29,26,3,0,8
91056,suguḷhatthā,sugulhattha,1,1,0,0,11
91057,dayāpannena,dayapannena,4,4,0,0,11
91058,desitā,desita,373,368,5,0,6
91059,jinabhāsite,jinabhasite,6,6,0,0,11
91060,garūpadesahīno,garupadesahino,2,2,0,0,14
91061,atthasāraṃ,atthasaram,17,17,0,0,10
91062,atthasāravihīno,atthasaravihino,2,2,0,0,15
91063,parihāyati,parihayati,550,542,8,0,10
91064,garūpadesalābhī,garupadesalabhi,2,2,0,0,15
91065,atthasārasamāyuto,atthasarasamayuto,2,2,0,0,17
91066,paripālento,paripalento,4,4,0,0,11
91067,saddhammasmā,saddhammasma,2,2,0,0,12
91068,hāyati,hayati,146,136,10,0,6
91069,saddhammatthāya,saddhammatthaya,4,4,0,0,15
91070,saṅkhyāmālāpi,sankhyamalapi,1,1,0,0,13
91071,sahevatthavinicchayā,sahevatthavinicchaya,1,1,0,0,20
91072,terasamo,terasamo,53,53,0,0,8
91073,atthattikavibhāga,atthattikavibhaga,1,1,0,0,17
91074,nipphannarūpañcāti,nipphannarupancati,1,1,0,0,18
91075,padhānamamhehi,padhanamamhehi,1,1,0,0,14
91076,vakkhāmatthattikaṃ,vakkhamatthattikam,1,1,0,0,18
91077,mantañca,mantanca,2,2,0,0,8
91078,diyantaṃ,diyantam,1,1,0,0,8
91079,khandhasattāmanussesu,khandhasattamanussesu,1,1,0,0,21
91080,khīṇāsave,khinasave,44,43,1,0,9
91081,rukkhādimhi,rukkhadimhi,1,1,0,0,11
91082,sopasaggoyaṃ,sopasaggoyam,1,1,0,0,12
91083,hīḷane,hilane,3,3,0,0,6
91084,vidhamepi,vidhamepi,1,1,0,0,9
91085,parājaye,parajaye,18,17,1,0,8
91086,vediyane,vediyane,3,3,0,0,8
91087,pākaṭatāya,pakatataya,5,5,0,0,10
91088,pañcakkhandhāmanussadhātuvijjamānakhīṇāsavasattarukkhādīsu,pancakkhandhamanussadhatuvijjamanakhinasavasattarukkhadisu,1,1,0,0,58
91089,bhūtamidanti,bhutamidanti,27,24,3,0,12
91090,pañcakkhandhesu,pancakkhandhesu,5,5,0,0,15
91091,samāgatānī,samagatani,4,4,0,0,10
91092,amanusse,amanusse,11,10,1,0,8
91093,pācittiyaṃ,pacittiyam,2549,2192,357,0,10
91094,bhūtagāmapātabyatāyā,bhutagamapatabyataya,7,5,2,0,20
91095,rukkhādīsūti,rukkhadisuti,2,1,1,0,12
91096,mūlapariyāyasuttaṭṭhakathāya,mulapariyayasuttatthakathaya,1,0,1,0,28
91097,mādisaddena,madisaddena,1,1,0,0,11
91098,uppādādīni,uppadadini,4,4,0,0,10
91099,gayhare,gayhare,8,8,0,0,7
91100,saṅkhataṃ,sankhatam,284,252,32,0,9
91101,saupasaggo,saupasaggo,47,42,5,0,10
91102,pabhūtamariyo,pabhutamariyo,2,2,0,0,13
91103,paribhūtarūpo,paribhutarupo,2,2,0,0,13
91104,sāṇavāsī,sanavasi,11,11,0,0,8
91105,vijito,vijito,25,24,1,0,6
91106,saṅgāmo,sangamo,51,48,3,0,7
91107,vidhamane,vidhamane,1,1,0,0,9
91108,parābhūtarūpokho,parabhutarupokho,1,1,0,0,16
91109,acelo,acelo,119,115,4,0,5
91110,pāthikaputto,pathikaputto,58,58,0,0,12
91111,anubhūtaṃ,anubhutam,45,43,2,0,9
91112,paññāyā,pannaya,26,15,11,0,7
91113,rukkhādīsū,rukkhadisu,1,1,0,0,10
91114,itiādisaddena,itiadisaddena,12,12,0,0,13
91115,daṭṭhabbāti,datthabbati,56,42,14,0,11
91116,mantapadāni,mantapadani,17,17,0,0,11
91117,ubbhavituṃ,ubbhavitum,1,1,0,0,10
91118,samubbhavituṃ,samubbhavitum,1,1,0,0,13
91119,pabhavituṃ,pabhavitum,1,1,0,0,10
91120,parābhavituṃ,parabhavitum,1,1,0,0,12
91121,atibhavituṃ,atibhavitum,2,2,0,0,11
91122,sambhavituṃ,sambhavitum,9,7,2,0,11
91123,vibhavituṃ,vibhavitum,1,1,0,0,10
91124,sambhotuṃ,sambhotum,1,1,0,0,9
91125,vibhotuṃ,vibhotum,1,1,0,0,8
91126,pātubhavituṃ,patubhavitum,1,1,0,0,12
91127,pātubbhavituṃ,patubbhavitum,1,1,0,0,13
91128,pātubhotuṃ,patubhotum,1,1,0,0,10
91129,paribhotuṃ,paribhotum,1,1,0,0,10
91130,abhibhotuṃ,abhibhotum,1,1,0,0,10
91131,abhibhavituṃ,abhibhavitum,30,30,0,0,12
91132,adhibhotuṃ,adhibhotum,1,1,0,0,10
91133,adhibhavituṃ,adhibhavitum,5,5,0,0,12
91134,atibhotuṃ,atibhotum,1,1,0,0,9
91135,anubhotuṃ,anubhotum,1,1,0,0,9
91136,samanubhotuṃ,samanubhotum,1,1,0,0,12
91137,samanubhavituṃ,samanubhavitum,1,1,0,0,14
91138,abhisambhotuṃ,abhisambhotum,2,2,0,0,13
91139,abhisambhavituṃ,abhisambhavitum,8,6,2,0,15
91140,bhāvetuṃ,bhavetum,37,37,0,0,8
91141,pabhāvetuṃ,pabhavetum,1,1,0,0,10
91142,sambhāvetuṃ,sambhavetum,14,14,0,0,11
91143,paribhāvetuṃ,paribhavetum,1,1,0,0,12
91144,sakammakāniyeva,sakammakaniyeva,1,1,0,0,15
91145,samānatthapadesu,samanatthapadesu,2,2,0,0,16
91146,ekamevādipadaṃ,ekamevadipadam,2,2,0,0,14
91147,vijjituṃ,vijjitum,1,1,0,0,8
91148,paññāyituṃ,pannayitum,1,1,0,0,10
91149,labhituṃ,labhitum,21,21,0,0,8
91150,sesānampi,sesanampi,30,29,1,0,9
91151,catutthiyatthe,catutthiyatthe,3,2,1,0,14
91152,cittamaññāya,cittamannaya,35,34,1,0,12
91153,yācitumāgato,yacitumagato,10,10,0,0,12
91154,yācituṃ,yacitum,108,101,7,0,7
91155,yācanatthāyāti,yacanatthayati,1,1,0,0,14
91156,bhavanatthāyā,bhavanatthaya,1,1,0,0,13
91157,bhavanatthaṃ,bhavanattham,1,1,0,0,12
91158,bhavanāyā,bhavanaya,1,1,0,0,9
91159,daṭṭhu,datthu,43,30,13,0,6
91160,atthadassanato,atthadassanato,1,1,0,0,14
91161,mantāni,mantani,3,3,0,0,7
91162,saddantapadatthavasenapi,saddantapadatthavasenapi,1,1,0,0,24
91163,nipātapadesu,nipatapadesu,1,1,0,0,12
91164,saṅgahaṃgacchanti,sangahamgacchanti,1,1,0,0,17
91165,nipātapadaparicchede,nipatapadaparicchede,1,1,0,0,20
91166,tatrāyamattho,tatrayamattho,18,18,0,0,13
91167,etadanto,etadanto,1,1,0,0,8
91168,mantakathā,mantakatha,1,1,0,0,10
91169,diyantapadāni,diyantapadani,5,5,0,0,13
91170,bhavitvā,bhavitva,50,49,1,0,8
91171,bhavitvāna,bhavitvana,13,13,0,0,10
91172,bhavituna,bhavituna,1,1,0,0,9
91173,bhaviya,bhaviya,1,1,0,0,7
91174,bhaviyāna,bhaviyana,1,1,0,0,9
91175,ubbhavitvā,ubbhavitva,1,1,0,0,10
91176,ubbhavitvāna,ubbhavitvana,1,1,0,0,12
91177,ubbhavituna,ubbhavituna,1,1,0,0,11
91178,ubbhaviya,ubbhaviya,1,1,0,0,9
91179,ubbhaviyāna,ubbhaviyana,1,1,0,0,11
91180,samubbhavitvā,samubbhavitva,1,1,0,0,13
91181,parābhavitvā,parabhavitva,1,1,0,0,12
91182,sambhavitvā,sambhavitva,3,3,0,0,11
91183,vibhavitvā,vibhavitva,1,1,0,0,10
91184,pātubbhavitvā,patubbhavitva,1,1,0,0,13
91185,ussukkanatthāni,ussukkanatthani,3,3,0,0,15
91186,bhutvāna,bhutvana,35,30,5,0,8
91187,paribhavitvā,paribhavitva,16,15,1,0,12
91188,paribhavitvāna,paribhavitvana,1,1,0,0,14
91189,paribhavituna,paribhavituna,1,1,0,0,13
91190,paribhaviya,paribhaviya,2,2,0,0,11
91191,paribhaviyāna,paribhaviyana,1,1,0,0,13
91192,paribhuyya,paribhuyya,3,3,0,0,10
91193,abhibhavitvāna,abhibhavitvana,1,1,0,0,14
91194,abhibhavituna,abhibhavituna,1,1,0,0,13
91195,abhibhaviya,abhibhaviya,9,9,0,0,11
91196,abhibhaviyāna,abhibhaviyana,1,1,0,0,13
91197,adhibhavitvā,adhibhavitva,15,14,1,0,12
91198,atibhavitvā,atibhavitva,2,2,0,0,11
91199,idañcettha,idancettha,22,19,3,0,10
91200,tamavoca,tamavoca,5,4,1,0,8
91201,anubhaviyāna,anubhaviyana,4,3,1,0,12
91202,ahamapi,ahamapi,13,12,1,0,7
91203,anubhutvā,anubhutva,5,5,0,0,9
91204,anubhutvāna,anubhutvana,4,4,0,0,11
91205,adhibhotvā,adhibhotva,3,3,0,0,10
91206,adhibhotvāna,adhibhotvana,2,2,0,0,12
91207,kappasahassāni,kappasahassani,73,73,0,0,14
91208,ramissati,ramissati,50,49,1,0,9
91209,kārayissatī,karayissati,1,1,0,0,11
91210,suddhakattariyeva,suddhakattariyeva,1,1,0,0,17
91211,bhāvetvāna,bhavetvana,3,3,0,0,10
91212,pabhāvetvā,pabhavetva,1,1,0,0,10
91213,pabhāvetvāna,pabhavetvana,1,1,0,0,12
91214,sambhāvetvā,sambhavetva,19,18,1,0,11
91215,sambhāvetvāna,sambhavetvana,3,3,0,0,13
91216,vibhāvetvā,vibhavetva,60,58,2,0,10
91217,vibhāvetvāna,vibhavetvana,1,1,0,0,12
91218,paribhāvetvā,paribhavetva,23,23,0,0,12
91219,paribhāvetvāna,paribhavetvana,1,1,0,0,14
91220,hetukattariyeva,hetukattariyeva,1,1,0,0,15
91221,bhavitvāti,bhavitvati,6,1,5,0,10
91222,paññāyitvā,pannayitva,1,1,0,0,10
91223,diyantapadānaṃ,diyantapadanam,1,1,0,0,14
91224,bhutvāti,bhutvati,6,0,6,0,8
91225,anubhutvāti,anubhutvati,2,1,1,0,11
91226,imesañhi,imesanhi,50,42,8,0,8
91227,samānatthataṃ,samanatthatam,4,4,0,0,13
91228,saddhammavidū,saddhammavidu,1,1,0,0,13
91229,sūcenti,sucenti,2,2,0,0,7
91230,bhūtvā,bhutva,4,4,0,0,6
91231,rassatā,rassata,2,2,0,0,7
91232,dvayampetaṃ,dvayampetam,1,1,0,0,11
91233,dīghattasañhitaṃ,dighattasanhitam,1,1,0,0,16
91234,savisesantu,savisesantu,1,1,0,0,11
91235,sāradassinā,saradassina,2,2,0,0,11
91236,pekkhitabbakaṃ,pekkhitabbakam,1,1,0,0,14
91237,ussukkanatthe,ussukkanatthe,3,3,0,0,13
91238,diyantapadānipi,diyantapadanipi,1,1,0,0,15
91239,avibhattikānīti,avibhattikaniti,1,1,0,0,15
91240,nipātaparicchede,nipataparicchede,1,1,0,0,16
91241,avibhattikāni,avibhattikani,4,4,0,0,13
91242,saddatthavidūnaṃ,saddatthavidunam,1,1,0,0,16
91243,paṭhamādivibhattivasena,pathamadivibhattivasena,1,1,0,0,23
91244,savibhattikāni,savibhattikani,4,4,0,0,14
91245,imasmiñca,imasminca,187,173,14,0,9
91246,diyantādhikāre,diyantadhikare,1,1,0,0,14
91247,idañcupalakkhitabbaṃ,idancupalakkhitabbam,1,1,0,0,20
91248,kasitvā,kasitva,48,47,1,0,7
91249,umaṅgā,umanga,8,8,0,0,6
91250,nikkhamitvāna,nikkhamitvana,53,53,0,0,13
91251,nāvamāruhi,navamaruhi,3,3,0,0,10
91252,bhikkhassu,bhikkhassu,6,6,0,0,10
91253,samānakattukānaṃ,samanakattukanam,8,8,0,0,16
91254,disaddappayogā,disaddappayoga,2,2,0,0,14
91255,pubbakālakriyādīpakaṃ,pubbakalakriyadipakam,2,2,0,0,21
91256,uttarakālakriyādīpakaṃ,uttarakalakriyadipakam,2,2,0,0,22
91257,samānakattukāni,samanakattukani,1,1,0,0,15
91258,gamanakriyāya,gamanakriyaya,1,1,0,0,13
91259,bhuñjanakriyāya,bhunjanakriyaya,1,1,0,0,15
91260,nihantvāna,nihantvana,16,16,0,0,10
91261,uditoyaṃ,uditoyam,2,2,0,0,8
91262,paññāvabhāsehi,pannavabhasehi,1,1,0,0,14
91263,samuggato,samuggato,18,17,1,0,9
91264,samānakāle,samanakale,9,8,1,0,10
91265,nihantvānā,nihantvana,2,2,0,0,10
91266,samānakālakriyādīpakaṃ,samanakalakriyadipakam,2,2,0,0,22
91267,samānakālakriyāya,samanakalakriyaya,1,1,0,0,17
91268,idhādhippetattā,idhadhippetatta,30,30,0,0,15
91269,byādāya,byadaya,3,3,0,0,7
91270,akkhiṃ,akkhim,49,47,2,0,6
91271,udāharanti,udaharanti,13,12,1,0,10
91272,nisajja,nisajja,177,175,2,0,7
91273,kathetī,katheti,90,78,12,0,7
91274,byādānaparivattanuttarakālo,byadanaparivattanuttarakalo,1,1,0,0,27
91275,byādānūpasamalakkhaṇaṃ,byadanupasamalakkhanam,1,1,0,0,22
91276,passanakriyāya,passanakriyaya,1,1,0,0,14
91277,samānakālatāyapi,samanakalatayapi,2,2,0,0,16
91278,ajjhenakathanehi,ajjhenakathanehi,2,2,0,0,16
91279,nisajjaṭṭhānāni,nisajjatthanani,2,2,0,0,15
91280,pubbuttarakālatā,pubbuttarakalata,3,3,0,0,16
91281,purimāniyeva,purimaniyeva,4,4,0,0,12
91282,udāharaṇāni,udaharanani,25,25,0,0,11
91283,yuttāni,yuttani,34,34,0,0,7
91284,udayasamakālameva,udayasamakalameva,2,2,0,0,17
91285,tannivattanīyanivattananti,tannivattaniyanivattananti,1,1,0,0,26
91286,dvāramāvaritvā,dvaramavaritva,2,2,0,0,14
91287,aparakāle,aparakale,15,13,2,0,9
91288,disaddappayogo,disaddappayogo,5,5,0,0,14
91289,pavisanakriyā,pavisanakriya,1,1,0,0,13
91290,āvaraṇakriyā,avaranakriya,1,1,0,0,12
91291,pacchimā,pacchima,284,263,21,0,8
91292,āvaritvā,avaritva,22,22,0,0,8
91293,aparakālakriyādīpakaṃ,aparakalakriyadipakam,1,1,0,0,21
91294,pavisatī,pavisati,14,9,5,0,8
91295,dhaṃ,dham,5,5,0,0,4
91296,kacca,kacca,11,10,1,0,5
91297,udāharaṇanti,udaharananti,5,5,0,0,12
91298,abhighātabhūtasamāyoge,abhighatabhutasamayoge,1,1,0,0,22
91299,abhighātajasaddassa,abhighatajasaddassa,2,2,0,0,19
91300,samānakālatā,samanakalata,3,3,0,0,12
91301,yuttānīti,yuttaniti,5,5,0,0,9
91302,pisācaṃ,pisacam,8,6,2,0,7
91303,asamāne,asamane,6,5,1,0,7
91304,samānakattukatā,samanakattukata,8,8,0,0,15
91305,dassanakriyāya,dassanakriyaya,1,1,0,0,14
91306,bhavanādikriyāya,bhavanadikriyaya,1,1,0,0,16
91307,pavattanatoti,pavattanatoti,22,21,1,0,13
91308,upalakkhitabbaṃ,upalakkhitabbam,1,1,0,0,15
91309,parāparayogo,paraparayogo,2,1,1,0,12
91310,lakkhaṇahetuādippayogo,lakkhanahetuadippayogo,2,1,1,0,22
91311,nhatvā,nhatva,191,188,3,0,6
91312,miccāpi,miccapi,1,1,0,0,7
91313,byattayena,byattayena,3,2,1,0,10
91314,saddasiddhippayogoti,saddasiddhippayogoti,2,1,1,0,20
91315,asamānakattukānaṃ,asamanakattukanam,1,1,0,0,17
91316,diyantānaṃ,diyantanam,2,2,0,0,10
91317,pubbakālekakattukānaṃ,pubbakalekakattukanam,3,2,1,0,21
91318,pubbakāleyeva,pubbakaleyeva,1,1,0,0,13
91319,ekakattukaggahaṇaṃ,ekakattukaggahanam,1,1,0,0,18
91320,yetuyyena,yetuyyena,1,1,0,0,9
91321,purimakālakriyādīpanato,purimakalakriyadipanato,1,1,0,0,23
91322,hetuatthavasenapi,hetuatthavasenapi,1,1,0,0,17
91323,disaddantānaṃ,disaddantanam,1,1,0,0,13
91324,pacitvā,pacitva,315,307,8,0,7
91325,bhavanahetu,bhavanahetu,1,1,0,0,11
91326,pacanahetū,pacanahetu,1,1,0,0,10
91327,hetuatthopi,hetuatthopi,2,2,0,0,11
91328,hetutthepi,hetutthepi,1,1,0,0,10
91329,ussukkanatthakā,ussukkanatthaka,1,1,0,0,15
91330,hetuvasenāpi,hetuvasenapi,1,1,0,0,12
91331,vadeyyatthaṃ,vadeyyattham,1,1,0,0,12
91332,atthasaṃvaṇṇanāsu,atthasamvannanasu,1,1,0,0,17
91333,karaṇahetū,karanahetu,2,1,1,0,10
91334,pāṭhepi,pathepi,2,2,0,0,7
91335,hetuttho,hetuttho,6,5,1,0,8
91336,pubbaviññubhi,pubbavinnubhi,1,1,0,0,13
91337,gamanahetū,gamanahetu,1,1,0,0,10
91338,hetutthevaṃ,hetutthevam,1,1,0,0,11
91339,yathāyogamaññatrāpi,yathayogamannatrapi,1,1,0,0,19
91340,mantapadañca,mantapadanca,1,1,0,0,12
91341,diyantapadañcāti,diyantapadancati,1,1,0,0,16
91342,atthattikaṃ,atthattikam,1,1,0,0,11
91343,imamatthatikaṃ,imamatthatikam,1,1,0,0,14
91344,kaṇṇarasāyanamāgamikānaṃ,kannarasayanamagamikanam,1,1,0,0,24
91345,gatakaṅkhā,gatakankha,1,1,0,0,10
91346,pāvacanamhi,pavacanamhi,1,1,0,0,11
91347,sukhumatthe,sukhumatthe,1,1,0,0,11
91348,atthattikavibhāgo,atthattikavibhago,1,1,0,0,17
91349,cuddasamo,cuddasamo,48,48,0,0,9
91350,dhāturūpāni,dhaturupani,5,5,0,0,11
91351,dhātumālā,dhatumala,2,1,1,0,9
91352,saravaggapañcakantika,saravaggapancakantika,1,1,0,0,21
91353,suddhassaradhātu,suddhassaradhatu,1,1,0,0,16
91354,kakārantādibhedato,kakarantadibhedato,1,1,0,0,18
91355,dhātunipphannarūpāni,dhatunipphannarupani,1,1,0,0,20
91356,jinapāṭhe,jinapathe,1,1,0,0,9
91357,kathessa,kathessa,1,1,0,0,8
91358,gatiattho,gatiattho,9,9,0,0,9
91359,buddhipi,buddhipi,10,10,0,0,8
91360,pavattipāpuṇānipi,pavattipapunanipi,1,1,0,0,17
91361,iriyāpathagamanaṃ,iriyapathagamanam,2,2,0,0,17
91362,ñāṇuppatti,nanuppatti,2,2,0,0,10
91363,iriyāpathagamanena,iriyapathagamanena,1,1,0,0,18
91364,gacchatītipi,gacchatitipi,5,5,0,0,12
91365,ñāṇagamanena,nanagamanena,6,6,0,0,12
91366,udāyatī,udayati,1,1,0,0,7
91367,uṭṭhāpetīti,utthapetiti,11,6,5,0,11
91368,dukāro,dukaro,1,1,0,0,6
91369,samupeti,samupeti,7,6,1,0,8
91370,aveti,aveti,6,4,2,0,5
91371,abhisameti,abhisameti,116,111,5,0,10
91372,īdi,idi,1,1,0,0,3
91373,ekodi,ekodi,87,69,18,0,5
91374,anvito,anvito,3,3,0,0,6
91375,paṭiyamāno,patiyamano,1,1,0,0,10
91376,paṭicco,paticco,12,11,1,0,7
91377,ento,ento,1,1,0,0,4
91378,itthinapuṃsakavasenapi,itthinapumsakavasenapi,1,1,0,0,22
91379,paccetuṃ,paccetum,3,3,0,0,8
91380,upetuṃ,upetum,2,2,0,0,6
91381,samupetuṃ,samupetum,2,2,0,0,9
91382,anvetuṃ,anvetum,2,2,0,0,7
91383,sametuṃ,sametum,15,15,0,0,7
91384,abhisametuṃ,abhisametum,11,10,1,0,11
91385,icca,icca,5,5,0,0,4
91386,abhisamecca,abhisamecca,97,95,2,0,11
91387,apecca,apecca,8,8,0,0,6
91388,itvā,itva,4,4,0,0,4
91389,itvāna,itvana,1,1,0,0,6
91390,upetvā,upetva,35,35,0,0,6
91391,upetvāna,upetvana,1,1,0,0,8
91392,upetuna,upetuna,1,1,0,0,7
91393,buddhavacanānurūpato,buddhavacananurupato,1,1,0,0,20
91394,dassanāyeva,dassanayeva,1,1,0,0,11
91395,itāyaṃ,itayam,7,5,2,0,6
91396,kodharūpena,kodharupena,3,3,0,0,11
91397,aṅguttaranikāyamhi,anguttaranikayamhi,1,0,1,0,18
91398,munināhacca,muninahacca,1,1,0,0,11
91399,aṅguttaranikāye,anguttaranikaye,80,78,2,0,15
91400,nindantena,nindantena,1,1,0,0,10
91401,maccuveso,maccuveso,4,3,1,0,9
91402,guhāsayo,guhasayo,10,9,1,0,8
91403,damena,damena,63,62,1,0,6
91404,samucchinde,samucchinde,3,3,0,0,11
91405,paññāvīriyena,pannaviriyena,6,5,1,0,13
91406,lokiyamahājanena,lokiyamahajanena,6,6,0,0,16
91407,sarīrasaṅkhātaguhāsayo,sarirasankhataguhasayo,1,1,0,0,22
91408,maccurājā,maccuraja,54,46,8,0,9
91409,kodhavasena,kodhavasena,72,69,3,0,11
91410,pamaddanto,pamaddanto,1,1,0,0,10
91411,sattasantāne,sattasantane,33,32,1,0,12
91412,anatthakaraṃ,anatthakaram,2,2,0,0,12
91413,hitakāmo,hitakamo,24,24,0,0,8
91414,chindeyyāti,chindeyyati,9,4,5,0,11
91415,sandhikiccena,sandhikiccena,1,1,0,0,13
91416,paṭicchannattā,paticchannatta,43,43,0,0,14
91417,valāhakāvattharito,valahakavattharito,1,1,0,0,18
91418,puṇṇacando,punnacando,69,67,2,0,10
91419,etu,etu,49,48,1,0,3
91420,āgacchatū,agacchatu,85,84,1,0,9
91421,byākaraṇasatthepi,byakaranasatthepi,1,1,0,0,17
91422,vuddhivasena,vuddhivasena,2,2,0,0,12
91423,āgamanādīni,agamanadini,1,1,0,0,11
91424,mattāvasenapi,mattavasenapi,1,1,0,0,13
91425,savisesatthāni,savisesatthani,1,1,0,0,14
91426,pabbājitoti,pabbajitoti,2,2,0,0,11
91427,saññogāsaññogavasenapi,sannogasannogavasenapi,1,1,0,0,22
91428,niggacchati,niggacchati,34,34,0,0,11
91429,āgamanatthassa,agamanatthassa,2,2,0,0,14
91430,vācikā,vacika,4,4,0,0,6
91431,iriyāpathatthato,iriyapathatthato,1,1,0,0,16
91432,niccāgamavācikā,niccagamavacika,1,1,0,0,15
91433,aniriyāpathatthena,aniriyapathatthena,1,1,0,0,18
91434,gamanepi,gamanepi,11,11,0,0,8
91435,phalametī,phalameti,1,1,0,0,9
91436,vuddhippattā,vuddhippatta,18,17,1,0,12
91437,ikāravhā,ikaravha,1,1,0,0,8
91438,atthamentamhi,atthamentamhi,7,7,0,0,13
91439,itiādisvāgamane,itiadisvagamane,1,1,0,0,15
91440,ītīti,ititi,1,1,0,0,5
91441,āgamanattho,agamanattho,1,1,0,0,11
91442,āgantukānaṃ,agantukanam,119,116,3,0,11
91443,akusalabhāgīnaṃ,akusalabhaginam,2,2,0,0,15
91444,byasanahetūnaṃ,byasanahetunam,5,5,0,0,14
91445,nipātākhyātanāmikapariyāpannānaṃ,nipatakhyatanamikapariyapannanam,1,1,0,0,32
91446,itiito,itiito,1,0,1,0,6
91447,saddānamatthuddhāro,saddanamatthuddharo,1,1,0,0,19
91448,hetuparisamāpanādipadattha,hetuparisamapanadipadattha,1,1,0,0,26
91449,vipariyāya,vipariyaya,1,1,0,0,10
91450,pakārāvadhāraṇa,pakaravadharana,1,1,0,0,15
91451,nidassanādianekatthappabhedo,nidassanadianekatthappabhedo,1,1,0,0,28
91452,ruppatīti,ruppatiti,68,47,21,0,9
91453,hetuatthe,hetuatthe,54,54,0,0,9
91454,dhammadāyādā,dhammadayada,72,69,3,0,12
91455,āmisadāyādā,amisadayada,64,61,3,0,11
91456,parisamāpane,parisamapane,17,17,0,0,12
91457,visūkadassanā,visukadassana,12,12,0,0,13
91458,paṭivirato,pativirato,1094,1087,7,0,10
91459,ādiattho,adiattho,88,88,0,0,8
91460,māgaṇḍiyoti,magandiyoti,11,7,4,0,11
91461,nāmakammaṃ,namakammam,44,36,8,0,10
91462,byañjanamabhilāpo,byanjanamabhilapo,3,3,0,0,17
91463,padatthavipariyāye,padatthavipariyaye,6,6,0,0,18
91464,sappaṭibhayo,sappatibhayo,40,35,5,0,12
91465,appaṭibhayo,appatibhayo,13,13,0,0,11
91466,saupaddavo,saupaddavo,12,12,0,0,10
91467,anupaddavo,anupaddavo,33,32,1,0,10
91468,jarāmaraṇanti,jaramarananti,82,80,2,0,13
91469,puṭṭhena,putthena,94,93,1,0,8
91470,ādanda,adanda,1,1,0,0,6
91471,atthītissa,atthitissa,17,17,0,0,10
91472,kaccāna,kaccana,208,204,4,0,7
91473,nipātavaseneva,nipatavaseneva,1,1,0,0,14
91474,kodharūpenā,kodharupena,2,2,0,0,11
91475,ākhyātavasena,akhyatavasena,5,5,0,0,13
91476,nipātattho,nipatattho,2,2,0,0,10
91477,kosallupādanatthaṃ,kosallupadanattham,1,1,0,0,18
91478,cimasaddatthe,cimasaddatthe,1,1,0,0,13
91479,atthamhi,atthamhi,4,4,0,0,8
91480,itarattho,itarattho,1,1,0,0,9
91481,atthuddhāravasā,atthuddharavasa,1,1,0,0,15
91482,sanibbacanaṃ,sanibbacanam,1,1,0,0,12
91483,vattabbampi,vattabbampi,14,14,0,0,11
91484,dhātuvisayeyeva,dhatuvisayeyeva,1,1,0,0,15
91485,tidhātumayattā,tidhatumayatta,1,1,0,0,14
91486,kārānantaratyantapadassa,karanantaratyantapadassa,1,1,0,0,24
91487,udetī,udeti,3,2,1,0,5
91488,itiādīnañca,itiadinanca,16,15,1,0,11
91489,kārānantara,karanantara,10,10,0,0,11
91490,ntapadānaṃ,ntapadanam,3,3,0,0,10
91491,dukkarā,dukkara,41,41,0,0,7
91492,ntapadamālā,ntapadamala,1,1,0,0,11
91493,vihitehi,vihitehi,1,1,0,0,8
91494,asabbasādhāraṇañca,asabbasadharananca,1,1,0,0,18
91495,padamālānayaṃ,padamalanayam,1,1,0,0,13
91496,kārānantaratyantapadānaṃ,karanantaratyantapadanam,1,1,0,0,24
91497,pantiyo,pantiyo,11,11,0,0,7
91498,rundhatā,rundhata,1,0,1,0,8
91499,cetesaṃ,cetesam,9,9,0,0,7
91500,suddhassarapubbakānaṃ,suddhassarapubbakanam,1,1,0,0,21
91501,ntapadānañcāpi,ntapadanancapi,1,1,0,0,14
91502,asnāti,asnati,10,10,0,0,6
91503,vaṇṇānantaratyantapadānamapi,vannanantaratyantapadanamapi,1,1,0,0,28
91504,peraṇatthe,peranatthe,1,1,0,0,10
91505,ntapadānampi,ntapadanampi,2,2,0,0,12
91506,yuttitovade,yuttitovade,1,1,0,0,11
91507,nayadassanā,nayadassana,1,1,0,0,11
91508,ikārānantaratyantapadassa,ikaranantaratyantapadassa,1,1,0,0,25
91509,inti,inti,3,3,0,0,4
91510,itha,itha,2,2,0,0,4
91511,vattamānānayo,vattamananayo,1,1,0,0,13
91512,itu,itu,1,1,0,0,3
91513,intu,intu,1,1,0,0,4
91514,ihi,ihi,1,1,0,0,3
91515,pañcamīnayo,pancaminayo,1,1,0,0,11
91516,sāsanānurūpabhāvassa,sasananurupabhavassa,1,1,0,0,20
91517,sādhakapadāni,sadhakapadani,1,1,0,0,13
91518,anvetī,anveti,5,5,0,0,6
91519,vigacchatīti,vigacchatiti,20,18,2,0,12
91520,apagacchatīti,apagacchatiti,5,3,2,0,13
91521,anugacchatīti,anugacchatiti,18,14,4,0,13
91522,anvetīti,anvetiti,14,8,6,0,8
91523,āraññakaṃ,arannakam,44,40,4,0,9
91524,dantiṃ,dantim,22,18,4,0,6
91525,jessantaṃ,jessantam,9,7,2,0,9
91526,giriduggesu,giriduggesu,13,13,0,0,11
91527,visamesu,visamesu,17,17,0,0,8
91528,anugacchāmi,anugacchami,10,10,0,0,11
91529,anugacchāmī,anugacchami,1,1,0,0,11
91530,iriyāpathavācako,iriyapathavacako,1,1,0,0,16
91531,āgamanaṃyeva,agamanamyeva,1,1,0,0,12
91532,ayuttito,ayuttito,2,2,0,0,8
91533,gamanatthassa,gamanatthassa,1,1,0,0,13
91534,yuttito,yuttito,72,72,0,0,7
91535,katachedānaṃ,katachedanam,1,1,0,0,12
91536,atthibhāvaṃ,atthibhavam,130,119,11,0,11
91537,yuttibhāvañca,yuttibhavanca,1,1,0,0,13
91538,pāḷiyeva,paliyeva,18,17,1,0,8
91539,labbhamānanayena,labbhamananayena,1,1,0,0,16
91540,vattamānāpañcamīnayo,vattamanapancaminayo,1,1,0,0,20
91541,parassapadavasena,parassapadavasena,3,3,0,0,17
91542,sattamīrūpādīni,sattamirupadini,1,1,0,0,15
91543,issasi,issasi,2,2,0,0,6
91544,issatha,issatha,3,3,0,0,7
91545,issāmi,issami,1,1,0,0,6
91546,issāma,issama,1,1,0,0,6
91547,issate,issate,3,3,0,0,6
91548,issante,issante,1,1,0,0,7
91549,issase,issase,2,2,0,0,6
91550,issavhe,issavhe,2,2,0,0,7
91551,issaṃ,issam,61,54,7,0,5
91552,issāmhe,issamhe,1,1,0,0,7
91553,asabbadhātukattepi,asabbadhatukattepi,1,1,0,0,18
91554,suddhassarattā,suddhassaratta,2,2,0,0,14
91555,bhavissantīnayo,bhavissantinayo,1,1,0,0,15
91556,issaṃsu,issamsu,1,1,0,0,7
91557,issamhā,issamha,1,1,0,0,7
91558,issisu,issisu,1,1,0,0,6
91559,issāmhase,issamhase,1,1,0,0,9
91560,kālātipattibhāve,kalatipattibhave,1,1,0,0,16
91561,asabbadhātukatte,asabbadhatukatte,1,1,0,0,16
91562,kārikārāgamo,karikaragamo,1,1,0,0,12
91563,anupapannattā,anupapannatta,1,1,0,0,13
91564,dvinnañhettha,dvinnanhettha,1,1,0,0,13
91565,suddhassarānaṃ,suddhassaranam,1,1,0,0,14
91566,anantarikānaṃ,anantarikanam,2,2,0,0,13
91567,ekatosannipāto,ekatosannipato,1,1,0,0,14
91568,anupapatti,anupapatti,15,15,0,0,10
91569,kālātipattinayo,kalatipattinayo,1,1,0,0,15
91570,payogatthesu,payogatthesu,1,1,0,0,12
91571,purisaparakkamassā,purisaparakkamassa,1,1,0,0,18
91572,vuttappakārehi,vuttappakarehi,15,15,0,0,14
91573,asamānatthāni,asamanatthani,1,1,0,0,13
91574,vattamānikarūpāni,vattamanikarupani,1,1,0,0,17
91575,bhavissantīkālātipattīnaṃ,bhavissantikalatipattinam,1,1,0,0,25
91576,pakāsayissāma,pakasayissama,22,22,0,0,13
91577,vattamānāvasena,vattamanavasena,5,5,0,0,15
91578,issathā,issatha,1,1,0,0,7
91579,bhavissantīvasena,bhavissantivasena,3,3,0,0,17
91580,ississati,ississati,1,1,0,0,9
91581,ississanti,ississanti,1,1,0,0,10
91582,ississasi,ississasi,1,1,0,0,9
91583,ississathā,ississatha,2,2,0,0,10
91584,ississā,ississa,1,1,0,0,7
91585,ississaṃsu,ississamsu,1,1,0,0,10
91586,ississe,ississe,1,1,0,0,7
91587,dhātvantaravasena,dhatvantaravasena,1,1,0,0,17
91588,saṃsandanānayoyaṃ,samsandananayoyam,1,1,0,0,17
91589,ekārānantaratyantapadassa,ekaranantaratyantapadassa,1,1,0,0,25
91590,enti,enti,36,35,1,0,4
91591,emi,emi,6,6,0,0,3
91592,ema,ema,3,3,0,0,3
91593,entu,entu,2,2,0,0,4
91594,dukkhantaṃ,dukkhantam,4,3,1,0,10
91595,vissāsaṃ,vissasam,120,111,9,0,8
91596,pahiṇissāmi,pahinissami,5,5,0,0,11
91597,khattiya,khattiya,88,88,0,0,8
91598,parokkhāhiyyattanajjatanīrūpāni,parokkhahiyyattanajjatanirupani,1,1,0,0,31
91599,essanti,essanti,3,2,1,0,7
91600,essasi,essasi,2,2,0,0,6
91601,essatha,essatha,3,3,0,0,7
91602,essāmi,essami,2,2,0,0,6
91603,essāma,essama,1,1,0,0,6
91604,essate,essate,1,1,0,0,6
91605,essante,essante,1,1,0,0,7
91606,essase,essase,2,2,0,0,6
91607,essavhe,essavhe,2,2,0,0,7
91608,essaṃ,essam,5,4,1,0,5
91609,essāmhe,essamhe,1,1,0,0,7
91610,jālamādāya,jalamadaya,5,5,0,0,10
91611,vivadissanti,vivadissanti,9,9,0,0,12
91612,ehinti,ehinti,9,8,1,0,6
91613,abhidosagato,abhidosagato,3,3,0,0,12
91614,ehī,ehi,97,95,2,0,3
91615,vacanadassanato,vacanadassanato,1,1,0,0,15
91616,bhavissantīrūpāni,bhavissantirupani,3,3,0,0,17
91617,ehisi,ehisi,7,7,0,0,5
91618,ehitha,ehitha,1,1,0,0,6
91619,ehimi,ehimi,1,1,0,0,5
91620,ehima,ehima,1,1,0,0,5
91621,ehite,ehite,2,2,0,0,5
91622,ehinte,ehinte,1,1,0,0,6
91623,ehise,ehise,1,1,0,0,5
91624,ehivhe,ehivhe,1,1,0,0,6
91625,ehissaṃ,ehissam,1,1,0,0,7
91626,ehissāmhe,ehissamhe,1,1,0,0,9
91627,essā,essa,2,2,0,0,4
91628,essaṃsu,essamsu,1,1,0,0,7
91629,esse,esse,1,1,0,0,4
91630,essāmhā,essamha,1,1,0,0,7
91631,essisu,essisu,1,1,0,0,6
91632,essiṃ,essim,1,1,0,0,5
91633,essāmhase,essamhase,1,1,0,0,9
91634,athāparopi,athaparopi,3,3,0,0,10
91635,kārānantaratyantapadakkamo,karanantaratyantapadakkamo,1,1,0,0,26
91636,udenti,udenti,21,20,1,0,6
91637,udesi,udesi,1,1,0,0,5
91638,udetha,udetha,2,2,0,0,6
91639,udemi,udemi,2,2,0,0,5
91640,udema,udema,2,2,0,0,5
91641,udetu,udetu,1,1,0,0,5
91642,udentu,udentu,1,1,0,0,6
91643,udehi,udehi,3,3,0,0,5
91644,udāmase,udamase,1,1,0,0,7
91645,udeyya,udeyya,3,3,0,0,6
91646,udeyyuṃ,udeyyum,1,1,0,0,7
91647,udissati,udissati,1,1,0,0,8
91648,udissanti,udissanti,1,1,0,0,9
91649,udissā,udissa,1,1,0,0,6
91650,udissaṃsu,udissamsu,1,1,0,0,9
91651,suddhassaradhāturūpāni,suddhassaradhaturupani,1,1,0,0,22
91652,kakārantadhātu,kakarantadhatu,2,2,0,0,14
91653,koti,koti,28,13,15,0,4
91654,kattupadāni,kattupadani,5,5,0,0,11
91655,kuyyati,kuyyati,2,2,0,0,7
91656,kiyyati,kiyyati,2,2,0,0,7
91657,kammapadāni,kammapadani,11,11,0,0,11
91658,kutvā,kutva,1,1,0,0,5
91659,kutvāna,kutvana,1,1,0,0,7
91660,kavitvā,kavitva,1,1,0,0,7
91661,kavitvāna,kavitvana,1,1,0,0,9
91662,kāvitvā,kavitva,1,1,0,0,7
91663,kāvitvāna,kavitvana,1,1,0,0,9
91664,kāyituṃ,kayitum,2,2,0,0,7
91665,abyayapadāni,abyayapadani,4,4,0,0,12
91666,ṭhitamajjhanhikasamaye,thitamajjhanhikasamaye,4,3,1,0,22
91667,majjhanhike,majjhanhike,95,89,6,0,11
91668,sannisīvesu,sannisivesu,7,7,0,0,11
91669,pakkhisu,pakkhisu,12,12,0,0,8
91670,saṇateva,sanateva,9,9,0,0,8
91671,brahāraññaṃ,braharannam,22,22,0,0,11
91672,kokilamayūrādayo,kokilamayuradayo,1,1,0,0,16
91673,kūjanti,kujanti,8,7,1,0,7
91674,manoharatāya,manoharataya,1,1,0,0,12
91675,paṇḍitehīti,panditehiti,6,5,1,0,11
91676,kāviyaṃ,kaviyam,1,0,1,0,7
91677,kāveyyaṃ,kaveyyam,8,3,5,0,8
91678,kābyaṃ,kabyam,2,0,2,0,6
91679,sakkaṭabhāsābhāvato,sakkatabhasabhavato,1,1,0,0,19
91680,sakkaṭabhāsātopi,sakkatabhasatopi,1,1,0,0,16
91681,cariyaṃ,cariyam,66,64,2,0,7
91682,kīyati,kiyati,2,2,0,0,6
91683,jātakapāḷi,jatakapali,7,6,1,0,10
91684,jātakanti,jatakanti,12,12,0,0,9
91685,jātaka,jataka,7,4,3,0,6
91686,desanāyampi,desanayampi,2,2,0,0,11
91687,itivuttakaṃ,itivuttakam,91,81,10,0,11
91688,abbhutadhammaṃ,abbhutadhammam,116,108,8,0,14
91689,jātiyampi,jatiyampi,2,2,0,0,9
91690,samodhānesī,samodhanesi,2,2,0,0,11
91691,nīcagatiyaṃ,nicagatiyam,1,0,1,0,11
91692,nīcagamanaṃ,nicagamanam,1,0,1,0,11
91693,hīnagamanaṃ,hinagamanam,1,1,0,0,11
91694,hīnappavatti,hinappavatti,1,1,0,0,12
91695,nīca,nica,4,2,2,0,4
91696,hīnavācako,hinavacako,2,2,0,0,10
91697,paccājāto,paccajato,73,72,1,0,9
91698,pakkati,pakkati,1,1,0,0,7
91699,kriyāpadamettha,kriyapadamettha,1,1,0,0,15
91700,kriyāpadameva,kriyapadameva,1,1,0,0,13
91701,pakkanaṃ,pakkanam,1,1,0,0,8
91702,takanaṃ,takanam,1,1,0,0,7
91703,bhāvavācakāni,bhavavacakani,1,1,0,0,13
91704,hasanaṃ,hasanam,13,11,2,0,7
91705,takati,takati,1,1,0,0,6
91706,kicchajīvanaṃ,kicchajivanam,1,0,1,0,13
91707,kasirajīvanaṃ,kasirajivanam,1,1,0,0,13
91708,taṅkati,tankati,1,1,0,0,7
91709,ātaṅkati,atankati,1,1,0,0,8
91710,ātaṅkoti,atankoti,5,2,3,0,8
91711,kicchajīvitakaro,kicchajivitakaro,4,4,0,0,16
91712,appābādhaṃ,appabadham,78,67,11,0,10
91713,appātaṅkaṃ,appatankam,73,63,10,0,10
91714,ābādhoti,abadhoti,18,4,14,0,8
91715,visabhāgavedanā,visabhagavedana,8,7,1,0,15
91716,sakalasarīraṃ,sakalasariram,221,210,11,0,13
91717,ayapaṭṭena,ayapattena,11,9,2,0,10
91718,yāpetabbarogo,yapetabbarogo,2,2,0,0,13
91719,ajjhattasamuṭṭhāno,ajjhattasamutthano,2,2,0,0,18
91720,bahiddhāsamuṭṭhāno,bahiddhasamutthano,3,3,0,0,18
91721,byādhā,byadha,1,1,0,0,6
91722,akallañceva,akallanceva,1,1,0,0,11
91723,rogābhidhānakaṃ,rogabhidhanakam,1,1,0,0,15
91724,sokati,sokati,2,2,0,0,6
91725,sukī,suki,2,2,0,0,4
91726,sukoti,sukoti,1,0,1,0,6
91727,bukka,bukka,4,2,2,0,5
91728,sunakhabhassanaṃ,sunakhabhassanam,2,2,0,0,16
91729,bhassitvā,bhassitva,33,33,0,0,9
91730,bhassaṃ,bhassam,26,18,8,0,7
91731,vacanasaṅkhātaṃ,vacanasankhatam,3,3,0,0,15
91732,bukkati,bukkati,2,2,0,0,7
91733,dhaka,dhaka,1,0,1,0,5
91734,paṭighāto,patighato,60,55,5,0,9
91735,paṭihananaṃ,patihananam,8,7,1,0,11
91736,dhakati,dhakati,1,1,0,0,7
91737,tittipaṭighātesu,tittipatighatesu,1,0,1,0,16
91738,paṭighātaṃ,patighatam,5,4,1,0,10
91739,paṭihananaṃva,patihananamva,1,1,0,0,13
91740,kuṭilagatiyaṃ,kutilagatiyam,2,0,2,0,13
91741,akati,akati,3,3,0,0,5
91742,ādikā,adika,19,17,2,0,5
91743,bhāsāti,bhasati,3,3,0,0,7
91744,iccādīnaṃyeva,iccadinamyeva,2,2,0,0,13
91745,ajjhayane,ajjhayane,7,5,2,0,9
91746,ajjhayanaṃ,ajjhayanam,2,1,1,0,10
91747,adhīyati,adhiyati,7,7,0,0,8
91748,ajjhayati,ajjhayati,2,2,0,0,9
91749,ajjhenaṃ,ajjhenam,4,3,1,0,8
91750,ajjhāyako,ajjhayako,70,62,8,0,9
91751,adhīyase,adhiyase,3,3,0,0,8
91752,adhīyanti,adhiyanti,4,4,0,0,9
91753,dibbamāyidha,dibbamayidha,3,3,0,0,12
91754,ajjhenamariyā,ajjhenamariya,6,6,0,0,13
91755,janindā,janinda,13,13,0,0,7
91756,ajjhāyakoti,ajjhayakoti,7,0,7,0,11
91757,ajjhayatīti,ajjhayatiti,1,1,0,0,11
91758,parivattetīti,parivattetiti,16,8,8,0,13
91759,avanti,avanti,9,9,0,0,6
91760,avasi,avasi,10,10,0,0,5
91761,pāvā,pava,15,15,0,0,4
91762,kāralopappayogotipi,karalopappayogotipi,1,1,0,0,19
91763,vaṅkati,vankati,2,2,0,0,7
91764,vaṅkaṃ,vankam,99,91,8,0,6
91765,jagatiruhaṃ,jagatiruham,7,5,2,0,11
91766,pamuñcati,pamuncati,11,11,0,0,9
91767,bhajatha,bhajatha,13,13,0,0,8
91768,vakkaṅgā,vakkanga,16,16,0,0,8
91769,saraṇato,saranato,48,45,3,0,8
91770,sakkaṭabhāsaṃ,sakkatabhasam,1,1,0,0,13
91771,kārasaññogakkhariko,karasannogakkhariko,1,1,0,0,19
91772,dhātubhāvo,dhatubhavo,3,3,0,0,10
91773,vaṅkatī,vankati,2,2,0,0,7
91774,kriyāpadañca,kriyapadanca,1,1,0,0,12
91775,bhāvavācako,bhavavacako,3,3,0,0,11
91776,tatta,tatta,14,14,0,0,5
91777,avijjamānampi,avijjamanampi,19,19,0,0,13
91778,nāthatīti,nathatiti,14,11,3,0,9
91779,kriyāpadamiva,kriyapadamiva,1,1,0,0,13
91780,bhāvavācakassa,bhavavacakassa,2,2,0,0,14
91781,aṭṭhavaṅkaṃ,atthavankam,5,4,1,0,11
91782,maṇiratanaṃ,maniratanam,147,139,8,0,11
91783,aṭṭhavaṅkāni,atthavankani,1,1,0,0,12
91784,dabbavācako,dabbavacako,2,2,0,0,11
91785,bhāvavācakoti,bhavavacakoti,1,1,0,0,13
91786,vakkañca,vakkanca,7,7,0,0,8
91787,jimhañca,jimhanca,1,1,0,0,8
91788,rimhamanuju,rimhamanuju,1,1,0,0,11
91789,vaṅkaghastā,vankaghasta,6,6,0,0,11
91790,giribhede,giribhede,1,1,0,0,9
91791,baḷisaṃ,balisam,52,50,2,0,7
91792,chāditaṃ,chaditam,48,46,2,0,8
91793,vaṅkaghastova,vankaghastova,3,2,1,0,13
91794,ambujo,ambujo,5,4,1,0,6
91795,guṇavācako,gunavacako,2,2,0,0,10
91796,visesanasado,visesanasado,1,1,0,0,12
91797,visesito,visesito,20,20,0,0,8
91798,baḷisanti,balisanti,6,6,0,0,9
91799,viññāyatī,vinnayati,21,12,9,0,9
91800,baḷisasabhāvassa,balisasabhavassa,1,1,0,0,16
91801,vaṅkattā,vankatta,1,1,0,0,8
91802,kuṭilattho,kutilattho,1,1,0,0,10
91803,pākaṭoti,pakatoti,42,38,4,0,8
91804,itiādivacanamiva,itiadivacanamiva,1,1,0,0,16
91805,aññamaññapariyā,annamannapariya,1,1,0,0,15
91806,yavacanattepi,yavacanattepi,1,1,0,0,13
91807,manoramadantayuttanti,manoramadantayuttanti,1,1,0,0,21
91808,pariyāyavacanattepi,pariyayavacanattepi,1,1,0,0,19
91809,kuṭilanti,kutilanti,1,1,0,0,9
91810,suphullito,suphullito,1,1,0,0,10
91811,vilāsappattā,vilasappatta,1,1,0,0,12
91812,guṇaguṇīvasena,gunagunivasena,1,1,0,0,14
91813,balappatto,balappatto,14,13,1,0,10
91814,nikhilavisayaṃ,nikhilavisayam,1,1,0,0,14
91815,suddhiyā,suddhiya,32,31,1,0,8
91816,suddhiṃ,suddhim,301,225,76,0,7
91817,baḷisassābhidhānantaraṃ,balisassabhidhanantaram,1,1,0,0,23
91818,kaṅkaṃ,kankam,1,1,0,0,6
91819,vaṅkatapabbato,vankatapabbato,10,10,0,0,14
91820,girivisese,girivisese,1,1,0,0,10
91821,vaṅkapabbato,vankapabbato,4,4,0,0,12
91822,sukhuccāraṇatthaṃ,sukhuccaranattham,4,4,0,0,17
91823,animittaṃ,animittam,192,164,28,0,9
91824,vaṅkoyeva,vankoyeva,1,1,0,0,9
91825,disatāti,disatati,2,1,1,0,8
91826,vaṅkamassa,vankamassa,1,1,0,0,10
91827,saṇṭhānamatthīti,santhanamatthiti,1,1,0,0,16
91828,vaṅkatoti,vankatoti,1,1,0,0,9
91829,pabbamassa,pabbamassa,2,2,0,0,10
91830,vaṅkato,vankato,1,1,0,0,7
91831,pādakkharapāripūriyā,padakkharaparipuriya,1,1,0,0,20
91832,lokati,lokati,1,1,0,0,6
91833,ālokoti,alokoti,23,9,14,0,7
91834,oloketi,oloketi,110,109,1,0,7
91835,olokayatī,olokayati,1,1,0,0,9
91836,āhāraṭṭhitikā,aharatthitika,67,61,6,0,13
91837,cakkavāḷasaṅkhāto,cakkavalasankhato,3,3,0,0,17
91838,bhājanaloko,bhajanaloko,4,4,0,0,11
91839,puññapāpaṃ,punnapapam,6,6,0,0,10
91840,vicittākārato,vicittakarato,2,2,0,0,13
91841,samūhepi,samuhepi,2,2,0,0,8
91842,paññāpiyatīti,pannapiyatiti,3,3,0,0,13
91843,kilesaloko,kilesaloko,11,7,4,0,10
91844,bhavaloko,bhavaloko,20,14,6,0,9
91845,indriyalokoti,indriyalokoti,5,4,1,0,13
91846,bahuvidhatañca,bahuvidhatanca,1,1,0,0,14
91847,piṇḍanaṃ,pindanam,3,3,0,0,8
91848,silokamanukassāmi,silokamanukassami,2,2,0,0,17
91849,akkharapadaniyamito,akkharapadaniyamito,1,1,0,0,19
91850,vacanasaṅghāto,vacanasanghato,1,1,0,0,14
91851,pajjanti,pajjanti,29,29,0,0,8
91852,deka,deka,1,0,1,0,4
91853,dheka,dheka,1,0,1,0,5
91854,saddussāhesu,saddussahesu,1,0,1,0,12
91855,dhekati,dhekati,1,1,0,0,7
91856,reka,reka,1,0,1,0,4
91857,rekati,rekati,1,1,0,0,6
91858,saṅkati,sankati,10,10,0,0,7
91859,saṅkate,sankate,11,10,1,0,7
91860,aṅkati,ankati,1,1,0,0,6
91861,maṇḍanaṃ,mandanam,24,13,11,0,8
91862,loliye,loliye,1,0,1,0,6
91863,lolabhāvo,lolabhavo,6,4,2,0,9
91864,loliyaṃ,loliyam,1,0,1,0,7
91865,dakkhiyaṃ,dakkhiyam,12,11,1,0,9
91866,kakati,kakati,1,1,0,0,6
91867,kākī,kaki,19,19,0,0,4
91868,dhaṅko,dhanko,12,10,2,0,6
91869,bhoji,bhoji,2,2,0,0,5
91870,kākābhidhānāni,kakabhidhanani,1,1,0,0,14
91871,koko,koko,5,4,1,0,4
91872,vako,vako,13,13,0,0,4
91873,kokoti,kokoti,1,0,1,0,6
91874,araññasunakho,arannasunakho,1,1,0,0,13
91875,vakoti,vakoti,1,0,1,0,6
91876,khuddakavanadīpiko,khuddakavanadipiko,1,1,0,0,18
91877,byagghotipi,byagghotipi,1,1,0,0,11
91878,vaki,vaki,2,1,1,0,4
91879,ṭika,tika,1,0,1,0,4
91880,seka,seka,2,0,2,0,4
91881,sakkati,sakkati,9,8,1,0,7
91882,nisakkati,nisakkati,3,3,0,0,9
91883,parisakkati,parisakkati,71,70,1,0,11
91884,osakkati,osakkati,21,20,1,0,8
91885,vadhāya,vadhaya,129,125,4,0,7
91886,parisakkanaṃ,parisakkanam,18,18,0,0,12
91887,biḷāranisakkamattampi,bilaranisakkamattampi,1,1,0,0,21
91888,tekati,tekati,1,1,0,0,6
91889,ṭekati,tekati,2,2,0,0,6
91890,sekati,sekati,1,1,0,0,6
91891,ṭīkāti,tikati,1,0,1,0,6
91892,ṭikiyati,tikiyati,1,1,0,0,8
91893,jāniyati,janiyati,1,1,0,0,8
91894,saṃvaṇṇanāya,samvannanaya,75,74,1,0,12
91895,dhātuādikā,dhatuadika,1,1,0,0,10
91896,attanobhāsā,attanobhasa,4,0,4,0,11
91897,hikka,hikka,2,0,2,0,5
91898,abyattasaddo,abyattasaddo,5,4,1,0,12
91899,avibhāvitatthasaddo,avibhavitatthasaddo,1,1,0,0,19
91900,niratthakasaddo,niratthakasaddo,1,1,0,0,15
91901,hikkati,hikkati,1,1,0,0,7
91902,hikkate,hikkate,1,1,0,0,7
91903,ubhayatobhāsā,ubhayatobhasa,2,0,2,0,13
91904,pāvacanena,pavacanena,8,4,4,0,10
91905,parassattanobhāsānañhi,parassattanobhasananhi,1,1,0,0,22
91906,bādhate,badhate,3,3,0,0,7
91907,bādhatī,badhati,12,12,0,0,7
91908,kārantadhāturūpāni,karantadhaturupani,50,50,0,0,18
91909,khakārantadhātu,khakarantadhatu,2,2,0,0,15
91910,pakathane,pakathane,4,3,1,0,9
91911,pakathanaṃ,pakathanam,1,0,1,0,10
91912,khāti,khati,1,1,0,0,5
91913,saṅkhāti,sankhati,19,3,16,0,8
91914,pubbatte,pubbatte,1,1,0,0,8
91915,visadisabhāvena,visadisabhavena,2,2,0,0,15
91916,tyakkharassa,tyakkharassa,1,1,0,0,12
91917,saññogapubbattā,sannogapubbatta,1,1,0,0,15
91918,akkhāti,akkhati,20,19,1,0,7
91919,akkheyyaṃ,akkheyyam,20,11,9,0,9
91920,saṅkhāyati,sankhayati,10,10,0,0,10
91921,akkhāyati,akkhayati,86,85,1,0,9
91922,svākhāto,svakhato,14,13,1,0,8
91923,akkhāto,akkhato,115,115,0,0,7
91924,akkhātāro,akkhataro,8,8,0,0,9
91925,ākyāti,akyati,1,1,0,0,6
91926,svākkhyāto,svakkhyato,1,1,0,0,10
91927,padamicchanti,padamicchanti,3,3,0,0,13
91928,sakkaṭabhāsāto,sakkatabhasato,2,2,0,0,14
91929,yathāṭhitarūpanipphattivasena,yathathitarupanipphattivasena,1,1,0,0,29
91930,yathādassitapadāniyeva,yathadassitapadaniyeva,1,1,0,0,22
91931,pasatthatarāni,pasatthatarani,1,1,0,0,14
91932,ñāṇakoṭṭhāsapaññattigaṇanāsu,nanakotthasapannattigananasu,2,2,0,0,28
91933,saṅkhāyekaṃ,sankhayekam,63,61,2,0,11
91934,papañcasaññāsaṅkhā,papancasannasankha,24,23,1,0,18
91935,samudācarantī,samudacaranti,16,15,1,0,13
91936,saṅkhātuṃ,sankhatum,62,57,5,0,9
91937,gaṇanāyaṃ,gananayam,4,4,0,0,9
91938,ñāṇapaññattikoṭṭhāsagaṇanāsu,nanapannattikotthasagananasu,1,1,0,0,28
91939,dhammadīpassa,dhammadipassa,9,9,0,0,13
91940,khiyanadhammaṃ,khiyanadhammam,1,1,0,0,14
91941,sāsanānurūpena,sasananurupena,5,5,0,0,14
91942,iyyā,iyya,2,0,2,0,4
91943,khiyyati,khiyyati,103,99,4,0,8
91944,khayoti,khayoti,30,19,11,0,7
91945,khiyanti,khiyanti,4,4,0,0,8
91946,magganibbānāni,magganibbanani,1,1,0,0,14
91947,khayasaṅkhātena,khayasankhatena,2,2,0,0,15
91948,pāpuṇiyattā,papuniyatta,1,1,0,0,11
91949,gaṇepi,ganepi,9,9,0,0,6
91950,pakkhipitabbo,pakkhipitabbo,14,14,0,0,13
91951,abhiramaṇīyaṃ,abhiramaniyam,1,1,0,0,13
91952,rājakkhayaṃ,rajakkhayam,2,1,1,0,11
91953,cakkhādiindriyaṃ,cakkhadiindriyam,2,2,0,0,16
91954,nivāsaṭṭhena,nivasatthena,6,6,0,0,12
91955,kusena,kusena,24,22,2,0,6
91956,jātakhattiyaṃ,jatakhattiyam,1,1,0,0,13
91957,savaṇṇamaṇimekhalaṃ,savannamanimekhalam,1,1,0,0,19
91958,yamakkhayaṃ,yamakkhayam,10,6,4,0,11
91959,yamanivesanaṃ,yamanivesanam,4,4,0,0,13
91960,khoti,khoti,370,51,319,0,5
91961,khavati,khavati,1,1,0,0,7
91962,khādanasattāsu,khadanasattasu,1,0,1,0,14
91963,undūrā,undura,3,3,0,0,6
91964,vikkhāyitakaṃ,vikkhayitakam,20,13,7,0,13
91965,gokhāyitakaṃ,gokhayitakam,1,1,0,0,12
91966,assirī,assiri,8,6,2,0,6
91967,disāpi,disapi,23,21,2,0,6
91968,pakkhāyanti,pakkhayanti,15,15,0,0,11
91969,etthādimhi,etthadimhi,2,2,0,0,10
91970,upaṭṭhāti,upatthati,495,478,17,0,9
91971,takriyāti,takriyati,1,0,1,0,9
91972,sukhadukkhānaṃ,sukhadukkhanam,51,48,3,0,14
91973,dukkhananti,dukkhananti,1,1,0,0,11
91974,akammakā,akammaka,13,12,1,0,8
91975,sukhati,sukhati,3,3,0,0,7
91976,dukkhati,dukkhati,2,2,0,0,8
91977,dukkhito,dukkhito,204,188,16,0,8
91978,pīṇanaṃ,pinanam,10,8,2,0,7
91979,vighātaṃ,vighatam,64,47,17,0,8
91980,sukhadukkha,sukhadukkha,3,2,1,0,11
91981,dukkhayati,dukkhayati,6,5,1,0,10
91982,kammatthamādāya,kammatthamadaya,1,1,0,0,15
91983,vivaraṇassa,vivaranassa,4,4,0,0,11
91984,sukhāpayati,sukhapayati,1,1,0,0,11
91985,dukkheti,dukkheti,17,8,9,0,8
91986,dukkhāpayatī,dukkhapayati,1,1,0,0,12
91987,kāritapadarūpāni,karitapadarupani,1,1,0,0,16
91988,kimhici,kimhici,28,28,0,0,7
91989,sukhāpeyya,sukhapeyya,3,3,0,0,10
91990,mahosadho,mahosadho,54,54,0,0,9
91991,pāḷiādidassanato,paliadidassanato,1,1,0,0,16
91992,dhātupāṭhasaṅkhepe,dhatupathasankhepe,1,1,0,0,18
91993,dukkhayatī,dukkhayati,2,2,0,0,10
91994,akāritāni,akaritani,2,2,0,0,9
91995,suddhakattupadāni,suddhakattupadani,17,17,0,0,17
91996,icchitāni,icchitani,3,3,0,0,9
91997,tabbacanaṃ,tabbacanam,1,1,0,0,10
91998,pāḷiādīhi,paliadihi,1,1,0,0,9
91999,suddhakattuvisaye,suddhakattuvisaye,2,2,0,0,17
92000,sukhatīti,sukhatiti,2,2,0,0,9
92001,dukkhatīti,dukkhatiti,3,3,0,0,10
92002,dukkhatī,dukkhati,1,1,0,0,8
92003,aṭṭhakathānayavasena,atthakathanayavasena,1,1,0,0,20
92004,caravho,caravho,1,1,0,0,7
92005,ekadviyojanamattampi,ekadviyojanamattampi,1,1,0,0,20
92006,dukkhantī,dukkhanti,3,3,0,0,9
92007,akammakaṃ,akammakam,5,4,1,0,9
92008,suddhakattuvācakaṃ,suddhakattuvacakam,3,3,0,0,18
92009,diṭṭhiyeva,ditthiyeva,66,63,3,0,10
92010,sukhasi,sukhasi,1,1,0,0,7
92011,sukhatha,sukhatha,1,1,0,0,8
92012,sukhāmi,sukhami,1,1,0,0,7
92013,sukhāmā,sukhama,1,1,0,0,7
92014,dukkhasi,dukkhasi,1,1,0,0,8
92015,dukkhathā,dukkhatha,1,1,0,0,9
92016,itiādīnica,itiadinica,1,1,0,0,10
92017,anavajjassa,anavajjassa,8,8,0,0,11
92018,sañjātasukhoti,sanjatasukhoti,1,1,0,0,14
92019,dukkhitoti,dukkhitoti,20,8,12,0,10
92020,muccane,muccane,4,3,1,0,7
92021,akammakoyaṃ,akammakoyam,2,2,0,0,11
92022,mokkhati,mokkhati,4,4,0,0,8
92023,mokkheti,mokkheti,37,36,1,0,8
92024,mokkhayati,mokkhayati,2,2,0,0,10
92025,mokkhāpeti,mokkhapeti,1,1,0,0,10
92026,mokkhāpayatī,mokkhapayati,1,1,0,0,12
92027,panimaṃ,panimam,11,11,0,0,7
92028,paṭhitvā,pathitva,11,11,0,0,8
92029,pakkhipanti,pakkhipanti,77,76,1,0,11
92030,mokkhayatī,mokkhayati,2,2,0,0,10
92031,aṭṭhakathāya,atthakathaya,336,226,110,0,12
92032,virujjhanti,virujjhanti,19,18,1,0,11
92033,mokkhanti,mokkhanti,10,9,1,0,9
92034,mokkhasi,mokkhasi,4,4,0,0,8
92035,mahāyaññaṃ,mahayannam,70,68,2,0,10
92036,yajissāma,yajissama,6,6,0,0,9
92037,mokkhāma,mokkhama,4,4,0,0,8
92038,moceti,moceti,105,103,2,0,6
92039,āpāyikādīhi,apayikadihi,16,16,0,0,11
92040,dukkhehīti,dukkhehiti,14,13,1,0,10
92041,mokkhesi,mokkhesi,1,1,0,0,8
92042,mokkhemā,mokkhema,1,1,0,0,8
92043,mokkhāmā,mokkhama,1,1,0,0,8
92044,apādānavisayaṃ,apadanavisayam,1,1,0,0,14
92045,mocetī,moceti,10,8,2,0,6
92046,hetukattuvācakaṃ,hetukattuvacakam,2,2,0,0,16
92047,apādānavisayaṃyeva,apadanavisayamyeva,1,1,0,0,18
92048,akammakabhāvo,akammakabhavo,1,1,0,0,13
92049,hetukattuvisaye,hetukattuvisaye,2,2,0,0,15
92050,ekakammakabhāvo,ekakammakabhavo,1,1,0,0,15
92051,chidā,chida,1,0,1,0,5
92052,dvigaṇikoti,dviganikoti,1,1,0,0,11
92053,suddhakatturūpānaṃ,suddhakatturupanam,2,2,0,0,18
92054,kakkhati,kakkhati,1,1,0,0,8
92055,okha,okha,1,0,1,0,4
92056,rākha,rakha,1,0,1,0,5
92057,dākha,dakha,1,0,1,0,5
92058,dhākha,dhakha,1,0,1,0,6
92059,sosanālamatthesu,sosanalamatthesu,1,0,1,0,16
92060,okhati,okhati,1,1,0,0,6
92061,rākhati,rakhati,1,1,0,0,7
92062,lākhati,lakhati,1,1,0,0,7
92063,dākhati,dakhati,1,1,0,0,7
92064,dhākhati,dhakhati,1,1,0,0,8
92065,sākhati,sakhati,1,1,0,0,7
92066,makha,makha,2,1,1,0,5
92067,rakha,rakha,2,1,1,0,5
92068,lakha,lakha,2,1,1,0,5
92069,rakhi,rakhi,1,0,1,0,5
92070,lakhi,lakhi,1,0,1,0,5
92071,ikhi,ikhi,1,0,1,0,4
92072,rikhi,rikhi,1,0,1,0,5
92073,nakhati,nakhati,1,1,0,0,7
92074,makhati,makhati,1,1,0,0,7
92075,rakhati,rakhati,1,1,0,0,7
92076,lakhati,lakhati,1,1,0,0,7
92077,raṅkhati,rankhati,1,1,0,0,8
92078,laṅkhati,lankhati,1,1,0,0,8
92079,iṅkhati,inkhati,1,1,0,0,7
92080,riṅkhati,rinkhati,1,1,0,0,8
92081,rakkhitaṃ,rakkhitam,86,76,10,0,9
92082,rakkhako,rakkhako,8,8,0,0,8
92083,byattisaṅkhātesu,byattisankhatesu,1,0,1,0,16
92084,nikkha,nikkha,2,1,1,0,6
92085,cumbane,cumbane,3,1,2,0,7
92086,nikkhati,nikkhati,1,1,0,0,8
92087,nakkhati,nakkhati,1,1,0,0,8
92088,visamagatiyā,visamagatiya,3,3,0,0,12
92089,agantvā,agantva,187,182,5,0,7
92090,vīthiyāva,vithiyava,5,5,0,0,9
92091,nakkhanaṃ,nakkhanam,3,3,0,0,9
92092,nassantīti,nassantiti,12,9,3,0,10
92093,nakkhattānī,nakkhattani,2,0,2,0,11
92094,nirikkhaṃ,nirikkham,1,1,0,0,9
92095,vekkha,vekkha,1,0,1,0,6
92096,vekkhane,vekkhane,1,0,1,0,8
92097,vekkhati,vekkhati,1,1,0,0,8
92098,makkha,makkha,4,2,2,0,6
92099,makkhati,makkhati,1,1,0,0,8
92100,takkha,takkha,1,0,1,0,6
92101,tapane,tapane,1,0,1,0,6
92102,takkhati,takkhati,1,1,0,0,8
92103,sukkha,sukkha,6,5,1,0,6
92104,sukkhati,sukkhati,11,11,0,0,8
92105,kakhi,kakhi,3,1,2,0,5
92106,vakhi,vakhi,2,1,1,0,5
92107,makhi,makhi,2,1,1,0,5
92108,vaṅkhati,vankhati,1,1,0,0,8
92109,maṅkhati,mankhati,1,1,0,0,8
92110,kaṅkhāyanā,kankhayana,18,16,2,0,10
92111,kaṅkhāyitattaṃ,kankhayitattam,16,14,2,0,14
92112,dvedhāpatho,dvedhapatho,21,19,2,0,11
92113,anekaṃsagāho,anekamsagaho,2,2,0,0,12
92114,āsappanā,asappana,18,15,3,0,8
92115,parisappanā,parisappana,18,15,3,0,11
92116,apariyogāhanā,apariyogahana,23,20,3,0,13
92117,thambhitattaṃ,thambhitattam,24,19,5,0,13
92118,kaṅkhāpariyāyā,kankhapariyaya,1,1,0,0,14
92119,lokavohāre,lokavohare,2,2,0,0,10
92120,nāmāniyeva,namaniyeva,1,1,0,0,10
92121,iccāyaṃ,iccayam,6,4,2,0,7
92122,abhikaṅkhati,abhikankhati,14,14,0,0,12
92123,nābhikaṅkhāmi,nabhikankhami,11,11,0,0,13
92124,abhikaṅkhitaṃ,abhikankhitam,1,1,0,0,13
92125,dakhi,dakhi,2,0,2,0,5
92126,dhakhi,dhakhi,1,0,1,0,6
92127,kaṅkhāyañca,kankhayanca,1,0,1,0,11
92128,daṅkhati,dankhati,1,1,0,0,8
92129,dhaṅkhati,dhankhati,1,1,0,0,9
92130,ukkhati,ukkhati,1,1,0,0,7
92131,kakha,kakha,1,0,1,0,5
92132,kakhati,kakhati,1,1,0,0,7
92133,jakkha,jakkha,2,1,1,0,6
92134,bhakkhaṇe,bhakkhane,14,10,4,0,9
92135,hasanānukaḍḍhanatthaṃ,hasananukaddhanattham,1,1,0,0,21
92136,jakkhati,jakkhati,1,1,0,0,8
92137,likhati,likhati,9,9,0,0,7
92138,sallekhati,sallekhati,5,5,0,0,10
92139,atisallekhatevāyaṃ,atisallekhatevayam,1,1,0,0,18
92140,lekhako,lekhako,6,6,0,0,7
92141,likhitaṃ,likhitam,524,521,3,0,8
92142,sallekhapaṭipatti,sallekhapatipatti,2,2,0,0,17
92143,parassabhāsā,parassabhasa,5,0,5,0,12
92144,dhukkha,dhukkha,1,0,1,0,7
92145,dhikkha,dhikkha,1,0,1,0,7
92146,sandīpanakilesanajīvanesu,sandipanakilesanajivanesu,1,0,1,0,25
92147,dhukkhati,dhukkhati,1,1,0,0,9
92148,dhikkhati,dhikkhati,1,1,0,0,9
92149,dhukkhate,dhukkhate,1,1,0,0,9
92150,dhikkhate,dhikkhate,1,1,0,0,9
92151,attanobhāsaṃ,attanobhasam,1,0,1,0,12
92152,rūpānipi,rupanipi,5,5,0,0,8
92153,vakkha,vakkha,5,2,3,0,6
92154,rukkhati,rukkhati,1,1,0,0,8
92155,vakkho,vakkho,2,2,0,0,6
92156,vakkhoti,vakkhoti,1,0,1,0,8
92157,rukkhoyeva,rukkhoyeva,2,2,0,0,10
92158,sādūni,saduni,11,11,0,0,6
92159,ramaṇīyāni,ramaniyani,16,15,1,0,10
92160,vakkhā,vakkha,6,6,0,0,6
92161,araññajā,arannaja,7,7,0,0,8
92162,jātakapāṭho,jatakapatho,1,1,0,0,11
92163,mahīruho,mahiruho,3,3,0,0,8
92164,jagatīruho,jagatiruho,1,1,0,0,10
92165,phalavā,phalava,5,5,0,0,7
92166,sālarukkhoyeva,salarukkhoyeva,2,2,0,0,14
92167,nāñño,nanno,20,19,1,0,5
92168,phandanamāluvā,phandanamaluva,5,5,0,0,14
92169,sālarukkhepi,salarukkhepi,1,1,0,0,12
92170,vanappatijeṭṭharukkhepi,vanappatijettharukkhepi,1,1,0,0,23
92171,rukkhepi,rukkhepi,8,7,1,0,8
92172,sālarukkhopi,salarukkhopi,3,3,0,0,12
92173,nigamassa,nigamassa,50,47,3,0,9
92174,sālavanaṃ,salavanam,55,54,1,0,9
92175,tañcassa,tancassa,79,74,5,0,8
92176,elaṇḍehi,elandehi,1,1,0,0,8
92177,sañchannaṃ,sanchannam,43,43,0,0,10
92178,yamakasālānaṃ,yamakasalanam,20,14,6,0,13
92179,vanappatijeṭṭharukkhopi,vanappatijettharukkhopi,1,1,0,0,23
92180,vijite,vijite,147,144,3,0,6
92181,tavevuyyānabhūmiyā,tavevuyyanabhumiya,3,3,0,0,18
92182,ujuvaṃsā,ujuvamsa,4,4,0,0,8
92183,nīlobhāsā,nilobhasa,8,8,0,0,9
92184,māluvabījaṃ,maluvabijam,2,2,0,0,11
92185,sālamūle,salamule,8,8,0,0,8
92186,nipateyyā,nipateyya,2,2,0,0,9
92187,jeṭṭharukkhe,jettharukkhe,1,1,0,0,12
92188,pādape,padape,10,10,0,0,6
92189,sandhāgāre,sandhagare,15,15,0,0,10
92190,sikkhitaṃ,sikkhitam,16,16,0,0,9
92191,sikkhako,sikkhako,1,1,0,0,8
92192,sekkho,sekkho,271,248,23,0,6
92193,sekho,sekho,157,140,17,0,5
92194,asekho,asekho,39,38,1,0,6
92195,sikkhitoti,sikkhitoti,8,3,5,0,10
92196,sañjātasikkho,sanjatasikkho,1,1,0,0,13
92197,asikkhīti,asikkhiti,1,1,0,0,9
92198,kattuppayogo,kattuppayogo,1,1,0,0,12
92199,anavayo,anavayo,39,35,4,0,7
92200,ācariyake,acariyake,24,24,0,0,9
92201,kumbhakārakamme,kumbhakarakamme,2,2,0,0,15
92202,bhikkhati,bhikkhati,13,13,0,0,9
92203,bhikkhanaṃ,bhikkhanam,1,1,0,0,10
92204,bhikkhako,bhikkhako,19,18,1,0,9
92205,bhikkhitaṃ,bhikkhitam,1,1,0,0,10
92206,anagāro,anagaro,13,12,1,0,7
92207,upasampanno,upasampanno,352,345,7,0,11
92208,bhikkhusataṃ,bhikkhusatam,7,7,0,0,12
92209,bhojesi,bhojesi,31,31,0,0,7
92210,bhikkhusahassaṃ,bhikkhusahassam,29,29,0,0,15
92211,bhojesī,bhojesi,3,3,0,0,7
92212,sāmaṇerepiupādāya,samanerepiupadaya,1,1,0,0,17
92213,tāpasāpi,tapasapi,6,6,0,0,8
92214,sīghatte,sighatte,1,0,1,0,8
92215,vaddhanti,vaddhanti,1,1,0,0,9
92216,sampattīhi,sampattihi,23,22,1,0,10
92217,muṇḍiopanayananiyamabbatādesesu,mundiopanayananiyamabbatadesesu,1,0,1,0,31
92218,muṇḍiye,mundiye,3,3,0,0,7
92219,upanayane,upanayane,1,1,0,0,9
92220,dikkhati,dikkhati,1,1,0,0,8
92221,dikkhito,dikkhito,13,13,0,0,8
92222,sarabhaṅgajātake,sarabhangajatake,7,2,5,0,16
92223,ciradikkhitānaṃ,ciradikkhitanam,15,11,4,0,15
92224,mālutenā,malutena,4,4,0,0,8
92225,cirapabbajitānaṃ,cirapabbajitanam,18,16,2,0,16
92226,ciramuṇḍānaṃ,ciramundanam,1,1,0,0,12
92227,dikkhita,dikkhita,2,0,2,0,8
92228,pabbajite,pabbajite,119,119,0,0,9
92229,dhātuatthassa,dhatuatthassa,2,2,0,0,13
92230,vibhāvanatthaṃ,vibhavanattham,26,26,0,0,14
92231,dhātuatthavibhāvanatthaṃ,dhatuatthavibhavanattham,1,1,0,0,24
92232,muṇḍiyatthavācakena,mundiyatthavacakena,1,1,0,0,19
92233,cakkavattisuttatthavaṇṇanāyaṃ,cakkavattisuttatthavannanayam,1,0,1,0,29
92234,kesamassuṃ,kesamassum,194,187,7,0,10
92235,ohāretvā,oharetva,184,182,2,0,8
92236,kāsāyāni,kasayani,253,242,11,0,8
92237,vatthāni,vatthani,394,389,5,0,8
92238,acchādetvā,acchadetva,197,194,3,0,10
92239,atthavivaraṇe,atthavivarane,2,2,0,0,13
92240,tāpasapabbajjaṃ,tapasapabbajjam,92,91,1,0,15
92241,pabbajantāpi,pabbajantapi,3,3,0,0,12
92242,ohārenti,oharenti,2,2,0,0,8
92243,parūḷhakese,parulhakese,2,2,0,0,11
92244,vivaranti,vivaranti,57,52,5,0,9
92245,upekkhati,upekkhati,14,14,0,0,9
92246,paccavekkhaṇā,paccavekkhana,142,127,15,0,13
92247,upekhā,upekha,1,1,0,0,6
92248,apekhā,apekha,2,2,0,0,6
92249,upasampadāpekho,upasampadapekho,4,4,0,0,15
92250,dakkhako,dakkhako,1,1,0,0,8
92251,cikkhati,cikkhati,1,1,0,0,8
92252,ācikkhako,acikkhako,1,1,0,0,9
92253,cakkhūti,cakkhuti,47,35,12,0,8
92254,cakkhatīti,cakkhatiti,34,26,8,0,10
92255,abhibyattaṃ,abhibyattam,8,8,0,0,11
92256,cakkhatī,cakkhati,10,9,1,0,8
92257,assādatthopi,assadatthopi,2,2,0,0,12
92258,viññāṇādhiṭṭhitaṃ,vinnanadhitthitam,16,16,0,0,17
92259,assādentaṃ,assadentam,5,5,0,0,10
92260,māgaṇḍiyaṃ,magandiyam,8,6,2,0,10
92261,rūpārāmaṃ,ruparamam,14,11,3,0,9
92262,rūparataṃ,ruparatam,13,10,3,0,9
92263,rūpasammuditaṃ,rupasammuditam,11,9,2,0,14
92264,sotādīnaṃ,sotadinam,12,12,0,0,9
92265,saddārāmatādibhāve,saddaramatadibhave,2,2,0,0,18
92266,padumādīsu,padumadisu,4,4,0,0,10
92267,pekkhanaṃ,pekkhanam,30,28,2,0,9
92268,gakārantadhātu,gakarantadhatu,2,2,0,0,14
92269,karīsussagge,karisussagge,3,1,2,0,12
92270,karīsussaggo,karisussaggo,2,0,2,0,12
92271,vaccakaraṇaṃ,vaccakaranam,2,2,0,0,12
92272,vaggati,vaggati,1,1,0,0,7
92273,vagganaṃ,vagganam,1,1,0,0,8
92274,nāgapetavatthuaṭṭhakathāyaṃ,nagapetavatthuatthakathayam,1,0,1,0,27
92275,assatarīrathena,assatarirathena,5,5,0,0,15
92276,yuttena,yuttena,31,29,2,0,7
92277,suvaggitena,suvaggitena,3,3,0,0,11
92278,suvaggitenāti,suvaggitenati,2,0,2,0,13
92279,sundaragamanenā,sundaragamanena,1,1,0,0,15
92280,kriyāpadampi,kriyapadampi,3,3,0,0,12
92281,dhunanti,dhunanti,7,7,0,0,8
92282,vagganti,vagganti,6,6,0,0,8
92283,cambare,cambare,3,3,0,0,7
92284,ragi,ragi,2,0,2,0,4
92285,vagi,vagi,1,0,1,0,4
92286,magi,magi,1,0,1,0,4
92287,igi,igi,1,0,1,0,3
92288,rigi,rigi,1,0,1,0,4
92289,ligi,ligi,1,0,1,0,4
92290,sagi,sagi,1,0,1,0,4
92291,gatipekkhako,gatipekkhako,3,3,0,0,12
92292,laṅgati,langati,1,1,0,0,7
92293,laṅgo,lango,1,1,0,0,5
92294,laṅgī,langi,17,12,5,0,5
92295,aṅgeti,angeti,5,4,1,0,6
92296,vaṅgati,vangati,1,1,0,0,7
92297,vaṅgo,vango,2,1,1,0,5
92298,maṅgo,mango,1,1,0,0,5
92299,upaṅgo,upango,1,1,0,0,6
92300,riṅgati,ringati,1,1,0,0,7
92301,riṅganaṃ,ringanam,1,1,0,0,8
92302,liṅganaṃ,linganam,1,1,0,0,8
92303,ulliṅgati,ullingati,1,1,0,0,9
92304,ulliṅganaṃ,ullinganam,1,1,0,0,10
92305,taṅgati,tangati,1,1,0,0,7
92306,taṅganaṃ,tanganam,1,1,0,0,8
92307,kāraṇampi,karanampi,9,8,1,0,9
92308,taṃsamaṅgipuggalā,tamsamangipuggala,2,2,0,0,17
92309,nihīnabhāvaṃ,nihinabhavam,5,5,0,0,12
92310,aṅgaṇānī,anganani,3,2,1,0,8
92311,aṅgaṇassa,anganassa,17,17,0,0,9
92312,pahānāya,pahanaya,848,841,7,0,8
92313,vāyamatī,vayamati,23,21,2,0,8
92314,makkhetīti,makkhetiti,12,8,4,0,10
92315,malādi,maladi,3,3,0,0,6
92316,tathārūpo,tatharupo,119,118,1,0,9
92317,vivaṭappadeso,vivatappadeso,2,2,0,0,13
92318,cetiyaṅgaṇaṃ,cetiyanganam,79,78,1,0,12
92319,bodhiyaṅgaṇaṃ,bodhiyanganam,15,14,1,0,13
92320,atisundaratāya,atisundarataya,2,2,0,0,14
92321,abhibyañjetīti,abhibyanjetiti,3,3,0,0,14
92322,vivaṭo,vivato,64,59,5,0,6
92323,rāgādīsu,ragadisu,23,22,1,0,8
92324,kāyamalamhi,kayamalamhi,1,1,0,0,11
92325,yugi,yugi,2,1,1,0,4
92326,jugi,jugi,1,0,1,0,4
92327,yuṅgati,yungati,1,1,0,0,7
92328,juṅgati,jungati,1,1,0,0,7
92329,saṅgeca,sangeca,1,0,1,0,7
92330,anantaravuttāpekkhako,anantaravuttapekkhako,1,1,0,0,21
92331,thagaṃ,thagam,1,0,1,0,6
92332,thagati,thagati,1,1,0,0,7
92333,aggatīti,aggatiti,1,1,0,0,8
92334,tivako,tivako,1,1,0,0,6
92335,hutāsano,hutasano,2,2,0,0,8
92336,ghatāsano,ghatasano,7,6,1,0,9
92337,kaṇhavattani,kanhavattani,1,1,0,0,12
92338,gāti,gati,2,2,0,0,4
92339,uggame,uggame,7,1,6,0,6
92340,panimāsaṃ,panimasam,1,1,0,0,9
92341,gāte,gate,1,1,0,0,4
92342,gavate,gavate,1,1,0,0,6
92343,attanobhāsattaṃ,attanobhasattam,1,0,1,0,15
92344,ghakārantadhātu,ghakarantadhatu,2,2,0,0,15
92345,ghatvā,ghatva,13,13,0,0,6
92346,muṭṭhā,muttha,42,39,3,0,6
92347,pattāya,pattaya,14,14,0,0,7
92348,ghāyitvā,ghayitva,146,146,0,0,8
92349,abhigamane,abhigamane,1,0,1,0,10
92350,abhigamanaṃ,abhigamanam,2,1,1,0,11
92351,adhigamanaṃ,adhigamanam,3,3,0,0,11
92352,ghoti,ghoti,2,2,0,0,5
92353,jaggha,jaggha,3,1,2,0,6
92354,jagghati,jagghati,4,4,0,0,8
92355,sañjagghati,sanjagghati,8,8,0,0,11
92356,sañjagghittho,sanjagghittho,5,5,0,0,13
92357,jagghitumpi,jagghitumpi,2,2,0,0,11
92358,jagghitvā,jagghitva,1,1,0,0,9
92359,tagghati,tagghati,1,1,0,0,8
92360,sighi,sighi,1,0,1,0,5
92361,āghānaṃ,aghanam,1,0,1,0,7
92362,ghānena,ghanena,135,135,0,0,7
92363,gandhānubhavanaṃ,gandhanubhavanam,1,1,0,0,16
92364,upasiṅghati,upasinghati,4,4,0,0,11
92365,upasiṅghitvā,upasinghitva,7,7,0,0,12
92366,siṅghāmi,singhami,8,8,0,0,8
92367,vārijaṃ,varijam,25,24,1,0,7
92368,ghavati,ghavati,2,2,0,0,7
92369,raghi,raghi,1,0,1,0,5
92370,laghi,laghi,2,1,1,0,5
92371,gatyakkhepe,gatyakkhepe,1,0,1,0,11
92372,gatyakkhepo,gatyakkhepo,1,0,1,0,11
92373,ullaṅghati,ullanghati,4,4,0,0,10
92374,laṅghitā,langhita,2,2,0,0,8
92375,ullaṅghikāpīti,ullanghikapiti,1,1,0,0,14
92376,maghi,maghi,1,0,1,0,5
92377,pubbatthāpekkho,pubbatthapekkho,1,1,0,0,15
92378,maṅghati,manghati,1,1,0,0,8
92379,rāgha,ragha,1,0,1,0,5
92380,rāghati,raghati,1,1,0,0,7
92381,lāghati,laghati,1,1,0,0,7
92382,dāgha,dagha,1,0,1,0,5
92383,āyāse,ayase,1,0,1,0,5
92384,āyāso,ayaso,32,27,5,0,5
92385,sāmatthiyāpekkhako,samatthiyapekkhako,1,1,0,0,18
92386,dāghati,daghati,1,1,0,0,7
92387,katthanaṃ,katthanam,2,1,1,0,9
92388,pasaṃsanaṃ,pasamsanam,16,15,1,0,10
92389,silāghati,silaghati,1,1,0,0,9
92390,silāghitvā,silaghitva,1,1,0,0,10
92391,bhūvādā,bhuvada,1,0,1,0,7
92392,vaggantadhāturūpāni,vaggantadhaturupani,11,11,0,0,19
92393,samattāni,samattani,40,34,6,0,9
92394,cakārantadhātu,cakarantadhatu,2,2,0,0,14
92395,socanā,socana,32,30,2,0,6
92396,socanto,socanto,11,11,0,0,7
92397,socantī,socanti,4,4,0,0,7
92398,socantaṃ,socantam,2,2,0,0,8
92399,socitvā,socitva,4,4,0,0,7
92400,tāre,tare,1,0,1,0,4
92401,tārasaddo,tarasaddo,1,0,1,0,9
92402,accuccasaddo,accuccasaddo,1,1,0,0,12
92403,kocati,kocati,4,4,0,0,6
92404,uccasaddaṃ,uccasaddam,2,2,0,0,10
92405,koṭilla,kotilla,1,0,1,0,7
92406,ppībhāvesu,ppibhavesu,1,0,1,0,10
92407,kuñcati,kuncati,1,1,0,0,7
92408,kuñcikā,kuncika,18,17,1,0,7
92409,kuñcitakeso,kuncitakeso,1,1,0,0,11
92410,kuñcitvā,kuncitva,1,1,0,0,8
92411,luñca,lunca,3,2,1,0,5
92412,luñcati,luncati,2,2,0,0,7
92413,luñcako,luncako,1,1,0,0,7
92414,luñcituṃ,luncitum,2,2,0,0,8
92415,luñcitvā,luncitva,70,63,7,0,8
92416,añcu,ancu,2,0,2,0,4
92417,gatipūjanāsu,gatipujanasu,1,0,1,0,12
92418,anuggantvā,anuggantva,4,4,0,0,10
92419,añcitoti,ancitoti,1,1,0,0,8
92420,kaṭukañcukatā,katukancukata,21,16,5,0,13
92421,vañcu,vancu,2,0,2,0,5
92422,tañcu,tancu,1,0,1,0,5
92423,vañcati,vancati,2,2,0,0,7
92424,cañcati,cancati,1,1,0,0,7
92425,tañcati,tancati,1,1,0,0,7
92426,mañcati,mancati,4,4,0,0,7
92427,avañcanā,avancana,7,7,0,0,8
92428,avañcanāti,avancanati,3,0,3,0,10
92429,vañcituṃ,vancitum,3,3,0,0,8
92430,gucu,gucu,1,0,1,0,4
92431,gaṇecu,ganecu,1,0,1,0,6
92432,thenanaṃ,thenanam,7,7,0,0,8
92433,theyyakaraṇaṃ,theyyakaranam,1,0,1,0,13
92434,gocati,gocati,1,1,0,0,6
92435,gaṇecati,ganecati,1,1,0,0,8
92436,accati,accati,1,1,0,0,6
92437,brahmāsurasuraccito,brahmasurasuraccito,4,4,0,0,19
92438,tacca,tacca,1,0,1,0,5
92439,taccati,taccati,1,1,0,0,7
92440,jacca,jacca,2,1,1,0,5
92441,paribhāsanavajjanesu,paribhasanavajjanesu,1,0,1,0,20
92442,caccati,caccati,1,1,0,0,7
92443,jaccati,jaccati,1,1,0,0,7
92444,saṃpaccanakoṭillapaṭikkamavilekhanesu,sampaccanakotillapatikkamavilekhanesu,1,0,1,0,37
92445,kucati,kucati,1,1,0,0,6
92446,saṅkucati,sankucati,16,16,0,0,9
92447,saṅkoco,sankoco,12,12,0,0,7
92448,dica,dica,1,0,1,0,4
92449,dicati,dicati,1,1,0,0,6
92450,saṅkocati,sankocati,4,4,0,0,9
92451,byāca,byaca,1,0,1,0,5
92452,byājikaraṇe,byajikarane,1,0,1,0,11
92453,byājikaraṇaṃ,byajikaranam,1,0,1,0,12
92454,byājikriyā,byajikriya,1,1,0,0,10
92455,byācati,byacati,1,1,0,0,7
92456,viyattassa,viyattassa,5,5,0,0,10
92457,viyatti,viyatti,2,2,0,0,7
92458,viyattāyaṃ,viyattayam,1,1,0,0,10
92459,vācāyanti,vacayanti,2,2,0,0,9
92460,viyattā,viyatta,52,51,1,0,7
92461,kucchisaddatiracchānagatādisaddo,kucchisaddatiracchanagatadisaddo,1,1,0,0,32
92462,vacanasaṅkhāto,vacanasankhato,1,1,0,0,14
92463,viññātatthattā,vinnatatthatta,1,1,0,0,14
92464,vatti,vatti,59,58,1,0,5
92465,vācenti,vacenti,24,24,0,0,7
92466,hetukattupadāni,hetukattupadani,10,10,0,0,15
92467,devadhammāti,devadhammati,9,7,2,0,12
92468,sakkaṭabhāsānulomāni,sakkatabhasanulomani,1,1,0,0,20
92469,kārāgamavisaye,karagamavisaye,1,1,0,0,14
92470,niruttaṃ,niruttam,12,8,4,0,8
92471,neruttaṃ,neruttam,14,8,6,0,8
92472,pavuttaṃ,pavuttam,40,31,9,0,8
92473,vattave,vattave,6,6,0,0,7
92474,mantādīni,mantadini,7,7,0,0,9
92475,vattīti,vattiti,3,1,2,0,7
92476,ākhyātapadañhetaṃ,akhyatapadanhetam,1,1,0,0,17
92477,atthasaṃvaṇṇakehipi,atthasamvannakehipi,1,1,0,0,19
92478,vacantītiādīni,vacantitiadini,1,1,0,0,14
92479,kriyāpadarūpāni,kriyapadarupani,1,1,0,0,15
92480,chaḍḍetabbānī,chaddetabbani,1,1,0,0,13
92481,avaciṃsū,avacimsu,1,1,0,0,8
92482,vācentī,vacenti,4,4,0,0,7
92483,vacantī,vacanti,1,1,0,0,7
92484,vaceyya,vaceyya,3,3,0,0,7
92485,vuccatu,vuccatu,3,3,0,0,7
92486,parokkhārūpāni,parokkharupani,2,2,0,0,14
92487,vacu,vacu,1,1,0,0,4
92488,vacittha,vacittha,3,3,0,0,8
92489,vacimha,vacimha,2,2,0,0,7
92490,vacire,vacire,1,1,0,0,6
92491,vacittho,vacittho,1,1,0,0,8
92492,vacivho,vacivho,1,1,0,0,7
92493,vacimhe,vacimhe,2,2,0,0,7
92494,hiyyattanīrūpāni,hiyyattanirupani,4,4,0,0,16
92495,avaco,avaco,6,6,0,0,5
92496,avocaṃ,avocam,34,32,2,0,6
92497,avacumha,avacumha,2,2,0,0,8
92498,avacutthuṃ,avacutthum,1,1,0,0,10
92499,avacase,avacase,2,2,0,0,7
92500,avacuvhaṃ,avacuvham,1,1,0,0,9
92501,avaciṃ,avacim,2,2,0,0,6
92502,avacamhase,avacamhase,1,1,0,0,10
92503,ajjatanīrūpāni,ajjatanirupani,3,3,0,0,14
92504,avaci,avaci,3,3,0,0,5
92505,avaciṃsu,avacimsu,4,4,0,0,8
92506,avoco,avoco,3,3,0,0,5
92507,avocuttha,avocuttha,11,11,0,0,9
92508,avociṃ,avocim,4,4,0,0,6
92509,avocumha,avocumha,38,35,3,0,8
92510,avocā,avoca,36,31,5,0,5
92511,avocu,avocu,2,2,0,0,5
92512,avocivaṃ,avocivam,1,1,0,0,8
92513,avocimhe,avocimhe,1,1,0,0,8
92514,vakkhasi,vakkhasi,7,7,0,0,8
92515,vakkhatha,vakkhatha,8,8,0,0,9
92516,vakkhate,vakkhate,2,2,0,0,8
92517,vakkhante,vakkhante,2,2,0,0,9
92518,vakkhase,vakkhase,2,2,0,0,8
92519,vakkhavhe,vakkhavhe,2,2,0,0,9
92520,vakkhassaṃ,vakkhassam,1,1,0,0,10
92521,vakkhamhe,vakkhamhe,1,1,0,0,9
92522,kathessantī,kathessanti,5,5,0,0,11
92523,roseti,roseti,24,18,6,0,6
92524,vakkhasī,vakkhasi,1,1,0,0,8
92525,uttamapurisekavacanaṭṭhāne,uttamapurisekavacanatthane,1,1,0,0,26
92526,vakkhemī,vakkhemi,1,1,0,0,8
92527,panimesaṃ,panimesam,11,11,0,0,9
92528,rosati,rosati,3,3,0,0,6
92529,rosantī,rosanti,1,1,0,0,7
92530,vacavakkha,vacavakkha,2,0,2,0,10
92531,bhavissantīvattamānāvasena,bhavissantivattamanavasena,1,1,0,0,26
92532,rūpasaṃsandanānayo,rupasamsandananayo,2,2,0,0,18
92533,sahitāni,sahitani,18,18,0,0,8
92534,vakkhissati,vakkhissati,3,3,0,0,11
92535,vakkhissanti,vakkhissanti,2,2,0,0,12
92536,vakkhissasi,vakkhissasi,1,1,0,0,11
92537,vakkhissatha,vakkhissatha,1,1,0,0,12
92538,vakkhissāmi,vakkhissami,1,1,0,0,11
92539,vakkhissāma,vakkhissama,1,1,0,0,11
92540,vakkhissate,vakkhissate,1,1,0,0,11
92541,vakkhissante,vakkhissante,1,1,0,0,12
92542,vakkhissase,vakkhissase,1,1,0,0,11
92543,vakkhissavhe,vakkhissavhe,1,1,0,0,12
92544,vakkhissaṃ,vakkhissam,1,1,0,0,10
92545,vakkhissāmhe,vakkhissamhe,1,1,0,0,12
92546,abhītakappe,abhitakappe,1,1,0,0,11
92547,gadratapañhepi,gadratapanhepi,1,1,0,0,14
92548,paṭisanthāraṃ,patisantharam,211,210,1,0,13
92549,nisīdathāti,nisidathati,11,9,2,0,11
92550,vakkhissatī,vakkhissati,1,1,0,0,11
92551,evamādiaṭṭhakathāpāṭho,evamadiatthakathapatho,1,1,0,0,22
92552,dhātussapi,dhatussapi,1,1,0,0,10
92553,bhavissantīsahitāni,bhavissantisahitani,1,1,0,0,19
92554,vakkhissantī,vakkhissanti,1,1,0,0,12
92555,rosissati,rosissati,1,1,0,0,9
92556,rosissantī,rosissanti,1,1,0,0,10
92557,bhavissantīvaseneva,bhavissantivaseneva,1,1,0,0,19
92558,vacissā,vacissa,1,1,0,0,7
92559,avacissaṃsu,avacissamsu,2,2,0,0,11
92560,vacissaṃsu,vacissamsu,1,1,0,0,10
92561,upariyeva,upariyeva,14,14,0,0,9
92562,vattabbaṭṭhānattā,vattabbatthanatta,1,1,0,0,17
92563,cāvetī,caveti,4,3,1,0,6
92564,cavituṃ,cavitum,1,1,0,0,7
92565,seca,seca,1,0,1,0,4
92566,secati,secati,2,2,0,0,6
92567,muci,muci,1,0,1,0,4
92568,ubbaṭṭanaṃ,ubbattanam,2,2,0,0,10
92569,macati,macati,1,1,0,0,6
92570,muñcati,muncati,74,74,0,0,7
92571,dhāraṇucchāyapūjanesu,dharanucchayapujanesu,1,0,1,0,21
92572,ucchāyo,ucchayo,2,1,1,0,7
92573,pūjananti,pujananti,1,1,0,0,9
92574,malaharaṇaṃ,malaharanam,1,1,0,0,11
92575,mañco,manco,144,123,21,0,5
92576,mañcanaṃ,mancanam,1,1,0,0,8
92577,byattikaraṇe,byattikarane,1,0,1,0,12
92578,paripāko,paripako,37,36,1,0,8
92579,thocati,thocati,1,1,0,0,7
92580,saggakāmassa,saggakamassa,6,6,0,0,12
92581,ekattamuparocitaṃ,ekattamuparocitam,2,2,0,0,17
92582,ruciatthaṃ,ruciattham,2,2,0,0,10
92583,roceti,roceti,19,18,1,0,6
92584,rocayatī,rocayati,1,1,0,0,8
92585,rocesī,rocesi,26,26,0,0,6
92586,tegaṇikoyaṃ,teganikoyam,1,1,0,0,11
92587,saṃpāke,sampake,1,0,1,0,7
92588,byayagatiyaṃ,byayagatiyam,1,0,1,0,12
92589,byayagati,byayagati,1,0,1,0,9
92590,vināsagati,vinasagati,1,1,0,0,10
92591,brāhmaṇena,brahmanena,254,248,6,0,10
92592,ayācisuṃ,ayacisum,6,6,0,0,8
92593,rathamayācatha,rathamayacatha,3,3,0,0,14
92594,āyācati,ayacati,9,8,1,0,7
92595,yāceti,yaceti,7,3,4,0,6
92596,yācayati,yacayati,2,2,0,0,8
92597,yācāpeti,yacapeti,3,3,0,0,8
92598,yācāpayati,yacapayati,1,1,0,0,10
92599,yāciyati,yaciyati,1,1,0,0,8
92600,yācayiyati,yacayiyati,1,1,0,0,10
92601,yācāpiyati,yacapiyati,1,1,0,0,10
92602,yācāpayiyati,yacapayiyati,1,1,0,0,12
92603,yācanto,yacanto,71,71,0,0,7
92604,yācantī,yacanti,18,18,0,0,7
92605,yācantaṃ,yacantam,3,3,0,0,8
92606,yācamāno,yacamano,30,28,2,0,8
92607,yācamānā,yacamana,19,19,0,0,8
92608,yācamānaṃ,yacamanam,5,4,1,0,9
92609,yācitvāna,yacitvana,6,6,0,0,9
92610,yācituna,yacituna,1,1,0,0,8
92611,yāciya,yaciya,4,3,1,0,6
92612,yāciyāna,yaciyana,1,1,0,0,8
92613,avisesato,avisesato,124,122,2,0,9
92614,vuttassapi,vuttassapi,9,9,0,0,10
92615,akammakoyeva,akammakoyeva,1,1,0,0,12
92616,divādigaṇiko,divadiganiko,1,1,0,0,12
92617,pānīyantiādi,paniyantiadi,1,1,0,0,12
92618,gaṇapakkhiko,ganapakkhiko,1,1,0,0,12
92619,kammakattuppayogo,kammakattuppayogo,1,1,0,0,17
92620,manusseheva,manusseheva,4,4,0,0,11
92621,pānakriyaṃ,panakriyam,1,1,0,0,10
92622,kammabhūtampi,kammabhutampi,1,1,0,0,13
92623,sukarapānakriyāvasena,sukarapanakriyavasena,1,1,0,0,21
92624,sukarattā,sukaratta,26,26,0,0,9
92625,sijjhantaṃ,sijjhantam,1,1,0,0,10
92626,kariyate,kariyate,9,9,0,0,8
92627,karaṇakriyaṃ,karanakriyam,1,1,0,0,12
92628,kammabhūtopi,kammabhutopi,3,3,0,0,12
92629,sukaraṇa,sukarana,1,1,0,0,8
92630,kriyāvasena,kriyavasena,1,1,0,0,11
92631,sijjhanto,sijjhanto,3,3,0,0,9
92632,pānīyeneva,paniyeneva,1,1,0,0,10
92633,kaṭeneva,kateneva,1,1,0,0,8
92634,amhehīti,amhehiti,9,7,2,0,8
92635,sakammakavisayattā,sakammakavisayatta,1,1,0,0,18
92636,kriyāpaṭisedhanasaṅkhātaṃ,kriyapatisedhanasankhatam,1,1,0,0,25
92637,atthavisesaṃ,atthavisesam,26,25,1,0,12
92638,ajjhāharito,ajjhaharito,1,1,0,0,11
92639,akammakavisayattā,akammakavisayatta,1,1,0,0,17
92640,akammakakattuvācakattā,akammakakattuvacakatta,1,1,0,0,22
92641,kammarahitasuddhakattuvācakattā,kammarahitasuddhakattuvacakatta,1,1,0,0,31
92642,gaṇikarūpanti,ganikarupanti,1,1,0,0,13
92643,lokavohārakusalassa,lokavoharakusalassa,1,1,0,0,19
92644,pāḷinayaññeva,palinayanneva,1,1,0,0,13
92645,pakkhipissāma,pakkhipissama,2,2,0,0,13
92646,dhammapālācariya,dhammapalacariya,1,0,1,0,16
92647,anuruddhācariyā,anuruddhacariya,1,0,1,0,15
92648,abhisaṅkhatā,abhisankhata,26,25,1,0,12
92649,gaṇikappayogā,ganikappayoga,1,1,0,0,13
92650,ñāṇayuttavaraṃ,nanayuttavaram,3,3,0,0,14
92651,tihetukaṃ,tihetukam,43,40,3,0,9
92652,pākānaṃ,pakanam,8,8,0,0,7
92653,pavatte,pavatte,788,759,29,0,7
92654,aṭṭhake,atthake,9,9,0,0,7
92655,asaṅkhāraṃ,asankharam,51,48,3,0,10
92656,sasaṅkhāravipākāni,sasankharavipakani,6,6,0,0,18
92657,gaṇamhi,ganamhi,1,1,0,0,7
92658,sakammakabhāvena,sakammakabhavena,1,1,0,0,16
92659,akammakabhāvena,akammakabhavena,1,1,0,0,15
92660,dhātusseva,dhatusseva,2,2,0,0,10
92661,sakamakassapi,sakamakassapi,1,1,0,0,13
92662,akammakabhūtassa,akammakabhutassa,3,3,0,0,16
92663,sakammakattamicchanti,sakammakattamicchanti,1,1,0,0,21
92664,saṃsayasamugghāṭatthaṃ,samsayasamugghatattham,4,3,1,0,22
92665,paṭṭhapema,patthapema,2,2,0,0,10
92666,gaṇanānattayogato,ganananattayogato,1,1,0,0,17
92667,sakammākammakā,sakammakammaka,2,2,0,0,14
92668,pacabhidā,pacabhida,1,0,1,0,9
92669,bhūtapacaniṃ,bhutapacanim,10,8,2,0,12
92670,vīhisīsaṃ,vihisisam,9,9,0,0,9
92671,rukkhaphalāni,rukkhaphalani,12,11,1,0,13
92672,pākāraṃ,pakaram,88,83,5,0,7
92673,taḷākapāḷi,talakapali,1,1,0,0,10
92674,bhijjanadhammaṃ,bhijjanadhammam,10,10,0,0,15
92675,abujjhī,abujjhi,1,1,0,0,7
92676,āṇattisambhūtahananakriyāpaṭisedhamiva,anattisambhutahananakriyapatisedhamiva,1,1,0,0,38
92677,paropadesasambhūtabujjhanakriyāpaṭisedhanamiva,paropadesasambhutabujjhanakriyapatisedhanamiva,1,1,0,0,46
92678,kriyāpaṭisedhanavasena,kriyapatisedhanavasena,1,1,0,0,22
92679,kammakattubhāvaparikappo,kammakattubhavaparikappo,1,1,0,0,24
92680,suddhakattuatthepi,suddhakattuatthepi,1,1,0,0,18
92681,kammattheyeva,kammattheyeva,4,4,0,0,13
92682,nayaññūhi,nayannuhi,6,6,0,0,9
92683,gaṇantaraṃ,ganantaram,1,1,0,0,10
92684,paccāmitte,paccamitte,15,15,0,0,10
92685,gaṇantarañcopasaggaṃ,ganantarancopasaggam,2,2,0,0,20
92686,atthanānataṃ,atthananatam,1,1,0,0,12
92687,gambhīresupi,gambhiresupi,1,1,0,0,12
92688,payogañcatthanānataṃ,payogancatthananatam,1,1,0,0,20
92689,dhātādayo,dhatadayo,4,4,0,0,9
92690,rodanti,rodanti,75,72,3,0,7
92691,upasaggavaseneke,upasaggavaseneke,1,1,0,0,16
92692,sakammāpi,sakammapi,1,1,0,0,9
92693,tathekacce,tathekacce,1,1,0,0,10
92694,akammāpi,akammapi,1,1,0,0,8
92695,tupasaggehi,tupasaggehi,1,1,0,0,11
92696,esatthopettha,esatthopettha,1,1,0,0,13
92697,paciyatī,paciyati,1,1,0,0,8
92698,pāciyati,paciyati,1,1,0,0,8
92699,pācayiyati,pacayiyati,1,1,0,0,10
92700,pācāpiyati,pacapiyati,1,1,0,0,10
92701,pācāpayiyatī,pacapayiyati,1,1,0,0,12
92702,pacantī,pacanti,6,6,0,0,7
92703,pacamānā,pacamana,4,4,0,0,8
92704,pacitabbaṃ,pacitabbam,30,28,2,0,10
92705,pacanīyaṃ,pacaniyam,1,1,0,0,9
92706,pacituṃ,pacitum,72,72,0,0,7
92707,pacasī,pacasi,4,4,0,0,6
92708,padakkamo,padakkamo,5,5,0,0,9
92709,subodho,subodho,1,1,0,0,7
92710,gharaṇe,gharane,1,0,1,0,7
92711,ubhatobhāsā,ubhatobhasa,1,0,1,0,11
92712,chakārantadhātu,chakarantadhatu,2,2,0,0,15
92713,dibhāvaṃ,dibhavam,1,1,0,0,8
92714,dhātunaṃ,dhatunam,5,5,0,0,8
92715,byākarissaṃ,byakarissam,2,2,0,0,11
92716,choti,choti,1,1,0,0,5
92717,chotvāna,chotvana,1,1,0,0,8
92718,moḷiṃ,molim,22,19,3,0,5
92719,varagandhavāsitaṃ,varagandhavasitam,10,9,1,0,17
92720,acchocchuṃvata,acchocchumvata,1,1,0,0,14
92721,milecha,milecha,2,0,2,0,7
92722,aviyattāyaṃ,aviyattayam,1,0,1,0,11
92723,milecchati,milecchati,1,1,0,0,10
92724,milakkhu,milakkhu,5,4,1,0,8
92725,milakkhūsu,milakkhusu,7,7,0,0,10
92726,aviññātāresu,avinnataresu,11,11,0,0,12
92727,vachi,vachi,1,0,1,0,5
92728,vañchati,vanchati,1,1,0,0,8
92729,vañchitaṃ,vanchitam,1,1,0,0,9
92730,achi,achi,1,0,1,0,4
92731,añchanto,anchanto,6,6,0,0,8
92732,añchāmīti,anchamiti,2,1,1,0,9
92733,hucchati,hucchati,1,1,0,0,8
92734,mohamucchāsu,mohamucchasu,1,0,1,0,12
92735,mucchati,mucchati,10,10,0,0,8
92736,mucchito,mucchito,66,65,1,0,8
92737,visavegena,visavegena,18,17,1,0,10
92738,samapajjatha,samapajjatha,11,11,0,0,12
92739,phucha,phucha,1,0,1,0,6
92740,phochati,phochati,1,1,0,0,8
92741,yucha,yucha,1,0,1,0,5
92742,yucchati,yucchati,1,1,0,0,8
92743,uchi,uchi,1,0,1,0,4
92744,uñche,unche,11,4,7,0,5
92745,uñcho,uncho,9,6,3,0,5
92746,pariyesanaṃ,pariyesanam,40,39,1,0,11
92747,uñchati,unchati,7,7,0,0,7
92748,uñchācariyāya,unchacariyaya,40,39,1,0,13
92749,īhatha,ihatha,4,4,0,0,6
92750,ucha,ucha,1,0,1,0,4
92751,uchati,uchati,1,1,0,0,6
92752,pucchako,pucchako,1,1,0,0,8
92753,vinayadharaṃ,vinayadharam,34,34,0,0,12
92754,pucchi,pucchi,2482,2469,13,0,6
92755,pucchituṃ,pucchitum,130,121,9,0,9
92756,adiṭṭhajotanāpucchā,aditthajotanapuccha,23,20,3,0,19
92757,diṭṭhasaṃsandanāpucchā,ditthasamsandanapuccha,24,19,5,0,22
92758,vimaticchedanāpucchā,vimaticchedanapuccha,21,17,4,0,20
92759,anumatipucchā,anumatipuccha,39,23,16,0,13
92760,kathetukamyatāpucchāti,kathetukamyatapucchati,20,19,1,0,22
92761,aṭṭhasālini,atthasalini,1,0,1,0,11
92762,yādito,yadito,2,2,0,0,6
92763,vicchikā,vicchika,17,17,0,0,8
92764,vacchu,vacchu,1,0,1,0,6
92765,vucchati,vucchati,1,1,0,0,8
92766,vuttavā,vuttava,1,1,0,0,7
92767,kāragatassa,karagatassa,2,2,0,0,11
92768,kesoharaṇepi,kesoharanepi,1,1,0,0,12
92769,kāpaṭiko,kapatiko,16,16,0,0,8
92770,mañcaṭṭhā,mancattha,1,1,0,0,9
92771,cakkhunissitaṃ,cakkhunissitam,6,4,2,0,14
92772,ropitepi,ropitepi,3,3,0,0,8
92773,sāradikaṃ,saradikam,7,5,2,0,9
92774,virūhatī,viruhati,5,5,0,0,8
92775,kathitepi,kathitepi,10,10,0,0,9
92776,vuttamarahatā,vuttamarahata,3,2,1,0,13
92777,vacchuvapavaca,vacchuvapavaca,1,0,1,0,14
92778,kesohāre,kesohare,2,2,0,0,8
92779,ropite,ropite,24,23,1,0,6
92780,yathākkamanti,yathakkamanti,11,11,0,0,13
92781,paṭivuttaṃ,pativuttam,10,8,2,0,10
92782,vāpasamīkaraṇe,vapasamikarane,8,8,0,0,14
92783,pannalomo,pannalomo,10,9,1,0,9
92784,paradattavutto,paradattavutto,8,8,0,0,14
92785,paṇḍupalāso,pandupalaso,36,33,3,0,11
92786,samīhitaṃ,samihitam,16,14,2,0,9
92787,pāvacanavasena,pavacanavasena,8,8,0,0,14
92788,pavattite,pavattite,33,32,1,0,9
92789,pārāyano,parayano,4,4,0,0,8
92790,ajjhene,ajjhene,10,10,0,0,7
92791,cevametesu,cevametesu,1,1,0,0,10
92792,padissatī,padissati,1,1,0,0,9
92793,saupasaggoca,saupasaggoca,1,1,0,0,12
92794,vapane,vapane,6,6,0,0,6
92795,pamuttabhāve,pamuttabhave,4,4,0,0,12
92796,kathaneti,kathaneti,2,2,0,0,9
92797,virūhati,viruhati,29,29,0,0,8
92798,phalamasnāti,phalamasnati,7,7,0,0,12
92799,dubbhatī,dubbhati,6,6,0,0,8
92800,aṭṭhadantakādīhi,atthadantakadihi,3,3,0,0,16
92801,kesoharaṇe,kesoharane,1,1,0,0,10
92802,migabhūtena,migabhutena,18,14,4,0,11
92803,abhabbo,abhabbo,490,465,25,0,7
92804,haritatthāyā,haritatthaya,3,3,0,0,12
92805,yesamidaṃ,yesamidam,20,20,0,0,9
92806,porāṇaṃ,poranam,100,92,8,0,7
92807,pāvacanabhāvena,pavacanabhavena,13,13,0,0,15
92808,vacchuvaca,vacchuvaca,1,0,1,0,10
92809,nopasaggo,nopasaggo,1,1,0,0,9
92810,muṇḍatāya,mundataya,1,1,0,0,9
92811,jīvavutyaṃ,jivavutyam,1,1,0,0,10
92812,pamuttatthe,pamuttatthe,1,1,0,0,11
92813,pāvacanassa,pavacanassa,2,2,0,0,11
92814,jakārantadhātu,jakarantadhatu,3,3,0,0,14
92815,parājayati,parajayati,6,6,0,0,10
92816,parajjati,parajjati,9,9,0,0,9
92817,jayāpesuṃ,jayapesum,4,3,1,0,9
92818,jayāpetvā,jayapetva,9,9,0,0,9
92819,jayatu,jayatu,11,11,0,0,6
92820,āsīsavacanaṃ,asisavacanam,1,1,0,0,12
92821,vadiṃsūti,vadimsuti,4,4,0,0,9
92822,jeto,jeto,26,22,4,0,4
92823,jitāvī,jitavi,2,2,0,0,6
92824,odhijino,odhijino,5,4,1,0,8
92825,anodhijino,anodhijino,3,3,0,0,10
92826,vijitvā,vijitva,14,14,0,0,7
92827,abhibhavane,abhibhavane,3,2,1,0,11
92828,janatāsālimaṃsodanaṃ,janatasalimamsodanam,1,1,0,0,20
92829,atimaññissatī,atimannissati,3,2,1,0,13
92830,abhibhavanatthasādhakā,abhibhavanatthasadhaka,1,1,0,0,22
92831,adhibhūtanti,adhibhutanti,1,1,0,0,12
92832,sīghagati,sighagati,3,3,0,0,9
92833,javanaṃ,javanam,209,204,5,0,7
92834,javanto,javanto,2,2,0,0,7
92835,javanacittaṃ,javanacittam,21,21,0,0,12
92836,javanahaṃso,javanahamso,4,4,0,0,11
92837,manojavaṃ,manojavam,21,20,1,0,9
92838,yenakāmaṃ,yenakamam,44,41,3,0,9
92839,jekhaye,jekhaye,1,0,1,0,7
92840,īyā,iya,1,0,1,0,3
92841,jīyethā,jiyetha,1,1,0,0,7
92842,khuju,khuju,1,0,1,0,5
92843,kojati,kojati,1,1,0,0,6
92844,khojati,khojati,1,1,0,0,7
92845,dhaji,dhaji,1,0,1,0,5
92846,abbajati,abbajati,1,1,0,0,8
92847,manussattañca,manussattanca,17,17,0,0,13
92848,abbaje,abbaje,16,16,0,0,6
92849,vajanaṃ,vajanam,3,3,0,0,7
92850,pavajanaṃ,pavajanam,1,1,0,0,9
92851,pabbājito,pabbajito,39,39,0,0,9
92852,duruttānaṃ,duruttanam,33,28,5,0,10
92853,nidhetave,nidhetave,4,4,0,0,9
92854,dhajati,dhajati,1,1,0,0,7
92855,dhañjati,dhanjati,1,1,0,0,8
92856,dhañjanaṃ,dhanjanam,2,1,1,0,9
92857,dhajoti,dhajoti,7,3,4,0,7
92858,gatiapekkhakoyeva,gatiapekkhakoyeva,1,1,0,0,17
92859,ajoti,ajoti,2,1,1,0,5
92860,urabbhoti,urabbhoti,1,0,1,0,9
92861,avīti,aviti,4,0,4,0,5
92862,rattalomo,rattalomo,1,1,0,0,9
92863,meṇḍoti,mendoti,2,0,2,0,7
92864,kuṭilasiṅgo,kutilasingo,1,1,0,0,11
92865,janakajātake,janakajatake,1,0,1,0,12
92866,ajarathato,ajarathato,1,1,0,0,10
92867,meṇḍarathā,mendaratha,3,3,0,0,10
92868,ajato,ajato,1,1,0,0,5
92869,eḷakassa,elakassa,21,21,0,0,8
92870,meṇḍopi,mendopi,1,1,0,0,7
92871,mahosadhajātakaṭṭhakathāya,mahosadhajatakatthakathaya,1,0,1,0,26
92872,meṇḍeḷakānaṃ,mendelakanam,1,1,0,0,12
92873,nibbisesatā,nibbisesata,1,1,0,0,11
92874,ajjanaṃ,ajjanam,1,0,1,0,7
92875,ajjanakriyā,ajjanakriya,1,1,0,0,11
92876,byathanaṃ,byathanam,1,0,1,0,9
92877,majjane,majjane,2,0,2,0,7
92878,majjanaṃ,majjanam,3,1,2,0,8
92879,byathanāpekkho,byathanapekkho,1,1,0,0,14
92880,khajjati,khajjati,25,25,0,0,8
92881,mantho,mantho,3,0,3,0,6
92882,viloḷanaṃ,vilolanam,1,1,0,0,9
92883,khajati,khajati,2,2,0,0,7
92884,gativekalle,gativekalle,2,0,2,0,11
92885,khañjā,khanja,8,8,0,0,6
92886,khañjanaṃ,khanjanam,3,3,0,0,9
92887,khañjituṃ,khanjitum,1,1,0,0,9
92888,khañjitvā,khanjitva,1,1,0,0,9
92889,ejāti,ejati,4,1,3,0,5
92890,lābhādiṃ,labhadim,4,4,0,0,8
92891,balavataṇhāyetaṃ,balavatanhayetam,3,3,0,0,16
92892,buja,buja,1,0,1,0,4
92893,vajiranibbese,vajiranibbese,1,0,1,0,13
92894,vajiranigghoseti,vajiranigghoseti,1,1,0,0,16
92895,bojati,bojati,1,1,0,0,6
92896,khija,khija,1,0,1,0,5
92897,kuji,kuji,2,0,2,0,4
92898,guji,guji,1,0,1,0,4
92899,khijati,khijati,1,1,0,0,7
92900,kuñjati,kunjati,2,2,0,0,7
92901,guñjati,gunjati,1,1,0,0,7
92902,laja,laja,2,0,2,0,4
92903,lajati,lajati,1,1,0,0,6
92904,lājati,lajati,1,1,0,0,6
92905,tajjati,tajjati,1,1,0,0,7
92906,bhassanāpekkho,bhassanapekkho,1,1,0,0,14
92907,lañjati,lanjati,1,1,0,0,7
92908,nayalañjako,nayalanjako,10,7,3,0,11
92909,lañjeti,lanjeti,5,4,1,0,7
92910,suttatthanti,suttatthanti,3,3,0,0,12
92911,lañjako,lanjako,8,7,1,0,7
92912,jaja,jaja,1,0,1,0,4
92913,jaji,jaji,1,0,1,0,4
92914,yujjhanaṃ,yujjhanam,8,8,0,0,9
92915,jajati,jajati,1,1,0,0,6
92916,jañjati,janjati,1,1,0,0,7
92917,tojati,tojati,1,1,0,0,6
92918,tuji,tuji,3,0,3,0,4
92919,balane,balane,1,0,1,0,6
92920,balanaṃ,balanam,1,0,1,0,7
92921,balanakriyā,balanakriya,1,1,0,0,11
92922,hiṃsāpekkhako,himsapekkhako,3,3,0,0,13
92923,tuñjati,tunjati,1,1,0,0,7
92924,gajati,gajati,1,1,0,0,6
92925,muñjati,munjati,1,1,0,0,7
92926,gajjati,gajjati,30,26,4,0,7
92927,ñāṇagajjanaṃ,nanagajjanam,1,1,0,0,12
92928,gajjituṃ,gajjitum,1,1,0,0,8
92929,gajjitvā,gajjitva,19,19,0,0,8
92930,gajoti,gajoti,2,0,2,0,6
92931,nekapo,nekapo,1,1,0,0,6
92932,hatthipoto,hatthipoto,3,3,0,0,10
92933,hatthicchāpo,hatthicchapo,2,2,0,0,12
92934,cajanto,cajanto,6,6,0,0,7
92935,sañcati,sancati,1,1,0,0,7
92936,sajanaṃ,sajanam,5,4,1,0,7
92937,sajituṃ,sajitum,1,1,0,0,7
92938,sajitvā,sajitva,1,1,0,0,7
92939,īja,ija,1,0,1,0,3
92940,ījati,ijati,1,1,0,0,5
92941,bhajjane,bhajjane,1,0,1,0,8
92942,tāpakaraṇaṃ,tapakaranam,1,1,0,0,11
92943,tilāni,tilani,10,10,0,0,6
92944,bhajjati,bhajjati,5,5,0,0,8
92945,bhajjamānāni,bhajjamanani,1,1,0,0,12
92946,bheja,bheja,1,0,1,0,5
92947,bhejati,bhejati,1,1,0,0,7
92948,bhājati,bhajati,3,3,0,0,7
92949,khamāyañca,khamayanca,2,0,2,0,10
92950,tikkhatākaraṇaṃ,tikkhatakaranam,1,1,0,0,15
92951,tejano,tejano,3,3,0,0,6
92952,tejanoti,tejanoti,1,0,1,0,8
92953,tejoti,tejoti,11,2,9,0,6
92954,uṇhattaṃ,unhattam,14,14,0,0,8
92955,parissagge,parissagge,1,0,1,0,10
92956,āliṅganaṃ,alinganam,3,3,0,0,9
92957,parissaggo,parissaggo,1,0,1,0,10
92958,khañjati,khanjati,4,4,0,0,8
92959,rājitvā,rajitva,1,1,0,0,7
92960,virājitvā,virajitva,1,1,0,0,9
92961,viññūnamatthavivaraṇe,vinnunamatthavivarane,1,1,0,0,21
92962,paṭhamapādassa,pathamapadassa,1,1,0,0,14
92963,dutiyapade,dutiyapade,20,20,0,0,10
92964,matthī,matthi,3,2,1,0,6
92965,arāja,araja,5,3,2,0,5
92966,yopāyaṃ,yopayam,25,24,1,0,7
92967,atikaramakarācariyā,atikaramakaracariya,1,1,0,0,19
92968,akarīti,akariti,2,1,1,0,7
92969,akara,akara,4,3,1,0,5
92970,ākhyātaparokkhāvibhattiko,akhyataparokkhavibhattiko,1,1,0,0,25
92971,virocīti,virociti,1,1,0,0,8
92972,piṇḍattho,pindattho,48,44,4,0,9
92973,ahituṇḍikajanā,ahitundikajana,1,1,0,0,14
92974,kariṃsū,karimsu,17,17,0,0,7
92975,rajati,rajati,14,14,0,0,6
92976,haliddirāgo,haliddirago,12,10,2,0,11
92977,rajjati,rajjati,153,140,13,0,7
92978,virajjatī,virajjati,6,6,0,0,9
92979,rajanavatthu,rajanavatthu,2,2,0,0,12
92980,rajakoti,rajakoti,2,0,2,0,8
92981,rajakāro,rajakaro,1,1,0,0,8
92982,vatthadhovanako,vatthadhovanako,1,1,0,0,15
92983,rañjanamattameva,ranjanamattameva,1,1,0,0,16
92984,tadabhidhānāni,tadabhidhanani,5,5,0,0,14
92985,lubbhitattañca,lubbhitattanca,1,1,0,0,14
92986,lubbhanā,lubbhana,13,13,0,0,8
92987,nikāmanā,nikamana,24,22,2,0,8
92988,niyanti,niyanti,2,2,0,0,7
92989,nandīrāgo,nandirago,18,15,3,0,9
92990,sañjananī,sanjanani,11,9,2,0,9
92991,ajjhosānantinekadhā,ajjhosanantinekadha,1,1,0,0,19
92992,virāgoti,viragoti,30,9,21,0,8
92993,pathavissaro,pathavissaro,13,13,0,0,12
92994,dhātudvayavasena,dhatudvayavasena,2,2,0,0,16
92995,niyyante,niyyante,4,4,0,0,8
92996,piyavacanañca,piyavacananca,1,1,0,0,13
92997,atthacariyā,atthacariya,42,40,2,0,11
92998,samānattatā,samanattata,27,26,1,0,11
92999,saṅgahavatthūhi,sangahavatthuhi,81,77,4,0,15
93000,mahājanaṃ,mahajanam,314,305,9,0,9
93001,rañjetītipi,ranjetitipi,1,1,0,0,11
93002,rājinīti,rajiniti,1,0,1,0,8
93003,rājabhariyā,rajabhariya,1,1,0,0,11
93004,sahābhidhānantarehi,sahabhidhanantarehi,1,1,0,0,19
93005,manujindo,manujindo,21,21,0,0,9
93006,raṭṭhādhipo,ratthadhipo,2,2,0,0,11
93007,bhūmipālo,bhumipalo,16,14,2,0,9
93008,manussindo,manussindo,6,6,0,0,10
93009,janādhipo,janadhipo,26,26,0,0,9
93010,khettassāmi,khettassami,1,1,0,0,11
93011,pabhāvako,pabhavako,1,1,0,0,9
93012,khattiyajātiko,khattiyajatiko,5,5,0,0,14
93013,anurājā,anuraja,1,1,0,0,7
93014,uparājāti,uparajati,1,1,0,0,9
93015,catuddīpī,catuddipi,1,1,0,0,9
93016,uparī,upari,28,24,4,0,5
93017,bhūbhujaṅganā,bhubhujangana,1,1,0,0,13
93018,rājapadumī,rajapadumi,1,1,0,0,10
93019,itthāgārantu,itthagarantu,1,1,0,0,12
93020,uparītipi,uparitipi,1,1,0,0,9
93021,bhajanā,bhajana,21,20,1,0,7
93022,sambhajanā,sambhajana,11,11,0,0,10
93023,sambhatti,sambhatti,18,17,1,0,9
93024,devapūjasaṅgatakaraṇadānadhammesu,devapujasangatakaranadanadhammesu,1,0,1,0,33
93025,devapūja,devapuja,1,0,1,0,8
93026,buddhādipūjā,buddhadipuja,1,1,0,0,12
93027,saṅgatakaraṇaṃ,sangatakaranam,1,0,1,0,14
93028,samodhānakaraṇaṃ,samodhanakaranam,1,1,0,0,16
93029,adhimuttattheravatthumhi,adhimuttattheravatthumhi,2,1,1,0,24
93030,saṅgata,sangata,3,2,1,0,7
93031,samodhānaṃ,samodhanam,215,178,37,0,10
93032,jhānasīlādi,jhanasiladi,1,1,0,0,11
93033,ijjati,ijjati,2,2,0,0,6
93034,dhammayāgo,dhammayago,7,7,0,0,10
93035,yajamāno,yajamano,12,11,1,0,8
93036,yiṭṭhuṃ,yitthum,2,2,0,0,7
93037,yajituṃ,yajitum,24,24,0,0,7
93038,puthuyaññaṃ,puthuyannam,7,6,1,0,11
93039,soḷasaparikkhāraṃ,solasaparikkharam,8,7,1,0,17
93040,sammajjati,sammajjati,47,46,1,0,10
93041,sammajjanī,sammajjani,27,26,1,0,10
93042,niñji,ninji,1,0,1,0,5
93043,niñjati,ninjati,2,2,0,0,7
93044,paniñjati,paninjati,1,1,0,0,9
93045,niñjituṃ,ninjitum,1,1,0,0,8
93046,paniñjituṃ,paninjitum,1,1,0,0,10
93047,niñjitvā,ninjitva,1,1,0,0,8
93048,paniñjitvā,paninjitva,3,3,0,0,10
93049,uṭṭhāyāsanā,utthayasana,633,623,10,0,11
93050,anulokeyyāsī,anulokeyyasi,1,1,0,0,12
93051,bhajjamānā,bhajjamana,1,1,0,0,10
93052,ujubhāvo,ujubhavo,10,10,0,0,8
93053,ojati,ojati,1,1,0,0,5
93054,vissaggaparissajjanabbhukkiraṇesu,vissaggaparissajjanabbhukkiranesu,1,0,1,0,33
93055,sajati,sajati,3,3,0,0,6
93056,lokyaṃ,lokyam,7,5,2,0,6
93057,sajantaṃ,sajantam,9,8,1,0,8
93058,rujati,rujati,15,15,0,0,6
93059,rujāti,rujati,3,1,2,0,6
93060,rujanaṭṭhena,rujanatthena,4,4,0,0,12
93061,rogoti,rogoti,10,7,3,0,6
93062,byādhiyeva,byadhiyeva,1,1,0,0,10
93063,bhujati,bhujati,2,2,0,0,7
93064,ābhujati,abhujati,25,21,4,0,8
93065,ūrubaddhāsanaṃ,urubaddhasanam,28,20,8,0,14
93066,āvaṭṭatīti,avattatiti,5,4,1,0,10
93067,osakkatī,osakkati,1,1,0,0,8
93068,vaṇṇadānaṃ,vannadanam,6,6,0,0,10
93069,vibhujatīti,vibhujatiti,2,1,1,0,11
93070,mūlavibhujo,mulavibhujo,1,0,1,0,11
93071,ābhujitvā,abhujitva,254,252,2,0,9
93072,bhogoti,bhogoti,7,3,4,0,7
93073,bhujayati,bhujayati,1,1,0,0,9
93074,ahisarīraṃ,ahisariram,2,2,0,0,10
93075,bhogīti,bhogiti,4,0,4,0,7
93076,raji,raji,1,0,1,0,4
93077,ārañjati,aranjati,1,1,0,0,8
93078,tathāgatarañjitaṃ,tathagataranjitam,1,1,0,0,17
93079,itipī,itipi,56,53,3,0,5
93080,nettipāḷi,nettipali,2,2,0,0,9
93081,sikkhattayasaṅgahitaṃ,sikkhattayasangahitam,21,19,2,0,21
93082,sāsanabrahmacariyaṃ,sasanabrahmacariyam,55,48,7,0,19
93083,tathāgatagandhahatthino,tathagatagandhahatthino,3,3,0,0,23
93084,mahāvajirañāṇasabbaññutaññāṇadantehi,mahavajirananasabbannutannanadantehi,3,3,0,0,36
93085,ārañjitaṃ,aranjitam,3,1,2,0,9
93086,tebhūmakadhammānaṃ,tebhumakadhammanam,25,25,0,0,18
93087,ārañjanaṭṭhānantipi,aranjanatthanantipi,2,2,0,0,19
93088,ruñjitaṃ,runjitam,1,1,0,0,8
93089,rañjanaṭṭhānaṃ,ranjanatthanam,1,1,0,0,14
93090,padakkantaṃ,padakkantam,11,9,2,0,11
93091,adhikaraṇatthasambhavato,adhikaranatthasambhavato,1,1,0,0,24
93092,vijī,viji,3,1,2,0,4
93093,bhayacalanesu,bhayacalanesu,3,1,2,0,13
93094,saniggahītāgamāni,saniggahitagamani,5,5,0,0,17
93095,vejati,vejati,1,1,0,0,6
93096,dhammasaṃvego,dhammasamvego,23,19,4,0,13
93097,saṃvigo,samvigo,1,1,0,0,7
93098,palāyi,palayi,151,151,0,0,6
93099,nadīvego,nadivego,1,1,0,0,8
93100,ūmivego,umivego,7,7,0,0,7
93101,vātavego,vatavego,4,3,1,0,8
93102,dhammasaṃvegoti,dhammasamvegoti,2,0,2,0,15
93103,sahottappaṃ,sahottappam,7,6,1,0,11
93104,ubbijjatī,ubbijjati,2,2,0,0,9
93105,dvigaṇikattā,dviganikatta,2,2,0,0,12
93106,lajjāti,lajjati,8,3,5,0,7
93107,viriḷanā,virilana,1,1,0,0,8
93108,vaḷaji,valaji,2,1,1,0,6
93109,paribhoge,paribhoge,121,102,19,0,9
93110,vaḷañjati,valanjati,1,1,0,0,9
93111,kujja,kujja,1,0,1,0,5
93112,adhomukhīkaraṇe,adhomukhikarane,1,0,1,0,15
93113,kujjati,kujjati,2,1,1,0,7
93114,nikujjati,nikujjati,1,1,0,0,9
93115,ukkujjati,ukkujjati,3,3,0,0,9
93116,paṭikujjati,patikujjati,2,2,0,0,11
93117,nikujjitaṃ,nikujjitam,11,10,1,0,10
93118,ukkujjeyya,ukkujjeyya,94,91,3,0,10
93119,pātiyā,patiya,31,31,0,0,6
93120,avakujjo,avakujjo,18,17,1,0,8
93121,nipajjahaṃ,nipajjaham,11,10,1,0,10
93122,nikujjatīti,nikujjatiti,1,0,1,0,11
93123,vicaratī,vicarati,37,36,1,0,8
93124,adhomukhaṃ,adhomukham,53,52,1,0,10
93125,ukkujjatīti,ukkujjatiti,1,0,1,0,11
93126,uparimukhaṃ,uparimukham,10,9,1,0,11
93127,paṭikujjatīti,patikujjatiti,1,0,1,0,13
93128,mujja,mujja,3,2,1,0,5
93129,osīdane,osidane,1,0,1,0,7
93130,mujjati,mujjati,2,2,0,0,7
93131,nimujjati,nimujjati,22,21,1,0,9
93132,ummuggo,ummuggo,2,2,0,0,7
93133,opuji,opuji,1,0,1,0,5
93134,vilimpane,vilimpane,1,0,1,0,9
93135,gomayena,gomayena,11,11,0,0,8
93136,opuñjati,opunjati,1,1,0,0,8
93137,jhakārantadhātu,jhakarantadhatu,1,1,0,0,15
93138,jhāyati,jhayati,236,230,6,0,7
93139,nijjhāyati,nijjhayati,47,46,1,0,10
93140,upanijjhāyati,upanijjhayati,27,27,0,0,13
93141,ujjhāyati,ujjhayati,60,60,0,0,9
93142,nijjhānaṃ,nijjhanam,73,59,14,0,9
93143,upanijjhānaṃ,upanijjhanam,1,1,0,0,12
93144,ujjhāyanaṃ,ujjhayanam,3,3,0,0,10
93145,sajjhāyanaṃ,sajjhayanam,6,6,0,0,11
93146,nijjhatti,nijjhatti,2,2,0,0,9
93147,jhāyananti,jhayananti,1,1,0,0,10
93148,jhāyanaṃ,jhayanam,5,5,0,0,8
93149,sobhanamasobhanañca,sobhanamasobhananca,1,1,0,0,19
93150,jhāyāmi,jhayami,20,20,0,0,7
93151,jhāyanto,jhayanto,40,38,2,0,8
93152,adhomukho,adhomukho,48,48,0,0,9
93153,pajjhāyanto,pajjhayanto,24,24,0,0,11
93154,nisīdī,nisidi,35,32,3,0,6
93155,jhāyīti,jhayiti,35,7,28,0,7
93156,ārammaṇūpanijjhānena,arammanupanijjhanena,18,18,0,0,20
93157,lakkhaṇūpanijjhānena,lakkhanupanijjhanena,23,23,0,0,20
93158,jhāyanasīlo,jhayanasilo,5,5,0,0,11
93159,cintanasīlo,cintanasilo,1,1,0,0,11
93160,jhānavāti,jhanavati,1,1,0,0,9
93161,dānime,danime,25,25,0,0,6
93162,jhāyanti,jhayanti,48,47,1,0,8
93163,jhāyantīti,jhayantiti,24,17,7,0,10
93164,ajjhāyakā,ajjhayaka,9,9,0,0,9
93165,ajjhāyakātveva,ajjhayakatveva,2,1,1,0,14
93166,upanibbattaṃ,upanibbattam,17,15,2,0,12
93167,paṭhamakappikakāle,pathamakappikakale,14,14,0,0,18
93168,jhānavirahitānaṃ,jhanavirahitanam,4,4,0,0,16
93169,garahavacanaṃ,garahavacanam,7,7,0,0,13
93170,ajjhāyatīti,ajjhayatiti,5,5,0,0,11
93171,pasaṃsāvacanaṃ,pasamsavacanam,20,16,4,0,14
93172,voharantīti,voharantiti,65,62,3,0,11
93173,atthaparivattanaṃ,atthaparivattanam,1,1,0,0,17
93174,mantadharo,mantadharo,47,43,4,0,10
93175,dārūni,daruni,110,109,1,0,6
93176,jhāyanajalana,jhayanajalana,1,0,1,0,13
93177,jajjha,jajjha,1,0,1,0,6
93178,jajjhati,jajjhati,1,1,0,0,8
93179,ujjha,ujjha,2,1,1,0,5
93180,ussaggo,ussaggo,7,6,1,0,7
93181,chaḍḍanaṃ,chaddanam,21,19,2,0,9
93182,ujjhati,ujjhati,4,4,0,0,7
93183,ujjhitaṃ,ujjhitam,8,6,2,0,8
93184,jhakārantadhāturūpāni,jhakarantadhaturupani,1,1,0,0,21
93185,ñakārantadhātu,nakarantadhatu,1,1,0,0,14
93186,ñanti,nanti,2,2,0,0,5
93187,ñāsi,nasi,3,3,0,0,4
93188,ñātu,natu,4,4,0,0,4
93189,ñantu,nantu,1,1,0,0,5
93190,ñeyyuṃ,neyyum,1,1,0,0,6
93191,ñatti,natti,294,291,3,0,5
93192,saññatti,sannatti,5,5,0,0,8
93193,ñātabbaṭṭhena,natabbatthena,3,3,0,0,13
93194,diṭṭhadhammikādayo,ditthadhammikadayo,1,1,0,0,18
93195,avidvā,avidva,61,57,4,0,6
93196,jānanabhāvo,jananabhavo,5,5,0,0,11
93197,saññāpeti,sannapeti,35,34,1,0,9
93198,viññāpayatī,vinnapayati,1,1,0,0,11
93199,aññāti,annati,41,14,27,0,6
93200,anaññātaññassāmītindriyaṃ,anannatannassamitindriyam,266,254,12,0,25
93201,nabbhaññaṃsu,nabbhannamsu,2,2,0,0,12
93202,abbhaññaṃsū,abbhannamsu,1,1,0,0,11
93203,ñātītiādīni,natitiadini,1,0,1,0,11
93204,ākhyātikapadāni,akhyatikapadani,1,1,0,0,15
93205,aññātīti,annatiti,3,0,3,0,8
93206,parassakkharassa,parassakkharassa,1,1,0,0,16
93207,saññoguccāraṇicchāya,sannoguccaranicchaya,1,1,0,0,20
93208,ñāsī,nasi,1,1,0,0,4
93209,padamālākaraṇe,padamalakarane,1,1,0,0,14
93210,jīvitindriyupacchedakaraṇaṃ,jivitindriyupacchedakaranam,1,1,0,0,27
93211,tosanaṃ,tosanam,20,16,4,0,7
93212,tikkhatā,tikkhata,12,10,2,0,8
93213,ñattīti,nattiti,10,5,5,0,7
93214,nisetīti,nisetiti,1,1,0,0,8
93215,ādatteti,adatteti,1,0,1,0,8
93216,vibhattibhūtassa,vibhattibhutassa,1,1,0,0,16
93217,vibhattibhūtassati,vibhattibhutassati,1,1,0,0,18
93218,saññogabhāvo,sannogabhavo,1,1,0,0,12
93219,dhātuantassarassa,dhatuantassarassa,1,1,0,0,17
93220,ñeti,neti,1,1,0,0,4
93221,pubbassimassa,pubbassimassa,1,1,0,0,13
93222,pavattinivāraṇena,pavattinivaranena,8,8,0,0,17
93223,anekavidhena,anekavidhena,22,22,0,0,12
93224,somanassuppādanaṃ,somanassuppadanam,1,1,0,0,17
93225,atikhiṇabuddhīnaṃ,atikhinabuddhinam,3,3,0,0,17
93226,ñāṇatikhiṇakaraṇañca,nanatikhinakarananca,2,2,0,0,20
93227,cittatosanena,cittatosanena,5,5,0,0,13
93228,cittanisānena,cittanisanena,3,3,0,0,13
93229,paññāpanaṃ,pannapanam,48,43,5,0,10
93230,ṭakārantadhātu,takarantadhatu,3,3,0,0,14
93231,ṭavaggantadhāturūpāni,tavaggantadhaturupani,1,1,0,0,21
93232,soṭu,sotu,1,0,1,0,4
93233,dabbanaṃ,dabbanam,1,1,0,0,8
93234,soṭati,sotati,1,1,0,0,6
93235,yoṭu,yotu,1,0,1,0,4
93236,yoṭati,yotati,1,1,0,0,6
93237,meṭu,metu,1,0,1,0,4
93238,mileṭu,miletu,1,0,1,0,6
93239,meṭati,metati,1,1,0,0,6
93240,mileṭati,miletati,1,1,0,0,8
93241,saṭati,satati,5,5,0,0,6
93242,laṭa,lata,1,0,1,0,4
93243,pubbāpekkhāya,pubbapekkhaya,1,1,0,0,13
93244,laṭati,latati,1,1,0,0,6
93245,lāṭo,lato,1,1,0,0,4
93246,vippharaṇaṃ,vippharanam,4,4,0,0,11
93247,gatyāvasānaṃ,gatyavasanam,2,0,2,0,12
93248,nisīdananti,nisidananti,10,10,0,0,11
93249,sāṭo,sato,1,1,0,0,4
93250,sāṭako,satako,53,51,2,0,6
93251,vāṭo,vato,1,1,0,0,4
93252,khiṭa,khita,2,1,1,0,5
93253,uttāsane,uttasane,2,1,1,0,8
93254,kheṭati,khetati,1,1,0,0,7
93255,ākheṭako,akhetako,1,1,0,0,8
93256,kheṭo,kheto,1,1,0,0,5
93257,ukkheṭito,ukkhetito,18,18,0,0,9
93258,samukkheṭito,samukkhetito,12,12,0,0,12
93259,siṭa,sita,1,0,1,0,4
93260,seṭati,setati,1,1,0,0,6
93261,jaṭati,jatati,1,1,0,0,6
93262,antojaṭā,antojata,19,17,2,0,8
93263,bahijaṭā,bahijata,12,12,0,0,8
93264,jaṭāya,jataya,20,15,5,0,6
93265,jaṭitā,jatita,19,15,4,0,6
93266,vijaṭaye,vijataye,35,29,6,0,8
93267,arahattamaggakkhaṇe,arahattamaggakkhane,28,28,0,0,19
93268,vijaṭeti,vijateti,6,5,1,0,8
93269,bhaṭa,bhata,3,1,2,0,5
93270,bhaṭako,bhatako,7,7,0,0,7
93271,ussayo,ussayo,1,0,1,0,6
93272,taṭati,tatati,1,1,0,0,6
93273,giritaṭo,giritato,1,1,0,0,8
93274,nadītaṭo,naditato,1,1,0,0,8
93275,kaṃse,kamse,13,11,2,0,5
93276,khaṭati,khatati,1,1,0,0,7
93277,khaṭo,khato,1,1,0,0,5
93278,natiyaṃ,natiyam,1,0,1,0,7
93279,naṭati,natati,1,1,0,0,6
93280,saddasaṅghāṭesu,saddasanghatesu,1,0,1,0,15
93281,peṭati,petati,1,1,0,0,6
93282,piṭakaṃ,pitakam,70,62,8,0,7
93283,piṭakasaddo,pitakasaddo,5,4,1,0,11
93284,piṭakasampadānenā,pitakasampadanena,7,6,1,0,17
93285,pariyattiyaṃ,pariyattiyam,31,29,2,0,12
93286,āgaccheyya,agaccheyya,264,258,6,0,10
93287,kudālapiṭakaṃ,kudalapitakam,13,11,2,0,13
93288,haṭati,hatati,1,1,0,0,6
93289,hāṭakaṃ,hatakam,2,2,0,0,7
93290,haṭakaṃ,hatakam,3,1,2,0,7
93291,luṭa,luta,4,1,3,0,4
93292,viloṭhane,vilothane,1,0,1,0,9
93293,loṭati,lotati,2,2,0,0,6
93294,ceṭati,cetati,2,2,0,0,6
93295,veṭati,vetati,1,1,0,0,6
93296,veṭako,vetako,1,1,0,0,6
93297,iṭa,ita,1,0,1,0,3
93298,eṭati,etati,1,1,0,0,5
93299,keṭati,ketati,1,1,0,0,6
93300,paṭoti,patoti,6,5,1,0,6
93301,vasanamaṃsukaṃ,vasanamamsukam,1,1,0,0,14
93302,dussamacchādanaṃ,dussamacchadanam,1,1,0,0,16
93303,muṭa,muta,4,1,3,0,4
93304,pamaddane,pamaddane,1,0,1,0,9
93305,moṭati,motati,1,1,0,0,6
93306,cuṭa,cuta,4,0,4,0,4
93307,coṭati,cotati,1,1,0,0,6
93308,vaṇṭo,vanto,2,2,0,0,5
93309,ruṭi,ruti,1,0,1,0,4
93310,luṭi,luti,2,0,2,0,4
93311,ruṇṭati,runtati,1,1,0,0,7
93312,luṇṭati,luntati,1,1,0,0,7
93313,ruṇṭako,runtako,1,1,0,0,7
93314,luṇṭako,luntako,1,1,0,0,7
93315,phoṭati,photati,1,1,0,0,7
93316,ceṭa,ceta,1,0,1,0,4
93317,ceṭāyaṃ,cetayam,1,0,1,0,7
93318,ghoṭati,ghotati,1,1,0,0,7
93319,ruṭa,ruta,1,0,1,0,4
93320,roṭati,rotati,1,1,0,0,6
93321,ghaṭati,ghatati,46,46,0,0,7
93322,tuṇḍikiro,tundikiro,1,1,0,0,9
93323,ukkhalī,ukkhali,2,2,0,0,7
93324,mahantabhājanaṃ,mahantabhajanam,1,1,0,0,15
93325,cāṭi,cati,11,8,3,0,4
93326,atikhuddaṃ,atikhuddam,1,1,0,0,10
93327,deṭa,deta,1,0,1,0,4
93328,deṭati,detati,1,1,0,0,6
93329,paṭikuṭati,patikutati,12,12,0,0,10
93330,puṭati,putati,1,1,0,0,6
93331,chuṭa,chuta,2,0,2,0,5
93332,cuṭati,cutati,1,1,0,0,6
93333,chuṭati,chutati,1,1,0,0,7
93334,phuṭati,phutati,2,2,0,0,7
93335,aggisaddapakkhepamaddanesu,aggisaddapakkhepamaddanesu,1,0,1,0,26
93336,muṭati,mutati,1,1,0,0,6
93337,tuṭa,tuta,1,0,1,0,4
93338,kalahakammani,kalahakammani,1,0,1,0,13
93339,tuṭati,tutati,1,1,0,0,6
93340,ghuṭati,ghutati,1,1,0,0,7
93341,ṭakārantadhāturūpāni,takarantadhaturupani,1,1,0,0,20
93342,ṭhakārantadhātu,thakarantadhatu,2,2,0,0,15
93343,gatinivatti,gatinivatti,5,4,1,0,11
93344,uppajjamānassa,uppajjamanassa,32,32,0,0,14
93345,gamanassupacchedo,gamanassupacchedo,1,1,0,0,17
93346,adhiṭṭheti,adhittheti,64,58,6,0,10
93347,saṇṭhāti,santhati,248,244,4,0,8
93348,adhiṭṭhahati,adhitthahati,3,3,0,0,12
93349,upaṭṭhahati,upatthahati,46,45,1,0,11
93350,ṭhātu,thatu,9,9,0,0,5
93351,aṭṭhu,atthu,1,1,0,0,5
93352,aṭṭhū,atthu,1,1,0,0,5
93353,yāvassa,yavassa,41,39,2,0,7
93354,ṭhassati,thassati,94,92,2,0,8
93355,tiṭṭhissati,titthissati,2,2,0,0,11
93356,upassuti,upassuti,24,15,9,0,8
93357,tiṭṭhissatha,titthissatha,2,2,0,0,12
93358,aṭṭhissā,atthissa,1,1,0,0,8
93359,aṭṭhissaṃsu,atthissamsu,1,1,0,0,11
93360,atiṭṭhissā,atitthissa,1,1,0,0,10
93361,atiṭṭhissaṃsu,atitthissamsu,1,1,0,0,13
93362,upaṭṭhātuṃ,upatthatum,71,71,0,0,10
93363,upaṭṭhahituṃ,upatthahitum,7,7,0,0,12
93364,adhiṭṭhātuṃ,adhitthatum,169,153,16,0,11
93365,adhiṭṭhahituṃ,adhitthahitum,1,1,0,0,13
93366,adhiṭṭhitvā,adhitthitva,5,4,1,0,11
93367,upaṭṭhahitvā,upatthahitva,61,61,0,0,12
93368,adhiṭṭhahitvā,adhitthahitva,272,258,14,0,13
93369,avaṭṭhiti,avatthiti,49,46,3,0,9
93370,pabbataṭṭho,pabbatattho,7,7,0,0,11
93371,bhūmaṭṭho,bhumattho,5,5,0,0,9
93372,issariyaṭhitikhaṇakāraṇesu,issariyathitikhanakaranesu,1,1,0,0,26
93373,panāyasmā,panayasma,99,99,0,0,9
93374,ṭhānakusalo,thanakusalo,6,6,0,0,11
93375,akkhaṇavedhī,akkhanavedhi,22,20,2,0,12
93376,ṭhānasopetaṃ,thanasopetam,1,1,0,0,12
93377,paṭibhātī,patibhati,16,15,1,0,9
93378,aṭṭhānañca,atthananca,50,48,2,0,10
93379,aṭṭhānaso,atthanaso,3,3,0,0,9
93380,tadāyattavuttibhāvena,tadayattavuttibhavena,4,4,0,0,21
93381,ṭhitiyañca,thitiyanca,3,3,0,0,10
93382,khaṇasmimpi,khanasmimpi,1,1,0,0,11
93383,saddasaṅkātesu,saddasankatesu,1,0,1,0,14
93384,ṭhāyati,thayati,2,2,0,0,7
93385,nakkhattapāṭhako,nakkhattapathako,9,8,1,0,16
93386,horapāṭhakaṃ,horapathakam,1,1,0,0,12
93387,sabbapāṭhī,sabbapathi,9,7,2,0,10
93388,paṭhituṃ,pathitum,1,1,0,0,8
93389,paṭhitave,pathitave,1,1,0,0,9
93390,paṭhitvāna,pathitvana,1,1,0,0,10
93391,paṭhituna,pathituna,1,1,0,0,9
93392,paṭhiya,pathiya,1,1,0,0,7
93393,paṭhiyāna,pathiyana,1,1,0,0,9
93394,paccayantādivibhāgaṃ,paccayantadivibhagam,1,1,0,0,20
93395,vattukāmāpi,vattukamapi,4,4,0,0,11
93396,vitthārabhayena,vittharabhayena,1,1,0,0,15
93397,pāḷinidassanādiviseso,palinidassanadiviseso,1,1,0,0,21
93398,tatthevetaṃ,tatthevetam,2,2,0,0,11
93399,vaṭha,vatha,2,1,1,0,5
93400,thūliye,thuliye,2,0,2,0,7
93401,vaṭhati,vathati,2,2,0,0,7
93402,vaṭharoti,vatharoti,5,1,4,0,9
93403,thūlaghanasarīrasmiṃ,thulaghanasarirasmim,1,1,0,0,20
93404,vinayaṭṭhakathāyaṃ,vinayatthakathayam,42,23,19,0,18
93405,ghanasarīro,ghanasariro,3,3,0,0,11
93406,maṭha,matha,2,0,2,0,5
93407,maṭhati,mathati,2,2,0,0,7
93408,maṭho,matho,1,1,0,0,5
93409,raṭhati,rathati,1,1,0,0,7
93410,yathājjhāsayaṃ,yathajjhasayam,29,27,2,0,14
93411,dabbalassa,dabbalassa,1,1,0,0,10
93412,sāṭhati,sathati,1,1,0,0,7
93413,sāṭho,satho,1,1,0,0,5
93414,uṭha,utha,1,0,1,0,4
93415,ruṭha,rutha,1,0,1,0,5
93416,luṭha,lutha,3,0,3,0,5
93417,oṭhati,othati,1,1,0,0,6
93418,roṭhati,rothati,1,1,0,0,7
93419,loṭhati,lothati,3,3,0,0,7
93420,peṭhati,pethati,1,1,0,0,7
93421,pubbatthesu,pubbatthesu,1,1,0,0,11
93422,saṭhoti,sathoti,13,1,12,0,7
93423,kerāṭiko,keratiko,17,16,1,0,8
93424,suṭha,sutha,2,0,2,0,5
93425,gamanapaṭihananaṃ,gamanapatihananam,1,1,0,0,17
93426,gatipaṭighāto,gatipatighato,1,0,1,0,13
93427,soṭhati,sothati,1,1,0,0,7
93428,luṭhi,luthi,2,0,2,0,5
93429,ālassiye,alassiye,1,0,1,0,8
93430,pubbatthe,pubbatthe,1,1,0,0,9
93431,luṇṭhati,lunthati,2,2,0,0,8
93432,luṇṭho,luntho,1,1,0,0,6
93433,suṇṭhati,sunthati,1,1,0,0,8
93434,ruṭhi,ruthi,1,0,1,0,5
93435,aṭhi,athi,1,0,1,0,4
93436,ruṇṭhati,runthati,1,1,0,0,8
93437,aṇṭhati,anthati,1,1,0,0,7
93438,nibbeṭhati,nibbethati,1,1,0,0,10
93439,nibbeṭhanaṃ,nibbethanam,9,8,1,0,11
93440,vaṭhi,vathi,1,0,1,0,5
93441,ekacariyāyaṃ,ekacariyayam,1,0,1,0,12
93442,vaṇṭhati,vanthati,1,1,0,0,8
93443,eṭha,etha,1,0,1,0,4
93444,heṭha,hetha,3,2,1,0,5
93445,eṭhati,ethati,1,1,0,0,6
93446,heṭhati,hethati,1,1,0,0,7
93447,viheṭhati,vihethati,1,1,0,0,9
93448,viheṭhanaṃ,vihethanam,9,9,0,0,10
93449,vikhyāne,vikhyane,1,0,1,0,8
93450,ḍakārantadhātu,dakarantadhatu,3,3,0,0,14
93451,ḍi,di,2,0,2,0,2
93452,vihāyasagatiyaṃ,vihayasagatiyam,1,0,1,0,15
93453,gamanamatte,gamanamatte,1,0,1,0,11
93454,ḍayati,dayati,1,1,0,0,6
93455,ḍemāno,demano,3,3,0,0,6
93456,ḍemāna,demana,4,4,0,0,6
93457,paccuḍḍenti,paccuddenti,1,1,0,0,11
93458,khipanuḍḍanesu,khipanuddanesu,1,0,1,0,14
93459,uḍḍeti,uddeti,3,3,0,0,6
93460,pāsaṇḍā,pasanda,20,16,4,0,7
93461,rocemi,rocemi,7,7,0,0,6
93462,kovidā,kovida,61,60,1,0,6
93463,ḍentīti,dentiti,3,2,1,0,7
93464,diṭṭhipāsaṃ,ditthipasam,4,3,1,0,11
93465,khipantīti,khipantiti,15,10,5,0,10
93466,uḍḍentīti,uddentiti,1,1,0,0,9
93467,muḍi,mudi,2,1,1,0,4
93468,kaṇḍane,kandane,1,0,1,0,7
93469,muṇḍati,mundati,1,1,0,0,7
93470,muṇḍiṃsu,mundimsu,1,1,0,0,8
93471,cuḍḍa,cudda,1,0,1,0,5
93472,cuḍḍati,cuddati,1,1,0,0,7
93473,aḍḍati,addati,1,1,0,0,6
93474,huḍi,hudi,1,0,1,0,4
93475,huṇḍati,hundati,1,1,0,0,7
93476,piṇḍati,pindati,1,1,0,0,7
93477,hiḍi,hidi,2,1,1,0,4
93478,hiṇḍati,hindati,1,1,0,0,7
93479,āhiṇḍati,ahindati,22,22,0,0,8
93480,vaṇḍati,vandati,1,1,0,0,7
93481,maṇḍati,mandati,4,4,0,0,7
93482,bhaṇḍati,bhandati,1,1,0,0,8
93483,bhaṇḍo,bhando,6,6,0,0,6
93484,toḷane,tolane,2,0,2,0,6
93485,tuṇḍati,tundati,1,1,0,0,7
93486,tuṇḍo,tundo,1,1,0,0,5
93487,tuṇḍenādāya,tundenadaya,9,9,0,0,11
93488,bhuḍi,bhudi,1,0,1,0,5
93489,bhuṇḍati,bhundati,1,1,0,0,8
93490,caṇḍikkaṃ,candikkam,39,35,4,0,9
93491,saṇḍati,sandati,1,1,0,0,7
93492,paṇḍāti,pandati,3,2,1,0,7
93493,sukhumesupi,sukhumesupi,2,2,0,0,11
93494,pīḷanādikampi,pilanadikampi,1,1,0,0,13
93495,paṇḍāya,pandaya,1,1,0,0,7
93496,ñāṇagatiyā,nanagatiya,33,31,2,0,10
93497,paṇḍantīti,pandantiti,3,3,0,0,10
93498,sandiṭṭhikasamparāyikatthesu,sanditthikasamparayikatthesu,1,1,0,0,28
93499,khaṇḍito,khandito,4,4,0,0,8
93500,jivhāmathane,jivhamathane,1,0,1,0,12
93501,laṇḍati,landati,1,1,0,0,7
93502,ḍakārantadhāturūpāni,dakarantadhaturupani,2,2,0,0,20
93503,sirivaḍḍhako,sirivaddhako,9,9,0,0,12
93504,dhanavaḍḍhako,dhanavaddhako,7,7,0,0,13
93505,kaḍḍha,kaddha,2,1,1,0,6
93506,ākaḍḍhane,akaddhane,5,4,1,0,9
93507,kaḍḍhati,kaddhati,15,14,1,0,8
93508,nikaḍḍhati,nikaddhati,1,1,0,0,10
93509,akāmā,akama,85,75,10,0,5
93510,parikaḍḍhanti,parikaddhanti,5,5,0,0,13
93511,ulūkaññeva,ulukanneva,4,3,1,0,10
93512,vāyasā,vayasa,11,11,0,0,6
93513,ṇakārantadhātu,nakarantadhatu,2,2,0,0,14
93514,maṇa,mana,2,0,2,0,4
93515,aṇako,anako,1,1,0,0,5
93516,raṇati,ranati,2,2,0,0,6
93517,vaṇati,vanati,2,2,0,0,6
93518,vāṇako,vanako,1,1,0,0,6
93519,bhaṇati,bhanati,697,685,12,0,7
93520,bhāṇako,bhanako,9,8,1,0,7
93521,maṇiko,maniko,3,3,0,0,6
93522,brāhmaṇoti,brahmanoti,101,52,49,0,10
93523,aṇatīti,anatiti,8,6,2,0,7
93524,sajjhāyatīti,sajjhayatiti,11,8,3,0,12
93525,bāhitapāpattā,bahitapapatta,34,33,1,0,13
93526,bhovādī,bhovadi,11,9,2,0,7
93527,brahmasūnu,brahmasunu,1,1,0,0,10
93528,kamalāsanasūnu,kamalasanasunu,1,1,0,0,14
93529,atthavivaraṇampi,atthavivaranampi,1,1,0,0,16
93530,saddasaṅkhātamatthaṃ,saddasankhatamattham,1,1,0,0,20
93531,antoyeva,antoyeva,82,78,4,0,8
93532,adhippāyatthavasena,adhippayatthavasena,5,5,0,0,19
93533,dhātunānatthavasenāti,dhatunanatthavasenati,1,1,0,0,21
93534,dhātūnamatthātisayayogopi,dhatunamatthatisayayogopi,1,1,0,0,25
93535,atthavivaraṇaṃ,atthavivaranam,17,17,0,0,14
93536,katantipi,katantipi,3,3,0,0,9
93537,dīghabhāṇako,dighabhanako,4,4,0,0,12
93538,bhāṇavāro,bhanavaro,13,11,2,0,9
93539,bhāṇavāroti,bhanavaroti,3,1,2,0,11
93540,aṭṭhakkharā,atthakkhara,3,3,0,0,11
93541,ekapadaṃ,ekapadam,23,17,6,0,8
93542,cekāmato,cekamato,1,1,0,0,8
93543,bāttiṃsatakkharo,battimsatakkharo,3,3,0,0,16
93544,bāttiṃsakkharaganthānaṃ,battimsakkharaganthanam,2,2,0,0,23
93545,svaṭṭhakkharasahassako,svatthakkharasahassako,2,2,0,0,22
93546,aṭṭhakkharasahassaparimāṇo,atthakkharasahassaparimano,2,2,0,0,26
93547,oṇaṃ,onam,1,0,1,0,4
93548,oṇati,onati,1,1,0,0,5
93549,soṇati,sonati,2,2,0,0,6
93550,siloṇa,silona,1,0,1,0,6
93551,siloṇati,silonati,1,1,0,0,8
93552,ghiṇi,ghini,1,0,1,0,5
93553,ghuṇi,ghuni,1,0,1,0,5
93554,ghaṇi,ghani,2,1,1,0,5
93555,ghiṇṇati,ghinnati,1,1,0,0,8
93556,ghuṇṇati,ghunnati,2,2,0,0,8
93557,ghaṇṇati,ghannati,1,1,0,0,8
93558,ghuṇa,ghuna,1,0,1,0,5
93559,ghuṇṇa,ghunna,1,0,1,0,6
93560,ghoṇati,ghonati,1,1,0,0,7
93561,thutiyañca,thutiyanca,2,0,2,0,10
93562,vāṇijo,vanijo,90,89,1,0,6
93563,thomayati,thomayati,3,3,0,0,9
93564,sāpaṇo,sapano,5,5,0,0,6
93565,gaṇati,ganati,1,1,0,0,6
93566,caṇati,canati,1,1,0,0,6
93567,saṇati,sanati,8,7,1,0,6
93568,phaṇati,phanati,1,1,0,0,7
93569,phaṇaṃ,phanam,65,62,3,0,6
93570,ñāṇacintānisāmanesu,nanacintanisamanesu,1,0,1,0,19
93571,veṇati,venati,1,1,0,0,6
93572,pīṇo,pino,1,1,0,0,4
93573,miṇa,mina,1,0,1,0,4
93574,miṇati,minati,1,1,0,0,6
93575,duṇati,dunati,1,1,0,0,6
93576,brahmāraññaṃ,brahmarannam,1,1,0,0,12
93577,saṇatevāti,sanatevati,4,0,4,0,10
93578,tuṇa,tuna,1,0,1,0,4
93579,toṇati,tonati,1,1,0,0,6
93580,nipuṇe,nipune,37,32,5,0,6
93581,nipuṇati,nipunati,1,1,0,0,8
93582,nipuṇadhammo,nipunadhammo,1,1,0,0,12
93583,nipuṇasaṇhasukhumasaddā,nipunasanhasukhumasadda,1,0,1,0,23
93584,vevacanasaddā,vevacanasadda,3,3,0,0,13
93585,kusalachekadakkha,kusalachekadakkha,1,0,1,0,17
93586,muṇa,muna,1,0,1,0,4
93587,muṇati,munati,1,1,0,0,6
93588,saddopakaraṇe,saddopakarane,1,0,1,0,13
93589,koṇati,konati,1,1,0,0,6
93590,cuṇa,cuna,2,0,2,0,4
93591,coṇati,conati,1,1,0,0,6
93592,maṇatīti,manatiti,5,3,2,0,8
93593,phuṇa,phuna,1,0,1,0,5
93594,phuṇati,phunati,1,1,0,0,7
93595,aṅgārakāsuṃ,angarakasum,40,36,4,0,11
93596,phuṇanti,phunanti,11,11,0,0,8
93597,takārantadhātu,takarantadhatu,2,2,0,0,14
93598,vidhami,vidhami,2,2,0,0,7
93599,ādipurisasammuditaṃ,adipurisasammuditam,1,1,0,0,19
93600,assayujādivasena,assayujadivasena,1,1,0,0,16
93601,sattavīsatividhaṃ,sattavisatividham,3,3,0,0,17
93602,rohaṇī,rohani,3,3,0,0,6
93603,migasiro,migasiro,3,3,0,0,8
93604,assaliso,assaliso,1,1,0,0,8
93605,pubbaphagguṇī,pubbaphagguni,1,1,0,0,13
93606,uttaraphagguṇī,uttaraphagguni,1,1,0,0,14
93607,pubbāsaḷhaṃ,pubbasalham,1,1,0,0,11
93608,uttarāsaḷhaṃ,uttarasalham,1,1,0,0,12
93609,sāvaṇaṃ,savanam,1,1,0,0,7
93610,dhanasiṭṭhā,dhanasittha,1,1,0,0,11
93611,satabhisattaṃ,satabhisattam,1,1,0,0,13
93612,pubbabhaddapadaṃ,pubbabhaddapadam,1,1,0,0,16
93613,uttarabhaddapadaṃ,uttarabhaddapadam,1,1,0,0,17
93614,dandhaṃ,dandham,84,75,9,0,7
93615,yantacakke,yantacakke,1,1,0,0,10
93616,samappamāṇagatiyā,samappamanagatiya,1,1,0,0,17
93617,maṇḍalākārena,mandalakarena,12,12,0,0,13
93618,tāyanti,tayanti,13,13,0,0,7
93619,nakkhattānīti,nakkhattaniti,3,1,2,0,13
93620,āvocuṃ,avocum,1,1,0,0,6
93621,rikkhaṃ,rikkham,1,1,0,0,7
93622,nakkhattatārakānaṃ,nakkhattatarakanam,1,1,0,0,18
93623,sabbāsampi,sabbasampi,19,19,0,0,10
93624,sādhāraṇanāmāni,sadharananamani,1,1,0,0,15
93625,osadhīti,osadhiti,4,2,2,0,8
93626,tārakāvisesassa,tarakavisesassa,1,1,0,0,15
93627,saññāṇe,sannane,6,5,1,0,7
93628,lakkhaṇakaraṇaṃ,lakkhanakaranam,1,1,0,0,15
93629,cetati,cetati,2,2,0,0,6
93630,īkārantavasena,ikarantavasena,2,2,0,0,14
93631,papatati,papatati,15,15,0,0,8
93632,papātaṃ,papatam,17,15,2,0,7
93633,papateyyahaṃ,papateyyaham,4,3,1,0,12
93634,pāpattaṃ,papattam,3,3,0,0,8
93635,papatitosmīti,papatitosmiti,1,1,0,0,13
93636,pāpattha,papattha,6,6,0,0,8
93637,sokumāroti,sokumaroti,1,1,0,0,10
93638,papatitoti,papatitoti,2,1,1,0,10
93639,parokkhāpadañhietaṃ,parokkhapadanhietam,1,1,0,0,19
93640,pāvadaṃ,pavadam,2,2,0,0,7
93641,pāvadā,pavada,1,1,0,0,6
93642,upasaggapadassa,upasaggapadassa,1,1,0,0,15
93643,dīghabhāvo,dighabhavo,11,9,2,0,10
93644,acinteyyo,acinteyyo,52,49,3,0,9
93645,pāḷinayo,palinayo,23,22,1,0,8
93646,sātaccagamanaṃ,sataccagamanam,1,0,1,0,14
93647,nirantaragamanaṃ,nirantaragamanam,1,1,0,0,16
93648,sātaccagamanatthavācikā,sataccagamanatthavacika,1,1,0,0,23
93649,jātijarābyādhimaraṇādibhedaṃ,jatijarabyadhimaranadibhedam,1,1,0,0,28
93650,adhigacchatīti,adhigacchatiti,24,20,4,0,14
93651,attātipi,attatipi,2,2,0,0,8
93652,atthantaravasena,atthantaravasena,3,3,0,0,16
93653,ahaṃmāno,ahammano,15,15,0,0,8
93654,attamanoti,attamanoti,22,8,14,0,10
93655,pītisomanassena,pitisomanassena,11,11,0,0,15
93656,gahitamano,gahitamano,8,7,1,0,10
93657,gahetabbatoti,gahetabbatoti,1,1,0,0,13
93658,cuta,cuta,3,2,1,0,4
93659,kharaṇe,kharane,1,0,1,0,7
93660,cotati,cotati,1,1,0,0,6
93661,antati,antati,2,2,0,0,6
93662,antiyatibandhiyati,antiyatibandhiyati,1,1,0,0,18
93663,antaguṇenāti,antagunenati,1,1,0,0,12
93664,udariyaṃ,udariyam,59,52,7,0,8
93665,dvattiṃsākārantogadhaṃ,dvattimsakarantogadham,1,1,0,0,22
93666,kuṇapantaṃ,kunapantam,2,2,0,0,10
93667,kāyabandhanassa,kayabandhanassa,29,29,0,0,15
93668,haritantaṃ,haritantam,14,11,3,0,10
93669,antimamariyādanto,antimamariyadanto,1,1,0,0,17
93670,antamidaṃ,antamidam,20,17,3,0,9
93671,jīvikānaṃ,jivikanam,20,19,1,0,9
93672,lāmakanto,lamakanto,5,4,1,0,9
93673,sakkāyo,sakkayo,81,64,17,0,7
93674,koṭṭhāsanto,kotthasanto,1,1,0,0,11
93675,esevanto,esevanto,70,60,10,0,8
93676,sappaccayasaṅkhayā,sappaccayasankhaya,1,1,0,0,18
93677,koṭanto,kotanto,1,1,0,0,7
93678,antimañca,antimanca,1,1,0,0,9
93679,antasaddena,antasaddena,5,5,0,0,11
93680,āmodamāno,amodamano,6,5,1,0,9
93681,sanniketaṃ,sanniketam,7,6,1,0,10
93682,cikicchako,cikicchako,1,1,0,0,10
93683,gahitavasanaṭṭhānattā,gahitavasanatthanatta,1,1,0,0,21
93684,patiyatanaṃ,patiyatanam,2,1,1,0,11
93685,vāyāmakaraṇaṃ,vayamakaranam,4,4,0,0,13
93686,payatanaṃ,payatanam,8,6,2,0,9
93687,āyatanato,ayatanato,19,19,0,0,9
93688,cakkhurūpādīni,cakkhurupadini,6,6,0,0,14
93689,taṃdvārārammaṇacittacetasikā,tamdvararammanacittacetasika,1,1,0,0,28
93690,anubhavanādikiccena,anubhavanadikiccena,3,3,0,0,19
93691,etesūti,etesuti,71,39,32,0,7
93692,āyatanānī,ayatanani,47,46,1,0,9
93693,nītanu,nitanu,1,0,1,0,6
93694,vasenapi,vasenapi,26,26,0,0,8
93695,āyatanasaddattho,ayatanasaddattho,5,3,2,0,16
93696,āyatana,ayatana,11,4,7,0,7
93697,nivāsaṭṭhāne,nivasatthane,25,25,0,0,12
93698,ākare,akare,3,3,0,0,5
93699,samosaraṇaṭṭhāne,samosaranatthane,12,12,0,0,16
93700,sañjātidese,sanjatidese,3,3,0,0,11
93701,issarāyatanaṃ,issarayatanam,11,11,0,0,13
93702,vāsudevāyatanaṃ,vasudevayatanam,11,11,0,0,15
93703,suvaṇṇāyatanaṃ,suvannayatanam,13,13,0,0,14
93704,rajatāyatanaṃ,rajatayatanam,11,11,0,0,13
93705,vihaṅgamā,vihangama,46,43,3,0,9
93706,sakkhibhabbataṃ,sakkhibhabbatam,68,63,5,0,15
93707,satiāyatane,satiayatane,32,32,0,0,11
93708,nānāpavattinimittavasena,nanapavattinimittavasena,1,1,0,0,24
93709,jātidese,jatidese,1,1,0,0,8
93710,nucchiṭṭhaṃ,nucchittham,1,1,0,0,11
93711,kāraṇenā,karanena,82,49,33,0,8
93712,evamādiniratthakakāraṇapaṭisaṃyuttaṃ,evamadiniratthakakaranapatisamyuttam,4,4,0,0,36
93713,titthiyasatthaṃ,titthiyasattham,7,6,1,0,15
93714,vitaṇḍasatthaṃ,vitandasattham,6,6,0,0,14
93715,asamadhuro,asamadhuro,7,7,0,0,10
93716,seve,seve,36,30,6,0,4
93717,lokāyatikaṃ,lokayatikam,7,6,1,0,11
93718,lokāyatasippaṃ,lokayatasippam,4,2,2,0,14
93719,setattā,setatta,13,13,0,0,7
93720,rattattā,rattatta,10,10,0,0,8
93721,evamādinayappavattaṃ,evamadinayappavattam,5,5,0,0,20
93722,paralokanibbānānaṃ,paralokanibbananam,2,2,0,0,18
93723,paṭisedhakaṃ,patisedhakam,3,3,0,0,12
93724,vitaṇḍasatthasippaṃ,vitandasatthasippam,2,2,0,0,19
93725,yuta,yuta,1,0,1,0,4
93726,yotati,yotati,1,1,0,0,6
93727,vijjotati,vijjotati,11,11,0,0,9
93728,jotīti,jotiti,7,3,4,0,6
93729,candādīni,candadini,1,1,0,0,9
93730,sirimāvimāna,sirimavimana,1,0,1,0,12
93731,vatthuaṭṭhakathāyaṃ,vatthuatthakathayam,1,0,1,0,19
93732,candimasūriyanakkhattatārakānaṃ,candimasuriyanakkhattatarakanam,1,1,0,0,31
93733,sādhāraṇanāmaṃ,sadharananamam,4,4,0,0,14
93734,jotiparāyaṇo,jotiparayano,15,11,4,0,12
93735,khattiyakulādīsu,khattiyakuladisu,9,9,0,0,16
93736,rūpasobhāyuttattā,rupasobhayuttatta,1,1,0,0,17
93737,jotī,joti,2,2,0,0,4
93738,setavaṇṇe,setavanne,1,1,0,0,9
93739,vaṇṇasāmaññaṃ,vannasamannam,3,3,0,0,13
93740,nīlapītādīsu,nilapitadisu,2,2,0,0,12
93741,setavaṇṇoyeva,setavannoyeva,1,1,0,0,13
93742,payogadassanavasena,payogadassanavasena,1,1,0,0,19
93743,setati,setati,1,1,0,0,6
93744,dhavalampi,dhavalampi,1,0,1,0,10
93745,akaṇhaṃ,akanham,42,35,7,0,7
93746,goramodātaṃ,goramodatam,1,0,1,0,11
93747,setanāmāni,setanamani,1,0,1,0,10
93748,parivattati,parivattati,148,144,4,0,11
93749,kilota,kilota,1,0,1,0,6
93750,addabhāvo,addabhavo,2,0,2,0,9
93751,tintabhāvo,tintabhavo,2,2,0,0,10
93752,kilotati,kilotati,1,1,0,0,8
93753,pakilotati,pakilotati,1,1,0,0,10
93754,pakiloteti,pakiloteti,1,1,0,0,10
93755,pakilotayati,pakilotayati,1,1,0,0,12
93756,uṇhodakasmiṃ,unhodakasmim,4,3,1,0,12
93757,pakilotayitvā,pakilotayitva,1,1,0,0,13
93758,temetvāti,temetvati,4,1,3,0,9
93759,vatati,vatati,1,1,0,0,6
93760,ketako,ketako,2,2,0,0,6
93761,saṅketo,sanketo,24,21,3,0,7
93762,suttajanane,suttajanane,1,0,1,0,11
93763,vikantati,vikantati,4,4,0,0,9
93764,sallakanto,sallakanto,2,2,0,0,10
93765,catī,cati,1,0,1,0,4
93766,hiṃsāgandhesu,himsagandhesu,1,0,1,0,13
93767,īkārantattā,ikarantatta,2,2,0,0,11
93768,catati,catati,1,1,0,0,6
93769,thakārantadhātu,thakarantadhatu,2,2,0,0,15
93770,thāti,thati,1,1,0,0,5
93771,vanathañcā,vanathanca,3,2,1,0,10
93772,abhitthavati,abhitthavati,3,3,0,0,12
93773,thavanā,thavana,3,3,0,0,7
93774,abhitthavanā,abhitthavana,2,2,0,0,12
93775,abhitthuti,abhitthuti,3,3,0,0,10
93776,rūpinī,rupini,6,6,0,0,6
93777,sameyya,sameyya,9,8,1,0,7
93778,anomadassissa,anomadassissa,58,52,6,0,13
93779,phalametaṃ,phalametam,5,5,0,0,10
93780,ñāṇathavanāya,nanathavanaya,3,3,0,0,13
93781,thutippasattho,thutippasattho,1,1,0,0,14
93782,yenidaṃ,yenidam,13,13,0,0,7
93783,thavitaṃ,thavitam,4,4,0,0,8
93784,buddhaseṭṭho,buddhasettho,24,21,3,0,12
93785,thavanāti,thavanati,1,0,1,0,9
93786,pasaṃsanā,pasamsana,4,4,0,0,9
93787,pasaṃsāya,pasamsaya,72,72,0,0,9
93788,panuti,panuti,1,1,0,0,6
93789,thīyati,thiyati,9,9,0,0,7
93790,patitthīyati,patitthiyati,27,27,0,0,12
93791,pātukaroti,patukaroti,82,81,1,0,10
93792,paribhāsiṃsūti,paribhasimsuti,2,1,1,0,14
93793,patitthīyatī,patitthiyati,3,3,0,0,12
93794,ssīyā,ssiya,2,0,2,0,5
93795,sudukkarovāde,sudukkarovade,1,1,0,0,13
93796,padasambhavo,padasambhavo,13,13,0,0,12
93797,nicchayaṃ,nicchayam,25,25,0,0,9
93798,labbhamānatthaṃ,labbhamanattham,1,1,0,0,15
93799,ropiya,ropiya,1,1,0,0,6
93800,appānaṃ,appanam,2,2,0,0,7
93801,bahutā,bahuta,10,10,0,0,6
93802,ñāye,naye,17,15,2,0,4
93803,tiidaṃ,tiidam,17,17,0,0,6
93804,vaṇṇāgamādito,vannagamadito,1,1,0,0,13
93805,niruttilakkhaṇenāpi,niruttilakkhanenapi,1,1,0,0,19
93806,icchāpetīti,icchapetiti,3,2,1,0,11
93807,nibbacanañcāpi,nibbacanancapi,1,1,0,0,14
93808,nibbacanatthinā,nibbacanatthina,1,1,0,0,15
93809,itthīnamabhidhānāni,itthinamabhidhanani,1,1,0,0,19
93810,sīmaninī,simanini,1,1,0,0,8
93811,dayitā,dayita,17,17,0,0,6
93812,lalanā,lalana,4,4,0,0,6
93813,ṅganā,ngana,2,2,0,0,5
93814,avatthāto,avatthato,1,1,0,0,9
93815,mahallikā,mahallika,47,46,1,0,9
93816,aṭṭhavassikā,atthavassika,2,2,0,0,12
93817,yobbanitthī,yobbanitthi,2,2,0,0,11
93818,dvādasavassikā,dvadasavassika,4,4,0,0,14
93819,purisesupi,purisesupi,2,2,0,0,10
93820,aniyamavasenapi,aniyamavasenapi,1,1,0,0,15
93821,kumāramādāya,kumaramadaya,9,9,0,0,12
93822,rājaputtī,rajaputti,68,68,0,0,9
93823,dārikaṃ,darikam,104,104,0,0,7
93824,nigaḷamaṇḍite,nigalamandite,1,1,0,0,13
93825,sadena,sadena,2,2,0,0,6
93826,rājakaññā,rajakanna,33,33,0,0,9
93827,maddimpi,maddimpi,4,4,0,0,8
93828,nhāpesuṃ,nhapesum,12,11,1,0,8
93829,kaññāyeva,kannayeva,1,1,0,0,9
93830,nāmātipi,namatipi,10,10,0,0,8
93831,gorītipi,goritipi,1,1,0,0,8
93832,dārikātipi,darikatipi,1,1,0,0,10
93833,yadāhaṃ,yadaham,46,45,1,0,7
93834,dārako,darako,246,241,5,0,6
93835,aṭṭhavassiko,atthavassiko,13,13,0,0,12
93836,aṭṭhavasso,atthavasso,3,3,0,0,10
93837,tatthaddasakumāraṃ,tatthaddasakumaram,1,1,0,0,18
93838,ramamānaṃ,ramamanam,8,7,1,0,9
93839,saṃvaddho,samvaddho,3,3,0,0,9
93840,vessantaramahārājā,vessantaramaharaja,7,6,1,0,18
93841,yujjissati,yujjissati,7,7,0,0,10
93842,dvādasavassātikkantattā,dvadasavassatikkantatta,1,1,0,0,23
93843,icchāvasena,icchavasena,31,31,0,0,11
93844,dhammissarattā,dhammissaratta,5,5,0,0,14
93845,vohārakusalatāya,voharakusalataya,5,5,0,0,16
93846,veneyyajanānurūpaṃ,veneyyajananurupam,1,1,0,0,18
93847,desetuṃ,desetum,218,212,6,0,7
93848,atthitaṃ,atthitam,47,41,6,0,8
93849,kumāraparihārena,kumarapariharena,13,13,0,0,16
93850,vaddhitattañca,vaddhitattanca,1,1,0,0,14
93851,kumārakassapo,kumarakassapo,81,77,4,0,13
93852,vaddhitattā,vaddhitatta,1,1,0,0,11
93853,mahallakopi,mahallakopi,13,13,0,0,11
93854,kumārakassapotveva,kumarakassapotveva,1,1,0,0,18
93855,kumārako,kumarako,74,65,9,0,8
93856,mattamaññāsī,mattamannasi,21,19,2,0,12
93857,palitesu,palitesu,8,8,0,0,8
93858,jātesupi,jatesupi,5,5,0,0,8
93859,mahākassapo,mahakassapo,230,218,12,0,11
93860,adhimattavissāso,adhimattavissaso,1,1,0,0,16
93861,komāravādena,komaravadena,1,1,0,0,12
93862,ovadanto,ovadanto,119,119,0,0,8
93863,kumārakoti,kumarakoti,10,7,3,0,10
93864,avocāti,avocati,78,63,15,0,7
93865,udānaṭṭhakathāyaṃ,udanatthakathayam,14,4,10,0,17
93866,jātadivasato,jatadivasato,20,20,0,0,12
93867,pañcadasavassaṃ,pancadasavassam,1,1,0,0,15
93868,bālāti,balati,26,9,17,0,6
93869,vīsativassāni,visativassani,23,23,0,0,13
93870,mattha,mattha,2,1,1,0,6
93871,manthañca,manthanca,18,17,1,0,9
93872,madhupiṇḍikañca,madhupindikanca,14,13,1,0,15
93873,abhimatthati,abhimatthati,7,4,3,0,12
93874,dummedhaṃ,dummedham,22,19,3,0,9
93875,vajiraṃvamhamayaṃ,vajiramvamhamayam,1,1,0,0,17
93876,kuthi,kuthi,1,0,1,0,5
93877,puthi,puthi,1,0,1,0,5
93878,luthi,luthi,1,0,1,0,5
93879,kunthati,kunthati,1,1,0,0,8
93880,puttakaṃ,puttakam,54,54,0,0,8
93881,paṃsukunthitaṃ,pamsukunthitam,13,13,0,0,14
93882,punthati,punthati,1,1,0,0,8
93883,lunthati,lunthati,1,1,0,0,8
93884,yācanopatāpissariyāsīsāsu,yacanopatapissariyasisasu,2,0,2,0,25
93885,kilesabyasanaṃ,kilesabyasanam,3,3,0,0,14
93886,paccavekkheyyā,paccavekkheyya,3,3,0,0,14
93887,paramissaro,paramissaro,7,7,0,0,11
93888,nādha,nadha,3,0,3,0,5
93889,dhātudvayaṃ,dhatudvayam,7,6,1,0,11
93890,attanobhāsattā,attanobhasatta,1,0,1,0,14
93891,nāthate,nathate,1,1,0,0,7
93892,nādhate,nadhate,1,1,0,0,7
93893,yācanatthena,yacanatthena,1,1,0,0,12
93894,ayācako,ayacako,2,2,0,0,7
93895,anātho,anatho,37,37,0,0,6
93896,yācanatthādīsu,yacanatthadisu,1,1,0,0,14
93897,uttamapurisesu,uttamapurisesu,1,1,0,0,14
93898,uttamesu,uttamesu,5,5,0,0,8
93899,anātha,anatha,4,3,1,0,6
93900,ittarajanesu,ittarajanesu,1,1,0,0,12
93901,dabbapaṭisedhavasena,dabbapatisedhavasena,1,1,0,0,20
93902,dhātuatthapaṭisedhavasena,dhatuatthapatisedhavasena,1,1,0,0,25
93903,anāthoti,anathoti,5,4,1,0,8
93904,panatthassa,panatthassa,31,31,0,0,11
93905,evāhaṃ,evaham,162,154,8,0,6
93906,nekakoṭisataṃ,nekakotisatam,6,6,0,0,13
93907,nāthānāthānaṃ,nathanathanam,8,7,1,0,13
93908,himavantamupāgamiṃ,himavantamupagamim,9,9,0,0,18
93909,nidassanāni,nidassanani,6,6,0,0,11
93910,asamiddho,asamiddho,1,1,0,0,9
93911,paññavatā,pannavata,48,47,1,0,9
93912,dhātuatthamattena,dhatuatthamattena,1,1,0,0,17
93913,lokasamaññaṃ,lokasamannam,13,12,1,0,12
93914,anatidhāvitvā,anatidhavitva,1,1,0,0,13
93915,vithu,vithu,1,0,1,0,5
93916,vethati,vethati,1,1,0,0,7
93917,seṭhille,sethille,2,0,2,0,8
93918,sathati,sathati,1,1,0,0,7
93919,sathalo,sathalo,1,1,0,0,7
93920,paribbājo,paribbajo,8,8,0,0,9
93921,ākirate,akirate,12,9,3,0,7
93922,siṭhilotipi,sithilotipi,1,1,0,0,11
93923,kanthati,kanthati,1,1,0,0,8
93924,katthati,katthati,11,11,0,0,8
93925,vikatthati,vikatthati,10,10,0,0,10
93926,katthatīti,katthatiti,2,0,2,0,10
93927,vikatthatīti,vikatthatiti,2,0,2,0,12
93928,abhūtavatthudīpanato,abhutavatthudipanato,1,1,0,0,20
93929,bahumpi,bahumpi,173,168,5,0,7
93930,vikattheyya,vikattheyya,7,6,1,0,11
93931,katthī,katthi,11,8,3,0,6
93932,vikatthī,vikatthi,8,8,0,0,8
93933,ahamasmi,ahamasmi,95,95,0,0,8
93934,sīlasampannoti,silasampannoti,28,12,16,0,14
93935,vattasampannoti,vattasampannoti,4,2,2,0,15
93936,vikatthatī,vikatthati,1,1,0,0,10
93937,byatha,byatha,2,1,1,0,6
93938,dukkhabhayacalanesu,dukkhabhayacalanesu,1,0,1,0,19
93939,byathati,byathati,7,7,0,0,8
93940,byathitamānasā,byathitamanasa,3,3,0,0,14
93941,kumārābyathitā,kumarabyathita,1,1,0,0,14
93942,luddassa,luddassa,40,40,0,0,8
93943,itthetaṃ,itthetam,19,14,5,0,8
93944,calañceva,calanceva,5,4,1,0,9
93945,byathañca,byathanca,4,4,0,0,9
93946,sutha,sutha,1,0,1,0,5
93947,sothati,sothati,1,1,0,0,7
93948,kothati,kothati,1,1,0,0,7
93949,kathati,kathati,3,3,0,0,7
93950,pathoti,pathoti,22,16,6,0,7
93951,mahājanena,mahajanena,105,104,1,0,10
93952,paṭipajjitabbo,patipajjitabbo,16,16,0,0,14
93953,pakatimaggo,pakatimaggo,6,6,0,0,11
93954,paṇḍitehinibbānatthikehi,panditehinibbanatthikehi,1,1,0,0,24
93955,paṭipadāsaṅkhāto,patipadasankhato,1,1,0,0,16
93956,uppannakiccākiccehi,uppannakiccakiccehi,1,1,0,0,19
93957,pathiyati,pathiyati,2,2,0,0,9
93958,gacchiyatīti,gacchiyatiti,1,1,0,0,12
93959,amatamahāpuraṃ,amatamahapuram,1,1,0,0,14
93960,gantukāmehi,gantukamehi,1,1,0,0,11
93961,saddhāpātheyyaṃ,saddhapatheyyam,1,1,0,0,15
93962,pātheti,patheti,1,1,0,0,7
93963,sampāpetīti,sampapetiti,14,14,0,0,11
93964,paṭipadāyeva,patipadayeva,2,2,0,0,12
93965,maggābhidhānaṃ,maggabhidhanam,1,1,0,0,14
93966,dhātukathanaṭṭhāne,dhatukathanatthane,1,1,0,0,18
93967,nippāke,nippake,1,0,1,0,7
93968,vilothane,vilothane,1,0,1,0,9
93969,potha,potha,1,0,1,0,5
93970,pariyāyanabhāve,pariyayanabhave,1,0,1,0,15
93971,pothati,pothati,2,2,0,0,7
93972,pothako,pothako,1,1,0,0,7
93973,pothetīti,pothetiti,1,1,0,0,9
93974,anupariyeyyuṃ,anupariyeyyum,4,3,1,0,13
93975,nippothentā,nippothenta,4,4,0,0,11
93976,catuddisā,catuddisa,88,84,4,0,9
93977,gottha,gottha,1,0,1,0,6
93978,gotthati,gotthati,1,1,0,0,8
93979,dakārantadhātu,dakarantadhatu,5,5,0,0,14
93980,ādeti,adeti,8,7,1,0,5
93981,taddīpakattā,taddipakatta,10,10,0,0,12
93982,assaddhaṃ,assaddham,32,32,0,0,9
93983,dāpeti,dapeti,75,72,3,0,6
93984,ādapeti,adapeti,4,4,0,0,7
93985,samādapeti,samadapeti,457,456,1,0,10
93986,dhammamevādapayanti,dhammamevadapayanti,8,6,2,0,19
93987,kāritapadāni,karitapadani,1,1,0,0,12
93988,hetukattupadānīti,hetukattupadaniti,1,1,0,0,17
93989,ādīyati,adiyati,9,9,0,0,7
93990,samādīyati,samadiyati,1,1,0,0,10
93991,dāneti,daneti,2,0,2,0,6
93992,sāsanānurūpasutivasena,sasananurupasutivasena,1,1,0,0,22
93993,supana,supana,1,0,1,0,6
93994,niddāyati,niddayati,52,52,0,0,9
93995,sanāmapadāni,sanamapadani,5,5,0,0,12
93996,janayati,janayati,29,27,2,0,8
93997,dānamavakhaṇḍanañca,danamavakhandananca,1,0,1,0,19
93998,diyati,diyati,4,4,0,0,6
93999,vedāyati,vedayati,1,1,0,0,8
94000,pubbavasena,pubbavasena,2,2,0,0,11
94001,gahaṇañca,gahananca,17,15,2,0,9
94002,kucchitagamanaṃ,kucchitagamanam,1,1,0,0,15
94003,suddāti,suddati,3,2,1,0,7
94004,suddī,suddi,9,8,1,0,5
94005,upaparikkhitabbo,upaparikkhitabbo,27,27,0,0,16
94006,nāmapadāni,namapadani,9,9,0,0,10
94007,brahmadeyyaṃ,brahmadeyyam,29,22,7,0,12
94008,dāyikā,dayika,15,15,0,0,6
94009,padātuṃ,padatum,3,3,0,0,7
94010,padātave,padatave,5,5,0,0,8
94011,dadātuna,dadatuna,1,1,0,0,8
94012,daditvā,daditva,11,10,1,0,7
94013,daditvāna,daditvana,26,26,0,0,9
94014,dadiya,dadiya,1,1,0,0,6
94015,dadiyāna,dadiyana,1,1,0,0,8
94016,ādātuṃ,adatum,22,20,2,0,6
94017,ādiya,adiya,13,13,0,0,5
94018,dadanti,dadanti,128,121,7,0,7
94019,dānacetanā,danacetana,12,11,1,0,10
94020,datta,datta,14,5,9,0,5
94021,akathane,akathane,9,9,0,0,8
94022,guṇabhūto,gunabhuto,3,3,0,0,9
94023,paṇṇattivacane,pannattivacane,1,1,0,0,14
94024,paṇṇattivacanattā,pannattivacanatta,1,1,0,0,17
94025,dattā,datta,4,2,2,0,5
94026,dinnassa,dinnassa,52,47,5,0,8
94027,passissatha,passissatha,7,7,0,0,11
94028,sakkaṭe,sakkate,1,1,0,0,7
94029,byāsamhi,byasamhi,1,1,0,0,8
94030,mahāmāyā,mahamaya,44,43,1,0,8
94031,byāsasamāsānaṃ,byasasamasanam,1,1,0,0,14
94032,sakkaṭabhāsite,sakkatabhasite,1,1,0,0,14
94033,asamāsamhi,asamasamhi,2,2,0,0,10
94034,munimate,munimate,1,1,0,0,8
94035,sirappadānaṃ,sirappadanam,1,1,0,0,12
94036,bhūridattassa,bhuridattassa,13,13,0,0,13
94037,buddhadatto,buddhadatto,1,1,0,0,11
94038,asamāsasamāsiko,asamasasamasiko,1,1,0,0,15
94039,paradattabhojanaṃ,paradattabhojanam,1,1,0,0,17
94040,guṇabhūtoyaṃ,gunabhutoyam,1,1,0,0,12
94041,dinnādāyī,dinnadayi,25,19,6,0,9
94042,guṇapaṇṇattibhāvenesa,gunapannattibhavenesa,1,1,0,0,21
94043,saddaracanamakāsi,saddaracanamakasi,1,1,0,0,17
94044,yassaṅkurehi,yassankurehi,1,1,0,0,12
94045,jimutambujaloditehi,jimutambujaloditehi,1,1,0,0,19
94046,vāteritehi,vateritehi,2,2,0,0,10
94047,suṇehi,sunehi,1,1,0,0,6
94048,jenantacīvaramasobhatha,jenantacivaramasobhatha,1,1,0,0,23
94049,brahmadattaṃ,brahmadattam,28,27,1,0,12
94050,caladalaṃ,caladalam,1,1,0,0,9
94051,varabodhirukkhaṃ,varabodhirukkham,1,1,0,0,16
94052,pāḷinayañhipatvā,palinayanhipatva,1,1,0,0,16
94053,brahmadattiyaṃ,brahmadattiyam,1,1,0,0,14
94054,brahmadinnaṃ,brahmadinnam,1,1,0,0,12
94055,devadattiyaṃ,devadattiyam,14,10,4,0,12
94056,devadinnaṃ,devadinnam,9,1,8,0,10
94057,sakkadattiye,sakkadattiye,7,7,0,0,12
94058,vasiṃsū,vasimsu,10,6,4,0,7
94059,pāḷinayānurūpo,palinayanurupo,1,1,0,0,14
94060,etthevaṃ,etthevam,1,1,0,0,8
94061,ṭhānamhi,thanamhi,7,7,0,0,8
94062,dattiyaṃ,dattiyam,2,2,0,0,8
94063,devadattiyapatto,devadattiyapatto,1,1,0,0,16
94064,sakkadattiyo,sakkadattiyo,3,3,0,0,12
94065,paripuṇṇāparipuṇṇavasena,paripunnaparipunnavasena,1,1,0,0,24
94066,dadāsi,dadasi,11,11,0,0,6
94067,dadāmase,dadamase,11,11,0,0,8
94068,dadeyyuṃ,dadeyyum,39,38,1,0,8
94069,dadeyyāsi,dadeyyasi,21,21,0,0,9
94070,dajjāsi,dajjasi,22,22,0,0,7
94071,dajjesi,dajjesi,5,5,0,0,7
94072,dakarakkhino,dakarakkhino,27,27,0,0,12
94073,sīlavantesu,silavantesu,33,32,1,0,11
94074,dadeyyātha,dadeyyatha,7,7,0,0,10
94075,dajjātha,dajjatha,4,4,0,0,8
94076,dadeyyāmi,dadeyyami,3,3,0,0,9
94077,dadeyyāma,dadeyyama,15,15,0,0,9
94078,dajjāma,dajjama,5,5,0,0,7
94079,dadetha,dadetha,6,6,0,0,7
94080,daderaṃ,daderam,2,2,0,0,7
94081,dadetho,dadetho,2,2,0,0,7
94082,dadeyyāvho,dadeyyavho,2,2,0,0,10
94083,dajjāvho,dajjavho,2,2,0,0,8
94084,dadeyyāmhe,dadeyyamhe,3,3,0,0,10
94085,dajjāmhe,dajjamhe,2,2,0,0,8
94086,dajjati,dajjati,4,4,0,0,7
94087,dajjanti,dajjanti,5,5,0,0,8
94088,aṭṭhannampi,atthannampi,52,50,2,0,11
94089,vasenāhu,vasenahu,2,2,0,0,8
94090,padakkamaṃ,padakkamam,1,1,0,0,10
94091,kārasahiteyeva,karasahiteyeva,1,1,0,0,14
94092,padarūpe,padarupe,2,2,0,0,8
94093,dadeyyā,dadeyya,45,45,0,0,7
94094,saralopaṃ,saralopam,7,7,0,0,9
94095,saṃyogañca,samyoganca,1,1,0,0,10
94096,tīsusaññogabyañjanesu,tisusannogabyanjanesu,1,1,0,0,21
94097,sarūpānamekassa,sarupanamekassa,2,2,0,0,15
94098,dyakārasaññogassa,dyakarasannogassa,2,2,0,0,17
94099,kāradvayaṃ,karadvayam,8,8,0,0,10
94100,dīghavasenuccāritabbattā,dighavasenuccaritabbatta,1,1,0,0,24
94101,dīghabhāvaṃ,dighabhavam,6,6,0,0,11
94102,sāsanassānurūpo,sasanassanurupo,1,1,0,0,15
94103,vaṇṇasandhi,vannasandhi,3,3,0,0,11
94104,padasandhi,padasandhi,58,52,6,0,10
94105,vaṇṇasandhīti,vannasandhiti,1,1,0,0,13
94106,paddhāni,paddhani,3,3,0,0,8
94107,duvidhesu,duvidhesu,20,20,0,0,9
94108,sandhīsu,sandhisu,7,5,2,0,8
94109,paccayantavasena,paccayantavasena,1,1,0,0,16
94110,indako,indako,21,21,0,0,6
94111,parittakaṃ,parittakam,69,64,5,0,10
94112,tāragaṇe,taragane,9,7,2,0,8
94113,dajjāti,dajjati,17,2,15,0,7
94114,datvāti,datvati,95,15,80,0,7
94115,dadiyya,dadiyya,2,2,0,0,7
94116,saññogesu,sannogesu,2,2,0,0,9
94117,sarūpalopañca,sarupalopanca,1,1,0,0,13
94118,dīghattañca,dighattanca,1,1,0,0,11
94119,saññogabhāvañca,sannogabhavanca,1,1,0,0,15
94120,kāradvayañca,karadvayanca,3,3,0,0,12
94121,paccayādiñca,paccayadinca,1,1,0,0,12
94122,dātabbā,databba,256,251,5,0,7
94123,dadeyyāsī,dadeyyasi,25,25,0,0,9
94124,sarūpalopaṃ,sarupalopam,1,1,0,0,11
94125,kārasamaññogassa,karasamannogassa,1,1,0,0,16
94126,nipphajjanti,nipphajjanti,11,11,0,0,12
94127,dajjāsīti,dajjasiti,3,0,3,0,9
94128,tassāvayavassa,tassavayavassa,1,1,0,0,14
94129,dajjesī,dajjesi,1,1,0,0,7
94130,acinteyyānubhāvassa,acinteyyanubhavassa,1,1,0,0,19
94131,acinteyyoyeva,acinteyyoyeva,1,1,0,0,13
94132,viraciteheva,viraciteheva,1,1,0,0,12
94133,cetiyānī,cetiyani,3,3,0,0,8
94134,titthyā,titthya,13,8,5,0,7
94135,puthuso,puthuso,24,18,6,0,7
94136,ārāmarukkhacetyānī,aramarukkhacetyani,1,1,0,0,18
94137,sākacchati,sakacchati,3,3,0,0,10
94138,kathayatī,kathayati,1,1,0,0,9
94139,tivā,tiva,8,8,0,0,4
94140,saṃkathayatī,samkathayati,1,1,0,0,12
94141,tathyaṃ,tathyam,1,1,0,0,7
94142,niggahītalopaṃ,niggahitalopam,1,1,0,0,14
94143,thya,thya,2,0,2,0,4
94144,kārasaññogassa,karasannogassa,2,2,0,0,14
94145,visabhāgasaññoge,visabhagasannoge,1,1,0,0,16
94146,sabhāgattamāpajjati,sabhagattamapajjati,1,1,0,0,19
94147,sākacchiṃsu,sakacchimsu,1,1,0,0,11
94148,dhammasākacchā,dhammasakaccha,19,13,6,0,14
94149,yathātathiyaṃ,yathatathiyam,2,1,1,0,13
94150,viditvāpi,viditvapi,2,2,0,0,9
94151,paribbajeyyā,paribbajeyya,6,6,0,0,12
94152,savikapāni,savikapani,1,1,0,0,10
94153,vaṇṇasandhivasena,vannasandhivasena,1,1,0,0,17
94154,lopavidhi,lopavidhi,1,1,0,0,9
94155,labbhatiyeva,labbhatiyeva,54,54,0,0,12
94156,rūpanipphādanupāyo,rupanipphadanupayo,1,1,0,0,18
94157,yamanarādīsū,yamanaradisu,1,1,0,0,12
94158,yogirājassa,yogirajassa,1,1,0,0,11
94159,dajjāhaṃ,dajjaham,19,16,3,0,8
94160,dammī,dammi,421,415,6,0,5
94161,sattamīpayogoyeva,sattamipayogoyeva,2,2,0,0,17
94162,sattamīpayogo,sattamipayogo,1,1,0,0,13
94163,jānantāpi,janantapi,52,48,4,0,9
94164,parikappatthampi,parikappatthampi,1,1,0,0,16
94165,gaṇheyyuṃ,ganheyyum,40,39,1,0,9
94166,āsaṅkāya,asankaya,35,35,0,0,8
94167,vivaraṇamakaṃsu,vivaranamakamsu,1,1,0,0,15
94168,anāparādhakammantaṃ,anaparadhakammantam,4,3,1,0,19
94169,dakarakkhassa,dakarakkhassa,1,1,0,0,13
94170,sattamīpayogavaseneva,sattamipayogavaseneva,1,1,0,0,21
94171,dajjaṃpadassa,dajjampadassa,1,1,0,0,13
94172,parokkhādivasena,parokkhadivasena,2,2,0,0,16
94173,dadū,dadu,2,2,0,0,4
94174,nārado,narado,126,118,8,0,6
94175,dadittha,dadittha,2,2,0,0,8
94176,dadimha,dadimha,2,2,0,0,7
94177,dadire,dadire,1,1,0,0,6
94178,dadittho,dadittho,1,1,0,0,8
94179,dadivho,dadivho,1,1,0,0,7
94180,daditthoti,daditthoti,1,0,1,0,10
94181,kisittho,kisittho,6,5,1,0,8
94182,kalale,kalale,35,35,0,0,6
94183,akkamittho,akkamittho,2,2,0,0,10
94184,dadimhe,dadimhe,1,1,0,0,7
94185,parokkhāsahibharūpāni,parokkhasahibharupani,1,1,0,0,21
94186,adadū,adadu,3,3,0,0,5
94187,adade,adade,1,1,0,0,5
94188,adadattha,adadattha,4,4,0,0,9
94189,adadaṃ,adadam,23,19,4,0,6
94190,adadamha,adadamha,2,2,0,0,8
94191,adadatthuṃ,adadatthum,1,1,0,0,10
94192,adadase,adadase,2,2,0,0,7
94193,adadavhaṃ,adadavham,1,1,0,0,9
94194,adadiṃ,adadim,78,77,1,0,6
94195,adadamhase,adadamhase,2,2,0,0,10
94196,anakārapubbampi,anakarapubbampi,1,1,0,0,15
94197,dadamhase,dadamhase,7,7,0,0,9
94198,hiyyattanīsahitarūpāni,hiyyattanisahitarupani,1,1,0,0,22
94199,adadi,adadi,4,4,0,0,5
94200,adaduṃ,adadum,3,3,0,0,6
94201,adadiṃsu,adadimsu,4,4,0,0,8
94202,adado,adado,3,3,0,0,5
94203,adadittha,adadittha,1,1,0,0,9
94204,adadimhā,adadimha,1,1,0,0,8
94205,adadivhaṃ,adadivham,1,1,0,0,9
94206,adadimhe,adadimhe,1,1,0,0,8
94207,ajjatanīsahitarūpāni,ajjatanisahitarupani,1,1,0,0,20
94208,dadissanti,dadissanti,4,4,0,0,10
94209,bhavissantīsahitarūpāni,bhavissantisahitarupani,1,1,0,0,23
94210,adadisā,adadisa,1,1,0,0,7
94211,dadissā,dadissa,1,1,0,0,7
94212,adadissaṃsu,adadissamsu,1,1,0,0,11
94213,dadissaṃsu,dadissamsu,1,1,0,0,10
94214,kālātipattisahitarūpāni,kalatipattisahitarupani,1,1,0,0,23
94215,vattamānādisahitarūpāni,vattamanadisahitarupani,1,1,0,0,23
94216,detha,detha,448,441,7,0,5
94217,sattamīnayo,sattaminayo,1,1,0,0,11
94218,parokkhānayo,parokkhanayo,1,1,0,0,12
94219,hiyuttanīnayo,hiyuttaninayo,1,1,0,0,13
94220,ajjatanīnayo,ajjataninayo,1,1,0,0,12
94221,adū,adu,2,2,0,0,3
94222,varañceme,varanceme,1,1,0,0,9
94223,adāsime,adasime,1,1,0,0,7
94224,adaṃsu,adamsu,371,369,2,0,6
94225,mamokāsaṃ,mamokasam,7,7,0,0,9
94226,tadāti,tadati,82,19,63,0,6
94227,dassati,dassati,164,159,5,0,7
94228,dassanti,dassanti,145,144,1,0,8
94229,adassā,adassa,3,3,0,0,6
94230,dassā,dassa,3,2,1,0,5
94231,adassaṃsu,adassamsu,2,2,0,0,9
94232,dassaṃsu,dassamsu,3,3,0,0,8
94233,dassiṃsu,dassimsu,3,3,0,0,8
94234,ādadanti,adadanti,1,1,0,0,8
94235,ādadāsi,adadasi,1,1,0,0,7
94236,ādadātha,adadatha,1,1,0,0,8
94237,ādadāmi,adadami,1,1,0,0,7
94238,ādadāma,adadama,1,1,0,0,7
94239,ādadātu,adadatu,1,1,0,0,7
94240,ādadeyya,adadeyya,1,1,0,0,8
94241,ādetu,adetu,2,2,0,0,5
94242,ādāpetī,adapeti,1,1,0,0,7
94243,dākucchite,dakucchite,1,0,1,0,10
94244,suddoti,suddoti,3,2,1,0,7
94245,suddātīti,suddatiti,1,1,0,0,9
94246,parapothanādiluddācārakammunā,parapothanadiluddacarakammuna,1,1,0,0,29
94247,dārukammādikhuddācārakammunā,darukammadikhuddacarakammuna,1,1,0,0,28
94248,kucchitagativācakattā,kucchitagativacakatta,1,1,0,0,21
94249,suddassa,suddassa,16,16,0,0,8
94250,mūlakkhandhasākhāviṭapapattapallavapupphaphalehi,mulakkhandhasakhavitapapattapallavapupphaphalehi,1,1,0,0,48
94251,desodhane,desodhane,1,0,1,0,9
94252,sodhanaṃ,sodhanam,29,28,1,0,8
94253,pariyodāpanaṃ,pariyodapanam,4,3,1,0,13
94254,dāyanaṃ,dayanam,1,1,0,0,7
94255,dāyituṃ,dayitum,2,2,0,0,7
94256,dāyitvā,dayitva,3,3,0,0,7
94257,dhātāvayava,dhatavayava,1,1,0,0,11
94258,sodhetuṃ,sodhetum,111,104,7,0,8
94259,sodhetvāti,sodhetvati,28,4,24,0,10
94260,abyatto,abyatto,150,143,7,0,7
94261,nappaṭibalo,nappatibalo,7,7,0,0,11
94262,anuyuñjiyamāno,anuyunjiyamano,20,20,0,0,14
94263,anuyogaṃ,anuyogam,147,140,7,0,8
94264,sodhetunti,sodhetunti,3,3,0,0,10
94265,anuyuñjiyati,anuyunjiyati,3,3,0,0,12
94266,paccāgacchī,paccagacchi,1,1,0,0,11
94267,anuyogadāpanatthaṃ,anuyogadapanattham,9,6,3,0,18
94268,esoyevattho,esoyevattho,2,2,0,0,11
94269,sodhāpetuṃ,sodhapetum,3,3,0,0,10
94270,vimaddakkhamañhi,vimaddakkhamanhi,3,3,0,0,16
94271,sodhāpeti,sodhapeti,9,8,1,0,9
94272,samantapaṭṭhānamahāpakaraṇa,samantapatthanamahapakarana,1,1,0,0,27
94273,saṃvaṇṇanāyampi,samvannanayampi,1,1,0,0,15
94274,pariyodāpetvā,pariyodapetva,2,2,0,0,13
94275,sodhanattho,sodhanattho,2,2,0,0,11
94276,ṭhapetabbā,thapetabba,86,84,2,0,10
94277,duggatito,duggatito,18,18,0,0,9
94278,vippakiṇṇabhāvena,vippakinnabhavena,3,3,0,0,17
94279,nassituṃ,nassitum,4,4,0,0,8
94280,saṅgahavacananti,sangahavacananti,4,4,0,0,16
94281,pacchuddānādikaṃ,pacchuddanadikam,1,1,0,0,16
94282,khādikā,khadika,2,2,0,0,7
94283,aññamaññakhādikā,annamannakhadika,3,3,0,0,16
94284,pubbaphalakhādikā,pubbaphalakhadika,1,1,0,0,17
94285,pūvaphalāphalādi,puvaphalaphaladi,1,1,0,0,16
94286,bhojanīyassa,bhojaniyassa,8,7,1,0,12
94287,khajjassa,khajjassa,2,2,0,0,9
94288,khādanīyassa,khadaniyassa,12,11,1,0,12
94289,hiṃsāpi,himsapi,1,1,0,0,7
94290,jātijarābyādhidukkhādīhi,jatijarabyadhidukkhadihi,2,2,0,0,24
94291,khajjantīti,khajjantiti,1,1,0,0,11
94292,rūpavedanāsaññāsaṅkhāraviññāṇāni,rupavedanasannasankharavinnanani,3,3,0,0,32
94293,cīvarāni,civarani,374,364,10,0,8
94294,nassantipi,nassantipi,3,3,0,0,10
94295,ḍayhantipi,dayhantipi,3,3,0,0,10
94296,undūrehipi,undurehipi,14,14,0,0,10
94297,khajjantī,khajjanti,2,2,0,0,9
94298,kammattho,kammattho,6,6,0,0,9
94299,thirabhāvo,thirabhavo,9,9,0,0,10
94300,theriyaṃ,theriyam,3,1,2,0,8
94301,badati,badati,1,1,0,0,6
94302,badaraṃ,badaram,3,3,0,0,7
94303,kakkandhu,kakkandhu,1,1,0,0,9
94304,kulavamiccapi,kulavamiccapi,1,1,0,0,13
94305,tenilaṃ,tenilam,1,1,0,0,7
94306,badarañcāti,badarancati,1,1,0,0,11
94307,koliyāti,koliyati,2,1,1,0,8
94308,dhitihiṃsāsu,dhitihimsasu,1,0,1,0,12
94309,theriyāpekkhāya,theriyapekkhaya,1,1,0,0,15
94310,khadati,khadati,2,2,0,0,7
94311,āgadanaṃ,agadanam,13,12,1,0,8
94312,āgado,agado,23,23,0,0,5
94313,radati,radati,1,1,0,0,6
94314,dāṭhārado,datharado,1,1,0,0,9
94315,radanoti,radanoti,1,0,1,0,8
94316,paṇadati,panadati,1,1,0,0,8
94317,pabbatesu,pabbatesu,19,18,1,0,9
94318,vanādīsu,vanadisu,1,1,0,0,8
94319,kiṃniccamabyattasaddeyeva,kimniccamabyattasaddeyeva,1,1,0,0,25
94320,viyattiyampi,viyattiyampi,1,1,0,0,12
94321,niccamabyattasaddeyeva,niccamabyattasaddeyeva,1,1,0,0,22
94322,nadatī,nadati,33,30,3,0,6
94323,tiracchānagatādisaddabhāvena,tiracchanagatadisaddabhavena,1,1,0,0,28
94324,avibhāvitatthatāya,avibhavitatthataya,1,1,0,0,18
94325,manussabhāsāpi,manussabhasapi,3,3,0,0,14
94326,viyattāpi,viyattapi,1,1,0,0,9
94327,manussabhāsā,manussabhasa,3,3,0,0,12
94328,samupekkhāvasena,samupekkhavasena,1,1,0,0,16
94329,padatthassāpekkhanato,padatthassapekkhanato,1,1,0,0,21
94330,purisāpekkhanavasena,purisapekkhanavasena,1,1,0,0,20
94331,valāhakūpamāvasena,valahakupamavasena,1,1,0,0,18
94332,vassanañca,vassananca,1,1,0,0,10
94333,alabbhamānampi,alabbhamanampi,7,6,1,0,14
94334,gajjanavassanasadisatāya,gajjanavassanasadisataya,1,1,0,0,24
94335,bhāsanakaraṇakriyāyūpalabbhanato,bhasanakaranakriyayupalabbhanato,1,1,0,0,32
94336,nibbhayabhāvena,nibbhayabhavena,1,1,0,0,15
94337,sīhanādasadisiyā,sihanadasadisiya,1,1,0,0,16
94338,niccharaṇato,niccharanato,2,2,0,0,12
94339,avibhāvitatthavantena,avibhavitatthavantena,1,1,0,0,21
94340,ambaphalūpamādayopi,ambaphalupamadayopi,1,1,0,0,19
94341,pakkāmakatādīni,pakkamakatadini,1,1,0,0,15
94342,ambaphalādīsu,ambaphaladisu,1,1,0,0,13
94343,aññenākārena,annenakarena,27,25,2,0,12
94344,ambaphalūpamādayo,ambaphalupamadayo,1,1,0,0,17
94345,abyattasaddabhāvena,abyattasaddabhavena,1,1,0,0,19
94346,tiracchānagatasaddādīsu,tiracchanagatasaddadisu,1,1,0,0,23
94347,atthantaravibhāvanatthaṃ,atthantaravibhavanattham,1,1,0,0,24
94348,manussabhāsāyampi,manussabhasayampi,1,1,0,0,17
94349,saddādīhipi,saddadihipi,1,1,0,0,11
94350,siṅgālānaṃ,singalanam,18,18,0,0,10
94351,sakuṇānañca,sakunananca,13,12,1,0,11
94352,manussavassitaṃ,manussavassitam,8,8,0,0,15
94353,dubbijānataraṃ,dubbijanataram,10,9,1,0,14
94354,niddisiyatīti,niddisiyatiti,1,1,0,0,13
94355,niddisituṃ,niddisitum,43,42,1,0,10
94356,saddasadisī,saddasadisi,1,1,0,0,11
94357,kūjatī,kujati,3,3,0,0,6
94358,saṅgāmaṃ,sangamam,125,122,3,0,8
94359,otaritvāna,otaritvana,9,9,0,0,10
94360,abyattasaddeyeva,abyattasaddeyeva,1,1,0,0,16
94361,nadda,nadda,1,0,1,0,5
94362,naddati,naddati,1,1,0,0,7
94363,gaddati,gaddati,1,1,0,0,7
94364,tadda,tadda,1,0,1,0,5
94365,taddati,taddati,2,1,1,0,7
94366,kadda,kadda,1,0,1,0,5
94367,kaddati,kaddati,1,1,0,0,7
94368,khadda,khadda,1,0,1,0,6
94369,daṃsana,damsana,1,0,1,0,7
94370,dantasukatakattikā,dantasukatakattika,1,1,0,0,18
94371,sādhanappayogasamavāyī,sadhanappayogasamavayi,1,1,0,0,22
94372,khaddati,khaddati,1,1,0,0,8
94373,andati,andati,2,2,0,0,6
94374,saddopanettha,saddopanettha,1,1,0,0,13
94375,pūrā,pura,61,61,0,0,4
94376,samatittikā,samatittika,16,16,0,0,11
94377,kākapeyyā,kakapeyya,26,24,2,0,9
94378,pāratthiko,paratthiko,4,4,0,0,10
94379,taritukāmo,taritukamo,16,16,0,0,10
94380,orimatīre,orimatire,31,31,0,0,9
94381,daḷhāya,dalhaya,52,49,3,0,7
94382,anduyā,anduya,6,6,0,0,6
94383,pacchābāhaṃ,pacchabaham,46,46,0,0,11
94384,gāḷhabandhanabandho,galhabandhanabandho,1,1,0,0,19
94385,andūti,anduti,2,1,1,0,6
94386,andughare,andughare,12,12,0,0,9
94387,bandhanaviseso,bandhanaviseso,1,1,0,0,14
94388,andubandhanādīni,andubandhanadini,6,6,0,0,16
94389,palāyiṃsū,palayimsu,1,1,0,0,9
94390,andanaṭṭhena,andanatthena,1,1,0,0,12
94391,bandhanaṭṭhena,bandhanatthena,38,36,2,0,14
94392,ariyassa,ariyassa,332,320,12,0,8
94393,andūtipi,andutipi,3,3,0,0,8
94394,bandhanantipi,bandhanantipi,3,3,0,0,13
94395,niggahītāgamavasenāyaṃ,niggahitagamavasenayam,1,1,0,0,22
94396,vigataniggahītāgamopi,vigataniggahitagamopi,1,1,0,0,21
94397,pubbaṅgamā,pubbangama,103,100,3,0,10
94398,samāpattiyā,samapattiya,211,205,6,0,11
94399,anvadeva,anvadeva,29,26,3,0,8
94400,ahirikaṃ,ahirikam,186,169,17,0,8
94401,anuandati,anuandati,1,1,0,0,9
94402,anubandhatīti,anubandhatiti,14,11,3,0,13
94403,anvadi,anvadi,2,2,0,0,6
94404,anvadevāti,anvadevati,5,0,5,0,10
94405,kitaviggaho,kitaviggaho,1,1,0,0,11
94406,anubandhamānamevā,anubandhamanameva,1,1,0,0,17
94407,avijjamahirikaṃ,avijjamahirikam,1,1,0,0,15
94408,anubandhamānameva,anubandhamanameva,2,2,0,0,17
94409,indanaṃ,indanam,2,2,0,0,7
94410,adhipatibhūto,adhipatibhuto,11,11,0,0,13
94411,hūtapati,hutapati,1,1,0,0,8
94412,devakuñjaro,devakunjaro,9,9,0,0,11
94413,surādhipo,suradhipo,2,2,0,0,9
94414,jambāri,jambari,1,1,0,0,7
94415,asurasāsano,asurasasano,1,1,0,0,11
94416,gandharājā,gandharaja,1,1,0,0,10
94417,devindo,devindo,105,104,1,0,7
94418,surindo,surindo,1,1,0,0,7
94419,asurābhibhūti,asurabhibhuti,1,1,0,0,13
94420,anekasaddappavattinimittatāya,anekasaddappavattinimittataya,1,1,0,0,29
94421,anekanāmo,anekanamo,1,1,0,0,9
94422,āvāsaṃ,avasam,307,299,8,0,6
94423,muhuttena,muhuttena,53,52,1,0,9
94424,devānamindassa,devanamindassa,93,92,1,0,14
94425,asurakaññā,asurakanna,6,6,0,0,10
94426,sujampatī,sujampati,11,11,0,0,9
94427,issariyādhipaccaṃ,issariyadhipaccam,31,26,5,0,17
94428,evamekassāpi,evamekassapi,1,1,0,0,12
94429,saddappavattinimittāni,saddappavattinimittani,1,1,0,0,22
94430,tāvatiṃsādhipatimhi,tavatimsadhipatimhi,2,2,0,0,19
94431,sakkādi,sakkadi,1,0,1,0,7
94432,vijjādi,vijjadi,2,1,1,0,7
94433,sampayuttadhammānaṃ,sampayuttadhammanam,133,130,3,0,19
94434,pubbaṅgamabhāvena,pubbangamabhavena,5,5,0,0,17
94435,uppannadhammasmiṃ,uppannadhammasmim,1,1,0,0,17
94436,viññāṇādi,vinnanadi,9,8,1,0,9
94437,sammutyattho,sammutyattho,1,1,0,0,12
94438,paramattho,paramattho,181,166,15,0,10
94439,anekasaddappavttinimittatāya,anekasaddappavttinimittataya,1,1,0,0,28
94440,anekanāmoti,anekanamoti,1,1,0,0,11
94441,saddappavattinimittaṃ,saddappavattinimittam,5,5,0,0,21
94442,pariyesissāmi,pariyesissami,49,49,0,0,13
94443,asabhāvadhammabhūtaṃ,asabhavadhammabhutam,1,1,0,0,20
94444,nāmapaññattisaṅkhātaṃ,namapannattisankhatam,1,1,0,0,21
94445,saddappavattinimittampi,saddappavattinimittampi,1,1,0,0,23
94446,nāmagottaṃ,namagottam,116,100,16,0,10
94447,sataliṅgo,satalingo,2,2,0,0,9
94448,saddappavattinimittassa,saddappavattinimittassa,4,4,0,0,23
94449,saddappavattinimittañca,saddappavattinimittanca,1,1,0,0,23
94450,lokasaṅketasiddho,lokasanketasiddho,3,3,0,0,17
94451,taṃtaṃvacanatthaniyato,tamtamvacanatthaniyato,2,2,0,0,22
94452,sāmaññākāravisesoti,samannakaravisesoti,2,2,0,0,19
94453,evaṃbhūtoyeva,evambhutoyeva,4,4,0,0,13
94454,sāmaññākāraviseso,samannakaraviseso,2,2,0,0,17
94455,nāmasaññaṃ,namasannam,2,2,0,0,10
94456,saviññattivikārassa,savinnattivikarassa,1,1,0,0,19
94457,sammutiparamatthasaccānaṃ,sammutiparamatthasaccanam,1,1,0,0,25
94458,paññattibhāve,pannattibhave,8,8,0,0,13
94459,paññattibhāvo,pannattibhavo,3,3,0,0,13
94460,niruttipaṭisambhidā,niruttipatisambhida,148,139,9,0,19
94461,parittārammaṇā,parittarammana,113,107,6,0,14
94462,paccuppannārammaṇā,paccuppannarammana,98,96,2,0,18
94463,bahiddhārammaṇā,bahiddharammana,80,80,0,0,15
94464,saddappavattinimittādhikārattā,saddappavattinimittadhikaratta,1,1,0,0,30
94465,anekavidhassa,anekavidhassa,4,4,0,0,13
94466,nāmapaññattisaṅkhātassa,namapannattisankhatassa,1,1,0,0,23
94467,ñeyyattho,neyyattho,4,3,1,0,9
94468,anekaliṅgoti,anekalingoti,1,1,0,0,12
94469,suhemanto,suhemanto,4,3,1,0,9
94470,sataliṅgassa,satalingassa,8,7,1,0,12
94471,satalakkhaṇadhārino,satalakkhanadharino,5,5,0,0,19
94472,ekaṅgadassī,ekangadassi,5,4,1,0,11
94473,satadassīva,satadassiva,1,1,0,0,11
94474,sabbābhidhānesupi,sabbabhidhanesupi,1,1,0,0,17
94475,abhidhānamatthi,abhidhanamatthi,1,1,0,0,15
94476,kaṇḍati,kandati,2,2,0,0,7
94477,khidi,khidi,2,0,2,0,5
94478,candaviduno,candaviduno,1,1,0,0,11
94479,khindatī,khindati,1,1,0,0,8
94480,porāṇametaṃ,poranametam,5,3,2,0,11
94481,atula,atula,7,7,0,0,5
94482,ajjatanāmiva,ajjatanamiva,5,5,0,0,12
94483,tuṇhimāsīnaṃ,tunhimasinam,6,5,1,0,12
94484,bahubhāṇinaṃ,bahubhaninam,6,5,1,0,12
94485,mitabhāṇimpi,mitabhanimpi,4,4,0,0,12
94486,anindito,anindito,26,26,0,0,8
94487,aguṇo,aguno,10,10,0,0,5
94488,ayasopi,ayasopi,9,9,0,0,7
94489,asiloko,asiloko,3,3,0,0,7
94490,akitti,akitti,17,11,6,0,6
94491,asilāghā,asilagha,1,1,0,0,8
94492,atthuti,atthuti,2,2,0,0,7
94493,nandāya,nandaya,20,20,0,0,7
94494,maraṇena,maranena,265,259,6,0,8
94495,nandasi,nandasi,7,7,0,0,7
94496,sirivāhana,sirivahana,3,3,0,0,10
94497,abhisaddayoge,abhisaddayoge,1,0,1,0,13
94498,sakammakopi,sakammakopi,1,0,1,0,11
94499,abhinandaṃ,abhinandam,1,0,1,0,10
94500,nābhinandanti,nabhinandanti,3,3,0,0,13
94501,sirīva,siriva,1,1,0,0,6
94502,rūpiniṃ,rupinim,7,6,1,0,7
94503,nanditaṃ,nanditam,4,4,0,0,8
94504,nandāti,nandati,24,16,8,0,7
94505,veḷuvanaṃ,veluvanam,93,86,7,0,9
94506,sugatālayaṃ,sugatalayam,12,12,0,0,11
94507,mahesayaṃ,mahesayam,2,2,0,0,9
94508,naranandananandanaṃ,naranandananandanam,3,3,0,0,19
94509,amarindasunandanaṃ,amarindasunandanam,3,3,0,0,18
94510,candano,candano,32,29,3,0,7
94511,candanassapi,candanassapi,1,1,0,0,12
94512,suvaṇṇacandanaṃ,suvannacandanam,1,1,0,0,15
94513,candayati,candayati,2,2,0,0,9
94514,sītaguṇasamaṅgitāya,sitagunasamangitaya,1,1,0,0,19
94515,paliḷāhaṃ,palilaham,1,1,0,0,9
94516,vūpasamentaṃ,vupasamentam,6,6,0,0,12
94517,sītaguṇasampattiyā,sitagunasampattiya,1,1,0,0,18
94518,vūpasamento,vupasamento,23,21,2,0,11
94519,āgamaṭṭhakathāsu,agamatthakathasu,20,12,8,0,16
94520,sasīpi,sasipi,1,1,0,0,6
94521,dvijarājā,dvijaraja,1,1,0,0,9
94522,tārāpati,tarapati,1,1,0,0,8
94523,kumudabandhavo,kumudabandhavo,1,1,0,0,14
94524,sudhi,sudhi,4,4,0,0,5
94525,dhūpi,dhupi,1,1,0,0,5
94526,yūparasmi,yuparasmi,1,1,0,0,9
94527,khamākaro,khamakaro,1,1,0,0,9
94528,nakkhatteso,nakkhatteso,1,1,0,0,11
94529,rajanīkaro,rajanikaro,1,1,0,0,10
94530,tadi,tadi,3,1,2,0,4
94531,tandati,tandati,2,2,0,0,7
94532,kaladi,kaladi,1,0,1,0,6
94533,pakkandati,pakkandati,1,1,0,0,10
94534,kandanto,kandanto,28,27,1,0,8
94535,kalidi,kalidi,1,0,1,0,6
94536,kalindati,kalindati,1,1,0,0,9
94537,khoda,khoda,1,0,1,0,5
94538,khodati,khodati,2,2,0,0,7
94539,khanda,khanda,1,0,1,0,6
94540,khandati,khandati,2,2,0,0,8
94541,āpavane,apavane,1,0,1,0,7
94542,khundati,khundati,1,1,0,0,8
94543,sidi,sidi,1,0,1,0,4
94544,sītiye,sitiye,1,0,1,0,6
94545,sītiyaṃ,sitiyam,1,0,1,0,7
94546,sītibhāvo,sitibhavo,13,13,0,0,9
94547,sosindo,sosindo,4,4,0,0,7
94548,sotatto,sotatto,9,7,2,0,7
94549,abhivandati,abhivandati,5,5,0,0,11
94550,abhivandanā,abhivandana,1,1,0,0,11
94551,vandako,vandako,4,4,0,0,7
94552,suttantaṭīkā,suttantatika,1,0,1,0,12
94553,thomemi,thomemi,6,6,0,0,7
94554,kallāṇe,kallane,1,0,1,0,7
94555,sokhiye,sokhiye,1,0,1,0,7
94556,kallāṇaṃ,kallanam,1,0,1,0,8
94557,sokhiyaṃ,sokhiyam,1,0,1,0,8
94558,sukhino,sukhino,222,218,4,0,7
94559,sukhamiccevattho,sukhamiccevattho,1,1,0,0,16
94560,bhandati,bhandati,1,1,0,0,8
94561,bhandako,bhandako,1,1,0,0,8
94562,thutimodamadasupanagatīsu,thutimodamadasupanagatisu,1,0,1,0,25
94563,mandoti,mandoti,18,1,17,0,7
94564,aññāṇīpi,annanipi,1,1,0,0,8
94565,bāladārakopi,baladarakopi,3,3,0,0,12
94566,aññāṇī,annani,23,21,2,0,6
94567,aññāṇabhāvena,annanabhavena,6,6,0,0,13
94568,appasaṃsitabbampi,appasamsitabbampi,1,1,0,0,17
94569,amoditabbaṭṭhānepi,amoditabbatthanepi,1,1,0,0,18
94570,dānasīlādipuññakriyāsu,danasiladipunnakriyasu,1,1,0,0,22
94571,pamajjatīti,pamajjatiti,2,1,1,0,11
94572,paresañca,paresanca,132,131,1,0,9
94573,khādanīyabhojanīyādīhi,khadaniyabhojaniyadihi,1,1,0,0,22
94574,sañjātamedaṃ,sanjatamedam,2,2,0,0,12
94575,diṭṭhānugatiāpajjanena,ditthanugatiapajjanena,5,5,0,0,22
94576,paṭisandhiggahaṇavasena,patisandhiggahanavasena,44,44,0,0,23
94577,gabbhamupeti,gabbhamupeti,19,18,1,0,12
94578,bāladārako,baladarako,14,14,0,0,10
94579,yuttāyuttamajānanto,yuttayuttamajananto,1,1,0,0,19
94580,uttānaseyyaṃparivattanaseyyaṃ,uttanaseyyamparivattanaseyyam,1,1,0,0,29
94581,nonītasukhumālaṃ,nonitasukhumalam,4,3,1,0,16
94582,jātapallavakomalaṃ,jatapallavakomalam,4,3,1,0,18
94583,uttānasayanaṃ,uttanasayanam,3,3,0,0,13
94584,pisācabhayatajjitā,pisacabhayatajjita,3,3,0,0,18
94585,sāyesuṃ,sayesum,6,5,1,0,7
94586,dīnamānasā,dinamanasa,7,6,1,0,10
94587,uttānasayanato,uttanasayanato,1,1,0,0,14
94588,mandadasakaṃ,mandadasakam,5,3,2,0,12
94589,appatthavācakopi,appatthavacakopi,1,1,0,0,16
94590,pāṭipadikattā,patipadikatta,1,1,0,0,13
94591,appabhāvena,appabhavena,8,8,0,0,11
94592,nipphannapāṭipadikavasenapi,nipphannapatipadikavasenapi,1,1,0,0,27
94593,sammodati,sammodati,3,3,0,0,9
94594,sammodako,sammodako,7,5,2,0,9
94595,muditā,mudita,195,178,17,0,6
94596,hada,hada,8,4,4,0,4
94597,karīsossaggo,karisossaggo,1,0,1,0,12
94598,karīsassa,karisassa,11,11,0,0,9
94599,ossajjanaṃ,ossajjanam,1,1,0,0,10
94600,vissajjanaṃ,vissajjanam,375,347,28,0,11
94601,hadati,hadati,1,1,0,0,6
94602,uhadati,uhadati,1,1,0,0,7
94603,hadano,hadano,1,1,0,0,6
94604,dārakā,daraka,272,271,1,0,6
94605,uhadantipi,uhadantipi,4,4,0,0,10
94606,ummihantipī,ummihantipi,1,1,0,0,11
94607,uhadantipīti,uhadantipiti,1,0,1,0,12
94608,vaccampi,vaccampi,5,3,2,0,8
94609,ummihantipīti,ummihantipiti,2,0,2,0,13
94610,passāvampi,passavampi,40,38,2,0,10
94611,pacchimapadassattho,pacchimapadassattho,1,1,0,0,19
94612,secaneti,secaneti,3,2,1,0,8
94613,mutteti,mutteti,9,6,3,0,7
94614,ohadeti,ohadeti,3,3,0,0,7
94615,cariyāpiṭakapāḷi,cariyapitakapali,2,1,1,0,16
94616,ppadeso,ppadeso,2,2,0,0,7
94617,muttetīti,muttetiti,3,0,3,0,9
94618,passāvaṃ,passavam,138,129,9,0,8
94619,ohadetīti,ohadetiti,3,0,3,0,9
94620,vissajjeti,vissajjeti,209,204,5,0,10
94621,mode,mode,2,1,1,0,4
94622,kīḷāyañca,kilayanca,1,0,1,0,9
94623,udati,udati,3,3,0,0,5
94624,udānanaṭṭhena,udananatthena,3,3,0,0,13
94625,udānanaṃ,udananam,1,1,0,0,8
94626,pībhivegasamuṭṭhāpito,pibhivegasamutthapito,1,1,0,0,21
94627,udāhāro,udaharo,9,9,0,0,7
94628,minitabbavatthu,minitabbavatthu,4,4,0,0,15
94629,mānaṃgahetuṃ,manamgahetum,1,1,0,0,12
94630,vissanditvā,vissanditva,11,11,0,0,11
94631,avaseko,avaseko,5,4,1,0,7
94632,pītivegasamuṭṭhāpitaṃ,pitivegasamutthapitam,5,5,0,0,21
94633,vitakkavipphāraṃ,vitakkavippharam,5,5,0,0,16
94634,sandhāretuṃ,sandharetum,186,177,9,0,11
94635,asaṇṭhahitvā,asanthahitva,15,15,0,0,12
94636,vacīdvārena,vacidvarena,10,9,1,0,11
94637,nikkhamanto,nikkhamanto,88,85,3,0,11
94638,paṭiggāhakanirapekkho,patiggahakanirapekkho,5,5,0,0,21
94639,udāhāraviseso,udaharaviseso,5,5,0,0,13
94640,udaggoti,udaggoti,6,1,5,0,8
94641,sañjātasomanasso,sanjatasomanasso,37,37,0,0,16
94642,kuda,kuda,1,0,1,0,4
94643,kodati,kodati,1,1,0,0,6
94644,godati,godati,1,1,0,0,6
94645,suttanti,suttanti,66,63,3,0,8
94646,tepiṭakaṃ,tepitakam,114,101,13,0,9
94647,sakammikadhātuttā,sakammikadhatutta,2,2,0,0,17
94648,paggharāpetī,paggharapeti,1,1,0,0,12
94649,nipphādetī,nipphadeti,3,3,0,0,10
94650,sūdoti,sudoti,3,0,3,0,6
94651,evañcevañca,evancevanca,18,18,0,0,11
94652,surasañca,surasanca,3,3,0,0,9
94653,randhanakriyāya,randhanakriyaya,1,1,0,0,15
94654,sukusalatāya,sukusalataya,2,2,0,0,12
94655,paggharāpeti,paggharapeti,6,6,0,0,12
94656,abhinibbattetīti,abhinibbattetiti,17,11,6,0,16
94657,rahada,rahada,1,0,1,0,6
94658,rahadati,rahadati,1,1,0,0,8
94659,hilādi,hiladi,1,0,1,0,6
94660,pubbatthāpekkhako,pubbatthapekkhako,1,1,0,0,17
94661,hilādati,hiladati,1,1,0,0,8
94662,hilādo,hilado,1,1,0,0,6
94663,mettāsahāyakatasattamahāhilādo,mettasahayakatasattamahahilado,1,1,0,0,30
94664,saddati,saddati,1,1,0,0,7
94665,vasāsaṅkhāto,vasasankhato,2,2,0,0,12
94666,pītisnehoti,pitisnehoti,1,1,0,0,11
94667,medati,medati,3,3,0,0,6
94668,medatīti,medatiti,1,0,1,0,8
94669,medasahito,medasahito,1,1,0,0,10
94670,thūlassa,thulassa,10,10,0,0,8
94671,pharitvā,pharitva,606,594,12,0,8
94672,jaṅghamaṃsādīni,janghamamsadini,6,6,0,0,15
94673,patthinnasineho,patthinnasineho,2,2,0,0,15
94674,haliddivaṇṇo,haliddivanno,1,1,0,0,12
94675,medeti,medeti,3,3,0,0,6
94676,medayatī,medayati,2,2,0,0,8
94677,gāhenti,gahenti,16,15,1,0,7
94678,brūhenti,bruhenti,8,8,0,0,8
94679,medenti,medenti,2,2,0,0,7
94680,medentīti,medentiti,2,0,2,0,9
94681,pītisinehatthe,pitisinehatthe,1,1,0,0,14
94682,mejjatī,mejjati,1,1,0,0,7
94683,suddhakatturūpaṃ,suddhakatturupam,5,5,0,0,16
94684,suddhakatturūpāni,suddhakatturupani,11,11,0,0,17
94685,sidati,sidati,1,1,0,0,6
94686,avicchedappavatti,avicchedappavatti,4,4,0,0,17
94687,puññābhisando,punnabhisando,56,54,2,0,13
94688,puññābhisandoti,punnabhisandoti,3,0,3,0,15
94689,puññappavāho,punnappavaho,4,4,0,0,12
94690,puññanadītipi,punnanaditipi,1,1,0,0,13
94691,maddabhi,maddabhi,1,1,0,0,8
94692,pamaddati,pamaddati,1,1,0,0,9
94693,mārasenappamaddano,marasenappamaddano,10,10,0,0,18
94694,vilambabhāvo,vilambabhavo,1,1,0,0,12
94695,velambo,velambo,1,0,1,0,7
94696,kadati,kadati,1,1,0,0,6
94697,khadi,khadi,3,1,2,0,5
94698,ujjhane,ujjhane,1,0,1,0,7
94699,chandati,chandati,3,3,0,0,8
94700,sīda,sida,1,0,1,0,4
94701,saṃsīdati,samsidati,72,71,1,0,9
94702,osīdati,osidati,13,13,0,0,7
94703,vippasīdati,vippasidati,21,21,0,0,11
94704,vippasanno,vippasanno,44,41,3,0,10
94705,pasādako,pasadako,3,3,0,0,8
94706,pasādito,pasadito,14,12,2,0,8
94707,osīdāpako,osidapako,1,1,0,0,9
94708,nisinnako,nisinnako,19,18,1,0,9
94709,gonisādo,gonisado,1,1,0,0,8
94710,sīdeti,sideti,2,2,0,0,6
94711,sīdayati,sidayati,2,2,0,0,8
94712,sīdāpeti,sidapeti,2,2,0,0,8
94713,sīdāpayati,sidapayati,1,1,0,0,10
94714,nisīdāpetuṃ,nisidapetum,5,5,0,0,11
94715,nisādetuṃ,nisadetum,2,1,1,0,9
94716,nisīdāpeti,nisidapeti,10,10,0,0,10
94717,nisīdāpetvā,nisidapetva,447,446,1,0,11
94718,nisādetvā,nisadetva,4,4,0,0,9
94719,atthānusāsati,atthanusasati,3,3,0,0,13
94720,nisīditvātipi,nisiditvatipi,1,1,0,0,13
94721,nisīditvāna,nisiditvana,12,12,0,0,11
94722,nisīdituna,nisidituna,1,1,0,0,10
94723,nisīdiya,nisidiya,29,29,0,0,8
94724,nisīdiyāna,nisidiyana,1,1,0,0,10
94725,saṃsīditvā,samsiditva,8,5,3,0,10
94726,avasīditvā,avasiditva,1,1,0,0,10
94727,osīditvā,osiditva,20,20,0,0,8
94728,kusītoti,kusitoti,7,1,6,0,8
94729,vīriyenādhigantabbassa,viriyenadhigantabbassa,1,1,0,0,22
94730,alābhato,alabhato,24,24,0,0,8
94731,sīdatīti,sidatiti,32,20,12,0,8
94732,sīdanassa,sidanassa,1,1,0,0,9
94733,sambhavatoti,sambhavatoti,29,23,6,0,12
94734,kaṭṭhamārūyha,katthamaruyha,1,1,0,0,13
94735,sīde,side,11,9,2,0,4
94736,mahaṇṇave,mahannave,55,54,1,0,9
94737,kusītamāgamma,kusitamagamma,8,8,0,0,13
94738,sādhajīvīpi,sadhajivipi,1,1,0,0,11
94739,sīdatī,sidati,7,7,0,0,6
94740,satasmīti,satasmiti,14,11,3,0,9
94741,aniccassetaṃ,aniccassetam,5,5,0,0,12
94742,sannisīvesūti,sannisivesuti,4,0,4,0,13
94743,parissamavinodanatthaṃ,parissamavinodanattham,8,8,0,0,22
94744,nisīdantesu,nisidantesu,4,4,0,0,11
94745,vissamamānesūti,vissamamanesuti,1,1,0,0,15
94746,nisīdanakriyā,nisidanakriya,2,2,0,0,13
94747,mañcapīṭhādikaṃ,mancapithadikam,5,5,0,0,15
94748,jāgarite,jagarite,47,40,7,0,8
94749,sampajānakārī,sampajanakari,285,248,37,0,13
94750,nisinnanti,nisinnanti,6,6,0,0,10
94751,upadahatītiādīsu,upadahatitiadisu,1,1,0,0,16
94752,gabhaṃ,gabham,1,1,0,0,6
94753,nisannaṃ,nisannam,1,1,0,0,8
94754,jāgaraṇaṃ,jagaranam,7,7,0,0,9
94755,jāgaritaṃ,jagaritam,13,12,1,0,9
94756,bhāsitanti,bhasitanti,35,35,0,0,10
94757,nisajjāti,nisajjati,6,5,1,0,9
94758,nisīdanā,nisidana,1,1,0,0,8
94759,gonisādoti,gonisadoti,1,0,1,0,10
94760,gonisajjanā,gonisajjana,1,1,0,0,11
94761,upanisāti,upanisati,14,2,12,0,9
94762,upanisīdati,upanisidati,17,17,0,0,11
94763,nisādetvāti,nisadetvati,2,0,2,0,11
94764,gatādīsupyayaṃ,gatadisupyayam,1,1,0,0,14
94765,cada,cada,1,0,1,0,4
94766,cadati,cadati,1,1,0,0,6
94767,meda,meda,1,0,1,0,4
94768,medhāhiṃsāsu,medhahimsasu,1,0,1,0,12
94769,nida,nida,1,0,1,0,4
94770,kucchāsannikarisesu,kucchasannikarisesu,1,0,1,0,19
94771,sannikarisaṃ,sannikarisam,1,0,1,0,12
94772,vohāraviseso,voharaviseso,1,1,0,0,12
94773,nidati,nidati,1,1,0,0,6
94774,nedati,nedati,1,1,0,0,6
94775,bundi,bundi,1,0,1,0,5
94776,bundati,bundati,1,1,0,0,7
94777,bondīti,bonditi,3,0,3,0,7
94778,bundāni,bundani,1,1,0,0,7
94779,tikkhāni,tikkhani,25,22,3,0,8
94780,pisuṇapharusavācādīni,pisunapharusavacadini,1,1,0,0,21
94781,paññāvīriyādīni,pannaviriyadini,1,1,0,0,15
94782,saññogaparattepi,sannogaparattepi,1,1,0,0,16
94783,pāpakalyāṇajanavasenesa,papakalyanajanavasenesa,1,1,0,0,23
94784,sarīravācakatā,sariravacakata,1,1,0,0,14
94785,apunappunaṃ,apunappunam,5,4,1,0,11
94786,hatthibondiṃ,hatthibondim,5,4,1,0,12
94787,pavekkhāmi,pavekkhami,9,8,1,0,10
94788,imānissa,imanissa,7,7,0,0,8
94789,bimbañca,bimbanca,2,2,0,0,8
94790,viggahaṃ,viggaham,64,59,5,0,8
94791,tathūpadhi,tathupadhi,1,1,0,0,10
94792,samussayoti,samussayoti,6,2,4,0,11
94793,dehanāmāni,dehanamani,1,1,0,0,10
94794,vajjati,vajjati,10,10,0,0,7
94795,ovadati,ovadati,190,185,5,0,7
94796,ovadeti,ovadeti,3,3,0,0,7
94797,paṭivadati,pativadati,5,5,0,0,10
94798,abhivadati,abhivadati,60,59,1,0,10
94799,anuvadati,anuvadati,38,38,0,0,9
94800,upavadati,upavadati,54,54,0,0,9
94801,apavadati,apavadati,10,10,0,0,9
94802,nivadati,nivadati,3,3,0,0,8
94803,vajjantu,vajjantu,8,7,1,0,8
94804,ammaṃ,ammam,19,19,0,0,5
94805,vajjetī,vajjeti,2,1,1,0,7
94806,yuttañce,yuttance,3,3,0,0,8
94807,ovadetīti,ovadetiti,1,0,1,0,9
94808,ovādeti,ovadeti,2,2,0,0,7
94809,vādayati,vadayati,6,6,0,0,8
94810,vādāpeti,vadapeti,4,4,0,0,8
94811,vādāpayati,vadapayati,1,1,0,0,10
94812,vajjento,vajjento,4,4,0,0,8
94813,vajjayanto,vajjayanto,2,2,0,0,10
94814,vadiyati,vadiyati,1,1,0,0,8
94815,ovadiyati,ovadiyati,1,1,0,0,9
94816,vajjiyati,vajjiyati,1,1,0,0,9
94817,vadiyamāno,vadiyamano,1,1,0,0,10
94818,vajjamāno,vajjamano,3,3,0,0,9
94819,ovadiyamāno,ovadiyamano,26,26,0,0,11
94820,ovajjamāno,ovajjamano,12,12,0,0,10
94821,ovādo,ovado,171,156,15,0,5
94822,paṭivādo,pativado,1,1,0,0,8
94823,pavādo,pavado,4,4,0,0,6
94824,nivādanaṃ,nivadanam,1,1,0,0,9
94825,vaditvā,vaditva,1,1,0,0,7
94826,vivaditvā,vivaditva,8,8,0,0,9
94827,vaditabbaṃ,vaditabbam,3,3,0,0,10
94828,saccavajjena,saccavajjena,83,83,0,0,12
94829,samaṅginī,samangini,5,5,0,0,9
94830,massañca,massanca,1,1,0,0,8
94831,sūkarādimukhaṃ,sukaradimukham,1,1,0,0,14
94832,tuṇḍamiti,tundamiti,1,1,0,0,9
94833,nādaṃ,nadam,35,35,0,0,5
94834,vadasi,vadasi,81,81,0,0,6
94835,vadate,vadate,20,12,8,0,6
94836,vadante,vadante,23,23,0,0,7
94837,vadase,vadase,4,4,0,0,6
94838,vadavhe,vadavhe,1,1,0,0,7
94839,vadamhe,vadamhe,1,1,0,0,7
94840,vadatu,vadatu,52,49,3,0,6
94841,vadantu,vadantu,48,48,0,0,7
94842,vadāhi,vadahi,4,4,0,0,6
94843,vadassu,vadassu,2,2,0,0,7
94844,vadavho,vadavho,1,1,0,0,7
94845,vadāmase,vadamase,1,1,0,0,8
94846,vajjanti,vajjanti,49,48,1,0,8
94847,vajjasi,vajjasi,1,1,0,0,7
94848,vajjatha,vajjatha,2,2,0,0,8
94849,vajjāma,vajjama,5,5,0,0,7
94850,vajjate,vajjate,1,1,0,0,7
94851,vajjante,vajjante,2,2,0,0,8
94852,vajjase,vajjase,1,1,0,0,7
94853,vajjavhe,vajjavhe,1,1,0,0,8
94854,vajje,vajje,41,38,3,0,5
94855,vajjamhe,vajjamhe,1,1,0,0,8
94856,vajjatu,vajjatu,1,1,0,0,7
94857,vajjāhi,vajjahi,1,1,0,0,7
94858,vajjataṃ,vajjatam,6,6,0,0,8
94859,vajjantaṃ,vajjantam,1,1,0,0,9
94860,vajjassu,vajjassu,1,1,0,0,8
94861,vajjavho,vajjavho,1,1,0,0,8
94862,vajjāmhase,vajjamhase,1,1,0,0,10
94863,sukhumatthavinicchayo,sukhumatthavinicchayo,1,1,0,0,21
94864,mānussakā,manussaka,11,11,0,0,9
94865,tūriyā,turiya,5,5,0,0,6
94866,vajjantīti,vajjantiti,10,2,8,0,10
94867,suddhakattupadaṃ,suddhakattupadam,4,4,0,0,16
94868,udīrayantu,udirayantu,4,4,0,0,10
94869,saṅkhapaṇavā,sankhapanava,3,3,0,0,12
94870,nadantu,nadantu,8,8,0,0,7
94871,bheī,bhei,1,1,0,0,4
94872,vaggū,vaggu,26,26,0,0,5
94873,dundubhī,dundubhi,8,8,0,0,8
94874,vajjiṃsūti,vajjimsuti,1,1,0,0,10
94875,atītavacane,atitavacane,3,3,0,0,11
94876,vattamānavacanaṃ,vattamanavacanam,54,51,3,0,16
94877,suddhakattuvasena,suddhakattuvasena,10,10,0,0,17
94878,paṇavā,panava,10,10,0,0,6
94879,diṇḍimā,dindima,2,2,0,0,7
94880,antalikkhamhi,antalikkhamhi,11,11,0,0,13
94881,disvānaccherakaṃ,disvanaccherakam,9,9,0,0,16
94882,hetukattupadaṃ,hetukattupadam,9,9,0,0,14
94883,vaṇṇasandhivisayattā,vannasandhivisayatta,1,1,0,0,20
94884,vādayantīti,vadayantiti,6,0,6,0,11
94885,kāritapadarūpena,karitapadarupena,1,1,0,0,16
94886,vādayantī,vadayanti,8,8,0,0,9
94887,hetukattuvasena,hetukattuvasena,14,14,0,0,15
94888,accherakaṃ,accherakam,21,18,3,0,10
94889,saṅkhapaṇavādīni,sankhapanavadini,1,1,0,0,16
94890,vajjantī,vajjanti,1,1,0,0,8
94891,suddhakattupadameva,suddhakattupadameva,1,1,0,0,19
94892,diṭṭhiparibbasānā,ditthiparibbasana,15,12,3,0,17
94893,vivādayantī,vivadayanti,2,2,0,0,11
94894,viggayha,viggayha,75,58,17,0,8
94895,dassanakriyāvacanato,dassanakriyavacanato,1,1,0,0,20
94896,saṅkhapaṇavādīnaṃ,sankhapanavadinam,1,1,0,0,17
94897,pāṭihāriyādidassanaṃ,patihariyadidassanam,1,1,0,0,20
94898,dassanacittassa,dassanacittassa,1,1,0,0,15
94899,abhāvatoti,abhavatoti,108,92,16,0,10
94900,rādante,radante,1,1,0,0,7
94901,ubbiddhā,ubbiddha,6,6,0,0,8
94902,upapajjateva,upapajjateva,1,1,0,0,12
94903,dassanavacanaṃ,dassanavacanam,5,5,0,0,14
94904,saṅgītiyo,sangitiyo,57,48,9,0,9
94905,anilañjase,anilanjase,33,32,1,0,10
94906,cammanaddhāni,cammanaddhani,3,3,0,0,13
94907,vādenti,vadenti,27,27,0,0,7
94908,iminnā,iminna,1,1,0,0,6
94909,vādentīti,vadentiti,4,2,2,0,9
94910,sapāṭhasesassa,sapathasesassa,1,1,0,0,14
94911,atthavivaraṇassa,atthavivaranassa,1,1,0,0,16
94912,kammavācakapadaṃ,kammavacakapadam,1,1,0,0,16
94913,niṭṭhamettha,nitthamettha,98,98,0,0,12
94914,dvigaṇiko,dviganiko,1,1,0,0,9
94915,gaṇiko,ganiko,2,2,0,0,6
94916,vattanto,vattanto,14,14,0,0,8
94917,vajjatī,vajjati,1,1,0,0,7
94918,vādeti,vadeti,17,14,3,0,6
94919,vādāpayatī,vadapayati,3,3,0,0,10
94920,hetukatturūpāni,hetukatturupani,11,11,0,0,15
94921,vādayatī,vadayati,5,5,0,0,8
94922,vajjeyyuṃ,vajjeyyum,12,12,0,0,9
94923,vajjuṃ,vajjum,31,20,11,0,6
94924,dajjunti,dajjunti,1,1,0,0,8
94925,rūhanā,ruhana,5,5,0,0,6
94926,vadeyyuṃvāti,vadeyyumvati,1,1,0,0,12
94927,vadeyyāsi,vadeyyasi,58,58,0,0,9
94928,vajjāsi,vajjasi,28,28,0,0,7
94929,vajjesi,vajjesi,19,19,0,0,7
94930,vāmūraṃ,vamuram,1,1,0,0,7
94931,vajjātha,vajjatha,6,6,0,0,8
94932,vadeyyāmi,vadeyyami,1,1,0,0,9
94933,vaderaṃ,vaderam,1,1,0,0,7
94934,vadetho,vadetho,1,1,0,0,7
94935,vadeyyāvho,vadeyyavho,1,1,0,0,10
94936,vajjāvho,vajjavho,1,1,0,0,8
94937,vadeyyāmhe,vadeyyamhe,1,1,0,0,10
94938,vajjāmhe,vajjamhe,2,2,0,0,8
94939,parokkhādirūpāni,parokkhadirupani,1,1,0,0,16
94940,pāvada,pavada,19,19,0,0,6
94941,babhuva,babhuva,15,15,0,0,7
94942,pāva,pava,22,15,7,0,4
94943,paṭipaṃ,patipam,2,2,0,0,7
94944,vadehi,vadehi,167,165,2,0,6
94945,pāvadati,pavadati,8,8,0,0,8
94946,pāvāti,pavati,17,2,15,0,6
94947,jānantopi,janantopi,76,76,0,0,9
94948,vattamānavacanavasena,vattamanavacanavasena,1,1,0,0,21
94949,vadatī,vadati,126,103,23,0,6
94950,vivaraṇamakāsi,vivaranamakasi,1,1,0,0,14
94951,kālavipallāsavasena,kalavipallasavasena,2,2,0,0,19
94952,nikkhipitvā,nikkhipitva,451,444,7,0,11
94953,vatasampanno,vatasampanno,12,12,0,0,12
94954,vattamānavacanena,vattamanavacanena,2,2,0,0,17
94955,dhātuvaseneva,dhatuvaseneva,9,6,3,0,13
94956,dhātuvasenapi,dhatuvasenapi,6,6,0,0,13
94957,parokkhābhūte,parokkhabhute,1,1,0,0,13
94958,sandhikiccaṃ,sandhikiccam,1,1,0,0,12
94959,tannipphannarūpassa,tannipphannarupassa,1,1,0,0,19
94960,nipphannarūpena,nipphannarupena,1,1,0,0,15
94961,samānarūpattā,samanarupatta,3,3,0,0,13
94962,pāvadatī,pavadati,2,2,0,0,8
94963,niddisīti,niddisiti,7,7,0,0,9
94964,vicchinnā,vicchinna,2,2,0,0,9
94965,vadittha,vadittha,3,3,0,0,8
94966,vadimha,vadimha,3,3,0,0,7
94967,vadire,vadire,1,1,0,0,6
94968,vadittho,vadittho,1,1,0,0,8
94969,vadivho,vadivho,1,1,0,0,7
94970,vadiṃ,vadim,4,4,0,0,5
94971,vadimhe,vadimhe,1,1,0,0,7
94972,pāvadu,pavadu,1,1,0,0,6
94973,pāvadittha,pavadittha,2,2,0,0,10
94974,pāvadimha,pavadimha,1,1,0,0,9
94975,pāvadire,pavadire,1,1,0,0,8
94976,pāvadittho,pavadittho,1,1,0,0,10
94977,pāvadivho,pavadivho,1,1,0,0,9
94978,pāvadiṃ,pavadim,3,3,0,0,7
94979,pāvadimhe,pavadimhe,1,1,0,0,9
94980,vajju,vajju,1,1,0,0,5
94981,avadā,avada,2,2,0,0,5
94982,avadū,avadu,2,2,0,0,5
94983,avajjā,avajja,2,2,0,0,6
94984,avajjū,avajju,2,2,0,0,6
94985,avadi,avadi,6,6,0,0,5
94986,avaduṃ,avadum,2,2,0,0,6
94987,avadiṃsu,avadimsu,3,3,0,0,8
94988,avajji,avajji,2,2,0,0,6
94989,vajji,vajji,3,3,0,0,5
94990,vadissati,vadissati,3,3,0,0,9
94991,vadissanti,vadissanti,5,5,0,0,10
94992,vajjissati,vajjissati,2,2,0,0,10
94993,vajjissanti,vajjissanti,1,1,0,0,11
94994,avadissā,avadissa,1,1,0,0,8
94995,vadissā,vadissa,1,1,0,0,7
94996,avajjissā,avajjissa,2,2,0,0,9
94997,vajjissā,vajjissa,1,1,0,0,8
94998,kālātipattirūpāni,kalatipattirupani,2,2,0,0,17
94999,bherivādako,bherivadako,2,2,0,0,11
95000,abyattasaddepi,abyattasaddepi,1,1,0,0,14
95001,upacaritavasenāti,upacaritavasenati,1,1,0,0,17
95002,pavedeti,pavedeti,71,71,0,0,8
95003,vedayanti,vedayanti,62,59,3,0,9
95004,tuṭṭhiṃ,tutthim,71,68,3,0,7
95005,mānusakā,manusaka,47,45,2,0,8
95006,pavedetīti,pavedetiti,14,1,13,0,10
95007,vedoti,vedoti,8,1,7,0,6
95008,sukhumampi,sukhumampi,17,17,0,0,10
95009,ājānātīti,ajanatiti,10,8,2,0,9
95010,vedehamunī,vedehamuni,5,5,0,0,10
95011,vedaganthassapi,vedaganthassapi,1,1,0,0,15
95012,uccāritamattena,uccaritamattena,1,1,0,0,15
95013,tadādhāraṃ,tadadharam,1,1,0,0,10
95014,kattabbakiccanti,kattabbakiccanti,1,1,0,0,16
95015,iruvedayajuvedasāmavedavasena,iruvedayajuvedasamavedavasena,1,1,0,0,29
95016,āthabbaṇavedaṃ,athabbanavedam,8,7,1,0,14
95017,paṇītajjhāsayā,panitajjhasaya,2,2,0,0,14
95018,sikkhanti,sikkhanti,89,89,0,0,9
95019,parūpaghātasahitattā,parupaghatasahitatta,1,1,0,0,20
95020,sutī,suti,3,3,0,0,4
95021,tuṭṭhiyaṃ,tutthiyam,3,1,2,0,9
95022,veda,veda,9,4,5,0,4
95023,pāvakepi,pavakepi,1,1,0,0,8
95024,jātasaddapurecaro,jatasaddapurecaro,1,1,0,0,17
95025,pacchānuge,pacchanuge,1,1,0,0,10
95026,tuṭṭhajanepi,tutthajanepi,1,1,0,0,12
95027,viditesu,viditesu,1,1,0,0,8
95028,vidūti,viduti,29,4,25,0,6
95029,paṇḍitamanusso,panditamanusso,4,4,0,0,14
95030,yathāsabhāvato,yathasabhavato,91,87,4,0,14
95031,kusalādibhede,kusaladibhede,5,5,0,0,13
95032,sakammikavasenimissā,sakammikavasenimissa,1,1,0,0,20
95033,rodanaṃ,rodanam,10,10,0,0,7
95034,rodanto,rodanto,38,38,0,0,7
95035,rodamāno,rodamano,33,32,1,0,8
95036,rodamānā,rodamana,48,48,0,0,8
95037,rudamukhā,rudamukha,7,7,0,0,9
95038,rudaṃ,rudam,31,26,5,0,5
95039,rudanto,rudanto,6,6,0,0,7
95040,rodāmi,rodami,60,58,2,0,6
95041,evamāha,evamaha,1600,1594,6,0,7
95042,parodāmi,parodami,3,3,0,0,8
95043,paridevāmi,paridevami,5,4,1,0,10
95044,anutthunāmī,anutthunami,3,2,1,0,11
95045,sakammikavasenattho,sakammikavasenattho,1,1,0,0,19
95046,assumuñcanamattena,assumuncanamattena,2,2,0,0,18
95047,jīvantaṃ,jivantam,54,49,5,0,8
95048,rodasī,rodasi,44,44,0,0,6
95049,ayañcettha,ayancettha,22,19,3,0,10
95050,maṭṭhakathā,matthakatha,1,0,1,0,11
95051,dhātusaddā,dhatusadda,7,7,0,0,10
95052,atthavisesavasena,atthavisesavasena,8,8,0,0,17
95053,vibuddho,vibuddho,9,9,0,0,8
95054,kamalasaṇḍo,kamalasando,4,4,0,0,11
95055,akammakāpi,akammakapi,6,6,0,0,10
95056,anutthuna,anutthuna,2,0,2,0,9
95057,purāṇāni,puranani,19,18,1,0,8
95058,anutthunanaṃ,anutthunanam,2,1,1,0,12
95059,rudanaṃ,rudanam,1,1,0,0,7
95060,duggatīti,duggatiti,13,8,5,0,9
95061,duggatiṃvinipātaṃ,duggatimvinipatam,1,1,0,0,17
95062,annapānādilābho,annapanadilabho,1,1,0,0,15
95063,daliddati,daliddati,1,1,0,0,9
95064,daliddī,daliddi,10,9,1,0,7
95065,daliddatīti,daliddatiti,1,0,1,0,11
95066,icchiticchitaṃ,icchiticchitam,33,32,1,0,14
95067,yācitvā,yacitva,360,360,0,0,7
95068,ayācitvāti,ayacitvati,1,1,0,0,10
95069,duliddoti,duliddoti,1,0,1,0,9
95070,duggatamanusso,duggatamanusso,15,15,0,0,14
95071,daliddīti,dalidditi,1,0,1,0,9
95072,duggatā,duggata,117,116,1,0,7
95073,daliddassa,daliddassa,28,27,1,0,10
95074,daliddatī,daliddati,2,2,0,0,9
95075,lokikappayogadassanato,lokikappayogadassanato,1,1,0,0,22
95076,nāmapadāniyeva,namapadaniyeva,1,1,0,0,14
95077,sāsanānulomattā,sasananulomatta,1,1,0,0,15
95078,kaccāyanamatavasena,kaccayanamatavasena,1,1,0,0,19
95079,duggatimhīti,duggatimhiti,1,0,1,0,12
95080,duggativācaka,duggativacaka,1,1,0,0,13
95081,dassesuṃ,dassesum,105,104,1,0,8
95082,vitudati,vitudati,9,9,0,0,8
95083,tujjati,tujjati,7,7,0,0,7
95084,vitujjamāno,vitujjamano,1,1,0,0,11
95085,vedanābhibhunno,vedanabhibhunno,1,1,0,0,15
95086,tudanti,tudanti,24,23,1,0,7
95087,saṅgāmagataṃva,sangamagatamva,3,2,1,0,14
95088,adhivāsaye,adhivasaye,5,3,2,0,10
95089,aduṭṭhacitto,adutthacitto,13,13,0,0,12
95090,cuṇṇikaraṇaṃ,cunnikaranam,3,3,0,0,12
95091,nudati,nudati,27,26,1,0,6
95092,panudati,panudati,6,6,0,0,8
95093,panudanaṃ,panudanam,4,4,0,0,9
95094,uṭṭhātā,utthata,28,26,2,0,7
95095,vindate,vindate,39,33,6,0,7
95096,parighāte,parighate,1,0,1,0,9
95097,parighātaṃ,parighatam,1,0,1,0,10
95098,dhakārantadhātu,dhakarantadhatu,2,2,0,0,15
95099,saṃvidheti,samvidheti,4,4,0,0,10
95100,nidhīyati,nidhiyati,4,3,1,0,9
95101,sunihito,sunihito,16,14,2,0,8
95102,parihari,parihari,14,14,0,0,8
95103,nidahati,nidahati,5,5,0,0,8
95104,nidahāmi,nidahami,7,7,0,0,8
95105,paridahati,paridahati,14,14,0,0,10
95106,paridahissati,paridahissati,16,16,0,0,13
95107,dhassati,dhassati,3,3,0,0,8
95108,paridhassati,paridhassati,5,5,0,0,12
95109,ambaṭṭha,ambattha,106,105,1,0,8
95110,ukkākaṃ,ukkakam,2,2,0,0,7
95111,pitāmahaṃ,pitamaham,23,20,3,0,9
95112,saddahati,saddahati,115,114,1,0,9
95113,saddhātabbaṃ,saddhatabbam,28,28,0,0,12
95114,saddahitabbaṃ,saddahitabbam,19,19,0,0,13
95115,saddhāyiko,saddhayiko,14,10,4,0,10
95116,paccayiko,paccayiko,50,50,0,0,9
95117,saddahituṃ,saddahitum,9,9,0,0,10
95118,visesādhānaṃ,visesadhanam,12,11,1,0,12
95119,sotāvadhānaṃ,sotavadhanam,72,61,11,0,12
95120,odahati,odahati,29,29,0,0,7
95121,ohitasoto,ohitasoto,51,51,0,0,9
95122,odahitvā,odahitva,30,30,0,0,8
95123,māradheyyaṃ,maradheyyam,39,25,14,0,11
95124,nidhānavatī,nidhanavati,7,1,6,0,11
95125,ādhānagāhī,adhanagahi,2,2,0,0,10
95126,karotya,karotya,2,1,1,0,7
95127,nyāsaṃ,nyasam,1,0,1,0,6
95128,nyāsāropanasandhisu,nyasaropanasandhisu,1,0,1,0,19
95129,iccupasaggassa,iccupasaggassa,2,2,0,0,14
95130,pidahanto,pidahanto,14,14,0,0,9
95131,pidahituṃ,pidahitum,27,27,0,0,9
95132,apidahitvā,apidahitva,9,9,0,0,10
95133,paṭisedhatthavācako,patisedhatthavacako,1,1,0,0,19
95134,upasaggāvayavo,upasaggavayavo,1,1,0,0,14
95135,adassanaṃ,adassanam,241,224,17,0,9
95136,niccālopo,niccalopo,1,1,0,0,9
95137,evarūpapopi,evarupapopi,1,1,0,0,11
95138,sandissati,sandissati,54,54,0,0,10
95139,hadayavimhāpanakaro,hadayavimhapanakaro,1,1,0,0,19
95140,upasagge,upasagge,2,2,0,0,8
95141,lopālopavasena,lopalopavasena,1,1,0,0,14
95142,tadākāravatiṃ,tadakaravatim,1,1,0,0,13
95143,jinavarapāḷiṃ,jinavarapalim,1,1,0,0,13
95144,ānayāma,anayama,1,1,0,0,7
95145,pidahissanti,pidahissanti,3,3,0,0,12
95146,apidhetuṃ,apidhetum,4,4,0,0,9
95147,mahāsindhuṃ,mahasindhum,4,4,0,0,11
95148,akkhātuṃ,akkhatum,19,19,0,0,8
95149,cittatthasādhaniṃ,cittatthasadhanim,1,1,0,0,17
95150,sambhavajātake,sambhavajatake,4,3,1,0,14
95151,paññāsambhavamicchanto,pannasambhavamicchanto,1,1,0,0,22
95152,avipariṇāmadhammo,aviparinamadhammo,47,47,0,0,17
95153,gatitheriyatthavasena,gatitheriyatthavasena,1,1,0,0,21
95154,nibbānasseva,nibbanasseva,59,55,4,0,12
95155,bhavitumarahati,bhavitumarahati,13,13,0,0,15
95156,jātijarābyādhimaraṇasokādito,jatijarabyadhimaranasokadito,1,1,0,0,28
95157,muccitukāmehi,muccitukamehi,3,3,0,0,13
95158,dhavitabbaṃ,dhavitabbam,1,1,0,0,11
95159,uppādavayābhāvena,uppadavayabhavena,2,2,0,0,17
95160,niccasabhāvattā,niccasabhavatta,9,9,0,0,15
95161,dhuvañca,dhuvanca,6,6,0,0,8
95162,dhuvagāminiñca,dhuvagamininca,1,1,0,0,14
95163,dhuva,dhuva,8,5,3,0,5
95164,dhuvasassataṃ,dhuvasassatam,36,33,3,0,13
95165,nipātapadabhāvena,nipatapadabhavena,1,1,0,0,17
95166,vidhūnane,vidhunane,2,0,2,0,9
95167,dhūvati,dhuvati,1,1,0,0,7
95168,dhūvitā,dhuvita,1,1,0,0,7
95169,dhūvitabbaṃ,dhuvitabbam,1,1,0,0,11
95170,dhuto,dhuto,60,53,7,0,5
95171,dhayati,dhayati,2,2,0,0,7
95172,dhena,dhena,1,1,0,0,5
95173,dhenūti,dhenuti,1,0,1,0,7
95174,potakoti,potakoti,3,3,0,0,8
95175,godhenu,godhenu,1,1,0,0,7
95176,assadhenu,assadhenu,1,1,0,0,9
95177,migadhenū,migadhenu,1,1,0,0,9
95178,sapotikāsu,sapotikasu,1,1,0,0,10
95179,tiracchānagatitthīsu,tiracchanagatitthisu,1,1,0,0,20
95180,dhenusate,dhenusate,3,3,0,0,9
95181,sedhati,sedhati,2,2,0,0,7
95182,nisedhati,nisedhati,3,3,0,0,9
95183,paṭisedhati,patisedhati,1,1,0,0,11
95184,nisiddho,nisiddho,2,2,0,0,8
95185,paṭisedhito,patisedhito,17,15,2,0,11
95186,paṭisedhako,patisedhako,12,11,1,0,11
95187,paṭisedhituṃ,patisedhitum,1,1,0,0,12
95188,paṭisedhitvā,patisedhitva,1,1,0,0,12
95189,acinteyyabalattā,acinteyyabalatta,1,1,0,0,16
95190,upasaggānaṃ,upasagganam,12,12,0,0,11
95191,taṃyoge,tamyoge,2,2,0,0,7
95192,maṅgalye,mangalye,2,1,1,0,8
95193,maṅgalyaṃ,mangalyam,4,2,2,0,9
95194,pāpavināsanaṃ,papavinasanam,1,1,0,0,13
95195,vuddhikāraṇaṃ,vuddhikaranam,4,4,0,0,13
95196,dadhateti,dadhateti,1,1,0,0,9
95197,dhakārassa,dhakarassa,5,5,0,0,10
95198,kāratte,karatte,2,2,0,0,7
95199,ayyikaṃ,ayyikam,9,9,0,0,7
95200,samādahātabbaṃ,samadahatabbam,8,8,0,0,14
95201,samādahaṃ,samadaham,36,31,5,0,9
95202,edha,edha,1,0,1,0,4
95203,edho,edho,2,2,0,0,4
95204,gādhamedhati,gadhamedhati,4,4,0,0,12
95205,edhoti,edhoti,1,0,1,0,6
95206,pāvakoti,pavakoti,5,3,2,0,8
95207,sukhedhitoti,sukhedhitoti,4,0,4,0,12
95208,edhito,edhito,3,3,0,0,6
95209,sukhasaṃvaḍḍhitoti,sukhasamvaddhitoti,3,3,0,0,18
95210,gādhamedhatīti,gadhamedhatiti,2,0,2,0,14
95211,saṃharise,samharise,2,0,2,0,9
95212,saṃhariso,samhariso,2,0,2,0,9
95213,vinibaddhakriyā,vinibaddhakriya,1,1,0,0,15
95214,baddhati,baddhati,2,2,0,0,8
95215,vinibaddhati,vinibaddhati,1,1,0,0,12
95216,vinibaddhā,vinibaddha,10,10,0,0,10
95217,patiṭṭhānissayagandhesu,patitthanissayagandhesu,1,0,1,0,23
95218,vibādhati,vibadhati,23,23,0,0,9
95219,ābādhati,abadhati,2,2,0,0,8
95220,viloḷetīti,viloletiti,1,1,0,0,10
95221,yācanādīsu,yacanadisu,1,0,1,0,10
95222,nādhati,nadhati,4,3,1,0,7
95223,nādhanaṃ,nadhanam,1,1,0,0,8
95224,bandhanako,bandhanako,1,1,0,0,10
95225,bandhāpito,bandhapito,5,5,0,0,10
95226,paṭibandho,patibandho,4,4,0,0,10
95227,sambandhanaṃ,sambandhanam,4,4,0,0,12
95228,saṅkhalikādi,sankhalikadi,1,1,0,0,12
95229,sambandhitabbaṭṭhena,sambandhitabbatthena,1,1,0,0,20
95230,theragāthāsaṃvaṇṇanāyaṃ,theragathasamvannanayam,4,1,3,0,23
95231,pemabandhanena,pemabandhanena,2,2,0,0,14
95232,asīghacāre,asighacare,1,0,1,0,10
95233,asīghacāro,asighacaro,1,0,1,0,10
95234,asīghappavatti,asighappavatti,5,5,0,0,14
95235,dandhapañño,dandhapanno,6,6,0,0,11
95236,vaddhati,vaddhati,3,3,0,0,8
95237,jātivuddho,jativuddho,3,2,1,0,10
95238,guṇavuddho,gunavuddho,3,2,1,0,10
95239,vuddhamapacāyanti,vuddhamapacayanti,2,2,0,0,17
95240,pāsaṃsā,pasamsa,68,64,4,0,7
95241,suggatiṃ,suggatim,63,59,4,0,8
95242,sadhu,sadhu,3,0,3,0,5
95243,saddakucchiyaṃ,saddakucchiyam,1,0,1,0,14
95244,sadhati,sadhati,2,2,0,0,7
95245,piḷadhi,piladhi,1,0,1,0,7
95246,piḷandhati,pilandhati,2,2,0,0,10
95247,piḷandhanaṃ,pilandhanam,70,68,2,0,11
95248,piḷandhanamalaṅkāro,pilandhanamalankaro,1,1,0,0,19
95249,maṇḍanañca,mandananca,1,1,0,0,10
95250,pasādhanañcābharaṇaṃ,pasadhanancabharanam,1,1,0,0,20
95251,medhati,medhati,21,21,0,0,7
95252,medhāti,medhati,8,2,6,0,7
95253,siluccaye,siluccaye,19,18,1,0,9
95254,sappurisadhammehi,sappurisadhammehi,2,2,0,0,17
95255,ekikā,ekika,49,49,0,0,5
95256,anvāyikā,anvayika,13,12,1,0,8
95257,paññavato,pannavato,56,54,2,0,9
95258,dhammojapaññāya,dhammojapannaya,24,24,0,0,15
95259,bodhane,bodhane,11,8,3,0,7
95260,bodhati,bodhati,2,2,0,0,7
95261,abhisambuddhāno,abhisambuddhano,3,3,0,0,15
95262,asambuddhaṃ,asambuddham,10,7,3,0,11
95263,tatrahi,tatrahi,1,1,0,0,7
95264,bujjhatī,bujjhati,15,14,1,0,8
95265,bodhatī,bodhati,1,1,0,0,7
95266,apabodhatī,apabodhati,1,1,0,0,10
95267,yodhati,yodhati,1,1,0,0,7
95268,yodhetha,yodhetha,10,10,0,0,8
95269,caraṇāyudho,caranayudho,2,2,0,0,11
95270,caraṇāvudho,caranavudho,1,1,0,0,11
95271,gaṇikassa,ganikassa,5,5,0,0,9
95272,yujjhatī,yujjhati,1,1,0,0,8
95273,dīdhi,didhi,1,0,1,0,5
95274,dittivedhanesu,dittivedhanesu,1,0,1,0,14
95275,dīdhati,didhati,1,1,0,0,7
95276,dīdhitīti,didhititi,1,0,1,0,9
95277,rasmināmāni,rasminamani,1,1,0,0,11
95278,bhāṇva,bhanva,1,1,0,0,6
95279,nāgadhāmo,nagadhamo,1,1,0,0,9
95280,rasmivācakā,rasmivacaka,1,1,0,0,11
95281,cakārantarūpāni,cakarantarupani,1,1,0,0,15
95282,nakārantadhātu,nakarantadhatu,3,3,0,0,14
95283,āneti,aneti,26,25,1,0,5
95284,ānayati,anayati,4,4,0,0,7
95285,neyyo,neyyo,111,83,28,0,5
95286,veneyyo,veneyyo,5,5,0,0,7
95287,nīyamāne,niyamane,19,19,0,0,8
95288,pisācena,pisacena,12,12,0,0,8
95289,udikkhati,udikkhati,39,39,0,0,9
95290,nīyanto,niyanto,1,1,0,0,7
95291,samūhatā,samuhata,167,164,3,0,8
95292,udakañhi,udakanhi,20,15,5,0,8
95293,nettikā,nettika,19,14,5,0,7
95294,netuṃ,netum,34,32,2,0,5
95295,vinetuṃ,vinetum,86,80,6,0,7
95296,vinetvā,vinetva,59,59,0,0,7
95297,nettīti,nettiti,11,9,2,0,7
95298,bhavanettīti,bhavanettiti,13,4,9,0,12
95299,bhavarajju,bhavarajju,6,6,0,0,10
95300,taṇhāyetaṃ,tanhayetam,18,15,3,0,10
95301,nettikāti,nettikati,3,0,3,0,9
95302,kassakā,kassaka,48,48,0,0,7
95303,nettāti,nettati,1,0,1,0,7
95304,gavajeṭṭhako,gavajetthako,1,1,0,0,12
95305,nayoti,nayoti,286,87,199,0,6
95306,pāḷigati,paligati,8,8,0,0,8
95307,netabbākāro,netabbakaro,1,1,0,0,11
95308,tathattanayādi,tathattanayadi,2,2,0,0,14
95309,antadvayavivajjananayādi,antadvayavivajjananayadi,1,1,0,0,24
95310,tathattanayo,tathattanayo,2,1,1,0,12
95311,pattinayo,pattinayo,2,1,1,0,9
95312,desanānayo,desananayo,18,15,3,0,10
95313,antadvayavivajjananayo,antadvayavivajjananayo,1,1,0,0,22
95314,acinteyyanayo,acinteyyanayo,1,1,0,0,13
95315,adhippāyanayoti,adhippayanayoti,1,1,0,0,15
95316,antadvayavivajjananayena,antadvayavivajjananayena,1,1,0,0,24
95317,acinteyyanayena,acinteyyanayena,1,1,0,0,15
95318,adhippāyanayena,adhippayanayena,1,1,0,0,15
95319,kammasādhanena,kammasadhanena,4,4,0,0,14
95320,karaṇasādhanena,karanasadhanena,3,3,0,0,15
95321,tathattādinayattayamiti,tathattadinayattayamiti,1,1,0,0,23
95322,papañciyamāne,papanciyamane,1,1,0,0,13
95323,ekattanayo,ekattanayo,14,10,4,0,10
95324,nānattanayo,nanattanayo,9,5,4,0,11
95325,abyāpāranayo,abyaparanayo,10,5,5,0,12
95326,evaṃdhammatānayoti,evamdhammatanayoti,4,4,0,0,18
95327,kāyavācānaṃ,kayavacanam,34,34,0,0,11
95328,vinayanatopi,vinayanatopi,1,1,0,0,12
95329,anamatagge,anamatagge,112,110,2,0,10
95330,nayateva,nayateva,1,1,0,0,8
95331,pavattatevāti,pavattatevati,3,3,0,0,13
95332,āyatananti,ayatananti,64,63,1,0,10
95333,sañjātiṭṭhānaṃ,sanjatitthanam,3,3,0,0,14
95334,āyaanaṃ,ayaanam,1,1,0,0,7
95335,chāyaṃ,chayam,75,69,6,0,6
95336,chāyatthino,chayatthino,4,4,0,0,11
95337,phalatthaṃ,phalattham,3,3,0,0,10
95338,phalabhojino,phalabhojino,4,4,0,0,12
95339,pañcimāni,pancimani,162,156,6,0,9
95340,vimuttāyatanānī,vimuttayatanani,3,3,0,0,15
95341,patiyataneti,patiyataneti,1,0,1,0,12
95342,navati,navati,1,1,0,0,6
95343,nuto,nuto,1,1,0,0,4
95344,thanati,thanati,1,1,0,0,7
95345,dittikantīsu,dittikantisu,2,1,1,0,12
95346,yobbanibhāve,yobbanibhave,1,1,0,0,12
95347,rūpavilāsena,rupavilasena,1,1,0,0,12
95348,kāmiyabhi,kamiyabhi,1,1,0,0,9
95349,abhipatthiyati,abhipatthiyati,1,1,0,0,14
95350,purisehītipi,purisehitipi,1,1,0,0,12
95351,kanīyatīti,kaniyatiti,1,1,0,0,10
95352,haṭakampi,hatakampi,1,1,0,0,9
95353,tapanīyaṃ,tapaniyam,4,4,0,0,9
95354,tabbhedakā,tabbhedaka,1,1,0,0,10
95355,siṅgikañca,singikanca,1,1,0,0,10
95356,cāmikaranti,camikaranti,1,1,0,0,11
95357,sanati,sanati,1,1,0,0,6
95358,sambhajanti,sambhajanti,7,7,0,0,11
95359,mayūrakokilādayo,mayurakokiladayo,1,1,0,0,16
95360,sambhajati,sambhajati,2,2,0,0,10
95361,saṃkilesapuggalanti,samkilesapuggalanti,1,1,0,0,19
95362,janati,janati,7,7,0,0,6
95363,sunati,sunati,4,4,0,0,6
95364,janatī,janati,3,3,0,0,6
95365,janatīti,janatiti,2,0,2,0,8
95366,kāyikacetasikasukhanti,kayikacetasikasukhanti,1,1,0,0,22
95367,aññamaññapaṭipakkhā,annamannapatipakkha,1,1,0,0,19
95368,samāsapaavasena,samasapaavasena,1,1,0,0,15
95369,khamassāti,khamassati,3,3,0,0,10
95370,nibbacanānipi,nibbacananipi,1,1,0,0,13
95371,nimittañca,nimittanca,30,27,3,0,10
95372,dānati,danati,1,1,0,0,6
95373,apadānaṃ,apadanam,283,274,9,0,8
95374,tejane,tejane,4,3,1,0,6
95375,sānati,sanati,1,1,0,0,6
95376,pharusāya,pharusaya,157,157,0,0,9
95377,pīḷanañca,pilananca,2,2,0,0,9
95378,paharaṇañca,paharananca,3,3,0,0,11
95379,hiṃsāpaharaṇagatīsūti,himsapaharanagatisuti,1,0,1,0,21
95380,haneyyuṃ,haneyyum,26,17,9,0,8
95381,bandheyyuṃ,bandheyyum,20,17,3,0,10
95382,potheyyuñceva,potheyyunceva,4,3,1,0,13
95383,chindeyyuñcā,chindeyyunca,3,2,1,0,12
95384,hatthapādādichedanaṃ,hatthapadadichedanam,2,2,0,0,20
95385,sīsacchedavasena,sisacchedavasena,1,1,0,0,16
95386,hanasi,hanasi,11,9,2,0,6
95387,pādehī,padehi,4,4,0,0,6
95388,paharatīti,paharatiti,5,2,3,0,10
95389,mārentīti,marentiti,4,3,1,0,9
95390,vadheti,vadheti,16,16,0,0,7
95391,dukkaṭassa,dukkatassa,1793,1791,2,0,10
95392,rodatī,rodati,13,13,0,0,6
95393,pāṇavadho,panavadho,13,12,1,0,9
95394,khaṇḍahālassa,khandahalassa,40,40,0,0,13
95395,ghātetī,ghateti,2,1,1,0,7
95396,hanavadha,hanavadha,1,0,1,0,9
95397,saddatthogamanaṃ,saddatthogamanam,1,1,0,0,16
95398,vātātape,vatatape,37,35,2,0,8
95399,ghore,ghore,24,24,0,0,5
95400,paccattavacanassekārattaṃ,paccattavacanassekarattam,1,1,0,0,25
95401,vihārenāti,viharenati,8,3,5,0,10
95402,hanitvā,hanitva,21,21,0,0,7
95403,vajjhetvā,vajjhetva,1,1,0,0,9
95404,sanāmikāni,sanamikani,1,1,0,0,10
95405,tumantādipadāni,tumantadipadani,1,1,0,0,15
95406,upahananti,upahananti,8,7,1,0,10
95407,vadhūti,vadhuti,5,1,4,0,7
95408,kilesavasena,kilesavasena,141,137,4,0,12
95409,sunakhampi,sunakhampi,3,3,0,0,10
95410,upagamanasīlāti,upagamanasilati,2,2,0,0,15
95411,sādhāraṇametaṃ,sadharanametam,2,2,0,0,14
95412,āroceyyāsī,aroceyyasi,30,30,0,0,10
95413,sassusasurehi,sassusasurehi,2,2,0,0,13
95414,adhigantabbā,adhigantabba,11,10,1,0,12
95415,jānitabbāti,janitabbati,23,10,13,0,11
95416,buddhiyatthakathanato,buddhiyatthakathanato,1,1,0,0,21
95417,suṇhā,sunha,20,20,0,0,5
95418,bhikkhusamūho,bhikkhusamuho,4,4,0,0,13
95419,maggāsinā,maggasina,1,1,0,0,9
95420,māretītipi,maretitipi,1,1,0,0,10
95421,puthujjanāriyavasena,puthujjanariyavasena,1,1,0,0,20
95422,vividhe,vividhe,23,21,2,0,7
95423,āhanati,ahanati,13,13,0,0,7
95424,ghātetīti,ghatetiti,9,3,6,0,9
95425,viyaggho,viyaggho,1,1,0,0,8
95426,vaggho,vaggho,1,1,0,0,6
95427,puṇḍarīkoti,pundarikoti,7,5,2,0,11
95428,dubbale,dubbale,16,16,0,0,7
95429,paṭihaññatī,patihannati,8,6,2,0,11
95430,pāṇanaṃ,pananam,4,2,2,0,7
95431,assāsoti,assasoti,16,2,14,0,8
95432,nikkhamanavāto,nikkhamanavato,5,5,0,0,14
95433,pavisanavāto,pavisanavato,5,5,0,0,12
95434,suttantaṭṭhakathāsu,suttantatthakathasu,4,1,3,0,19
95435,gabbhaseyyakānaṃ,gabbhaseyyakanam,58,54,4,0,16
95436,abbhantaravāto,abbhantaravato,5,4,1,0,14
95437,bāhiravāto,bahiravato,4,4,0,0,10
95438,pavisanto,pavisanto,158,153,5,0,9
95439,nibbāyati,nibbayati,53,53,0,0,9
95440,nayesu,nayesu,49,49,0,0,6
95441,vinayanayena,vinayanayena,4,4,0,0,12
95442,uṭṭhitasasanaṃ,utthitasasanam,6,6,0,0,14
95443,uṭṭhahitvāpi,utthahitvapi,8,8,0,0,12
95444,sasanato,sasanato,11,11,0,0,8
95445,assāsādimajjhapariyosānaṃ,assasadimajjhapariyosanam,11,9,2,0,25
95446,anugacchato,anugacchato,21,21,0,0,11
95447,vikkhepagatena,vikkhepagatena,16,14,2,0,14
95448,kāyopi,kayopi,136,125,11,0,6
95449,sāraddhā,saraddha,32,30,2,0,8
95450,iñjitā,injita,44,41,3,0,6
95451,phanditā,phandita,33,30,3,0,8
95452,passāsādimajjhapariyosānaṃ,passasadimajjhapariyosanam,9,8,1,0,26
95453,siripuññapaññānaṃ,siripunnapannanam,1,1,0,0,17
95454,dhātuattho,dhatuattho,9,8,1,0,10
95455,vakkarukkhataceti,vakkarukkhataceti,1,0,1,0,17
95456,evamādippabhedaṃ,evamadippabhedam,1,1,0,0,16
95457,evamidha,evamidha,104,103,1,0,8
95458,dhanino,dhanino,10,10,0,0,7
95459,dhanti,dhanti,1,1,0,0,6
95460,siripuññapaññāsampadā,siripunnapannasampada,2,2,0,0,21
95461,siripaññāva,siripannava,1,1,0,0,11
95462,nadato,nadato,16,16,0,0,6
95463,parisāyante,parisayante,1,1,0,0,11
95464,vāditabbapahārino,vaditabbapaharino,3,3,0,0,17
95465,narapuṅgava,narapungava,3,3,0,0,11
95466,tambanakhe,tambanakhe,5,5,0,0,10
95467,āyatapaṇhike,ayatapanhike,3,3,0,0,12
95468,paṇamissanti,panamissanti,3,3,0,0,12
95469,guṇandhara,gunandhara,3,3,0,0,10
95470,pahaṭṭhāni,pahatthani,3,3,0,0,10
95471,dosagghāni,dosagghani,3,3,0,0,10
95472,hitāni,hitani,17,17,0,0,6
95473,yetevākyāni,yetevakyani,1,1,0,0,11
95474,sossanti,sossanti,7,7,0,0,8
95475,dhaññānaruttamā,dhannanaruttama,1,1,0,0,15
95476,puññasampadā,punnasampada,6,5,1,0,12
95477,puññasampadāya,punnasampadaya,6,6,0,0,14
95478,siripaññāsampadāpi,siripannasampadapi,1,1,0,0,18
95479,maṅgalasammataṃ,mangalasammatam,10,9,1,0,15
95480,uttamaratanaṃ,uttamaratanam,5,5,0,0,13
95481,dhanāyitabbaṃ,dhanayitabbam,4,4,0,0,13
95482,saddhāyitabbanti,saddhayitabbanti,1,1,0,0,16
95483,sirisampannaṃ,sirisampannam,1,1,0,0,13
95484,puññasampannaṃ,punnasampannam,1,1,0,0,14
95485,paññāsampannantipi,pannasampannantipi,1,1,0,0,18
95486,dhaññasamaṃ,dhannasamam,7,6,1,0,11
95487,dhanāyitabbanti,dhanayitabbanti,1,1,0,0,15
95488,pubbaṇṇaṃ,pubbannam,36,25,11,0,9
95489,osadhivisesopi,osadhivisesopi,1,1,0,0,14
95490,adhano,adhano,8,8,0,0,6
95491,daliddapuggalo,daliddapuggalo,1,1,0,0,14
95492,tiettha,tiettha,25,25,0,0,7
95493,kampanatthavācakassa,kampanatthavacakassa,1,1,0,0,20
95494,cine,cine,1,0,1,0,4
95495,maññanāyaṃ,mannanayam,2,1,1,0,10
95496,aluttantoyaṃ,aluttantoyam,2,2,0,0,12
95497,gile,gile,4,1,3,0,4
95498,mile,mile,3,1,2,0,4
95499,cināyati,cinayati,1,1,0,0,8
95500,ocināyati,ocinayati,1,1,0,0,9
95501,ocināyatū,ocinayatu,1,1,0,0,9
95502,ocināyatati,ocinayatati,1,0,1,0,11
95503,avamaññatūti,avamannatuti,1,1,0,0,12
95504,pakārantadhātu,pakarantadhatu,5,5,0,0,14
95505,pāntu,pantu,1,1,0,0,5
95506,pasārehi,pasarehi,14,14,0,0,8
95507,ayañhite,ayanhite,1,1,0,0,8
95508,rūḷho,rulho,2,2,0,0,5
95509,pāssati,passati,2,2,0,0,7
95510,lohitanti,lohitanti,3,3,0,0,9
95511,pāssatīti,passatiti,1,0,1,0,9
95512,pāssanti,passanti,1,1,0,0,8
95513,pāssasi,passasi,1,1,0,0,7
95514,pāssatha,passatha,1,1,0,0,8
95515,pāssāmi,passami,1,1,0,0,7
95516,pāssāma,passama,1,1,0,0,7
95517,apassā,apassa,2,2,0,0,6
95518,apassaṃsu,apassamsu,1,1,0,0,9
95519,vippakiṇṇarūpantararatanāni,vippakinnarupantararatanani,1,1,0,0,27
95520,gahaṇūpāyamattameva,gahanupayamattameva,1,1,0,0,19
95521,pivaṃ,pivam,11,9,2,0,5
95522,bhāgirasodakaṃ,bhagirasodakam,2,2,0,0,14
95523,pāyeti,payeti,12,12,0,0,6
95524,taṇhāsamanaṃ,tanhasamanam,1,1,0,0,12
95525,pāyito,payito,4,4,0,0,6
95526,mādīsu,madisu,2,2,0,0,6
95527,pivituṃ,pivitum,37,36,1,0,7
95528,pitvā,pitva,67,63,4,0,5
95529,pāyetvā,payetva,97,96,1,0,7
95530,nipāti,nipati,5,5,0,0,6
95531,vippāti,vippati,1,1,0,0,7
95532,vippoti,vippoti,2,0,2,0,7
95533,vippeti,vippeti,1,1,0,0,7
95534,veduccāraṇādinā,veduccaranadina,1,1,0,0,15
95535,brāhmaṇakammena,brahmanakammena,1,1,0,0,15
95536,vedānīti,vedaniti,2,1,1,0,8
95537,vippakule,vippakule,13,13,0,0,9
95538,kiyā,kiya,1,0,1,0,4
95539,digaṇaṃ,diganam,1,1,0,0,7
95540,punātī,punati,1,1,0,0,6
95541,trajo,trajo,6,6,0,0,5
95542,puttanattādayo,puttanattadayo,5,5,0,0,14
95543,apaccanti,apaccanti,10,10,0,0,9
95544,puttīti,puttiti,1,1,0,0,7
95545,atrajāti,atrajati,4,3,1,0,8
95546,sesaṭṭhānesu,sesatthanesu,15,14,1,0,12
95547,yathārahamudīraye,yatharahamudiraye,1,1,0,0,17
95548,sattarattassa,sattarattassa,3,3,0,0,13
95549,vedehassatrajā,vedehassatraja,3,3,0,0,14
95550,dhātimātaramabravī,dhatimataramabravi,1,1,0,0,18
95551,attajā,attaja,2,2,0,0,6
95552,labbhamānālabbhamānavasena,labbhamanalabbhamanavasena,2,2,0,0,26
95553,vessī,vessi,6,6,0,0,5
95554,kiṃpurisī,kimpurisi,1,1,0,0,9
95555,niruttilakkhaṇassito,niruttilakkhanassito,1,1,0,0,20
95556,janapūjādito,janapujadito,1,1,0,0,12
95557,attakāraṃ,attakaram,1,1,0,0,9
95558,subhamicceva,subhamicceva,1,1,0,0,12
95559,kusalassādhivacanaṃ,kusalassadhivacanam,1,1,0,0,19
95560,peti,peti,2,2,0,0,4
95561,penti,penti,1,1,0,0,5
95562,petha,petha,1,1,0,0,5
95563,assakhaḷuṅko,assakhalunko,39,37,2,0,12
95564,pehīti,pehiti,2,1,1,0,6
95565,codito,codito,237,230,7,0,6
95566,sārathinā,sarathina,45,43,2,0,9
95567,paṭisakkati,patisakkati,1,1,0,0,11
95568,paṭivatteti,pativatteti,1,1,0,0,11
95569,ummaggaṃ,ummaggam,14,13,1,0,8
95570,ubbaṭumaṃ,ubbatumam,4,3,1,0,9
95571,apāyoti,apayoti,12,0,12,0,7
95572,vuddhito,vuddhito,1,1,0,0,8
95573,nirayatiracchānayonipettivisayaasurakāyā,nirayatiracchanayonipettivisayaasurakaya,4,4,0,0,40
95574,pāyati,payati,3,3,0,0,6
95575,nipayati,nipayati,4,4,0,0,8
95576,visoseti,visoseti,14,14,0,0,8
95577,gopako,gopako,19,19,0,0,6
95578,sāntarabāhiraṃ,santarabahiram,1,1,0,0,14
95579,gopetha,gopetha,9,9,0,0,7
95580,upaccagā,upaccaga,69,60,9,0,8
95581,gopethāti,gopethati,2,1,1,0,9
95582,gopeyya,gopeyya,7,7,0,0,7
95583,cupa,cupa,3,2,1,0,4
95584,mandagatiyaṃ,mandagatiyam,1,0,1,0,12
95585,copati,copati,1,1,0,0,6
95586,tupa,tupa,1,0,1,0,4
95587,topati,topati,1,1,0,0,6
95588,tuppati,tuppati,1,1,0,0,7
95589,gopanajigucchanesu,gopanajigucchanesu,1,0,1,0,18
95590,jigucchaṃ,jiguccham,10,10,0,0,9
95591,jegucchī,jegucchi,27,26,1,0,8
95592,jigucchitvā,jigucchitva,30,29,1,0,11
95593,hiṃsātakkalagandhesu,himsatakkalagandhesu,2,1,1,0,20
95594,kāpaññaṃ,kapannam,2,1,1,0,8
95595,karuṇāyati,karunayati,6,6,0,0,10
95596,kapaṇabhāvo,kapanabhavo,1,1,0,0,11
95597,abhisapatho,abhisapatho,1,1,0,0,11
95598,abhisapito,abhisapito,8,8,0,0,10
95599,sapanako,sapanako,1,1,0,0,8
95600,vāpako,vapako,1,1,0,0,6
95601,vāpitaṃ,vapitam,20,18,2,0,7
95602,vappati,vappati,12,12,0,0,7
95603,vappamaṅgalaṃ,vappamangalam,11,8,3,0,13
95604,supati,supati,91,86,5,0,6
95605,bajjhare,bajjhare,8,8,0,0,8
95606,khepati,khepati,1,1,0,0,7
95607,khepako,khepako,2,2,0,0,7
95608,khipitasaddo,khipitasaddo,12,12,0,0,12
95609,khipi,khipi,159,157,2,0,5
95610,lokagganāyako,lokagganayako,44,44,0,0,13
95611,chaḍḍano,chaddano,1,0,1,0,8
95612,ukkhipati,ukkhipati,91,90,1,0,9
95613,avakhipati,avakhipati,1,1,0,0,10
95614,saṃkhipati,samkhipati,6,6,0,0,10
95615,ukkhittaṃ,ukkhittam,53,48,5,0,9
95616,vikkhittaṃ,vikkhittam,98,89,9,0,10
95617,opa,opa,1,0,1,0,3
95618,niṭṭhubhane,nitthubhane,3,1,2,0,11
95619,niṭṭhubhanaṃ,nitthubhanam,5,3,2,0,12
95620,kheḷapātanaṃ,khelapatanam,3,3,0,0,12
95621,opati,opati,1,1,0,0,5
95622,saṅkharitvā,sankharitva,12,12,0,0,11
95623,kheḷaṃ,khelam,119,114,5,0,6
95624,opi,opi,3,3,0,0,3
95625,upalepe,upalepe,1,0,1,0,7
95626,lepati,lepati,1,1,0,0,6
95627,littaṃ,littam,14,11,3,0,6
95628,khimpati,khimpati,1,1,0,0,8
95629,ḍipa,dipa,2,0,2,0,4
95630,ḍepati,depati,1,1,0,0,6
95631,nidapi,nidapi,1,0,1,0,6
95632,nidampane,nidampane,1,0,1,0,9
95633,nidampanaṃ,nidampanam,1,0,1,0,10
95634,sassarukkhādīsu,sassarukkhadisu,1,1,0,0,15
95635,varakasīsaṃ,varakasisam,1,1,0,0,11
95636,acchinditvā,acchinditva,127,123,4,0,11
95637,khuddakasākhaṃ,khuddakasakham,1,1,0,0,14
95638,yathāṭhitameva,yathathitameva,5,5,0,0,14
95639,bījamattasseva,bijamattasseva,3,3,0,0,14
95640,paṇṇamattasseva,pannamattasseva,1,1,0,0,15
95641,nidampati,nidampati,2,2,0,0,9
95642,rukkhapattaṃ,rukkhapattam,1,1,0,0,12
95643,nidampako,nidampako,1,1,0,0,9
95644,nidampitaṃ,nidampitam,1,1,0,0,10
95645,nidampituṃ,nidampitum,1,1,0,0,10
95646,nidampitvā,nidampitva,2,2,0,0,10
95647,tapatiādicco,tapatiadicco,1,1,0,0,12
95648,utrāso,utraso,16,14,2,0,6
95649,bhīrutā,bhiruta,4,4,0,0,7
95650,uttapati,uttapati,1,1,0,0,8
95651,tapodhanaṃ,tapodhanam,6,6,0,0,10
95652,sandhūpano,sandhupano,1,1,0,0,10
95653,tāpiyati,tapiyati,1,1,0,0,8
95654,dhūpiyati,dhupiyati,1,1,0,0,9
95655,tāpanaṃ,tapanam,8,8,0,0,7
95656,santāpo,santapo,33,21,12,0,7
95657,dhūpanaṃ,dhupanam,2,2,0,0,8
95658,phakārantadhātu,phakarantadhatu,1,1,0,0,15
95659,akammako,akammako,5,5,0,0,8
95660,pupphanaṃ,pupphanam,5,5,0,0,9
95661,pupphituṃ,pupphitum,6,5,1,0,9
95662,pupphitvā,pupphitva,3,3,0,0,9
95663,pupphino,pupphino,11,10,1,0,8
95664,mañjūsako,manjusako,15,14,1,0,9
95665,yattakāni,yattakani,57,53,4,0,9
95666,tupha,tupha,1,0,1,0,5
95667,tophati,tophati,1,1,0,0,7
95668,dapha,dapha,1,0,1,0,5
95669,daphi,daphi,1,0,1,0,5
95670,vappha,vappha,1,0,1,0,6
95671,daphati,daphati,1,1,0,0,7
95672,damphati,damphati,1,1,0,0,8
95673,vapphati,vapphati,1,1,0,0,8
95674,dipha,dipha,1,0,1,0,5
95675,kathanayuddhanindāhiṃsādānesu,kathanayuddhanindahimsadanesu,1,0,1,0,29
95676,dephati,dephati,1,1,0,0,7
95677,depho,depho,1,1,0,0,5
95678,tapha,tapha,1,0,1,0,5
95679,taphati,taphati,1,1,0,0,7
95680,dupha,dupha,1,0,1,0,5
95681,upakkilese,upakkilese,73,66,7,0,10
95682,upakkilissanaṃ,upakkilissanam,1,1,0,0,14
95683,upakkileso,upakkileso,246,241,5,0,10
95684,dophati,dophati,1,1,0,0,7
95685,gupha,gupha,1,0,1,0,5
95686,ganthikaraṇaṃ,ganthikaranam,2,2,0,0,13
95687,gophati,gophati,1,1,0,0,7
95688,bakārantadhātu,bakarantadhatu,2,2,0,0,14
95689,bhabbati,bhabbati,1,1,0,0,8
95690,vabba,vabba,1,0,1,0,5
95691,mabba,mabba,1,0,1,0,5
95692,khabba,khabba,2,0,2,0,6
95693,cabba,cabba,2,1,1,0,5
95694,pabbati,pabbati,2,2,0,0,7
95695,vabbati,vabbati,1,1,0,0,7
95696,mabbati,mabbati,1,1,0,0,7
95697,kabbati,kabbati,2,2,0,0,7
95698,khabbati,khabbati,2,2,0,0,8
95699,gabbati,gabbati,3,3,0,0,7
95700,sabbati,sabbati,5,5,0,0,7
95701,cabbati,cabbati,1,1,0,0,7
95702,gatyāpekkhāya,gatyapekkhaya,1,1,0,0,13
95703,kubi,kubi,2,0,2,0,4
95704,lubi,lubi,2,0,2,0,4
95705,tubi,tubi,1,0,1,0,4
95706,lumbati,lumbati,1,1,0,0,7
95707,lumbinīvanaṃ,lumbinivanam,7,7,0,0,12
95708,udakatumbo,udakatumbo,8,5,3,0,10
95709,tumbāni,tumbani,5,5,0,0,7
95710,cubi,cubi,2,0,2,0,4
95711,cumbati,cumbati,5,5,0,0,7
95712,ambudharabinducumbitakūṭoti,ambudharabinducumbitakutoti,1,0,1,0,27
95713,avadane,avadane,1,1,0,0,7
95714,aviññāṇake,avinnanake,9,9,0,0,10
95715,pabbatakūṭe,pabbatakute,6,6,0,0,11
95716,ambudharabindūnaṃ,ambudharabindunam,2,2,0,0,17
95717,cumbanaṃ,cumbanam,2,2,0,0,8
95718,cumbanākārasadisenākārena,cumbanakarasadisenakarena,2,2,0,0,25
95719,adassanasambhavepi,adassanasambhavepi,1,1,0,0,18
95720,dassanasadisenākārena,dassanasadisenakarena,1,1,0,0,21
95721,acakkhukānampi,acakkhukanampi,1,1,0,0,14
95722,avadanānampi,avadananampi,1,1,0,0,12
95723,aviññāṇakānaṃ,avinnanakanam,3,3,0,0,13
95724,dassanacumbanādīni,dassanacumbanadini,1,1,0,0,18
95725,saviññāṇakānaṃyeva,savinnanakanamyeva,1,1,0,0,18
95726,padavikkhepetiādīsupi,padavikkhepetiadisupi,1,0,1,0,21
95727,ubbi,ubbi,1,0,1,0,4
95728,tubbi,tubbi,1,0,1,0,5
95729,thubbi,thubbi,1,0,1,0,6
95730,dubbi,dubbi,1,0,1,0,5
95731,dhubbi,dhubbi,1,0,1,0,6
95732,hiṃsatthā,himsattha,3,0,3,0,9
95733,ubbati,ubbati,1,1,0,0,6
95734,tubbati,tubbati,1,1,0,0,7
95735,thubbati,thubbati,1,1,0,0,8
95736,dubbati,dubbati,1,1,0,0,7
95737,dhubbati,dhubbati,1,1,0,0,8
95738,dubbāti,dubbati,2,0,2,0,7
95739,dabbatiṇaṃ,dabbatinam,3,3,0,0,10
95740,tiriyā,tiriya,9,8,1,0,6
95741,tiṇajātī,tinajati,1,1,0,0,8
95742,mubbi,mubbi,1,0,1,0,5
95743,mubbati,mubbati,1,1,0,0,7
95744,kubbi,kubbi,2,1,1,0,5
95745,pubbati,pubbati,3,3,0,0,7
95746,pubbasabba,pubbasabba,1,0,1,0,10
95747,dhātucintāyaṃ,dhatucintayam,2,2,0,0,13
95748,mantādivirahitesu,mantadivirahitesu,1,1,0,0,17
95749,nipātesu,nipatesu,8,7,1,0,8
95750,dhātucintā,dhatucinta,1,1,0,0,10
95751,tabbhāvamuttattā,tabbhavamuttatta,1,1,0,0,16
95752,sabbatī,sabbati,2,2,0,0,7
95753,payogadassanatoti,payogadassanatoti,1,1,0,0,17
95754,anāgamanabhāvena,anagamanabhavena,3,3,0,0,16
95755,avijjamānabhāvena,avijjamanabhavena,1,1,0,0,17
95756,buddhavacanesu,buddhavacanesu,3,3,0,0,14
95757,purāṇabhāsāti,puranabhasati,1,1,0,0,13
95758,avijjamānāpi,avijjamanapi,6,6,0,0,12
95759,sāsanānurūpā,sasananurupa,1,1,0,0,12
95760,camba,camba,1,0,1,0,5
95761,cambati,cambati,1,1,0,0,7
95762,abi,abi,1,0,1,0,3
95763,dabi,dabi,1,0,1,0,4
95764,dambati,dambati,1,1,0,0,7
95765,avasaṃsanaṃ,avasamsanam,1,0,1,0,11
95766,lambati,lambati,6,6,0,0,7
95767,vilambati,vilambati,1,1,0,0,9
95768,byālambati,byalambati,1,1,0,0,10
95769,lambate,lambate,1,1,0,0,7
95770,ālambanaṃ,alambanam,16,16,0,0,9
95771,tadālambanaṃ,tadalambanam,1,1,0,0,12
95772,tadālambaṇaṃ,tadalambanam,1,1,0,0,12
95773,tadālambaṃ,tadalambam,20,20,0,0,10
95774,bhakārantadhātu,bhakarantadhatu,2,2,0,0,15
95775,pañhā,panha,555,544,11,0,5
95776,vibhātā,vibhata,8,8,0,0,7
95777,bhīmaseno,bhimaseno,19,19,0,0,9
95778,bhīrukajātiko,bhirukajatiko,6,6,0,0,13
95779,bhāyeti,bhayeti,7,4,3,0,7
95780,bhāyayati,bhayayati,1,1,0,0,9
95781,bhāyāpeti,bhayapeti,5,5,0,0,9
95782,bhāyāpayatī,bhayapayati,1,1,0,0,11
95783,sabhu,sabhu,1,0,1,0,5
95784,sabhati,sabhati,2,2,0,0,7
95785,sambhati,sambhati,2,2,0,0,8
95786,sumbha,sumbha,4,2,2,0,6
95787,sumbhati,sumbhati,13,13,0,0,8
95788,sumbho,sumbho,3,3,0,0,6
95789,sumbhaṃ,sumbham,1,1,0,0,7
95790,nikkhanāhī,nikkhanahi,1,1,0,0,10
95791,kusumbhoti,kusumbhoti,1,0,1,0,10
95792,khuddakaāvāṭo,khuddakaavato,2,2,0,0,13
95793,pabbatakandarapadarasākhāparipūrā,pabbatakandarapadarasakhaparipura,2,2,0,0,33
95794,kusumbhe,kusumbhe,2,2,0,0,8
95795,paripūrentī,paripurenti,54,52,2,0,11
95796,vabbha,vabbha,2,0,2,0,6
95797,mabbha,mabbha,1,0,1,0,6
95798,abbhati,abbhati,2,2,0,0,7
95799,vabbhati,vabbhati,2,2,0,0,8
95800,mabbhati,mabbhati,1,1,0,0,8
95801,abbhoti,abbhoti,1,0,1,0,7
95802,anekasatapaṭalo,anekasatapatalo,2,2,0,0,15
95803,vijjumālī,vijjumali,4,4,0,0,9
95804,satakkakū,satakkaku,1,1,0,0,9
95805,satakkakūti,satakkakuti,4,0,4,0,11
95806,abbhuṭṭhitova,abbhutthitova,11,10,1,0,13
95807,rāhū,rahu,3,3,0,0,4
95808,abbhāni,abbhani,5,5,0,0,7
95809,chādentī,chadenti,5,5,0,0,8
95810,laṅghi,langhi,1,1,0,0,6
95811,himagabbhako,himagabbhako,1,1,0,0,12
95812,mithunassa,mithunassa,1,1,0,0,10
95813,janadvayassa,janadvayassa,1,1,0,0,12
95814,methūnaṃ,methunam,2,0,2,0,8
95815,yabhati,yabhati,1,1,0,0,7
95816,yābhassaṃ,yabhassam,2,2,0,0,9
95817,sabbhivācā,sabbhivaca,1,1,0,0,10
95818,lajjāsampannehi,lajjasampannehi,1,1,0,0,15
95819,vattabbabhāsābhāvato,vattabbabhasabhavato,1,1,0,0,20
95820,methuno,methuno,22,20,2,0,7
95821,paṭisevitabbo,patisevitabbo,7,7,0,0,13
95822,vācāvisaye,vacavisaye,1,1,0,0,10
95823,yabhatī,yabhati,1,1,0,0,7
95824,sikharaṇī,sikharani,10,8,2,0,9
95825,asambhivācā,asambhivaca,1,1,0,0,11
95826,lokiyajanopi,lokiyajanopi,1,1,0,0,12
95827,adhimattukkaṃsagatahirottappopi,adhimattukkamsagatahirottappopi,1,1,0,0,31
95828,sañcoditahadayo,sancoditahadayo,2,2,0,0,15
95829,mahākaruṇāti,mahakarunati,1,1,0,0,12
95830,methunadhammassa,methunadhammassa,38,33,5,0,16
95831,saṃvesanaṃ,samvesanam,3,3,0,0,10
95832,niddhuvanaṃ,niddhuvanam,1,1,0,0,11
95833,sūrataṃ,suratam,1,1,0,0,7
95834,rataṃ,ratam,48,41,7,0,5
95835,byathayo,byathayo,1,1,0,0,8
95836,mohanaṃ,mohanam,17,15,2,0,7
95837,vasaladhammo,vasaladhammo,8,7,1,0,12
95838,mīḷhasukhampi,milhasukhampi,1,1,0,0,13
95839,dvayaṃdvayasamāpatti,dvayamdvayasamapatti,11,9,2,0,20
95840,gammo,gammo,15,14,1,0,5
95841,dakantiko,dakantiko,1,1,0,0,9
95842,sibha,sibha,1,0,1,0,5
95843,sibhati,sibhati,1,1,0,0,7
95844,vibhati,vibhati,1,1,0,0,7
95845,debha,debha,1,0,1,0,5
95846,dabhi,dabhi,2,0,2,0,5
95847,debhati,debhati,1,1,0,0,7
95848,ambhati,ambhati,2,2,0,0,7
95849,dambhati,dambhati,2,2,0,0,8
95850,nijjīvampi,nijjivampi,1,1,0,0,10
95851,oghakālādīsu,oghakaladisu,1,1,0,0,12
95852,vissandamānaṃ,vissandamanam,11,7,4,0,13
95853,ambhoti,ambhoti,4,0,4,0,7
95854,papampi,papampi,1,1,0,0,7
95855,nīrañca,niranca,1,1,0,0,7
95856,kepukaṃ,kepukam,7,7,0,0,7
95857,pāni,pani,7,7,0,0,4
95858,elameva,elameva,1,1,0,0,7
95859,āponāmāni,aponamani,1,1,0,0,9
95860,vālaggesu,valaggesu,2,2,0,0,9
95861,kepuke,kepuke,2,2,0,0,6
95862,pivitañca,pivitanca,1,1,0,0,9
95863,pānī,pani,5,5,0,0,4
95864,thabhi,thabhi,2,0,2,0,6
95865,khabhi,khabhi,1,0,1,0,6
95866,paṭibaddhe,patibaddhe,5,3,2,0,10
95867,thambhati,thambhati,2,2,0,0,9
95868,vitthambhati,vitthambhati,3,3,0,0,12
95869,khambhati,khambhati,1,1,0,0,9
95870,vikkhambhati,vikkhambhati,1,1,0,0,12
95871,upatthambho,upatthambho,24,21,3,0,11
95872,upatthambhinī,upatthambhini,2,2,0,0,13
95873,vikkhambho,vikkhambho,1,1,0,0,10
95874,vikkhambhitakileso,vikkhambhitakileso,5,5,0,0,18
95875,jabha,jabha,1,0,1,0,5
95876,jabhi,jabhi,2,0,2,0,5
95877,jabhati,jabhati,1,1,0,0,7
95878,jambhati,jambhati,1,1,0,0,8
95879,vijambhanaṃ,vijambhanam,9,9,0,0,11
95880,vijambhitā,vijambhita,28,23,5,0,10
95881,vijambhanto,vijambhanto,1,1,0,0,11
95882,vijambhamāno,vijambhamano,10,10,0,0,12
95883,vijambhito,vijambhito,1,1,0,0,10
95884,sabbha,sabbha,2,1,1,0,6
95885,sabbhati,sabbhati,1,1,0,0,8
95886,gabbhati,gabbhati,4,4,0,0,8
95887,mātukucchipi,matukucchipi,2,2,0,0,12
95888,kucchigataputtopi,kucchigataputtopi,1,1,0,0,17
95889,yamekarattiṃ,yamekarattim,16,12,4,0,12
95890,mātukucchi,matukucchi,23,22,1,0,10
95891,kucchigataputto,kucchigataputto,1,1,0,0,15
95892,āvāsaviseso,avasaviseso,1,1,0,0,11
95893,rabha,rabha,7,1,6,0,5
95894,rābhasse,rabhasse,5,4,1,0,8
95895,hiṃsākaraṇavāyamanesu,himsakaranavayamanesu,1,0,1,0,21
95896,rābhassaṃ,rabhassam,1,0,1,0,9
95897,rābhasabhāvo,rabhasabhavo,1,1,0,0,12
95898,caṇḍā,canda,50,50,0,0,5
95899,ruddhā,ruddha,12,11,1,0,6
95900,rabhasā,rabhasa,5,5,0,0,7
95901,rabhasāti,rabhasati,4,0,4,0,9
95902,karaṇuttariyā,karanuttariya,3,2,1,0,13
95903,rabhati,rabhati,1,1,0,0,7
95904,ārabhati,arabhati,354,340,14,0,8
95905,samārabhati,samarabhati,7,6,1,0,11
95906,ārambhati,arambhati,8,7,1,0,9
95907,samārambho,samarambho,13,10,3,0,10
95908,ārabhanto,arabhanto,36,35,1,0,9
95909,samārabhanto,samarabhanto,9,8,1,0,12
95910,sārambhaṃ,sarambham,156,150,6,0,9
95911,anārambhaṃ,anarambham,122,116,6,0,10
95912,sārambho,sarambho,79,62,17,0,8
95913,pakāraṇārambho,pakaranarambho,1,1,0,0,14
95914,vīriyārambho,viriyarambho,114,111,3,0,12
95915,ārabhituṃ,arabhitum,3,2,1,0,9
95916,vīriyārambhoti,viriyarambhoti,9,5,4,0,14
95917,vīriyasaṅkhāto,viriyasankhato,7,7,0,0,14
95918,ārambha,arambha,11,4,7,0,7
95919,hiṃsāya,himsaya,9,9,0,0,7
95920,vikopaneti,vikopaneti,4,4,0,0,10
95921,sambhobhi,sambhobhi,1,1,0,0,9
95922,ārambhapaccayā,arambhapaccaya,8,8,0,0,14
95923,ārambhānaṃ,arambhanam,7,7,0,0,10
95924,ārambhoti,arambhoti,12,10,2,0,9
95925,vippaṭisārī,vippatisari,166,149,17,0,11
95926,mahāyaññā,mahayanna,10,10,0,0,9
95927,mahārambhā,maharambha,10,10,0,0,10
95928,mahapphallā,mahapphalla,1,1,0,0,11
95929,yūpussāpanādikriyā,yupussapanadikriya,1,1,0,0,18
95930,ārambhatha,arambhatha,36,31,5,0,10
95931,nikkamatha,nikkamatha,19,19,0,0,10
95932,yuñjatha,yunjatha,34,30,4,0,8
95933,ārambhantī,arambhanti,3,3,0,0,10
95934,bījagāmabhūtagāmasamārambhā,bijagamabhutagamasamarambha,33,30,3,0,27
95935,chedanabhañjanādikaṃ,chedanabhanjanadikam,4,4,0,0,20
95936,āpattiyañceva,apattiyanceva,1,1,0,0,13
95937,hiṃsākriyāsu,himsakriyasu,1,1,0,0,12
95938,vikopane,vikopane,10,10,0,0,8
95939,alatthuṃ,alatthum,20,16,4,0,8
95940,khobhati,khobhati,3,3,0,0,8
95941,saṅkhobhati,sankhobhati,1,1,0,0,11
95942,hatthināge,hatthinage,16,16,0,0,10
95943,padinnamhi,padinnamhi,21,21,0,0,10
95944,khubbhittha,khubbhittha,3,3,0,0,11
95945,khobhā,khobha,1,1,0,0,6
95946,saṅkhobho,sankhobho,2,2,0,0,9
95947,tubha,tubha,1,0,1,0,5
95948,tubhati,tubhati,1,1,0,0,7
95949,lobhati,lobhati,1,1,0,0,7
95950,palobhati,palobhati,1,1,0,0,9
95951,thullakumārīpalobhanaṃ,thullakumaripalobhanam,1,1,0,0,22
95952,lobheti,lobheti,1,1,0,0,7
95953,palobheti,palobheti,4,4,0,0,9
95954,giddhiyatthe,giddhiyatthe,1,1,0,0,12
95955,lubbhatī,lubbhati,3,3,0,0,8
95956,dambhanaṃ,dambhanam,1,1,0,0,9
95957,rubhi,rubhi,1,0,1,0,5
95958,rumbhati,rumbhati,2,2,0,0,8
95959,sannirumbhati,sannirumbhati,1,1,0,0,13
95960,sannirumbho,sannirumbho,1,1,0,0,11
95961,sannirumbhitvā,sannirumbhitva,33,31,2,0,14
95962,ubbhati,ubbhati,2,2,0,0,7
95963,ubhanā,ubhana,1,1,0,0,6
95964,ubbhanā,ubbhana,1,1,0,0,7
95965,umbhanā,umbhana,1,1,0,0,7
95966,obho,obho,1,1,0,0,4
95967,ubbhaṃ,ubbham,4,3,1,0,6
95968,obheti,obheti,3,3,0,0,6
95969,ubbheti,ubbheti,2,2,0,0,7
95970,umbhetī,umbheti,1,1,0,0,7
95971,upakāriyasatthaṃ,upakariyasattham,1,1,0,0,16
95972,kiṭeti,kiteti,1,1,0,0,6
95973,anavasesapariyādānato,anavasesapariyadanato,9,9,0,0,21
95974,keṭento,ketento,1,1,0,0,7
95975,keṭutaṃ,ketutam,1,1,0,0,7
95976,kiṭaubha,kitaubha,1,0,1,0,8
95977,pūraṇanti,purananti,12,12,0,0,9
95978,cariyāpiṭakepi,cariyapitakepi,1,0,1,0,14
95979,accubbhaṃ,accubbham,3,2,1,0,9
95980,sāgarūpamaṃ,sagarupamam,11,9,2,0,11
95981,akkhumbhaṃ,akkhumbham,1,0,1,0,10
95982,ubbhetabboti,ubbhetabboti,1,1,0,0,12
95983,dhovati,dhovati,91,89,2,0,7
95984,onato,onato,14,14,0,0,5
95985,hatthisiropiṇḍe,hatthisiropinde,2,2,0,0,15
95986,dasambaṇe,dasambane,2,2,0,0,9
95987,makārantadhātu,makarantadhatu,4,4,0,0,14
95988,mātāti,matati,37,25,12,0,6
95989,cūḷamātā,culamata,13,13,0,0,8
95990,mahāmātā,mahamata,14,14,0,0,8
95991,gaṇassa,ganassa,258,244,14,0,7
95992,munātī,munati,2,2,0,0,6
95993,paṭidānaādānesu,patidanaadanesu,1,0,1,0,15
95994,khippameva,khippameva,274,260,14,0,10
95995,metīti,metiti,4,1,3,0,6
95996,gahaṇadhāraṇaṭṭhena,gahanadharanatthena,9,9,0,0,19
95997,saṅgamatthavācakassa,sangamatthavacakassa,1,1,0,0,20
95998,sīlasamādhiādīhi,silasamadhiadihi,1,1,0,0,16
95999,saṅgacchatīti,sangacchatiti,2,2,0,0,13
96000,dvidhātuyekadhātuyā,dvidhatuyekadhatuya,1,1,0,0,19
96001,dviratthavatiyāpi,dviratthavatiyapi,1,1,0,0,17
96002,nipphattiṃ,nipphattim,183,180,3,0,10
96003,omā,oma,2,0,2,0,3
96004,samatthabhāvo,samatthabhavo,11,11,0,0,13
96005,omāti,omati,4,3,1,0,5
96006,omanti,omanti,1,1,0,0,6
96007,brahmalokaṃ,brahmalokam,142,136,6,0,11
96008,omātīti,omatiti,3,0,3,0,7
96009,temati,temati,3,3,0,0,6
96010,tinto,tinto,20,20,0,0,5
96011,temiyo,temiyo,11,11,0,0,6
96012,temitukāmā,temitukama,2,2,0,0,10
96013,temiṃsu,temimsu,9,9,0,0,7
96014,temiyoti,temiyoti,5,2,3,0,8
96015,temento,temento,6,6,0,0,7
96016,addabhāvaṃ,addabhavam,1,1,0,0,10
96017,pāpento,papento,53,53,0,0,7
96018,sītalabhāvaṃ,sitalabhavam,3,3,0,0,12
96019,janento,janento,51,51,0,0,7
96020,nitami,nitami,1,0,1,0,6
96021,kilamane,kilamane,1,0,1,0,8
96022,nitammati,nitammati,1,1,0,0,9
96023,dayhate,dayhate,7,7,0,0,7
96024,nitammāmi,nitammami,3,3,0,0,9
96025,chamu,chamu,3,2,1,0,5
96026,japu,japu,1,0,1,0,4
96027,jhamu,jhamu,2,1,1,0,5
96028,umu,umu,1,0,1,0,3
96029,jimu,jimu,1,0,1,0,4
96030,camūti,camuti,2,0,2,0,6
96031,chamati,chamati,2,2,0,0,7
96032,jamati,jamati,1,1,0,0,6
96033,jhamati,jhamati,1,1,0,0,7
96034,umati,umati,1,1,0,0,5
96035,jemati,jemati,1,1,0,0,6
96036,padavikkhepo,padavikkhepo,1,0,1,0,12
96037,vohārasīsamattaṃ,voharasisamattam,1,1,0,0,16
96038,kamatī,kamati,9,8,1,0,6
96039,apadavikkhepatthopi,apadavikkhepatthopi,1,1,0,0,19
96040,abhikkamati,abhikkamati,71,69,2,0,11
96041,paṭikkamati,patikkamati,88,87,1,0,11
96042,parakkamati,parakkamati,34,34,0,0,11
96043,vikkamati,vikkamati,3,3,0,0,9
96044,nikkamati,nikkamati,1,1,0,0,9
96045,saṅkamati,sankamati,31,31,0,0,9
96046,saṅkamanaṃ,sankamanam,19,17,2,0,10
96047,saṅkanti,sankanti,25,21,4,0,8
96048,kamanaṃ,kamanam,8,8,0,0,7
96049,abhikkantā,abhikkanta,60,57,3,0,10
96050,abhinikkhamati,abhinikkhamati,2,2,0,0,14
96051,nikkhāmeti,nikkhameti,8,8,0,0,10
96052,icchākanti,icchakanti,1,1,0,0,10
96053,yatthesu,yatthesu,1,1,0,0,8
96054,upasaggavisesite,upasaggavisesite,1,1,0,0,16
96055,abhikkanta,abhikkanta,9,0,9,0,10
96056,viramanaṃ,viramanam,1,1,0,0,9
96057,yamabhi,yamabhi,1,1,0,0,7
96058,yamāmase,yamamase,21,21,0,0,8
96059,yamāmaseti,yamamaseti,2,0,2,0,10
96060,uparamāma,uparamama,4,4,0,0,9
96061,nassāma,nassama,5,5,0,0,7
96062,marāmāti,maramati,1,1,0,0,8
96063,nama,nama,3,2,1,0,4
96064,bahutto,bahutto,1,0,1,0,7
96065,uggatasaddo,uggatasaddo,2,2,0,0,11
96066,hamma,hamma,1,0,1,0,5
96067,chama,chama,1,0,1,0,5
96068,damati,damati,2,2,0,0,6
96069,hammati,hammati,1,1,0,0,7
96070,mimati,mimati,1,1,0,0,6
96071,chamāti,chamati,8,0,8,0,7
96072,chamāyaṃ,chamayam,101,89,12,0,8
96073,agilānassa,agilanassa,137,121,16,0,10
96074,desessāmīti,desessamiti,85,52,33,0,11
96075,karaṇīyā,karaniya,299,219,80,0,8
96076,parivattāmi,parivattami,3,3,0,0,11
96077,vāricarova,varicarova,5,5,0,0,10
96078,chamanti,chamanti,1,1,0,0,8
96079,saddaggisaṃ,saddaggisam,1,0,1,0,11
96080,yogesu,yogesu,3,2,1,0,6
96081,mukhavātena,mukhavatena,6,6,0,0,11
96082,aggisaṃyoge,aggisamyoge,1,1,0,0,11
96083,saṅkhadhamako,sankhadhamako,11,9,2,0,13
96084,bheriṃ,bherim,226,225,1,0,6
96085,bheridhamako,bheridhamako,1,1,0,0,12
96086,samuṭṭhāpeti,samutthapeti,252,243,9,0,12
96087,aggiṃva,aggimva,27,23,4,0,7
96088,sandhamaṃ,sandhamam,18,14,4,0,9
96089,bhāma,bhama,2,0,2,0,5
96090,bhāmati,bhamati,1,1,0,0,7
96091,nati,nati,21,17,4,0,4
96092,namamāno,namamano,1,1,0,0,8
96093,namito,namito,4,4,0,0,6
96094,nāmitaṃ,namitam,4,4,0,0,7
96095,namituṃ,namitum,1,1,0,0,7
96096,namitvāna,namitvana,4,4,0,0,9
96097,namituna,namituna,1,1,0,0,8
96098,nāmayati,namayati,1,1,0,0,8
96099,nāmetvā,nametva,37,37,0,0,7
96100,nāmayitvā,namayitva,1,1,0,0,9
96101,namanatthe,namanatthe,1,1,0,0,10
96102,vandanāyañca,vandanayanca,1,1,0,0,12
96103,vandanāyameva,vandanayameva,1,1,0,0,13
96104,atrāyamupalakkhaṇamattā,atrayamupalakkhanamatta,1,1,0,0,23
96105,phalabhāragarutāya,phalabharagarutaya,1,1,0,0,18
96106,jarājajjaratāya,jarajajjarataya,1,1,0,0,15
96107,agamāsīti,agamasiti,68,57,11,0,9
96108,namoti,namoti,9,2,7,0,6
96109,nipātesupi,nipatesupi,2,1,1,0,10
96110,paccattopayogavacanāni,paccattopayogavacanani,1,1,0,0,22
96111,abhinnarūpāni,abhinnarupani,1,1,0,0,13
96112,devarāja,devaraja,43,43,0,0,8
96113,tyatthu,tyatthu,20,20,0,0,7
96114,upasaggehipi,upasaggehipi,3,3,0,0,12
96115,uṇṇamati,unnamati,4,3,1,0,8
96116,uṇṇati,unnati,6,5,1,0,6
96117,khamo,khamo,134,128,6,0,5
96118,khamitā,khamita,5,4,1,0,7
96119,sītassapi,sitassapi,1,1,0,0,9
96120,uṇhassapī,unhassapi,1,1,0,0,9
96121,yama,yama,141,139,2,0,4
96122,parivesane,parivesane,8,7,1,0,10
96123,thama,thama,1,0,1,0,5
96124,thamati,thamati,1,1,0,0,7
96125,īhāyaṃ,ihayam,2,1,1,0,6
96126,gamako,gamako,8,8,0,0,6
96127,gacchāpetī,gacchapeti,1,1,0,0,10
96128,viramati,viramati,43,43,0,0,8
96129,paṭiviramati,pativiramati,1,1,0,0,12
96130,uparamati,uparamati,2,2,0,0,9
96131,uparato,uparato,24,23,1,0,7
96132,dhīratthu,dhiratthu,11,11,0,0,9
96133,vantaṃ,vantam,63,55,8,0,6
96134,yamahaṃ,yamaham,209,191,18,0,7
96135,jīvitakāraṇā,jivitakarana,11,11,0,0,12
96136,paccāvamissāmi,paccavamissami,2,2,0,0,14
96137,vammikoti,vammikoti,7,4,3,0,9
96138,vantakoti,vantakoti,7,5,2,0,9
96139,vantussayoti,vantussayoti,3,2,1,0,12
96140,vantasinehasambandhoti,vantasinehasambandhoti,3,3,0,0,22
96141,ahinakulaundūragharagoḷikādayo,ahinakulaunduragharagolikadayo,2,2,0,0,30
96142,upacikāhi,upacikahi,40,39,1,0,9
96143,vamitvā,vamitva,16,15,1,0,7
96144,mukhatuṇḍakena,mukhatundakena,53,52,1,0,14
96145,ukkhittapaṃsucuṇṇena,ukkhittapamsucunnena,3,3,0,0,20
96146,kaṭippamāṇenapi,katippamanenapi,3,3,0,0,15
96147,porisappamāṇenapi,porisappamanenapi,3,3,0,0,17
96148,ussitoti,ussitoti,3,3,0,0,8
96149,vantakheḷasinehena,vantakhelasinehena,3,3,0,0,18
96150,ābaddhatāya,abaddhataya,3,3,0,0,11
96151,sattasattāhaṃ,sattasattaham,53,53,0,0,13
96152,vassantepi,vassantepi,8,8,0,0,10
96153,vippakirayati,vippakirayati,1,1,0,0,13
96154,nidāghepi,nidaghepi,4,4,0,0,9
96155,paṃsumuṭṭhiṃ,pamsumutthim,6,6,0,0,12
96156,muṭṭhinā,mutthina,32,32,0,0,8
96157,pīḷiyamāne,piliyamane,5,5,0,0,10
96158,sinehova,sinehova,2,2,0,0,8
96159,nipphādetabbāni,nipphadetabbani,2,2,0,0,15
96160,visuddhimaggakārako,visuddhimaggakarako,2,1,1,0,19
96161,taṇhāsaṅkhātaṃ,tanhasankhatam,25,21,4,0,14
96162,gamanamanena,gamanamanena,3,3,0,0,12
96163,vantagamano,vantagamano,21,20,1,0,11
96164,vanta,vanta,3,1,2,0,5
96165,aggāhito,aggahito,2,2,0,0,8
96166,paranipātavasena,paranipatavasena,4,4,0,0,16
96167,gamanavanto,gamanavanto,1,1,0,0,11
96168,evamavatvā,evamavatva,5,5,0,0,10
96169,pubbanipātabhvassa,pubbanipatabhvassa,1,1,0,0,18
96170,kesañca,kesanca,3,3,0,0,7
96171,tosetuṃ,tosetum,10,10,0,0,7
96172,akkharakkamaṃ,akkharakkamam,1,1,0,0,13
96173,atthamattanidassanavasena,atthamattanidassanavasena,1,1,0,0,25
96174,pubbanipātavasena,pubbanipatavasena,1,1,0,0,17
96175,īdisasmiñhi,idisasminhi,1,1,0,0,11
96176,āhitaggī,ahitaggi,1,1,0,0,8
96177,hatthacchinno,hatthacchinno,22,22,0,0,13
96178,ṭhitesupi,thitesupi,9,9,0,0,9
96179,ayutti,ayutti,7,7,0,0,6
96180,vedajātotiādīsu,vedajatotiadisu,1,0,1,0,15
96181,bhage,bhage,77,66,11,0,5
96182,vamīti,vamiti,67,53,14,0,6
96183,bhagasaṅkhātaṃ,bhagasankhatam,8,8,0,0,14
96184,yasañca,yasanca,33,32,1,0,7
96185,uggiri,uggiri,28,28,0,0,6
96186,chaḍḍayīti,chaddayiti,4,4,0,0,10
96187,bhāni,bhani,9,9,0,0,5
96188,bhagā,bhaga,21,16,5,0,5
96189,sineruyugandharauttarakuruhimavantādibhājanalokā,sineruyugandharauttarakuruhimavantadibhajanaloka,1,1,0,0,48
96190,visesasannissayasobhākappaṭṭhiyabhāvato,visesasannissayasobhakappatthiyabhavato,1,1,0,0,39
96191,tannivāsisattāvāsasamatikkamanato,tannivasisattavasasamatikkamanato,3,3,0,0,33
96192,tappaṭibaddhachandarāgappahānena,tappatibaddhachandaragappahanena,15,15,0,0,32
96193,pajahīti,pajahiti,11,11,0,0,8
96194,lokacittañca,lokacittanca,6,6,0,0,12
96195,khandhāyatanadhātādibhede,khandhayatanadhatadibhede,1,1,0,0,25
96196,dhammakoṭṭhāse,dhammakotthase,9,9,0,0,14
96197,papañca,papanca,21,19,2,0,7
96198,saṃyojanaṃ,samyojanam,375,340,35,0,10
96199,samadhigacchanto,samadhigacchanto,6,6,0,0,16
96200,chaḍḍayi,chaddayi,18,18,0,0,8
96201,paccāvamīti,paccavamiti,1,1,0,0,11
96202,sāvajjānavajje,savajjanavajje,16,16,0,0,14
96203,hīnappaṇīte,hinappanite,11,11,0,0,11
96204,kaṇhasukkasappaṭibhāge,kanhasukkasappatibhage,16,15,1,0,22
96205,ariyamaggañāṇamukhena,ariyamaggananamukhena,6,6,0,0,21
96206,pariccaji,pariccaji,35,35,0,0,9
96207,khandhāyatanadhātādī,khandhayatanadhatadi,1,1,0,0,20
96208,dhammabhedā,dhammabheda,3,2,1,0,11
96209,vantā,vanta,25,25,0,0,5
96210,bagavā,bagava,2,2,0,0,6
96211,himavāti,himavati,5,0,5,0,8
96212,sambhavajātakaṭṭhakathāyaṃ,sambhavajatakatthakathayam,1,0,1,0,26
96213,himapātasamaye,himapatasamaye,30,30,0,0,14
96214,himayuttoti,himayuttoti,2,2,0,0,11
96215,gimhakāle,gimhakale,29,29,0,0,9
96216,ṭhānesupi,thanesupi,5,5,0,0,9
96217,guṇavāgaṇavā,gunavaganava,1,1,0,0,12
96218,nayeyya,nayeyya,3,3,0,0,7
96219,parihīnaguṇo,parihinaguno,1,1,0,0,12
96220,evamādiattho,evamadiattho,1,1,0,0,12
96221,sabbatthapi,sabbatthapi,46,45,1,0,11
96222,itiādipadānaṃ,itiadipadanam,5,5,0,0,13
96223,niruttinayo,niruttinayo,5,5,0,0,11
96224,atthayuttipaṭibandhamattova,atthayuttipatibandhamattova,1,1,0,0,27
96225,atthayuttiyaṃ,atthayuttiyam,1,1,0,0,13
96226,nipphādetumasakkuṇeyyānipi,nipphadetumasakkuneyyanipi,1,1,0,0,26
96227,rūpanipphādanādhikāre,rupanipphadanadhikare,1,1,0,0,21
96228,udāharaṇehi,udaharanehi,2,2,0,0,11
96229,sāramate,saramate,6,6,0,0,8
96230,munirājamate,munirajamate,1,1,0,0,12
96231,paṭutaṃ,patutam,7,6,1,0,7
96232,pihayaṃ,pihayam,6,5,1,0,7
96233,vipulatthadharaṃ,vipulatthadharam,1,1,0,0,16
96234,dhaninītimimaṃ,dhaninitimimam,1,1,0,0,14
96235,matisuddhakaraṃ,matisuddhakaram,1,1,0,0,15
96236,saravaggapañcakantiko,saravaggapancakantiko,1,1,0,0,21
96237,dhātuvibhāgo,dhatuvibhago,1,1,0,0,12
96238,pannarasamo,pannarasamo,38,38,0,0,11
96239,bhūvādigaṇikapariccheda,bhuvadiganikapariccheda,1,1,0,0,23
96240,vaggantā,vagganta,7,7,0,0,8
96241,missakā,missaka,38,32,6,0,7
96242,dhātubhedādikusalassa,dhatubhedadikusalassa,2,2,0,0,21
96243,matānugā,matanuga,1,1,0,0,8
96244,yakārantadhātu,yakarantadhatu,2,2,0,0,14
96245,yātu,yatu,3,3,0,0,4
96246,yantu,yantu,10,10,0,0,5
96247,yeyya,yeyya,3,3,0,0,5
96248,yeyyuṃ,yeyyum,2,2,0,0,6
96249,yanto,yanto,6,6,0,0,5
96250,upayānaṃ,upayanam,11,8,3,0,8
96251,yāyati,yayati,35,34,1,0,6
96252,yāyantī,yayanti,3,3,0,0,7
96253,rathasakaṭādi,rathasakatadi,1,1,0,0,13
96254,upayanti,upayanti,27,26,1,0,8
96255,issarassa,issarassa,15,15,0,0,9
96256,piyamanāpassa,piyamanapassa,4,4,0,0,13
96257,paṇṇākāraṃ,pannakaram,170,169,1,0,10
96258,upayānāni,upayanani,2,2,0,0,9
96259,rājaputta,rajaputta,60,60,0,0,9
96260,paṇṇākārāni,pannakarani,8,8,0,0,11
96261,upayānānī,upayanani,1,1,0,0,9
96262,sampannadassanīyapupphaphalāditāya,sampannadassaniyapupphaphaladitaya,1,1,0,0,34
96263,byā,bya,18,14,4,0,3
96264,ummīsane,ummisane,1,0,1,0,8
96265,byāti,byati,7,7,0,0,5
96266,byanti,byanti,9,8,1,0,6
96267,byāsi,byasi,1,1,0,0,5
96268,byātha,byatha,1,1,0,0,6
96269,byāmi,byami,1,1,0,0,5
96270,byāma,byama,1,1,0,0,5
96271,nimmīsati,nimmisati,1,1,0,0,9
96272,rasatibbayo,rasatibbayo,3,3,0,0,11
96273,byātīti,byatiti,3,0,3,0,7
96274,ummīsati,ummisati,2,2,0,0,8
96275,purāṇabhāsā,puranabhasa,2,2,0,0,11
96276,cūḷabodhiparibbājako,culabodhiparibbajako,1,1,0,0,20
96277,yavati,yavati,8,8,0,0,6
96278,āyavanti,ayavanti,4,4,0,0,8
96279,missībhavanti,missibhavanti,2,2,0,0,13
96280,arūpadhammāti,arupadhammati,5,5,0,0,13
96281,āyavanaṭṭhena,ayavanatthena,1,1,0,0,13
96282,arūpadhammā,arupadhamma,97,91,6,0,11
96283,āyūti,ayuti,68,52,16,0,5
96284,lokavohāravasena,lokavoharavasena,19,19,0,0,16
96285,abhidhammavasena,abhidhammavasena,4,4,0,0,16
96286,yapanā,yapana,31,30,1,0,6
96287,iccetepi,iccetepi,1,1,0,0,8
96288,yonīti,yoniti,17,8,9,0,6
96289,aṇḍajādīnaṃ,andajadinam,2,2,0,0,11
96290,aṇḍajādīhi,andajadihi,1,1,0,0,10
96291,missībhāvo,missibhavo,11,11,0,0,10
96292,ekajātisamanvayena,ekajatisamanvayena,2,2,0,0,18
96293,khandhakoṭṭhāsassapi,khandhakotthasassapi,4,4,0,0,20
96294,kāraṇassapi,karanassapi,5,5,0,0,11
96295,passāvamaggassapi,passavamaggassapi,4,4,0,0,17
96296,nāgayoniyo,nagayoniyo,9,9,0,0,10
96297,supaṇṇayoniyo,supannayoniyo,8,8,0,0,13
96298,bhūmija,bhumija,49,49,0,0,7
96299,adhigamāyā,adhigamaya,23,22,1,0,10
96300,cāhaṃ,caham,286,263,23,0,5
96301,yonijaṃ,yonijam,15,11,4,0,7
96302,mattisambhavaṃ,mattisambhavam,15,11,4,0,14
96303,khandhānañcāpi,khandhanancapi,1,1,0,0,14
96304,muttamagge,muttamagge,1,1,0,0,10
96305,bye,bye,2,0,2,0,3
96306,byāyati,byayati,3,3,0,0,7
96307,sahabyo,sahabyo,14,13,1,0,7
96308,sahabyoti,sahabyoti,2,0,2,0,9
96309,ekabhavūpago,ekabhavupago,3,3,0,0,12
96310,hayoti,hayoti,3,1,2,0,6
96311,hayopi,hayopi,1,1,0,0,6
96312,gojo,gojo,2,2,0,0,4
96313,assataropi,assataropi,1,1,0,0,10
96314,kāraṇākāraṇaññū,karanakaranannu,3,3,0,0,15
96315,hayuttamo,hayuttamo,4,4,0,0,9
96316,khaḷuṅkasso,khalunkasso,1,1,0,0,11
96317,vaḷavoti,valavoti,1,1,0,0,8
96318,assapoto,assapoto,2,2,0,0,8
96319,kisoroti,kisoroti,1,1,0,0,8
96320,khaḷuṅkotipi,khalunkotipi,1,1,0,0,12
96321,hariya,hariya,1,0,1,0,6
96322,gatigelaññesu,gatigelannesu,1,0,1,0,13
96323,hariyati,hariyati,1,1,0,0,8
96324,taya,taya,4,3,1,0,4
96325,tayati,tayati,1,1,0,0,6
96326,rayati,rayati,1,1,0,0,6
96327,mayatayacaya,mayatayacaya,1,0,1,0,12
96328,upaparikkhitabbāni,upaparikkhitabbani,3,3,0,0,18
96329,ayoti,ayoti,24,16,8,0,5
96330,kāḷalohaṃ,kalaloham,11,10,1,0,9
96331,nānākammārakiccesu,nanakammarakiccesu,1,1,0,0,18
96332,upayogaṃ,upayogam,17,16,1,0,8
96333,vayoti,vayoti,22,3,19,0,6
96334,paṭhamavayādiāyukoṭṭhāso,pathamavayadiayukotthaso,1,1,0,0,24
96335,payoti,payoti,2,0,2,0,6
96336,khīrassapi,khirassapi,1,1,0,0,10
96337,udakassapi,udakassapi,2,2,0,0,10
96338,pātabbabhāvaṃ,patabbabhavam,2,2,0,0,13
96339,rayoti,rayoti,1,0,1,0,6
96340,rayanaṃ,rayanam,1,1,0,0,7
96341,nibbacanena,nibbacanena,6,6,0,0,11
96342,hetudiṭṭhisu,hetuditthisu,11,11,0,0,12
96343,paṭilābhe,patilabhe,27,27,0,0,9
96344,upasaṅkameyyāma,upasankameyyama,20,19,1,0,15
96345,uṇhasamayo,unhasamayo,26,17,9,0,10
96346,pariḷāhasamayo,parilahasamayo,24,16,8,0,14
96347,uggāhamāno,uggahamano,18,17,1,0,10
96348,paribbājako,paribbajako,435,419,16,0,11
96349,samaṇamuṇḍikāputto,samanamundikaputto,21,19,2,0,18
96350,tindukācīre,tindukacire,15,14,1,0,11
96351,ekasālake,ekasalake,15,14,1,0,9
96352,paṭivasatī,pativasati,17,17,0,0,10
96353,cattho,cattho,31,30,1,0,6
96354,samparāyiko,samparayiko,69,64,5,0,11
96355,antamakāsi,antamakasi,40,32,8,0,10
96356,dukkhassā,dukkhassa,69,67,2,0,9
96357,abhisamayaṭṭho,abhisamayattho,25,19,6,0,14
96358,paṭivedho,pativedho,161,138,23,0,9
96359,jotakamattattā,jotakamattatta,6,6,0,0,14
96360,atthuddhārepi,atthuddharepi,5,5,0,0,13
96361,samāgacchati,samagacchati,22,22,0,0,12
96362,tadādhārapuggaloti,tadadharapuggaloti,1,1,0,0,18
96363,saṅgacchanti,sangacchanti,1,1,0,0,12
96364,sahajātadhammehi,sahajatadhammehi,11,11,0,0,16
96365,avayavasahāvaṭṭhānameva,avayavasahavatthanameva,7,7,0,0,23
96366,paccayantarasamāgame,paccayantarasamagame,4,4,0,0,20
96367,saṃyojanabhāvato,samyojanabhavato,9,9,0,0,16
96368,bajjhanti,bajjhanti,24,24,0,0,9
96369,appavattīti,appavattiti,24,10,14,0,11
96370,adhigantabboti,adhigantabboti,5,5,0,0,14
96371,yathābhūtasabhāvāvabodho,yathabhutasabhavavabodho,6,6,0,0,24
96372,atthamattaṃ,atthamattam,31,31,0,0,11
96373,abhinivisantīti,abhinivisantiti,10,6,4,0,15
96374,abhidhīyantīti,abhidhiyantiti,4,4,0,0,14
96375,saddavisese,saddavisese,8,8,0,0,11
96376,apekkhite,apekkhite,25,25,0,0,9
96377,apekkhamāne,apekkhamane,2,2,0,0,11
96378,anekatthābhidhānaṃ,anekatthabhidhanam,3,3,0,0,18
96379,samūhādiatthaṃ,samuhadiattham,3,3,0,0,14
96380,saddavacanīyatā,saddavacaniyata,2,2,0,0,15
96381,sāmaññamupādāya,samannamupadaya,1,1,0,0,15
96382,anekatthatā,anekatthata,5,5,0,0,11
96383,samudīraye,samudiraye,5,5,0,0,10
96384,samavāyādivācino,samavayadivacino,1,1,0,0,16
96385,samānatthehi,samanatthehi,2,2,0,0,12
96386,dhātuhi,dhatuhi,2,2,0,0,7
96387,samānarūpāni,samanarupani,1,1,0,0,12
96388,dānagatihiṃsādānarakkhāsu,danagatihimsadanarakkhasu,1,0,1,0,25
96389,mettāpi,mettapi,5,4,1,0,7
96390,karuṇāpi,karunapi,6,6,0,0,8
96391,dayāpanno,dayapanno,49,49,0,0,9
96392,adayāpanno,adayapanno,23,23,0,0,10
96393,nikkaruṇataṃ,nikkarunatam,5,5,0,0,12
96394,mettākaruṇāsu,mettakarunasu,1,1,0,0,13
96395,adhippāyavasena,adhippayavasena,27,27,0,0,15
96396,anurakkhaṇatthaṃ,anurakkhanattham,13,12,1,0,16
96397,antonītaṃ,antonitam,16,15,1,0,9
96398,pharantaṃ,pharantam,3,3,0,0,9
96399,pavāhentaṃ,pavahentam,1,1,0,0,10
96400,udakamivātipi,udakamivatipi,1,1,0,0,13
96401,chaḍḍetvā,chaddetva,613,604,9,0,9
96402,sabbaññutaññāṇañcātipi,sabbannutannanancatipi,1,1,0,0,22
96403,anudayati,anudayati,1,1,0,0,9
96404,payogamettha,payogamettha,1,1,0,0,12
96405,maṃsapesiṃ,mamsapesim,46,44,2,0,10
96406,dayeyya,dayeyya,1,1,0,0,7
96407,dayesi,dayesi,3,3,0,0,6
96408,sassuyā,sassuya,24,23,1,0,7
96409,sasuramhi,sasuramhi,3,3,0,0,9
96410,rathesabha,rathesabha,97,96,1,0,10
96411,dayeyyāti,dayeyyati,1,0,1,0,9
96412,uppatitvā,uppatitva,318,312,6,0,9
96413,gatyatthavasenetaṃ,gatyatthavasenetam,1,1,0,0,18
96414,dayesīti,dayesiti,2,0,2,0,8
96415,mettacittaṃ,mettacittam,106,94,12,0,11
96416,dayitabboti,dayitabboti,2,0,2,0,11
96417,rakkhaṇatthaṃ,rakkhanattham,16,16,0,0,13
96418,ūyī,uyi,1,0,1,0,3
96419,ūyati,uyati,1,1,0,0,5
96420,ūto,uto,1,1,0,0,3
96421,ūtavā,utava,1,1,0,0,5
96422,pūyī,puyi,1,0,1,0,4
96423,pūyati,puyati,1,1,0,0,6
96424,pūto,puto,3,3,0,0,4
96425,pūtavā,putava,2,2,0,0,6
96426,pūtimacchaṃ,putimaccham,12,11,1,0,11
96427,kusaggena,kusaggena,36,36,0,0,9
96428,upanayhati,upanayhati,22,21,1,0,10
96429,kanuyī,kanuyi,1,0,1,0,6
96430,kanuyati,kanuyati,1,1,0,0,8
96431,kanuto,kanuto,1,1,0,0,6
96432,kanutavā,kanutava,1,1,0,0,8
96433,khamāya,khamaya,2,1,1,0,7
96434,khamāyati,khamayati,1,1,0,0,9
96435,khamāto,khamato,1,1,0,0,7
96436,khamātavā,khamatava,1,1,0,0,9
96437,phīto,phito,15,15,0,0,5
96438,phatavā,phatava,1,1,0,0,7
96439,tatavantu,tatavantu,1,0,1,0,9
96440,tiracchānayoni,tiracchanayoni,69,63,6,0,14
96441,pettivisayo,pettivisayo,38,32,6,0,11
96442,asurakāyoti,asurakayoti,6,4,2,0,11
96443,tāyu,tayu,3,2,1,0,4
96444,santānapālanesu,santanapalanesu,1,0,1,0,15
96445,tāyanaṃ,tayanam,5,5,0,0,7
96446,kārapaccayamatteneva,karapaccayamatteneva,1,1,0,0,20
96447,cāyu,cayu,4,3,1,0,4
96448,nisāmanaṃ,nisamanam,7,5,2,0,9
96449,savanañca,savananca,13,13,0,0,9
96450,nisāmehi,nisamehi,29,29,0,0,8
96451,nisāmayatha,nisamayatha,13,13,0,0,11
96452,olokanasavanāni,olokanasavanani,1,1,0,0,15
96453,nisāmana,nisamana,1,0,1,0,8
96454,upaparikkhaṇampi,upaparikkhanampi,1,1,0,0,16
96455,nisāmanamevāti,nisamanamevati,1,1,0,0,14
96456,cāyati,cayati,1,1,0,0,6
96457,apacāyati,apacayati,7,7,0,0,9
96458,anagāre,anagare,1,1,0,0,7
96459,brahmacāriye,brahmacariye,2,2,0,0,12
96460,apacitiṃ,apacitim,55,52,3,0,8
96461,vuddhāpacāyino,vuddhapacayino,2,2,0,0,14
96462,rakārantadhātu,rakarantadhatu,3,3,0,0,14
96463,reti,reti,13,1,12,0,4
96464,ṇūti,nuti,1,1,0,0,4
96465,uparavo,uparavo,3,3,0,0,7
96466,rutamanuññaṃ,rutamanunnam,1,1,0,0,12
96467,rāyati,rayati,2,2,0,0,6
96468,nisāsaṅkhāto,nisasankhato,1,1,0,0,12
96469,tiyyati,tiyyati,2,2,0,0,7
96470,brunti,brunti,2,2,0,0,6
96471,brūsi,brusi,101,89,12,0,5
96472,brūtha,brutha,11,10,1,0,6
96473,bruvante,bruvante,2,2,0,0,8
96474,brūse,bruse,2,2,0,0,5
96475,bruvhe,bruvhe,1,1,0,0,6
96476,bruve,bruve,4,4,0,0,5
96477,brumhe,brumhe,1,1,0,0,6
96478,brūtu,brutu,5,5,0,0,5
96479,bruvitu,bruvitu,1,1,0,0,7
96480,bruvantu,bruvantu,2,2,0,0,8
96481,brūtaṃ,brutam,2,2,0,0,6
96482,bruvantaṃ,bruvantam,2,2,0,0,9
96483,ambaṭṭhasutte,ambatthasutte,19,13,6,0,13
96484,bruvitū,bruvitu,2,2,0,0,7
96485,sabbatthāpi,sabbatthapi,82,76,6,0,11
96486,bruveyya,bruveyya,3,3,0,0,8
96487,bruveyyuṃ,bruveyyum,3,3,0,0,9
96488,bruveyyāsi,bruveyyasi,2,2,0,0,10
96489,bruveyyātha,bruveyyatha,2,2,0,0,11
96490,bruveyyāmi,bruveyyami,2,2,0,0,10
96491,bruveyyāma,bruveyyama,2,2,0,0,10
96492,bruvetha,bruvetha,2,2,0,0,8
96493,bruveraṃ,bruveram,2,2,0,0,8
96494,bruvetho,bruvetho,1,1,0,0,8
96495,bruveyyāvho,bruveyyavho,1,1,0,0,11
96496,bruveyyaṃ,bruveyyam,1,1,0,0,9
96497,bruveyyāmhe,bruveyyamhe,1,1,0,0,11
96498,pabrūti,pabruti,4,4,0,0,7
96499,anubrūti,anubruti,1,1,0,0,8
96500,pabrūtu,pabrutu,1,1,0,0,7
96501,anubrūtu,anubrutu,1,1,0,0,8
96502,pabruveyya,pabruveyya,1,1,0,0,10
96503,anubruveyya,anubruveyya,1,1,0,0,11
96504,paanu,paanu,1,0,1,0,5
96505,brave,brave,2,2,0,0,5
96506,bravittha,bravittha,4,3,1,0,9
96507,bravire,bravire,1,1,0,0,7
96508,bravittho,bravittho,1,1,0,0,9
96509,bravivho,bravivho,1,1,0,0,8
96510,braviṃ,bravim,2,2,0,0,6
96511,bravimhe,bravimhe,1,1,0,0,8
96512,parokkhāvasena,parokkhavasena,2,2,0,0,14
96513,abravā,abrava,3,3,0,0,6
96514,abravū,abravu,2,2,0,0,6
96515,abravo,abravo,2,2,0,0,6
96516,abravattha,abravattha,2,2,0,0,10
96517,abravaṃ,abravam,2,2,0,0,7
96518,abravamhā,abravamha,1,1,0,0,9
96519,abravatthuṃ,abravatthum,1,1,0,0,11
96520,abravase,abravase,2,2,0,0,8
96521,abravhaṃ,abravham,1,1,0,0,8
96522,abraviṃ,abravim,8,5,3,0,7
96523,abravimhase,abravimhase,1,1,0,0,11
96524,hiyyattanīvasena,hiyyattanivasena,3,3,0,0,16
96525,abravittha,abravittha,1,1,0,0,10
96526,abravimhā,abravimha,1,1,0,0,9
96527,abravivhaṃ,abravivham,1,1,0,0,10
96528,abravimhe,abravimhe,1,1,0,0,9
96529,ajjatanīvasena,ajjatanivasena,3,3,0,0,14
96530,bruvissati,bruvissati,1,1,0,0,10
96531,bruvissanti,bruvissanti,1,1,0,0,11
96532,abravissā,abravissa,1,1,0,0,9
96533,abravissaṃsu,abravissamsu,1,1,0,0,12
96534,brūyatī,bruyati,1,1,0,0,7
96535,luyati,luyati,2,2,0,0,6
96536,lūyatī,luyati,1,1,0,0,6
96537,brūhane,bruhane,1,0,1,0,7
96538,jīraṃ,jiram,4,4,0,0,5
96539,saṅkappā,sankappa,76,70,6,0,8
96540,pūrituṃ,puritum,1,1,0,0,7
96541,pūritvā,puritva,2,2,0,0,7
96542,pūritaṃ,puritam,98,87,11,0,7
96543,pūrayati,purayati,4,4,0,0,8
96544,pūrāpeti,purapeti,1,1,0,0,8
96545,pūrāpayati,purapayati,1,1,0,0,10
96546,pūrayitvā,purayitva,11,11,0,0,9
96547,pūrāpetvā,purapetva,43,42,1,0,9
96548,pūrāpayitvā,purapayitva,2,2,0,0,11
96549,paripūretvā,paripuretva,48,46,2,0,11
96550,ghora,ghora,1,0,1,0,5
96551,gatipaṭighātaṃ,gatipatighatam,1,0,1,0,14
96552,gatipaṭihananaṃ,gatipatihananam,1,1,0,0,15
96553,ghorati,ghorati,1,1,0,0,7
96554,gaticāturiyaṃ,gaticaturiyam,1,0,1,0,13
96555,gatichekabhāvo,gatichekabhavo,1,1,0,0,14
96556,dhoreti,dhoreti,1,1,0,0,7
96557,ussarati,ussarati,1,1,0,0,8
96558,ussāraṇā,ussarana,8,7,1,0,8
96559,vicarati,vicarati,309,306,3,0,8
96560,anucarati,anucarati,4,4,0,0,9
96561,sañcarati,sancarati,30,29,1,0,9
96562,paṭicarati,paticarati,48,45,3,0,10
96563,anuvicāro,anuvicaro,13,12,1,0,9
96564,upavicāro,upavicaro,14,14,0,0,9
96565,cārako,carako,7,7,0,0,6
96566,ocarako,ocarako,8,5,3,0,7
96567,paṭicaratīti,paticaratiti,17,4,13,0,12
96568,cārakoti,carakoti,1,0,1,0,8
96569,taṃpavesitānaṃ,tampavesitanam,1,1,0,0,14
96570,ocarakoti,ocarakoti,1,0,1,0,9
96571,adhocārī,adhocari,1,1,0,0,8
96572,dānampi,danampi,21,21,0,0,7
96573,veyyāvaccampi,veyyavaccampi,3,3,0,0,13
96574,sikkhāpadampi,sikkhapadampi,7,7,0,0,13
96575,brahmavihāropi,brahmaviharopi,1,1,0,0,14
96576,dhammadesanāpi,dhammadesanapi,4,4,0,0,14
96577,methunaviratipi,methunaviratipi,2,2,0,0,15
96578,sadārasantosopi,sadarasantosopi,2,2,0,0,15
96579,uposathopi,uposathopi,3,3,0,0,10
96580,ariyamaggopi,ariyamaggopi,8,8,0,0,12
96581,sāsanampi,sasanampi,6,6,0,0,9
96582,ajjhāsayopi,ajjhasayopi,3,3,0,0,11
96583,iddhijutibalavīriyūpapatti,iddhijutibalaviriyupapatti,2,2,0,0,26
96584,ahumhā,ahumha,33,32,1,0,6
96585,puṇṇakajātake,punnakajatake,7,3,4,0,13
96586,veyyāvaccaṃ,veyyavaccam,106,91,15,0,11
96587,brahmavihārā,brahmavihara,49,37,12,0,12
96588,brahmacariyasmiṃ,brahmacariyasmim,5,3,2,0,16
96589,methunavirati,methunavirati,20,19,1,0,13
96590,tāha,taha,1,1,0,0,4
96591,sadārasantoso,sadarasantoso,5,5,0,0,13
96592,mahāgovindasuttasmi,mahagovindasuttasmi,1,0,1,0,19
96593,ṃyeva,myeva,1,1,0,0,5
96594,sikkhattayasaṅgahaṃ,sikkhattayasangaham,22,22,0,0,19
96595,ataramānānaṃ,ataramananam,15,12,3,0,12
96596,phalāsāva,phalasava,10,8,2,0,9
96597,vipakkabrahmacariyosmi,vipakkabrahmacariyosmi,12,12,0,0,22
96598,veyyāvaṭiyañca,veyyavatiyanca,1,1,0,0,14
96599,brahmavihārakā,brahmaviharaka,1,1,0,0,14
96600,dhammakkhānaṃ,dhammakkhanam,44,38,6,0,13
96601,methunatāvirati,methunatavirati,1,1,0,0,15
96602,sadāresu,sadaresu,1,1,0,0,8
96603,cime,cime,59,56,3,0,4
96604,hura,hura,1,0,1,0,4
96605,hurati,hurati,1,1,0,0,6
96606,saddopatāpesu,saddopatapesu,2,0,2,0,13
96607,usupi,usupi,1,1,0,0,5
96608,saraṇagatānaṃ,saranagatanam,20,15,5,0,13
96609,saraṇagamanena,saranagamanena,32,31,1,0,14
96610,parikilesañcāti,parikilesancati,1,1,0,0,15
96611,buddhādiratanattayaṃ,buddhadiratanattayam,6,6,0,0,20
96612,saraṇamidaṃ,saranamidam,1,1,0,0,11
96613,cātipi,catipi,41,41,0,0,6
96614,susarati,susarati,2,2,0,0,8
96615,appakkharānañhi,appakkharananhi,1,1,0,0,15
96616,bahubhāvo,bahubhavo,28,28,0,0,9
96617,anussarati,anussarati,389,388,1,0,10
96618,paṭissarati,patissarati,3,3,0,0,11
96619,paṭissati,patissati,26,24,2,0,9
96620,paṭissato,patissato,53,50,3,0,9
96621,dvara,dvara,1,0,1,0,5
96622,rakkhaṇā,rakkhana,8,7,1,0,8
96623,dvarati,dvarati,1,1,0,0,7
96624,dvisaddūpapadaaradhātuvasenapi,dvisaddupapadaaradhatuvasenapi,1,1,0,0,30
96625,dvaranti,dvaranti,1,1,0,0,8
96626,kavāṭā,kavata,11,11,0,0,6
96627,etthātipi,etthatipi,3,3,0,0,9
96628,gehadvārampi,gehadvarampi,1,1,0,0,12
96629,kāyadvārādīnipi,kayadvaradinipi,1,1,0,0,15
96630,upāyopi,upayopi,3,3,0,0,7
96631,dvāranti,dvaranti,14,14,0,0,8
96632,dvāra,dvara,24,20,4,0,5
96633,dvārampi,dvarampi,61,59,2,0,8
96634,dvārāpesā,dvarapesa,10,9,1,0,9
96635,dhūra,dhura,1,0,1,0,5
96636,hucchane,hucchane,1,0,1,0,8
96637,hucchana,hucchana,1,0,1,0,8
96638,koṭillaṃ,kotillam,1,1,0,0,8
96639,dhūrati,dhurati,1,1,0,0,7
96640,plavanasaraṇesu,plavanasaranesu,1,0,1,0,15
96641,otiṇṇo,otinno,136,118,18,0,6
96642,udakapiṭṭhe,udakapitthe,51,50,1,0,11
96643,jalayānanti,jalayananti,1,1,0,0,11
96644,nāvānāmāni,navanamani,1,1,0,0,10
96645,tarito,tarito,3,3,0,0,6
96646,māsakhettaṃ,masakhettam,4,4,0,0,11
96647,avāsariṃ,avasarim,5,3,2,0,8
96648,taritoti,taritoti,1,0,1,0,8
96649,sambhamanto,sambhamanto,3,3,0,0,11
96650,upagacchiṃ,upagacchim,50,45,5,0,10
96651,upavisiṃ,upavisim,1,1,0,0,8
96652,jararogoyeva,jararogoyeva,1,1,0,0,12
96653,jararoge,jararoge,1,1,0,0,8
96654,pavattaniyamanatthaṃ,pavattaniyamanattham,1,1,0,0,20
96655,jarati,jarati,4,4,0,0,6
96656,sajjaro,sajjaro,1,1,0,0,7
96657,pajjararogo,pajjararogo,1,1,0,0,11
96658,jarena,jarena,7,7,0,0,6
96659,vayohānivācako,vayohanivacako,1,1,0,0,14
96660,darati,darati,7,7,0,0,6
96661,bīlāsayā,bilasaya,1,1,0,0,8
96662,darīsayā,darisaya,6,6,0,0,8
96663,darīti,dariti,1,0,1,0,6
96664,bhāyitabbaṭṭhena,bhayitabbatthena,9,9,0,0,16
96665,ādarānādaresu,adaranadaresu,2,0,2,0,13
96666,ādarati,adarati,1,1,0,0,7
96667,anādarati,anadarati,1,1,0,0,9
96668,anādaraṃ,anadaram,25,20,5,0,8
96669,dūrāsannavācako,durasannavacako,1,1,0,0,15
96670,tathāyampi,tathayampi,2,2,0,0,10
96671,ādarānādaravācako,adaranadaravacako,1,1,0,0,17
96672,kāyadarathe,kayadarathe,9,7,2,0,11
96673,cittadarathe,cittadarathe,2,2,0,0,12
96674,kilesadarathe,kilesadarathe,3,3,0,0,13
96675,ādittaṃ,adittam,245,230,15,0,7
96676,ghatasittaṃva,ghatasittamva,20,20,0,0,13
96677,pāvakaṃ,pavakam,30,26,4,0,7
96678,vārinā,varina,73,72,1,0,6
96679,osiñci,osinci,9,9,0,0,6
96680,nibbāpaye,nibbapaye,26,24,2,0,9
96681,vītaddaro,vitaddaro,6,6,0,0,9
96682,vītasoko,vitasoko,18,18,0,0,8
96683,vītasallo,vitasallo,6,6,0,0,9
96684,vītaddaroti,vitaddaroti,2,0,2,0,11
96685,samucchinnattā,samucchinnatta,76,76,0,0,14
96686,vigatakilesadarathoti,vigatakilesadarathoti,1,1,0,0,21
96687,datarāya,dataraya,1,1,0,0,8
96688,puri,puri,10,10,0,0,4
96689,uccāṭṭhāne,uccatthane,1,1,0,0,10
96690,netuṭṭhāne,netutthane,2,2,0,0,10
96691,itarāsaṃ,itarasam,70,65,5,0,8
96692,nārīti,nariti,7,0,7,0,6
96693,narassāyanti,narassayanti,1,1,0,0,12
96694,niyyateo,niyyateo,1,1,0,0,8
96695,sattamanussavacane,sattamanussavacane,1,1,0,0,18
96696,edisako,edisako,4,4,0,0,7
96697,āmoditā,amodita,20,20,0,0,7
96698,naramarū,naramaru,21,20,1,0,8
96699,saṃvaṇṇetabbo,samvannetabbo,5,5,0,0,13
96700,viharissati,viharissati,47,46,1,0,11
96701,appamatto,appamatto,505,471,34,0,9
96702,vihissati,vihissati,2,2,0,0,9
96703,saṃvoharati,samvoharati,1,1,0,0,11
96704,rūpiyasaṃvohāro,rupiyasamvoharo,13,13,0,0,15
96705,rūpiyasabbohāro,rupiyasabboharo,1,1,0,0,15
96706,pītipāmojjahāro,pitipamojjaharo,1,1,0,0,15
96707,abhinīharati,abhiniharati,90,85,5,0,12
96708,viharaṃ,viharam,29,25,4,0,7
96709,viharamāno,viharamano,8,7,1,0,10
96710,vihātabbaṃ,vihatabbam,76,74,2,0,10
96711,viharituṃ,viharitum,155,154,1,0,9
96712,viharitvā,viharitva,126,123,3,0,9
96713,āgañchi,aganchi,41,40,1,0,7
96714,vihāroti,viharoti,61,26,35,0,8
96715,ṭhānanisajjādinā,thananisajjadina,1,1,0,0,16
96716,viharaṇaṃ,viharanam,15,15,0,0,9
96717,viharaṇakriyā,viharanakriya,1,1,0,0,13
96718,byavahāropi,byavaharopi,1,1,0,0,11
96719,paṇṇattipi,pannattipi,5,5,0,0,10
96720,cetanāpi,cetanapi,68,63,5,0,8
96721,upajīvati,upajivati,17,17,0,0,9
96722,byavahāravohāro,byavaharavoharo,2,1,1,0,15
96723,paṇṇattivohāro,pannattivoharo,2,1,1,0,14
96724,parāmasantīti,paramasantiti,7,6,1,0,13
96725,vacanavohāro,vacanavoharo,2,1,1,0,12
96726,ariyavohārā,ariyavohara,17,14,3,0,11
96727,anariyavohārā,anariyavohara,33,27,6,0,13
96728,cetanāvohāro,cetanavoharo,2,1,1,0,12
96729,paṇṇatticetanāsu,pannatticetanasu,1,1,0,0,16
96730,imesvatthesu,imesvatthesu,2,2,0,0,12
96731,sabbadosaharo,sabbadosaharo,1,1,0,0,13
96732,mattāvaṇṇabhedenettha,mattavannabhedenettha,1,1,0,0,21
96733,adinnaṃ,adinnam,469,414,55,0,7
96734,harissati,harissati,7,7,0,0,9
96735,hāhiti,hahiti,5,5,0,0,6
96736,iccapa,iccapa,1,1,0,0,6
96737,kharājinaṃ,kharajinam,10,6,4,0,10
96738,suñca,sunca,1,1,0,0,5
96739,khārikājañca,kharikajanca,4,4,0,0,12
96740,hāhitī,hahiti,1,1,0,0,6
96741,saṃharati,samharati,22,22,0,0,9
96742,apaharati,apaharati,5,5,0,0,9
96743,upaharati,upaharati,3,3,0,0,9
96744,sampaharati,sampaharati,1,1,0,0,11
96745,sampahāro,sampaharo,18,17,1,0,9
96746,hariyyati,hariyyati,1,1,0,0,9
96747,āhariyyati,ahariyyati,4,4,0,0,10
96748,āhariyyanti,ahariyyanti,1,1,0,0,11
96749,āhaṭaṃ,ahatam,86,78,8,0,6
96750,harituṃ,haritum,115,102,13,0,7
96751,āharituṃ,aharitum,84,83,1,0,8
96752,dharate,dharate,6,6,0,0,7
96753,satthusāsanaṃ,satthusasanam,196,170,26,0,13
96754,aviddhaṃsane,aviddhamsane,1,0,1,0,12
96755,kharaṇaṃ,kharanam,1,1,0,0,8
96756,khiyyantīti,khiyyantiti,9,2,7,0,11
96757,jāgaraniddakkhaye,jagaraniddakkhaye,2,1,1,0,17
96758,jāgarati,jagarati,5,5,0,0,8
96759,jāgaraṃ,jagaram,5,5,0,0,7
96760,jāgaramāno,jagaramano,1,1,0,0,10
96761,jāgaroti,jagaroti,6,2,4,0,8
96762,paṭijāgarotī,patijagaroti,1,1,0,0,12
96763,eritaṃ,eritam,17,14,3,0,6
96764,jinerito,jinerito,1,1,0,0,8
96765,kuppanti,kuppanti,29,27,2,0,8
96766,vātassapi,vatassapi,5,5,0,0,9
96767,eritassa,eritassa,4,4,0,0,8
96768,samīraṇoti,samiranoti,1,0,1,0,10
96769,samīrati,samirati,16,14,2,0,8
96770,samīreti,samireti,3,3,0,0,8
96771,rukkhasākhāpaṇṇādīni,rukkhasakhapannadini,1,1,0,0,20
96772,aluttantoyamekāranto,aluttantoyamekaranto,1,1,0,0,20
96773,pītikkhayeti,pitikkhayeti,1,0,1,0,12
96774,harāyati,harayati,29,29,0,0,8
96775,harāyanaṃ,harayanam,1,1,0,0,9
96776,aṭṭīyāmi,attiyami,7,7,0,0,8
96777,harāyāmi,harayami,14,14,0,0,8
96778,harāyatīti,harayatiti,6,2,4,0,10
96779,hiriṃ,hirim,57,52,5,0,5
96780,pālanapūraṇesu,palanapuranesu,1,0,1,0,14
96781,parati,parati,5,5,0,0,6
96782,nayaneti,nayaneti,1,0,1,0,8
96783,suddhakattuvasenidaṃ,suddhakattuvasenidam,1,1,0,0,20
96784,pārayatī,parayati,1,1,0,0,8
96785,dānādīnaṃ,danadinam,50,48,2,0,9
96786,vīmaṃsitabaṃ,vimamsitabam,1,1,0,0,12
96787,niggiraṇo,niggirano,1,0,1,0,9
96788,niggiraṇaṃ,niggiranam,1,0,1,0,10
96789,paggharaṇaṃ,paggharanam,5,1,4,0,11
96790,girīti,giriti,5,2,3,0,6
96791,sandhisaṅkhātehi,sandhisankhatehi,3,3,0,0,16
96792,pabbehi,pabbehi,5,5,0,0,7
96793,citattā,citatta,5,5,0,0,7
96794,himavamanādivasena,himavamanadivasena,2,2,0,0,18
96795,sārabhūtānaṃ,sarabhutanam,3,3,0,0,12
96796,bhesajjādivatthūnañca,bhesajjadivatthunanca,2,2,0,0,21
96797,giraṇato,giranato,3,3,0,0,8
96798,mahīdharo,mahidharo,1,1,0,0,9
96799,addi,addi,2,2,0,0,4
96800,giripaṇṇattiyo,giripannattiyo,1,1,0,0,14
96801,devābhidhānāni,devabhidhanani,1,1,0,0,14
96802,asuroti,asuroti,3,0,3,0,7
96803,mittapaṭipakkhā,mittapatipakkha,5,4,1,0,15
96804,amittā,amitta,79,71,8,0,6
96805,pubbadevo,pubbadevo,2,2,0,0,9
96806,kumbhajātake,kumbhajatake,3,1,2,0,12
96807,sassatiyā,sassatiya,13,10,3,0,9
96808,samāyā,samaya,6,5,1,0,6
96809,majjamimaṃ,majjamimam,4,4,0,0,10
96810,niratthaṃ,nirattham,14,14,0,0,9
96811,piveyyā,piveyya,2,2,0,0,7
96812,sagāthāvaggasaṃvaṇṇanāyaṃ,sagathavaggasamvannanayam,1,0,1,0,25
96813,suraṃ,suram,179,176,3,0,5
96814,pivimha,pivimha,9,9,0,0,7
96815,pivimhā,pivimha,5,5,0,0,7
96816,āhaṃsu,ahamsu,924,922,2,0,6
96817,devatāri,devatari,1,1,0,0,8
96818,asurānanti,asurananti,1,1,0,0,10
96819,paṇṇattītipi,pannattitipi,1,1,0,0,12
96820,kummī,kummi,2,2,0,0,5
96821,khurati,khurati,3,3,0,0,7
96822,saṃveṭhane,samvethane,1,0,1,0,10
96823,murati,murati,1,1,0,0,6
96824,muro,muro,1,1,0,0,4
96825,abhimatta,abhimatta,1,0,1,0,9
96826,aggagamanaṃ,aggagamanam,1,0,1,0,11
96827,padhānagamanaṃ,padhanagamanam,1,1,0,0,14
96828,purati,purati,1,1,0,0,6
96829,avāpuretaṃ,avapuretam,6,5,1,0,10
96830,rājadhānī,rajadhani,62,61,1,0,9
96831,puramantare,puramantare,1,1,0,0,11
96832,padhānatāya,padhanataya,9,9,0,0,11
96833,avāpuranti,avapuranti,1,1,0,0,10
96834,tāḷo,talo,4,4,0,0,4
96835,avāpuratītiādīsu,avapuratitiadisu,1,0,1,0,16
96836,iccubho,iccubho,1,1,0,0,7
96837,upasaggāti,upasaggati,3,1,2,0,10
96838,pharaṇaṃ,pharanam,40,31,9,0,8
96839,āhāratthaṃ,aharattham,20,15,5,0,10
96840,mātāpitādayo,matapitadayo,9,8,1,0,12
96841,gāravayuttapuggalā,garavayuttapuggala,1,1,0,0,18
96842,garanti,garanti,2,2,0,0,7
96843,uggacchanti,uggacchanti,14,12,2,0,11
96844,pāsāṇacchattaṃ,pasanacchattam,25,25,0,0,14
96845,bhāriyaṭṭhena,bhariyatthena,4,4,0,0,13
96846,idamāsanaṃ,idamasanam,32,27,5,0,10
96847,bhavañhi,bhavanhi,49,48,1,0,8
96848,sanarāmaralokagaruṃ,sanaramaralokagarum,23,14,9,0,19
96849,sabbalokācariye,sabbalokacariye,2,2,0,0,15
96850,sabbaññumhi,sabbannumhi,4,4,0,0,11
96851,aññesvatthesupi,annesvatthesupi,1,1,0,0,15
96852,mātāpitācariyesu,matapitacariyesu,2,2,0,0,16
96853,alahumhi,alahumhi,2,2,0,0,8
96854,cuggate,cuggate,4,4,0,0,7
96855,nichekādikaresu,nichekadikaresu,2,2,0,0,15
96856,vaṇṇavisesesu,vannavisesesu,2,2,0,0,13
96857,bhāriyavācakatte,bhariyavacakatte,2,2,0,0,16
96858,ācariyavācakatte,acariyavacakatte,2,2,0,0,16
96859,pāḷivisaye,palivisaye,2,2,0,0,10
96860,vācakatte,vacakatte,2,2,0,0,9
96861,kārabhāve,karabhave,2,2,0,0,9
96862,savuddhikassa,savuddhikassa,2,2,0,0,13
96863,taddhitantapadassa,taddhitantapadassa,4,4,0,0,18
96864,sakkaṭabhāsāvisaye,sakkatabhasavisaye,1,1,0,0,18
96865,vuddhibhāve,vuddhibhave,1,1,0,0,11
96866,mattuṃ,mattum,2,1,1,0,6
96867,maritvā,maritva,26,21,5,0,7
96868,mārāpeti,marapeti,9,9,0,0,8
96869,mārāpayati,marapayati,3,3,0,0,10
96870,māretuṃ,maretum,113,113,0,0,7
96871,māretvā,maretva,288,288,0,0,7
96872,maṭṭu,mattu,3,3,0,0,5
96873,marituṃ,maritum,11,10,1,0,7
96874,alīnasattujātake,alinasattujatake,1,0,1,0,16
96875,mattumicche,mattumicche,6,5,1,0,11
96876,pamokkhā,pamokkha,9,9,0,0,8
96877,maritabbasabhāvatāya,maritabbasabhavataya,8,8,0,0,20
96878,marūti,maruti,11,1,10,0,6
96879,dīghāyukopi,dighayukopi,1,1,0,0,11
96880,maraṇasīloti,maranasiloti,1,1,0,0,12
96881,hindaṃ,hindam,3,2,1,0,6
96882,nikkhepo,nikkhepo,149,141,8,0,8
96883,maraṇassa,maranassa,192,183,9,0,9
96884,māroti,maroti,34,16,18,0,6
96885,kāmadevo,kamadevo,2,2,0,0,8
96886,vasavatti,vasavatti,5,5,0,0,9
96887,dabbakopi,dabbakopi,1,1,0,0,9
96888,kusumāyudho,kusumayudho,2,2,0,0,11
96889,sāsanānulomāni,sasananulomani,2,2,0,0,14
96890,pamattabandhū,pamattabandhu,3,3,0,0,13
96891,cattārova,cattarova,65,63,2,0,9
96892,devaputtamārena,devaputtamarena,2,2,0,0,15
96893,kilesamāro,kilesamaro,20,18,2,0,10
96894,khandhamāro,khandhamaro,10,8,2,0,11
96895,abhisaṅkhāramāro,abhisankharamaro,7,5,2,0,16
96896,maccumāro,maccumaro,10,8,2,0,9
96897,devaputtamāroti,devaputtamaroti,1,1,0,0,15
96898,avatthāne,avatthane,1,0,1,0,9
96899,bharito,bharito,19,18,1,0,7
96900,tharati,tharati,3,3,0,0,7
96901,santharati,santharati,12,11,1,0,10
96902,santharaṇaṃ,santharanam,13,13,0,0,11
96903,daro,daro,3,2,1,0,4
96904,adhogatiyaṃ,adhogatiyam,1,0,1,0,11
96905,tirati,tirati,1,1,0,0,6
96906,sattakiccaṃ,sattakiccam,4,4,0,0,11
96907,lakārantadhātu,lakarantadhatu,3,3,0,0,14
96908,lānaṃ,lanam,1,1,0,0,5
96909,sīhaḷo,sihalo,13,7,6,0,6
96910,garuḷoti,garuloti,4,0,4,0,8
96911,dijādhipo,dijadhipo,3,3,0,0,9
96912,nāgāri,nagari,1,1,0,0,6
96913,karoṭī,karoti,1,1,0,0,6
96914,sīhaḷoti,sihaloti,1,0,1,0,8
96915,pubbapuriso,pubbapuriso,15,14,1,0,11
96916,tabbaṃse,tabbamse,3,3,0,0,8
96917,rāhulotiādīsu,rahulotiadisu,1,0,1,0,13
96918,rāhulabhaddo,rahulabhaddo,16,16,0,0,12
96919,buddhaputto,buddhaputto,9,9,0,0,11
96920,jātadivase,jatadivase,52,52,0,0,10
96921,suddhodanamahārājā,suddhodanamaharaja,52,52,0,0,18
96922,nivedethā,nivedetha,4,4,0,0,9
96923,kīḷantassa,kilantassa,16,16,0,0,10
96924,pahiṇi,pahini,158,158,0,0,6
96925,jāyanaṃ,jayanam,4,4,0,0,7
96926,rāhuggaho,rahuggaho,11,10,1,0,9
96927,taṇhākilissanatāpādanato,tanhakilissanatapadanato,1,1,0,0,24
96928,bāḷhena,balhena,1,1,0,0,7
96929,saṅkhalikādibandhanena,sankhalikadibandhanena,1,1,0,0,22
96930,muccituṃ,muccitum,31,31,0,0,8
96931,appadānatoti,appadanatoti,2,2,0,0,12
96932,mahāpadānasuttaṭīkāyañhi,mahapadanasuttatikayanhi,1,0,1,0,24
96933,rāhūti,rahuti,15,12,3,0,6
96934,vacanassatthaṃ,vacanassattham,2,2,0,0,14
96935,saddasambandhaṃ,saddasambandham,1,1,0,0,15
96936,vuttavacanassa,vuttavacanassa,27,27,0,0,14
96937,atthau,atthau,1,1,0,0,6
96938,rāhulotveva,rahulotveva,2,2,0,0,11
96939,āhāti,ahati,144,129,15,0,5
96940,potthake,potthake,191,187,4,0,8
96941,saddhiṃvirocato,saddhimvirocato,1,1,0,0,15
96942,kumārassa,kumarassa,243,239,4,0,9
96943,pacchāyeva,pacchayeva,3,3,0,0,10
96944,ayyakena,ayyakena,10,10,0,0,8
96945,anabhisitte,anabhisitte,1,1,0,0,11
96946,arājini,arajini,1,1,0,0,7
96947,nappavattati,nappavattati,85,85,0,0,12
96948,ādānattho,adanattho,1,1,0,0,9
96949,rāhulānaṃ,rahulanam,1,1,0,0,9
96950,dabbavācakaṃ,dabbavacakam,1,1,0,0,12
96951,ekaccehi,ekaccehi,25,24,1,0,8
96952,duropitaṃ,duropitam,6,5,1,0,9
96953,suparisuddhesu,suparisuddhesu,1,1,0,0,14
96954,gambhīrasukhumañāṇehi,gambhirasukhumananehi,1,1,0,0,21
96955,ācariyapacāriyehi,acariyapacariyehi,1,1,0,0,17
96956,paṭhitattā,pathitatta,6,6,0,0,10
96957,sādhippāyā,sadhippaya,9,9,0,0,10
96958,atthappakāsanā,atthappakasana,10,10,0,0,14
96959,jātasāsanaṃ,jatasasanam,7,7,0,0,11
96960,saṃvegappatto,samvegappatto,31,31,0,0,13
96961,appadānavasena,appadanavasena,33,33,0,0,14
96962,uppannoti,uppannoti,92,78,14,0,9
96963,rāhuggahoti,rahuggahoti,1,0,1,0,11
96964,rāhuno,rahuno,7,7,0,0,6
96965,rāhuggahaṇaṃ,rahuggahanam,1,1,0,0,12
96966,rāhusadiso,rahusadiso,1,1,0,0,10
96967,candasadiso,candasadiso,3,3,0,0,11
96968,puttarāhunā,puttarahuna,1,1,0,0,11
96969,padesaṃ,padesam,315,293,22,0,7
96970,duropito,duropito,1,1,0,0,8
96971,porāṇako,poranako,25,25,0,0,8
96972,abhimato,abhimato,14,14,0,0,8
96973,pāṭhoyeva,pathoyeva,13,13,0,0,9
96974,avirodhatoti,avirodhatoti,1,1,0,0,12
96975,pāpadhammānaṃ,papadhammanam,74,72,2,0,13
96976,sānato,sanato,15,15,0,0,6
96977,tanukaraṇato,tanukaranato,13,13,0,0,12
96978,kusaṃ,kusam,53,43,10,0,5
96979,lātabbaṃ,latabbam,7,7,0,0,8
96980,diṭṭhadhammikasamparāyikasaṅkhāte,ditthadhammikasamparayikasankhate,1,1,0,0,33
96981,devadattakokālikādayo,devadattakokalikadayo,2,2,0,0,21
96982,taṃnāmāni,tamnamani,1,1,0,0,9
96983,avicakkhaṇo,avicakkhano,4,4,0,0,11
96984,apaṇḍito,apandito,11,11,0,0,8
96985,kumati,kumati,2,1,1,0,6
96986,nippañño,nippanno,18,18,0,0,8
96987,dummedhī,dummedhi,1,1,0,0,8
96988,avidū,avidu,2,2,0,0,5
96989,aviññū,avinnu,13,13,0,0,6
96990,andhabālo,andhabalo,32,32,0,0,9
96991,aviddasu,aviddasu,22,22,0,0,8
96992,mahallakoti,mahallakoti,18,4,14,0,11
96993,jiṇṇapuriso,jinnapuriso,2,2,0,0,11
96994,kattaro,kattaro,3,2,1,0,7
96995,jiṇṇapaññattiyo,jinnapannattiyo,1,1,0,0,15
96996,dure,dure,3,3,0,0,4
96997,therova,therova,15,14,1,0,7
96998,jiṇṇā,jinna,46,42,4,0,5
96999,vuddhī,vuddhi,33,32,1,0,6
97000,buddhī,buddhi,3,3,0,0,6
97001,vuḍḍhī,vuddhi,10,9,1,0,6
97002,jiṇṇāya,jinnaya,9,9,0,0,7
97003,dalito,dalito,1,1,0,0,6
97004,phalito,phalito,13,13,0,0,7
97005,sālaṅkānanayogepi,salankananayogepi,1,1,0,0,17
97006,sālaṅkānanavajjitā,salankananavajjita,1,1,0,0,18
97007,imissañhi,imissanhi,1,1,0,0,9
97008,alaṅka,alanka,1,0,1,0,6
97009,bhūsanavisesaṃ,bhusanavisesam,1,1,0,0,14
97010,bhūsanapariyāpanavāranesūti,bhusanapariyapanavaranesuti,1,0,1,0,27
97011,alatī,alati,1,1,0,0,5
97012,pariyattinivāraṇatthavācakattaṃ,pariyattinivaranatthavacakattam,1,1,0,0,31
97013,payogādassanato,payogadassanato,1,1,0,0,15
97014,pariyattinivāraṇatthavācako,pariyattinivaranatthavacako,1,1,0,0,27
97015,alametaṃ,alametam,45,34,11,0,8
97016,mīla,mila,4,2,2,0,4
97017,nimelane,nimelane,1,0,1,0,8
97018,mīlati,milati,1,1,0,0,6
97019,nimīlati,nimilati,5,5,0,0,8
97020,ummīlati,ummilati,4,4,0,0,8
97021,nīlavatthaṃ,nilavattham,13,10,3,0,11
97022,sīlanaṃ,silanam,19,17,2,0,7
97023,saddalakkhaṇavidū,saddalakkhanavidu,4,4,0,0,17
97024,anujānanti,anujananti,16,16,0,0,10
97025,siraṭṭho,sirattho,6,6,0,0,8
97026,sīlaṭṭho,silattho,12,11,1,0,8
97027,sītalaṭṭho,sitalattho,6,5,1,0,10
97028,nayenettha,nayenettha,23,23,0,0,10
97029,vaṇṇentī,vannenti,7,7,0,0,8
97030,saddalakkhaṇa,saddalakkhana,4,4,0,0,13
97031,anujānantī,anujananti,2,2,0,0,10
97032,dvigaṇikassa,dviganikassa,1,1,0,0,12
97033,sīlayatī,silayati,3,3,0,0,8
97034,upadhāretītipi,upadharetitipi,1,1,0,0,14
97035,gaṇikattā,ganikatta,2,2,0,0,9
97036,samādhānatthe,samadhanatthe,1,1,0,0,13
97037,sīlatī,silati,2,2,0,0,6
97038,samādhiyatīti,samadhiyatiti,28,4,24,0,13
97039,gaṇikavasena,ganikavasena,4,4,0,0,12
97040,patiṭṭhābhāvena,patitthabhavena,13,12,1,0,15
97041,kilati,kilati,2,2,0,0,6
97042,kilaṃ,kilam,2,2,0,0,5
97043,pakūlaje,pakulaje,2,2,0,0,8
97044,nadīkūle,nadikule,12,11,1,0,8
97045,vasāmahaṃ,vasamaham,23,23,0,0,9
97046,kūlati,kulati,1,1,0,0,6
97047,nikkhamituṃ,nikkhamitum,66,65,1,0,11
97048,sūlati,sulati,1,1,0,0,6
97049,kaṇṇasūlaṃ,kannasulam,13,12,1,0,10
97050,tūla,tula,1,0,1,0,4
97051,nikkarīse,nikkarise,1,0,1,0,9
97052,nikkarīsaṃ,nikkarisam,1,0,1,0,10
97053,karīsamattenapi,karisamattenapi,1,1,0,0,15
97054,aminetabbato,aminetabbato,1,1,0,0,12
97055,lahubhāvoyeva,lahubhavoyeva,1,1,0,0,13
97056,tūlati,tulati,1,1,0,0,6
97057,tūlaṃ,tulam,56,49,7,0,5
97058,bhaṭṭhaṃva,bhatthamva,6,5,1,0,10
97059,pañcapuli,pancapuli,1,1,0,0,9
97060,uddhareyya,uddhareyya,73,70,3,0,10
97061,ussīranāḷimattānipī,ussiranalimattanipi,1,1,0,0,19
97062,akusalamūlaṃ,akusalamulam,278,259,19,0,12
97063,asādhāraṇahetumhi,asadharanahetumhi,7,7,0,0,17
97064,yāvamajjhanhike,yavamajjhanhike,1,1,0,0,15
97065,rukkhamūlaṃ,rukkhamulam,224,193,31,0,11
97066,nibbattiyaṃ,nibbattiyam,5,4,1,0,11
97067,mahānisaṃsaṃ,mahanisamsam,68,62,6,0,12
97068,sotāpattiphalaṃ,sotapattiphalam,284,280,4,0,15
97069,mahānibbattikaṃ,mahanibbattikam,1,1,0,0,15
97070,phalatu,phalatu,26,26,0,0,7
97071,phaliṃsu,phalimsu,19,19,0,0,8
97072,phalatūti,phalatuti,2,1,1,0,9
97073,bhajjitu,bhajjitu,1,1,0,0,8
97074,asanī,asani,9,9,0,0,5
97075,asaniyā,asaniya,23,22,1,0,7
97076,phalantiyā,phalantiya,19,19,0,0,10
97077,santasanti,santasanti,9,8,1,0,10
97078,phalantiyāti,phalantiyati,3,0,3,0,12
97079,karontiyā,karontiya,73,71,2,0,9
97080,hāvakaraṇaṃ,havakaranam,1,0,1,0,11
97081,vilāsakaraṇaṃ,vilasakaranam,1,1,0,0,13
97082,cullati,cullati,1,1,0,0,7
97083,vikasanabhedesu,vikasanabhedesu,1,0,1,0,15
97084,phullati,phullati,3,3,0,0,8
97085,phullito,phullito,18,17,1,0,8
97086,suphullitamaravindavanaṃ,suphullitamaravindavanam,1,1,0,0,24
97087,asītihatthamubbedho,asitihatthamubbedho,10,10,0,0,19
97088,dīparukkhova,diparukkhova,12,12,0,0,12
97089,sālarājāva,salarajava,30,28,2,0,10
97090,khaṇḍaphullapaṭisaṅkharaṇaṃ,khandaphullapatisankharanam,6,5,1,0,27
97091,cilla,cilla,1,0,1,0,5
97092,siṭhilabhāvo,sithilabhavo,1,1,0,0,12
97093,seṭhillaṃ,sethillam,1,0,1,0,9
97094,cillati,cillati,1,1,0,0,7
97095,velu,velu,1,0,1,0,4
97096,celu,celu,1,0,1,0,4
97097,kelu,kelu,1,0,1,0,4
97098,khelu,khelu,1,0,1,0,5
97099,pelu,pelu,1,0,1,0,4
97100,belu,belu,1,0,1,0,4
97101,selu,selu,4,3,1,0,4
97102,velati,velati,1,1,0,0,6
97103,celati,celati,1,1,0,0,6
97104,kelati,kelati,1,1,0,0,6
97105,khelati,khelati,1,1,0,0,7
97106,pelati,pelati,1,1,0,0,6
97107,belati,belati,1,1,0,0,6
97108,selati,selati,1,1,0,0,6
97109,tilati,tilati,2,2,0,0,6
97110,belako,belako,1,1,0,0,6
97111,pelakoti,pelakoti,1,0,1,0,8
97112,khalati,khalati,3,3,0,0,7
97113,khaloti,khaloti,1,0,1,0,7
97114,pāpajano,papajano,2,2,0,0,8
97115,sañcinane,sancinane,1,0,1,0,9
97116,khalaṃ,khalam,26,21,5,0,6
97117,vīhiṭṭhapanokāsabhūtaṃ,vihitthapanokasabhutam,1,1,0,0,22
97118,bhūmimaṇḍalaṃ,bhumimandalam,1,1,0,0,13
97119,khalanti,khalanti,2,2,0,0,8
97120,sañcinanti,sancinanti,2,2,0,0,10
97121,dhaññānīti,dhannaniti,8,1,7,0,10
97122,pasuṃ,pasum,38,31,7,0,5
97123,abhikkhaṇaṃ,abhikkhanam,131,120,11,0,11
97124,ajjhoharaṇe,ajjhoharane,5,4,1,0,11
97125,gilamakkhaṃ,gilamakkham,4,4,0,0,11
97126,ajjhoharanti,ajjhoharanti,5,5,0,0,12
97127,galoti,galoti,3,1,2,0,6
97128,āsugati,asugati,1,0,1,0,7
97129,sallati,sallati,3,3,0,0,7
97130,khola,khola,1,0,1,0,5
97131,kholati,kholati,1,1,0,0,7
97132,pītikkhaye,pitikkhaye,1,0,1,0,10
97133,gilāno,gilano,396,382,14,0,6
97134,gilānoti,gilanoti,14,8,6,0,8
97135,akallako,akallako,24,20,4,0,8
97136,vinayepi,vinayepi,16,15,1,0,8
97137,akallakoti,akallakoti,15,4,11,0,10
97138,milāyati,milayati,13,13,0,0,8
97139,milāyano,milayano,1,1,0,0,8
97140,milāyanto,milayanto,2,2,0,0,9
97141,milāyamāno,milayamano,1,1,0,0,10
97142,kele,kele,1,0,1,0,4
97143,mamāyane,mamayane,1,0,1,0,8
97144,mamāyanaṃ,mamayanam,7,6,1,0,9
97145,taṇhādiṭṭhivasena,tanhaditthivasena,52,50,2,0,17
97146,kelāyati,kelayati,6,5,1,0,8
97147,saṃvaraṇāpekkhāyaṃ,samvaranapekkhayam,1,1,0,0,18
97148,pāpadhamme,papadhamme,43,42,1,0,10
97149,vallanti,vallanti,1,1,0,0,8
97150,kākasenādayo,kakasenadayo,1,1,0,0,12
97151,akhādanatthāyāti,akhadanatthayati,1,1,0,0,16
97152,mallati,mallati,1,1,0,0,7
97153,bhalati,bhalati,1,1,0,0,7
97154,bhallati,bhallati,1,1,0,0,8
97155,soḷasabhāgādibhāgo,solasabhagadibhago,1,1,0,0,18
97156,atkkanto,atkkanto,1,1,0,0,8
97157,kalitabbo,kalitabbo,1,1,0,0,9
97158,saṅkhātabboti,sankhatabboti,1,1,0,0,13
97159,pubbaṇhādisamayo,pubbanhadisamayo,1,1,0,0,16
97160,asadde,asadde,1,0,1,0,6
97161,asaddo,asaddo,5,4,1,0,6
97162,pajjalanto,pajjalanto,7,7,0,0,10
97163,jalaṃva,jalamva,6,3,3,0,7
97164,saddhammapajjoto,saddhammapajjoto,2,2,0,0,16
97165,jalito,jalito,16,15,1,0,6
97166,hula,hula,3,0,3,0,4
97167,hulati,hulati,2,2,0,0,6
97168,haloti,haloti,1,0,1,0,6
97169,holeti,holeti,1,1,0,0,6
97170,bhindanto,bhindanto,59,56,3,0,9
97171,mattikakhaṇḍaṃ,mattikakhandam,1,1,0,0,14
97172,cāletīti,caletiti,6,3,3,0,8
97173,cālo,calo,2,2,0,0,4
97174,ṭala,tala,1,0,1,0,4
97175,ṭula,tula,1,0,1,0,4
97176,ṭalati,talati,1,1,0,0,6
97177,ṭulati,tulati,1,1,0,0,6
97178,thalati,thalati,2,2,0,0,7
97179,thalo,thalo,3,3,0,0,5
97180,thaloti,thaloti,1,0,1,0,7
97181,pabbajjānibbānesupi,pabbajjanibbanesupi,1,1,0,0,19
97182,udakoghena,udakoghena,25,25,0,0,10
97183,anottharaṇaṭṭhānaṃ,anottharanatthanam,1,1,0,0,18
97184,kilesoghena,kilesoghena,1,1,0,0,11
97185,anottharaṇīyattā,anottharaniyatta,1,1,0,0,16
97186,phālati,phalati,1,1,0,0,7
97187,nalati,nalati,1,1,0,0,6
97188,sasanañca,sasananca,1,1,0,0,9
97189,kāyabalabhogabalādikaṃ,kayabalabhogabaladikam,1,1,0,0,22
97190,sammājīvanaṃ,sammajivanam,1,1,0,0,12
97191,saddhādikaṃ,saddhadikam,2,2,0,0,11
97192,assaddhiye,assaddhiye,41,38,3,0,10
97193,saddhābalaṃ,saddhabalam,130,115,15,0,11
97194,daḷhaṭṭhena,dalhatthena,2,2,0,0,11
97195,vattabbānaṃ,vattabbanam,11,11,0,0,11
97196,akampanabhāvadassanatthaṃ,akampanabhavadassanattham,1,1,0,0,25
97197,assaddhiyādīnaṃ,assaddhiyadinam,15,15,0,0,15
97198,abhibhavanena,abhibhavanena,3,3,0,0,13
97199,saddhādibalānaṃ,saddhadibalanam,3,3,0,0,15
97200,abhibhavanatthopi,abhibhavanatthopi,1,1,0,0,17
97201,baliyantī,baliyanti,1,1,0,0,9
97202,assasati,assasati,76,68,8,0,8
97203,passasati,passasati,52,48,4,0,9
97204,balantīti,balantiti,1,1,0,0,9
97205,paññājīvinoyeva,pannajivinoyeva,1,1,0,0,15
97206,paññājīviṃ,pannajivim,18,16,2,0,10
97207,jīvitamāhu,jivitamahu,30,26,4,0,10
97208,saṅkhāne,sankhane,4,3,1,0,8
97209,kolati,kolati,1,1,0,0,6
97210,pītiya,pitiya,1,0,1,0,6
97211,kīḷanesu,kilanesu,1,0,1,0,8
97212,pītassa,pitassa,14,14,0,0,7
97213,kīḷāyeva,kilayeva,1,1,0,0,8
97214,elaṃ,elam,28,22,6,0,4
97215,kampanaṭṭhena,kampanatthena,4,4,0,0,13
97216,nelaṅgo,nelango,21,20,1,0,7
97217,setapacchādo,setapacchado,23,22,1,0,12
97218,elambujaṃ,elambujam,7,4,3,0,9
97219,kaṇṭakiṃ,kantakim,2,2,0,0,8
97220,elāti,elati,5,2,3,0,5
97221,elamūgo,elamugo,2,2,0,0,7
97222,nelapatiṃ,nelapatim,5,3,2,0,9
97223,panthā,pantha,5,5,0,0,6
97224,apakkamuṃ,apakkamum,5,5,0,0,9
97225,kheḷabindunipātavirahitaṃ,khelabindunipatavirahitam,1,1,0,0,25
97226,lālākheḷavācakassa,lalakhelavacakassa,2,2,0,0,18
97227,pariyesitabbaṃ,pariyesitabbam,96,81,15,0,14
97228,anekappavattinimittā,anekappavattinimitta,1,1,0,0,20
97229,kampaneti,kampaneti,1,0,1,0,9
97230,ilanti,ilanti,1,1,0,0,6
97231,jigucchitabbabhāvena,jigucchitabbabhavena,1,1,0,0,20
97232,samānapavattinimittāyeva,samanapavattinimittayeva,1,1,0,0,24
97233,nānāpadatthavācakāpi,nanapadatthavacakapi,1,1,0,0,20
97234,asamānappavattinimittāyeva,asamanappavattinimittayeva,1,1,0,0,26
97235,samānapadatthavācakāpi,samanapadatthavacakapi,1,1,0,0,22
97236,rañcatīti,rancatiti,1,1,0,0,9
97237,narindoti,narindoti,1,0,1,0,9
97238,helati,helati,1,1,0,0,6
97239,silati,silati,1,1,0,0,6
97240,sinehane,sinehane,11,3,8,0,8
97241,cilati,cilati,1,1,0,0,6
97242,vilāsane,vilasane,1,0,1,0,8
97243,pilati,pilati,1,1,0,0,6
97244,milati,milati,2,2,0,0,6
97245,phula,phula,2,1,1,0,5
97246,sañcale,sancale,2,1,1,0,7
97247,phulati,phulati,1,1,0,0,7
97248,vakārantadhātu,vakarantadhatu,2,2,0,0,14
97249,pajanakanti,pajanakanti,1,0,1,0,11
97250,asanakhādana,asanakhadana,1,0,1,0,12
97251,abhiruci,abhiruci,16,16,0,0,8
97252,bhattaparibhogo,bhattaparibhogo,2,2,0,0,15
97253,pūvādibhakkhanaṃ,puvadibhakkhanam,1,1,0,0,16
97254,dhivu,dhivu,2,0,2,0,5
97255,khivu,khivu,3,0,3,0,5
97256,dhevati,dhevati,1,1,0,0,7
97257,khevati,khevati,2,2,0,0,7
97258,thivu,thivu,1,0,1,0,5
97259,thevati,thevati,1,1,0,0,7
97260,madhumadhukā,madhumadhuka,3,3,0,0,12
97261,thevanti,thevanti,3,3,0,0,8
97262,yādisakīdisā,yadisakidisa,3,3,0,0,12
97263,niva,niva,1,0,1,0,4
97264,pivaro,pivaro,2,2,0,0,6
97265,mivati,mivati,1,1,0,0,6
97266,tivati,tivati,1,1,0,0,6
97267,nivati,nivati,1,1,0,0,6
97268,pivaroti,pivaroti,1,0,1,0,8
97269,thūlasarīro,thulasariro,19,19,0,0,11
97270,khivati,khivati,1,1,0,0,7
97271,dhovu,dhovu,2,1,1,0,5
97272,dhovane,dhovane,14,11,3,0,7
97273,devu,devu,3,1,2,0,4
97274,devane,devane,2,1,1,0,6
97275,devati,devati,2,2,0,0,6
97276,ādevati,adevati,1,1,0,0,7
97277,paridevati,paridevati,129,126,3,0,10
97278,ādevo,adevo,16,11,5,0,5
97279,ādevanā,adevana,11,11,0,0,7
97280,paridevanā,paridevana,49,49,0,0,10
97281,ādevitattaṃ,adevitattam,13,13,0,0,11
97282,paridevitattaṃ,paridevitattam,13,13,0,0,14
97283,sevu,sevu,2,1,1,0,4
97284,kevu,kevu,1,0,1,0,4
97285,khevu,khevu,1,0,1,0,5
97286,gevu,gevu,1,0,1,0,4
97287,gilevu,gilevu,1,0,1,0,6
97288,mevu,mevu,1,0,1,0,4
97289,milevu,milevu,1,0,1,0,6
97290,gevati,gevati,1,1,0,0,6
97291,gilevati,gilevati,1,1,0,0,8
97292,mevati,mevati,1,1,0,0,6
97293,milevati,milevati,1,1,0,0,8
97294,plutagati,plutagati,1,0,1,0,9
97295,pariplutagamanaṃ,pariplutagamanam,1,1,0,0,16
97296,ādhāvati,adhavati,2,2,0,0,8
97297,paridhāvati,paridhavati,9,9,0,0,11
97298,dhāvako,dhavako,1,1,0,0,7
97299,civu,civu,1,0,1,0,4
97300,ādānasaṃvaresu,adanasamvaresu,1,0,1,0,14
97301,civati,civati,1,1,0,0,6
97302,cevi,cevi,1,0,1,0,4
97303,cetanātulye,cetanatulye,1,0,1,0,11
97304,cevati,cevati,1,1,0,0,6
97305,sakārantadhātu,sakarantadhatu,4,4,0,0,14
97306,sevanā,sevana,68,62,6,0,6
97307,seṭṭhamupagamaṃ,setthamupagamam,4,3,1,0,15
97308,bhajetha,bhajetha,34,29,5,0,8
97309,atiseti,atiseti,25,25,0,0,7
97310,atisituṃ,atisitum,1,1,0,0,8
97311,atisitvā,atisitva,17,15,2,0,8
97312,sutoti,sutoti,12,8,4,0,6
97313,vittiñhi,vittinhi,1,1,0,0,8
97314,devasuto,devasuto,2,2,0,0,8
97315,hatthisuttādi,hatthisuttadi,1,1,0,0,13
97316,pāṇagabbhavimocanesu,panagabbhavimocanesu,1,0,1,0,20
97317,hiṃsako,himsako,3,3,0,0,7
97318,hiṃsanā,himsana,9,8,1,0,7
97319,issāyaṃ,issayam,4,3,1,0,7
97320,issāyanā,issayana,11,9,2,0,8
97321,vandanānatiyaṃ,vandananatiyam,1,0,1,0,14
97322,vandanānati,vandananati,1,0,1,0,11
97323,vandanāsaṅkhātaṃ,vandanasankhatam,1,1,0,0,16
97324,sakammakoyevāyaṃ,sakammakoyevayam,1,1,0,0,16
97325,ghusati,ghusati,3,3,0,0,7
97326,ghosati,ghosati,4,4,0,0,7
97327,cusa,cusa,1,0,1,0,4
97328,cusati,cusati,1,1,0,0,6
97329,pusati,pusati,2,2,0,0,6
97330,sampīḷe,sampile,4,4,0,0,7
97331,duddikkho,duddikkho,6,5,1,0,9
97332,cakkhumusano,cakkhumusano,1,1,0,0,12
97333,vāsati,vasati,1,1,0,0,6
97334,bhūsati,bhusati,1,1,0,0,7
97335,vibhūsati,vibhusati,1,1,0,0,9
97336,ucche,ucche,1,0,1,0,5
97337,esantīti,esantiti,9,7,2,0,8
97338,tāpasapabbajjāya,tapasapabbajjaya,15,15,0,0,16
97339,tāpasapariyāyā,tapasapariyaya,1,1,0,0,14
97340,kassakoti,kassakoti,1,0,1,0,9
97341,kasikārako,kasikarako,1,1,0,0,10
97342,ākāsoti,akasoti,40,31,9,0,7
97343,kassatīti,kassatiti,7,5,2,0,9
97344,kasituṃ,kasitum,25,25,0,0,7
97345,vilekhituṃ,vilekhitum,1,1,0,0,10
97346,antalikkha,antalikkha,1,1,0,0,10
97347,maghaṃ,magham,4,4,0,0,6
97348,mādiccapathopi,madiccapathopi,1,1,0,0,14
97349,nakkhattapatho,nakkhattapatho,1,1,0,0,14
97350,ravipathopi,ravipathopi,1,1,0,0,11
97351,vāyupatho,vayupatho,1,1,0,0,9
97352,apatho,apatho,1,1,0,0,6
97353,anilañjasaṃ,anilanjasam,2,2,0,0,11
97354,jasa,jasa,3,0,3,0,4
97355,jusa,jusa,3,0,3,0,4
97356,yusa,yusa,1,0,1,0,4
97357,jasati,jasati,1,1,0,0,6
97358,jhasati,jhasati,1,1,0,0,7
97359,masako,masako,2,2,0,0,6
97360,omasati,omasati,23,23,0,0,7
97361,omasavādo,omasavado,7,5,2,0,9
97362,jusati,jusati,1,1,0,0,6
97363,yūsati,yusati,1,1,0,0,6
97364,omasatīti,omasatiti,2,0,2,0,9
97365,omasavādoti,omasavadoti,1,0,1,0,11
97366,vijjhanavādo,vijjhanavado,1,1,0,0,12
97367,masakoti,masakoti,1,0,1,0,8
97368,bhassakārakaṃ,bhassakarakam,2,2,0,0,13
97369,subhāsitā,subhasita,77,70,7,0,9
97370,atthavatī,atthavati,16,16,0,0,9
97371,nijjhattomhi,nijjhattomhi,3,3,0,0,12
97372,subhaṭṭhena,subhatthena,3,3,0,0,11
97373,nijjhattoti,nijjhattoti,1,0,1,0,11
97374,nijjhāpito,nijjhapito,2,2,0,0,10
97375,paññattigato,pannattigato,1,1,0,0,12
97376,subhaṭṭhenāti,subhatthenati,2,0,2,0,13
97377,subhāsitena,subhasitena,35,35,0,0,11
97378,jisu,jisu,1,0,1,0,4
97379,misu,misu,1,0,1,0,4
97380,jesati,jesati,2,2,0,0,6
97381,nesati,nesati,5,4,1,0,6
97382,vesati,vesati,1,1,0,0,6
97383,mesati,mesati,3,3,0,0,6
97384,marisu,marisu,1,0,1,0,6
97385,secanāpekkhako,secanapekkhako,1,1,0,0,14
97386,marisati,marisati,1,1,0,0,8
97387,posati,posati,14,14,0,0,6
97388,kammacittautuāhiārehi,kammacittautuahiarehi,1,1,0,0,21
97389,posiyatīti,posiyatiti,1,1,0,0,10
97390,posetī,poseti,7,7,0,0,6
97391,silisu,silisu,1,0,1,0,6
97392,pusu,pusu,1,0,1,0,4
97393,palusu,palusu,1,0,1,0,6
97394,upadāhe,upadahe,1,0,1,0,7
97395,pesati,pesati,2,2,0,0,6
97396,silesati,silesati,1,1,0,0,8
97397,palosati,palosati,1,1,0,0,8
97398,osati,osati,2,2,0,0,5
97399,ghasu,ghasu,1,0,1,0,5
97400,saṅghaṭṭanaṃ,sanghattanam,35,34,1,0,12
97401,ghassati,ghassati,1,1,0,0,8
97402,hasu,hasu,1,0,1,0,4
97403,āliṅge,alinge,1,0,1,0,6
97404,upagūhanaṃ,upaguhanam,2,2,0,0,10
97405,hasanti,hasanti,53,53,0,0,7
97406,ājānīyā,ajaniya,21,21,0,0,7
97407,pahasati,pahasati,1,1,0,0,8
97408,uhasati,uhasati,4,4,0,0,7
97409,hāseti,haseti,14,13,1,0,6
97410,uhasiyamāno,uhasiyamano,2,2,0,0,11
97411,pahāso,pahaso,29,25,4,0,6
97412,pahasanaṃ,pahasanam,1,1,0,0,9
97413,mandahasanaṃ,mandahasanam,1,1,0,0,12
97414,pātvākāsī,patvakasi,4,4,0,0,9
97415,uhasatīti,uhasatiti,1,0,1,0,9
97416,avahasati,avahasati,3,3,0,0,9
97417,udasiyamānoti,udasiyamanoti,1,0,1,0,13
97418,avahasiyamāno,avahasiyamano,3,3,0,0,13
97419,araññagataṃ,arannagatam,24,23,1,0,11
97420,rukkhamūlagataṃ,rukkhamulagatam,9,9,0,0,15
97421,suññāgāragataṃ,sunnagaragatam,8,8,0,0,14
97422,upapajjathā,upapajjatha,8,8,0,0,11
97423,hisa,hisa,1,0,1,0,4
97424,tusati,tusati,2,2,0,0,6
97425,hisati,hisati,1,1,0,0,6
97426,rasati,rasati,5,5,0,0,6
97427,bheriyo,bheriyo,35,34,1,0,7
97428,rasantu,rasantu,3,2,1,0,7
97429,assādasinehesu,assadasinehesu,1,0,1,0,14
97430,naheva,naheva,20,19,1,0,6
97431,ṭhita,thita,19,18,1,0,5
97432,sīnaṃ,sinam,3,3,0,0,5
97433,sayānaṃ,sayanam,7,5,2,0,7
97434,paddhaguṃ,paddhagum,5,3,2,0,9
97435,nimīsati,nimisati,2,2,0,0,8
97436,rasatibbayoti,rasatibbayoti,1,0,1,0,13
97437,silesanakīḷanesu,silesanakilanesu,1,0,1,0,16
97438,lāso,laso,2,2,0,0,4
97439,lasī,lasi,5,4,1,0,4
97440,nippalitā,nippalita,3,3,0,0,9
97441,lasi,lasi,2,1,1,0,4
97442,matthaluṅgaṃ,matthalungam,75,63,12,0,12
97443,nippalitāti,nippalitati,1,0,1,0,11
97444,nisa,nisa,2,0,2,0,4
97445,cittekaggatā,cittekaggata,132,121,11,0,12
97446,pesu,pesu,1,0,1,0,4
97447,hiṃsāpekkhāya,himsapekkhaya,1,1,0,0,13
97448,pasaṃsamāno,pasamsamano,3,3,0,0,11
97449,pasaṃsito,pasamsito,57,49,8,0,9
97450,pasaṃsako,pasamsako,3,3,0,0,9
97451,pasaṃsitabbo,pasamsitabbo,8,6,2,0,12
97452,pasaṃsanīyo,pasamsaniyo,12,12,0,0,11
97453,pasaṃsitvā,pasamsitva,36,35,1,0,10
97454,nānārūpāni,nanarupani,7,7,0,0,10
97455,dissatu,dissatu,7,7,0,0,7
97456,dakkhatu,dakkhatu,4,4,0,0,8
97457,disseyya,disseyya,4,4,0,0,8
97458,dakkheyya,dakkheyya,7,7,0,0,9
97459,disse,disse,3,3,0,0,5
97460,dakkhe,dakkhe,5,5,0,0,6
97461,adissā,adissa,1,1,0,0,6
97462,sīdantare,sidantare,13,12,1,0,9
97463,nage,nage,13,13,0,0,4
97464,addakkhā,addakkha,1,1,0,0,8
97465,addakkhuṃ,addakkhum,20,19,1,0,9
97466,adassuṃ,adassum,1,1,0,0,7
97467,dassissati,dassissati,3,2,1,0,10
97468,passissati,passissati,40,39,1,0,10
97469,adassissā,adassissa,1,1,0,0,9
97470,apassissā,apassissa,1,1,0,0,9
97471,dakkhissā,dakkhissa,1,1,0,0,9
97472,vattamānapañcamiyādivasena,vattamanapancamiyadivasena,1,1,0,0,26
97473,dassayatī,dassayati,1,1,0,0,9
97474,passiyati,passiyati,1,1,0,0,9
97475,passitā,passita,8,7,1,0,7
97476,ñāṇadassananti,nanadassananti,17,14,3,0,14
97477,āgatāmha,agatamha,5,5,0,0,8
97478,dhammasamayaṃ,dhammasamayam,6,4,2,0,13
97479,dakkhitāyeti,dakkhitayeti,1,0,1,0,12
97480,dassanatthāyāti,dassanatthayati,3,2,1,0,15
97481,passitunti,passitunti,7,7,0,0,10
97482,disātiādīsu,disatiadisu,1,0,1,0,11
97483,puratthimādibhedāpi,puratthimadibhedapi,1,1,0,0,19
97484,disāti,disati,67,17,50,0,6
97485,yamaddasā,yamaddasa,7,7,0,0,9
97486,chabbisāṇaṃ,chabbisanam,11,11,0,0,11
97487,mātāpitādayopi,matapitadayopi,1,1,0,0,14
97488,mittāmaccā,mittamacca,75,72,3,0,10
97489,dāsakammakarā,dasakammakara,24,23,1,0,13
97490,namasseyya,namasseyya,17,17,0,0,10
97491,alamatto,alamatto,16,16,0,0,8
97492,paccayadāyakāpi,paccayadayakapi,2,2,0,0,15
97493,agārino,agarino,11,11,0,0,7
97494,annadapānavatthadā,annadapanavatthada,5,5,0,0,18
97495,avhāyikā,avhayika,6,6,0,0,8
97496,nampi,nampi,8,4,4,0,5
97497,niddukkhā,niddukkha,16,15,1,0,9
97498,attharūpaṃ,attharupam,1,1,0,0,10
97499,nibbacanamevaṃ,nibbacanamevam,1,1,0,0,14
97500,candāvaṭṭanādivasena,candavattanadivasena,1,1,0,0,20
97501,paññāyatīti,pannayatiti,203,140,63,0,11
97502,puratthimadisādayo,puratthimadisadayo,1,1,0,0,18
97503,garuṭṭhānaṃ,garutthanam,1,1,0,0,11
97504,passitabbāti,passitabbati,4,3,1,0,12
97505,dāyakāti,dayakati,3,2,1,0,8
97506,paññāyantīti,pannayantiti,24,20,4,0,12
97507,paccayadāyakā,paccayadayaka,20,20,0,0,13
97508,niccadhammattā,niccadhammatta,1,1,0,0,14
97509,sabbakālampi,sabbakalampi,19,18,1,0,12
97510,passoti,passoti,3,0,3,0,7
97511,apassantampi,apassantampi,2,2,0,0,12
97512,passantampi,passantampi,1,1,0,0,11
97513,dassanakriyā,dassanakriya,1,1,0,0,12
97514,nibbānadassanato,nibbanadassanato,17,17,0,0,16
97515,kattabbakiccaṃ,kattabbakiccam,88,86,2,0,14
97516,appahānato,appahanato,8,8,0,0,10
97517,disvāpi,disvapi,135,128,7,0,7
97518,kiccanipphattiyā,kiccanipphattiya,16,16,0,0,16
97519,adiṭṭhattā,aditthatta,34,34,0,0,10
97520,ajjāpi,ajjapi,110,103,7,0,6
97521,passāmīti,passamiti,151,116,35,0,9
97522,gāmavāsī,gamavasi,28,28,0,0,8
97523,vipassanāti,vipassanati,58,32,26,0,11
97524,vipassanakaṃ,vipassanakam,1,1,0,0,12
97525,dibbacakkhupi,dibbacakkhupi,7,6,1,0,13
97526,vipassanāpi,vipassanapi,26,24,2,0,11
97527,paccavekkhaṇañāṇampi,paccavekkhanananampi,11,11,0,0,20
97528,sabbaññutaññāṇampi,sabbannutannanampi,17,15,2,0,18
97529,ārādhetī,aradheti,9,9,0,0,8
97530,ñāṇadassanāya,nanadassanaya,32,31,1,0,13
97531,abhininnāmetī,abhininnameti,10,10,0,0,13
97532,vipassanāñāṇaṃ,vipassanananam,155,140,15,0,14
97533,abhabbā,abhabba,143,126,17,0,7
97534,anuttarāya,anuttaraya,61,58,3,0,10
97535,sambodhāyā,sambodhaya,7,7,0,0,10
97536,ayamañño,ayamanno,16,16,0,0,8
97537,uttarimanussadhammo,uttarimanussadhammo,46,36,10,0,19
97538,alamariyañāṇadassanaviseso,alamariyananadassanaviseso,51,45,6,0,26
97539,phāsuvihāro,phasuviharo,174,157,17,0,11
97540,phalañāṇaṃ,phalananam,25,25,0,0,10
97541,akuppā,akuppa,86,71,15,0,6
97542,cetovimutti,cetovimutti,238,210,28,0,11
97543,paccavekkhaṇañāṇaṃ,paccavekkhanananam,101,93,8,0,18
97544,sattāhakālaṅkato,sattahakalankato,10,9,1,0,16
97545,āḷāro,alaro,83,82,1,0,5
97546,kālāmo,kalamo,73,72,1,0,6
97547,phalañcāpi,phalancapi,3,2,1,0,10
97548,sabbaññutāpi,sabbannutapi,1,1,0,0,12
97549,ñāṇadassana,nanadassana,4,1,3,0,11
97550,vidaṃseti,vidamseti,15,15,0,0,9
97551,saṃse,samse,11,11,0,0,5
97552,mahānāgaṃ,mahanagam,34,33,1,0,9
97553,kilisa,kilisa,6,1,5,0,6
97554,kilisati,kilisati,2,2,0,0,8
97555,bādhanaṭṭhena,badhanatthena,3,3,0,0,13
97556,rāgādayopi,ragadayopi,4,4,0,0,10
97557,dukkhampi,dukkhampi,37,37,0,0,9
97558,dukkhavasena,dukkhavasena,11,9,2,0,12
97559,kilesamattano,kilesamattano,1,1,0,0,13
97560,ānandiyaṃ,anandiyam,4,3,1,0,9
97561,vicariṃsu,vicarimsu,57,57,0,0,9
97562,ramaṇīye,ramaniye,98,97,1,0,8
97563,giribbaje,giribbaje,32,31,1,0,9
97564,kilissatī,kilissati,3,3,0,0,9
97565,vilīnasineho,vilinasineho,3,3,0,0,12
97566,nāḷikeratelavaṇṇā,nalikeratelavanna,3,3,0,0,17
97567,ācāme,acame,6,6,0,0,5
97568,āsittatelavaṇṇātipi,asittatelavannatipi,3,3,0,0,19
97569,hiṃsāgatidassanesu,himsagatidassanesu,1,0,1,0,18
97570,bhāsabyattāyaṃ,bhasabyattayam,1,0,1,0,14
97571,paribhāsati,paribhasati,100,100,0,0,11
97572,paribhāsako,paribhasako,39,38,1,0,11
97573,māgadhabhāsādi,magadhabhasadi,1,1,0,0,14
97574,jeṭṭhabhātāti,jetthabhatati,3,2,1,0,13
97575,vattuṃlabhati,vattumlabhati,1,1,0,0,13
97576,bhātikasataṃ,bhatikasatam,2,2,0,0,12
97577,sattabhātaro,sattabhataro,1,1,0,0,12
97578,dujjāsi,dujjasi,2,2,0,0,7
97579,jeṭṭhakaniṭṭhabhātūsu,jetthakanitthabhatusu,1,1,0,0,21
97580,jeṭṭhake,jetthake,8,8,0,0,8
97581,nirūṭṭho,niruttho,1,1,0,0,8
97582,kaniṭṭhabhātā,kanitthabhata,65,64,1,0,13
97583,jeṭṭhabhātā,jetthabhata,27,26,1,0,11
97584,kaniṭṭhepi,kanitthepi,1,1,0,0,10
97585,hariṇesu,harinesu,1,1,0,0,8
97586,avasesacatuppadesupi,avasesacatuppadesupi,1,1,0,0,20
97587,hariṇamigo,harinamigo,1,1,0,0,10
97588,sampadamidaṃ,sampadamidam,47,47,0,0,12
97589,gohatthimahiṃsaacchasūkarasasabiḷārādīsu,gohatthimahimsaacchasukarasasabilaradisu,1,1,0,0,40
97590,vattamānepi,vattamanepi,4,4,0,0,11
97591,migacammaṃ,migacammam,15,15,0,0,10
97592,migamaṃsaṃ,migamamsam,18,18,0,0,10
97593,hariṇassā,harinassa,1,1,0,0,9
97594,visesanasaddaṃ,visesanasaddam,2,2,0,0,14
97595,hariṇamigacammaṃ,harinamigacammam,1,1,0,0,16
97596,hariṇamigamaṃsaṃ,harinamigamamsam,1,1,0,0,16
97597,visesatthādhigamo,visesatthadhigamo,3,3,0,0,17
97598,gohatthiādīnaṃ,gohatthiadinam,3,3,0,0,14
97599,khādantī,khadanti,36,34,2,0,8
97600,khādantīti,khadantiti,17,9,8,0,10
97601,jeṭṭhaka,jetthaka,3,2,1,0,8
97602,jeṭṭhakabhātā,jetthakabhata,5,5,0,0,13
97603,cammamaṃsa,cammamamsa,2,0,2,0,10
97604,saddeheva,saddeheva,1,1,0,0,9
97605,lokasaṅketena,lokasanketena,4,3,1,0,13
97606,paricchinnattā,paricchinnatta,39,39,0,0,14
97607,cammādīni,cammadini,6,6,0,0,9
97608,hariṇacammādīniyeva,harinacammadiniyeva,1,1,0,0,19
97609,gilesu,gilesu,1,0,1,0,6
97610,anvicchāyaṃ,anvicchayam,1,0,1,0,11
97611,anvicchā,anviccha,1,0,1,0,8
97612,gilesati,gilesati,1,1,0,0,8
97613,yesati,yesati,1,1,0,0,6
97614,jesu,jesu,1,0,1,0,4
97615,hesu,hesu,4,2,2,0,4
97616,hesati,hesati,2,2,0,0,6
97617,jessati,jessati,5,5,0,0,7
97618,nessatī,nessati,3,3,0,0,7
97619,jessamāno,jessamano,1,1,0,0,9
97620,jessaṃ,jessam,1,1,0,0,6
97621,jessanto,jessanto,1,1,0,0,8
97622,desu,desu,1,0,1,0,4
97623,desati,desati,2,2,0,0,6
97624,kāsati,kasati,7,7,0,0,6
97625,ukkāsati,ukkasati,1,1,0,0,8
97626,sāsaṃ,sasam,4,4,0,0,5
97627,balyaṃ,balyam,3,3,0,0,6
97628,khīṇamedho,khinamedho,3,3,0,0,10
97629,dittīti,dittiti,1,0,1,0,7
97630,virājanatā,virajanata,2,2,0,0,10
97631,pabhāsati,pabhasati,36,36,0,0,9
97632,tucchabhāvena,tucchabhavena,3,3,0,0,13
97633,puñjabhāvena,punjabhavena,1,1,0,0,12
97634,āvāṭopi,avatopi,4,4,0,0,7
97635,rāsipi,rasipi,5,5,0,0,6
97636,kiṃnu,kimnu,25,24,1,0,5
97637,khanasi,khanasi,3,3,0,0,7
97638,kiṃkāsuyā,kimkasuya,1,1,0,0,9
97639,karissasī,karissasi,83,78,5,0,9
97640,rudantā,rudanta,19,19,0,0,7
97641,paridaḍḍhagattā,paridaddhagatta,8,7,1,0,15
97642,obhāsetīti,obhasetiti,10,6,4,0,10
97643,obhāsako,obhasako,1,1,0,0,8
97644,pakāsiyatīti,pakasiyatiti,1,1,0,0,12
97645,kāsanā,kasana,6,5,1,0,6
97646,saṅkāsanā,sankasana,20,18,2,0,9
97647,mantāditte,mantaditte,2,2,0,0,10
97648,obhāsituṃ,obhasitum,18,15,3,0,9
97649,obhāsetuṃ,obhasetum,3,3,0,0,9
97650,pakāsitvā,pakasitva,1,1,0,0,9
97651,obhāsitvā,obhasitva,1,1,0,0,9
97652,bhāsuroti,bhasuroti,2,1,1,0,9
97653,virājanavācako,virajanavacako,1,1,0,0,14
97654,rūpasiriyā,rupasiriya,6,6,0,0,10
97655,virājanasampannatāya,virajanasampannataya,1,1,0,0,20
97656,nāsāti,nasati,5,3,2,0,6
97657,hatthisoṇḍāpi,hatthisondapi,1,1,0,0,13
97658,olokeyya,olokeyya,25,24,1,0,8
97659,pabhāvatī,pabhavati,61,61,0,0,9
97660,nāsikāpi,nasikapi,1,1,0,0,8
97661,kaṇṇanāsañca,kannanasanca,23,23,0,0,12
97662,chedayī,chedayi,1,1,0,0,7
97663,nāsanti,nasanti,1,1,0,0,7
97664,abyattasaddaṃ,abyattasaddam,7,7,0,0,13
97665,hatthidabbe,hatthidabbe,1,1,0,0,11
97666,narādīsu,naradisu,1,1,0,0,8
97667,nasati,nasati,1,1,0,0,6
97668,bhisi,bhisi,75,59,16,0,5
97669,bhiṃsati,bhimsati,1,1,0,0,8
97670,bhiṃsanako,bhimsanako,18,18,0,0,10
97671,bhiṃsanakaṃ,bhimsanakam,39,35,4,0,11
97672,bhesmākāyo,bhesmakayo,1,1,0,0,10
97673,āsisi,asisi,1,0,1,0,5
97674,sisi,sisi,2,1,1,0,4
97675,āsisati,asisati,1,1,0,0,7
97676,āsisateva,asisateva,1,1,0,0,9
97677,āsisanā,asisana,7,6,1,0,7
97678,āsisattaṃ,asisattam,1,1,0,0,9
97679,āsisanto,asisanto,1,1,0,0,8
97680,āsisamāno,asisamano,1,1,0,0,9
97681,āsamāno,asamano,1,1,0,0,7
97682,suggatimāsamānā,suggatimasamana,4,4,0,0,15
97683,gasu,gasu,1,0,1,0,4
97684,ghusī,ghusi,1,0,1,0,5
97685,bhaṃsu,bhamsu,1,0,1,0,6
97686,bhaṃsati,bhamsati,1,1,0,0,8
97687,nuddhaṃsati,nuddhamsati,4,4,0,0,11
97688,kosati,kosati,2,2,0,0,6
97689,pakkosati,pakkosati,33,31,2,0,9
97690,pakkosako,pakkosako,1,1,0,0,9
97691,pakkosito,pakkosito,2,2,0,0,9
97692,pakkosanaṃ,pakkosanam,3,3,0,0,10
97693,parikassati,parikassati,13,13,0,0,11
97694,paṭikassati,patikassati,57,57,0,0,11
97695,paṭikasseyyāti,patikasseyyati,9,8,1,0,14
97696,ākaḍḍheyya,akaddheyya,14,13,1,0,10
97697,mūlāpattiyaṃyeva,mulapattiyamyeva,1,1,0,0,16
97698,patiṭṭhāpeyyāti,patitthapeyyati,6,5,1,0,15
97699,dityādānesu,dityadanesu,1,0,1,0,11
97700,dāsu,dasu,1,0,1,0,4
97701,dāsati,dasati,1,1,0,0,6
97702,rosako,rosako,20,18,2,0,6
97703,bhesu,bhesu,1,0,1,0,5
97704,bhesati,bhesati,1,1,0,0,7
97705,bādhanaphassanesu,badhanaphassanesu,1,0,1,0,17
97706,nāgapāso,nagapaso,1,1,0,0,8
97707,hatthapāso,hatthapaso,49,38,11,0,10
97708,vilasati,vilasati,3,3,0,0,8
97709,vilasanaṃ,vilasanam,1,1,0,0,9
97710,suhitatā,suhitata,1,1,0,0,8
97711,tisati,tisati,1,1,0,0,6
97712,vasiyati,vasiyati,2,2,0,0,8
97713,parivāso,parivaso,170,165,5,0,8
97714,vippavāso,vippavaso,41,38,3,0,9
97715,cirappavāsī,cirappavasi,1,1,0,0,11
97716,cirappavuttho,cirappavuttho,4,4,0,0,13
97717,vasituṃ,vasitum,268,258,10,0,7
97718,upavāsoti,upavasoti,3,0,3,0,9
97719,vajjito,vajjito,18,16,2,0,7
97720,uposathoti,uposathoti,27,14,13,0,10
97721,anasanena,anasanena,10,9,1,0,9
97722,upetā,upeta,52,51,1,0,5
97723,āyāmāvuso,ayamavuso,25,25,0,0,9
97724,kappina,kappina,13,13,0,0,7
97725,pātimokkhuddeso,patimokkhuddeso,68,68,0,0,15
97726,upavuttho,upavuttho,62,61,1,0,9
97727,phaggu,phaggu,6,6,0,0,6
97728,suddhassuposatho,suddhassuposatho,9,7,2,0,16
97729,tadahuposathe,tadahuposathe,189,189,0,0,13
97730,sabhikkhukā,sabhikkhuka,146,145,1,0,11
97731,āvāsā,avasa,251,247,4,0,5
97732,upavasitabbadivasoti,upavasitabbadivasoti,2,1,1,0,20
97733,jinavacchayo,jinavacchayo,1,1,0,0,12
97734,susane,susane,1,0,1,0,6
97735,satova,satova,95,85,10,0,6
97736,assasanto,assasanto,79,77,2,0,9
97737,passasanto,passasanto,71,71,0,0,10
97738,duvidhanti,duvidhanti,10,10,0,0,10
97739,asasmīti,asasmiti,18,15,3,0,8
97740,niccassetaṃ,niccassetam,6,6,0,0,11
97741,pasiddhāni,pasiddhani,5,5,0,0,10
97742,āhi,ahi,4,4,0,0,3
97743,siyaṃsu,siyamsu,4,4,0,0,7
97744,samaggānaṃ,samagganam,51,49,2,0,10
97745,sammodamānānaṃ,sammodamananam,17,17,0,0,14
97746,nānāvādā,nanavada,9,9,0,0,8
97747,siyaṃsūti,siyamsuti,2,0,2,0,9
97748,abhidhammeti,abhidhammeti,19,5,14,0,12
97749,pathavīdhātu,pathavidhatu,322,301,21,0,12
97750,aññatarassa,annatarassa,417,406,11,0,11
97751,āpattivītikkamo,apattivitikkamo,1,1,0,0,15
97752,ekamārakhyātapadaṃ,ekamarakhyatapadam,1,1,0,0,18
97753,ekamabyayapadaṃ,ekamabyayapadam,1,1,0,0,15
97754,ākhyātatte,akhyatatte,10,10,0,0,10
97755,abyayatte,abyayatte,2,2,0,0,9
97756,abyayapadamiva,abyayapadamiva,1,1,0,0,14
97757,ekavacanantampi,ekavacanantampi,1,1,0,0,15
97758,tassākhyātatte,tassakhyatatte,1,1,0,0,14
97759,payogoviditova,payogoviditova,1,1,0,0,14
97760,pītisahagataṃ,pitisahagatam,119,119,0,0,13
97761,ekavacanabahuvacanappayogā,ekavacanabahuvacanappayoga,1,1,0,0,26
97762,āsiṃsu,asimsu,18,17,1,0,6
97763,āsimhā,asimha,4,4,0,0,6
97764,anusāsati,anusasati,87,80,7,0,9
97765,kammantaṃ,kammantam,85,76,9,0,9
97766,anusāsanī,anusasani,103,88,15,0,9
97767,anusāsikā,anusasika,8,8,0,0,9
97768,adhisīlādisikkhattayasaṅgahitasāsanaṃ,adhisiladisikkhattayasangahitasasanam,1,1,0,0,37
97769,pariyattipaṭipattipaṭivedhasaṅkhātaṃ,pariyattipatipattipativedhasankhatam,2,2,0,0,36
97770,pesetī,peseti,10,6,4,0,6
97771,pāpetabbavacanaṃ,papetabbavacanam,1,1,0,0,16
97772,sāsananti,sasananti,36,36,0,0,9
97773,anusiṭṭhī,anusitthi,1,1,0,0,9
97774,tividhayānamukhena,tividhayanamukhena,8,8,0,0,18
97775,diṭṭhadhammikasamparāyikaparamatthehi,ditthadhammikasamparayikaparamatthehi,35,34,1,0,37
97776,kiṃtaṃ,kimtam,2,2,0,0,6
97777,issarabhāvo,issarabhavo,11,11,0,0,11
97778,janapadeso,janapadeso,1,1,0,0,10
97779,manujeso,manujeso,1,1,0,0,8
97780,vaṅgīsoti,vangisoti,6,0,6,0,9
97781,vaṅge,vange,5,5,0,0,5
97782,lokasammataṃ,lokasammatam,15,13,2,0,12
97783,āsati,asati,20,20,0,0,5
97784,upāsati,upasati,7,7,0,0,7
97785,nisīdanayoggaṃ,nisidanayoggam,3,3,0,0,14
97786,mañcapīṭhādi,mancapithadi,10,10,0,0,12
97787,tenito,tenito,1,1,0,0,6
97788,nisī,nisi,1,0,1,0,4
97789,dessati,dessati,3,3,0,0,7
97790,dessī,dessi,2,2,0,0,5
97791,desso,desso,8,7,1,0,5
97792,dessiyo,dessiyo,7,7,0,0,7
97793,disoti,disoti,2,0,2,0,6
97794,diṭṭhoti,ditthoti,42,27,15,0,8
97795,paccāmittassādhivacanametaṃ,paccamittassadhivacanametam,1,1,0,0,27
97796,nappiyāyati,nappiyayati,2,2,0,0,11
97797,dessiyati,dessiyati,1,1,0,0,9
97798,vāpaccāmitto,vapaccamitto,1,1,0,0,12
97799,paccāmittoyeva,paccamittoyeva,1,1,0,0,14
97800,verinaṃ,verinam,14,11,3,0,7
97801,micchāpaṇihitaṃ,micchapanihitam,19,14,5,0,15
97802,dhammakathaṃ,dhammakatham,480,474,6,0,12
97803,suṇantū,sunantu,8,8,0,0,7
97804,yassete,yassete,55,51,4,0,7
97805,vānarinda,vanarinda,17,17,0,0,9
97806,ativattatī,ativattati,8,8,0,0,10
97807,dessīti,dessiti,1,0,1,0,7
97808,dessanasīlo,dessanasilo,1,1,0,0,11
97809,appiyāyanasīloti,appiyayanasiloti,1,1,0,0,16
97810,dessoti,dessoti,1,0,1,0,7
97811,appiyo,appiyo,144,138,6,0,6
97812,dessiyoti,dessiyoti,2,1,1,0,9
97813,maddīdevī,maddidevi,2,2,0,0,9
97814,dessaṃ,dessam,16,12,4,0,6
97815,mahāyasaṃ,mahayasam,56,53,3,0,9
97816,vatamadhiṭṭhahiṃ,vatamadhitthahim,8,8,0,0,16
97817,paccamitto,paccamitto,2,2,0,0,10
97818,paṇṇattikārisū,pannattikarisu,1,1,0,0,14
97819,bhassanadittīsu,bhassanadittisu,1,0,1,0,15
97820,dhisa,dhisa,1,0,1,0,5
97821,dhisati,dhisati,1,1,0,0,7
97822,upadisati,upadisati,37,37,0,0,9
97823,sandisati,sandisati,1,1,0,0,9
97824,paccādisati,paccadisati,1,1,0,0,11
97825,paṭisandisati,patisandisati,1,1,0,0,13
97826,samphusanā,samphusana,31,30,1,0,10
97827,samphusitattaṃ,samphusitattam,30,26,4,0,14
97828,phoṭṭhabbaṃ,photthabbam,217,205,12,0,11
97829,ekamekaṃ,ekamekam,191,182,9,0,8
97830,phusāyati,phusayati,11,11,0,0,9
97831,phuṭṭhuṃ,phutthum,14,10,4,0,8
97832,phusituṃ,phusitum,45,44,1,0,8
97833,phusitvāna,phusitvana,2,2,0,0,10
97834,phusiya,phusiya,2,2,0,0,7
97835,phusiyāna,phusiyana,1,1,0,0,9
97836,byantiṃ,byantim,102,94,8,0,7
97837,phassoti,phassoti,85,48,37,0,8
97838,phusanamattameva,phusanamattameva,2,2,0,0,16
97839,phusanalakkhaṇo,phusanalakkhano,36,34,2,0,15
97840,risati,risati,1,1,0,0,6
97841,risatīti,risatiti,1,1,0,0,8
97842,resati,resati,1,1,0,0,6
97843,pavesanaṃ,pavesanam,100,88,12,0,9
97844,pavisaṃ,pavisam,8,7,1,0,7
97845,āmasati,amasati,279,277,2,0,7
97846,parāmāsoti,paramasoti,12,2,10,0,10
97847,aniccādidhamme,aniccadidhamme,2,2,0,0,14
97848,niccādivasena,niccadivasena,34,34,0,0,13
97849,kummaggo,kummaggo,54,43,11,0,8
97850,micchāpatho,micchapatho,31,29,2,0,11
97851,vevacanapadāni,vevacanapadani,1,1,0,0,14
97852,abhidhammato,abhidhammato,3,3,0,0,12
97853,sampaṭicchati,sampaticchati,99,93,6,0,13
97854,sampaṭicchanaṃ,sampaticchanam,68,59,9,0,14
97855,abhicchā,abhiccha,1,1,0,0,8
97856,icchaṃ,iccham,65,57,8,0,6
97857,vesu,vesu,3,2,1,0,4
97858,vecchati,vecchati,1,1,0,0,8
97859,pavecchati,pavecchati,16,16,0,0,10
97860,paveccheti,paveccheti,3,1,2,0,10
97861,pavecchaṃ,paveccham,1,1,0,0,9
97862,pavecchanto,pavecchanto,2,2,0,0,11
97863,baddhāyaṃ,baddhayam,3,1,2,0,9
97864,baddhāti,baddhati,13,6,7,0,8
97865,vinibaddho,vinibaddho,13,11,2,0,10
97866,ahaṅkārassetaṃ,ahankarassetam,1,1,0,0,14
97867,jusi,jusi,2,0,2,0,4
97868,pītisevanesu,pitisevanesu,2,0,2,0,12
97869,josati,josati,1,1,0,0,6
97870,pariyesane,pariyesane,8,7,1,0,10
97871,esamāno,esamano,3,3,0,0,7
97872,saṃkase,samkase,1,0,1,0,7
97873,acchane,acchane,2,1,1,0,7
97874,acchanaṃ,acchanam,2,1,1,0,8
97875,saṅkasāyati,sankasayati,5,5,0,0,11
97876,hakārantadhātu,hakarantadhatu,4,4,0,0,14
97877,vijahati,vijahati,134,134,0,0,8
97878,vijahanaṃ,vijahanam,11,11,0,0,9
97879,jahātave,jahatave,1,1,0,0,8
97880,jahitvā,jahitva,240,234,6,0,7
97881,mhī,mhi,2,0,2,0,3
97882,mhayate,mhayate,1,1,0,0,7
97883,umhayate,umhayate,12,9,3,0,8
97884,vimhayate,vimhayate,1,1,0,0,9
97885,mhayateti,mhayateti,1,0,1,0,9
97886,umhayateti,umhayateti,1,0,1,0,10
97887,pahaṭṭhākāraṃ,pahatthakaram,13,12,1,0,13
97888,vimhayateti,vimhayateti,1,0,1,0,11
97889,vimhayanaṃ,vimhayanam,1,1,0,0,10
97890,pekkhitena,pekkhitena,5,5,0,0,10
97891,mhitena,mhitena,4,4,0,0,7
97892,mhitapubbaṃva,mhitapubbamva,1,1,0,0,13
97893,umhayamānā,umhayamana,3,3,0,0,10
97894,umhāpeyya,umhapeyya,1,1,0,0,9
97895,pamhāpeyya,pamhapeyya,1,1,0,0,10
97896,umhayamānāti,umhayamanati,2,0,2,0,12
97897,hasamānā,hasamana,15,15,0,0,8
97898,umhāpeyyāti,umhapeyyati,1,0,1,0,11
97899,sitavasena,sitavasena,1,1,0,0,10
97900,pahaṃseyya,pahamseyya,1,1,0,0,10
97901,pamhāpeyyāti,pamhapeyyati,1,0,1,0,12
97902,mahāhasitavasena,mahahasitavasena,2,2,0,0,16
97903,parihāseyya,parihaseyya,3,3,0,0,11
97904,pasajjakaraṇe,pasajjakarane,1,0,1,0,13
97905,pasajjakaraṇaṃ,pasajjakaranam,1,0,1,0,14
97906,sajjanakriyā,sajjanakriya,1,1,0,0,12
97907,āhuti,ahuti,7,4,3,0,5
97908,homa,homa,85,84,1,0,4
97909,pahonti,pahonti,30,29,1,0,7
97910,kalahā,kalaha,31,19,12,0,6
97911,vivādā,vivada,31,23,8,0,6
97912,pacchāsamaṇena,pacchasamanena,59,58,1,0,14
97913,hotabbaṃ,hotabbam,23,23,0,0,8
97914,hotuye,hotuye,3,3,0,0,6
97915,pahotuṃ,pahotum,1,1,0,0,7
97916,vattamānāvibhattirūpādīni,vattamanavibhattirupadini,1,1,0,0,25
97917,pasiddharūpāneva,pasiddharupaneva,2,2,0,0,16
97918,pañcamīvibhattirūpāni,pancamivibhattirupani,1,1,0,0,21
97919,huveyya,huveyya,7,6,1,0,7
97920,huveyyuṃ,huveyyum,3,3,0,0,8
97921,huveyyāsi,huveyyasi,1,1,0,0,9
97922,huveyyātha,huveyyatha,1,1,0,0,10
97923,huveyyāmi,huveyyami,1,1,0,0,9
97924,huveyyāma,huveyyama,1,1,0,0,9
97925,huvetha,huvetha,1,1,0,0,7
97926,huveraṃ,huveram,1,1,0,0,7
97927,huvetho,huvetho,1,1,0,0,7
97928,huveyyāvho,huveyyavho,1,1,0,0,10
97929,huveyyaṃ,huveyyam,1,1,0,0,8
97930,huveyyāmhe,huveyyamhe,1,1,0,0,10
97931,upako,upako,45,43,2,0,5
97932,ājīvako,ajivako,63,59,4,0,7
97933,okampetvā,okampetva,9,9,0,0,9
97934,pakkamī,pakkami,3,3,0,0,7
97935,huveyyāti,huveyyati,1,0,1,0,9
97936,hupeyyā,hupeyya,2,0,2,0,7
97937,paccapekkhaṇā,paccapekkhana,1,1,0,0,13
97938,hupeyya,hupeyya,2,1,1,0,7
97939,hupeyyuṃ,hupeyyum,1,1,0,0,8
97940,hupeyyāsī,hupeyyasi,1,1,0,0,9
97941,kārādesabhūtāni,karadesabhutani,1,1,0,0,15
97942,heyya,heyya,7,7,0,0,5
97943,heyyuṃ,heyyum,4,4,0,0,6
97944,heyyāsi,heyyasi,2,2,0,0,7
97945,heyyātha,heyyatha,2,2,0,0,8
97946,heyyāmi,heyyami,2,2,0,0,7
97947,heyyāma,heyyama,2,2,0,0,7
97948,hetha,hetha,3,3,0,0,5
97949,heraṃ,heram,1,1,0,0,5
97950,hetho,hetho,1,1,0,0,5
97951,heyyāvho,heyyavho,1,1,0,0,8
97952,heyyāmhe,heyyamhe,1,1,0,0,8
97953,aṭṭhakathānayena,atthakathanayena,12,12,0,0,16
97954,gahitarūpāni,gahitarupani,1,1,0,0,12
97955,uppādassāpi,uppadassapi,2,2,0,0,11
97956,pāpuṇeyyā,papuneyya,10,9,1,0,9
97957,huva,huva,1,1,0,0,4
97958,huvu,huvu,2,2,0,0,4
97959,huve,huve,1,1,0,0,4
97960,huvittha,huvittha,2,2,0,0,8
97961,huvaṃ,huvam,1,1,0,0,5
97962,huvimha,huvimha,1,1,0,0,7
97963,saññogatakāralopena,sannogatakaralopena,1,1,0,0,19
97964,tathāhi,tathahi,131,129,2,0,7
97965,kasirā,kasira,11,9,2,0,6
97966,hothā,hotha,111,110,1,0,5
97967,vaṇṇentehi,vannentehi,4,4,0,0,10
97968,huvire,huvire,1,1,0,0,6
97969,huvittho,huvittho,1,1,0,0,8
97970,huvivdo,huvivdo,1,1,0,0,7
97971,huviṃ,huvim,1,1,0,0,5
97972,huvimhe,huvimhe,1,1,0,0,7
97973,ahuvā,ahuva,34,32,2,0,5
97974,ahuvū,ahuvu,3,3,0,0,5
97975,ahuvattha,ahuvattha,49,49,0,0,9
97976,ahuvaṃ,ahuvam,6,6,0,0,6
97977,ahuvamha,ahuvamha,2,2,0,0,8
97978,ahuvatthuṃ,ahuvatthum,4,4,0,0,10
97979,ahuvase,ahuvase,3,3,0,0,7
97980,ahuvavhaṃ,ahuvavham,2,2,0,0,9
97981,ahuviṃ,ahuvim,3,3,0,0,6
97982,ahuvamhase,ahuvamhase,8,8,0,0,10
97983,ahuvamhaseti,ahuvamhaseti,2,0,2,0,12
97984,bhavamhaseti,bhavamhaseti,1,1,0,0,12
97985,ahuva,ahuva,4,4,0,0,5
97986,amhase,amhase,3,3,0,0,6
97987,pacchimanaye,pacchimanaye,19,19,0,0,12
97988,akaramhāti,akaramhati,6,6,0,0,10
97989,ahuvittha,ahuvittha,2,2,0,0,9
97990,ahositthaiccapi,ahositthaiccapi,1,1,0,0,15
97991,ahosiṃ,ahosim,1059,1017,42,0,6
97992,ahuvāsiṃ,ahuvasim,5,3,2,0,8
97993,ahosimhā,ahosimha,2,2,0,0,8
97994,ahuvu,ahuvu,3,3,0,0,5
97995,ahuvivhaṃ,ahuvivham,1,1,0,0,9
97996,ahuvimhe,ahuvimhe,2,2,0,0,8
97997,kevaṭṭagāmasmiṃ,kevattagamasmim,6,6,0,0,15
97998,kevaṭṭadārako,kevattadarako,6,6,0,0,13
97999,sumedhanāmassa,sumedhanamassa,4,3,1,0,14
98000,anekavaṇṇavimānavatthuaṭṭhakathāyaṃ,anekavannavimanavatthuatthakathayam,1,0,1,0,35
98001,hohitī,hohiti,1,1,0,0,6
98002,mātikāpadāni,matikapadani,13,13,0,0,12
98003,vibhajissāmi,vibhajissami,12,12,0,0,12
98004,hessāti,hessati,1,1,0,0,7
98005,hessasi,hessasi,14,14,0,0,7
98006,hessatha,hessatha,3,3,0,0,8
98007,hessāmi,hessami,22,22,0,0,7
98008,hessāma,hessama,66,66,0,0,7
98009,hessate,hessate,6,6,0,0,7
98010,hessase,hessase,3,3,0,0,7
98011,hessavhe,hessavhe,1,1,0,0,8
98012,hessaṃ,hessam,48,43,5,0,6
98013,hessāmhe,hessamhe,1,1,0,0,8
98014,anāgatamhi,anagatamhi,44,43,1,0,10
98015,hehissasi,hehissasi,2,2,0,0,9
98016,hohissasi,hohissasi,2,2,0,0,9
98017,hehisi,hehisi,11,10,1,0,6
98018,hohisi,hohisi,43,41,2,0,6
98019,ahuvissā,ahuvissa,1,1,0,0,8
98020,ahuvissaṃsu,ahuvissamsu,1,1,0,0,11
98021,ahuvissase,ahuvissase,2,2,0,0,10
98022,ahuvissatha,ahuvissatha,2,2,0,0,11
98023,ahuvissaṃ,ahuvissam,1,1,0,0,9
98024,ahuvissamhā,ahuvissamha,1,1,0,0,11
98025,ahuvissisu,ahuvissisu,1,1,0,0,10
98026,ahuvissavhe,ahuvissavhe,1,1,0,0,11
98027,ahuvissiṃ,ahuvissim,1,1,0,0,9
98028,ahuvissāmhase,ahuvissamhase,1,1,0,0,13
98029,avhāyanaṃ,avhayanam,6,4,2,0,9
98030,ghaṭṭanaṃ,ghattanam,54,45,9,0,9
98031,sārambhakaraṇaṃ,sarambhakaranam,1,1,0,0,15
98032,vheti,vheti,1,1,0,0,5
98033,vhāyati,vhayati,1,1,0,0,7
98034,avheti,avheti,8,7,1,0,6
98035,avhāyati,avhayati,4,4,0,0,8
98036,avhāsi,avhasi,1,1,0,0,6
98037,māṇavakosmi,manavakosmi,3,3,0,0,11
98038,anūnanāmo,anunanamo,5,5,0,0,9
98039,mavhayanti,mavhayanti,3,3,0,0,10
98040,upasaggova,upasaggova,1,1,0,0,10
98041,saññogaparattā,sannogaparatta,1,1,0,0,14
98042,anavhito,anavhito,6,6,0,0,8
98043,āgā,aga,22,22,0,0,3
98044,avhāyanā,avhayana,1,1,0,0,8
98045,vāraṇavhayanā,varanavhayana,1,1,0,0,13
98046,kāmavhe,kamavhe,2,2,0,0,7
98047,candasavhayo,candasavhayo,3,3,0,0,12
98048,sattatantiṃ,sattatantim,12,9,3,0,11
98049,sumadhuraṃ,sumadhuram,26,23,3,0,10
98050,rāmaṇeyyaṃ,ramaneyyam,8,7,1,0,10
98051,avācayiṃ,avacayim,8,7,1,0,8
98052,raṅgamhi,rangamhi,6,5,1,0,8
98053,kosiyā,kosiya,37,35,2,0,6
98054,avhetīti,avhetiti,1,0,1,0,8
98055,sārambhavasena,sarambhavasena,9,9,0,0,14
98056,saṅghaṭṭatīti,sanghattatiti,1,1,0,0,13
98057,samāgate,samagate,31,30,1,0,8
98058,ekasataṃ,ekasatam,50,44,6,0,8
98059,avhettha,avhettha,4,4,0,0,8
98060,avikampamāno,avikampamano,29,24,5,0,12
98061,avhāyanti,avhayanti,31,30,1,0,9
98062,varāvaraṃ,varavaram,8,6,2,0,9
98063,varato,varato,4,4,0,0,6
98064,naccañca,naccanca,12,12,0,0,8
98065,pañhati,panhati,2,2,0,0,7
98066,paripucchati,paripucchati,48,43,5,0,12
98067,paripañhati,paripanhati,23,20,3,0,11
98068,suṇā,suna,2,2,0,0,4
98069,pulliṅgappayogadassanato,pullingappayogadassanato,1,1,0,0,24
98070,itthiliṅgopi,itthilingopi,1,1,0,0,12
98071,napuṃsakaliṅgopi,napumsakalingopi,3,3,0,0,16
98072,mesā,mesa,78,74,4,0,4
98073,cintitā,cintita,80,80,0,0,7
98074,koṇḍañña,kondanna,26,24,2,0,8
98075,pañhāni,panhani,9,9,0,0,7
98076,viyākarohī,viyakarohi,2,2,0,0,10
98077,taddīpikā,taddipika,1,1,0,0,9
98078,pañhoti,panhoti,45,21,24,0,7
98079,pañhiyati,panhiyati,1,1,0,0,9
98080,vissajjitamhi,vissajjitamhi,10,10,0,0,13
98081,nettipāḷiyā,nettipaliya,3,2,1,0,11
98082,saṃvaṇṇentena,samvannentena,2,2,0,0,13
98083,pañheti,panheti,17,2,15,0,7
98084,ummihati,ummihati,1,1,0,0,8
98085,ummihatīti,ummihatiti,1,0,1,0,10
98086,vassadhārāhīti,vassadharahiti,1,1,0,0,14
98087,guyhaṭṭhānaṃ,guyhatthanam,2,2,0,0,12
98088,āgārāni,agarani,1,1,0,0,7
98089,ayyikāti,ayyikati,3,2,1,0,8
98090,dahantī,dahanti,11,7,4,0,7
98091,dayhati,dayhati,11,11,0,0,7
98092,dayhamānaṃ,dayhamanam,2,2,0,0,10
98093,ḍā,da,1,0,1,0,2
98094,ḍahatī,dahati,2,2,0,0,6
98095,ḍahantaṃ,dahantam,10,8,2,0,8
98096,bālamanveti,balamanveti,8,6,2,0,11
98097,bhasmāchannova,bhasmachannova,4,4,0,0,14
98098,caha,caha,2,0,2,0,4
98099,parisakkane,parisakkane,1,0,1,0,11
98100,cahati,cahati,1,1,0,0,6
98101,rahaṃ,raham,10,6,4,0,5
98102,dahi,dahi,7,6,1,0,4
98103,saddhe,saddhe,38,34,4,0,6
98104,vuddhāpekkho,vuddhapekkho,1,1,0,0,12
98105,tuhi,tuhi,1,0,1,0,4
98106,duhi,duhi,4,2,2,0,4
98107,tuhati,tuhati,1,1,0,0,6
98108,mahanaṃ,mahanam,1,1,0,0,7
98109,maho,maho,9,8,1,0,4
98110,vihāramaho,viharamaho,9,9,0,0,10
98111,cetiyamaho,cetiyamaho,2,2,0,0,10
98112,nikkilesattā,nikkilesatta,3,3,0,0,12
98113,ekantadakkhiṇeyyabhāvena,ekantadakkhineyyabhavena,1,1,0,0,24
98114,katapūjāsakkārādīnaṃ,katapujasakkaradinam,1,1,0,0,20
98115,arahaṇīyo,arahaniyo,1,1,0,0,9
98116,pūjanīyoti,pujaniyoti,2,1,1,0,10
98117,pilahi,pilahi,1,0,1,0,6
98118,ahati,ahati,4,4,0,0,5
98119,pilahati,pilahati,1,1,0,0,8
98120,ahīti,ahiti,6,2,4,0,5
98121,nippādopi,nippadopi,1,1,0,0,9
98122,kalaha,kalaha,8,7,1,0,6
98123,garahati,garahati,154,153,1,0,8
98124,kalahati,kalahati,1,1,0,0,8
98125,valaha,valaha,1,0,1,0,6
98126,padhāniye,padhaniye,1,0,1,0,9
98127,varahati,varahati,1,1,0,0,8
98128,valahati,valahati,1,1,0,0,8
98129,varāhoti,varahoti,2,0,2,0,8
98130,sūkaropi,sukaropi,3,3,0,0,8
98131,hatthīpi,hatthipi,21,21,0,0,8
98132,eneyyā,eneyya,1,1,0,0,6
98133,mahāvarāhova,mahavarahova,13,12,1,0,12
98134,nivāpapuṭṭho,nivapaputtho,16,15,1,0,12
98135,mahāvarāhassa,mahavarahassa,3,3,0,0,13
98136,nadīsu,nadisu,19,16,3,0,6
98137,jaggato,jaggato,6,6,0,0,7
98138,ghasamānassā,ghasamanassa,1,1,0,0,12
98139,mahāvarāhassāti,mahavarahassati,3,0,3,0,15
98140,mahāhatthinoti,mahahatthinoti,1,1,0,0,14
98141,vehu,vehu,1,0,1,0,4
98142,jehu,jehu,1,0,1,0,4
98143,vehati,vehati,1,1,0,0,6
98144,jehati,jehati,1,1,0,0,6
98145,vāhati,vahati,1,1,0,0,6
98146,vāhano,vahano,6,5,1,0,6
98147,vāhanti,vahanti,2,2,0,0,7
98148,saṅgāmādīsu,sangamadisu,1,1,0,0,11
98149,payatanti,payatanti,1,1,0,0,9
98150,vāhanoti,vahanoti,1,0,1,0,8
98151,dāhu,dahu,4,3,1,0,4
98152,dāhati,dahati,1,1,0,0,6
98153,āyūhati,ayuhati,28,27,1,0,7
98154,viyūhati,viyuhati,5,5,0,0,8
98155,byūhati,byuhati,3,2,1,0,7
98156,apohati,apohati,2,2,0,0,7
98157,apoho,apoho,2,2,0,0,5
98158,ūhatīti,uhatiti,2,1,1,0,7
98159,āyūhatīti,ayuhatiti,2,0,2,0,9
98160,viyūhatīti,viyuhatiti,1,0,1,0,10
98161,byūhatīti,byuhatiti,1,0,1,0,9
98162,apohatīti,apohatiti,1,0,1,0,9
98163,viveceti,viveceti,3,3,0,0,8
98164,gāhu,gahu,3,0,3,0,4
98165,gāhati,gahati,2,2,0,0,6
98166,candaggāho,candaggaho,12,12,0,0,10
98167,sūriyaggāho,suriyaggaho,10,10,0,0,11
98168,nakkhattaggāho,nakkhattaggaho,6,6,0,0,14
98169,gahati,gahati,2,2,0,0,6
98170,paggahati,paggahati,1,1,0,0,9
98171,āhutiṃpaggahissāmi,ahutimpaggahissami,1,1,0,0,18
98172,paggāho,paggaho,84,77,7,0,7
98173,paggahoti,paggahoti,8,1,7,0,9
98174,paggāhoti,paggahoti,3,1,2,0,9
98175,māhati,mahati,1,1,0,0,6
98176,guhati,guhati,3,3,0,0,6
98177,nigguhati,nigguhati,2,2,0,0,9
98178,duyhamānā,duyhamana,4,4,0,0,9
98179,dehati,dehati,1,1,0,0,6
98180,dehoti,dehoti,5,3,2,0,6
98181,lehati,lehati,5,4,1,0,6
98182,palehati,palehati,1,1,0,0,8
98183,lehanīyaṃ,lehaniyam,2,2,0,0,9
98184,himassa,himassa,6,5,1,0,7
98185,palihiṃsu,palihimsu,4,3,1,0,9
98186,palihiṃsūti,palihimsuti,1,1,0,0,11
98187,ohati,ohati,1,1,0,0,5
98188,sabbamanatthaṃ,sabbamanattham,2,2,0,0,14
98189,brahati,brahati,1,1,0,0,7
98190,thaha,thaha,2,0,2,0,5
98191,thahati,thahati,1,1,0,0,7
98192,vivekamanubrūhetuṃ,vivekamanubruhetum,3,3,0,0,18
98193,brūhitoti,bruhitoti,2,1,1,0,9
98194,mahābrahmāpi,mahabrahmapi,6,6,0,0,12
98195,tathāgatopi,tathagatopi,26,25,1,0,11
98196,brāhmaṇopi,brahmanopi,57,57,0,0,10
98197,mātāpitaropi,matapitaropi,30,30,0,0,12
98198,seṭṭhampi,setthampi,3,3,0,0,9
98199,dvisahasso,dvisahasso,5,5,0,0,10
98200,tathāgatassetaṃ,tathagatassetam,46,44,2,0,15
98201,sabbabhavātivatto,sabbabhavativatto,8,7,1,0,17
98202,saccavhayo,saccavhayo,11,9,2,0,10
98203,pubbācariyāti,pubbacariyati,23,20,3,0,13
98204,pavattetī,pavatteti,23,17,6,0,9
98205,mahābrahmani,mahabrahmani,3,3,0,0,12
98206,sammutibrahmāno,sammutibrahmano,4,4,0,0,15
98207,upapattibrahmāno,upapattibrahmano,5,5,0,0,16
98208,visuddhibrahmānoti,visuddhibrahmanoti,2,2,0,0,18
98209,sālikedāraṃ,salikedaram,14,12,2,0,11
98210,kosiya,kosiya,63,62,1,0,6
98211,paṭivedemi,pativedemi,11,11,0,0,10
98212,vāretumussahe,varetumussahe,10,10,0,0,13
98213,paribbaja,paribbaja,10,9,1,0,9
98214,mahābrahme,mahabrahme,40,40,0,0,10
98215,pacantaññepi,pacantannepi,8,6,2,0,12
98216,sotavanto,sotavanto,11,11,0,0,9
98217,pamuñcantu,pamuncantu,20,15,5,0,10
98218,sahampatī,sahampati,10,10,0,0,9
98219,upapattibrahmā,upapattibrahma,1,1,0,0,14
98220,ariyadhammo,ariyadhammo,21,21,0,0,11
98221,avisesena,avisesena,402,381,21,0,9
98222,visuddhibrahmāno,visuddhibrahmano,2,2,0,0,16
98223,paramatthabrahmatāya,paramatthabrahmataya,2,2,0,0,20
98224,uttamabrahmā,uttamabrahma,2,2,0,0,12
98225,brahmabhūtehi,brahmabhutehi,6,6,0,0,13
98226,ukkaṃsapāramippattito,ukkamsaparamippattito,2,2,0,0,21
98227,sammutiyupapattīnaṃ,sammutiyupapattinam,1,1,0,0,19
98228,visuddhīnaṃ,visuddhinam,7,7,0,0,11
98229,dhimha,dhimha,1,0,1,0,6
98230,dhimheti,dhimheti,1,1,0,0,8
98231,paṭivāmagataṃ,pativamagatam,4,3,1,0,13
98232,dhimhāmi,dhimhami,3,3,0,0,8
98233,dhimhāmīti,dhimhamiti,2,0,2,0,10
98234,niṭṭhubhāmīti,nitthubhamiti,1,1,0,0,13
98235,ḷakārantadhātu,lakarantadhatu,5,5,0,0,14
98236,biḷa,bila,1,0,1,0,4
98237,beḷati,belati,1,1,0,0,6
98238,kīḷati,kilati,57,57,0,0,6
98239,aḷa,ala,1,0,1,0,3
98240,aḷati,alati,1,1,0,0,5
98241,laḷa,lala,7,5,2,0,4
98242,laḷati,lalati,9,9,0,0,6
98243,laḷito,lalito,1,1,0,0,6
98244,kaḷa,kala,2,0,2,0,4
98245,kakkasse,kakkasse,1,0,1,0,8
98246,kakkassaṃ,kakkassam,1,0,1,0,9
98247,kassasiyaṃ,kassasiyam,1,1,0,0,10
98248,kaḷati,kalati,2,2,0,0,6
98249,tuḷa,tula,1,0,1,0,4
98250,toḷati,tolati,1,1,0,0,6
98251,huḷa,hula,1,0,1,0,4
98252,hoḷa,hola,2,0,2,0,4
98253,huḷati,hulati,1,1,0,0,6
98254,hoḷati,holati,2,2,0,0,6
98255,roḷa,rola,1,0,1,0,4
98256,roḷati,rolati,1,1,0,0,6
98257,loḷa,lola,1,0,1,0,4
98258,loyati,loyati,1,1,0,0,6
98259,heḷa,hela,2,0,2,0,4
98260,heḷati,helati,2,2,0,0,6
98261,vāḷa,vala,3,2,1,0,4
98262,ālape,alape,2,1,1,0,5
98263,vāḷati,valati,1,1,0,0,6
98264,dāḷa,dala,1,0,1,0,4
98265,dhāḷa,dhala,1,0,1,0,5
98266,dāḷati,dalati,1,1,0,0,6
98267,dhāḷati,dhalati,1,1,0,0,7
98268,haḷa,hala,1,0,1,0,4
98269,haḷati,halati,1,1,0,0,6
98270,hīḷati,hilati,1,1,0,0,6
98271,hīḷā,hila,1,1,0,0,4
98272,hīḷiko,hiliko,1,1,0,0,6
98273,kaḷanaṃ,kalanam,1,1,0,0,7
98274,īḷa,ila,1,1,0,0,3
98275,īḷati,ilati,1,1,0,0,5
98276,juḷa,jula,3,0,3,0,4
98277,juḷati,julati,2,2,0,0,6
98278,joḷati,jolati,1,1,0,0,6
98279,puḷa,pula,2,0,2,0,4
98280,muḷa,mula,1,0,1,0,4
98281,sukhane,sukhane,2,1,1,0,7
98282,puḷati,pulati,2,2,0,0,6
98283,muḷati,mulati,1,1,0,0,6
98284,guḷati,gulati,2,2,0,0,6
98285,kuḷa,kula,1,0,1,0,4
98286,ghasane,ghasane,1,0,1,0,7
98287,kuḷati,kulati,1,1,0,0,6
98288,khuḷa,khula,1,0,1,0,5
98289,ghasanāpekkhako,ghasanapekkhako,1,1,0,0,15
98290,khuḷati,khulati,1,1,0,0,7
98291,suḷa,sula,1,0,1,0,4
98292,buḷa,bula,1,0,1,0,4
98293,suḷati,sulati,1,1,0,0,6
98294,buḷati,bulati,1,1,0,0,6
98295,saḷa,sala,1,0,1,0,4
98296,saḷati,salati,4,4,0,0,6
98297,sāḷiko,saliko,3,3,0,0,6
98298,usabhova,usabhova,5,5,0,0,8
98299,migarājāva,migarajava,14,14,0,0,10
98300,kūjati,kujati,6,6,0,0,6
98301,susumārova,susumarova,3,3,0,0,10
98302,gaṇikadhātūnaṃyeva,ganikadhatunamyeva,1,1,0,0,18
98303,asamānasutikā,asamanasutika,1,1,0,0,13
98304,asamānantikā,asamanantika,1,1,0,0,12
98305,samānatthavasena,samanatthavasena,1,1,0,0,16
98306,rūpavibhāvanādīhi,rupavibhavanadihi,1,1,0,0,17
98307,ajesi,ajesi,27,27,0,0,5
98308,naravīraseṭṭhaṃ,naravirasettham,5,5,0,0,15
98309,tatthappanādo,tatthappanado,5,4,1,0,13
98310,bahūva,bahuva,3,3,0,0,6
98311,pahūtamariyo,pahutamariyo,7,7,0,0,12
98312,pahūtavitto,pahutavitto,2,2,0,0,11
98313,piyappabhūtā,piyappabhuta,3,3,0,0,12
98314,hetuye,hetuye,10,10,0,0,6
98315,nahetuyeti,nahetuyeti,1,0,1,0,10
98316,abhavituṃ,abhavitum,2,2,0,0,9
98317,tuye,tuye,2,1,1,0,4
98318,hetubhāvāya,hetubhavaya,2,2,0,0,11
98319,sakkātipi,sakkatipi,2,2,0,0,9
98320,payogabhāvāya,payogabhavaya,1,1,0,0,13
98321,udāharitapadassatthabhāvato,udaharitapadassatthabhavato,1,1,0,0,27
98322,vipulabhāvena,vipulabhavena,11,11,0,0,13
98323,nappahoti,nappahoti,143,142,1,0,9
98324,pahūtavittoti,pahutavittoti,2,0,2,0,13
98325,vipulavitto,vipulavitto,1,1,0,0,11
98326,pahūtajivhoti,pahutajivhoti,4,0,4,0,13
98327,suputhulasudīghasumudukajivho,suputhulasudighasumudukajivho,1,1,0,0,29
98328,piyappabhūtāti,piyappabhutati,1,0,1,0,14
98329,piyato,piyato,19,17,2,0,6
98330,gamati,gamati,5,5,0,0,6
98331,ghammati,ghammati,4,4,0,0,8
98332,atigacchati,atigacchati,1,1,0,0,11
98333,paṭigacchati,patigacchati,2,2,0,0,12
98334,avagacchati,avagacchati,12,9,3,0,11
98335,apagacchati,apagacchati,10,10,0,0,11
98336,vigacchati,vigacchati,108,108,0,0,10
98337,samuggacchatī,samuggacchati,1,1,0,0,13
98338,upasaggadvayavasenapi,upasaggadvayavasenapi,1,1,0,0,21
98339,saṃsappati,samsappati,28,28,0,0,10
98340,parisappati,parisappati,4,4,0,0,11
98341,gamatīti,gamatiti,1,0,1,0,8
98342,gamayatī,gamayati,2,2,0,0,8
98343,gametīti,gametiti,55,47,8,0,8
98344,apāyagamanīyaṃ,apayagamaniyam,23,23,0,0,14
98345,āgameti,agameti,22,21,1,0,7
98346,āgamayati,agamayati,3,3,0,0,9
98347,āgamento,agamento,23,23,0,0,8
98348,āgamayamāno,agamayamano,55,54,1,0,11
98349,āgametīti,agametiti,3,0,3,0,9
98350,adhivāsetīti,adhivasetiti,14,5,9,0,12
98351,ghammatīti,ghammatiti,1,0,1,0,10
98352,uyyāti,uyyati,3,3,0,0,6
98353,atigacchatīti,atigacchatiti,1,0,1,0,13
98354,paṭigacchatīti,patigacchatiti,1,0,1,0,14
98355,avagacchatīti,avagacchatiti,3,1,2,0,13
98356,vigamati,vigamati,1,1,0,0,8
98357,nigacchatīti,nigacchatiti,7,3,4,0,12
98358,nigacchatī,nigacchati,7,6,1,0,10
98359,niggacchatīti,niggacchatiti,7,3,4,0,13
98360,saṃsappatīti,samsappatiti,6,1,5,0,12
98361,parisappatīti,parisappatiti,2,1,1,0,13
98362,gacchemu,gacchemu,5,5,0,0,8
98363,gaccheyyāvho,gaccheyyavho,2,2,0,0,12
98364,gacchu,gacchu,1,1,0,0,6
98365,gacchittha,gacchittha,8,8,0,0,10
98366,gañchittha,ganchittha,6,6,0,0,10
98367,gacchimha,gacchimha,2,2,0,0,9
98368,gañchimha,ganchimha,2,2,0,0,9
98369,gacchire,gacchire,1,1,0,0,8
98370,gacchittho,gacchittho,2,2,0,0,10
98371,gacchivho,gacchivho,1,1,0,0,9
98372,gacchiṃ,gacchim,11,10,1,0,7
98373,gañchiṃ,ganchim,3,3,0,0,7
98374,gacchimhe,gacchimhe,1,1,0,0,9
98375,agacchū,agacchu,2,2,0,0,7
98376,agacche,agacche,1,1,0,0,7
98377,agacchatha,agacchatha,2,2,0,0,10
98378,agacchaṃ,agaccham,7,6,1,0,8
98379,agacchamhā,agacchamha,2,2,0,0,10
98380,agacchatthuṃ,agacchatthum,2,2,0,0,12
98381,agacchase,agacchase,2,2,0,0,9
98382,agacchivhaṃ,agacchivham,1,1,0,0,11
98383,agacchimhe,agacchimhe,1,1,0,0,10
98384,gacchissasi,gacchissasi,8,8,0,0,11
98385,gacchissatha,gacchissatha,11,11,0,0,12
98386,gacchissāma,gacchissama,8,8,0,0,11
98387,gacchissate,gacchissate,3,3,0,0,11
98388,gacchissante,gacchissante,3,3,0,0,12
98389,gacchissase,gacchissase,3,3,0,0,11
98390,gacchissavhe,gacchissavhe,3,3,0,0,12
98391,gacchissāmhe,gacchissamhe,3,3,0,0,12
98392,agacchisse,agacchisse,3,3,0,0,10
98393,agacchissatha,agacchissatha,4,4,0,0,13
98394,agacchissaṃ,agacchissam,6,5,1,0,11
98395,agacchissāmhā,agacchissamha,2,2,0,0,13
98396,agacchissisu,agacchissisu,1,1,0,0,12
98397,agacchissase,agacchissase,1,1,0,0,12
98398,agacchissavhe,agacchissavhe,1,1,0,0,13
98399,agacchissāmhase,agacchissamhase,1,1,0,0,15
98400,gacchi,gacchi,27,27,0,0,6
98401,gacchissā,gacchissa,2,2,0,0,9
98402,gamanti,gamanti,1,1,0,0,7
98403,gamatu,gamatu,1,1,0,0,6
98404,gamantu,gamantu,1,1,0,0,7
98405,gameyyuṃ,gameyyum,2,2,0,0,8
98406,parokkhāhiyyattanajjatanīsu,parokkhahiyyattanajjatanisu,1,1,0,0,27
98407,māga,maga,3,3,0,0,4
98408,māgu,magu,1,1,0,0,4
98409,guttha,guttha,2,2,0,0,6
98410,māguttha,maguttha,1,1,0,0,8
98411,māgaṃ,magam,1,1,0,0,5
98412,anvagaṃ,anvagam,1,1,0,0,7
98413,gumha,gumha,2,2,0,0,5
98414,āgumha,agumha,1,1,0,0,6
98415,anvagumha,anvagumha,1,1,0,0,9
98416,agami,agami,15,15,0,0,5
98417,guṃ,gum,1,1,0,0,3
98418,sopāgā,sopaga,4,3,1,0,6
98419,samitiṃ,samitim,49,38,11,0,7
98420,āguṃ,agum,105,82,23,0,4
98421,kākova,kakova,18,17,1,0,6
98422,kāmānaṃ,kamanam,392,355,37,0,7
98423,vasamanvagaṃ,vasamanvagam,16,16,0,0,12
98424,agamu,agamu,5,4,1,0,5
98425,upagacchu,upagacchu,1,1,0,0,9
98426,agu,agu,1,1,0,0,3
98427,ādibhedaṃ,adibhedam,1,1,0,0,9
98428,sahagataṃ,sahagatam,56,53,3,0,9
98429,avagamo,avagamo,2,2,0,0,7
98430,gamiyamānaṃ,gamiyamanam,1,1,0,0,11
98431,indagū,indagu,3,2,1,0,6
98432,medhago,medhago,2,2,0,0,7
98433,gacchāpeti,gacchapeti,3,3,0,0,10
98434,gacchāpayati,gacchapayati,4,4,0,0,12
98435,gacchayati,gacchayati,1,1,0,0,10
98436,gammeti,gammeti,1,1,0,0,7
98437,gammati,gammati,11,11,0,0,7
98438,adhigammati,adhigammati,3,3,0,0,11
98439,adhigamiyati,adhigamiyati,2,2,0,0,12
98440,gamitvāna,gamitvana,8,8,0,0,9
98441,gamiya,gamiya,4,3,1,0,6
98442,gamiyāna,gamiyana,1,1,0,0,8
98443,adhigamma,adhigamma,31,31,0,0,9
98444,adhigantvā,adhigantva,88,85,3,0,10
98445,sappinī,sappini,2,2,0,0,7
98446,sahagata,sahagata,12,6,6,0,8
98447,vokiṇṇe,vokinne,11,11,0,0,7
98448,saṃsaṭṭheti,samsattheti,4,3,1,0,11
98449,ponobbhavikā,ponobbhavika,67,66,1,0,12
98450,nandirāgasahagatā,nandiragasahagata,25,21,4,0,17
98451,nandirāgabhūtāti,nandiragabhutati,5,4,1,0,16
98452,kosajjasahagatā,kosajjasahagata,6,6,0,0,15
98453,kosajjasampayuttā,kosajjasampayutta,7,7,0,0,17
98454,antarantarā,antarantara,359,351,8,0,11
98455,uppajjamānena,uppajjamanena,29,28,1,0,13
98456,kosajjena,kosajjena,14,13,1,0,9
98457,vokiṇṇāti,vokinnati,4,4,0,0,9
98458,aṭṭhikasaññāsahagataṃ,atthikasannasahagatam,17,17,0,0,21
98459,satisambojjhaṅgaṃ,satisambojjhangam,120,111,9,0,17
98460,bhāvetī,bhaveti,116,106,10,0,7
98461,aṭṭhikasaññaṃ,atthikasannam,12,12,0,0,13
98462,paṭiladdhanti,patiladdhanti,11,11,0,0,13
98463,rūpasahagatānaṃ,rupasahagatanam,17,15,2,0,15
98464,samāpattīnaṃ,samapattinam,83,81,2,0,12
98465,arūpasahagatānaṃ,arupasahagatanam,17,15,2,0,16
98466,rūpārūpārammaṇānanti,ruparuparammanananti,3,3,0,0,20
98467,sahajātaṃ,sahajatam,768,648,120,0,9
98468,saṃsaṭṭhanti,samsatthanti,6,6,0,0,12
98469,nissayārammaṇesu,nissayarammanesu,1,1,0,0,16
98470,gatigati,gatigati,10,6,4,0,8
98471,nibbattigabhi,nibbattigabhi,1,1,0,0,13
98472,ajjhāsayagati,ajjhasayagati,7,3,4,0,13
98473,vibhavagati,vibhavagati,10,4,6,0,11
98474,nipphattigati,nipphattigati,5,1,4,0,13
98475,ñāṇagatīti,nanagatiti,2,1,1,0,10
98476,gandhabbamānusā,gandhabbamanusa,10,10,0,0,15
98477,sīlavantānaṃ,silavantanam,70,70,0,0,12
98478,jānāmi,janami,992,959,33,0,6
98479,gatiṃvā,gatimva,1,1,0,0,7
98480,agatiṃvā,agatimva,1,1,0,0,8
98481,nibbattigati,nibbattigati,5,2,3,0,12
98482,gatiñca,gatinca,13,11,2,0,7
98483,jutiñca,jutinca,10,10,0,0,7
98484,jānāmī,janami,220,211,9,0,6
98485,gatī,gati,79,72,7,0,4
98486,dhibhimā,dhibhima,1,1,0,0,8
98487,ñāṇagati,nanagati,6,4,2,0,8
98488,gatigatyañca,gatigatyanca,1,1,0,0,12
98489,nibbatyaṃ,nibbatyam,1,1,0,0,9
98490,vibhavajjhāsayesu,vibhavajjhasayesu,1,1,0,0,17
98491,nipphattiyañca,nipphattiyanca,1,1,0,0,14
98492,samabhāvaṃ,samabhavam,8,8,0,0,10
98493,missībhāvañca,missibhavanca,1,1,0,0,13
98494,hiṃsantaṃ,himsantam,1,1,0,0,9
98495,hiṅgujatucceva,hingujatucceva,1,1,0,0,14
98496,hiṅgusipāṭikā,hingusipatika,4,1,3,0,13
98497,hiṅgujātīti,hingujatiti,1,1,0,0,11
98498,vinayaṭṭhakathāya,vinayatthakathaya,60,55,5,0,17
98499,jagūti,jaguti,1,0,1,0,6
98500,indriyena,indriyena,14,14,0,0,9
98501,indabhūtena,indabhutena,2,2,0,0,11
98502,indagu,indagu,11,8,3,0,6
98503,hindagū,hindagu,4,3,1,0,7
98504,sattādhivacanaṃ,sattadhivacanam,8,8,0,0,15
98505,medhagoti,medhagoti,1,0,1,0,9
98506,nissayañca,nissayanca,3,3,0,0,10
98507,medhamāno,medhamano,1,1,0,0,9
98508,hiṃsamāno,himsamano,2,2,0,0,9
98509,sammanti,sammanti,260,249,11,0,8
98510,medhagā,medhaga,21,20,1,0,7
98511,medhaga,medhaga,2,1,1,0,7
98512,gamitvāti,gamitvati,1,1,0,0,9
98513,isivhayaṃ,isivhayam,3,3,0,0,9
98514,vinitvā,vinitva,2,2,0,0,7
98515,pañcavaggiye,pancavaggiye,57,53,4,0,12
98516,vinesi,vinesi,34,34,0,0,6
98517,saṃsappanto,samsappanto,7,6,1,0,11
98518,bhujanto,bhujanto,2,2,0,0,8
98519,pannasiro,pannasiro,2,2,0,0,9
98520,bilāsayo,bilasayo,4,2,2,0,8
98521,āvudhoti,avudhoti,4,3,1,0,8
98522,dāṭhāvudho,dathavudho,10,8,2,0,10
98523,tassaghoranti,tassaghoranti,1,1,0,0,13
98524,ghoraviso,ghoraviso,86,79,7,0,9
98525,dujivho,dujivho,1,0,1,0,7
98526,jivhāhi,jivhahi,7,6,1,0,7
98527,dvirasaññū,dvirasannu,3,2,1,0,10
98528,sappinīti,sappiniti,2,1,1,0,9
98529,uragī,uragi,1,1,0,0,5
98530,pīṭhasappīti,pithasappiti,1,0,1,0,12
98531,sappīti,sappiti,14,10,4,0,7
98532,balāyuvaḍḍhanatthaṃ,balayuvaddhanattham,2,2,0,0,19
98533,ṭeka,teka,1,0,1,0,4
98534,gatyattā,gatyatta,1,0,1,0,8
98535,nisakko,nisakko,1,1,0,0,7
98536,olaṅghati,olanghati,1,1,0,0,9
98537,laṅghako,langhako,3,3,0,0,8
98538,ullaṅghikā,ullanghika,1,1,0,0,10
98539,rāyituṃ,rayitum,1,1,0,0,7
98540,gāyituṃ,gayitum,16,16,0,0,7
98541,kāyitvā,kayitva,1,1,0,0,7
98542,rāyitvā,rayitva,1,1,0,0,7
98543,pariyattiyampi,pariyattiyampi,1,1,0,0,14
98544,khāyatīti,khayatiti,30,19,11,0,9
98545,nibbattatīti,nibbattatiti,58,48,10,0,12
98546,kathiyatī,kathiyati,1,1,0,0,9
98547,dhātūnantu,dhatunantu,1,1,0,0,10
98548,jīratī,jirati,12,10,2,0,6
98549,atthameva,atthameva,35,34,1,0,9
98550,cavanaṃ,cavanam,25,24,1,0,7
98551,plavanaṃ,plavanam,1,1,0,0,8
98552,pototi,pototi,2,0,2,0,6
98553,bhinnaplavo,bhinnaplavo,5,5,0,0,11
98554,sāgarasseva,sagarasseva,8,8,0,0,11
98555,jalayānaṃ,jalayanam,2,2,0,0,9
98556,nāvābhidhānāni,navabhidhanani,1,1,0,0,14
98557,dhāyati,dhayati,4,4,0,0,7
98558,thāyati,thayati,2,2,0,0,7
98559,jutasubha,jutasubha,1,0,1,0,9
98560,aga,aga,1,0,1,0,3
98561,salayatīti,salayatiti,1,1,0,0,10
98562,hetukattuvasenidaṃ,hetukattuvasenidam,1,1,0,0,18
98563,salayanti,salayanti,8,7,1,0,9
98564,calayanti,calayanti,8,8,0,0,9
98565,viddhaṃsentīti,viddhamsentiti,9,8,1,0,14
98566,sayantīti,sayantiti,20,18,2,0,9
98567,akusaladhammasaṅkhāte,akusaladhammasankhate,1,1,0,0,21
98568,lunanti,lunanti,21,20,1,0,7
98569,chindantīti,chindantiti,13,8,5,0,11
98570,lātabbāti,latabbati,3,3,0,0,9
98571,pavattetabbāti,pavattetabbati,7,7,0,0,14
98572,ubhayabhāgagataṃ,ubhayabhagagatam,18,17,1,0,16
98573,hatthappadesaṃ,hatthappadesam,7,7,0,0,14
98574,evamimepi,evamimepi,12,12,0,0,9
98575,uppannānuppannabhāvena,uppannanuppannabhavena,7,7,0,0,22
98576,kilesapakkhaṃ,kilesapakkham,6,6,0,0,13
98577,lunantītipi,lunantitipi,2,2,0,0,11
98578,padāpekkhaṃ,padapekkham,1,1,0,0,11
98579,tadanurūpaliṅgavacanavasena,tadanurupalingavacanavasena,1,1,0,0,27
98580,sāmaññaniddesavasena,samannaniddesavasena,1,1,0,0,20
98581,napuṃsakekavacananiddeso,napumsakekavacananiddeso,1,1,0,0,24
98582,puññavācako,punnavacako,2,2,0,0,11
98583,ārogyavācako,arogyavacako,1,1,0,0,12
98584,itaratthavācako,itaratthavacako,1,1,0,0,15
98585,samodhānagatadhātuyo,samodhanagatadhatuyo,1,1,0,0,20
98586,saṅkhepā,sankhepa,25,22,3,0,8
98587,bhūvādīnaṃ,bhuvadinam,1,0,1,0,10
98588,sauddeso,sauddeso,1,1,0,0,8
98589,saniddeso,saniddeso,1,1,0,0,9
98590,nānāatthayutehi,nanaatthayutehi,1,1,0,0,15
98591,yojetvāna,yojetvana,3,3,0,0,9
98592,padānettha,padanettha,3,3,0,0,10
98593,pāḷinidassanādīhi,palinidassanadihi,1,1,0,0,17
98594,dyantāni,dyantani,2,2,0,0,8
98595,nyantāni,nyantani,1,1,0,0,8
98596,sadisattañca,sadisattanca,1,1,0,0,12
98597,visadisattanaṃ,visadisattanam,1,1,0,0,14
98598,codanāparihārehi,codanapariharehi,1,1,0,0,16
98599,catthanicchayo,catthanicchayo,1,1,0,0,14
98600,bhidhānañca,bhidhananca,1,1,0,0,11
98601,liṅgattayavimissanaṃ,lingattayavimissanam,1,1,0,0,20
98602,savisesapadāni,savisesapadani,1,1,0,0,14
98603,nānāpadabahuppadasamodhānañca,nanapadabahuppadasamodhananca,1,1,0,0,29
98604,rūḷhīsaddādayo,rulhisaddadayo,1,1,0,0,14
98605,suvibhattā,suvibhatta,13,11,2,0,10
98606,anākulā,anakula,15,11,4,0,7
98607,sabbanāmasadisāni,sabbanamasadisani,1,1,0,0,17
98608,nānāpadehi,nanapadehi,3,3,0,0,10
98609,saddanītimhi,saddanitimhi,2,2,0,0,12
98610,vītakaṅkhā,vitakankha,1,1,0,0,10
98611,acchambhino,acchambhino,1,1,0,0,11
98612,sīhasamā,sihasama,1,1,0,0,8
98613,vibhūtabhutaggasayambhucakke,vibhutabhutaggasayambhucakke,1,1,0,0,28
98614,subhūtabhūriṃ,subhutabhurim,1,1,0,0,13
98615,bhuvādi,bhuvadi,2,1,1,0,7
98616,bhajathatthakāmo,bhajathatthakamo,1,1,0,0,16
98617,pannarasahi,pannarasahi,43,43,0,0,11
98618,rudhādichakka,rudhadichakka,1,1,0,0,13
98619,rudhādigaṇika,rudhadiganika,1,1,0,0,13
98620,rudhādika,rudhadika,1,0,1,0,9
98621,gaṇādayo,ganadayo,3,3,0,0,8
98622,chabbidhe,chabbidhe,11,11,0,0,9
98623,pidahanaṃ,pidahanam,24,24,0,0,9
98624,parirundhanaṃ,parirundhanam,1,1,0,0,13
98625,palibuddhanaṃ,palibuddhanam,2,2,0,0,13
98626,appadānaṃ,appadanam,7,7,0,0,9
98627,avarundheti,avarundheti,1,1,0,0,11
98628,rundhiyati,rundhiyati,1,1,0,0,10
98629,paṭivirodho,pativirodho,48,44,4,0,11
98630,pariruddho,pariruddho,8,8,0,0,10
98631,parirundhituṃ,parirundhitum,1,1,0,0,13
98632,rundhitvā,rundhitva,19,19,0,0,9
98633,parirundhitvā,parirundhitva,1,1,0,0,13
98634,rodhoti,rodhoti,2,0,2,0,7
98635,pavesitānaṃ,pavesitanam,3,2,1,0,11
98636,kurūrakammantānaṃ,kururakammantanam,3,3,0,0,17
98637,orodhoti,orodhoti,1,0,1,0,8
98638,rājubbarī,rajubbari,1,1,0,0,9
98639,yathākāmacāraṃ,yathakamacaram,1,1,0,0,14
98640,appadānena,appadanena,18,18,0,0,10
98641,orundhiyati,orundhiyati,1,1,0,0,11
98642,avarundhiyatīti,avarundhiyatiti,1,1,0,0,15
98643,ananukūlatā,ananukulata,3,3,0,0,11
98644,paṭivirodhoti,pativirodhoti,5,2,3,0,13
98645,viruddhoti,viruddhoti,5,2,3,0,10
98646,paṭiviruddhoti,pativiruddhoti,2,1,1,0,14
98647,paṭisattubhāvena,patisattubhavena,2,2,0,0,16
98648,pariruddhoti,pariruddhoti,2,0,2,0,12
98649,gahaṇatthāya,gahanatthaya,43,42,1,0,12
98650,samparivārito,samparivarito,3,3,0,0,13
98651,vijjante,vijjante,49,49,0,0,8
98652,avaruddhoti,avaruddhoti,1,0,1,0,11
98653,muñcanaṃ,muncanam,11,10,1,0,8
98654,mocanaṃ,mocanam,19,17,2,0,7
98655,dukkhappamocanaṃ,dukkhappamocanam,2,2,0,0,16
98656,moco,moco,2,2,0,0,4
98657,mocoti,mocoti,1,0,1,0,6
98658,aṭṭhikakadalīrukkho,atthikakadalirukkho,1,1,0,0,19
98659,muñcituṃ,muncitum,28,28,0,0,8
98660,mocetuṃ,mocetum,77,74,3,0,7
98661,mocetvā,mocetva,239,236,3,0,7
98662,virecane,virecane,1,0,1,0,8
98663,riñcati,rincati,57,53,4,0,7
98664,virecanaṃ,virecanam,55,50,5,0,9
98665,virecako,virecako,2,2,0,0,8
98666,riñcituṃ,rincitum,1,1,0,0,8
98667,riñcitvā,rincitva,5,4,1,0,8
98668,rajje,rajje,259,253,6,0,5
98669,abhisiñci,abhisinci,23,23,0,0,9
98670,sittaṭṭhānaṃ,sittatthanam,1,1,0,0,12
98671,siñcituṃ,sincitum,12,10,2,0,8
98672,siñcitvā,sincitva,62,58,4,0,8
98673,anuyuñjati,anuyunjati,35,33,2,0,10
98674,yuñjiyatī,yunjiyati,1,1,0,0,9
98675,yuñjate,yunjate,1,1,0,0,7
98676,yuñjanaṃ,yunjanam,9,9,0,0,8
98677,bhāvanānuyutto,bhavananuyutto,4,4,0,0,14
98678,saññojanaṃ,sannojanam,48,48,0,0,10
98679,yuñjituṃ,yunjitum,2,2,0,0,8
98680,anuyuñjituṃ,anuyunjitum,22,22,0,0,11
98681,anuyuñjitvā,anuyunjitva,17,17,0,0,11
98682,yojeti,yojeti,37,35,2,0,6
98683,kāmarāgādi,kamaragadi,2,2,0,0,10
98684,dvādasaṅgulyo,dvadasangulyo,1,1,0,0,13
98685,tadvayaṃ,tadvayam,1,1,0,0,8
98686,sattaratanikā,sattaratanika,1,1,0,0,13
98687,vīsayaṭṭhikaṃ,visayatthikam,1,1,0,0,13
98688,usabhāsīti,usabhasiti,2,2,0,0,10
98689,byavaharaṇaṃ,byavaharanam,1,0,1,0,12
98690,ajjhoharaṇaṃ,ajjhoharanam,16,15,1,0,12
98691,saṃbhuñjati,sambhunjati,2,2,0,0,11
98692,dāsaparibhogena,dasaparibhogena,5,4,1,0,15
98693,bhojeti,bhojeti,16,16,0,0,7
98694,bhojayatī,bhojayati,1,1,0,0,9
98695,mahibhujo,mahibhujo,1,1,0,0,9
98696,gāmabhojako,gamabhojako,22,22,0,0,11
98697,upabhogo,upabhogo,10,9,1,0,8
98698,paribhogo,paribhogo,164,156,8,0,9
98699,tumantāditte,tumantaditte,1,1,0,0,12
98700,paribhuñjituṃ,paribhunjitum,533,492,41,0,13
98701,bhojetuṃ,bhojetum,15,14,1,0,8
98702,bhojayituṃ,bhojayitum,2,2,0,0,10
98703,bhuñjitvā,bhunjitva,601,599,2,0,9
98704,bhuñjitvāna,bhunjitvana,5,5,0,0,11
98705,bhuñjiya,bhunjiya,11,11,0,0,8
98706,bhuñjiyāna,bhunjiyana,1,1,0,0,10
98707,bhojetvā,bhojetva,174,174,0,0,8
98708,bhojetvāna,bhojetvana,1,1,0,0,10
98709,bhojayitvā,bhojayitva,13,13,0,0,10
98710,bhojayitvāna,bhojayitvana,21,21,0,0,12
98711,visesitabbāni,visesitabbani,3,3,0,0,13
98712,khuddakappāni,khuddakappani,15,15,0,0,13
98713,piṇḍapātaṃ,pindapatam,665,628,37,0,10
98714,gilānapaccayabhesajjaparikkhāraṃ,gilanapaccayabhesajjaparikkharam,57,52,5,0,32
98715,paṭisevatīti,patisevatiti,26,12,14,0,12
98716,saṃvaṇṇiyati,samvanniyati,2,2,0,0,12
98717,bhuñjanaparibhuñjana,bhunjanaparibhunjana,1,0,1,0,20
98718,paṭisevanatthena,patisevanatthena,1,1,0,0,16
98719,samānatthāpi,samanatthapi,1,1,0,0,12
98720,avagantabbā,avagantabba,2,2,0,0,11
98721,saṃbhuñjatīti,sambhunjatiti,1,0,1,0,13
98722,sambhogaṃ,sambhogam,13,13,0,0,9
98723,ettakesupi,ettakesupi,1,1,0,0,10
98724,upasaggasahāye,upasaggasahaye,1,1,0,0,14
98725,labhitvāpi,labhitvapi,36,36,0,0,10
98726,anekatthatarāva,anekatthatarava,1,1,0,0,15
98727,bhejjissati,bhejjissati,1,1,0,0,11
98728,bhindissatī,bhindissati,6,5,1,0,11
98729,yodha,yodha,80,61,19,0,5
98730,bāhitvā,bahitva,19,16,3,0,7
98731,khīṇāsavaṃ,khinasavam,92,85,7,0,10
98732,sekkhaputhujjanasamaṇāpi,sekkhaputhujjanasamanapi,1,1,0,0,24
98733,pāpuṇantiyeva,papunantiyeva,4,4,0,0,13
98734,saṅghabhedako,sanghabhedako,114,108,6,0,13
98735,bhindiyatīti,bhindiyatiti,1,1,0,0,12
98736,chindiyatīti,chindiyatiti,1,1,0,0,12
98737,chinnopi,chinnopi,12,11,1,0,8
98738,bhidichidi,bhidichidi,1,0,1,0,10
98739,chijjatī,chijjati,14,14,0,0,8
98740,suddhakattuvasenapi,suddhakattuvasenapi,2,2,0,0,19
98741,hiṃsānādaresu,himsanadaresu,1,0,1,0,13
98742,taddu,taddu,1,1,0,0,5
98743,pasavakiledanesu,pasavakiledanesu,1,0,1,0,16
98744,kiledanaṃ,kiledanam,1,1,0,0,9
98745,tindatā,tindata,1,1,0,0,7
98746,vittīti,vittiti,10,3,7,0,7
98747,nibbindati,nibbindati,528,522,6,0,10
98748,nibbindanaṃ,nibbindanam,5,5,0,0,11
98749,nibbindo,nibbindo,6,6,0,0,8
98750,kāmaratiyā,kamaratiya,12,12,0,0,10
98751,atthavedaṃ,atthavedam,51,44,7,0,10
98752,dhammavedaṃ,dhammavedam,49,42,7,0,11
98753,vittijananattā,vittijananatta,1,1,0,0,14
98754,vittasaṅkhātaṃ,vittasankhatam,1,1,0,0,14
98755,ñāṇampi,nanampi,40,39,1,0,7
98756,somanassampi,somanassampi,7,7,0,0,12
98757,vedagumabhijaññā,vedagumabhijanna,1,1,0,0,16
98758,akiñcanaṃ,akincanam,94,64,30,0,9
98759,kāmabhave,kamabhave,246,218,28,0,9
98760,asattaṃ,asattam,39,25,14,0,7
98761,vedajātā,vedajata,21,21,0,0,8
98762,vedaganthe,vedaganthe,2,2,0,0,10
98763,somanasse,somanasse,12,12,0,0,9
98764,nānādhātuto,nanadhatuto,1,1,0,0,11
98765,limpane,limpane,3,2,1,0,7
98766,limpako,limpako,1,1,0,0,7
98767,avalepo,avalepo,2,2,0,0,7
98768,avalepoti,avalepoti,1,0,1,0,9
98769,acchedane,acchedane,1,0,1,0,9
98770,lumpati,lumpati,3,3,0,0,7
98771,vilumpako,vilumpako,4,4,0,0,9
98772,vilutto,vilutto,9,7,2,0,7
98773,vilopo,vilopo,6,6,0,0,6
98774,vilumpateva,vilumpateva,5,4,1,0,11
98775,upakappati,upakappati,74,74,0,0,10
98776,vilumpanti,vilumpanti,25,25,0,0,10
98777,vilumpatīti,vilumpatiti,6,4,2,0,11
98778,cuṇṇane,cunnane,2,1,1,0,7
98779,piṃsati,pimsati,2,2,0,0,7
98780,pisako,pisako,1,1,0,0,6
98781,suññabhāvaṃ,sunnabhavam,15,11,4,0,11
98782,hisi,hisi,3,1,2,0,4
98783,vihiṃsāyaṃ,vihimsayam,3,2,1,0,10
98784,vihiṃsati,vihimsati,37,37,0,0,9
98785,ahiṃsakoti,ahimsakoti,8,4,4,0,10
98786,hiṃsakassa,himsakassa,6,5,1,0,10
98787,ajjāhaṃ,ajjaham,26,25,1,0,7
98788,saccanāmomhi,saccanamomhi,4,4,0,0,12
98789,hiṃsitabbaṃ,himsitabbam,1,1,0,0,11
98790,kiṃsatīti,kimsatiti,1,1,0,0,9
98791,ādiantakkharavipallāsavasena,adiantakkharavipallasavasena,1,1,0,0,28
98792,kantanaṭṭhena,kantanatthena,2,2,0,0,13
98793,vihesako,vihesako,7,3,4,0,8
98794,vihesanaṃ,vihesanam,4,4,0,0,9
98795,gāvova,gavova,13,13,0,0,6
98796,parisumbhati,parisumbhati,4,4,0,0,12
98797,saṃsumbhamānā,samsumbhamana,3,3,0,0,13
98798,kālamāgamayāmase,kalamagamayamase,3,3,0,0,16
98799,kesaggahaṇamukkhepā,kesaggahanamukkhepa,4,3,1,0,19
98800,parisumbhanā,parisumbhana,3,3,0,0,12
98801,bahudukkhaṃ,bahudukkham,14,14,0,0,11
98802,sumbhāmi,sumbhami,5,5,0,0,8
98803,vegasā,vegasa,46,46,0,0,6
98804,anupapattito,anupapattito,6,6,0,0,12
98805,paṭiladdhavaggantabhāvassa,patiladdhavaggantabhavassa,2,2,0,0,26
98806,niggahītāgamassa,niggahitagamassa,4,4,0,0,16
98807,khañjatī,khanjati,3,3,0,0,8
98808,kantatī,kantati,2,2,0,0,7
98809,anekassarā,anekassara,10,10,0,0,10
98810,asaṃyogantā,asamyoganta,2,2,0,0,11
98811,ākhyātattañca,akhyatattanca,1,1,0,0,13
98812,nāmikattañca,namikattanca,2,2,0,0,12
98813,suddhakattuhetukattuvisayesu,suddhakattuhetukattuvisayesu,2,2,0,0,28
98814,niggahītāgamena,niggahitagamena,9,9,0,0,15
98815,nipphannarūpā,nipphannarupa,5,5,0,0,13
98816,rūpappavatti,rupappavatti,8,8,0,0,12
98817,anekassarānaṃ,anekassaranam,1,1,0,0,13
98818,gaṇikānaṃ,ganikanam,3,3,0,0,9
98819,asaṃyogantvā,asamyogantva,1,1,0,0,12
98820,ākhyātattaṃ,akhyatattam,2,2,0,0,11
98821,suddhakattuvisayeyeva,suddhakattuvisayeyeva,1,1,0,0,21
98822,nāmikattaṃ,namikattam,1,1,0,0,10
98823,sahaniggahītāgamena,sahaniggahitagamena,1,1,0,0,19
98824,sasaṃyogarūpāyeva,sasamyogarupayeva,1,1,0,0,17
98825,muñcāpeti,muncapeti,1,1,0,0,9
98826,mocāpeti,mocapeti,5,5,0,0,8
98827,chindāpeti,chindapeti,7,7,0,0,10
98828,chedeti,chedeti,3,3,0,0,7
98829,chedāpeti,chedapeti,15,13,2,0,9
98830,chindanaṃ,chindanam,15,15,0,0,9
98831,kantanaṃ,kantanam,4,4,0,0,8
98832,piṭṭhimaṃsāni,pitthimamsani,14,14,0,0,13
98833,ukkacca,ukkacca,9,9,0,0,7
98834,ukkaccāti,ukkaccati,4,0,4,0,9
98835,ukkantitvā,ukkantitva,7,7,0,0,10
98836,chinditvāti,chinditvati,25,6,19,0,11
98837,ākhyātanāmikabhāvaṃ,akhyatanamikabhavam,1,1,0,0,19
98838,paṭiladdhaniggahītāgamehi,patiladdhaniggahitagamehi,1,1,0,0,25
98839,ādīhiyeva,adihiyeva,2,2,0,0,9
98840,gaṇikehi,ganikehi,2,2,0,0,8
98841,mucachidi,mucachidi,3,0,3,0,9
98842,ādīhīti,adihiti,5,1,4,0,7
98843,rundhissa,rundhissa,1,1,0,0,9
98844,rundhayati,rundhayati,1,1,0,0,10
98845,rundhāpeti,rundhapeti,2,2,0,0,10
98846,rundhanaṃ,rundhanam,4,4,0,0,9
98847,niggahītāgamāniggahītāgamavasena,niggahitagamaniggahitagamavasena,2,2,0,0,32
98848,dvippakārāni,dvippakarani,2,2,0,0,12
98849,ādīnampīti,adinampiti,2,1,1,0,10
98850,niccavidhānatthaṃ,niccavidhanattham,2,2,0,0,17
98851,niggahītapubbañcā,niggahitapubbanca,3,3,0,0,17
98852,nāmikapadattampi,namikapadattampi,1,1,0,0,16
98853,kriyāpadattaṃyeva,kriyapadattamyeva,1,1,0,0,17
98854,sakikhaji,sakikhaji,3,0,3,0,9
98855,saniggahītāgamakriyāpadattaṃyeva,saniggahitagamakriyapadattamyeva,1,1,0,0,32
98856,mantunti,mantunti,2,2,0,0,8
98857,asamānagatikattā,asamanagatikatta,5,5,0,0,16
98858,nāmikatte,namikatte,7,7,0,0,9
98859,dvippakārassa,dvippakarassa,1,1,0,0,13
98860,dvippakāravantatā,dvippakaravantata,3,3,0,0,17
98861,gaṇabhāvassa,ganabhavassa,2,2,0,0,12
98862,saniggahītāgamo,saniggahitagamo,1,1,0,0,15
98863,dvippakāravantatāsambhavepi,dvippakaravantatasambhavepi,1,1,0,0,27
98864,abbhāsavisaye,abbhasavisaye,3,3,0,0,13
98865,niggahītāgamaṃ,niggahitagamam,3,3,0,0,14
98866,gaṇikabhāvassa,ganikabhavassa,1,1,0,0,14
98867,lakkhaṇanti,lakkhananti,54,54,0,0,11
98868,rudhādī,rudhadi,3,2,1,0,7
98869,suttesvaññepi,suttesvannepi,7,7,0,0,13
98870,pekkhitvā,pekkhitva,10,10,0,0,9
98871,gaṇhavho,ganhavho,8,8,0,0,8
98872,atthayuttitoti,atthayuttitoti,3,3,0,0,14
98873,dudhādi,dudhadi,1,0,1,0,7
98874,gaṇoyaṃ,ganoyam,8,8,0,0,7
98875,divādigaṇika,divadiganika,1,1,0,0,12
98876,kīḷāvijigisābyavahārajutithutikantigatisattīsu,kilavijigisabyavaharajutithutikantigatisattisu,1,0,1,0,46
98877,kīḷāti,kilati,3,1,2,0,6
98878,laḷanā,lalana,1,1,0,0,6
98879,laḷanāti,lalanati,1,0,1,0,8
98880,laḷitānubhavanavasena,lalitanubhavanavasena,2,2,0,0,21
98881,iriyāpathaparivattanādinā,iriyapathaparivattanadina,4,4,0,0,25
98882,vijigisāti,vijigisati,1,0,1,0,10
98883,vijayicchā,vijayiccha,3,3,0,0,10
98884,byavahāroti,byavaharoti,1,0,1,0,11
98885,kamanīyatā,kamaniyata,1,1,0,0,10
98886,sattīti,sattiti,8,3,5,0,7
98887,visuddhidevāti,visuddhidevati,11,10,1,0,14
98888,rājarājakumārādayo,rajarajakumaradayo,2,2,0,0,18
98889,bhummadeve,bhummadeve,10,10,0,0,10
98890,taduttaridevā,taduttarideva,5,5,0,0,13
98891,kāmaguṇajhānābhiññācittissariyādīhi,kamagunajhanabhinnacittissariyadihi,2,2,0,0,35
98892,yathābhilāsitaṃ,yathabhilasitam,2,2,0,0,15
98893,taṃtaṃbyasananittharaṇatthikehi,tamtambyasananittharanatthikehi,4,4,0,0,31
98894,parāyaṇanti,parayananti,12,12,0,0,11
98895,devanīyā,devaniya,4,4,0,0,8
98896,abhitthavanīyāti,abhitthavaniyati,1,1,0,0,16
98897,sobhāvisesayogena,sobhavisesayogena,5,5,0,0,17
98898,kamanīyāti,kamaniyati,8,5,3,0,10
98899,thutikanti,thutikanti,1,0,1,0,10
98900,kammasādhanavasena,kammasadhanavasena,9,9,0,0,18
98901,kattusādhanavasena,kattusadhanavasena,7,7,0,0,18
98902,kīḷāvijigisābyavahārajutithutigatīsū,kilavijigisabyavaharajutithutigatisu,1,1,0,0,36
98903,jutithutīsū,jutithutisu,1,1,0,0,11
98904,thutī,thuti,1,1,0,0,5
98905,jutigatīsū,jutigatisu,1,1,0,0,10
98906,sattithutikaṃ,sattithutikam,1,0,1,0,13
98907,itiatthepi,itiatthepi,1,1,0,0,10
98908,abhidhammassa,abhidhammassa,32,31,1,0,13
98909,anuṭīkākāro,anutikakaro,1,0,1,0,11
98910,kīḷāvijigisāvohārajutigatiattho,kilavijigisavoharajutigatiattho,2,2,0,0,31
98911,sattiabhitthavakamanatthopi,sattiabhitthavakamanatthopi,2,2,0,0,27
98912,dhātusaddānaṃ,dhatusaddanam,14,13,1,0,13
98913,anekatthabhāvato,anekatthabhavato,1,1,0,0,16
98914,sammutidevādīsu,sammutidevadisu,1,1,0,0,15
98915,yuttāyuttaṃ,yuttayuttam,16,16,0,0,11
98916,sarīrajutiyā,sarirajutiya,3,3,0,0,12
98917,thomiyanti,thomiyanti,2,2,0,0,10
98918,tabbhāvatthikehi,tabbhavatthikehi,1,1,0,0,16
98919,kāmiyanti,kamiyanti,2,2,0,0,9
98920,yathicchitaṭṭhānaṃ,yathicchitatthanam,8,8,0,0,18
98921,appaṭihatagamanena,appatihatagamanena,1,1,0,0,18
98922,ānubhāvasampattiyā,anubhavasampattiya,6,6,0,0,18
98923,taṃtaṃkiccaṃ,tamtamkiccam,2,2,0,0,12
98924,nipphādetunti,nipphadetunti,1,1,0,0,13
98925,cātumahārājikādayo,catumaharajikadayo,7,7,0,0,18
98926,jhānakīḷāya,jhanakilaya,2,2,0,0,11
98927,paramasukhumañāṇavisesavisayaṃ,paramasukhumananavisesavisayam,1,1,0,0,30
98928,sabbakilesadosakalusābhāvā,sabbakilesadosakalusabhava,1,1,0,0,26
98929,paramavisuddhāya,paramavisuddhaya,1,1,0,0,16
98930,ñāṇajutiyā,nanajutiya,4,4,0,0,10
98931,viññātasabhāvehi,vinnatasabhavehi,1,1,0,0,16
98932,paramanimmalaguṇavisesayogato,paramanimmalagunavisesayogato,1,1,0,0,29
98933,anuttarapuññakkhettatāya,anuttarapunnakkhettataya,1,1,0,0,24
98934,apaccāgamanīyāya,apaccagamaniyaya,1,1,0,0,16
98935,cittācāraṃ,cittacaram,73,69,4,0,10
98936,niyojetuṃ,niyojetum,11,11,0,0,9
98937,amatamahānibbānasukhe,amatamahanibbanasukhe,1,1,0,0,21
98938,patiṭṭhāpetunti,patitthapetunti,2,2,0,0,15
98939,viddhe,viddhe,36,36,0,0,6
98940,vigatavalāhake,vigatavalahake,54,50,4,0,14
98941,ajaṭākāse,ajatakase,9,9,0,0,9
98942,phusāyatī,phusayati,3,3,0,0,9
98943,issarapuggale,issarapuggale,1,1,0,0,13
98944,samappito,samappito,80,78,2,0,9
98945,samaṅgībhūto,samangibhuto,64,64,0,0,12
98946,paricāreti,paricareti,28,28,0,0,10
98947,upapattideve,upapattideve,2,2,0,0,12
98948,devātidevaṃ,devatidevam,15,13,2,0,11
98949,naradammasārathiṃ,naradammasarathim,7,7,0,0,17
98950,visuddhideve,visuddhideve,2,2,0,0,12
98951,devīti,deviti,17,9,8,0,6
98952,rājabhariyāpi,rajabhariyapi,1,1,0,0,13
98953,devadhītāpi,devadhitapi,6,6,0,0,11
98954,bhariyāti,bhariyati,21,7,14,0,9
98955,puññiddhiyā,punniddhiya,28,28,0,0,11
98956,brahmāpi,brahmapi,8,8,0,0,8
98957,ruttiyā,ruttiya,1,1,0,0,7
98958,vibudho,vibudho,2,2,0,0,7
98959,nijjaro,nijjaro,4,3,1,0,7
98960,amaro,amaro,36,34,2,0,5
98961,sudhāsī,sudhasi,2,2,0,0,7
98962,tidaso,tidaso,2,1,1,0,6
98963,saggavāsī,saggavasi,1,1,0,0,9
98964,animisopi,animisopi,1,1,0,0,9
98965,divoko,divoko,1,1,0,0,6
98966,matapāyī,matapayi,1,1,0,0,8
98967,saggaṭṭho,saggattho,2,2,0,0,9
98968,khiyati,khiyati,2,2,0,0,7
98969,rāgakkhayo,ragakkhayo,108,99,9,0,10
98970,kodhahiṃsāsu,kodhahimsasu,1,0,1,0,12
98971,nāgadānena,nagadanena,3,3,0,0,10
98972,khiyantīti,khiyantiti,2,0,2,0,10
98973,ghāyatīti,ghayatiti,25,24,1,0,9
98974,ghāyituṃ,ghayitum,10,10,0,0,8
98975,bhattampitassa,bhattampitassa,1,1,0,0,14
98976,ruccituṃ,ruccitum,1,1,0,0,8
98977,ruccitvā,ruccitva,9,8,1,0,8
98978,dittimhī,dittimhi,1,0,1,0,8
98979,dittisaṅkhātasobhanatthavācakassa,dittisankhatasobhanatthavacakassa,1,1,0,0,33
98980,rūpābhāvato,rupabhavato,5,5,0,0,11
98981,dittirucīnaṃ,dittirucinam,1,1,0,0,12
98982,bhuvādigaṇiko,bhuvadiganiko,1,1,0,0,13
98983,rūpāniyeva,rupaniyeva,3,3,0,0,10
98984,ruciyāyeva,ruciyayeva,1,1,0,0,10
98985,gaṇikopi,ganikopi,2,2,0,0,8
98986,gaṇikakāle,ganikakale,2,2,0,0,10
98987,ācikkhane,acikkhane,3,3,0,0,9
98988,āroceti,aroceti,231,229,2,0,7
98989,ārocayatī,arocayati,1,1,0,0,9
98990,adhimuccati,adhimuccati,79,79,0,0,11
98991,muccamāno,muccamano,10,9,1,0,9
98992,uccati,uccati,2,2,0,0,6
98993,okoti,okoti,4,0,4,0,5
98994,udakampi,udakampi,48,45,3,0,8
98995,āvāsopi,avasopi,3,3,0,0,7
98996,okapuṇṇehi,okapunnehi,7,7,0,0,10
98997,cīvarehī,civarehi,3,3,0,0,8
98998,vārijova,varijova,5,5,0,0,8
98999,khitto,khitto,69,68,1,0,6
99000,okamokatamubbhato,okamokatamubbhato,1,1,0,0,17
99001,nibbattakimiviseso,nibbattakimiviseso,1,1,0,0,18
99002,dīpikādayo,dipikadayo,1,1,0,0,10
99003,ukkāsu,ukkasu,24,23,1,0,6
99004,dhāriyamānāsū,dhariyamanasu,2,2,0,0,13
99005,bandheyya,bandheyya,40,40,0,0,9
99006,ukkāmukhaṃ,ukkamukham,19,18,1,0,10
99007,ālimpeyyā,alimpeyya,3,3,0,0,9
99008,bahī,bahi,17,14,3,0,4
99009,ukkāpāto,ukkapato,11,11,0,0,8
99010,saṇḍāsena,sandasena,44,44,0,0,9
99011,ukkāmukhe,ukkamukhe,22,19,3,0,9
99012,pakkhipeyyā,pakkhipeyya,6,6,0,0,11
99013,suvaṇṇakārānaṃ,suvannakaranam,9,9,0,0,14
99014,dīpikāvātavegesu,dipikavatavegesu,1,1,0,0,16
99015,kammārānañca,kammarananca,1,1,0,0,12
99016,mūsāyampi,musayampi,1,1,0,0,9
99017,aṅgārakapalle,angarakapalle,7,7,0,0,13
99018,che,che,1,0,1,0,3
99019,chiyati,chiyati,1,1,0,0,7
99020,chiyanti,chiyanti,1,1,0,0,8
99021,avacchitaṃ,avacchitam,1,1,0,0,10
99022,avacchātaṃ,avacchatam,1,1,0,0,10
99023,sammāpayogavasena,sammapayogavasena,1,1,0,0,17
99024,vāyametheva,vayametheva,28,25,3,0,11
99025,nibbindeyya,nibbindeyya,39,38,1,0,11
99026,mattānaṃ,mattanam,10,9,1,0,8
99027,icchiṃ,icchim,32,27,5,0,6
99028,upapajjatīti,upapajjatiti,97,73,24,0,12
99029,rajjamāno,rajjamano,6,5,1,0,9
99030,rajjanto,rajjanto,5,5,0,0,8
99031,virajjanaṃ,virajjanam,17,16,1,0,10
99032,rajanīyaṃ,rajaniyam,23,22,1,0,9
99033,upasaggavasena,upasaggavasena,74,73,1,0,14
99034,nirajjati,nirajjati,20,20,0,0,9
99035,virajjanti,virajjanti,21,21,0,0,10
99036,saṃkilesadhammāti,samkilesadhammati,1,1,0,0,17
99037,saṃvego,samvego,56,47,9,0,7
99038,saṃvejanīyaṃ,samvejaniyam,13,11,2,0,12
99039,ubbijjati,ubbijjati,7,7,0,0,9
99040,ubbiggahadayo,ubbiggahadayo,1,1,0,0,13
99041,lutti,lutti,2,2,0,0,5
99042,lujjanaṃ,lujjanam,2,2,0,0,8
99043,lutto,lutto,3,3,0,0,5
99044,tatraṭṭho,tatrattho,37,36,1,0,9
99045,kappaṭṭhāyī,kappatthayi,3,3,0,0,11
99046,āsabhaṭṭhānaṭṭhāyī,asabhatthanatthayi,1,1,0,0,18
99047,sayāmi,sayami,14,13,1,0,6
99048,ṭhāyāmi,thayami,3,3,0,0,7
99049,kappemi,kappemi,43,41,2,0,7
99050,ahatthapāso,ahatthapaso,5,4,1,0,11
99051,satthānukampako,satthanukampako,2,2,0,0,15
99052,lāpaṃ,lapam,15,14,1,0,5
99053,gocaraṭṭhāyinanti,gocaratthayinanti,1,1,0,0,17
99054,ṭhāyāmīti,thayamiti,2,0,2,0,9
99055,tiṭṭhāmi,titthami,43,41,2,0,8
99056,ḍigatiyaṃ,digatiyam,2,1,1,0,9
99057,ḍiyati,diyati,1,1,0,0,6
99058,ḍino,dino,2,2,0,0,4
99059,pattayāna,pattayana,7,7,0,0,9
99060,vihaṅgama,vihangama,14,14,0,0,9
99061,vāmūruṃ,vamurum,5,4,1,0,7
99062,ḍiyatīti,diyatiti,1,1,0,0,8
99063,ḍemānoti,demanoti,1,0,1,0,8
99064,khosi,khosi,54,54,0,0,5
99065,katakalyāṇo,katakalyano,22,20,2,0,11
99066,katabhīruttāṇo,katabhiruttano,8,7,1,0,14
99067,mahātejavantatāya,mahatejavantataya,1,1,0,0,17
99068,upaddavaṃ,upaddavam,44,37,7,0,9
99069,upasaggañca,upasagganca,1,1,0,0,11
99070,gattavināmo,gattavinamo,1,0,1,0,11
99071,gattavikkhepo,gattavikkhepo,2,2,0,0,13
99072,naccati,naccati,25,22,3,0,7
99073,nigaṇṭho,nigantho,185,176,9,0,8
99074,nāṭaputto,nataputto,114,109,5,0,9
99075,niddāyanaṃ,niddayanam,3,3,0,0,10
99076,niddāyamāno,niddayamano,7,6,1,0,11
99077,niddāyanto,niddayanto,35,33,2,0,10
99078,ādiyati,adiyati,195,190,5,0,7
99079,ādapayati,adapayati,1,1,0,0,9
99080,samādapayati,samadapayati,2,2,0,0,12
99081,diyanti,diyanti,2,2,0,0,7
99082,appamattakañhi,appamattakanhi,1,1,0,0,14
99083,gomayapiṇḍaṃ,gomayapindam,7,6,1,0,12
99084,appakassa,appakassa,15,14,1,0,9
99085,kāmāvacarassa,kamavacarassa,88,85,3,0,13
99086,appesakkhattā,appesakkhatta,1,1,0,0,13
99087,vodāyati,vodayati,13,12,1,0,8
99088,nettisaṃvaṇṇanāyaṃ,nettisamvannanayam,1,0,1,0,18
99089,dīnoti,dinoti,3,2,1,0,6
99090,parikkhīṇañātidhanādibhāvena,parikkhinanatidhanadibhavena,1,1,0,0,28
99091,ādīnavotiādīnaṃ,adinavotiadinam,1,0,1,0,15
99092,etenātiādīnavo,etenatiadinavo,1,1,0,0,14
99093,duyate,duyate,1,1,0,0,6
99094,duno,duno,3,3,0,0,4
99095,bhijjane,bhijjane,2,1,1,0,8
99096,bhijjanaṃ,bhijjanam,10,10,0,0,9
99097,chijjane,chijjane,1,0,1,0,8
99098,chijjanaṃ,chijjanam,1,1,0,0,9
99099,dīniye,diniye,1,0,1,0,6
99100,dīnabhāvo,dinabhavo,2,2,0,0,9
99101,dīniyaṃ,diniyam,1,0,1,0,7
99102,khijjati,khijjati,5,5,0,0,8
99103,akhinnamati,akhinnamati,1,1,0,0,11
99104,khedaṅgato,khedangato,1,1,0,0,10
99105,lokahitāya,lokahitaya,26,26,0,0,10
99106,khedaṅgatoti,khedangatoti,1,0,1,0,12
99107,kāyikadukkhasaṅkhātaṃ,kayikadukkhasankhatam,1,1,0,0,21
99108,parissamaṃ,parissamam,33,31,2,0,10
99109,dukkhamanubhavīti,dukkhamanubhaviti,2,2,0,0,17
99110,paṭipattiṃ,patipattim,249,243,6,0,10
99111,addhānamaggappaṭipanno,addhanamaggappatipanno,50,48,2,0,22
99112,phalasamāpattiṃ,phalasamapattim,137,133,4,0,15
99113,samāpajjati,samapajjati,319,312,7,0,11
99114,akammakampi,akammakampi,2,2,0,0,11
99115,byagghapajjo,byagghapajjo,2,1,1,0,12
99116,pajjoti,pajjoti,1,0,1,0,7
99117,byagghapajje,byagghapajje,1,1,0,0,12
99118,saddulapathe,saddulapathe,1,1,0,0,12
99119,sampadiyati,sampadiyati,1,1,0,0,11
99120,ñāpiyati,napiyati,1,1,0,0,8
99121,vijjamānākāro,vijjamanakaro,1,1,0,0,13
99122,jātavedoti,jatavedoti,4,0,4,0,10
99123,jātova,jatova,8,8,0,0,6
99124,dhūmajāluṭṭhānena,dhumajalutthanena,2,2,0,0,17
99125,vijjāti,vijjati,96,17,79,0,7
99126,viditaṃ,viditam,263,231,32,0,7
99127,rāsaṭṭhaṃ,rasattham,14,13,1,0,9
99128,āyatanānaṃ,ayatananam,236,206,30,0,10
99129,āyatanaṭṭhaṃ,ayatanattham,12,12,0,0,12
99130,suññaṭṭhaṃ,sunnattham,9,9,0,0,10
99131,tathaṭṭhaṃ,tathattham,10,10,0,0,10
99132,adhipatiyaṭṭhaṃ,adhipatiyattham,6,6,0,0,15
99133,pīḷanādivasena,pilanadivasena,8,8,0,0,14
99134,muyha,muyha,1,1,0,0,5
99135,sativippavāso,sativippavaso,4,3,1,0,13
99136,cittavikkhepo,cittavikkhepo,5,5,0,0,13
99137,pamajjati,pamajjati,37,37,0,0,9
99138,surāmadamatto,suramadamatto,10,10,0,0,13
99139,puttamaṃsāni,puttamamsani,23,23,0,0,12
99140,khādayiṃ,khadayim,2,2,0,0,8
99141,mattahatthī,mattahatthi,8,7,1,0,11
99142,mejjati,mejjati,5,5,0,0,7
99143,antaradhā,antaradha,1,0,1,0,9
99144,antaradhāyanto,antaradhayanto,1,1,0,0,14
99145,antarahitā,antarahita,80,76,4,0,10
99146,antarāpidhāyati,antarapidhayati,1,1,0,0,15
99147,avagamanaṃ,avagamanam,1,0,1,0,10
99148,buddhavā,buddhava,6,6,0,0,8
99149,vibodheti,vibodheti,2,2,0,0,9
99150,pāramitāparibhāvitāya,paramitaparibhavitaya,2,2,0,0,21
99151,abujjhīti,abujjhiti,2,1,1,0,9
99152,kammenapi,kammenapi,12,12,0,0,9
99153,icchantā,icchanta,16,16,0,0,8
99154,adhigataguṇavisesehi,adhigatagunavisesehi,1,1,0,0,20
99155,bujjhanaṃ,bujjhanam,13,13,0,0,9
99156,paññāyādhivacanaṃ,pannayadhivacanam,1,1,0,0,17
99157,evaṃpaṇṇattiko,evampannattiko,2,2,0,0,14
99158,puggalopi,puggalopi,46,43,3,0,9
99159,paṭhamābhisambuddho,pathamabhisambuddho,38,37,1,0,19
99160,gayaṃ,gayam,22,16,6,0,5
99161,sabbaññutāya,sabbannutaya,52,47,5,0,12
99162,paṇṇattiyañceva,pannattiyanceva,1,1,0,0,15
99163,guyhamatthamasambuddhaṃ,guyhamatthamasambuddham,2,2,0,0,23
99164,sambodhayati,sambodhayati,6,6,0,0,12
99165,sambuddhumarahati,sambuddhumarahati,4,4,0,0,17
99166,bujjhituṃ,bujjhitum,19,19,0,0,9
99167,buddhuṃ,buddhum,3,3,0,0,7
99168,bujjhitvāna,bujjhitvana,2,2,0,0,11
99169,bujjhituna,bujjhituna,2,2,0,0,10
99170,buddhiya,buddhiya,1,1,0,0,8
99171,buddhiyāna,buddhiyana,1,1,0,0,10
99172,aññātaṃ,annatam,128,113,15,0,7
99173,asambodhaṃ,asambodham,2,2,0,0,10
99174,ayuttanti,ayuttanti,55,52,3,0,9
99175,sambuddhuṃ,sambuddhum,1,0,1,0,10
99176,saṃbujjhituṃ,sambujjhitum,2,2,0,0,12
99177,buddhāti,buddhati,27,11,16,0,8
99178,buddhānāti,buddhanati,1,0,1,0,10
99179,nāmarūpaparicchede,namarupaparicchede,29,26,3,0,18
99180,bodhimaggena,bodhimaggena,2,2,0,0,12
99181,budhvā,budhva,5,5,0,0,6
99182,yamāha,yamaha,6,5,1,0,6
99183,kārasaññogavato,karasannogavato,1,1,0,0,15
99184,paccayantabhāvato,paccayantabhavato,1,1,0,0,17
99185,kārasaṃyogavasena,karasamyogavasena,1,1,0,0,17
99186,padarūpassa,padarupassa,3,3,0,0,11
99187,ananukūlatāya,ananukulataya,1,1,0,0,13
99188,parisuddhe,parisuddhe,169,162,7,0,10
99189,porāṇapotthake,poranapotthake,2,2,0,0,14
99190,kārasaṃyogavigatassa,karasamyogavigatassa,1,1,0,0,20
99191,tica,tica,10,10,0,0,4
99192,anukūlo,anukulo,2,2,0,0,7
99193,pariyesantā,pariyesanta,32,32,0,0,11
99194,kārasaññogapadaṃ,karasannogapadam,1,1,0,0,16
99195,passissanti,passissanti,39,38,1,0,11
99196,sakkaṭaganthe,sakkataganthe,2,2,0,0,13
99197,kataparicayabhāvena,kataparicayabhavena,1,1,0,0,19
99198,vañcitehi,vancitehi,1,1,0,0,9
99199,saddhammanītividūhi,saddhammanitividuhi,1,1,0,0,19
99200,viddhā,viddha,21,21,0,0,6
99201,nilīyati,niliyati,23,23,0,0,8
99202,yadicchati,yadicchati,15,14,1,0,10
99203,pubbāpariyaṃ,pubbapariyam,18,13,5,0,12
99204,maccurājassa,maccurajassa,40,36,4,0,12
99205,ummādantimahaṃ,ummadantimaham,3,3,0,0,14
99206,āmukkamaṇikuṇḍalaṃ,amukkamanikundalam,1,1,0,0,18
99207,supāmi,supami,11,10,1,0,6
99208,divārattiṃ,divarattim,29,26,3,0,10
99209,sahassaṃva,sahassamva,3,3,0,0,10
99210,viddhāti,viddhati,3,1,2,0,8
99211,vijjhitvā,vijjhitva,267,263,4,0,9
99212,laddhānāti,laddhanati,4,0,4,0,10
99213,labhitvāna,labhitvana,22,22,0,0,10
99214,gatānipi,gatanipi,1,1,0,0,8
99215,kārapaṭibaddhāni,karapatibaddhani,1,1,0,0,16
99216,iccetānipi,iccetanipi,1,1,0,0,10
99217,parihīna,parihina,2,2,0,0,8
99218,kārasaññogāni,karasannogani,1,1,0,0,13
99219,saddavinicchayo,saddavinicchayo,1,1,0,0,15
99220,sakammakākammakoyaṃ,sakammakakammakoyam,1,1,0,0,19
99221,bodhanasadduccāraṇena,bodhanasadduccaranena,1,1,0,0,21
99222,vikasanaṃ,vikasanam,6,6,0,0,9
99223,niddakkhayo,niddakkhayo,1,1,0,0,11
99224,pabujjhati,pabujjhati,19,19,0,0,10
99225,pabodhati,pabodhati,1,1,0,0,9
99226,saṃdhā,samdha,1,0,1,0,6
99227,nevassa,nevassa,129,121,8,0,7
99228,bhākuṭi,bhakuti,3,3,0,0,7
99229,sandhiyati,sandhiyati,20,18,2,0,10
99230,sandhiyatīti,sandhiyatiti,8,2,6,0,12
99231,pakaraṇehi,pakaranehi,1,1,0,0,10
99232,irandhati,irandhati,5,5,0,0,9
99233,vidharassa,vidharassa,1,1,0,0,10
99234,dhaniyyati,dhaniyyati,2,2,0,0,10
99235,dhīno,dhino,1,1,0,0,5
99236,caraṇāyudhoti,caranayudhoti,1,0,1,0,13
99237,kujjhanā,kujjhana,24,21,3,0,8
99238,kujjhitattaṃ,kujjhitattam,25,22,3,0,12
99239,sucibhāvo,sucibhavo,15,13,2,0,9
99240,sujjhanaṃ,sujjhanam,3,3,0,0,9
99241,sodhako,sodhako,2,2,0,0,7
99242,saṃrādhane,samradhane,1,0,1,0,10
99243,rajjhati,rajjhati,2,2,0,0,8
99244,virajjhati,virajjhati,12,11,1,0,10
99245,aparajjhati,aparajjhati,28,28,0,0,11
99246,rādhayati,radhayati,1,1,0,0,9
99247,sādhayati,sadhayati,8,8,0,0,9
99248,sādhetabbanti,sadhetabbanti,7,7,0,0,13
99249,laddhakaṃ,laddhakam,17,15,2,0,9
99250,viddha,viddha,1,1,0,0,6
99251,vijjhanako,vijjhanako,2,2,0,0,10
99252,paṭividdho,patividdho,53,52,1,0,10
99253,vijjhanaṃ,vijjhanam,22,19,3,0,9
99254,viddhāna,viddhana,1,1,0,0,8
99255,gidhu,gidhu,1,0,1,0,5
99256,gijjhati,gijjhati,9,8,1,0,8
99257,gaddhabādhipubbo,gaddhabadhipubbo,26,25,1,0,16
99258,kāmagiddho,kamagiddho,14,14,0,0,10
99259,rujjhati,rujjhati,3,3,0,0,8
99260,paṭivirujjhati,pativirujjhati,6,6,0,0,14
99261,virodhako,virodhako,1,1,0,0,9
99262,anuvirodho,anuvirodho,1,1,0,0,10
99263,anuvidhā,anuvidha,1,0,1,0,8
99264,anukaraṇe,anukarane,1,0,1,0,9
99265,anuvi,anuvi,1,0,1,0,5
99266,anukriyāyaṃ,anukriyayam,1,1,0,0,11
99267,anuvidhīyati,anuvidhiyati,10,10,0,0,12
99268,dūsito,dusito,22,20,2,0,6
99269,giridattena,giridattena,4,4,0,0,11
99270,sāmassa,samassa,60,60,0,0,7
99271,tassevānuvidhīyatī,tassevanuvidhiyati,1,1,0,0,18
99272,dampi,dampi,1,1,0,0,5
99273,anurudha,anurudha,1,0,1,0,8
99274,anuruddho,anuruddho,261,256,5,0,9
99275,anusmāti,anusmati,1,1,0,0,8
99276,anuruddhoti,anuruddhoti,7,2,5,0,11
99277,anurujjhati,anurujjhati,8,8,0,0,11
99278,anukūlatā,anukulata,2,2,0,0,9
99279,lābhaṃ,labham,375,345,30,0,6
99280,alābhe,alabhe,35,30,5,0,6
99281,paṭivirujjhatī,pativirujjhati,1,1,0,0,14
99282,byadha,byadha,1,0,1,0,6
99283,byajjhati,byajjhati,2,2,0,0,9
99284,byādhoti,byadhoti,1,0,1,0,8
99285,tāḷeti,taleti,8,8,0,0,6
99286,pariveṭhane,parivethane,2,1,1,0,11
99287,gujjhati,gujjhati,1,1,0,0,8
99288,avamaññati,avamannati,7,7,0,0,10
99289,atimaññati,atimannati,38,37,1,0,10
99290,seyyādivasena,seyyadivasena,16,16,0,0,13
99291,maññanā,mannana,84,75,9,0,7
99292,maññitattaṃ,mannitattam,28,26,2,0,11
99293,sakammakoyaṃ,sakammakoyam,1,1,0,0,12
99294,jaññatī,jannati,1,1,0,0,7
99295,janesi,janesi,73,73,0,0,6
99296,nibbattetā,nibbatteta,2,2,0,0,10
99297,hetukattuvasenapi,hetukattuvasenapi,1,1,0,0,17
99298,nibbattetī,nibbatteti,11,9,2,0,10
99299,janī,jani,3,1,2,0,4
99300,sañjāti,sanjati,38,29,9,0,7
99301,abhinibbatti,abhinibbatti,95,83,12,0,12
99302,vijāyati,vijayati,26,25,1,0,8
99303,vijātamātuyāpi,vijatamatuyapi,14,14,0,0,14
99304,amanāpo,amanapo,127,122,5,0,7
99305,upavijaññā,upavijanna,11,9,2,0,10
99306,jāpeti,japeti,9,9,0,0,6
99307,jāpayati,japayati,2,2,0,0,8
99308,atthajāpikā,atthajapika,14,9,5,0,11
99309,sotamhi,sotamhi,4,4,0,0,7
99310,lokile,lokile,1,1,0,0,6
99311,lohena,lohena,30,27,3,0,6
99312,jātarūpena,jatarupena,23,22,1,0,10
99313,haññatī,hannati,5,5,0,0,7
99314,kammārehi,kammarehi,4,4,0,0,9
99315,hanantī,hananti,4,4,0,0,7
99316,kammārā,kammara,7,7,0,0,7
99317,hanantīti,hanantiti,15,10,5,0,9
99318,paharaṇanti,paharananti,3,3,0,0,11
99319,ruppanaṃ,ruppanam,68,46,22,0,8
99320,kuppanaṃ,kuppanam,8,8,0,0,8
99321,pīḷanaṃ,pilanam,50,38,12,0,7
99322,rūpakriyāyaṃ,rupakriyayam,2,1,1,0,12
99323,rūpeti,rupeti,29,6,23,0,6
99324,rūpayatī,rupayati,1,1,0,0,8
99325,ruppanaṭṭhena,ruppanatthena,18,18,0,0,13
99326,sītenapi,sitenapi,24,22,2,0,8
99327,uṇhenapi,unhenapi,22,22,0,0,8
99328,jighacchāyapi,jighacchayapi,7,7,0,0,13
99329,pipāsāyapi,pipasayapi,6,6,0,0,10
99330,ḍaṃsamakasavātātapasarīsapasamphassenapi,damsamakasavatatapasarisapasamphassenapi,4,4,0,0,40
99331,rupaṃ,rupam,2,1,1,0,5
99332,ghaṭṭiyati,ghattiyati,4,3,1,0,10
99333,pīḷiyati,piliyati,5,5,0,0,8
99334,vikārāpatti,vikarapatti,5,5,0,0,11
99335,sītādisannipāte,sitadisannipate,4,3,1,0,15
99336,visadisarūpappavattiyeva,visadisarupappavattiyeva,1,1,0,0,24
99337,kattuatthe,kattuatthe,37,35,2,0,10
99338,rūpapadasiddhiṃ,rupapadasiddhim,2,2,0,0,15
99339,pīḷiyatīti,piliyatiti,4,3,1,0,10
99340,kopādikriyāyeva,kopadikriyayeva,1,1,0,0,15
99341,ruppanakriyāti,ruppanakriyati,1,1,0,0,14
99342,bhijjamāno,bhijjamano,12,10,2,0,10
99343,kammakattutthe,kammakattutthe,2,2,0,0,14
99344,rūpapadasiddhi,rupapadasiddhi,2,2,0,0,14
99345,ruppananti,ruppananti,7,7,0,0,10
99346,kammakattutthena,kammakattutthena,3,2,1,0,16
99347,ruppatī,ruppati,25,23,2,0,7
99348,sītenā,sitena,4,4,0,0,6
99349,kammakattuatthe,kammakattuatthe,2,2,0,0,15
99350,paccaya,paccaya,79,75,4,0,7
99351,vaṇṇasaṇṭhānādīsu,vannasanthanadisu,2,2,0,0,17
99352,rūpūpapattiyā,rupupapattiya,184,183,1,0,13
99353,arūpasaññī,arupasanni,167,161,6,0,10
99354,bahiddhārūpāni,bahiddharupani,2,2,0,0,14
99355,kasiṇanimitte,kasinanimitte,5,5,0,0,13
99356,arūpā,arupa,71,66,5,0,5
99357,rūpantveva,rupantveva,9,8,1,0,10
99358,rūpappamāṇo,rupappamano,24,20,4,0,11
99359,rūpappasanno,rupappasanno,20,17,3,0,12
99360,paccayepi,paccayepi,7,7,0,0,9
99361,saṇṭhānaādimhi,santhanaadimhi,1,1,0,0,14
99362,pakopo,pakopo,25,22,3,0,6
99363,vacīpakopaṃ,vacipakopam,4,4,0,0,11
99364,tappati,tappati,113,110,3,0,7
99365,santappati,santappati,31,31,0,0,10
99366,dapa,dapa,3,2,1,0,4
99367,dappati,dappati,1,1,0,0,7
99368,luppanaṃ,luppanam,1,1,0,0,8
99369,lubbhati,lubbhati,21,20,1,0,8
99370,attanoyeva,attanoyeva,82,80,2,0,10
99371,jaṇṇukaṃ,jannukam,6,6,0,0,8
99372,olubbha,olubbha,16,16,0,0,7
99373,lubbhitvā,lubbhitva,1,1,0,0,9
99374,lubbhitvāna,lubbhitvana,1,1,0,0,11
99375,lubbhiya,lubbhiya,1,1,0,0,8
99376,lubbhiyāna,lubbhiyana,1,1,0,0,10
99377,olubbhitvā,olubbhitva,2,2,0,0,10
99378,olubbhitvāna,olubbhitvana,1,1,0,0,12
99379,olubbhiya,olubbhiya,1,1,0,0,9
99380,olubbhiyāna,olubbhiyana,1,1,0,0,11
99381,lubbhituṃ,lubbhitum,1,1,0,0,9
99382,olubbhituṃ,olubbhitum,1,1,0,0,10
99383,lobhoti,lobhoti,21,11,10,0,7
99384,lubbhanti,lubbhanti,19,17,2,0,9
99385,lubbhanamattameva,lubbhanamattameva,11,11,0,0,17
99386,lubbhitattaṃ,lubbhitattam,11,10,1,0,12
99387,bahunāmāni,bahunamani,1,1,0,0,10
99388,khubbhati,khubbhati,5,5,0,0,9
99389,saṃkhubbhati,samkhubbhati,1,1,0,0,12
99390,khubbhitthanagaraṃ,khubbhitthanagaram,1,1,0,0,18
99391,khobheti,khobheti,17,16,1,0,8
99392,khobhayati,khobhayati,1,1,0,0,10
99393,sammati,sammati,326,320,6,0,7
99394,upasammati,upasammati,43,40,3,0,10
99395,vūpasammati,vupasammati,215,215,0,0,11
99396,samayatītidha,samayatitidha,1,1,0,0,13
99397,kāritarūpāni,karitarupani,3,3,0,0,12
99398,abhāvagamanaṃ,abhavagamanam,2,2,0,0,13
99399,addhānamaggappaṭipannassa,addhanamaggappatipannassa,9,7,2,0,25
99400,kilantabhāve,kilantabhave,3,3,0,0,12
99401,niruddhabhāve,niruddhabhave,3,3,0,0,13
99402,santañāṇagocaratāyaṃ,santananagocaratayam,2,2,0,0,20
99403,upasantassa,upasantassa,44,42,2,0,11
99404,satīmato,satimato,39,39,0,0,8
99405,kilesavūpasame,kilesavupasame,4,4,0,0,14
99406,mahācorā,mahacora,13,11,2,0,8
99407,kilantatte,kilantatte,1,1,0,0,10
99408,niruddhatte,niruddhatte,1,1,0,0,11
99409,santadhīgocarattane,santadhigocarattane,1,1,0,0,19
99410,kilesūpasame,kilesupasame,4,4,0,0,12
99411,sādhusu,sadhusu,2,2,0,0,7
99412,panāgato,panagato,5,5,0,0,8
99413,dammati,dammati,2,2,0,0,7
99414,dameti,dameti,41,37,4,0,6
99415,damayatī,damayati,1,1,0,0,8
99416,damoti,damoti,32,17,15,0,6
99417,indriyasaṃvarādīnaṃ,indriyasamvaradinam,4,3,1,0,19
99418,vusitabrahmacariyo,vusitabrahmacariyo,22,17,5,0,18
99419,indriyasaṃvaro,indriyasamvaro,97,86,11,0,14
99420,damā,dama,20,16,4,0,4
99421,cāgā,caga,35,32,3,0,4
99422,bhiyyodha,bhiyyodha,8,8,0,0,9
99423,saṃyamena,samyamena,62,62,0,0,9
99424,saccavajjenā,saccavajjena,3,3,0,0,12
99425,damupasamenā,damupasamena,1,1,0,0,12
99426,yāyanti,yayanti,7,7,0,0,7
99427,yāyamāno,yayamano,9,9,0,0,8
99428,yāyanto,yayanto,3,3,0,0,7
99429,yāyantamanuyāyati,yayantamanuyayati,1,1,0,0,17
99430,yātānuyāyī,yatanuyayi,4,4,0,0,10
99431,yāyituṃ,yayitum,2,2,0,0,7
99432,yāyitvā,yayitva,4,4,0,0,7
99433,vāradesanākāraṇesu,varadesanakaranesu,3,3,0,0,18
99434,gantabbaṭṭhāne,gantabbatthane,5,5,0,0,14
99435,bhikkhuniyo,bhikkhuniyo,1808,1777,31,0,11
99436,ovadituṃ,ovaditum,70,67,3,0,8
99437,madhupiṇḍikapariyāyotinaṃ,madhupindikapariyayotinam,1,1,0,0,25
99438,dhārehī,dharehi,66,66,0,0,7
99439,desanāyaṃ,desanayam,38,35,3,0,9
99440,rājañña,rajanna,101,98,3,0,7
99441,pariyāyapatho,pariyayapatho,3,2,1,0,13
99442,khobhapariyāyo,khobhapariyayo,2,2,0,0,14
99443,pariyāyaravo,pariyayaravo,1,1,0,0,12
99444,samantatova,samantatova,2,2,0,0,11
99445,riyati,riyati,1,1,0,0,6
99446,vilī,vili,1,0,1,0,4
99447,vilīnabhāve,vilinabhave,1,0,1,0,11
99448,vilīyati,viliyati,21,20,1,0,8
99449,vilāpayati,vilapayati,1,1,0,0,10
99450,saṃsibbati,samsibbati,11,10,1,0,10
99451,sibbaṃ,sibbam,1,1,0,0,6
99452,sibbanto,sibbanto,7,7,0,0,8
99453,sibbeti,sibbeti,6,6,0,0,7
99454,sibbayati,sibbayati,1,1,0,0,9
99455,sibbāpeti,sibbapeti,7,7,0,0,9
99456,sibbāpayati,sibbapayati,1,1,0,0,11
99457,dhibbati,dhibbati,1,1,0,0,8
99458,khibbati,khibbati,1,1,0,0,8
99459,siyanti,siyanti,167,167,0,0,7
99460,aggamaggo,aggamaggo,25,24,1,0,9
99461,sāyitaṃ,sayitam,18,15,3,0,7
99462,sāyanaṃ,sayanam,3,3,0,0,7
99463,pāṇippasave,panippasave,1,0,1,0,11
99464,sūyati,suyati,24,24,0,0,6
99465,pasūyati,pasuyati,1,1,0,0,8
99466,pasūtā,pasuta,6,6,0,0,6
99467,haraṇadittīsu,haranadittisu,1,0,1,0,13
99468,kusayati,kusayati,1,1,0,0,8
99469,saṃkileso,samkileso,170,136,34,0,9
99470,klissati,klissati,1,1,0,0,8
99471,malīnatāpi,malinatapi,1,1,0,0,10
99472,kiliṭṭhavatthaṃ,kilitthavattham,7,7,0,0,15
99473,saṃkiliṭṭhena,samkilitthena,14,13,1,0,13
99474,saṃkilissanti,samkilissanti,52,52,0,0,13
99475,māṇavā,manava,142,140,2,0,6
99476,anekatthatāya,anekatthataya,3,3,0,0,13
99477,massati,massati,2,2,0,0,7
99478,lissati,lissati,9,8,1,0,7
99479,lesane,lesane,1,1,0,0,6
99480,tassati,tassati,10,10,0,0,7
99481,paritassati,paritassati,99,94,5,0,11
99482,paritassanā,paritassana,46,38,8,0,11
99483,dosane,dosane,1,0,1,0,6
99484,dosanaṃ,dosanam,1,1,0,0,7
99485,dosito,dosito,1,1,0,0,6
99486,padussati,padussati,17,16,1,0,9
99487,paduṭṭho,paduttho,9,9,0,0,8
99488,dūsako,dusako,31,28,3,0,6
99489,dūsanā,dusana,3,3,0,0,6
99490,nirassatiādiyati,nirassatiadiyati,1,1,0,0,16
99491,nirassatīti,nirassatiti,8,0,8,0,11
99492,dhammakkhānādīni,dhammakkhanadini,1,1,0,0,16
99493,issāsoti,issasoti,4,0,4,0,8
99494,yasu,yasu,4,3,1,0,4
99495,niyasakammaṃ,niyasakammam,8,7,1,0,12
99496,vinayakammena,vinayakammena,13,13,0,0,13
99497,niyassiyati,niyassiyati,1,1,0,0,11
99498,bhajāpiyatīti,bhajapiyatiti,1,1,0,0,13
99499,niyaso,niyaso,2,2,0,0,6
99500,niggahakammaṃ,niggahakammam,6,6,0,0,13
99501,bhassakārako,bhassakarako,31,31,0,0,12
99502,migajātānaṃ,migajatanam,11,11,0,0,11
99503,nassanadhammaṃ,nassanadhammam,21,21,0,0,14
99504,panassati,panassati,6,5,1,0,9
99505,vasali,vasali,15,15,0,0,6
99506,pire,pire,16,15,1,0,4
99507,vinaṭṭho,vinattho,14,14,0,0,8
99508,nāseti,naseti,42,39,3,0,6
99509,nāsayati,nasayati,1,1,0,0,8
99510,sussati,sussati,36,36,0,0,7
99511,soseti,soseti,8,7,1,0,6
99512,sosayati,sosayati,3,3,0,0,8
99513,sosiyati,sosiyati,1,1,0,0,8
99514,kriyāpadamappasiddhaṃ,kriyapadamappasiddham,2,2,0,0,21
99515,sussaṃ,sussam,2,2,0,0,6
99516,sussanto,sussanto,2,2,0,0,8
99517,sussamāno,sussamano,6,6,0,0,9
99518,dahado,dahado,1,1,0,0,6
99519,tussati,tussati,66,66,0,0,7
99520,santussati,santussati,12,12,0,0,10
99521,santuṭṭhi,santutthi,36,33,3,0,9
99522,tussitabbaṃ,tussitabbam,5,5,0,0,11
99523,parihāniyaṃ,parihaniyam,5,1,4,0,11
99524,hāyanti,hayanti,29,28,1,0,7
99525,chambhitattaṃ,chambhitattam,177,158,19,0,13
99526,lomahaṃso,lomahamso,96,92,4,0,9
99527,pahīyissatī,pahiyissati,7,7,0,0,11
99528,pahīyatī,pahiyati,45,33,12,0,8
99529,gaṇikadhātussa,ganikadhatussa,1,1,0,0,14
99530,pajahatī,pajahati,80,65,15,0,8
99531,kattupadassa,kattupadassa,1,1,0,0,12
99532,sannayhati,sannayhati,8,8,0,0,10
99533,sammuyhati,sammuyhati,10,10,0,0,10
99534,pamuyhati,pamuyhati,1,1,0,0,9
99535,pamoho,pamoho,19,13,6,0,6
99536,momūho,momuho,38,34,4,0,6
99537,momūhaṃ,momuham,4,3,1,0,7
99538,moheti,moheti,18,16,2,0,6
99539,avisadatāya,avisadataya,13,13,0,0,11
99540,mahāmūḷhoti,mahamulhoti,4,4,0,0,11
99541,suha,suha,1,0,1,0,4
99542,sayhati,sayhati,1,1,0,0,7
99543,suyhati,suyhati,1,1,0,0,7
99544,nhā,nha,1,0,1,0,3
99545,nhāyati,nhayati,45,44,1,0,7
99546,appakkharānaṃ,appakkharanam,1,1,0,0,13
99547,bahubhāve,bahubhave,8,8,0,0,9
99548,nahāyati,nahayati,31,31,0,0,8
99549,nahāyitvā,nahayitva,26,26,0,0,9
99550,nhāyitvā,nhayitva,91,90,1,0,8
99551,nhānaṃ,nhanam,13,12,1,0,6
99552,nhātoti,nhatoti,2,1,1,0,7
99553,anumatattā,anumatatta,4,4,0,0,10
99554,siniyhati,siniyhati,10,10,0,0,9
99555,sinehako,sinehako,1,1,0,0,8
99556,sinehito,sinehito,1,1,0,0,8
99557,nisnehamabhikaṅkhāmī,nisnehamabhikankhami,1,1,0,0,20
99558,viriḷa,virila,1,0,1,0,6
99559,codane,codane,2,1,1,0,6
99560,viriḷito,virilito,1,1,0,0,8
99561,lajjāvasena,lajjavasena,1,1,0,0,11
99562,codanāvasena,codanavasena,10,10,0,0,12
99563,viriḷitoti,virilitoti,1,0,1,0,10
99564,lajjito,lajjito,27,27,0,0,7
99565,atthasaṃvaṇṇakā,atthasamvannaka,1,1,0,0,15
99566,lajjanākārappatto,lajjanakarappatto,4,4,0,0,17
99567,divādī,divadi,2,1,1,0,6
99568,svādigaṇika,svadiganika,1,1,0,0,11
99569,suṇiṃsu,sunimsu,39,39,0,0,7
99570,paṭissuṇi,patissuni,14,14,0,0,9
99571,paṭissuṇiṃsu,patissunimsu,4,4,0,0,12
99572,sussūsati,sussusati,23,23,0,0,9
99573,anabbhāsavisaye,anabbhasavisaye,1,1,0,0,15
99574,suyyamāno,suyyamano,12,12,0,0,9
99575,asuyitthāti,asuyitthati,1,1,0,0,11
99576,suṇitvā,sunitva,69,69,0,0,7
99577,suṇiya,suniya,3,3,0,0,6
99578,suṇiyāna,suniyana,1,1,0,0,8
99579,sāvayati,savayati,6,6,0,0,8
99580,padarūpamappasiddhaṃ,padarupamappasiddham,1,1,0,0,20
99581,sāvakoti,savakoti,25,16,9,0,8
99582,āgatapphalo,agatapphalo,2,2,0,0,11
99583,anāgatapphalo,anagatapphalo,1,1,0,0,13
99584,savanante,savanante,16,14,2,0,9
99585,ovādaṃ,ovadam,551,531,20,0,6
99586,sissoti,sissoti,5,5,0,0,7
99587,sota,sota,36,31,5,0,4
99588,atthuddhārena,atthuddharena,1,1,0,0,13
99589,anupapadena,anupapadena,1,1,0,0,11
99590,pacitepi,pacitepi,1,1,0,0,8
99591,sotadvārānusārañātesu,sotadvaranusaranatesu,1,1,0,0,21
99592,gacchantoti,gacchantoti,25,14,11,0,11
99593,sutadhammassa,sutadhammassa,14,14,0,0,13
99594,vissutadhammassāti,vissutadhammassati,9,8,1,0,18
99595,avassutā,avassuta,86,80,6,0,8
99596,avassutassa,avassutassa,83,76,7,0,11
99597,purisapuggalassā,purisapuggalassa,8,5,3,0,16
99598,tintassāti,tintassati,2,2,0,0,10
99599,jhānappasutā,jhanappasuta,9,9,0,0,12
99600,anuyuttāti,anuyuttati,5,2,3,0,10
99601,upacitanti,upacitanti,13,13,0,0,10
99602,mutaṃ,mutam,257,209,48,0,5
99603,sutasannicayo,sutasannicayo,64,59,5,0,13
99604,sotadvārānusāraviññātadhammadharoti,sotadvaranusaravinnatadhammadharoti,1,1,0,0,35
99605,anekatthappabhedo,anekatthappabhedo,3,3,0,0,17
99606,maṃsaviññāṇañāṇesu,mamsavinnanananesu,2,2,0,0,18
99607,taṇhādīsu,tanhadisu,6,6,0,0,9
99608,dhārāyaṃ,dharayam,2,2,0,0,8
99609,cittasantatiyampi,cittasantatiyampi,2,2,0,0,17
99610,sotāyatanaṃ,sotayatanam,376,376,0,0,11
99611,sotadhātu,sotadhatu,103,102,1,0,9
99612,sotindriyaṃ,sotindriyam,204,203,1,0,11
99613,maṃsasote,mamsasote,4,4,0,0,9
99614,sotaviññāṇe,sotavinnane,7,7,0,0,11
99615,dibbāya,dibbaya,287,280,7,0,7
99616,sotadhātuyā,sotadhatuya,275,272,3,0,11
99617,ñāṇasote,nanasote,4,4,0,0,8
99618,sotāni,sotani,56,54,2,0,6
99619,lokasminti,lokasminti,11,11,0,0,10
99620,kittitāni,kittitani,3,3,0,0,9
99621,pakittitāni,pakittitani,3,3,0,0,11
99622,ācikkhitāni,acikkhitani,3,3,0,0,11
99623,desitāni,desitani,105,105,0,0,8
99624,paññapitāni,pannapitani,3,3,0,0,11
99625,vivaritāni,vivaritani,3,3,0,0,10
99626,uttānīkatāni,uttanikatani,3,3,0,0,12
99627,taṇhāsoto,tanhasoto,8,8,0,0,9
99628,diṭṭhisoto,ditthisoto,5,5,0,0,10
99629,kilesasoto,kilesasoto,4,4,0,0,10
99630,duccaritasoto,duccaritasoto,4,4,0,0,13
99631,avijjāsoto,avijjasoto,5,5,0,0,10
99632,dārukkhandhaṃ,darukkhandham,39,36,3,0,13
99633,vuyhamānaṃ,vuyhamanam,50,44,6,0,10
99634,udakadhārāyaṃ,udakadharayam,2,2,0,0,13
99635,ariyassetaṃ,ariyassetam,8,8,0,0,11
99636,aṭṭhaṅgikassa,atthangikassa,70,68,2,0,13
99637,viññāṇasotaṃ,vinnanasotam,6,4,2,0,12
99638,patiṭṭhitañca,patitthitanca,5,5,0,0,13
99639,patiṭṭhitañcā,patitthitanca,2,2,0,0,13
99640,cittasantatiyanti,cittasantatiyanti,1,1,0,0,17
99641,soṇoti,sonoti,12,2,10,0,6
99642,sāḷuro,saluro,1,1,0,0,6
99643,migadaṃsano,migadamsano,1,1,0,0,11
99644,sunidhāti,sunidhati,1,1,0,0,9
99645,sunakhī,sunakhi,10,10,0,0,7
99646,kukkurī,kukkuri,1,1,0,0,7
99647,sārameyyāti,sarameyyati,1,1,0,0,11
99648,kukkuroti,kukkuroti,1,1,0,0,9
99649,bālakāle,balakale,8,6,2,0,8
99650,mahallakepi,mahallakepi,1,1,0,0,11
99651,kukkurajātake,kukkurajatake,1,0,1,0,13
99652,kukkurā,kukkura,14,14,0,0,7
99653,koleyyakā,koleyyaka,8,8,0,0,9
99654,vaṇṇabalūpapannā,vannabalupapanna,3,3,0,0,16
99655,tiimasmiṃpadese,tiimasmimpadese,1,1,0,0,15
99656,evamatthaṃ,evamattham,25,23,2,0,10
99657,vaṇṇayiṃsu,vannayimsu,10,10,0,0,10
99658,kukkurāti,kukkurati,3,1,2,0,9
99659,taruṇopi,tarunopi,10,10,0,0,8
99660,pūtimuttanti,putimuttanti,2,2,0,0,12
99661,tadahujātopi,tadahujatopi,7,7,0,0,12
99662,jarasiṅgālo,jarasingalo,22,21,1,0,11
99663,komalāpi,komalapi,2,2,0,0,8
99664,gaḷācīlatā,galacilata,1,1,0,0,10
99665,suvaṇṇavaṇṇopi,suvannavannopi,12,12,0,0,14
99666,vassasatikopi,vassasatikopi,5,5,0,0,13
99667,mahallakā,mahallaka,51,51,0,0,9
99668,kāyūpapannāpi,kayupapannapi,1,1,0,0,13
99669,kiṇoti,kinoti,1,1,0,0,6
99670,kiṇanti,kinanti,13,12,1,0,7
99671,sakkuṇāti,sakkunati,5,5,0,0,9
99672,sakkuṇanti,sakkunanti,18,17,1,0,10
99673,sakkī,sakki,1,1,0,0,5
99674,sakahitañca,sakahitanca,1,1,0,0,11
99675,sakyakulajāto,sakyakulajato,1,1,0,0,13
99676,kocipi,kocipi,42,42,0,0,6
99677,bhagavantañca,bhagavantanca,18,18,0,0,13
99678,piṅgiyo,pingiyo,64,60,4,0,7
99679,samuddharāhīti,samuddharahiti,1,1,0,0,14
99680,ālapi,alapi,21,21,0,0,5
99681,paramasakyā,paramasakya,5,5,0,0,11
99682,vacanamupādāya,vacanamupadaya,8,8,0,0,14
99683,sākiyā,sakiya,55,52,3,0,6
99684,svādi,svadi,5,1,4,0,5
99685,ttepi,ttepi,1,1,0,0,5
99686,anekassaradhātuto,anekassaradhatuto,1,1,0,0,17
99687,uṇāpaccayo,unapaccayo,2,2,0,0,10
99688,ṇāpaccayāti,napaccayati,1,1,0,0,11
99689,khīṇoti,khinoti,5,4,1,0,7
99690,khīṇāti,khinati,26,19,7,0,7
99691,giṇoti,ginoti,3,3,0,0,6
99692,giṇāti,ginati,3,3,0,0,6
99693,ruṇoti,runoti,1,1,0,0,6
99694,ruṇāti,runati,1,1,0,0,6
99695,rādhuṇāti,radhunati,1,1,0,0,9
99696,sādhuṇāti,sadhunati,1,1,0,0,9
99697,pīṇoti,pinoti,1,1,0,0,6
99698,pīṇāti,pinati,1,1,0,0,6
99699,yamasādhanaṃ,yamasadhanam,16,12,4,0,12
99700,sambhuṇāti,sambhunati,11,10,1,0,10
99701,abhisambhuṇāti,abhisambhunati,3,3,0,0,14
99702,sambhuṇanto,sambhunanto,1,1,0,0,11
99703,abhisambhuṇamāno,abhisambhunamano,1,1,0,0,16
99704,pappotī,pappoti,9,9,0,0,7
99705,pāpuṇīti,papuniti,52,40,12,0,8
99706,abhisambhuṇātīti,abhisambhunatiti,3,0,3,0,16
99707,sampāpuṇāti,sampapunati,32,31,1,0,11
99708,khipuṇāti,khipunati,1,1,0,0,9
99709,macchapañjaro,macchapanjaro,1,1,0,0,13
99710,āpuṇāti,apunati,1,1,0,0,7
99711,pakkhepane,pakkhepane,1,0,1,0,10
99712,sabbaguyhesu,sabbaguyhesu,4,4,0,0,12
99713,nimiyati,nimiyati,2,2,0,0,8
99714,pakkhipiyatīti,pakkhipiyatiti,2,2,0,0,14
99715,sattapadena,sattapadena,5,3,2,0,11
99716,vohāravasena,voharavasena,47,47,0,0,12
99717,avissāsiko,avissasiko,3,3,0,0,10
99718,paṭiviruddhopi,pativiruddhopi,1,1,0,0,14
99719,sattapadavītihāramattenapi,sattapadavitiharamattenapi,1,1,0,0,26
99720,piyavācānicchāraṇena,piyavacaniccharanena,1,1,0,0,20
99721,ālāpasallāpakaraṇamattena,alapasallapakaranamattena,1,1,0,0,25
99722,daḷhavissāso,dalhavissaso,1,1,0,0,12
99723,guṇapasaṃsāvasena,gunapasamsavasena,1,1,0,0,17
99724,vuṇāti,vunati,2,2,0,0,6
99725,sīlasaṃvuto,silasamvuto,13,13,0,0,11
99726,abhisavo,abhisavo,1,0,1,0,8
99727,manthanaṃ,manthanam,2,2,0,0,9
99728,sinhānaṃ,sinhanam,1,1,0,0,8
99729,siṇoti,sinoti,1,1,0,0,6
99730,siṇāti,sinati,1,1,0,0,6
99731,nisitasatthaṃ,nisitasattham,1,1,0,0,13
99732,nūnāyaṃ,nunayam,13,11,2,0,7
99733,sunisitena,sunisitena,9,9,0,0,10
99734,bhaṇantī,bhananti,19,17,2,0,8
99735,vusa,vusa,1,0,1,0,4
99736,pāgabbiye,pagabbiye,1,0,1,0,9
99737,pāgabbiyaṃ,pagabbiyam,3,2,1,0,10
99738,kāyavācāmanehi,kayavacamanehi,3,3,0,0,14
99739,pagabbabhāvo,pagabbabhavo,1,1,0,0,12
99740,vusuṇāti,vusunati,1,1,0,0,8
99741,asuṇāti,asunati,1,1,0,0,7
99742,asamānantattepi,asamanantattepi,1,1,0,0,15
99743,samānatthānaṃ,samanatthanam,1,1,0,0,13
99744,tiga,tiga,1,0,1,0,4
99745,sagha,sagha,1,0,1,0,5
99746,kivi,kivi,1,0,1,0,4
99747,jiri,jiri,1,0,1,0,4
99748,tikuṇāti,tikunati,1,1,0,0,8
99749,tiguṇāti,tigunati,3,2,1,0,8
99750,saghuṇāti,saghunati,1,1,0,0,9
99751,dikkhuṇāti,dikkhunati,1,1,0,0,10
99752,kivuṇāti,kivunati,1,1,0,0,8
99753,ciruṇāti,cirunati,1,1,0,0,8
99754,jiruṇāti,jirunati,1,1,0,0,8
99755,dāsuṇāti,dasunati,1,1,0,0,8
99756,duṇoti,dunoti,1,1,0,0,6
99757,duṇātīti,dunatiti,1,1,0,0,8
99758,hiṃsāvācakāni,himsavacakani,1,1,0,0,13
99759,suvādī,suvadi,1,0,1,0,6
99760,gaṇavho,ganavho,1,1,0,0,7
99761,atthayuttito,atthayuttito,5,5,0,0,12
99762,kiyādigaṇika,kiyadiganika,2,2,0,0,12
99763,dabbavinimayo,dabbavinimayo,1,0,1,0,13
99764,kayavikkayavasena,kayavikkayavasena,3,3,0,0,17
99765,bhaṇḍassa,bhandassa,61,58,3,0,9
99766,vikkiṇanti,vikkinanti,21,21,0,0,10
99767,ketuṃ,ketum,14,13,1,0,5
99768,kiṇituṃ,kinitum,6,6,0,0,7
99769,vikketuṃ,vikketum,3,3,0,0,8
99770,vikkiṇituṃ,vikkinitum,10,10,0,0,10
99771,kiṇitvā,kinitva,118,116,2,0,7
99772,vikkiṇitvā,vikkinitva,75,75,0,0,10
99773,vikkiṇeyya,vikkineyya,11,10,1,0,10
99774,haneyya,haneyya,55,52,3,0,7
99775,khiṇāti,khinati,1,1,0,0,7
99776,khiṇātīti,khinatiti,1,0,1,0,9
99777,atikhinoti,atikhinoti,1,0,1,0,10
99778,atigato,atigato,3,3,0,0,7
99779,cāpātikhiṇāva,capatikhinava,1,1,0,0,13
99780,cāpātikhiṇā,capatikhina,1,0,1,0,11
99781,cāpato,capato,8,7,1,0,6
99782,atigatā,atigata,1,1,0,0,7
99783,cāpātikhiṇāti,capatikhinati,1,0,1,0,13
99784,cāpā,capa,16,14,2,0,4
99785,vinimuttāti,vinimuttati,3,3,0,0,11
99786,padatthavivaraṇaṃ,padatthavivaranam,1,1,0,0,17
99787,gatatthaññeva,gatatthanneva,1,1,0,0,13
99788,khānīti,khaniti,1,0,1,0,7
99789,cināti,cinati,9,9,0,0,6
99790,vicināti,vicinati,35,31,4,0,8
99791,vicinati,vicinati,36,35,1,0,8
99792,ocināti,ocinati,3,3,0,0,7
99793,ocinati,ocinati,2,2,0,0,7
99794,pacināti,pacinati,1,1,0,0,8
99795,pacinitvā,pacinitva,2,2,0,0,9
99796,cinātīti,cinatiti,2,1,1,0,8
99797,iṭṭhakavaḍḍhakī,itthakavaddhaki,5,5,0,0,15
99798,puññasañcayo,punnasancayo,4,4,0,0,12
99799,vijināti,vijinati,3,3,0,0,8
99800,jiniyati,jiniyati,1,1,0,0,8
99801,jitabbo,jitabbo,1,1,0,0,7
99802,parājayanaṃ,parajayanam,1,1,0,0,11
99803,nāvajīyati,navajiyati,8,8,0,0,10
99804,jitamassa,jitamassa,4,4,0,0,9
99805,noyāti,noyati,4,4,0,0,6
99806,jetāti,jetati,1,0,1,0,6
99807,mārādiarayo,maradiarayo,1,1,0,0,11
99808,mārādayo,maradayo,5,5,0,0,8
99809,mādisā,madisa,33,33,0,0,6
99810,tasmāhaṃ,tasmaham,50,50,0,0,8
99811,upaka,upaka,15,15,0,0,5
99812,sopapado,sopapado,1,1,0,0,8
99813,paccekabuddhādīsu,paccekabuddhadisu,1,1,0,0,17
99814,paccekajino,paccekajino,1,1,0,0,11
99815,vipākajino,vipakajino,3,3,0,0,10
99816,avipākajino,avipakajino,2,2,0,0,11
99817,jāniyaṃ,janiyam,1,0,1,0,7
99818,jāpaye,japaye,7,7,0,0,6
99819,rathassaṃ,rathassam,6,4,2,0,9
99820,maṇikuṇḍale,manikundale,7,5,2,0,11
99821,dhanañca,dhananca,45,42,3,0,8
99822,animittā,animitta,96,75,21,0,8
99823,nāyare,nayare,10,10,0,0,6
99824,hāpaye,hapaye,8,8,0,0,6
99825,jaññūti,jannuti,4,3,1,0,7
99826,ñātimittā,natimitta,22,21,1,0,9
99827,suhajjā,suhajja,28,22,6,0,7
99828,saṅkhāravikāralakkhaṇanibbānapaññattidhammā,sankharavikaralakkhananibbanapannattidhamma,1,1,0,0,43
99829,vāccaliṅgatte,vaccalingatte,1,1,0,0,13
99830,sabbaliṅgiko,sabbalingiko,1,1,0,0,12
99831,thunāti,thunati,3,3,0,0,7
99832,abhitthunāti,abhitthunati,1,1,0,0,12
99833,abhitthuto,abhitthuto,10,10,0,0,10
99834,nitthunane,nitthunane,1,0,1,0,10
99835,revate,revate,15,13,2,0,6
99836,supāpadhamme,supapadhamme,8,8,0,0,12
99837,apārutadvāre,aparutadvare,5,5,0,0,12
99838,adānasīle,adanasile,4,4,0,0,9
99839,nessāma,nessama,8,8,0,0,7
99840,thunanti,thunanti,15,13,2,0,8
99841,samappitā,samappita,54,51,3,0,9
99842,mittaddu,mittaddu,8,8,0,0,8
99843,mittaddūti,mittadduti,1,0,1,0,10
99844,dubbhatīti,dubbhatiti,3,2,1,0,10
99845,dumoti,dumoti,5,1,4,0,6
99846,duniyati,duniyati,1,1,0,0,8
99847,gehasambhārādiatthāya,gehasambharadiatthaya,1,1,0,0,21
99848,hiṃsiyati,himsiyati,1,1,0,0,9
99849,chindiyati,chindiyati,2,2,0,0,10
99850,paṇṇapupphādiatthikehi,pannapupphadiatthikehi,1,1,0,0,22
99851,paṇṇapupphādiharaṇena,pannapupphadiharanena,1,1,0,0,21
99852,dhono,dhono,30,20,10,0,5
99853,vākacīrāni,vakacirani,11,11,0,0,10
99854,dhūmoti,dhumoti,7,1,6,0,7
99855,dhammadesanāyaṃ,dhammadesanayam,8,8,0,0,15
99856,pakatidhūmeti,pakatidhumeti,2,2,0,0,13
99857,bhasmāni,bhasmani,1,1,0,0,8
99858,mosavajjaṃ,mosavajjam,37,25,12,0,10
99859,dhūmāyito,dhumayito,1,1,0,0,9
99860,dhūmāyanto,dhumayanto,2,2,0,0,10
99861,palipo,palipo,14,12,2,0,6
99862,timulaṃ,timulam,1,1,0,0,7
99863,pabbaja,pabbaja,27,27,0,0,7
99864,brahmadattā,brahmadatta,9,9,0,0,11
99865,paññāno,pannano,1,1,0,0,7
99866,paññānamaggino,pannanamaggino,1,1,0,0,14
99867,pakatidhūme,pakatidhume,3,3,0,0,11
99868,kodhataṇhāvitakkesu,kodhatanhavitakkesu,1,1,0,0,19
99869,desanāyañca,desanayanca,5,5,0,0,11
99870,dhonāti,dhonati,2,1,1,0,7
99871,kāyaduccaritaṃ,kayaduccaritam,186,155,31,0,14
99872,dhutañca,dhutanca,10,10,0,0,8
99873,dhotañca,dhotanca,10,10,0,0,8
99874,sandhotañca,sandhotanca,9,9,0,0,11
99875,niddhotañca,niddhotanca,10,10,0,0,11
99876,manoduccaritaṃ,manoduccaritam,123,115,8,0,14
99877,taṃkāraṇā,tamkarana,66,65,1,0,9
99878,dhutā,dhuta,23,20,3,0,5
99879,sandhotā,sandhota,14,14,0,0,8
99880,niddhotā,niddhota,20,20,0,0,8
99881,dhonassāti,dhonassati,1,1,0,0,10
99882,dhātūnamanekatthatāya,dhatunamanekatthataya,1,1,0,0,21
99883,kampanatthepi,kampanatthepi,1,1,0,0,13
99884,dhovanatthepi,dhovanatthepi,1,1,0,0,13
99885,sobhitattheragāthāyaṃ,sobhitattheragathayam,1,0,1,0,21
99886,anāgatavacane,anagatavacane,2,2,0,0,13
99887,monena,monena,18,17,1,0,6
99888,monissaṃ,monissam,5,3,2,0,8
99889,rūpantarañca,rupantaranca,1,1,0,0,12
99890,jānissaṃ,janissam,4,4,0,0,8
99891,ñāṇamevādhippetaṃ,nanamevadhippetam,1,1,0,0,17
99892,moneyyapaṭipadāsaṅkhātaṃ,moneyyapatipadasankhatam,2,2,0,0,24
99893,maggañāṇamonampi,maggananamonampi,1,1,0,0,16
99894,khandhādiloke,khandhadiloke,8,8,0,0,13
99895,mūḷharūpo,mulharupo,6,6,0,0,9
99896,tulaṃva,tulamva,8,6,2,0,7
99897,varamādāya,varamadaya,6,6,0,0,10
99898,aparāpettha,aparapettha,1,1,0,0,11
99899,atthavibhāvanā,atthavibhavana,29,29,0,0,14
99900,kāyamoneyyādīsu,kayamoneyyadisu,2,2,0,0,15
99901,dantapoṇaṃ,dantaponam,8,6,2,0,10
99902,taṃsantānaṃ,tamsantanam,4,4,0,0,11
99903,kusalakammaṃ,kusalakammam,74,74,0,0,12
99904,sakammikattā,sakammikatta,2,2,0,0,12
99905,hīnajaccānaṃ,hinajaccanam,6,6,0,0,12
99906,caṇḍālādīnaṃ,candaladinam,1,1,0,0,12
99907,saddānamatthakathanassa,saddanamatthakathanassa,1,1,0,0,23
99908,evamādināpi,evamadinapi,14,14,0,0,11
99909,nānādhātuvasenapi,nanadhatuvasenapi,1,1,0,0,17
99910,samupagacchanti,samupagacchanti,1,1,0,0,15
99911,khetrajo,khetrajo,7,6,1,0,8
99912,dinnakoti,dinnakoti,4,3,1,0,9
99913,sayanapīṭhe,sayanapithe,5,5,0,0,11
99914,ureti,ureti,1,1,0,0,5
99915,sippuggaṇhanako,sippugganhanako,2,2,0,0,15
99916,posāpanatthāya,posapanatthaya,4,4,0,0,14
99917,dinnako,dinnako,13,11,2,0,7
99918,visodhenti,visodhenti,9,9,0,0,10
99919,piṇātīti,pinatiti,1,1,0,0,8
99920,pītīti,pititi,46,20,26,0,6
99921,piṇayatīti,pinayatiti,5,4,1,0,10
99922,khuddakāpīti,khuddakapiti,3,2,1,0,12
99923,khaṇikāpīti,khanikapiti,10,8,2,0,11
99924,okkantikāpīti,okkantikapiti,9,7,2,0,13
99925,ubbegāpīti,ubbegapiti,14,12,2,0,10
99926,pharaṇāpītīti,pharanapititi,6,6,0,0,13
99927,lomahaṃsanamattameva,lomahamsanamattameva,3,3,0,0,20
99928,vijjuppādasadisā,vijjuppadasadisa,7,7,0,0,16
99929,uddhaggaṃ,uddhaggam,13,13,0,0,9
99930,laṅghāpanappamāṇā,langhapanappamana,3,3,0,0,17
99931,pharaṇāpītiyā,pharanapitiya,3,2,1,0,13
99932,uppannāya,uppannaya,190,187,3,0,9
99933,pūritavatthi,puritavatthi,6,6,0,0,12
99934,pakkhandapabbatakucchi,pakkhandapabbatakucchi,6,6,0,0,22
99935,anupariphuṭaṃ,anupariphutam,2,2,0,0,13
99936,sampiyāyanalakkhaṇattā,sampiyayanalakkhanatta,1,1,0,0,22
99937,piṇātī,pinati,1,1,0,0,6
99938,piyāyati,piyayati,21,19,2,0,8
99939,piyāyatīti,piyayatiti,14,12,2,0,10
99940,pemanaṃ,pemanam,1,1,0,0,7
99941,minitabbaṃ,minitabbam,10,10,0,0,10
99942,metabbaṃ,metabbam,2,2,0,0,8
99943,metabbā,metabba,8,7,1,0,7
99944,manoti,manoti,113,48,65,0,6
99945,nāḷiyā,naliya,46,45,1,0,6
99946,minamāno,minamano,11,11,0,0,8
99947,miniyate,miniyate,1,1,0,0,8
99948,paricchindiyateti,paricchindiyateti,1,1,0,0,17
99949,puññabalena,punnabalena,20,19,1,0,11
99950,nibbattabyamhaṃ,nibbattabyamham,1,1,0,0,15
99951,devaniketaṃ,devaniketam,1,1,0,0,11
99952,upasobhitaṃ,upasobhitam,6,6,0,0,11
99953,pabhāsatimidaṃ,pabhasatimidam,1,1,0,0,14
99954,byamhanti,byamhanti,1,1,0,0,9
99955,thomiyati,thomiyati,1,1,0,0,9
99956,vārijo,varijo,13,11,2,0,6
99957,vāricaro,varicaro,1,1,0,0,8
99958,visesanāmāni,visesanamani,1,1,0,0,12
99959,khaliso,khaliso,1,1,0,0,7
99960,candakulo,candakulo,1,1,0,0,9
99961,kandaphali,kandaphali,1,1,0,0,10
99962,indaphali,indaphali,1,1,0,0,9
99963,indavalo,indavalo,1,1,0,0,8
99964,kuliso,kuliso,1,1,0,0,6
99965,vāmi,vami,1,1,0,0,4
99966,kuṅkutalo,kunkutalo,1,1,0,0,9
99967,kaṇḍiko,kandiko,1,1,0,0,7
99968,sakulo,sakulo,1,1,0,0,6
99969,satavaṅko,satavanko,1,1,0,0,9
99970,macchabandhanapañjaro,macchabandhanapanjaro,1,1,0,0,21
99971,kumīna,kumina,1,0,1,0,6
99972,vārijasseva,varijasseva,3,3,0,0,11
99973,kumināmukhe,kuminamukhe,16,15,1,0,11
99974,apassato,apassato,65,61,4,0,8
99975,rāgadosādivasaṃ,ragadosadivasam,1,1,0,0,15
99976,gatidesanesu,gatidesanesu,1,0,1,0,12
99977,rikāti,rikati,1,1,0,0,6
99978,lināti,linati,1,1,0,0,6
99979,nilināti,nilinati,1,1,0,0,8
99980,sallīnaṃ,sallinam,4,4,0,0,8
99981,paṭisallānaṃ,patisallanam,84,69,15,0,12
99982,vināti,vinati,74,48,26,0,6
99983,vināhi,vinahi,1,1,0,0,6
99984,viyyati,viyyati,10,9,1,0,7
99985,vītaṃ,vitam,28,26,2,0,5
99986,suvītaṃ,suvitam,4,1,3,0,7
99987,vetabbaṃ,vetabbam,5,4,1,0,8
99988,vāyāpeti,vayapeti,14,12,2,0,8
99989,tantavāyehi,tantavayehi,35,33,2,0,11
99990,vāyāpessāmā,vayapessama,1,1,0,0,11
99991,vāyāpesuṃ,vayapesum,6,6,0,0,9
99992,veṇūti,venuti,1,0,1,0,6
99993,lūto,luto,2,1,1,0,4
99994,vītarasabhāvaṃ,vitarasabhavam,1,1,0,0,14
99995,sarasabhāvaṃ,sarasabhavam,1,1,0,0,12
99996,anavajjaiṭṭhavipākalakkhaṇo,anavajjaitthavipakalakkhano,1,1,0,0,27
99997,diṭṭhadhammikasamparāyike,ditthadhammikasamparayike,3,3,0,0,25
99998,lūtoti,lutoti,1,0,1,0,6
99999,lūtasuttaṃ,lutasuttam,2,2,0,0,10
